Simulation,PlayerID,Player,Position,Team,Age,Games Played,Goals,Assists,Points
1,8476453,Nikita Kucherov,R,TBL,31,82,46,100,146
1,8478402,Connor McDavid,C,EDM,27,76,40,91,131
1,8477956,David Pastrnak,R,BOS,28,81,58,71,129
1,8479318,Auston Matthews,C,TOR,27,78,68,58,126
1,8481559,Jack Hughes,C,NJD,23,78,49,76,125
1,8477934,Leon Draisaitl,C,EDM,29,77,42,76,118
1,8477492,Nathan MacKinnon,C,COL,29,81,49,68,117
1,8478483,Mitch Marner,R,TOR,27,82,31,85,116
1,8480027,Jason Robertson,L,DAL,25,82,42,72,114
1,8477939,William Nylander,R,TOR,28,82,50,58,108
1,8478420,Mikko Rantanen,R,COL,28,78,45,62,107
1,8475172,Nazem Kadri,C,CGY,34,78,44,60,104
1,8479407,Jesper Bratt,L,NJD,26,77,34,70,104
1,8477404,Jake Guentzel,C,TBL,30,81,41,61,102
1,8478550,Artemi Panarin,L,NYR,33,79,38,62,100
1,8478398,Kyle Connor,L,WPG,28,72,48,50,98
1,8479314,Matthew Tkachuk,L,FLA,27,78,34,63,97
1,8477942,Kevin Fiala,L,LAK,28,82,33,64,97
1,8476468,J.T. Miller,C,VAN,31,79,35,61,96
1,8478010,Brayden Point,C,TBL,28,82,45,50,95
1,8478864,Kirill Kaprizov,L,MIN,27,72,40,55,95
1,8480800,Quinn Hughes,D,VAN,25,75,12,82,94
1,8480012,Elias Pettersson,C,VAN,26,74,40,52,92
1,8473419,Brad Marchand,L,BOS,36,79,37,54,91
1,8480002,Nico Hischier,C,NJD,25,73,35,56,91
1,8474600,Roman Josi,D,NSH,34,74,26,65,91
1,8476887,Filip Forsberg,L,NSH,30,73,43,47,90
1,8477493,Aleksander Barkov,C,FLA,29,79,34,56,90
1,8477501,Valeri Nichushkin,R,COL,29,82,44,44,88
1,8475166,John Tavares,C,TOR,34,80,47,40,87
1,8478427,Sebastian Aho,C,CAR,27,68,33,54,87
1,8480801,Brady Tkachuk,L,OTT,25,80,30,56,86
1,8478445,Mathew Barzal,C,NYI,27,81,27,58,85
1,8474564,Steven Stamkos,C,NSH,34,72,42,42,84
1,8480069,Cale Makar,D,COL,26,71,21,63,84
1,8482116,Tim Stützle,C,OTT,22,79,33,50,83
1,8479420,Tage Thompson,C,BUF,27,72,38,44,82
1,8476853,Morgan Rielly,D,TOR,30,76,17,65,82
1,8478493,Joel Eriksson Ek,C,MIN,27,69,43,38,81
1,8478414,Timo Meier,R,NJD,28,74,41,40,81
1,8478449,Roope Hintz,C,DAL,28,81,37,44,81
1,8481557,Matt Boldy,L,MIN,23,67,30,51,81
1,8480036,Miro Heiskanen,D,DAL,25,77,12,69,81
1,8475786,Zach Hyman,L,EDM,32,76,42,38,80
1,8479343,Clayton Keller,R,UTA,26,76,33,47,80
1,8476389,Vincent Trocheck,C,NYR,31,77,27,53,80
1,8480023,Robert Thomas,C,STL,25,77,21,59,80
1,8477955,Jared McCann,L,SEA,28,66,39,40,79
1,8478403,Jack Eichel,C,VGK,28,76,41,37,78
1,8476539,Jonathan Marchessault,R,NSH,34,74,34,44,78
1,8471675,Sidney Crosby,C,PIT,37,71,25,53,78
1,8476456,Jonathan Huberdeau,C,CGY,31,79,17,61,78
1,8477409,Carter Verhaeghe,C,FLA,29,78,36,41,77
1,8471685,Anze Kopitar,C,LAK,37,79,26,51,77
1,8478439,Travis Konecny,R,PHI,27,74,40,36,76
1,8476460,Mark Scheifele,C,WPG,31,72,27,49,76
1,8471215,Evgeni Malkin,C,PIT,38,74,26,50,76
1,8477504,Josh Morrissey,D,WPG,29,74,16,59,75
1,8477951,Nick Schmaltz,C,UTA,28,75,35,39,74
1,8477402,Pavel Buchnevich,L,STL,29,78,31,43,74
1,8480208,Drake Batherson,R,OTT,26,79,30,44,74
1,8475158,Ryan O'Reilly,C,NSH,33,77,27,47,74
1,8484144,Connor Bedard,C,CHI,19,72,26,48,74
1,8478401,Pavel Zacha,C,BOS,27,77,26,48,74
1,8475692,Mats Zuccarello,R,MIN,37,75,17,57,74
1,8475810,Bryan Rust,R,PIT,32,74,39,34,73
1,8475754,Brock Nelson,C,NYI,33,80,32,41,73
1,8479542,Brandon Hagel,L,TBL,26,81,35,37,72
1,8479675,Trevor Moore,L,LAK,29,81,29,43,72
1,8475913,Mark Stone,R,VGK,32,74,21,51,72
1,8473512,Claude Giroux,R,OTT,36,81,28,43,71
1,8480830,Andrei Svechnikov,R,CAR,24,79,27,44,71
1,8476454,Ryan Nugent-Hopkins,C,EDM,31,77,25,46,71
1,8482740,Wyatt Johnston,C,DAL,21,79,34,35,69
1,8477949,Alex Tuch,R,BUF,28,73,29,40,69
1,8474150,Mikael Backlund,C,CGY,35,81,29,40,69
1,8475167,Victor Hedman,D,TBL,34,82,11,57,68
1,8471214,Alex Ovechkin,L,WSH,39,74,28,39,67
1,8477933,Sam Reinhart,C,FLA,29,74,28,38,66
1,8474102,David Perron,L,OTT,36,82,23,43,66
1,8474578,Erik Karlsson,D,PIT,34,77,15,51,66
1,8479323,Adam Fox,D,NYR,26,74,12,54,66
1,8478444,Brock Boeser,R,VAN,27,74,38,27,65
1,8477416,Oliver Bjorkstrand,R,SEA,29,74,26,39,65
1,8478873,Troy Terry,R,ANA,27,74,24,41,65
1,8478469,Thomas Chabot,D,OTT,27,73,17,48,65
1,8480865,Noah Dobson,D,NYI,24,80,15,50,65
1,8480839,Rasmus Dahlin,D,BUF,24,66,11,54,65
1,8479425,Filip Hronek,D,VAN,27,78,15,49,64
1,8478397,Rasmus Andersson,D,CGY,28,77,11,53,64
1,8478460,Zach Werenski,D,CBJ,27,78,10,54,64
1,8482699,Dylan Guenther,R,UTA,21,70,30,33,63
1,8481540,Cole Caufield,R,MTL,23,79,30,33,63
1,8477960,Adrian Kempe,R,LAK,28,80,29,33,62
1,8478975,Mason Marchment,L,DAL,29,79,25,37,62
1,8478407,Vince Dunn,D,SEA,28,73,7,55,62
1,8481068,Yegor Sharangovich,C,CGY,26,78,34,27,61
1,8473994,Jamie Benn,L,DAL,35,82,24,37,61
1,8474141,Patrick Kane,R,DET,36,82,23,38,61
1,8476346,Johnny Gaudreau,L,CBJ,31,78,17,44,61
1,8475170,Brayden Schenn,C,STL,33,74,32,28,60
1,8477946,Dylan Larkin,C,DET,28,81,27,33,60
1,8478440,Dylan Strome,C,WSH,27,73,24,36,60
1,8482720,Matthew Knies,L,TOR,22,77,12,48,60
1,8476459,Mika Zibanejad,C,NYR,31,78,27,32,59
1,8480018,Nick Suzuki,C,MTL,25,76,22,37,59
1,8479410,Mikhail Sergachev,D,UTA,26,76,11,48,59
1,8482093,Seth Jarvis,C,CAR,22,74,34,24,58
1,8477500,Bo Horvat,C,NYI,29,79,33,25,58
1,8475169,Evander Kane,L,EDM,33,77,29,29,58
1,8482110,Dawson Mercer,C,NJD,23,75,22,36,58
1,8482665,Matty Beniers,C,SEA,22,72,21,37,58
1,8480803,Evan Bouchard,D,EDM,25,78,12,46,58
1,8475184,Chris Kreider,L,NYR,33,77,32,25,57
1,8482109,Alexis Lafrenière,L,NYR,23,76,29,28,57
1,8479337,Alex DeBrincat,R,DET,27,79,26,31,57
1,8477935,Sam Bennett,C,FLA,28,75,23,34,57
1,8477494,Jonathan Drouin,L,COL,29,80,11,46,57
1,8482745,Mason McTavish,C,ANA,21,74,22,34,56
1,8475765,Vladimir Tarasenko,R,DET,33,78,20,36,56
1,8476875,Mike Matheson,D,MTL,30,74,10,46,56
1,8479385,Jordan Kyrou,C,STL,26,71,28,27,55
1,8477998,Warren Foegele,L,LAK,28,80,19,36,55
1,8482684,Luke Hughes,D,NJD,21,70,11,44,55
1,8475784,Jeff Skinner,C,EDM,32,78,29,25,54
1,8476483,Rickard Rakell,R,PIT,31,75,25,29,54
1,8476881,Tomas Hertl,C,VGK,31,78,23,31,54
1,8482078,Lucas Raymond,L,DET,22,79,22,32,54
1,8475168,Matt Duchene,C,DAL,33,80,19,35,54
1,8483515,Juraj Slafkovsky,L,MTL,20,76,15,39,54
1,8477496,Elias Lindholm,C,BOS,30,78,24,29,53
1,8482124,Quinton Byfield,R,LAK,22,81,22,31,53
1,8477986,Brandon Montour,D,SEA,30,69,20,33,53
1,8479345,Jakob Chychrun,D,WSH,26,70,17,36,53
1,8479325,Charlie McAvoy,D,BOS,27,74,11,42,53
1,8477426,Nicholas Paul,L,TBL,29,80,25,27,52
1,8476826,Yanni Gourde,C,SEA,33,72,23,29,52
1,8474641,Adam Henrique,C,EDM,34,78,23,29,52
1,8476448,William Karlsson,C,VGK,31,78,18,34,52
1,8477511,Anthony Mantha,R,CGY,30,79,17,35,52
1,8478498,Jake DeBrusk,L,VAN,28,70,16,36,52
1,8477346,MacKenzie Weegar,D,CGY,30,72,14,38,52
1,8476462,Dougie Hamilton,D,NJD,31,67,12,40,52
1,8476399,Blake Coleman,C,CGY,33,78,29,22,51
1,8476432,Boone Jenner,C,CBJ,31,67,27,24,51
1,8478462,Nicolas Roy,C,VGK,27,75,25,26,51
1,8477940,Nikolaj Ehlers,L,WPG,28,69,22,29,51
1,8478047,Michael Bunting,L,PIT,29,73,22,29,51
1,8478474,Lawson Crouse,L,UTA,27,77,22,29,51
1,8482667,William Eklund,L,SJS,22,63,20,31,51
1,8481528,Dylan Cozens,C,BUF,23,71,18,33,51
1,8482702,Logan Stankoven,C,DAL,21,81,16,35,51
1,8480220,Noah Cates,L,PHI,25,74,15,36,51
1,8481711,Matias Maccelli,L,UTA,24,74,14,37,51
1,8480064,Josh Norris,C,OTT,25,79,31,19,50
1,8475726,Tyler Toffoli,C,SJS,32,69,26,24,50
1,8478519,Anthony Cirelli,C,TBL,27,82,25,25,50
1,8482159,Tyson Foerster,R,PHI,22,74,24,26,50
1,8474679,Gustav Nyquist,C,NSH,35,67,20,30,50
1,8476479,Phillip Danault,C,LAK,31,81,20,30,50
1,8482113,Anton Lundell,C,FLA,23,75,18,32,50
1,8480798,Philipp Kurashev,C,CHI,25,67,18,32,50
1,8476792,Torey Krug,D,STL,33,70,15,35,50
1,8474563,Drew Doughty,D,LAK,35,68,11,39,50
1,8480028,Morgan Frost,C,PHI,25,70,28,21,49
1,8475794,Tyler Seguin,C,DAL,32,81,25,24,49
1,8479525,Ross Colton,C,COL,28,82,24,25,49
1,8477479,Tyler Bertuzzi,L,CHI,29,65,21,28,49
1,8481533,Trevor Zegras,C,ANA,23,68,19,30,49
1,8475798,Mikael Granlund,C,SJS,32,71,12,37,49
1,8480014,Gabriel Vilardi,C,WPG,25,68,30,18,48
1,8471698,T.J. Oshie,R,WSH,38,70,28,20,48
1,8477476,Artturi Lehkonen,L,COL,29,80,23,25,48
1,8479400,Pierre-Luc Dubois,L,WSH,26,70,19,29,48
1,8479999,Casey Mittelstadt,C,COL,26,80,18,30,48
1,8480797,Joel Farabee,L,PHI,24,76,16,32,48
1,8484145,Zach Benson,L,BUF,19,69,15,33,48
1,8478542,Evan Rodrigues,C,FLA,31,76,25,22,47
1,8480015,Owen Tippett,R,PHI,25,75,23,24,47
1,8480009,Eeli Tolvanen,R,SEA,25,74,20,27,47
1,8477456,J.T. Compher,L,DET,29,80,20,27,47
1,8482149,Cole Perfetti,C,WPG,22,67,16,31,47
1,8476882,Teuvo Teravainen,C,CHI,30,67,15,32,47
1,8476905,Chandler Stephenson,C,SEA,30,74,14,33,47
1,8476906,Shayne Gostisbehere,D,CAR,31,75,11,36,47
1,8481542,Moritz Seider,D,DET,23,79,6,41,47
1,8478458,John (Jack) Roslovic,C,CAR,27,66,22,24,46
1,8475745,Charlie Coyle,C,BOS,32,78,20,26,46
1,8475753,Justin Faulk,D,STL,32,72,9,37,46
1,8473986,Alex Killorn,L,ANA,35,73,22,23,45
1,8478057,Dakota Joshua,C,VAN,28,70,20,25,45
1,8478438,Tommy Novak,C,NSH,27,70,10,35,45
1,8479987,Morgan Geekie,C,BOS,26,77,22,22,44
1,8478366,Frank Vatrano,R,ANA,30,71,22,22,44
1,8474586,Jordan Eberle,R,SEA,34,74,21,23,44
1,8477964,Ivan Barbashev,C,VGK,29,72,18,26,44
1,8474149,Evgenii Dadonov,R,DAL,35,81,16,28,44
1,8480188,Fabian Zetterlund,L,SJS,25,63,13,31,44
1,8484153,Leo Carlsson,C,ANA,20,74,24,19,43
1,8475151,Kyle Palmieri,C,NYI,33,81,24,19,43
1,8482475,Yegor Chinakhov,R,CBJ,23,66,21,22,43
1,8476872,Scott Laughton,C,PHI,30,73,18,25,43
1,8478856,Conor Garland,R,VAN,28,70,17,26,43
1,8478472,Mathieu Joseph,R,STL,27,67,14,29,43
1,8478055,Gustav Forsling,D,FLA,28,70,9,34,43
1,8477503,Max Domi,C,TOR,29,74,7,36,43
1,8478038,Devon Toews,D,COL,30,68,6,37,43
1,8481560,Arthur Kaliyev,R,LAK,23,78,21,21,42
1,8475768,Jaden Schwartz,C,SEA,32,73,19,23,42
1,8480849,Barrett Hayton,C,UTA,24,70,19,23,42
1,8478466,Daniel Sprong,R,VAN,27,74,18,24,42
1,8483431,Logan Cooley,C,UTA,20,73,17,25,42
1,8483808,Andrei Kuzmenko,L,CGY,28,77,16,26,42
1,8478042,Viktor Arvidsson,L,EDM,31,72,16,26,42
1,8477444,Andre Burakovsky,L,SEA,29,73,14,28,42
1,8477451,Ryan Hartman,R,MIN,30,69,14,28,42
1,8476438,Brandon Saad,L,STL,32,75,25,16,41
1,8478046,Danton Heinen,L,VAN,29,70,22,19,41
1,8475714,Calle Jarnkrok,C,TOR,33,78,19,22,41
1,8475763,Kevin Hayes,R,PIT,32,72,18,23,41
1,8482097,Jack Quinn,R,BUF,23,58,17,24,41
1,8480434,Sean Durzi,D,UTA,26,69,11,30,41
1,8477932,Aaron Ekblad,D,FLA,28,70,11,30,41
1,8479365,Trent Frederic,C,BOS,26,74,20,20,40
1,8475722,Jason Zucker,L,BUF,32,72,18,22,40
1,8480039,Martin Necas,C,CAR,25,71,16,24,40
1,8480185,Eetu Luostarinen,C,FLA,26,74,13,27,40
1,8471724,Kris Letang,D,PIT,37,80,5,35,40
1,8475314,Anders Lee,L,NYI,34,77,19,20,39
1,8477429,Andrew Copp,C,DET,30,77,17,22,39
1,8475287,Erik Haula,L,NJD,33,66,17,22,39
1,8481596,Shane Pinto,C,OTT,24,76,16,23,39
1,8480113,Alex Iafallo,L,WPG,31,67,15,24,39
1,8476461,Sean Couturier,C,PHI,32,69,15,24,39
1,8476458,Ryan Strome,C,ANA,31,67,14,25,39
1,8477447,Shea Theodore,D,VGK,29,55,7,32,39
1,8481554,Kaapo Kakko,R,NYR,23,73,21,17,38
1,8477505,Alexander Wennberg,C,SJS,30,66,20,18,38
1,8480459,Pius Suter,C,VAN,28,63,16,22,38
1,8475760,Nick Bjugstad,C,UTA,32,71,15,23,38
1,8481604,Pavel Dorofeyev,L,VGK,24,67,14,24,38
1,8481523,Kirby Dach,C,MTL,23,69,12,26,38
1,8484166,Adam Fantilli,C,CBJ,20,71,11,27,38
1,8475793,Ryan Johansen,C,PHI,32,67,11,27,38
1,8478396,Noah Hanifin,D,VGK,27,61,10,28,38
1,8481581,Thomas Harley,D,DAL,23,77,10,28,38
1,8474565,Alex Pietrangelo,D,VGK,34,60,8,30,38
1,8482122,Brock Faber,D,MIN,22,79,4,34,38
1,8481524,Bowen Byram,D,BUF,23,71,21,16,37
1,8481535,Nils Hoglander,L,VAN,24,65,21,16,37
1,8482624,Daniil Miromanov,D,CGY,27,71,18,19,37
1,8482146,Luke Evangelista,R,NSH,22,67,18,19,37
1,8478233,Andrew Mangiapane,L,WSH,28,66,15,22,37
1,8477953,Kasperi Kapanen,R,STL,28,69,15,22,37
1,8475218,Mattias Ekholm,D,EDM,34,72,10,27,37
1,8481703,Valtteri Puustinen,R,PIT,25,67,7,30,37
1,8470613,Brent Burns,D,CAR,39,75,7,30,37
1,8482079,Marco Rossi,C,MIN,23,55,17,19,36
1,8482074,Connor Zary,C,CGY,23,62,15,21,36
1,8476419,Jean-Gabriel Pageau,C,NYI,32,80,14,22,36
1,8481577,Philip Tomasino,C,NSH,23,65,13,23,36
1,8477497,Sean Monahan,C,CBJ,30,68,13,23,36
1,8477407,Anthony Duclair,L,NYI,29,78,13,23,36
1,8482671,Owen Power,D,BUF,22,71,10,26,36
1,8480817,K'Andre Miller,D,NYR,24,74,9,27,36
1,8482105,Jake Sanderson,D,OTT,22,75,8,28,36
1,8476923,Damon Severson,D,CBJ,30,80,7,29,36
1,8479591,Michael Eyssimont,C,TBL,28,81,18,17,35
1,8475193,Tomas Tatar,L,NJD,34,61,16,19,35
1,8481618,Alex Newhook,C,MTL,23,73,14,21,35
1,8475191,Reilly Smith,R,NYR,33,74,13,22,35
1,8476927,Teddy Blueger,C,VAN,30,66,12,23,35
1,8477495,Seth Jones,D,CHI,30,71,10,25,35
1,8477498,Darnell Nurse,D,EDM,29,79,7,28,35
1,8476854,Hampus Lindholm,D,BOS,30,69,5,30,35
1,8480145,Neal Pionk,D,WPG,29,71,3,32,35
1,8475799,Nino Niederreiter,R,WPG,32,62,18,16,34
1,8482175,JJ Peterka,R,BUF,22,69,18,16,34
1,8480813,Joe Veleno,C,DET,24,74,17,17,34
1,8474716,Jared Spurgeon,D,MIN,35,75,14,20,34
1,8476869,Brady Skjei,D,NSH,30,71,13,21,34
1,8480748,Kiefer Sherwood,L,VAN,29,61,13,21,34
1,8480078,Filip Chytil,C,NYR,25,64,11,23,34
1,8474590,John Carlson,D,WSH,34,63,5,29,34
1,8479293,Brandon Tanev,L,SEA,33,67,23,10,33
1,8482089,Jake Neighbours,L,STL,22,71,20,13,33
1,8478463,Anthony Beauvillier,L,PIT,27,69,19,14,33
1,8478891,Mason Appleton,C,WPG,28,66,15,18,33
1,8476958,Jaccob Slavin,D,CAR,30,77,5,28,33
1,8481186,Logan O'Connor,R,COL,28,79,17,15,32
1,8482055,Drew O'Connor,L,PIT,26,61,17,15,32
1,8482117,Lukas Reichel,L,CHI,22,60,16,16,32
1,8476880,Tom Wilson,R,WSH,30,68,15,17,32
1,8479339,Patrik Laine,L,CBJ,26,61,14,18,32
1,8476480,Vladislav Namestnikov,C,WPG,32,68,8,24,32
1,8476897,Oskar Sundqvist,C,STL,30,62,8,24,32
1,8482092,Ridly Greig,C,OTT,22,73,7,25,32
1,8476917,Adam Pelech,D,NYI,30,78,3,29,32
1,8475764,Cam Fowler,D,ANA,33,72,2,30,32
1,8475220,Marcus Foligno,L,MIN,33,62,18,13,31
1,8482660,Kent Johnson,C,CBJ,22,67,16,15,31
1,8482705,Cole Sillinger,C,CBJ,21,63,16,15,31
1,8476981,Josh Anderson,R,MTL,30,73,16,15,31
1,8475848,Brendan Gallagher,R,MTL,32,73,15,16,31
1,8474053,Logan Couture,C,SJS,35,66,10,21,31
1,8482133,Thomas Bordeleau,C,SJS,22,67,9,22,31
1,8481606,Jordan Spence,D,LAK,23,65,9,22,31
1,8478136,Jake Middleton,D,MIN,28,75,7,24,31
1,8476931,Jake McCabe,D,TOR,31,66,6,25,31
1,8482655,Janis Moser,D,TBL,24,77,5,26,31
1,8480802,Ryan McLeod,C,BUF,25,63,15,15,30
1,8479353,Brett Howden,C,VGK,26,71,15,15,30
1,8478115,Pierre Engvall,L,NYI,28,76,14,16,30
1,8479390,Taylor Raddysh,R,WSH,26,63,14,16,30
1,8483505,Matthew Poitras,C,BOS,20,73,12,18,30
1,8476292,Ondrej Palat,L,NJD,33,63,10,20,30
1,8478133,Jake Evans,C,MTL,28,72,10,20,30
1,8478507,John Marino,D,UTA,27,68,2,28,30
1,8481546,Cam York,D,PHI,23,70,2,28,30
1,8479941,Justin Danforth,R,CBJ,31,62,17,12,29
1,8480855,Jack McBain,C,UTA,24,71,13,16,29
1,8478413,Jordan Greenway,L,BUF,27,64,11,18,29
1,8477425,Miles Wood,L,COL,29,76,11,18,29
1,8482712,Oskar Olausson,R,COL,22,78,10,19,29
1,8477488,Brett Pesce,D,NJD,30,60,9,20,29
1,8475208,Brian Dumoulin,D,ANA,33,71,6,23,29
1,8478109,Victor Olofsson,L,VGK,29,71,20,8,28
1,8474189,Lars Eller,C,PIT,35,64,14,14,28
1,8478043,Sam Lafferty,C,BUF,29,59,14,14,28
1,8473422,Nick Foligno,L,CHI,37,56,13,15,28
1,8481580,Connor McMichael,C,WSH,23,61,13,15,28
1,8475149,Marcus Johansson,L,MIN,34,61,12,16,28
1,8480205,Emil Bemstrom,C,PIT,25,61,12,16,28
1,8481093,Rafael Harvey-Pinard,L,MTL,25,57,10,18,28
1,8479992,Michael Rasmussen,C,DET,25,80,10,18,28
1,8476925,Colton Sissons,C,NSH,31,65,10,18,28
1,8477952,Robby Fabbri,C,ANA,28,60,8,20,28
1,8479402,Jake Bean,D,CGY,26,66,6,22,28
1,8477948,Travis Sanheim,D,PHI,28,70,4,24,28
1,8478882,Vladislav Gavrikov,D,LAK,29,68,3,25,28
1,8476392,Adam Lowry,C,WPG,31,64,15,12,27
1,8479996,Cody Glass,C,NSH,25,57,14,13,27
1,8480980,Connor Dewar,C,TOR,25,68,14,13,27
1,8482679,Matt Coronato,R,CGY,22,65,14,13,27
1,8479315,Joey Anderson,R,CHI,26,55,13,14,27
1,8479351,Sam Steel,C,DAL,26,78,13,14,27
1,8476329,Travis Boyd,C,MIN,31,58,12,15,27
1,8481481,Blake Lizotte,C,PIT,27,62,11,16,27
1,8480144,David Kampf,C,TOR,29,70,11,16,27
1,8474715,Cameron Atkinson,R,TBL,35,82,11,16,27
1,8476474,Stefan Noesen,R,NJD,31,68,10,17,27
1,8477839,Conor Sheary,L,TBL,32,78,8,19,27
1,8477947,Sonny Milano,L,WSH,28,62,6,21,27
1,8479982,Conor Timmins,D,TOR,26,57,5,22,27
1,8476892,Colton Parayko,D,STL,31,69,4,23,27
1,8482259,Bobby McMann,C,TOR,28,59,19,7,26
1,8476469,Joel Armia,R,MTL,31,65,16,10,26
1,8481582,Nicholas Robertson,L,TOR,23,68,13,13,26
1,8470621,Corey Perry,R,EDM,39,71,13,13,26
1,8476422,Mike Reilly,D,NYI,31,79,11,15,26
1,8473563,Nicklas Backstrom,C,WSH,37,56,10,16,26
1,8482062,Cole Smith,L,NSH,29,55,10,16,26
1,8477987,Ryan Donato,C,CHI,28,63,8,18,26
1,8476463,Jonas Brodin,D,MIN,31,77,7,19,26
1,8475200,Dmitry Orlov,D,CAR,33,74,6,20,26
1,8478970,Jalen Chatfield,D,CAR,28,65,5,21,26
1,8476525,Colin Miller,D,WPG,32,70,5,21,26
1,8476979,Erik Gustafsson,D,DET,32,74,2,24,26
1,8478432,Christian Fischer,R,DET,27,76,14,11,25
1,8478508,Yakov Trenin,C,MIN,27,58,14,11,25
1,8480789,Oliver Wahlstrom,R,NYI,24,70,11,14,25
1,8481553,Bobby Brink,R,PHI,23,62,11,14,25
1,8483445,Cutter Gauthier,L,ANA,20,70,10,15,25
1,8475343,Nic Dowd,C,WSH,34,61,10,15,25
1,8477931,Tomas Nosek,L,FLA,32,62,9,16,25
1,8480871,Adam Boqvist,D,FLA,24,69,8,17,25
1,8483490,Pavel Mintyukov,D,ANA,21,69,5,20,25
1,8479976,Juuso Valimaki,D,UTA,26,57,5,20,25
1,8476885,Jacob Trouba,D,NYR,30,70,5,20,25
1,8475233,David Savard,D,MTL,34,61,4,21,25
1,8477353,Tyler Motte,C,DET,29,75,20,4,24
1,8480835,Jack Drury,C,CAR,24,52,15,9,24
1,8479066,Ryan Lomberg,L,CGY,30,65,14,10,24
1,8475855,Jesper Fast,R,CAR,33,63,13,11,24
1,8482155,Alex Laferriere,R,LAK,23,67,13,11,24
1,8477450,Jason Dickinson,C,CHI,29,59,12,12,24
1,8479414,Nathan Bastian,R,NJD,27,63,11,13,24
1,8477989,Christian Dvorak,C,MTL,28,60,10,14,24
1,8477919,Frederick Gaudreau,C,MIN,31,67,10,14,24
1,8478013,Jake Walman,D,SJS,28,74,10,14,24
1,8477015,Connor Brown,R,EDM,30,65,9,15,24
1,8479661,Tanner Jeannot,L,LAK,27,76,8,16,24
1,8475231,Casey Cizikas,C,NYI,33,70,8,16,24
1,8476902,Esa Lindell,D,DAL,30,70,7,17,24
1,8477021,Alex Kerfoot,C,UTA,30,76,6,18,24
1,8478911,Matt Roy,D,WSH,29,65,6,18,24
1,8482142,Jamie Drysdale,D,PHI,22,63,5,19,24
1,8479398,Samuel Girard,D,COL,26,61,4,20,24
1,8479371,Dante Fabbro,D,NSH,26,62,3,21,24
1,8477506,Ryan Pulock,D,NYI,30,78,1,23,24
1,8479393,Noah Gregor,L,OTT,26,69,16,7,23
1,8480068,Ryan Poehling,C,PHI,25,69,12,11,23
1,8481477,Nico Sturm,C,SJS,29,54,11,12,23
1,8483495,Simon Nemec,D,NJD,20,58,11,12,23
1,8479639,Dylan Coghlan,D,WPG,26,61,9,14,23
1,8484203,Bradly Nadeau,L,CAR,19,71,9,14,23
1,8475171,Oliver Ekman-Larsson,D,TOR,33,65,7,16,23
1,8477220,Nate Schmidt,D,FLA,33,72,4,19,23
1,8476891,Matthew Grzelcyk,D,PIT,30,68,4,19,23
1,8475690,Chris Tanev,D,TOR,35,63,4,19,23
1,8478859,Niko Mikkola,D,FLA,28,54,4,19,23
1,8478178,Darren Raddysh,D,TBL,28,75,3,20,23
1,8478500,Ivan Provorov,D,CBJ,27,82,2,21,23
1,8476278,Colin Blackwell,C,DAL,31,78,12,10,22
1,8478434,Keegan Kolesar,R,VGK,27,61,11,11,22
1,8483468,Jiri Kulich,C,BUF,20,54,10,12,22
1,8482749,Joshua Roy,R,MTL,21,65,10,12,22
1,8480289,Morgan Barron,C,WPG,26,60,10,12,22
1,8480003,Jesper Boqvist,C,FLA,26,67,8,14,22
1,8477979,Nicolas Aube-Kubel,R,BUF,28,58,8,14,22
1,8475225,Craig Smith,C,CHI,35,53,8,14,22
1,8476889,Radek Faksa,C,STL,30,56,8,14,22
1,8477369,Carson Soucy,D,VAN,30,60,6,16,22
1,8481019,David Gustafsson,C,WPG,24,54,5,17,22
1,8480073,Erik Brannstrom,D,COL,25,63,4,18,22
1,8474574,Tyler Myers,D,VAN,34,65,4,18,22
1,8473507,Jeff Petry,D,DET,37,74,3,19,22
1,8480891,Michael Kesselring,D,UTA,24,51,3,19,22
1,8479324,Ryan Lindgren,D,NYR,26,66,3,19,22
1,8480873,Rasmus Sandin,D,WSH,24,65,2,20,22
1,8480860,Kevin Bahl,D,CGY,24,57,2,20,22
1,8474151,Ryan McDonagh,D,TBL,35,72,1,21,22
1,8482111,Justin Barron,D,MTL,23,63,9,12,21
1,8481517,Brett Leason,R,ANA,25,61,9,12,21
1,8483491,Ivan Miroshnichenko,L,WSH,20,58,8,13,21
1,8483482,Tristan Luneau,D,ANA,20,60,8,13,21
1,8476429,Scott Mayfield,D,NYI,32,72,6,15,21
1,8475791,Taylor Hall,L,CHI,33,54,5,16,21
1,8477507,Nikita Zadorov,D,BOS,29,70,5,16,21
1,8476457,Adam Larsson,D,SEA,32,70,5,16,21
1,8481014,Alexander Romanov,D,NYI,24,77,4,17,21
1,8478851,Alexandre Carrier,D,NSH,28,65,2,19,21
1,8482067,Connor Mackey,D,NYR,28,59,11,9,20
1,8482125,Alexander Holtz,R,VGK,22,72,11,9,20
1,8479316,Luke Kunin,C,SJS,27,60,11,9,20
1,8481522,Peyton Krebs,C,BUF,23,64,10,10,20
1,8481704,Juuso Parssinen,C,NSH,23,60,10,10,20
1,8481656,Aliaksei Protas,C,WSH,23,66,8,12,20
1,8480336,Sean Walker,D,CAR,30,78,7,13,20
1,8478020,Michael Amadio,R,OTT,28,72,7,13,20
1,8479368,Max Jones,L,BOS,26,64,7,13,20
1,8476467,Jamie Oleksiak,D,SEA,32,68,6,14,20
1,8475181,Nick Leddy,D,STL,33,68,4,16,20
1,8479983,Mario Ferraro,D,SJS,26,71,4,16,20
1,8479980,Nicolas Hague,D,VGK,26,63,3,17,20
1,8483565,Nick Blankenburg,D,NSH,26,60,3,17,20
1,8476331,Dylan DeMelo,D,WPG,31,64,2,18,20
1,8481178,Egor Zamula,D,PHI,24,61,1,19,20
1,8483457,Lane Hutson,D,MTL,20,69,14,5,19
1,8477446,Michael McCarron,R,NSH,29,59,8,11,19
1,8480878,Nils Lundkvist,D,DAL,24,73,7,12,19
1,8481441,Joe Snively,C,DET,28,62,6,13,19
1,8481527,Kaedan Korczak,D,VGK,23,57,6,13,19
1,8478840,Will Borgen,D,SEA,28,63,6,13,19
1,8478416,Erik Cernak,D,TBL,27,76,6,13,19
1,8476921,Jordan Martinook,L,CAR,32,59,5,14,19
1,8480035,Henri Jokiharju,D,BUF,25,61,4,15,19
1,8475179,Dmitry Kulikov,D,FLA,34,61,4,15,19
1,8477435,Ryan Graves,D,PIT,29,75,4,15,19
1,8480049,Dylan Samberg,D,WPG,25,61,3,16,19
1,8480887,Jordan Harris,D,MTL,24,55,2,17,19
1,8481032,Paul Cotter,C,NJD,25,64,12,6,18
1,8476873,Mark Jankowski,C,NSH,30,56,11,7,18
1,8481716,Dmitri Voronkov,L,CBJ,24,46,11,7,18
1,8476960,Andreas Athanasiou,C,CHI,30,45,10,8,18
1,8476624,Barclay Goodrow,C,SJS,31,53,10,8,18
1,8478569,Noel Acciari,C,PIT,33,53,10,8,18
1,8476878,Zemgus Girgensons,C,TBL,30,82,9,9,18
1,8476918,Jimmy Vesey,L,NYR,31,65,8,10,18
1,8477903,Garnet Hathaway,R,PHI,33,61,8,10,18
1,8477478,William Carrier,L,CAR,30,57,7,11,18
1,8479718,Alex Barré-Boulet,C,MTL,27,51,7,11,18
1,8482803,Olen Zellweger,D,ANA,21,63,6,12,18
1,8481028,Martin Pospisil,C,CGY,25,53,6,12,18
1,8480043,Timothy Liljegren,D,TOR,25,60,5,13,18
1,8477845,Trevor van Riemsdyk,D,WSH,33,61,5,13,18
1,8481521,Ronnie Attard,D,PHI,25,50,5,13,18
1,8477018,Ben Hutton,D,VGK,31,46,4,14,18
1,8481059,Scott Perunovich,D,STL,26,60,3,15,18
1,8477969,Marcus Pettersson,D,PIT,28,79,2,16,18
1,8482077,Dylan Holloway,L,EDM,23,57,11,6,17
1,8477508,Curtis Lazar,C,NJD,29,63,9,8,17
1,8479619,Michael Carcone,L,UTA,28,60,9,8,17
1,8481624,Ilya Mikheyev,R,CHI,30,56,8,9,17
1,8483524,Shane Wright,C,SEA,20,60,7,10,17
1,8475188,Brayden McNabb,D,VGK,33,52,7,10,17
1,8478452,Caleb Jones,D,LAK,27,61,4,13,17
1,8482245,Artem Zub,D,OTT,29,67,4,13,17
1,8482087,Kaiden Guhle,D,MTL,22,66,3,14,17
1,8474673,TJ Brodie,D,CHI,34,67,2,15,17
1,8480246,Nick Perbix,D,TBL,26,72,1,16,17
1,8478421,A.J. Greer,L,FLA,28,61,9,7,16
1,8481013,Jonatan Berggren,R,DET,24,61,8,8,16
1,8480252,Cole Guttman,C,CHI,25,40,8,8,16
1,8482737,Zack Bolduc,C,STL,21,62,7,9,16
1,8480829,Jesperi Kotkaniemi,C,CAR,24,63,7,9,16
1,8473533,Jordan Staal,C,CAR,36,65,6,10,16
1,8480762,Eric Robinson,L,CAR,29,54,6,10,16
1,8479998,Mikey Anderson,D,LAK,25,65,6,10,16
1,8482095,Tyler Kleven,D,OTT,22,48,5,11,16
1,8482148,Hendrix Lapierre,C,WSH,22,57,5,11,16
1,8478399,Jonas Siegenthaler,D,NJD,27,58,5,11,16
1,8482157,Will Cuylle,L,NYR,22,64,5,11,16
1,8481789,Tye Kartye,L,SEA,23,41,5,11,16
1,8479372,Joshua Mahura,D,SEA,26,54,4,12,16
1,8483493,Frank Nazar,C,CHI,20,49,3,13,16
1,8480807,Mattias Samuelsson,D,BUF,24,57,3,13,16
1,8480727,Zach Whitecloud,D,VGK,28,50,2,14,16
1,8477365,Connor Clifton,D,BUF,29,55,1,15,16
1,8480893,Kirill Marchenko,R,CBJ,24,65,12,3,15
1,8480025,MacKenzie Entwistle,R,FLA,25,63,9,6,15
1,8480448,Parker Kelly,L,COL,25,77,8,7,15
1,8476934,Brock McGinn,L,ANA,30,49,8,7,15
1,8477406,Mattias Janmark,C,EDM,32,68,7,8,15
1,8480281,Alexey Toropchenko,R,STL,25,57,6,9,15
1,8482809,Jackson Blake,R,CAR,21,58,5,10,15
1,8482101,Danil Gushchin,L,SJS,22,47,4,11,15
1,8480021,Jack Studnicka,C,LAK,25,58,4,11,15
1,8476994,Vinnie Hinostroza,C,NSH,30,44,3,12,15
1,8475455,Brenden Dillon,D,NJD,34,63,3,12,15
1,8482192,Isaak Phillips,D,CHI,23,56,2,13,15
1,8476312,Josh Manson,D,COL,33,62,1,14,15
1,8470600,Ryan Suter,D,STL,39,64,0,15,15
1,8479336,Carl Grundstrom,R,SJS,27,47,10,4,14
1,8482807,Ethan Del Mastro,D,CHI,21,45,9,5,14
1,8476822,Luke Glendening,C,TBL,35,78,9,5,14
1,8484149,Gavin Brindley,C,CBJ,20,51,8,6,14
1,8476856,Mathew Dumba,D,DAL,30,67,8,6,14
1,8473453,Trevor Lewis,C,LAK,37,76,8,6,14
1,8479671,Mathieu Olivier,R,CBJ,27,43,6,8,14
1,8476374,Sean Kuraly,C,CBJ,31,57,6,8,14
1,8480950,Ilya Lyubushkin,D,DAL,30,63,5,9,14
1,8479968,Vinni Lettieri,C,BOS,29,50,5,9,14
1,8482859,Zack Ostapchuk,C,OTT,21,51,4,10,14
1,8474090,Brendan Smith,D,DAL,35,56,4,10,14
1,8480806,Isac Lundestrom,C,ANA,25,58,4,10,14
1,8476879,Cody Ceci,D,EDM,31,61,3,11,14
1,8480222,Sebastian Aho,D,PIT,28,73,2,12,14
1,8477499,Rasmus Ristolainen,D,PHI,30,57,2,12,14
1,8478443,Brandon Carlo,D,BOS,28,64,2,12,14
1,8475324,Nick Jensen,D,OTT,34,67,1,13,14
1,8480355,Mark Kastelic,C,BOS,25,55,8,5,13
1,8479520,Brandon Duhaime,R,WSH,27,48,7,6,13
1,8480074,Alexandre Texier,C,STL,25,55,6,7,13
1,8481617,Vasily Podkolzin,R,VAN,23,41,6,7,13
1,8476967,Brett Kulak,D,EDM,30,57,5,8,13
1,8479543,Michael Pezzetta,L,MTL,26,58,5,8,13
1,8478211,Dryden Hunt,L,CGY,29,50,5,8,13
1,8474034,Patrick Maroon,L,CHI,36,51,4,9,13
1,8480995,Pontus Holmberg,R,TOR,25,56,4,9,13
1,8479026,Philippe Myers,D,TOR,27,48,3,10,13
1,8482176,Wyatt Kaiser,D,CHI,22,50,3,10,13
1,8481599,Victor Soderstrom,D,UTA,23,49,3,10,13
1,8478585,Derek Ryan,C,EDM,38,65,3,10,13
1,8482451,Mikael Pyyhtia,L,CBJ,23,43,1,12,13
1,8475790,Erik Gudbranson,D,CBJ,32,78,1,12,13
1,8475279,Ben Chiarot,D,DET,33,68,1,12,13
1,8480172,Jan Rutta,D,SJS,34,58,0,13,13
1,8482784,Zach Dean,C,STL,21,38,9,3,12
1,8480157,Calle Rosen,D,COL,30,57,6,6,12
1,8476952,Dominic Toninato,C,WPG,30,31,6,6,12
1,8479536,Axel Jonsson-Fjallby,L,WPG,26,32,6,6,12
1,8475842,Sam Carrick,C,NYR,32,56,6,6,12
1,8479439,Jacob MacDonald,D,COL,31,49,5,7,12
1,8480192,Johnathan Kovacevic,D,NJD,27,52,5,7,12
1,8483499,Liam Ohgren,L,MIN,20,47,4,8,12
1,8481167,Brayden Pachal,D,CGY,25,41,4,8,12
1,8481537,Nikita Okhotiuk,D,CGY,24,47,4,8,12
1,8479370,Tyson Jost,C,CAR,26,48,4,8,12
1,8483466,Kevin Korchinski,D,CHI,20,49,4,8,12
1,8474013,Ian Cole,D,UTA,35,55,3,9,12
1,8479369,Andrew Peeke,D,BOS,26,67,2,10,12
1,8480796,Martin Fehervary,D,WSH,25,57,1,11,12
1,8473446,Erik Johnson,D,PHI,36,49,0,12,12
1,8474166,Alec Martinez,D,CHI,37,52,0,12,12
1,8480848,Ty Dellandrea,C,SJS,24,39,6,5,11
1,8479344,Jesse Puljujarvi,R,PIT,26,49,5,6,11
1,8477482,Zachary Sanford,L,CHI,30,38,4,7,11
1,8482652,Walker Duehr,R,CGY,27,40,4,7,11
1,8477380,Jonny Brodzinski,C,NYR,31,47,3,8,11
1,8480990,Declan Chisholm,D,MIN,24,35,3,8,11
1,8480058,Pierre-Olivier Joseph,D,STL,25,51,1,10,11
1,8475462,Radko Gudas,D,ANA,34,64,0,11,11
1,8478468,Jeremy Lauzon,D,NSH,27,57,0,11,11
1,8478831,Kevin Stenlund,C,UTA,28,50,8,2,10
1,8482659,Josh Doan,R,UTA,22,54,7,3,10
1,8480845,Rasmus Kupari,C,WPG,24,37,6,4,10
1,8482496,Nils Aman,C,VAN,24,49,6,4,10
1,8471709,Marc-Edouard Vlasic,D,SJS,37,61,5,5,10
1,8477392,Hudson Fasching,R,NYI,29,66,5,5,10
1,8482730,Brandt Clarke,D,LAK,21,48,5,5,10
1,8481147,Reese Johnson,C,MIN,26,49,5,5,10
1,8476858,Phillip Di Giuseppe,L,VAN,31,39,5,5,10
1,8480011,Klim Kostin,C,SJS,25,49,4,6,10
1,8480007,Jonas Rondbjerg,R,VGK,25,40,4,6,10
1,8481598,Philip Broberg,D,EDM,23,46,3,7,10
1,8480001,Urho Vaakanainen,D,ANA,25,55,3,7,10
1,8479772,Zack MacEwen,R,OTT,28,56,3,7,10
1,8482666,Scott Morrow,D,CAR,22,48,3,7,10
1,8481550,Adam Beckman,L,NJD,23,32,2,8,10
1,8478451,Ethan Bear,D,WSH,27,47,2,8,10
1,8482964,Arber Xhekaj,D,MTL,23,47,2,8,10
1,8479442,Troy Stecher,D,EDM,30,54,2,8,10
1,8480196,Jacob Bryson,D,BUF,27,43,1,9,10
1,8479378,Logan Stanley,D,WPG,26,43,1,9,10
1,8477851,Jordan Oesterle,D,BOS,32,41,1,9,10
1,8475177,Calvin de Haan,D,COL,33,47,1,9,10
1,8479249,Andrew Poturalski,C,SJS,30,35,0,10,10
1,8481567,Henry Thrun,D,SJS,23,52,0,10,10
1,8479972,Mason Shaw,C,WPG,26,41,5,4,9
1,8481532,Alex Turcotte,C,LAK,23,36,5,4,9
1,8479348,Kale Clague,D,BUF,26,36,4,5,9
1,8476988,Matt Benning,D,SJS,30,65,4,5,9
1,8482747,Brennan Othmann,L,NYR,21,42,4,5,9
1,8481641,Joel Kiviranta,L,COL,28,72,4,5,9
1,8471817,Ryan Reaves,R,TOR,37,57,4,5,9
1,8481751,Lukas Rousek,R,BUF,25,43,3,6,9
1,8482073,Braden Schneider,D,NYR,23,61,3,6,9
1,8478454,Noah Juulsen,D,VAN,27,36,3,6,9
1,8475762,Derek Forbort,D,VAN,32,53,3,6,9
1,8481518,Nolan Foote,L,NJD,24,36,3,6,9
1,8479291,Kevin Rooney,C,CGY,31,52,2,7,9
1,8481701,Santeri Hatakka,D,NJD,23,40,1,8,9
1,8474568,Luke Schenn,D,NSH,35,44,1,8,9
1,8476874,Olli Maatta,D,DET,30,64,0,9,9
1,8476442,Matt Nieto,L,PIT,32,36,7,1,8
1,8483763,Maksymilian Szuber,D,UTA,22,34,4,4,8
1,8481556,John Beecher,C,BOS,23,32,4,4,8
1,8480879,Jacob Bernard-Docker,D,OTT,24,52,3,5,8
1,8481592,Jakob Pelletier,L,CGY,23,38,3,5,8
1,8477938,Haydn Fleury,D,WPG,28,48,3,5,8
1,8484911,Collin Graf,R,SJS,22,41,3,5,8
1,8483012,Logan Morrison,C,SEA,22,39,3,5,8
1,8482861,Vincent Iorio,D,WSH,22,31,2,6,8
1,8481056,Spencer Stastney,D,NSH,24,33,2,6,8
1,8476441,Joel Edmundson,D,LAK,31,41,2,6,8
1,8479359,Beck Malenstyn,L,BUF,26,43,2,6,8
1,8481708,Zac Jones,D,NYR,24,50,1,7,8
1,8478017,Mark Friedman,D,VAN,29,36,1,7,8
1,8474612,Travis Hamonic,D,OTT,34,47,1,7,8
1,8477887,Patrick Brown,C,BOS,32,50,1,7,8
1,8477335,Kyle Burroughs,D,LAK,29,44,1,7,8
1,8482765,Isak Rosen,R,BUF,21,28,0,8,8
1,8477070,Liam O'Brien,C,UTA,30,56,6,1,7
1,8478409,Anthony Richard,C,PHI,28,29,5,2,7
1,8481754,Nikita Nesterenko,C,ANA,23,34,5,2,7
1,8479328,Julien Gauthier,R,NYI,27,59,4,3,7
1,8480890,Jan Jenik,C,OTT,24,32,4,3,7
1,8481609,Vladislav Kolyachonok,D,UTA,23,31,4,3,7
1,8482762,Simon Edvinsson,D,DET,21,49,4,3,7
1,8482070,Mitchell Chaffee,R,TBL,26,54,4,3,7
1,8482744,James Malatesta,L,CBJ,21,42,3,4,7
1,8477573,Nathan Walker,L,STL,30,48,3,4,7
1,8478874,Adam Gaudette,R,OTT,28,31,3,4,7
1,8479994,Jaret Anderson-Dolan,C,WPG,25,38,2,5,7
1,8478146,Matthew Highmore,C,OTT,28,29,2,5,7
1,8482177,Marat Khusnutdinov,C,MIN,22,37,2,5,7
1,8482634,Alex Steeves,C,TOR,25,43,1,6,7
1,8483460,David Jiricek,D,CBJ,21,51,1,6,7
1,8484254,Akito Hirose,D,VAN,25,37,1,6,7
1,8477462,Robert Hagg,D,VGK,29,22,1,6,7
1,8478021,William Lagesson,D,DET,28,26,1,6,7
1,8478450,Parker Wotherspoon,D,BOS,27,37,0,7,7
1,8476372,Nick Seeler,D,PHI,31,44,0,7,7
1,8474567,Zach Bogosian,D,MIN,34,64,0,7,7
1,8480441,Trey Fix-Wolansky,R,CBJ,25,29,4,2,6
1,8476867,Brendan Gaunce,C,MIN,30,42,4,2,6
1,8481679,Maxence Guenette,D,OTT,23,27,4,2,6
1,8475235,Nicolas Deslauriers,L,PHI,33,60,4,2,6
1,8475750,Jon Merrill,D,MIN,32,58,3,3,6
1,8481600,Tobias Bjornfot,D,FLA,23,31,3,3,6
1,8479379,Givani Smith,R,SJS,26,29,3,3,6
1,8479985,Cale Fleury,D,SEA,26,37,3,3,6
1,8481601,Simon Holmstrom,R,NYI,23,63,3,3,6
1,8479362,Riley Tufte,L,BOS,26,21,3,3,6
1,8477401,John Hayden,C,SEA,29,31,2,4,6
1,8477244,Chad Ruhwedel,D,NYR,34,33,2,4,6
1,8481543,Nikita Alexandrov,C,STL,24,24,2,4,6
1,8483630,Pavol Regenda,L,ANA,25,32,2,4,6
1,8480834,Ty Emberson,D,SJS,24,31,1,5,6
1,8482858,Ryker Evans,D,SEA,23,23,1,5,6
1,8479638,Justin Brazeau,R,BOS,26,36,1,5,6
1,8471677,Jack Johnson,D,CBJ,37,64,0,6,6
1,8481743,Marc Del Gaizo,D,NSH,25,26,0,6,6
1,8481122,Simon Benoit,D,TOR,26,41,0,6,6
1,8477962,Brendan Lemieux,L,CAR,28,36,4,1,5
1,8481161,Jake Christiansen,D,CBJ,25,59,4,1,5
1,8481043,Cole Koepke,L,BOS,26,21,4,1,5
1,8481206,John Ludvig,D,PIT,24,17,3,2,5
1,8479367,William Lockwood,R,FLA,26,24,3,2,5
1,8480292,Carson Meyer,R,ANA,27,36,2,3,5
1,8480245,Olle Lycksell,R,PHI,25,30,2,3,5
1,8482516,Matthew Kessel,D,STL,24,20,2,3,5
1,8482094,Daemon Hunt,D,MIN,22,25,2,3,5
1,8477467,Gustav Olofsson,D,SEA,30,20,2,3,5
1,8479944,Zach Aston-Reese,C,VGK,30,57,2,3,5
1,8483549,Lucas Condotta,L,MTL,27,29,1,4,5
1,8476913,Devin Shore,C,MIN,30,37,1,4,5
1,8481568,Alex Vlasic,D,CHI,23,53,1,4,5
1,8482751,Ryan Winterton,C,SEA,21,25,1,4,5
1,8482511,Mason Lohrei,D,BOS,23,31,1,4,5
1,8478051,Max Willman,C,NJD,29,19,1,4,5
1,8482713,Mackie Samoskevich,R,FLA,22,34,1,4,5
1,8475718,Justin Holl,D,DET,32,58,0,5,5
1,8478502,Dennis Gilbert,D,BUF,28,18,0,5,5
1,8479320,Maxime Lajoie,D,SEA,27,15,3,1,4
1,8480844,Grigori Denisenko,L,VGK,24,21,3,1,4
1,8478424,Jansen Harkins,C,ANA,27,42,2,2,4
1,8482166,Shakir Mukhamadullin,D,SJS,22,54,2,2,4
1,8482144,Jack Thompson,D,SJS,22,26,2,2,4
1,8482733,Logan Mailloux,D,MTL,31,32,2,2,4
1,8480870,Bo Groulx,C,NYR,24,27,2,2,4
1,8480070,Ian Mitchell,D,BOS,25,39,1,3,4
1,8479986,Kole Lind,R,DAL,26,48,1,3,4
1,8480880,Jakub Lauko,C,MIN,24,23,1,3,4
1,8478011,Louie Belpedio,D,PHI,28,19,1,3,4
1,8479991,Jake Leschyshyn,C,NYR,25,28,1,3,4
1,8481237,Kyle MacLean,C,NYI,25,24,1,3,4
1,8482145,Mavrik Bourque,C,DAL,22,54,1,3,4
1,8478477,Mitchell Stephens,C,SEA,27,21,0,4,4
1,8480032,Shane Bowers,C,NJD,25,21,0,4,4
1,8479981,Jonah Gadjovich,L,FLA,26,41,2,1,3
1,8482147,Jean-Luc Foudy,C,COL,22,23,2,1,3
1,8480084,Nick DeSimone,D,NJD,30,24,1,2,3
1,8477971,Andreas Englund,D,LAK,28,27,1,2,3
1,8482141,Lukas Cormier,D,VGK,22,26,1,2,3
1,8484287,Cole McWard,D,VAN,23,20,1,2,3
1,8482153,Brendan Brisson,C,VGK,23,29,1,2,3
1,8477473,Justin Bailey,R,SJS,29,24,1,2,3
1,8480267,Sammy Walker,C,MIN,25,21,1,2,3
1,8475958,Michael Sgarbossa,C,WSH,32,28,1,2,3
1,8475755,Alexander Petrovic,D,DAL,32,9,1,2,3
1,8483570,Ben Meyers,C,SEA,26,30,1,2,3
1,8479587,Rhett Gardner,C,PHI,28,21,0,3,3
1,8477034,Jaycob Megna,D,FLA,32,53,0,3,3
1,8482470,Ilya Solovyov,D,CGY,24,18,0,3,3
1,8474062,Riley Nash,C,NYR,35,22,0,3,3
1,8481006,Tyler Tucker,D,STL,24,18,2,0,2
1,8481806,Louis Crevier,D,CHI,23,12,2,0,2
1,8478881,Brett Seney,L,CHI,28,14,2,0,2
1,8483397,Marc McLaughlin,C,BOS,25,30,2,0,2
1,8481585,Egor Afanasyev,L,SJS,23,25,2,0,2
1,8475795,Dylan McIlrath,D,WSH,32,18,1,1,2
1,8477527,Ross Johnston,L,ANA,30,27,1,1,2
1,8483619,Filip Roos,D,OTT,25,36,1,1,2
1,8479419,Brett Murray,L,BUF,26,24,1,1,2
1,8481605,Jackson LaCombe,D,ANA,23,38,1,1,2
1,8482250,Callahan Burke,C,VGK,27,31,1,1,2
1,8482165,Yan Kuznetsov,D,CGY,22,19,1,1,2
1,8481593,Jayden Struble,D,MTL,23,25,1,1,2
1,8481030,Jack St. Ivany,D,PIT,25,20,1,1,2
1,8477541,Dakota Mermis,D,TOR,30,12,1,1,2
1,8483398,Declan Carlile,D,TBL,31,2,1,1,2
1,8475413,Justin Dowling,C,NJD,34,11,1,1,2
1,8481699,Aku Raty,R,UTA,23,22,1,1,2
1,8480851,Akil Thomas,C,LAK,24,15,1,1,2
1,8484325,Waltteri Merela,C,TBL,26,19,1,1,2
1,8482787,Nikita Chibrikov,R,WPG,31,8,1,1,2
1,8482201,Gage Goncalves,C,TBL,23,22,1,1,2
1,8482088,Justin Sourdif,R,FLA,22,23,1,1,2
1,8477073,Kurtis MacDermid,L,NJD,30,34,0,2,2
1,8477384,Joshua Brown,D,EDM,30,44,0,2,2
1,8481564,Ryan Johnson,D,BUF,23,14,0,2,2
1,8480874,Adam Ginning,D,PHI,24,8,0,2,2
1,8482162,Roby Jarventie,L,EDM,22,15,0,2,2
1,8478446,Glenn Gawdin,C,LAK,27,14,0,2,2
1,8476323,Max McCormick,L,SEA,32,6,1,0,1
1,8482929,Emil Lilleberg,D,TBL,23,15,1,0,1
1,8480306,Grant Hutton,D,NYI,29,6,1,0,1
1,8482172,Landon Slaggert,L,CHI,22,20,1,0,1
1,8481422,Jake Lucchini,C,NSH,29,23,1,0,1
1,8482460,Matt Rempe,C,NYR,22,16,1,0,1
1,8484259,Ondrej Pavel,C,COL,31,3,1,0,1
1,8475780,Chris Wagner,R,COL,33,5,1,0,1
1,8484255,Jason Polin,R,COL,25,8,1,0,1
1,8481578,Graeme Clarke,R,MIN,23,5,1,0,1
1,8483512,Matthew Savoie,C,EDM,20,19,0,1,1
1,8484258,Sam Malinski,D,COL,26,14,0,1,1
1,8479576,Vincent Desharnais,D,VAN,28,32,0,1,1
1,8477810,Joel Hanley,D,CGY,33,24,0,1,1
1,8476473,Connor Murphy,D,CHI,31,37,0,1,1
1,8481541,Samuel Bolduc,D,NYI,24,22,0,1,1
1,8481719,Maxwell Crozier,D,TBL,24,21,0,1,1
1,8479522,Hardy Haman Aktell,D,WSH,26,4,0,1,1
1,8483407,Brandon Scanlin,D,NYR,25,5,0,1,1
1,8484304,Uvis Balinskis,D,FLA,28,12,0,1,1
1,8479421,Jacob Moverare,D,LAK,26,5,0,1,1
1,8482197,Adam Raska,R,MIN,23,10,0,1,1
1,8483471,Brad Lambert,C,WPG,31,8,0,1,1
1,8483489,Fraser Minten,C,TOR,31,12,0,1,1
1,8483567,Georgii Merkulov,C,BOS,24,8,0,1,1
1,8481024,Linus Karlsson,C,VAN,25,8,0,1,1
1,8483395,Arshdeep Bains,L,VAN,23,11,0,1,1
1,8480468,James Hamblin,L,EDM,25,11,0,1,1
1,8470794,Joe Pavelski,C,,40,0,0,0,0
1,8479321,Lucas Johansen,D,,27,0,0,0,0
1,8477950,Tony DeAngelo,D,,29,0,0,0,0
1,8471218,Blake Wheeler,R,,38,0,0,0,0
1,8475197,Tyson Barrie,D,,33,0,0,0,0
1,8474157,Max Pacioretty,L,,36,0,0,0,0
1,8475744,Evgeny Kuznetsov,C,,32,0,0,0,0
1,8474037,James van Riemsdyk,L,,35,0,0,0,0
1,8476907,Mackenzie MacEachern,L,,30,0,0,0,0
1,8480216,Jacob Peterson,C,,25,0,0,0,0
1,8474602,Justin Schultz,D,,34,0,0,0,0
1,8482222,Alexander Barabanov,L,,30,0,0,0,0
1,8474031,Kevin Shattenkirk,D,,35,0,0,0,0
1,8477330,Dominik Kubalik,L,,29,0,0,0,0
1,8480884,Calen Addison,D,,24,0,0,0,0
1,8475906,John Klingberg,D,,32,0,0,0,0
1,8480008,Adam Ruzicka,C,,25,0,0,0,0
1,8476884,Derrick Pouliot,D,,30,0,0,0,0
1,8476919,Chris Tierney,C,,30,0,0,0,0
1,8479415,Michael McLeod,C,,26,0,0,0,0
1,8474870,Tyler Johnson,C,,34,0,0,0,0
1,8470604,Jeff Carter,C,,39,0,0,0,0
1,8478104,Sammy Blais,L,,28,0,0,0,0
1,8474884,Mike Hoffman,C,,35,0,0,0,0
1,8481591,Sam Poulin,R,,23,0,0,0,0
1,8471274,Alex Goligoski,D,,39,0,0,0,0
1,8476871,Tanner Pearson,L,,32,0,0,0,0
1,8476393,Nick Cousins,C,,31,0,0,0,0
1,8479977,Kailer Yamamoto,R,,26,0,0,0,0
1,8479346,Dillon Dube,C,,26,0,0,0,0
1,8480184,Gustav Lindstrom,D,,26,0,0,0,0
1,8479376,Victor Mete,D,,26,0,0,0,0
1,8473449,Kyle Okposo,R,,36,0,0,0,0
1,8481058,Jesse Ylonen,R,,25,0,0,0,0
1,8475752,Tyler Pitlick,C,,33,0,0,0,0
1,8481239,Samuel Fagemo,L,,24,0,0,0,0
1,8480821,Filip Zadina,R,,25,0,0,0,0
1,8470966,Mark Giordano,D,,41,0,0,0,0
1,8478495,Denis Gurianov,R,,27,0,0,0,0
1,8477464,Nic Petan,C,,29,0,0,0,0
1,8478099,Kevin Labanc,R,,29,0,0,0,0
1,8482241,Radim Zohorna,L,,28,0,0,0,0
1,8474040,Sam Gagner,C,,35,0,0,0,0
1,8479514,Rem Pitlick,C,,27,0,0,0,0
1,8478430,Oliver Kylington,D,,27,0,0,0,0
1,8479533,Joona Koppanen,L,,26,0,0,0,0
1,8479984,Cal Foote,D,,26,0,0,0,0
1,8477126,Jayson Megna,C,,34,0,0,0,0
1,8475164,Jakob Silfverberg,R,,34,0,0,0,0
1,8474009,Nick Bonino,C,,36,0,0,0,0
1,8479458,Nikita Zaitsev,D,,33,0,0,0,0
1,8477944,Jakub Vrana,L,,28,0,0,0,0
1,8471699,Andrew Cogliano,C,,37,0,0,0,0
1,8478067,Oskar Lindblom,L,,28,0,0,0,0
1,8471686,Marc Staal,D,,37,0,0,0,0
1,8470610,Zach Parise,L,,40,0,0,0,0
1,8478904,Steven Lorentz,C,,28,0,0,0,0
1,8473473,Milan Lucic,L,,36,0,0,0,0
1,8480031,Maxime Comtois,L,,25,0,0,0,0
1,8478512,Austin Czarnik,C,,32,0,0,0,0
1,8473504,Cal Clutterbuck,R,,37,0,0,0,0
1,8477454,Adam Erne,L,,29,0,0,0,0
1,8479383,Boris Katchouk,L,,26,0,0,0,0
1,8475825,Jani Hakanpää,D,,32,0,0,0,0
1,8477846,Ryan Carpenter,C,,33,0,0,0,0
1,8477930,Pierre-Edouard Bellemare,L,,39,0,0,0,0
1,8478400,Colin White,C,,27,0,0,0,0
1,8480226,Marián Studenic,R,,26,0,0,0,0
1,8480853,Liam Foudy,C,,24,0,0,0,0
1,8475797,Jarred Tinordi,D,,32,0,0,0,0
1,8479423,Alex Nylander,L,,26,0,0,0,0
1,8474618,Marco Scandella,D,,34,0,0,0,0
1,8477149,Scott Sabourin,R,SJS,32,16,0,0,0
1,8477320,Anton Blidh,L,NYR,29,12,0,0,0
1,8480823,Alexander Alexeyev,D,WSH,25,11,0,0,0
1,8478028,Fredrik Olofsson,L,,28,0,0,0,0
1,8474709,Matt Martin,L,,35,0,0,0,0
1,8481070,Hugh McGing,L,,26,0,0,0,0
1,8479546,Oskar Steen,C,,26,0,0,0,0
1,8474145,Robert Bortuzzo,D,,35,0,0,0,0
1,8480075,Cameron Crotty,D,MIN,25,4,0,0,0
1,8476915,Jujhar Khaira,L,,30,0,0,0,0
1,8480274,Philip Kemp,D,EDM,25,1,0,0,0
1,8483546,Marshall Rifai,D,TOR,26,4,0,0,0
1,8484326,Patrik Koch,D,UTA,28,2,0,0,0
1,8484321,Nikolas Matinpalo,D,OTT,26,0,0,0,0
1,8475278,Byron Froese,C,,33,0,0,0,0
1,8481812,Nikolai Knyzhov,D,,27,0,0,0,0
1,8478408,Travis Dermott,D,,28,0,0,0,0
1,8481077,John Leonard,L,,26,0,0,0,0
1,8479547,Matthew Phillips,R,,26,0,0,0,0
1,8482126,Emil Andrae,D,PHI,31,1,0,0,0
1,8480836,Jonathan Gruden,C,,24,0,0,0,0
1,8481655,Cole Schwindt,R,CGY,23,3,0,0,0
1,8481690,Tyler Angle,C,,24,0,0,0,0
1,8477993,Justin Kirkland,C,CGY,28,4,0,0,0
1,8482102,Vasily Ponomarev,C,PIT,22,20,0,0,0
1,8475766,Austin Watson,L,,32,0,0,0,0
1,8483597,Milos Kelemen,L,UTA,25,9,0,0,0
1,8478854,Ryan Shea,D,PIT,27,3,0,0,0
1,8481016,Ruslan Iskhakov,C,,24,0,0,0,0
1,8478078,Rourke Chartier,C,,28,0,0,0,0
1,8479330,Brandon Gignac,C,MTL,27,1,0,0,0
1,8483401,Marc Johnstone,R,PIT,28,2,0,0,0
1,8480776,Sheldon Rempal,R,,29,0,0,0,0
1,8482061,Brandon Biro,L,SEA,26,12,0,0,0
1,8478956,Samuel Laberge,L,NJD,27,2,0,0,0
1,8481726,Adam Edstrom,C,NYR,24,7,0,0,0
1,8483609,Adam Klapka,R,CGY,24,2,0,0,0
1,8483432,Luca Del Bel Belluz,C,CBJ,31,4,0,0,0
1,8483045,Cameron Butler,R,CBJ,31,1,0,0,0
1,8481534,Raphael Lavoie,C,EDM,24,2,0,0,0
1,8483920,Pierrick Dube,R,WSH,23,3,0,0,0
1,8478147,Bokondji Imama,L,PIT,28,1,0,0,0
1,8482476,Emil Heineman,L,MTL,23,7,0,0,0
1,8481462,Mason Morelli,L,VGK,28,11,0,0,0
1,8483531,Brian Halonen,L,NJD,25,4,0,0,0
1,8481065,Angus Crookshank,L,OTT,25,15,0,0,0
1,8482118,Sam Colangelo,R,ANA,23,14,0,0,0
1,8484314,Jiri Smejkal,L,,28,0,0,0,0
2,8477492,Nathan MacKinnon,C,COL,29,81,58,85,143
2,8479318,Auston Matthews,C,TOR,27,81,79,60,139
2,8478483,Mitch Marner,R,TOR,27,77,44,85,129
2,8477956,David Pastrnak,R,BOS,28,80,53,75,128
2,8474564,Steven Stamkos,C,NSH,34,77,54,67,121
2,8478402,Connor McDavid,C,EDM,27,76,29,90,119
2,8476453,Nikita Kucherov,R,TBL,31,82,34,83,117
2,8477934,Leon Draisaitl,C,EDM,29,78,44,71,115
2,8477939,William Nylander,R,TOR,28,79,52,57,109
2,8480027,Jason Robertson,L,DAL,25,82,41,68,109
2,8479314,Matthew Tkachuk,L,FLA,27,79,38,70,108
2,8476468,J.T. Miller,C,VAN,31,77,38,69,107
2,8478398,Kyle Connor,L,WPG,28,77,51,54,105
2,8478864,Kirill Kaprizov,L,MIN,27,66,40,64,104
2,8478420,Mikko Rantanen,R,COL,28,82,39,64,103
2,8471675,Sidney Crosby,C,PIT,37,73,37,60,97
2,8481559,Jack Hughes,C,NJD,23,74,36,60,96
2,8475692,Mats Zuccarello,R,MIN,37,76,28,67,95
2,8478550,Artemi Panarin,L,NYR,33,75,23,71,94
2,8477404,Jake Guentzel,C,TBL,30,82,38,55,93
2,8476887,Filip Forsberg,L,NSH,30,73,48,44,92
2,8471685,Anze Kopitar,C,LAK,37,82,21,71,92
2,8480800,Quinn Hughes,D,VAN,25,78,13,79,92
2,8475172,Nazem Kadri,C,CGY,34,77,35,56,91
2,8477933,Sam Reinhart,C,FLA,29,74,36,53,89
2,8478445,Mathew Barzal,C,NYI,27,80,21,68,89
2,8480069,Cale Makar,D,COL,26,69,20,69,89
2,8480012,Elias Pettersson,C,VAN,26,76,34,54,88
2,8480002,Nico Hischier,C,NJD,25,72,30,58,88
2,8478449,Roope Hintz,C,DAL,28,82,36,51,87
2,8482740,Wyatt Johnston,C,DAL,21,82,46,40,86
2,8475166,John Tavares,C,TOR,34,79,40,45,85
2,8477942,Kevin Fiala,L,LAK,28,82,31,54,85
2,8477493,Aleksander Barkov,C,FLA,29,79,34,50,84
2,8480018,Nick Suzuki,C,MTL,25,77,34,50,84
2,8480023,Robert Thomas,C,STL,25,73,27,57,84
2,8478403,Jack Eichel,C,VGK,28,78,47,36,83
2,8476881,Tomas Hertl,C,VGK,31,79,37,46,83
2,8475913,Mark Stone,R,VGK,32,78,34,49,83
2,8474600,Roman Josi,D,NSH,34,76,14,69,83
2,8476460,Mark Scheifele,C,WPG,31,71,32,50,82
2,8477501,Valeri Nichushkin,R,COL,29,81,43,38,81
2,8477946,Dylan Larkin,C,DET,28,81,35,46,81
2,8478439,Travis Konecny,R,PHI,27,75,28,53,81
2,8478493,Joel Eriksson Ek,C,MIN,27,75,41,39,80
2,8477951,Nick Schmaltz,C,UTA,28,77,29,51,80
2,8479407,Jesper Bratt,L,NJD,26,72,28,52,80
2,8480036,Miro Heiskanen,D,DAL,25,78,20,60,80
2,8478010,Brayden Point,C,TBL,28,82,38,41,79
2,8475754,Brock Nelson,C,NYI,33,82,38,41,79
2,8480830,Andrei Svechnikov,R,CAR,24,69,34,45,79
2,8482116,Tim Stützle,C,OTT,22,80,26,53,79
2,8478427,Sebastian Aho,C,CAR,27,71,30,47,77
2,8476454,Ryan Nugent-Hopkins,C,EDM,31,80,24,53,77
2,8471214,Alex Ovechkin,L,WSH,39,75,31,45,76
2,8478440,Dylan Strome,C,WSH,27,70,26,50,76
2,8476459,Mika Zibanejad,C,NYR,31,80,26,50,76
2,8477504,Josh Morrissey,D,WPG,29,74,15,60,75
2,8479323,Adam Fox,D,NYR,26,74,13,62,75
2,8477960,Adrian Kempe,R,LAK,28,79,31,43,74
2,8482665,Matty Beniers,C,SEA,22,75,28,46,74
2,8475168,Matt Duchene,C,DAL,33,82,28,46,74
2,8479385,Jordan Kyrou,C,STL,26,68,23,51,74
2,8476456,Jonathan Huberdeau,C,CGY,31,76,20,53,73
2,8475786,Zach Hyman,L,EDM,32,78,44,28,72
2,8476389,Vincent Trocheck,C,NYR,31,79,26,46,72
2,8475184,Chris Kreider,L,NYR,33,78,42,28,70
2,8475726,Tyler Toffoli,C,SJS,32,75,38,32,70
2,8477500,Bo Horvat,C,NYI,29,79,33,37,70
2,8480801,Brady Tkachuk,L,OTT,25,81,32,38,70
2,8477955,Jared McCann,L,SEA,28,72,31,39,70
2,8477496,Elias Lindholm,C,BOS,30,81,29,41,70
2,8477940,Nikolaj Ehlers,L,WPG,28,69,28,42,70
2,8473419,Brad Marchand,L,BOS,36,80,25,45,70
2,8475765,Vladimir Tarasenko,R,DET,33,78,19,51,70
2,8477402,Pavel Buchnevich,L,STL,29,71,30,39,69
2,8482124,Quinton Byfield,R,LAK,22,81,23,46,69
2,8478460,Zach Werenski,D,CBJ,27,80,19,50,69
2,8477964,Ivan Barbashev,C,VGK,29,79,22,46,68
2,8474679,Gustav Nyquist,C,NSH,35,74,15,53,68
2,8484144,Connor Bedard,C,CHI,19,64,19,48,67
2,8476346,Johnny Gaudreau,L,CBJ,31,74,19,47,66
2,8474141,Patrick Kane,R,DET,36,81,31,34,65
2,8477409,Carter Verhaeghe,C,FLA,29,74,28,37,65
2,8478401,Pavel Zacha,C,BOS,27,78,23,42,65
2,8478975,Mason Marchment,L,DAL,29,81,21,44,65
2,8481711,Matias Maccelli,L,UTA,24,77,19,46,65
2,8478414,Timo Meier,R,NJD,28,76,33,31,64
2,8476539,Jonathan Marchessault,R,NSH,34,73,32,32,64
2,8478873,Troy Terry,R,ANA,27,75,30,34,64
2,8471215,Evgeni Malkin,C,PIT,38,69,28,36,64
2,8481533,Trevor Zegras,C,ANA,23,72,23,41,64
2,8473512,Claude Giroux,R,OTT,36,80,22,42,64
2,8480865,Noah Dobson,D,NYI,24,80,15,49,64
2,8481540,Cole Caufield,R,MTL,23,76,29,34,63
2,8481557,Matt Boldy,L,MIN,23,69,24,39,63
2,8474590,John Carlson,D,WSH,34,66,15,48,63
2,8482109,Alexis Lafrenière,L,NYR,23,74,33,29,62
2,8480208,Drake Batherson,R,OTT,26,79,23,39,62
2,8473986,Alex Killorn,L,ANA,35,71,22,40,62
2,8476905,Chandler Stephenson,C,SEA,30,73,21,41,62
2,8482745,Mason McTavish,C,ANA,21,73,28,33,61
2,8479675,Trevor Moore,L,LAK,29,81,24,37,61
2,8475768,Jaden Schwartz,C,SEA,32,77,22,39,61
2,8478469,Thomas Chabot,D,OTT,27,80,15,46,61
2,8477476,Artturi Lehkonen,L,COL,29,80,30,30,60
2,8481068,Yegor Sharangovich,C,CGY,26,73,28,32,60
2,8479337,Alex DeBrincat,R,DET,27,80,27,33,60
2,8478444,Brock Boeser,R,VAN,27,72,25,35,60
2,8473994,Jamie Benn,L,DAL,35,81,21,39,60
2,8475798,Mikael Granlund,C,SJS,32,68,17,43,60
2,8479999,Casey Mittelstadt,C,COL,26,80,15,45,60
2,8475810,Bryan Rust,R,PIT,32,72,32,27,59
2,8482159,Tyson Foerster,R,PHI,22,74,31,28,59
2,8482093,Seth Jarvis,C,CAR,22,68,29,30,59
2,8479400,Pierre-Luc Dubois,L,WSH,26,74,28,31,59
2,8477511,Anthony Mantha,R,CGY,30,80,26,33,59
2,8477935,Sam Bennett,C,FLA,28,77,25,34,59
2,8476448,William Karlsson,C,VGK,31,75,23,36,59
2,8483515,Juraj Slafkovsky,L,MTL,20,75,22,37,59
2,8477503,Max Domi,C,TOR,29,77,15,44,59
2,8479420,Tage Thompson,C,BUF,27,74,34,24,58
2,8478047,Michael Bunting,L,PIT,29,74,27,31,58
2,8482078,Lucas Raymond,L,DET,22,82,26,32,58
2,8476399,Blake Coleman,C,CGY,33,77,25,33,58
2,8484153,Leo Carlsson,C,ANA,20,75,20,38,58
2,8476792,Torey Krug,D,STL,33,74,15,43,58
2,8479410,Mikhail Sergachev,D,UTA,26,72,14,44,58
2,8477447,Shea Theodore,D,VGK,29,61,13,45,58
2,8479325,Charlie McAvoy,D,BOS,27,79,7,51,58
2,8482702,Logan Stankoven,C,DAL,21,79,25,32,57
2,8477949,Alex Tuch,R,BUF,28,74,22,35,57
2,8477021,Alex Kerfoot,C,UTA,30,75,16,41,57
2,8476479,Phillip Danault,C,LAK,31,79,15,42,57
2,8477416,Oliver Bjorkstrand,R,SEA,29,73,24,32,56
2,8483431,Logan Cooley,C,UTA,20,77,22,34,56
2,8475784,Jeff Skinner,C,EDM,32,78,21,35,56
2,8476432,Boone Jenner,C,CBJ,31,70,31,24,55
2,8476880,Tom Wilson,R,WSH,30,70,31,24,55
2,8475169,Evander Kane,L,EDM,33,74,29,26,55
2,8475794,Tyler Seguin,C,DAL,32,82,26,29,55
2,8480803,Evan Bouchard,D,EDM,25,75,9,46,55
2,8478407,Vince Dunn,D,SEA,28,71,7,48,55
2,8482699,Dylan Guenther,R,UTA,21,76,27,27,54
2,8479343,Clayton Keller,R,UTA,26,77,23,31,54
2,8482113,Anton Lundell,C,FLA,23,80,23,31,54
2,8471698,T.J. Oshie,R,WSH,38,62,21,33,54
2,8475191,Reilly Smith,R,NYR,33,77,21,33,54
2,8476462,Dougie Hamilton,D,NJD,31,72,19,35,54
2,8476853,Morgan Rielly,D,TOR,30,73,12,42,54
2,8481577,Philip Tomasino,C,NSH,23,67,21,32,53
2,8477494,Jonathan Drouin,L,COL,29,80,7,45,52
2,8482684,Luke Hughes,D,NJD,21,77,7,45,52
2,8480014,Gabriel Vilardi,C,WPG,25,63,30,21,51
2,8480015,Owen Tippett,R,PHI,25,74,25,26,51
2,8475848,Brendan Gallagher,R,MTL,32,74,24,27,51
2,8481560,Arthur Kaliyev,R,LAK,23,81,23,28,51
2,8475170,Brayden Schenn,C,STL,33,71,21,30,51
2,8474578,Erik Karlsson,D,PIT,34,79,15,36,51
2,8476906,Shayne Gostisbehere,D,CAR,31,73,7,44,51
2,8477998,Warren Foegele,L,LAK,28,77,28,22,50
2,8474150,Mikael Backlund,C,CGY,35,77,22,28,50
2,8481554,Kaapo Kakko,R,NYR,23,70,21,29,50
2,8475158,Ryan O'Reilly,C,NSH,33,71,18,32,50
2,8476458,Ryan Strome,C,ANA,31,69,18,32,50
2,8483505,Matthew Poitras,C,BOS,20,77,14,36,50
2,8478498,Jake DeBrusk,L,VAN,28,77,31,18,49
2,8475799,Nino Niederreiter,R,WPG,32,72,24,25,49
2,8480188,Fabian Zetterlund,L,SJS,25,65,23,26,49
2,8480064,Josh Norris,C,OTT,25,74,22,27,49
2,8484166,Adam Fantilli,C,CBJ,20,71,16,33,49
2,8478038,Devon Toews,D,COL,30,77,14,35,49
2,8475167,Victor Hedman,D,TBL,34,78,10,39,49
2,8476875,Mike Matheson,D,MTL,30,74,9,40,49
2,8477986,Brandon Montour,D,SEA,30,71,15,33,48
2,8481542,Moritz Seider,D,DET,23,79,7,41,48
2,8476483,Rickard Rakell,R,PIT,31,73,26,21,47
2,8478519,Anthony Cirelli,C,TBL,27,81,21,26,47
2,8481618,Alex Newhook,C,MTL,23,73,19,28,47
2,8476826,Yanni Gourde,C,SEA,33,72,16,31,47
2,8479345,Jakob Chychrun,D,WSH,26,65,13,34,47
2,8471724,Kris Letang,D,PIT,37,80,9,38,47
2,8478055,Gustav Forsling,D,FLA,28,68,8,39,47
2,8478397,Rasmus Andersson,D,CGY,28,74,6,41,47
2,8475764,Cam Fowler,D,ANA,33,76,6,41,47
2,8476438,Brandon Saad,L,STL,32,69,27,19,46
2,8477456,J.T. Compher,L,DET,29,78,25,21,46
2,8478233,Andrew Mangiapane,L,WSH,28,69,22,24,46
2,8477451,Ryan Hartman,R,MIN,30,71,20,26,46
2,8478438,Tommy Novak,C,NSH,27,72,14,32,46
2,8482720,Matthew Knies,L,TOR,22,75,8,38,46
2,8475151,Kyle Palmieri,C,NYI,33,81,24,21,45
2,8480113,Alex Iafallo,L,WPG,31,67,21,24,45
2,8479542,Brandon Hagel,L,TBL,26,82,20,25,45
2,8481596,Shane Pinto,C,OTT,24,73,16,29,45
2,8481523,Kirby Dach,C,MTL,23,68,16,29,45
2,8481581,Thomas Harley,D,DAL,23,78,14,31,45
2,8470613,Brent Burns,D,CAR,39,79,10,35,45
2,8478020,Michael Amadio,R,OTT,28,69,25,19,44
2,8481535,Nils Hoglander,L,VAN,24,65,21,23,44
2,8474102,David Perron,L,OTT,36,78,20,24,44
2,8478466,Daniel Sprong,R,VAN,27,68,20,24,44
2,8478115,Pierre Engvall,L,NYI,28,77,18,26,44
2,8480028,Morgan Frost,C,PHI,25,75,13,31,44
2,8474053,Logan Couture,C,SJS,35,68,13,31,44
2,8477498,Darnell Nurse,D,EDM,29,73,11,33,44
2,8480039,Martin Necas,C,CAR,25,73,17,26,43
2,8477346,MacKenzie Weegar,D,CGY,30,74,13,30,43
2,8482667,William Eklund,L,SJS,22,65,13,30,43
2,8479987,Morgan Geekie,C,BOS,26,80,13,30,43
2,8480145,Neal Pionk,D,WPG,29,68,9,34,43
2,8479992,Michael Rasmussen,C,DET,25,78,22,20,42
2,8482110,Dawson Mercer,C,NJD,23,72,19,23,42
2,8478856,Conor Garland,R,VAN,28,76,16,26,42
2,8481528,Dylan Cozens,C,BUF,23,75,14,28,42
2,8478542,Evan Rodrigues,C,FLA,31,73,14,28,42
2,8478396,Noah Hanifin,D,VGK,27,65,11,31,42
2,8476854,Hampus Lindholm,D,BOS,30,73,11,31,42
2,8476979,Erik Gustafsson,D,DET,32,73,9,33,42
2,8477426,Nicholas Paul,L,TBL,29,81,26,15,41
2,8474641,Adam Henrique,C,EDM,34,75,16,25,41
2,8474586,Jordan Eberle,R,SEA,34,74,15,26,41
2,8479365,Trent Frederic,C,BOS,26,79,27,13,40
2,8479661,Tanner Jeannot,L,LAK,27,75,21,19,40
2,8475314,Anders Lee,L,NYI,34,77,20,20,40
2,8477450,Jason Dickinson,C,CHI,29,62,19,21,40
2,8477479,Tyler Bertuzzi,L,CHI,29,58,18,22,40
2,8483808,Andrei Kuzmenko,L,CGY,28,73,16,24,40
2,8477444,Andre Burakovsky,L,SEA,29,69,12,28,40
2,8482122,Brock Faber,D,MIN,22,78,10,30,40
2,8475753,Justin Faulk,D,STL,32,76,7,33,40
2,8479525,Ross Colton,C,COL,28,81,23,16,39
2,8478474,Lawson Crouse,L,UTA,27,74,18,21,39
2,8477429,Andrew Copp,C,DET,30,79,17,22,39
2,8479351,Sam Steel,C,DAL,26,80,17,22,39
2,8477497,Sean Monahan,C,CBJ,30,57,16,23,39
2,8477495,Seth Jones,D,CHI,30,72,12,27,39
2,8476869,Brady Skjei,D,NSH,30,70,9,30,39
2,8480839,Rasmus Dahlin,D,BUF,24,64,8,31,39
2,8479425,Filip Hronek,D,VAN,27,69,6,33,39
2,8477952,Robby Fabbri,C,ANA,28,72,20,18,38
2,8480797,Joel Farabee,L,PHI,24,75,18,20,38
2,8482092,Ridly Greig,C,OTT,22,79,18,20,38
2,8474189,Lars Eller,C,PIT,35,69,18,20,38
2,8476882,Teuvo Teravainen,C,CHI,30,67,13,25,38
2,8480434,Sean Durzi,D,UTA,26,71,11,27,38
2,8476958,Jaccob Slavin,D,CAR,30,72,5,33,38
2,8475793,Ryan Johansen,C,PHI,32,70,21,16,37
2,8479339,Patrik Laine,L,CBJ,26,69,15,22,37
2,8480009,Eeli Tolvanen,R,SEA,25,72,13,24,37
2,8480798,Philipp Kurashev,C,CHI,25,65,12,25,37
2,8477932,Aaron Ekblad,D,FLA,28,72,10,27,37
2,8481524,Bowen Byram,D,BUF,23,63,8,29,37
2,8482089,Jake Neighbours,L,STL,22,69,20,16,36
2,8480220,Noah Cates,L,PHI,25,69,18,18,36
2,8481604,Pavel Dorofeyev,L,VGK,24,71,17,19,36
2,8478046,Danton Heinen,L,VAN,29,71,16,20,36
2,8478463,Anthony Beauvillier,L,PIT,27,63,13,23,36
2,8478462,Nicolas Roy,C,VGK,27,77,12,24,36
2,8482149,Cole Perfetti,C,WPG,22,67,12,24,36
2,8482624,Daniil Miromanov,D,CGY,27,65,12,24,36
2,8475218,Mattias Ekholm,D,EDM,34,74,12,24,36
2,8482125,Alexander Holtz,R,VGK,22,70,20,15,35
2,8476981,Josh Anderson,R,MTL,30,68,17,18,35
2,8476278,Colin Blackwell,C,DAL,31,78,17,18,35
2,8475760,Nick Bjugstad,C,UTA,32,71,15,20,35
2,8477919,Frederick Gaudreau,C,MIN,31,64,14,21,35
2,8473422,Nick Foligno,L,CHI,37,64,13,22,35
2,8476927,Teddy Blueger,C,VAN,30,61,11,24,35
2,8477989,Christian Dvorak,C,MTL,28,68,11,24,35
2,8476885,Jacob Trouba,D,NYR,30,68,8,27,35
2,8474565,Alex Pietrangelo,D,VGK,34,66,6,29,35
2,8482097,Jack Quinn,R,BUF,23,71,20,14,34
2,8474715,Cameron Atkinson,R,TBL,35,78,18,16,34
2,8473533,Jordan Staal,C,CAR,36,67,18,16,34
2,8480078,Filip Chytil,C,NYR,25,66,17,17,34
2,8478042,Viktor Arvidsson,L,EDM,31,73,15,19,34
2,8475763,Kevin Hayes,R,PIT,32,66,14,20,34
2,8478133,Jake Evans,C,MTL,28,66,12,22,34
2,8477948,Travis Sanheim,D,PHI,28,68,6,28,34
2,8477407,Anthony Duclair,L,NYI,29,77,20,13,33
2,8481186,Logan O'Connor,R,COL,28,81,18,15,33
2,8478366,Frank Vatrano,R,ANA,30,71,17,16,33
2,8476419,Jean-Gabriel Pageau,C,NYI,32,79,13,20,33
2,8480829,Jesperi Kotkaniemi,C,CAR,24,64,13,20,33
2,8478458,John (Jack) Roslovic,C,CAR,27,61,9,24,33
2,8480871,Adam Boqvist,D,FLA,24,75,8,25,33
2,8475171,Oliver Ekman-Larsson,D,TOR,33,71,5,28,33
2,8476331,Dylan DeMelo,D,WPG,31,69,3,30,33
2,8475714,Calle Jarnkrok,C,TOR,33,75,19,13,32
2,8475287,Erik Haula,L,NJD,33,70,16,16,32
2,8476480,Vladislav Namestnikov,C,WPG,32,59,16,16,32
2,8475791,Taylor Hall,L,CHI,33,60,16,16,32
2,8482475,Yegor Chinakhov,R,CBJ,23,65,15,17,32
2,8480185,Eetu Luostarinen,C,FLA,26,79,15,17,32
2,8473563,Nicklas Backstrom,C,WSH,37,59,14,18,32
2,8476292,Ondrej Palat,L,NJD,33,71,12,20,32
2,8478413,Jordan Greenway,L,BUF,27,67,12,20,32
2,8476872,Scott Laughton,C,PHI,30,75,11,21,32
2,8476921,Jordan Martinook,L,CAR,32,66,9,23,32
2,8474563,Drew Doughty,D,LAK,35,68,8,24,32
2,8483490,Pavel Mintyukov,D,ANA,21,74,8,24,32
2,8482712,Oskar Olausson,R,COL,22,80,5,27,32
2,8480043,Timothy Liljegren,D,TOR,25,68,2,30,32
2,8481582,Nicholas Robertson,L,TOR,23,64,12,19,31
2,8482101,Danil Gushchin,L,SJS,22,60,12,19,31
2,8482671,Owen Power,D,BUF,22,65,11,20,31
2,8475745,Charlie Coyle,C,BOS,32,75,10,21,31
2,8480817,K'Andre Miller,D,NYR,24,70,9,22,31
2,8476923,Damon Severson,D,CBJ,30,82,7,24,31
2,8482705,Cole Sillinger,C,CBJ,21,63,17,13,30
2,8479390,Taylor Raddysh,R,WSH,26,61,15,15,30
2,8477839,Conor Sheary,L,TBL,32,80,15,15,30
2,8482146,Luke Evangelista,R,NSH,22,65,14,16,30
2,8480802,Ryan McLeod,C,BUF,25,67,14,16,30
2,8480144,David Kampf,C,TOR,29,73,13,17,30
2,8475343,Nic Dowd,C,WSH,34,61,13,17,30
2,8478891,Mason Appleton,C,WPG,28,61,12,18,30
2,8476925,Colton Sissons,C,NSH,31,62,12,18,30
2,8484145,Zach Benson,L,BUF,19,70,10,20,30
2,8477505,Alexander Wennberg,C,SJS,30,60,9,21,30
2,8482133,Thomas Bordeleau,C,SJS,22,57,8,22,30
2,8477507,Nikita Zadorov,D,BOS,29,70,8,22,30
2,8477425,Miles Wood,L,COL,29,78,16,13,29
2,8482175,JJ Peterka,R,BUF,22,66,15,14,29
2,8480849,Barrett Hayton,C,UTA,24,73,14,15,29
2,8480748,Kiefer Sherwood,L,VAN,29,66,14,15,29
2,8476392,Adam Lowry,C,WPG,31,64,14,15,29
2,8480855,Jack McBain,C,UTA,24,72,13,16,29
2,8482111,Justin Barron,D,MTL,23,73,13,16,29
2,8477947,Sonny Milano,L,WSH,28,66,10,19,29
2,8476917,Adam Pelech,D,NYI,30,78,7,22,29
2,8479983,Mario Ferraro,D,SJS,26,68,7,22,29
2,8476902,Esa Lindell,D,DAL,30,72,5,24,29
2,8480873,Rasmus Sandin,D,WSH,24,60,5,24,29
2,8476988,Matt Benning,D,SJS,30,62,5,24,29
2,8480459,Pius Suter,C,VAN,28,66,15,13,28
2,8476897,Oskar Sundqvist,C,STL,30,68,15,13,28
2,8475149,Marcus Johansson,L,MIN,34,68,15,13,28
2,8478472,Mathieu Joseph,R,STL,27,73,14,14,28
2,8482055,Drew O'Connor,L,PIT,26,68,14,14,28
2,8479591,Michael Eyssimont,C,TBL,28,82,11,17,28
2,8482142,Jamie Drysdale,D,PHI,22,65,7,21,28
2,8476461,Sean Couturier,C,PHI,32,66,6,22,28
2,8482655,Janis Moser,D,TBL,24,78,1,27,28
2,8480003,Jesper Boqvist,C,FLA,26,68,15,12,27
2,8479316,Luke Kunin,C,SJS,27,58,15,12,27
2,8480336,Sean Walker,D,CAR,30,76,12,15,27
2,8476474,Stefan Noesen,R,NJD,31,73,11,16,27
2,8474716,Jared Spurgeon,D,MIN,35,74,6,21,27
2,8481546,Cam York,D,PHI,23,71,6,21,27
2,8476892,Colton Parayko,D,STL,31,72,6,21,27
2,8476463,Jonas Brodin,D,MIN,31,79,5,22,27
2,8476931,Jake McCabe,D,TOR,31,69,4,23,27
2,8479398,Samuel Girard,D,COL,26,63,4,23,27
2,8479639,Dylan Coghlan,D,WPG,26,67,3,24,27
2,8470621,Corey Perry,R,EDM,39,68,16,10,26
2,8477446,Michael McCarron,R,NSH,29,63,15,11,26
2,8482259,Bobby McMann,C,TOR,28,61,14,12,26
2,8479353,Brett Howden,C,VGK,26,67,10,16,26
2,8476469,Joel Armia,R,MTL,31,65,10,16,26
2,8474149,Evgenii Dadonov,R,DAL,35,80,8,18,26
2,8480011,Klim Kostin,C,SJS,25,49,7,19,26
2,8477969,Marcus Pettersson,D,PIT,28,76,1,25,26
2,8476873,Mark Jankowski,C,NSH,30,54,15,10,25
2,8484203,Bradly Nadeau,L,CAR,19,59,13,12,25
2,8477987,Ryan Donato,C,CHI,28,55,11,14,25
2,8480835,Jack Drury,C,CAR,24,59,10,15,25
2,8481704,Juuso Parssinen,C,NSH,23,50,9,16,25
2,8482079,Marco Rossi,C,MIN,23,58,8,17,25
2,8478970,Jalen Chatfield,D,CAR,28,73,8,17,25
2,8481656,Aliaksei Protas,C,WSH,23,65,7,18,25
2,8478851,Alexandre Carrier,D,NSH,28,64,6,19,25
2,8476856,Mathew Dumba,D,DAL,30,74,5,20,25
2,8479402,Jake Bean,D,CGY,26,72,2,23,25
2,8479371,Dante Fabbro,D,NSH,26,67,2,23,25
2,8478507,John Marino,D,UTA,27,69,1,24,25
2,8473507,Jeff Petry,D,DET,37,71,1,24,25
2,8481641,Joel Kiviranta,L,COL,28,73,14,10,24
2,8479996,Cody Glass,C,NSH,25,63,13,11,24
2,8480068,Ryan Poehling,C,PHI,25,70,12,12,24
2,8482679,Matt Coronato,R,CGY,22,68,11,13,24
2,8477478,William Carrier,L,CAR,30,55,11,13,24
2,8482809,Jackson Blake,R,CAR,21,54,11,13,24
2,8478057,Dakota Joshua,C,VAN,28,64,9,15,24
2,8483445,Cutter Gauthier,L,ANA,20,58,9,15,24
2,8482245,Artem Zub,D,OTT,29,71,4,20,24
2,8478882,Vladislav Gavrikov,D,LAK,29,66,3,21,24
2,8480893,Kirill Marchenko,R,CBJ,24,61,15,8,23
2,8477953,Kasperi Kapanen,R,STL,28,65,12,11,23
2,8480980,Connor Dewar,C,TOR,25,70,12,11,23
2,8475842,Sam Carrick,C,NYR,32,69,12,11,23
2,8478434,Keegan Kolesar,R,VGK,27,63,11,12,23
2,8478013,Jake Walman,D,SJS,28,70,10,13,23
2,8476960,Andreas Athanasiou,C,CHI,30,55,10,13,23
2,8481580,Connor McMichael,C,WSH,23,60,9,14,23
2,8482067,Connor Mackey,D,NYR,28,63,9,14,23
2,8482105,Jake Sanderson,D,OTT,22,71,8,15,23
2,8479026,Philippe Myers,D,TOR,27,51,7,16,23
2,8475324,Nick Jensen,D,OTT,34,60,4,19,23
2,8477220,Nate Schmidt,D,FLA,33,66,3,20,23
2,8477499,Rasmus Ristolainen,D,PHI,30,61,3,20,23
2,8479941,Justin Danforth,R,CBJ,31,60,14,8,22
2,8482155,Alex Laferriere,R,LAK,23,73,13,9,22
2,8483524,Shane Wright,C,SEA,20,56,13,9,22
2,8479293,Brandon Tanev,L,SEA,33,66,12,10,22
2,8481624,Ilya Mikheyev,R,CHI,30,52,12,10,22
2,8479368,Max Jones,L,BOS,26,57,11,11,22
2,8483499,Liam Ohgren,L,MIN,20,54,11,11,22
2,8482117,Lukas Reichel,L,CHI,22,62,10,12,22
2,8478109,Victor Olofsson,L,VGK,29,67,10,12,22
2,8477406,Mattias Janmark,C,EDM,32,59,9,13,22
2,8483482,Tristan Luneau,D,ANA,20,71,8,14,22
2,8481703,Valtteri Puustinen,R,PIT,25,62,6,16,22
2,8482660,Kent Johnson,C,CBJ,22,57,6,16,22
2,8482095,Tyler Kleven,D,OTT,22,54,6,16,22
2,8481014,Alexander Romanov,D,NYI,24,79,5,17,22
2,8479980,Nicolas Hague,D,VGK,26,52,5,17,22
2,8481599,Victor Soderstrom,D,UTA,23,43,5,17,22
2,8476422,Mike Reilly,D,NYI,31,70,4,18,22
2,8477845,Trevor van Riemsdyk,D,WSH,33,63,4,18,22
2,8482074,Connor Zary,C,CGY,23,60,12,9,21
2,8480205,Emil Bemstrom,C,PIT,25,58,11,10,21
2,8475855,Jesper Fast,R,CAR,33,63,11,10,21
2,8480289,Morgan Barron,C,WPG,26,62,11,10,21
2,8481553,Bobby Brink,R,PHI,23,67,10,11,21
2,8477015,Connor Brown,R,EDM,30,63,10,11,21
2,8480448,Parker Kelly,L,COL,25,71,10,11,21
2,8476878,Zemgus Girgensons,C,TBL,30,81,9,12,21
2,8476624,Barclay Goodrow,C,SJS,31,49,8,13,21
2,8480355,Mark Kastelic,C,BOS,25,59,8,13,21
2,8481617,Vasily Podkolzin,R,VAN,23,52,8,13,21
2,8474574,Tyler Myers,D,VAN,34,77,7,14,21
2,8480074,Alexandre Texier,C,STL,25,56,7,14,21
2,8481441,Joe Snively,C,DET,28,71,6,15,21
2,8481019,David Gustafsson,C,WPG,24,48,5,16,21
2,8478500,Ivan Provorov,D,CBJ,27,82,4,17,21
2,8477506,Ryan Pulock,D,NYI,30,79,2,19,21
2,8475233,David Savard,D,MTL,34,66,1,20,21
2,8478911,Matt Roy,D,WSH,29,64,11,9,20
2,8476329,Travis Boyd,C,MIN,31,53,10,10,20
2,8475220,Marcus Foligno,L,MIN,33,61,8,12,20
2,8480789,Oliver Wahlstrom,R,NYI,24,67,8,12,20
2,8482803,Olen Zellweger,D,ANA,21,67,8,12,20
2,8475193,Tomas Tatar,L,NJD,34,65,7,13,20
2,8475231,Casey Cizikas,C,NYI,33,72,7,13,20
2,8479619,Michael Carcone,L,UTA,28,64,7,13,20
2,8476994,Vinnie Hinostroza,C,NSH,30,47,7,13,20
2,8477380,Jonny Brodzinski,C,NYR,31,51,7,13,20
2,8477488,Brett Pesce,D,NJD,30,67,5,15,20
2,8483457,Lane Hutson,D,MTL,20,63,4,16,20
2,8481481,Blake Lizotte,C,PIT,27,63,3,17,20
2,8480860,Kevin Bahl,D,CGY,24,55,2,18,20
2,8482073,Braden Schneider,D,NYR,23,71,2,18,20
2,8475690,Chris Tanev,D,TOR,35,51,1,19,20
2,8478211,Dryden Hunt,L,CGY,29,55,13,6,19
2,8475722,Jason Zucker,L,BUF,32,61,10,9,19
2,8482062,Cole Smith,L,NSH,29,56,10,9,19
2,8481093,Rafael Harvey-Pinard,L,MTL,25,61,8,11,19
2,8483491,Ivan Miroshnichenko,L,WSH,20,49,8,11,19
2,8479439,Jacob MacDonald,D,COL,31,52,8,11,19
2,8476457,Adam Larsson,D,SEA,32,69,7,12,19
2,8482749,Joshua Roy,R,MTL,21,63,6,13,19
2,8481606,Jordan Spence,D,LAK,23,58,5,14,19
2,8482737,Zack Bolduc,C,STL,21,59,5,14,19
2,8478136,Jake Middleton,D,MIN,28,71,4,15,19
2,8477353,Tyler Motte,C,DET,29,69,4,15,19
2,8474151,Ryan McDonagh,D,TBL,35,76,4,15,19
2,8475279,Ben Chiarot,D,DET,33,66,3,16,19
2,8478416,Erik Cernak,D,TBL,27,76,2,17,19
2,8482659,Josh Doan,R,UTA,22,48,13,5,18
2,8477573,Nathan Walker,L,STL,30,58,11,7,18
2,8478043,Sam Lafferty,C,BUF,29,57,9,9,18
2,8479393,Noah Gregor,L,OTT,26,72,8,10,18
2,8481521,Ronnie Attard,D,PHI,25,51,7,11,18
2,8476891,Matthew Grzelcyk,D,PIT,30,75,5,13,18
2,8480073,Erik Brannstrom,D,COL,25,61,4,14,18
2,8479324,Ryan Lindgren,D,NYR,26,63,4,14,18
2,8480035,Henri Jokiharju,D,BUF,25,63,3,15,18
2,8482087,Kaiden Guhle,D,MTL,22,71,2,16,18
2,8480281,Alexey Toropchenko,R,STL,25,60,11,6,17
2,8482652,Walker Duehr,R,CGY,27,45,10,7,17
2,8480813,Joe Veleno,C,DET,24,73,9,8,17
2,8480762,Eric Robinson,L,CAR,29,56,8,9,17
2,8482730,Brandt Clarke,D,LAK,21,51,8,9,17
2,8481751,Lukas Rousek,R,BUF,25,37,8,9,17
2,8479315,Joey Anderson,R,CHI,26,46,5,12,17
2,8481522,Peyton Krebs,C,BUF,23,61,5,12,17
2,8481161,Jake Christiansen,D,CBJ,25,54,5,12,17
2,8484149,Gavin Brindley,C,CBJ,20,43,4,13,17
2,8479976,Juuso Valimaki,D,UTA,26,62,3,14,17
2,8479998,Mikey Anderson,D,LAK,25,63,3,14,17
2,8478468,Jeremy Lauzon,D,NSH,27,54,3,14,17
2,8475181,Nick Leddy,D,STL,33,63,2,15,17
2,8477435,Ryan Graves,D,PIT,29,68,1,16,17
2,8478432,Christian Fischer,R,DET,27,76,9,7,16
2,8477903,Garnet Hathaway,R,PHI,33,70,9,7,16
2,8480806,Isac Lundestrom,C,ANA,25,51,9,7,16
2,8480252,Cole Guttman,C,CHI,25,42,8,8,16
2,8480025,MacKenzie Entwistle,R,FLA,25,57,8,8,16
2,8479414,Nathan Bastian,R,NJD,27,67,7,9,16
2,8481517,Brett Leason,R,ANA,25,52,7,9,16
2,8475225,Craig Smith,C,CHI,35,53,6,10,16
2,8476467,Jamie Oleksiak,D,SEA,32,63,4,12,16
2,8482148,Hendrix Lapierre,C,WSH,22,56,4,12,16
2,8476525,Colin Miller,D,WPG,32,59,3,13,16
2,8483493,Frank Nazar,C,CHI,20,47,3,13,16
2,8480796,Martin Fehervary,D,WSH,25,52,3,13,16
2,8476429,Scott Mayfield,D,NYI,32,74,2,14,16
2,8481178,Egor Zamula,D,PHI,24,57,2,14,16
2,8478443,Brandon Carlo,D,BOS,28,55,2,14,16
2,8480049,Dylan Samberg,D,WPG,25,67,1,15,16
2,8481059,Scott Perunovich,D,STL,26,59,1,15,16
2,8475790,Erik Gudbranson,D,CBJ,32,71,1,15,16
2,8481032,Paul Cotter,C,NJD,25,49,13,2,15
2,8479066,Ryan Lomberg,L,CGY,30,66,8,7,15
2,8476918,Jimmy Vesey,L,NYR,31,60,8,7,15
2,8478421,A.J. Greer,L,FLA,28,59,7,8,15
2,8479370,Tyson Jost,C,CAR,26,58,7,8,15
2,8482859,Zack Ostapchuk,C,OTT,21,55,6,9,15
2,8480995,Pontus Holmberg,R,TOR,25,63,6,9,15
2,8480887,Jordan Harris,D,MTL,24,58,5,10,15
2,8482451,Mikael Pyyhtia,L,CBJ,23,47,5,10,15
2,8483565,Nick Blankenburg,D,NSH,26,57,4,11,15
2,8475179,Dmitry Kulikov,D,FLA,34,58,4,11,15
2,8475208,Brian Dumoulin,D,ANA,33,66,2,13,15
2,8478178,Darren Raddysh,D,TBL,28,65,2,13,15
2,8477931,Tomas Nosek,L,FLA,32,63,9,5,14
2,8479520,Brandon Duhaime,R,WSH,27,57,7,7,14
2,8479291,Kevin Rooney,C,CGY,31,44,7,7,14
2,8475200,Dmitry Orlov,D,CAR,33,78,6,8,14
2,8483495,Simon Nemec,D,NJD,20,57,6,8,14
2,8479671,Mathieu Olivier,R,CBJ,27,49,6,8,14
2,8479968,Vinni Lettieri,C,BOS,29,49,6,8,14
2,8480880,Jakub Lauko,C,MIN,24,38,6,8,14
2,8480878,Nils Lundkvist,D,DAL,24,68,5,9,14
2,8480021,Jack Studnicka,C,LAK,25,57,5,9,14
2,8482807,Ethan Del Mastro,D,CHI,21,45,5,9,14
2,8481708,Zac Jones,D,NYR,24,44,5,9,14
2,8478859,Niko Mikkola,D,FLA,28,56,4,10,14
2,8476312,Josh Manson,D,COL,33,57,4,10,14
2,8478451,Ethan Bear,D,WSH,27,48,4,10,14
2,8482634,Alex Steeves,C,TOR,25,53,4,10,14
2,8479982,Conor Timmins,D,TOR,26,54,3,11,14
2,8474673,TJ Brodie,D,CHI,34,60,3,11,14
2,8480157,Calle Rosen,D,COL,30,43,3,11,14
2,8479369,Andrew Peeke,D,BOS,26,56,3,11,14
2,8480001,Urho Vaakanainen,D,ANA,25,52,3,11,14
2,8479972,Mason Shaw,C,WPG,26,43,2,12,14
2,8479359,Beck Malenstyn,L,BUF,26,43,2,12,14
2,8475718,Justin Holl,D,DET,32,64,2,12,14
2,8480891,Michael Kesselring,D,UTA,24,57,1,13,14
2,8479372,Joshua Mahura,D,SEA,26,48,1,13,14
2,8475455,Brenden Dillon,D,NJD,34,60,1,13,14
2,8476879,Cody Ceci,D,EDM,31,68,1,13,14
2,8473453,Trevor Lewis,C,LAK,37,71,10,3,13
2,8479336,Carl Grundstrom,R,SJS,27,54,8,5,13
2,8477482,Zachary Sanford,L,CHI,30,39,7,6,13
2,8477938,Haydn Fleury,D,WPG,28,49,7,6,13
2,8477070,Liam O'Brien,C,UTA,30,44,6,7,13
2,8482166,Shakir Mukhamadullin,D,SJS,22,58,6,7,13
2,8478508,Yakov Trenin,C,MIN,27,58,4,9,13
2,8477369,Carson Soucy,D,VAN,30,56,4,9,13
2,8477018,Ben Hutton,D,VGK,31,49,4,9,13
2,8477508,Curtis Lazar,C,NJD,29,60,4,9,13
2,8480845,Rasmus Kupari,C,WPG,24,46,4,9,13
2,8482666,Scott Morrow,D,CAR,22,41,4,9,13
2,8482157,Will Cuylle,L,NYR,22,54,3,10,13
2,8478840,Will Borgen,D,SEA,28,64,2,11,13
2,8480727,Zach Whitecloud,D,VGK,28,52,2,11,13
2,8483460,David Jiricek,D,CBJ,21,57,2,11,13
2,8481568,Alex Vlasic,D,CHI,23,52,2,11,13
2,8474090,Brendan Smith,D,DAL,35,54,1,12,13
2,8476874,Olli Maatta,D,DET,30,58,1,12,13
2,8479944,Zach Aston-Reese,C,VGK,30,54,8,4,12
2,8479718,Alex Barré-Boulet,C,MTL,27,50,7,5,12
2,8482077,Dylan Holloway,L,EDM,23,59,6,6,12
2,8478585,Derek Ryan,C,EDM,38,68,5,7,12
2,8482784,Zach Dean,C,STL,21,40,5,7,12
2,8482496,Nils Aman,C,VAN,24,31,5,7,12
2,8481518,Nolan Foote,L,NJD,24,33,5,7,12
2,8477401,John Hayden,C,SEA,29,30,5,7,12
2,8481527,Kaedan Korczak,D,VGK,23,49,4,8,12
2,8478452,Caleb Jones,D,LAK,27,59,3,9,12
2,8481537,Nikita Okhotiuk,D,CGY,24,48,3,9,12
2,8482744,James Malatesta,L,CBJ,21,45,3,9,12
2,8482176,Wyatt Kaiser,D,CHI,22,55,2,10,12
2,8482964,Arber Xhekaj,D,MTL,23,41,2,10,12
2,8481600,Tobias Bjornfot,D,FLA,23,41,2,10,12
2,8478399,Jonas Siegenthaler,D,NJD,27,56,1,11,12
2,8480007,Jonas Rondbjerg,R,VGK,25,43,1,11,12
2,8474567,Zach Bogosian,D,MIN,34,69,1,11,12
2,8480441,Trey Fix-Wolansky,R,CBJ,25,41,8,3,11
2,8476889,Radek Faksa,C,STL,30,59,7,4,11
2,8479328,Julien Gauthier,R,NYI,27,59,7,4,11
2,8482751,Ryan Winterton,C,SEA,21,38,7,4,11
2,8474034,Patrick Maroon,L,CHI,36,49,6,5,11
2,8484911,Collin Graf,R,SJS,22,40,6,5,11
2,8479986,Kole Lind,R,DAL,26,54,6,5,11
2,8481477,Nico Sturm,C,SJS,29,46,5,6,11
2,8481532,Alex Turcotte,C,LAK,23,43,5,6,11
2,8482747,Brennan Othmann,L,NYR,21,42,5,6,11
2,8480172,Jan Rutta,D,SJS,34,64,4,7,11
2,8480196,Jacob Bryson,D,BUF,27,48,4,7,11
2,8476442,Matt Nieto,L,PIT,32,49,4,7,11
2,8480222,Sebastian Aho,D,PIT,28,78,3,8,11
2,8479344,Jesse Puljujarvi,R,PIT,26,48,3,8,11
2,8481028,Martin Pospisil,C,CGY,25,54,2,9,11
2,8480807,Mattias Samuelsson,D,BUF,24,57,2,9,11
2,8477335,Kyle Burroughs,D,LAK,29,47,2,9,11
2,8474568,Luke Schenn,D,NSH,35,49,1,10,11
2,8476374,Sean Kuraly,C,CBJ,31,61,8,2,10
2,8476822,Luke Glendening,C,TBL,35,79,7,3,10
2,8478831,Kevin Stenlund,C,UTA,28,56,7,3,10
2,8477979,Nicolas Aube-Kubel,R,BUF,28,57,6,4,10
2,8482762,Simon Edvinsson,D,DET,21,52,6,4,10
2,8477392,Hudson Fasching,R,NYI,29,65,5,5,10
2,8482070,Mitchell Chaffee,R,TBL,26,53,5,5,10
2,8476934,Brock McGinn,L,ANA,30,55,4,6,10
2,8475762,Derek Forbort,D,VAN,32,42,4,6,10
2,8484254,Akito Hirose,D,VAN,25,35,4,6,10
2,8483466,Kevin Korchinski,D,CHI,20,49,3,7,10
2,8481550,Adam Beckman,L,NJD,23,52,3,7,10
2,8480879,Jacob Bernard-Docker,D,OTT,24,43,3,7,10
2,8482733,Logan Mailloux,D,MTL,31,28,3,7,10
2,8483468,Jiri Kulich,C,BUF,20,61,2,8,10
2,8482192,Isaak Phillips,D,CHI,23,47,2,8,10
2,8474166,Alec Martinez,D,CHI,37,49,2,8,10
2,8475462,Radko Gudas,D,ANA,34,62,2,8,10
2,8475188,Brayden McNabb,D,VGK,33,49,1,9,10
2,8471709,Marc-Edouard Vlasic,D,SJS,37,61,1,9,10
2,8480246,Nick Perbix,D,TBL,26,71,0,10,10
2,8480848,Ty Dellandrea,C,SJS,24,46,6,3,9
2,8481013,Jonatan Berggren,R,DET,24,58,5,4,9
2,8479543,Michael Pezzetta,L,MTL,26,54,5,4,9
2,8480990,Declan Chisholm,D,MIN,24,34,5,4,9
2,8476858,Phillip Di Giuseppe,L,VAN,31,40,5,4,9
2,8477887,Patrick Brown,C,BOS,32,47,5,4,9
2,8481601,Simon Holmstrom,R,NYI,23,65,4,5,9
2,8478569,Noel Acciari,C,PIT,33,52,3,6,9
2,8481167,Brayden Pachal,D,CGY,25,42,3,6,9
2,8478017,Mark Friedman,D,VAN,29,36,3,6,9
2,8480834,Ty Emberson,D,SJS,24,33,3,6,9
2,8477034,Jaycob Megna,D,FLA,32,43,3,6,9
2,8481147,Reese Johnson,C,MIN,26,39,2,7,9
2,8479378,Logan Stanley,D,WPG,26,39,2,7,9
2,8481567,Henry Thrun,D,SJS,23,51,2,7,9
2,8477462,Robert Hagg,D,VGK,29,27,2,7,9
2,8480950,Ilya Lyubushkin,D,DAL,30,60,1,8,9
2,8480058,Pierre-Olivier Joseph,D,STL,25,54,0,9,9
2,8479638,Justin Brazeau,R,BOS,26,41,7,1,8
2,8475235,Nicolas Deslauriers,L,PHI,33,47,6,2,8
2,8479772,Zack MacEwen,R,OTT,28,51,5,3,8
2,8477851,Jordan Oesterle,D,BOS,32,44,5,3,8
2,8481754,Nikita Nesterenko,C,ANA,23,32,5,3,8
2,8481789,Tye Kartye,L,SEA,23,42,3,5,8
2,8470600,Ryan Suter,D,STL,39,56,3,5,8
2,8478409,Anthony Richard,C,PHI,28,30,3,5,8
2,8476867,Brendan Gaunce,C,MIN,30,35,3,5,8
2,8474612,Travis Hamonic,D,OTT,34,42,2,6,8
2,8479994,Jaret Anderson-Dolan,C,WPG,25,38,2,6,8
2,8478454,Noah Juulsen,D,VAN,27,38,1,7,8
2,8481592,Jakob Pelletier,L,CGY,23,43,1,7,8
2,8477365,Connor Clifton,D,BUF,29,56,0,8,8
2,8473446,Erik Johnson,D,PHI,36,45,0,8,8
2,8479249,Andrew Poturalski,C,SJS,30,41,0,8,8
2,8482861,Vincent Iorio,D,WSH,22,30,0,8,8
2,8476473,Connor Murphy,D,CHI,31,44,0,8,8
2,8482177,Marat Khusnutdinov,C,MIN,22,42,4,3,7
2,8482713,Mackie Samoskevich,R,FLA,22,33,4,3,7
2,8478881,Brett Seney,L,CHI,28,17,4,3,7
2,8479367,William Lockwood,R,FLA,26,34,3,4,7
2,8483763,Maksymilian Szuber,D,UTA,22,22,2,5,7
2,8476967,Brett Kulak,D,EDM,30,56,1,6,7
2,8479442,Troy Stecher,D,EDM,30,58,1,6,7
2,8475750,Jon Merrill,D,MIN,32,67,1,6,7
2,8477962,Brendan Lemieux,L,CAR,28,41,1,6,7
2,8480070,Ian Mitchell,D,BOS,25,49,1,6,7
2,8475177,Calvin de Haan,D,COL,33,48,0,7,7
2,8480245,Olle Lycksell,R,PHI,25,25,0,7,7
2,8481716,Dmitri Voronkov,L,CBJ,24,46,4,2,6
2,8477244,Chad Ruhwedel,D,NYR,34,32,3,3,6
2,8471677,Jack Johnson,D,CBJ,37,66,3,3,6
2,8481598,Philip Broberg,D,EDM,23,42,2,4,6
2,8479348,Kale Clague,D,BUF,26,40,2,4,6
2,8479985,Cale Fleury,D,SEA,26,28,2,4,6
2,8477473,Justin Bailey,R,SJS,29,23,2,4,6
2,8476372,Nick Seeler,D,PHI,31,44,1,5,6
2,8477971,Andreas Englund,D,LAK,28,31,1,5,6
2,8475958,Michael Sgarbossa,C,WSH,32,26,0,6,6
2,8477467,Gustav Olofsson,D,SEA,30,24,5,0,5
2,8480292,Carson Meyer,R,ANA,27,39,4,1,5
2,8480468,James Hamblin,L,EDM,25,14,4,1,5
2,8479981,Jonah Gadjovich,L,FLA,26,37,3,2,5
2,8477073,Kurtis MacDermid,L,NJD,30,29,3,2,5
2,8481541,Samuel Bolduc,D,NYI,24,26,3,2,5
2,8479320,Maxime Lajoie,D,SEA,27,30,2,3,5
2,8480844,Grigori Denisenko,L,VGK,24,24,2,3,5
2,8471817,Ryan Reaves,R,TOR,37,49,1,4,5
2,8478146,Matthew Highmore,C,OTT,28,33,1,4,5
2,8478450,Parker Wotherspoon,D,BOS,27,34,1,4,5
2,8482145,Mavrik Bourque,C,DAL,22,41,1,4,5
2,8483619,Filip Roos,D,OTT,25,34,1,4,5
2,8481806,Louis Crevier,D,CHI,23,19,0,5,5
2,8483549,Lucas Condotta,L,MTL,27,35,4,0,4
2,8481556,John Beecher,C,BOS,23,34,3,1,4
2,8481679,Maxence Guenette,D,OTT,23,37,3,1,4
2,8481056,Spencer Stastney,D,NSH,24,30,2,2,4
2,8479362,Riley Tufte,L,BOS,26,10,2,2,4
2,8482165,Yan Kuznetsov,D,CGY,22,19,2,2,4
2,8484258,Sam Malinski,D,COL,26,22,2,2,4
2,8483395,Arshdeep Bains,L,VAN,23,13,2,2,4
2,8481701,Santeri Hatakka,D,NJD,23,34,1,3,4
2,8483012,Logan Morrison,C,SEA,22,33,1,3,4
2,8476441,Joel Edmundson,D,LAK,31,42,1,3,4
2,8478021,William Lagesson,D,DET,28,29,1,3,4
2,8479379,Givani Smith,R,SJS,26,31,1,3,4
2,8481122,Simon Benoit,D,TOR,26,36,1,3,4
2,8478424,Jansen Harkins,C,ANA,27,45,1,3,4
2,8482144,Jack Thompson,D,SJS,22,25,1,3,4
2,8480870,Bo Groulx,C,NYR,24,29,1,3,4
2,8481237,Kyle MacLean,C,NYI,25,24,1,3,4
2,8482153,Brendan Brisson,C,VGK,23,27,1,3,4
2,8477384,Joshua Brown,D,EDM,30,45,1,3,4
2,8479576,Vincent Desharnais,D,VAN,28,35,1,3,4
2,8474013,Ian Cole,D,UTA,35,60,0,4,4
2,8475795,Dylan McIlrath,D,WSH,32,26,0,4,4
2,8479536,Axel Jonsson-Fjallby,L,WPG,26,35,2,1,3
2,8481543,Nikita Alexandrov,C,STL,24,25,2,1,3
2,8479991,Jake Leschyshyn,C,NYR,25,32,2,1,3
2,8480267,Sammy Walker,C,MIN,25,20,2,1,3
2,8480192,Johnathan Kovacevic,D,NJD,27,55,1,2,3
2,8482765,Isak Rosen,R,BUF,21,26,1,2,3
2,8481609,Vladislav Kolyachonok,D,UTA,23,31,1,2,3
2,8478874,Adam Gaudette,R,OTT,28,34,1,2,3
2,8482858,Ryker Evans,D,SEA,23,24,1,2,3
2,8482511,Mason Lohrei,D,BOS,23,32,1,2,3
2,8483570,Ben Meyers,C,SEA,26,24,1,2,3
2,8474062,Riley Nash,C,NYR,35,14,1,2,3
2,8481605,Jackson LaCombe,D,ANA,23,24,1,2,3
2,8477541,Dakota Mermis,D,TOR,30,15,1,2,3
2,8482929,Emil Lilleberg,D,TBL,23,27,1,2,3
2,8477810,Joel Hanley,D,CGY,33,23,1,2,3
2,8481719,Maxwell Crozier,D,TBL,24,18,1,2,3
2,8477149,Scott Sabourin,R,SJS,32,12,1,2,3
2,8482516,Matthew Kessel,D,STL,24,19,0,3,3
2,8481564,Ryan Johnson,D,BUF,23,17,0,3,3
2,8483630,Pavol Regenda,L,ANA,25,35,2,0,2
2,8480032,Shane Bowers,C,NJD,25,12,2,0,2
2,8482147,Jean-Luc Foudy,C,COL,22,22,2,0,2
2,8483397,Marc McLaughlin,C,BOS,25,26,2,0,2
2,8481422,Jake Lucchini,C,NSH,29,17,2,0,2
2,8476913,Devin Shore,C,MIN,30,27,1,1,2
2,8482141,Lukas Cormier,D,VGK,22,22,1,1,2
2,8484287,Cole McWard,D,VAN,23,26,1,1,2
2,8482470,Ilya Solovyov,D,CGY,24,20,1,1,2
2,8477527,Ross Johnston,L,ANA,30,25,1,1,2
2,8484325,Waltteri Merela,C,TBL,26,17,1,1,2
2,8482162,Roby Jarventie,L,EDM,22,22,1,1,2
2,8475780,Chris Wagner,R,COL,33,7,1,1,2
2,8477320,Anton Blidh,L,NYR,29,16,1,1,2
2,8484326,Patrik Koch,D,UTA,28,5,1,1,2
2,8477993,Justin Kirkland,C,CGY,28,8,1,1,2
2,8481462,Mason Morelli,L,VGK,28,14,1,1,2
2,8476952,Dominic Toninato,C,WPG,30,24,0,2,2
2,8480890,Jan Jenik,C,OTT,24,25,0,2,2
2,8481743,Marc Del Gaizo,D,NSH,25,25,0,2,2
2,8481206,John Ludvig,D,PIT,24,12,0,2,2
2,8478051,Max Willman,C,NJD,29,18,0,2,2
2,8478502,Dennis Gilbert,D,BUF,28,19,0,2,2
2,8478011,Louie Belpedio,D,PHI,28,17,0,2,2
2,8480084,Nick DeSimone,D,NJD,30,14,0,2,2
2,8481006,Tyler Tucker,D,STL,24,19,0,2,2
2,8481593,Jayden Struble,D,MTL,23,18,0,2,2
2,8481030,Jack St. Ivany,D,PIT,25,14,0,2,2
2,8475413,Justin Dowling,C,NJD,34,15,0,2,2
2,8482172,Landon Slaggert,L,CHI,22,27,0,2,2
2,8483512,Matthew Savoie,C,EDM,20,15,0,2,2
2,8482126,Emil Andrae,D,PHI,31,5,0,2,2
2,8481065,Angus Crookshank,L,OTT,25,21,0,2,2
2,8479419,Brett Murray,L,BUF,26,17,1,0,1
2,8482250,Callahan Burke,C,VGK,27,18,1,0,1
2,8481699,Aku Raty,R,UTA,23,15,1,0,1
2,8480851,Akil Thomas,C,LAK,24,12,1,0,1
2,8480306,Grant Hutton,D,NYI,29,6,1,0,1
2,8479522,Hardy Haman Aktell,D,WSH,26,5,1,0,1
2,8482197,Adam Raska,R,MIN,23,6,1,0,1
2,8483546,Marshall Rifai,D,TOR,26,4,1,0,1
2,8482061,Brandon Biro,L,SEA,26,10,1,0,1
2,8482094,Daemon Hunt,D,MIN,22,10,0,1,1
2,8481585,Egor Afanasyev,L,SJS,23,17,0,1,1
2,8483398,Declan Carlile,D,TBL,31,3,0,1,1
2,8482201,Gage Goncalves,C,TBL,23,24,0,1,1
2,8476323,Max McCormick,L,SEA,32,7,0,1,1
2,8483407,Brandon Scanlin,D,NYR,25,7,0,1,1
2,8484304,Uvis Balinskis,D,FLA,28,13,0,1,1
2,8481024,Linus Karlsson,C,VAN,25,9,0,1,1
2,8480075,Cameron Crotty,D,MIN,25,10,0,1,1
2,8481655,Cole Schwindt,R,CGY,23,4,0,1,1
2,8483432,Luca Del Bel Belluz,C,CBJ,31,4,0,1,1
2,8483920,Pierrick Dube,R,WSH,23,4,0,1,1
2,8481043,Cole Koepke,L,BOS,26,24,0,0,0
2,8478477,Mitchell Stephens,C,SEA,27,21,0,0,0
2,8475755,Alexander Petrovic,D,DAL,32,8,0,0,0
2,8479587,Rhett Gardner,C,PHI,28,22,0,0,0
2,8482787,Nikita Chibrikov,R,WPG,31,7,0,0,0
2,8482088,Justin Sourdif,R,FLA,22,18,0,0,0
2,8480874,Adam Ginning,D,PHI,24,8,0,0,0
2,8478446,Glenn Gawdin,C,LAK,27,11,0,0,0
2,8482460,Matt Rempe,C,NYR,22,11,0,0,0
2,8484259,Ondrej Pavel,C,COL,31,3,0,0,0
2,8484255,Jason Polin,R,COL,25,4,0,0,0
2,8481578,Graeme Clarke,R,MIN,23,4,0,0,0
2,8479421,Jacob Moverare,D,LAK,26,7,0,0,0
2,8483471,Brad Lambert,C,WPG,31,11,0,0,0
2,8483489,Fraser Minten,C,TOR,31,8,0,0,0
2,8483567,Georgii Merkulov,C,BOS,24,7,0,0,0
2,8470794,Joe Pavelski,C,,40,0,0,0,0
2,8479321,Lucas Johansen,D,,27,0,0,0,0
2,8477950,Tony DeAngelo,D,,29,0,0,0,0
2,8471218,Blake Wheeler,R,,38,0,0,0,0
2,8475197,Tyson Barrie,D,,33,0,0,0,0
2,8474157,Max Pacioretty,L,,36,0,0,0,0
2,8475744,Evgeny Kuznetsov,C,,32,0,0,0,0
2,8474037,James van Riemsdyk,L,,35,0,0,0,0
2,8476907,Mackenzie MacEachern,L,,30,0,0,0,0
2,8480216,Jacob Peterson,C,,25,0,0,0,0
2,8474602,Justin Schultz,D,,34,0,0,0,0
2,8482222,Alexander Barabanov,L,,30,0,0,0,0
2,8474031,Kevin Shattenkirk,D,,35,0,0,0,0
2,8477330,Dominik Kubalik,L,,29,0,0,0,0
2,8480884,Calen Addison,D,,24,0,0,0,0
2,8475906,John Klingberg,D,,32,0,0,0,0
2,8480008,Adam Ruzicka,C,,25,0,0,0,0
2,8476884,Derrick Pouliot,D,,30,0,0,0,0
2,8476919,Chris Tierney,C,,30,0,0,0,0
2,8479415,Michael McLeod,C,,26,0,0,0,0
2,8474870,Tyler Johnson,C,,34,0,0,0,0
2,8470604,Jeff Carter,C,,39,0,0,0,0
2,8478104,Sammy Blais,L,,28,0,0,0,0
2,8474884,Mike Hoffman,C,,35,0,0,0,0
2,8481591,Sam Poulin,R,,23,0,0,0,0
2,8471274,Alex Goligoski,D,,39,0,0,0,0
2,8476871,Tanner Pearson,L,,32,0,0,0,0
2,8476393,Nick Cousins,C,,31,0,0,0,0
2,8479977,Kailer Yamamoto,R,,26,0,0,0,0
2,8479346,Dillon Dube,C,,26,0,0,0,0
2,8480184,Gustav Lindstrom,D,,26,0,0,0,0
2,8479376,Victor Mete,D,,26,0,0,0,0
2,8473449,Kyle Okposo,R,,36,0,0,0,0
2,8481058,Jesse Ylonen,R,,25,0,0,0,0
2,8475752,Tyler Pitlick,C,,33,0,0,0,0
2,8481239,Samuel Fagemo,L,,24,0,0,0,0
2,8480821,Filip Zadina,R,,25,0,0,0,0
2,8470966,Mark Giordano,D,,41,0,0,0,0
2,8478495,Denis Gurianov,R,,27,0,0,0,0
2,8477464,Nic Petan,C,,29,0,0,0,0
2,8478099,Kevin Labanc,R,,29,0,0,0,0
2,8482241,Radim Zohorna,L,,28,0,0,0,0
2,8474040,Sam Gagner,C,,35,0,0,0,0
2,8479514,Rem Pitlick,C,,27,0,0,0,0
2,8478430,Oliver Kylington,D,,27,0,0,0,0
2,8479533,Joona Koppanen,L,,26,0,0,0,0
2,8479984,Cal Foote,D,,26,0,0,0,0
2,8477126,Jayson Megna,C,,34,0,0,0,0
2,8475164,Jakob Silfverberg,R,,34,0,0,0,0
2,8474009,Nick Bonino,C,,36,0,0,0,0
2,8479458,Nikita Zaitsev,D,,33,0,0,0,0
2,8477944,Jakub Vrana,L,,28,0,0,0,0
2,8471699,Andrew Cogliano,C,,37,0,0,0,0
2,8478067,Oskar Lindblom,L,,28,0,0,0,0
2,8471686,Marc Staal,D,,37,0,0,0,0
2,8470610,Zach Parise,L,,40,0,0,0,0
2,8478904,Steven Lorentz,C,,28,0,0,0,0
2,8473473,Milan Lucic,L,,36,0,0,0,0
2,8480031,Maxime Comtois,L,,25,0,0,0,0
2,8478512,Austin Czarnik,C,,32,0,0,0,0
2,8473504,Cal Clutterbuck,R,,37,0,0,0,0
2,8477454,Adam Erne,L,,29,0,0,0,0
2,8479383,Boris Katchouk,L,,26,0,0,0,0
2,8475825,Jani Hakanpää,D,,32,0,0,0,0
2,8477846,Ryan Carpenter,C,,33,0,0,0,0
2,8477930,Pierre-Edouard Bellemare,L,,39,0,0,0,0
2,8478400,Colin White,C,,27,0,0,0,0
2,8480226,Marián Studenic,R,,26,0,0,0,0
2,8480853,Liam Foudy,C,,24,0,0,0,0
2,8475797,Jarred Tinordi,D,,32,0,0,0,0
2,8479423,Alex Nylander,L,,26,0,0,0,0
2,8474618,Marco Scandella,D,,34,0,0,0,0
2,8480823,Alexander Alexeyev,D,WSH,25,13,0,0,0
2,8478028,Fredrik Olofsson,L,,28,0,0,0,0
2,8474709,Matt Martin,L,,35,0,0,0,0
2,8481070,Hugh McGing,L,,26,0,0,0,0
2,8479546,Oskar Steen,C,,26,0,0,0,0
2,8474145,Robert Bortuzzo,D,,35,0,0,0,0
2,8476915,Jujhar Khaira,L,,30,0,0,0,0
2,8480274,Philip Kemp,D,EDM,25,1,0,0,0
2,8484321,Nikolas Matinpalo,D,OTT,26,0,0,0,0
2,8475278,Byron Froese,C,,33,0,0,0,0
2,8481812,Nikolai Knyzhov,D,,27,0,0,0,0
2,8478408,Travis Dermott,D,,28,0,0,0,0
2,8481077,John Leonard,L,,26,0,0,0,0
2,8479547,Matthew Phillips,R,,26,0,0,0,0
2,8480836,Jonathan Gruden,C,,24,0,0,0,0
2,8481690,Tyler Angle,C,,24,0,0,0,0
2,8482102,Vasily Ponomarev,C,PIT,22,15,0,0,0
2,8475766,Austin Watson,L,,32,0,0,0,0
2,8483597,Milos Kelemen,L,UTA,25,8,0,0,0
2,8478854,Ryan Shea,D,PIT,27,10,0,0,0
2,8481016,Ruslan Iskhakov,C,,24,0,0,0,0
2,8478078,Rourke Chartier,C,,28,0,0,0,0
2,8479330,Brandon Gignac,C,MTL,27,6,0,0,0
2,8483401,Marc Johnstone,R,PIT,28,1,0,0,0
2,8480776,Sheldon Rempal,R,,29,0,0,0,0
2,8478956,Samuel Laberge,L,NJD,27,1,0,0,0
2,8481726,Adam Edstrom,C,NYR,24,7,0,0,0
2,8483609,Adam Klapka,R,CGY,24,4,0,0,0
2,8483045,Cameron Butler,R,CBJ,31,1,0,0,0
2,8481534,Raphael Lavoie,C,EDM,24,4,0,0,0
2,8478147,Bokondji Imama,L,PIT,28,9,0,0,0
2,8482476,Emil Heineman,L,MTL,23,5,0,0,0
2,8483531,Brian Halonen,L,NJD,25,3,0,0,0
2,8482118,Sam Colangelo,R,ANA,23,14,0,0,0
2,8484314,Jiri Smejkal,L,,28,0,0,0,0
3,8477956,David Pastrnak,R,BOS,28,79,60,63,123
3,8481559,Jack Hughes,C,NJD,23,73,44,78,122
3,8476453,Nikita Kucherov,R,TBL,31,82,41,80,121
3,8478864,Kirill Kaprizov,L,MIN,27,77,52,67,119
3,8478402,Connor McDavid,C,EDM,27,75,36,79,115
3,8477492,Nathan MacKinnon,C,COL,29,82,32,83,115
3,8482116,Tim Stützle,C,OTT,22,79,37,76,113
3,8477934,Leon Draisaitl,C,EDM,29,76,49,61,110
3,8479314,Matthew Tkachuk,L,FLA,27,78,36,73,109
3,8479318,Auston Matthews,C,TOR,27,80,62,46,108
3,8477404,Jake Guentzel,C,TBL,30,82,41,63,104
3,8478483,Mitch Marner,R,TOR,27,78,27,74,101
3,8477939,William Nylander,R,TOR,28,80,34,66,100
3,8480027,Jason Robertson,L,DAL,25,81,31,68,99
3,8478550,Artemi Panarin,L,NYR,33,73,25,74,99
3,8477933,Sam Reinhart,C,FLA,29,79,46,51,97
3,8477946,Dylan Larkin,C,DET,28,80,40,56,96
3,8477493,Aleksander Barkov,C,FLA,29,74,32,64,96
3,8476468,J.T. Miller,C,VAN,31,79,35,58,93
3,8481557,Matt Boldy,L,MIN,23,76,47,45,92
3,8478420,Mikko Rantanen,R,COL,28,82,45,47,92
3,8477942,Kevin Fiala,L,LAK,28,78,32,59,91
3,8478403,Jack Eichel,C,VGK,28,77,44,46,90
3,8479343,Clayton Keller,R,UTA,26,76,42,47,89
3,8471675,Sidney Crosby,C,PIT,37,74,38,51,89
3,8479337,Alex DeBrincat,R,DET,27,79,38,51,89
3,8480036,Miro Heiskanen,D,DAL,25,81,20,69,89
3,8480800,Quinn Hughes,D,VAN,25,74,12,77,89
3,8473512,Claude Giroux,R,OTT,36,81,33,55,88
3,8478398,Kyle Connor,L,WPG,28,73,46,40,86
3,8484144,Connor Bedard,C,CHI,19,76,25,61,86
3,8480801,Brady Tkachuk,L,OTT,25,80,36,48,84
3,8479385,Jordan Kyrou,C,STL,26,73,28,56,84
3,8480069,Cale Makar,D,COL,26,70,24,60,84
3,8477501,Valeri Nichushkin,R,COL,29,80,39,43,82
3,8480023,Robert Thomas,C,STL,25,68,26,55,81
3,8477960,Adrian Kempe,R,LAK,28,82,26,55,81
3,8475166,John Tavares,C,TOR,34,79,35,45,80
3,8477940,Nikolaj Ehlers,L,WPG,28,71,34,46,80
3,8478460,Zach Werenski,D,CBJ,27,79,18,62,80
3,8477409,Carter Verhaeghe,C,FLA,29,76,43,36,79
3,8476887,Filip Forsberg,L,NSH,30,73,41,38,79
3,8478427,Sebastian Aho,C,CAR,27,75,28,51,79
3,8480012,Elias Pettersson,C,VAN,26,73,27,52,79
3,8476454,Ryan Nugent-Hopkins,C,EDM,31,79,22,57,79
3,8475692,Mats Zuccarello,R,MIN,37,76,17,62,79
3,8475184,Chris Kreider,L,NYR,33,77,42,36,78
3,8473419,Brad Marchand,L,BOS,36,79,31,47,78
3,8474141,Patrick Kane,R,DET,36,82,30,48,78
3,8478439,Travis Konecny,R,PHI,27,75,29,48,77
3,8479407,Jesper Bratt,L,NJD,26,71,20,57,77
3,8476389,Vincent Trocheck,C,NYR,31,80,34,42,76
3,8475765,Vladimir Tarasenko,R,DET,33,81,23,53,76
3,8478414,Timo Meier,R,NJD,28,76,41,34,75
3,8478010,Brayden Point,C,TBL,28,82,38,36,74
3,8475913,Mark Stone,R,VGK,32,76,27,47,74
3,8482124,Quinton Byfield,R,LAK,22,81,22,51,73
3,8475786,Zach Hyman,L,EDM,32,80,46,26,72
3,8476539,Jonathan Marchessault,R,NSH,34,70,38,33,71
3,8480002,Nico Hischier,C,NJD,25,71,26,45,71
3,8478449,Roope Hintz,C,DAL,28,82,32,38,70
3,8480830,Andrei Svechnikov,R,CAR,24,75,28,42,70
3,8477496,Elias Lindholm,C,BOS,30,79,27,43,70
3,8476459,Mika Zibanejad,C,NYR,31,78,24,46,70
3,8475172,Nazem Kadri,C,CGY,34,76,23,47,70
3,8478445,Mathew Barzal,C,NYI,27,81,8,62,70
3,8479420,Tage Thompson,C,BUF,27,70,33,36,69
3,8475191,Reilly Smith,R,NYR,33,75,26,43,69
3,8480018,Nick Suzuki,C,MTL,25,77,31,37,68
3,8475784,Jeff Skinner,C,EDM,32,80,30,38,68
3,8476448,William Karlsson,C,VGK,31,77,29,38,67
3,8483431,Logan Cooley,C,UTA,20,75,28,39,67
3,8478493,Joel Eriksson Ek,C,MIN,27,73,25,42,67
3,8480208,Drake Batherson,R,OTT,26,81,23,44,67
3,8479325,Charlie McAvoy,D,BOS,27,77,14,53,67
3,8482745,Mason McTavish,C,ANA,21,68,34,32,66
3,8481068,Yegor Sharangovich,C,CGY,26,80,33,33,66
3,8476881,Tomas Hertl,C,VGK,31,76,26,40,66
3,8475168,Matt Duchene,C,DAL,33,82,24,42,66
3,8476460,Mark Scheifele,C,WPG,31,71,22,44,66
3,8480839,Rasmus Dahlin,D,BUF,24,68,19,47,66
3,8476456,Jonathan Huberdeau,C,CGY,31,79,15,51,66
3,8470613,Brent Burns,D,CAR,39,76,14,52,66
3,8482684,Luke Hughes,D,NJD,21,69,12,54,66
3,8477935,Sam Bennett,C,FLA,28,74,30,35,65
3,8478444,Brock Boeser,R,VAN,27,70,29,35,64
3,8482665,Matty Beniers,C,SEA,22,74,25,39,64
3,8475745,Charlie Coyle,C,BOS,32,82,25,39,64
3,8477402,Pavel Buchnevich,L,STL,29,78,24,40,64
3,8474578,Erik Karlsson,D,PIT,34,79,18,46,64
3,8478873,Troy Terry,R,ANA,27,74,17,47,64
3,8475798,Mikael Granlund,C,SJS,32,72,14,50,64
3,8480865,Noah Dobson,D,NYI,24,82,13,51,64
3,8477500,Bo Horvat,C,NYI,29,80,32,31,63
3,8477955,Jared McCann,L,SEA,28,70,31,32,63
3,8474150,Mikael Backlund,C,CGY,35,79,29,34,63
3,8476479,Phillip Danault,C,LAK,31,78,21,42,63
3,8477951,Nick Schmaltz,C,UTA,28,77,17,46,63
3,8476853,Morgan Rielly,D,TOR,30,72,11,52,63
3,8480039,Martin Necas,C,CAR,25,69,26,36,62
3,8481528,Dylan Cozens,C,BUF,23,73,26,36,62
3,8480015,Owen Tippett,R,PHI,25,75,25,37,62
3,8471215,Evgeni Malkin,C,PIT,38,74,24,38,62
3,8471685,Anze Kopitar,C,LAK,37,82,21,41,62
3,8482740,Wyatt Johnston,C,DAL,21,78,32,29,61
3,8476875,Mike Matheson,D,MTL,30,75,12,49,61
3,8475167,Victor Hedman,D,TBL,34,80,10,51,61
3,8474102,David Perron,L,OTT,36,79,28,32,60
3,8474586,Jordan Eberle,R,SEA,34,73,22,38,60
3,8474600,Roman Josi,D,NSH,34,76,9,51,60
3,8473994,Jamie Benn,L,DAL,35,82,28,31,59
3,8475170,Brayden Schenn,C,STL,33,75,28,31,59
3,8479999,Casey Mittelstadt,C,COL,26,80,24,35,59
3,8474564,Steven Stamkos,C,NSH,34,74,20,39,59
3,8479675,Trevor Moore,L,LAK,29,78,33,25,58
3,8478440,Dylan Strome,C,WSH,27,70,19,39,58
3,8477949,Alex Tuch,R,BUF,28,68,18,40,58
3,8482699,Dylan Guenther,R,UTA,21,77,32,25,57
3,8482078,Lucas Raymond,L,DET,22,80,26,31,57
3,8471214,Alex Ovechkin,L,WSH,39,68,21,36,57
3,8477504,Josh Morrissey,D,WPG,29,71,16,41,57
3,8480803,Evan Bouchard,D,EDM,25,76,10,46,56
3,8475726,Tyler Toffoli,C,SJS,32,67,26,29,55
3,8477479,Tyler Bertuzzi,L,CHI,29,61,25,30,55
3,8477451,Ryan Hartman,R,MIN,30,72,24,31,55
3,8483808,Andrei Kuzmenko,L,CGY,28,71,23,32,55
3,8478401,Pavel Zacha,C,BOS,27,79,20,35,55
3,8481711,Matias Maccelli,L,UTA,24,74,16,39,55
3,8476346,Johnny Gaudreau,L,CBJ,31,70,14,41,55
3,8477998,Warren Foegele,L,LAK,28,81,28,26,54
3,8481533,Trevor Zegras,C,ANA,23,76,22,32,54
3,8474679,Gustav Nyquist,C,NSH,35,77,15,39,54
3,8476905,Chandler Stephenson,C,SEA,30,71,15,39,54
3,8482093,Seth Jarvis,C,CAR,22,71,31,22,53
3,8480797,Joel Farabee,L,PHI,24,74,27,26,53
3,8481560,Arthur Kaliyev,R,LAK,23,79,25,28,53
3,8479542,Brandon Hagel,L,TBL,26,82,24,29,53
3,8476882,Teuvo Teravainen,C,CHI,30,66,24,29,53
3,8478462,Nicolas Roy,C,VGK,27,75,22,31,53
3,8481540,Cole Caufield,R,MTL,23,77,21,32,53
3,8483515,Juraj Slafkovsky,L,MTL,20,74,19,34,53
3,8474590,John Carlson,D,WSH,34,70,15,38,53
3,8478407,Vince Dunn,D,SEA,28,75,10,43,53
3,8475151,Kyle Palmieri,C,NYI,33,79,28,24,52
3,8482109,Alexis Lafrenière,L,NYR,23,73,21,31,52
3,8478047,Michael Bunting,L,PIT,29,63,21,31,52
3,8477416,Oliver Bjorkstrand,R,SEA,29,79,16,36,52
3,8477986,Brandon Montour,D,SEA,30,73,13,39,52
3,8471724,Kris Letang,D,PIT,37,82,11,41,52
3,8475314,Anders Lee,L,NYI,34,71,29,22,51
3,8475754,Brock Nelson,C,NYI,33,75,21,30,51
3,8475287,Erik Haula,L,NJD,33,72,21,30,51
3,8479323,Adam Fox,D,NYR,26,77,9,42,51
3,8480064,Josh Norris,C,OTT,25,76,32,18,50
3,8478498,Jake DeBrusk,L,VAN,28,74,22,28,50
3,8475794,Tyler Seguin,C,DAL,32,82,20,30,50
3,8480188,Fabian Zetterlund,L,SJS,25,69,19,31,50
3,8478542,Evan Rodrigues,C,FLA,31,76,19,31,50
3,8476432,Boone Jenner,C,CBJ,31,69,28,21,49
3,8478366,Frank Vatrano,R,ANA,30,72,26,23,49
3,8482110,Dawson Mercer,C,NJD,23,73,21,28,49
3,8482720,Matthew Knies,L,TOR,22,79,18,31,49
3,8477407,Anthony Duclair,L,NYI,29,77,25,23,48
3,8482159,Tyson Foerster,R,PHI,22,75,21,27,48
3,8477503,Max Domi,C,TOR,29,76,18,30,48
3,8478975,Mason Marchment,L,DAL,29,81,15,33,48
3,8477494,Jonathan Drouin,L,COL,29,81,13,35,48
3,8478396,Noah Hanifin,D,VGK,27,61,12,36,48
3,8481618,Alex Newhook,C,MTL,23,78,11,37,48
3,8476792,Torey Krug,D,STL,33,77,10,38,48
3,8478397,Rasmus Andersson,D,CGY,28,75,8,40,48
3,8476483,Rickard Rakell,R,PIT,31,73,24,23,47
3,8477476,Artturi Lehkonen,L,COL,29,82,21,26,47
3,8477511,Anthony Mantha,R,CGY,30,76,21,26,47
3,8482097,Jack Quinn,R,BUF,23,68,21,26,47
3,8478466,Daniel Sprong,R,VAN,27,69,20,27,47
3,8484153,Leo Carlsson,C,ANA,20,71,18,29,47
3,8476462,Dougie Hamilton,D,NJD,31,70,15,32,47
3,8477346,MacKenzie Weegar,D,CGY,30,71,11,36,47
3,8474641,Adam Henrique,C,EDM,34,78,22,24,46
3,8479987,Morgan Geekie,C,BOS,26,80,17,29,46
3,8482667,William Eklund,L,SJS,22,66,15,31,46
3,8475753,Justin Faulk,D,STL,32,77,14,32,46
3,8481596,Shane Pinto,C,OTT,24,75,13,33,46
3,8478055,Gustav Forsling,D,FLA,28,75,8,38,46
3,8481542,Moritz Seider,D,DET,23,76,5,41,46
3,8475764,Cam Fowler,D,ANA,33,76,5,41,46
3,8479400,Pierre-Luc Dubois,L,WSH,26,74,28,17,45
3,8478856,Conor Garland,R,VAN,28,73,18,27,45
3,8475810,Bryan Rust,R,PIT,32,69,13,32,45
3,8481581,Thomas Harley,D,DAL,23,71,13,32,45
3,8477447,Shea Theodore,D,VGK,29,55,6,39,45
3,8480014,Gabriel Vilardi,C,WPG,25,74,19,25,44
3,8478438,Tommy Novak,C,NSH,27,69,16,28,44
3,8475714,Calle Jarnkrok,C,TOR,33,80,22,21,43
3,8478233,Andrew Mangiapane,L,WSH,28,64,21,22,43
3,8480028,Morgan Frost,C,PHI,25,73,19,24,43
3,8477429,Andrew Copp,C,DET,30,81,19,24,43
3,8477456,J.T. Compher,L,DET,29,77,16,27,43
3,8480798,Philipp Kurashev,C,CHI,25,63,16,27,43
3,8478911,Matt Roy,D,WSH,29,63,12,31,43
3,8482113,Anton Lundell,C,FLA,23,72,11,32,43
3,8482122,Brock Faber,D,MIN,22,77,6,37,43
3,8476438,Brandon Saad,L,STL,32,70,27,15,42
3,8475799,Nino Niederreiter,R,WPG,32,70,21,21,42
3,8481535,Nils Hoglander,L,VAN,24,68,21,21,42
3,8476826,Yanni Gourde,C,SEA,33,70,15,27,42
3,8480871,Adam Boqvist,D,FLA,24,68,14,28,42
3,8476958,Jaccob Slavin,D,CAR,30,73,13,29,42
3,8480817,K'Andre Miller,D,NYR,24,71,13,29,42
3,8479425,Filip Hronek,D,VAN,27,72,9,33,42
3,8475169,Evander Kane,L,EDM,33,77,22,19,41
3,8477021,Alex Kerfoot,C,UTA,30,75,14,27,41
3,8477964,Ivan Barbashev,C,VGK,29,76,12,29,41
3,8478507,John Marino,D,UTA,27,68,2,39,41
3,8476880,Tom Wilson,R,WSH,30,71,26,14,40
3,8480078,Filip Chytil,C,NYR,25,68,22,18,40
3,8471698,T.J. Oshie,R,WSH,38,69,20,20,40
3,8479992,Michael Rasmussen,C,DET,25,80,19,21,40
3,8482702,Logan Stankoven,C,DAL,21,81,18,22,40
3,8479339,Patrik Laine,L,CBJ,26,68,17,23,40
3,8475158,Ryan O'Reilly,C,NSH,33,66,16,24,40
3,8481523,Kirby Dach,C,MTL,23,64,15,25,40
3,8484145,Zach Benson,L,BUF,19,66,12,28,40
3,8481577,Philip Tomasino,C,NSH,23,71,11,29,40
3,8479410,Mikhail Sergachev,D,UTA,26,71,5,35,40
3,8482092,Ridly Greig,C,OTT,22,76,22,17,39
3,8475793,Ryan Johansen,C,PHI,32,72,22,17,39
3,8478474,Lawson Crouse,L,UTA,27,78,21,18,39
3,8481554,Kaapo Kakko,R,NYR,23,67,20,19,39
3,8477426,Nicholas Paul,L,TBL,29,80,19,20,39
3,8480009,Eeli Tolvanen,R,SEA,25,72,19,20,39
3,8478472,Mathieu Joseph,R,STL,27,68,18,21,39
3,8483505,Matthew Poitras,C,BOS,20,75,12,27,39
3,8476906,Shayne Gostisbehere,D,CAR,31,76,2,37,39
3,8478020,Michael Amadio,R,OTT,28,78,20,18,38
3,8480835,Jack Drury,C,CAR,24,64,19,19,38
3,8474053,Logan Couture,C,SJS,35,68,16,22,38
3,8475763,Kevin Hayes,R,PIT,32,64,16,22,38
3,8478458,John (Jack) Roslovic,C,CAR,27,69,14,24,38
3,8478469,Thomas Chabot,D,OTT,27,72,11,27,38
3,8475200,Dmitry Orlov,D,CAR,33,77,10,28,38
3,8478038,Devon Toews,D,COL,30,67,9,29,38
3,8476419,Jean-Gabriel Pageau,C,NYI,32,78,8,30,38
3,8481703,Valtteri Puustinen,R,PIT,25,61,8,30,38
3,8481604,Pavel Dorofeyev,L,VGK,24,72,20,17,37
3,8478042,Viktor Arvidsson,L,EDM,31,74,20,17,37
3,8478057,Dakota Joshua,C,VAN,28,56,18,19,37
3,8476292,Ondrej Palat,L,NJD,33,66,16,21,37
3,8476392,Adam Lowry,C,WPG,31,69,16,21,37
3,8477444,Andre Burakovsky,L,SEA,29,68,15,22,37
3,8480220,Noah Cates,L,PHI,25,70,15,22,37
3,8482133,Thomas Bordeleau,C,SJS,22,71,12,25,37
3,8482660,Kent Johnson,C,CBJ,22,70,10,27,37
3,8476872,Scott Laughton,C,PHI,30,68,9,28,37
3,8482712,Oskar Olausson,R,COL,22,79,9,28,37
3,8474563,Drew Doughty,D,LAK,35,73,7,30,37
3,8476854,Hampus Lindholm,D,BOS,30,72,6,31,37
3,8477948,Travis Sanheim,D,PHI,28,73,5,32,37
3,8481624,Ilya Mikheyev,R,CHI,30,63,16,20,36
3,8482149,Cole Perfetti,C,WPG,22,65,13,23,36
3,8476480,Vladislav Namestnikov,C,WPG,32,67,11,25,36
3,8481546,Cam York,D,PHI,23,74,5,31,36
3,8474565,Alex Pietrangelo,D,VGK,34,59,3,33,36
3,8476399,Blake Coleman,C,CGY,33,74,21,14,35
3,8475768,Jaden Schwartz,C,SEA,32,73,18,17,35
3,8473986,Alex Killorn,L,ANA,35,65,16,19,35
3,8479351,Sam Steel,C,DAL,26,80,11,24,35
3,8480434,Sean Durzi,D,UTA,26,74,11,24,35
3,8476979,Erik Gustafsson,D,DET,32,74,5,30,35
3,8479525,Ross Colton,C,COL,28,80,19,15,34
3,8476474,Stefan Noesen,R,NJD,31,67,18,16,34
3,8475722,Jason Zucker,L,BUF,32,70,18,16,34
3,8479393,Noah Gregor,L,OTT,26,76,14,20,34
3,8478519,Anthony Cirelli,C,TBL,27,82,13,21,34
3,8476463,Jonas Brodin,D,MIN,31,79,7,27,34
3,8476927,Teddy Blueger,C,VAN,30,66,6,28,34
3,8477495,Seth Jones,D,CHI,30,67,5,29,34
3,8480873,Rasmus Sandin,D,WSH,24,62,2,32,34
3,8481186,Logan O'Connor,R,COL,28,80,19,14,33
3,8482705,Cole Sillinger,C,CBJ,21,64,19,14,33
3,8474149,Evgenii Dadonov,R,DAL,35,81,19,14,33
3,8484166,Adam Fantilli,C,CBJ,20,68,18,15,33
3,8482175,JJ Peterka,R,BUF,22,67,17,16,33
3,8477932,Aaron Ekblad,D,FLA,28,71,15,18,33
3,8481553,Bobby Brink,R,PHI,23,64,13,20,33
3,8480813,Joe Veleno,C,DET,24,76,13,20,33
3,8479315,Joey Anderson,R,CHI,26,51,13,20,33
3,8474716,Jared Spurgeon,D,MIN,35,77,12,21,33
3,8477953,Kasperi Kapanen,R,STL,28,65,11,22,33
3,8477947,Sonny Milano,L,WSH,28,55,10,23,33
3,8480145,Neal Pionk,D,WPG,29,78,6,27,33
3,8477488,Brett Pesce,D,NJD,30,70,6,27,33
3,8476923,Damon Severson,D,CBJ,30,80,5,28,33
3,8480068,Ryan Poehling,C,PHI,25,58,18,14,32
3,8480855,Jack McBain,C,UTA,24,62,17,15,32
3,8479591,Michael Eyssimont,C,TBL,28,77,17,15,32
3,8478891,Mason Appleton,C,WPG,28,57,15,17,32
3,8481656,Aliaksei Protas,C,WSH,23,66,13,19,32
3,8480459,Pius Suter,C,VAN,28,71,12,20,32
3,8477498,Darnell Nurse,D,EDM,29,77,10,22,32
3,8476458,Ryan Strome,C,ANA,31,73,9,23,32
3,8476892,Colton Parayko,D,STL,31,69,4,28,32
3,8475848,Brendan Gallagher,R,MTL,32,76,23,8,31
3,8482155,Alex Laferriere,R,LAK,23,70,19,12,31
3,8477919,Frederick Gaudreau,C,MIN,31,57,18,13,31
3,8478115,Pierre Engvall,L,NYI,28,79,15,16,31
3,8476897,Oskar Sundqvist,C,STL,30,72,14,17,31
3,8475855,Jesper Fast,R,CAR,33,62,13,18,31
3,8476869,Brady Skjei,D,NSH,30,74,11,20,31
3,8481524,Bowen Byram,D,BUF,23,66,11,20,31
3,8476331,Dylan DeMelo,D,WPG,31,72,7,24,31
3,8482105,Jake Sanderson,D,OTT,22,75,7,24,31
3,8474715,Cameron Atkinson,R,TBL,35,79,20,10,30
3,8477450,Jason Dickinson,C,CHI,29,54,16,14,30
3,8476981,Josh Anderson,R,MTL,30,69,15,15,30
3,8477989,Christian Dvorak,C,MTL,28,66,15,15,30
3,8480185,Eetu Luostarinen,C,FLA,26,70,13,17,30
3,8478109,Victor Olofsson,L,VGK,29,67,13,17,30
3,8482062,Cole Smith,L,NSH,29,61,12,18,30
3,8480802,Ryan McLeod,C,BUF,25,66,10,20,30
3,8478133,Jake Evans,C,MTL,28,73,9,21,30
3,8480849,Barrett Hayton,C,UTA,24,72,9,21,30
3,8482111,Justin Barron,D,MTL,23,62,9,21,30
3,8476902,Esa Lindell,D,DAL,30,74,9,21,30
3,8481606,Jordan Spence,D,LAK,23,67,9,21,30
3,8482671,Owen Power,D,BUF,22,72,5,25,30
3,8476931,Jake McCabe,D,TOR,31,65,5,25,30
3,8482655,Janis Moser,D,TBL,24,75,3,27,30
3,8478046,Danton Heinen,L,VAN,29,67,17,12,29
3,8478413,Jordan Greenway,L,BUF,27,68,16,13,29
3,8473422,Nick Foligno,L,CHI,37,67,13,16,29
3,8476921,Jordan Martinook,L,CAR,32,57,12,17,29
3,8482146,Luke Evangelista,R,NSH,22,65,12,17,29
3,8482142,Jamie Drysdale,D,PHI,22,60,10,19,29
3,8473533,Jordan Staal,C,CAR,36,63,9,20,29
3,8475343,Nic Dowd,C,WSH,34,62,9,20,29
3,8482117,Lukas Reichel,L,CHI,22,60,9,20,29
3,8483490,Pavel Mintyukov,D,ANA,21,69,8,21,29
3,8475171,Oliver Ekman-Larsson,D,TOR,33,62,7,22,29
3,8478970,Jalen Chatfield,D,CAR,28,66,6,23,29
3,8474151,Ryan McDonagh,D,TBL,35,79,6,23,29
3,8478882,Vladislav Gavrikov,D,LAK,29,71,5,24,29
3,8474189,Lars Eller,C,PIT,35,63,20,8,28
3,8470621,Corey Perry,R,EDM,39,69,14,14,28
3,8475760,Nick Bjugstad,C,UTA,32,68,12,16,28
3,8480003,Jesper Boqvist,C,FLA,26,65,11,17,28
3,8475193,Tomas Tatar,L,NJD,34,64,10,18,28
3,8480893,Kirill Marchenko,R,CBJ,24,61,17,10,27
3,8479619,Michael Carcone,L,UTA,28,67,17,10,27
3,8479365,Trent Frederic,C,BOS,26,76,14,13,27
3,8482475,Yegor Chinakhov,R,CBJ,23,59,14,13,27
3,8482079,Marco Rossi,C,MIN,23,57,14,13,27
3,8477478,William Carrier,L,CAR,30,56,14,13,27
3,8482074,Connor Zary,C,CGY,23,65,13,14,27
3,8479353,Brett Howden,C,VGK,26,77,12,15,27
3,8482101,Danil Gushchin,L,SJS,22,57,11,16,27
3,8483493,Frank Nazar,C,CHI,20,53,11,16,27
3,8477497,Sean Monahan,C,CBJ,30,68,9,18,27
3,8477505,Alexander Wennberg,C,SJS,30,61,9,18,27
3,8480336,Sean Walker,D,CAR,30,74,8,19,27
3,8476885,Jacob Trouba,D,NYR,30,65,6,21,27
3,8482055,Drew O'Connor,L,PIT,26,66,14,12,26
3,8481704,Juuso Parssinen,C,NSH,23,50,13,13,26
3,8479293,Brandon Tanev,L,SEA,33,67,13,13,26
3,8475842,Sam Carrick,C,NYR,32,60,12,14,26
3,8481093,Rafael Harvey-Pinard,L,MTL,25,57,11,15,26
3,8484203,Bradly Nadeau,L,CAR,19,57,10,16,26
3,8481580,Connor McMichael,C,WSH,23,60,9,17,26
3,8482624,Daniil Miromanov,D,CGY,27,66,8,18,26
3,8482067,Connor Mackey,D,NYR,28,61,8,18,26
3,8476918,Jimmy Vesey,L,NYR,31,68,8,18,26
3,8482087,Kaiden Guhle,D,MTL,22,66,6,20,26
3,8482073,Braden Schneider,D,NYR,23,70,2,24,26
3,8481477,Nico Sturm,C,SJS,29,55,19,6,25
3,8479336,Carl Grundstrom,R,SJS,27,43,18,7,25
3,8480762,Eric Robinson,L,CAR,29,57,17,8,25
3,8479390,Taylor Raddysh,R,WSH,26,63,12,13,25
3,8475220,Marcus Foligno,L,MIN,33,60,11,14,25
3,8476457,Adam Larsson,D,SEA,32,66,10,15,25
3,8479345,Jakob Chychrun,D,WSH,26,60,8,17,25
3,8477435,Ryan Graves,D,PIT,29,75,7,18,25
3,8476856,Mathew Dumba,D,DAL,30,69,6,19,25
3,8482245,Artem Zub,D,OTT,29,70,5,20,25
3,8483499,Liam Ohgren,L,MIN,20,54,4,21,25
3,8477220,Nate Schmidt,D,FLA,33,71,3,22,25
3,8482125,Alexander Holtz,R,VGK,22,66,16,8,24
3,8480829,Jesperi Kotkaniemi,C,CAR,24,64,14,10,24
3,8478432,Christian Fischer,R,DET,27,75,13,11,24
3,8480113,Alex Iafallo,L,WPG,31,68,12,12,24
3,8476925,Colton Sissons,C,NSH,31,64,12,12,24
3,8479661,Tanner Jeannot,L,LAK,27,77,10,14,24
3,8477952,Robby Fabbri,C,ANA,28,62,10,14,24
3,8473507,Jeff Petry,D,DET,37,73,5,19,24
3,8481178,Egor Zamula,D,PHI,24,52,4,20,24
3,8480049,Dylan Samberg,D,WPG,25,65,4,20,24
3,8478500,Ivan Provorov,D,CBJ,27,77,2,22,24
3,8476878,Zemgus Girgensons,C,TBL,30,80,15,8,23
3,8480144,David Kampf,C,TOR,29,66,12,11,23
3,8476461,Sean Couturier,C,PHI,32,68,10,13,23
3,8480789,Oliver Wahlstrom,R,NYI,24,68,8,15,23
3,8475791,Taylor Hall,L,CHI,33,49,7,16,23
3,8474574,Tyler Myers,D,VAN,34,73,6,17,23
3,8475218,Mattias Ekholm,D,EDM,34,74,4,19,23
3,8476917,Adam Pelech,D,NYI,30,78,4,19,23
3,8476891,Matthew Grzelcyk,D,PIT,30,74,4,19,23
3,8474673,TJ Brodie,D,CHI,34,63,0,23,23
3,8482259,Bobby McMann,C,TOR,28,67,15,7,22
3,8482089,Jake Neighbours,L,STL,22,68,14,8,22
3,8479718,Alex Barré-Boulet,C,MTL,27,52,14,8,22
3,8480748,Kiefer Sherwood,L,VAN,29,63,10,12,22
3,8475149,Marcus Johansson,L,MIN,34,58,9,13,22
3,8482679,Matt Coronato,R,CGY,22,65,9,13,22
3,8478463,Anthony Beauvillier,L,PIT,27,64,7,15,22
3,8476329,Travis Boyd,C,MIN,31,56,6,16,22
3,8476525,Colin Miller,D,WPG,32,64,6,16,22
3,8475181,Nick Leddy,D,STL,33,73,3,19,22
3,8479369,Andrew Peeke,D,BOS,26,61,3,19,22
3,8479996,Cody Glass,C,NSH,25,63,15,6,21
3,8479414,Nathan Bastian,R,NJD,27,58,14,7,21
3,8480205,Emil Bemstrom,C,PIT,25,54,13,8,21
3,8476960,Andreas Athanasiou,C,CHI,30,52,11,10,21
3,8479066,Ryan Lomberg,L,CGY,30,61,9,12,21
3,8481527,Kaedan Korczak,D,VGK,23,52,6,15,21
3,8480355,Mark Kastelic,C,BOS,25,63,5,16,21
3,8475188,Brayden McNabb,D,VGK,33,55,5,16,21
3,8479976,Juuso Valimaki,D,UTA,26,58,3,18,21
3,8473563,Nicklas Backstrom,C,WSH,37,54,2,19,21
3,8482157,Will Cuylle,L,NYR,22,60,13,7,20
3,8481582,Nicholas Robertson,L,TOR,23,71,9,11,20
3,8482807,Ethan Del Mastro,D,CHI,21,51,8,12,20
3,8482730,Brandt Clarke,D,LAK,21,55,7,13,20
3,8470600,Ryan Suter,D,STL,39,65,7,13,20
3,8481441,Joe Snively,C,DET,28,61,6,14,20
3,8483565,Nick Blankenburg,D,NSH,26,62,6,14,20
3,8477406,Mattias Janmark,C,EDM,32,64,5,15,20
3,8480073,Erik Brannstrom,D,COL,25,57,5,15,20
3,8477506,Ryan Pulock,D,NYI,30,76,3,17,20
3,8481522,Peyton Krebs,C,BUF,23,61,3,17,20
3,8475690,Chris Tanev,D,TOR,35,64,2,18,20
3,8479982,Conor Timmins,D,TOR,26,56,2,18,20
3,8480995,Pontus Holmberg,R,TOR,25,53,15,4,19
3,8477987,Ryan Donato,C,CHI,28,60,11,8,19
3,8481032,Paul Cotter,C,NJD,25,58,11,8,19
3,8479520,Brandon Duhaime,R,WSH,27,58,11,8,19
3,8481601,Simon Holmstrom,R,NYI,23,69,10,9,19
3,8480980,Connor Dewar,C,TOR,25,65,9,10,19
3,8475225,Craig Smith,C,CHI,35,48,9,10,19
3,8477508,Curtis Lazar,C,NJD,29,64,9,10,19
3,8480025,MacKenzie Entwistle,R,FLA,25,69,8,11,19
3,8477839,Conor Sheary,L,TBL,32,82,7,12,19
3,8477425,Miles Wood,L,COL,29,79,7,12,19
3,8480806,Isac Lundestrom,C,ANA,25,61,7,12,19
3,8478451,Ethan Bear,D,WSH,27,49,3,16,19
3,8479371,Dante Fabbro,D,NSH,26,67,2,17,19
3,8475324,Nick Jensen,D,OTT,34,67,1,18,19
3,8476822,Luke Glendening,C,TBL,35,78,12,6,18
3,8483524,Shane Wright,C,SEA,20,65,11,7,18
3,8477446,Michael McCarron,R,NSH,29,52,10,8,18
3,8483445,Cutter Gauthier,L,ANA,20,69,10,8,18
3,8480252,Cole Guttman,C,CHI,25,43,10,8,18
3,8471817,Ryan Reaves,R,TOR,37,64,10,8,18
3,8478013,Jake Walman,D,SJS,28,76,9,9,18
3,8480448,Parker Kelly,L,COL,25,76,9,9,18
3,8476374,Sean Kuraly,C,CBJ,31,65,9,9,18
3,8477353,Tyler Motte,C,DET,29,76,8,10,18
3,8478585,Derek Ryan,C,EDM,38,63,8,10,18
3,8481481,Blake Lizotte,C,PIT,27,64,7,11,18
3,8482148,Hendrix Lapierre,C,WSH,22,57,7,11,18
3,8478569,Noel Acciari,C,PIT,33,59,7,11,18
3,8479983,Mario Ferraro,D,SJS,26,72,4,14,18
3,8475790,Erik Gudbranson,D,CBJ,32,78,4,14,18
3,8478399,Jonas Siegenthaler,D,NJD,27,55,4,14,18
3,8480035,Henri Jokiharju,D,BUF,25,63,3,15,18
3,8480058,Pierre-Olivier Joseph,D,STL,25,51,3,15,18
3,8479980,Nicolas Hague,D,VGK,26,61,2,16,18
3,8479398,Samuel Girard,D,COL,26,62,0,18,18
3,8478851,Alexandre Carrier,D,NSH,28,67,0,18,18
3,8477380,Jonny Brodzinski,C,NYR,31,50,10,7,17
3,8476889,Radek Faksa,C,STL,30,63,10,7,17
3,8481517,Brett Leason,R,ANA,25,56,9,8,17
3,8482747,Brennan Othmann,L,NYR,21,42,9,8,17
3,8476873,Mark Jankowski,C,NSH,30,55,8,9,17
3,8480878,Nils Lundkvist,D,DAL,24,70,7,10,17
3,8478043,Sam Lafferty,C,BUF,29,64,6,11,17
3,8477969,Marcus Pettersson,D,PIT,28,77,5,12,17
3,8479026,Philippe Myers,D,TOR,27,57,5,12,17
3,8480796,Martin Fehervary,D,WSH,25,59,5,12,17
3,8475179,Dmitry Kulikov,D,FLA,34,65,5,12,17
3,8477979,Nicolas Aube-Kubel,R,BUF,28,60,5,12,17
3,8479402,Jake Bean,D,CGY,26,72,4,13,17
3,8482192,Isaak Phillips,D,CHI,23,50,4,13,17
3,8479348,Kale Clague,D,BUF,26,41,4,13,17
3,8477845,Trevor van Riemsdyk,D,WSH,33,55,3,14,17
3,8479372,Joshua Mahura,D,SEA,26,54,2,15,17
3,8477499,Rasmus Ristolainen,D,PHI,30,57,1,16,17
3,8478416,Erik Cernak,D,TBL,27,72,0,17,17
3,8478211,Dryden Hunt,L,CGY,29,53,8,8,16
3,8483491,Ivan Miroshnichenko,L,WSH,20,56,8,8,16
3,8477392,Hudson Fasching,R,NYI,29,63,7,9,16
3,8481014,Alexander Romanov,D,NYI,24,79,6,10,16
3,8482749,Joshua Roy,R,MTL,21,63,6,10,16
3,8475231,Casey Cizikas,C,NYI,33,71,5,11,16
3,8476312,Josh Manson,D,COL,33,63,5,11,16
3,8476988,Matt Benning,D,SJS,30,63,3,13,16
3,8475233,David Savard,D,MTL,34,62,3,13,16
3,8476429,Scott Mayfield,D,NYI,32,77,3,13,16
3,8478178,Darren Raddysh,D,TBL,28,68,3,13,16
3,8480860,Kevin Bahl,D,CGY,24,57,2,14,16
3,8476879,Cody Ceci,D,EDM,31,71,2,14,16
3,8475208,Brian Dumoulin,D,ANA,33,59,0,16,16
3,8476278,Colin Blackwell,C,DAL,31,73,10,5,15
3,8479941,Justin Danforth,R,CBJ,31,52,10,5,15
3,8477903,Garnet Hathaway,R,PHI,33,65,9,6,15
3,8479439,Jacob MacDonald,D,COL,31,52,8,7,15
3,8480281,Alexey Toropchenko,R,STL,25,57,8,7,15
3,8476469,Joel Armia,R,MTL,31,60,7,8,15
3,8478434,Keegan Kolesar,R,VGK,27,63,7,8,15
3,8482803,Olen Zellweger,D,ANA,21,68,7,8,15
3,8476467,Jamie Oleksiak,D,SEA,32,73,7,8,15
3,8475235,Nicolas Deslauriers,L,PHI,33,65,7,8,15
3,8475279,Ben Chiarot,D,DET,33,61,6,9,15
3,8484149,Gavin Brindley,C,CBJ,20,47,6,9,15
3,8478468,Jeremy Lauzon,D,NSH,27,53,6,9,15
3,8482809,Jackson Blake,R,CAR,21,56,5,10,15
3,8479344,Jesse Puljujarvi,R,PIT,26,53,5,10,15
3,8477507,Nikita Zadorov,D,BOS,29,69,4,11,15
3,8476372,Nick Seeler,D,PHI,31,45,4,11,15
3,8480043,Timothy Liljegren,D,TOR,25,71,3,12,15
3,8481521,Ronnie Attard,D,PHI,25,56,3,12,15
3,8479998,Mikey Anderson,D,LAK,25,61,3,12,15
3,8479324,Ryan Lindgren,D,NYR,26,69,2,13,15
3,8474612,Travis Hamonic,D,OTT,34,47,2,13,15
3,8480246,Nick Perbix,D,TBL,26,73,1,14,15
3,8479328,Julien Gauthier,R,NYI,27,68,10,4,14
3,8481716,Dmitri Voronkov,L,CBJ,24,45,10,4,14
3,8483482,Tristan Luneau,D,ANA,20,68,8,6,14
3,8477015,Connor Brown,R,EDM,30,60,7,7,14
3,8476422,Mike Reilly,D,NYI,31,75,6,8,14
3,8480289,Morgan Barron,C,WPG,26,56,5,9,14
3,8477931,Tomas Nosek,L,FLA,32,62,5,9,14
3,8482451,Mikael Pyyhtia,L,CBJ,23,47,4,10,14
3,8474567,Zach Bogosian,D,MIN,34,58,4,10,14
3,8476441,Joel Edmundson,D,LAK,31,40,4,10,14
3,8483495,Simon Nemec,D,NJD,20,65,3,11,14
3,8480891,Michael Kesselring,D,UTA,24,57,3,11,14
3,8478452,Caleb Jones,D,LAK,27,57,1,13,14
3,8476967,Brett Kulak,D,EDM,30,64,0,14,14
3,8481518,Nolan Foote,L,NJD,24,43,9,4,13
3,8480848,Ty Dellandrea,C,SJS,24,45,9,4,13
3,8478508,Yakov Trenin,C,MIN,27,61,8,5,13
3,8483457,Lane Hutson,D,MTL,20,67,6,7,13
3,8482737,Zack Bolduc,C,STL,21,53,6,7,13
3,8480021,Jack Studnicka,C,LAK,25,57,5,8,13
3,8479671,Mathieu Olivier,R,CBJ,27,50,4,9,13
3,8483460,David Jiricek,D,CBJ,21,55,4,9,13
3,8476934,Brock McGinn,L,ANA,30,54,4,9,13
3,8481550,Adam Beckman,L,NJD,23,42,3,10,13
3,8475177,Calvin de Haan,D,COL,33,51,3,10,13
3,8481598,Philip Broberg,D,EDM,23,41,3,10,13
3,8476994,Vinnie Hinostroza,C,NSH,30,47,2,11,13
3,8480001,Urho Vaakanainen,D,ANA,25,54,1,12,13
3,8478840,Will Borgen,D,SEA,28,66,1,12,13
3,8479249,Andrew Poturalski,C,SJS,30,31,1,12,13
3,8480172,Jan Rutta,D,SJS,34,62,0,13,13
3,8481028,Martin Pospisil,C,CGY,25,57,7,5,12
3,8482762,Simon Edvinsson,D,DET,21,61,7,5,12
3,8481013,Jonatan Berggren,R,DET,24,56,7,5,12
3,8481617,Vasily Podkolzin,R,VAN,23,54,6,6,12
3,8476442,Matt Nieto,L,PIT,32,49,6,6,12
3,8480990,Declan Chisholm,D,MIN,24,44,6,6,12
3,8477962,Brendan Lemieux,L,CAR,28,39,6,6,12
3,8482077,Dylan Holloway,L,EDM,23,53,5,7,12
3,8474034,Patrick Maroon,L,CHI,36,42,5,7,12
3,8479370,Tyson Jost,C,CAR,26,50,4,8,12
3,8480807,Mattias Samuelsson,D,BUF,24,58,4,8,12
3,8479359,Beck Malenstyn,L,BUF,26,47,3,9,12
3,8477369,Carson Soucy,D,VAN,30,59,3,9,12
3,8482176,Wyatt Kaiser,D,CHI,22,59,3,9,12
3,8479639,Dylan Coghlan,D,WPG,26,52,2,10,12
3,8482095,Tyler Kleven,D,OTT,22,44,2,10,12
3,8481708,Zac Jones,D,NYR,24,43,2,10,12
3,8477938,Haydn Fleury,D,WPG,28,51,2,10,12
3,8475462,Radko Gudas,D,ANA,34,63,2,10,12
3,8478859,Niko Mikkola,D,FLA,28,56,1,11,12
3,8480950,Ilya Lyubushkin,D,DAL,30,67,0,12,12
3,8479968,Vinni Lettieri,C,BOS,29,47,9,2,11
3,8479316,Luke Kunin,C,SJS,27,51,5,6,11
3,8483468,Jiri Kulich,C,BUF,20,50,5,6,11
3,8482859,Zack Ostapchuk,C,OTT,21,44,4,7,11
3,8477070,Liam O'Brien,C,UTA,30,57,4,7,11
3,8481532,Alex Turcotte,C,LAK,23,47,4,7,11
3,8478831,Kevin Stenlund,C,UTA,28,51,4,7,11
3,8479994,Jaret Anderson-Dolan,C,WPG,25,44,4,7,11
3,8473446,Erik Johnson,D,PHI,36,56,4,7,11
3,8481537,Nikita Okhotiuk,D,CGY,24,52,3,8,11
3,8475455,Brenden Dillon,D,NJD,34,52,2,9,11
3,8474568,Luke Schenn,D,NSH,35,43,2,9,11
3,8483466,Kevin Korchinski,D,CHI,20,49,2,9,11
3,8480879,Jacob Bernard-Docker,D,OTT,24,44,2,9,11
3,8481605,Jackson LaCombe,D,ANA,23,35,1,10,11
3,8473453,Trevor Lewis,C,LAK,37,70,8,2,10
3,8483012,Logan Morrison,C,SEA,22,30,7,3,10
3,8482496,Nils Aman,C,VAN,24,32,6,4,10
3,8481147,Reese Johnson,C,MIN,26,41,6,4,10
3,8479986,Kole Lind,R,DAL,26,51,4,6,10
3,8475762,Derek Forbort,D,VAN,32,57,4,6,10
3,8477034,Jaycob Megna,D,FLA,32,42,3,7,10
3,8480070,Ian Mitchell,D,BOS,25,55,3,7,10
3,8481059,Scott Perunovich,D,STL,26,56,2,8,10
3,8477018,Ben Hutton,D,VGK,31,52,2,8,10
3,8481568,Alex Vlasic,D,CHI,23,51,2,8,10
3,8482964,Arber Xhekaj,D,MTL,23,49,2,8,10
3,8481600,Tobias Bjornfot,D,FLA,23,35,2,8,10
3,8480157,Calle Rosen,D,COL,30,42,1,9,10
3,8477365,Connor Clifton,D,BUF,29,52,1,9,10
3,8480222,Sebastian Aho,D,PIT,28,67,0,10,10
3,8482652,Walker Duehr,R,CGY,27,40,7,2,9
3,8480074,Alexandre Texier,C,STL,25,53,5,4,9
3,8482659,Josh Doan,R,UTA,22,50,5,4,9
3,8478421,A.J. Greer,L,FLA,28,54,5,4,9
3,8479981,Jonah Gadjovich,L,FLA,26,49,5,4,9
3,8478424,Jansen Harkins,C,ANA,27,33,5,4,9
3,8477573,Nathan Walker,L,STL,30,55,4,5,9
3,8481161,Jake Christiansen,D,CBJ,25,58,4,5,9
3,8480007,Jonas Rondbjerg,R,VGK,25,33,4,5,9
3,8478136,Jake Middleton,D,MIN,28,74,2,7,9
3,8482634,Alex Steeves,C,TOR,25,40,2,7,9
3,8480727,Zach Whitecloud,D,VGK,28,45,2,7,9
3,8480292,Carson Meyer,R,ANA,27,37,2,7,9
3,8475718,Justin Holl,D,DET,32,56,1,8,9
3,8477851,Jordan Oesterle,D,BOS,32,34,1,8,9
3,8476867,Brendan Gaunce,C,MIN,30,35,1,8,9
3,8479442,Troy Stecher,D,EDM,30,51,1,8,9
3,8476858,Phillip Di Giuseppe,L,VAN,31,47,6,2,8
3,8479291,Kevin Rooney,C,CGY,31,57,5,3,8
3,8481641,Joel Kiviranta,L,COL,28,65,4,4,8
3,8479368,Max Jones,L,BOS,26,58,4,4,8
3,8477482,Zachary Sanford,L,CHI,30,34,4,4,8
3,8482666,Scott Morrow,D,CAR,22,50,4,4,8
3,8482744,James Malatesta,L,CBJ,21,39,4,4,8
3,8481754,Nikita Nesterenko,C,ANA,23,34,4,4,8
3,8481751,Lukas Rousek,R,BUF,25,42,3,5,8
3,8478443,Brandon Carlo,D,BOS,28,62,3,5,8
3,8476874,Olli Maatta,D,DET,30,64,3,5,8
3,8474166,Alec Martinez,D,CHI,37,49,3,5,8
3,8481567,Henry Thrun,D,SJS,23,46,3,5,8
3,8481592,Jakob Pelletier,L,CGY,23,35,3,5,8
3,8475958,Michael Sgarbossa,C,WSH,32,31,3,5,8
3,8481599,Victor Soderstrom,D,UTA,23,43,2,6,8
3,8477335,Kyle Burroughs,D,LAK,29,34,2,6,8
3,8484254,Akito Hirose,D,VAN,25,35,2,6,8
3,8483397,Marc McLaughlin,C,BOS,25,30,2,6,8
3,8480011,Klim Kostin,C,SJS,25,48,1,7,8
3,8479378,Logan Stanley,D,WPG,26,39,1,7,8
3,8481056,Spencer Stastney,D,NSH,24,32,1,7,8
3,8479972,Mason Shaw,C,WPG,26,23,0,8,8
3,8481167,Brayden Pachal,D,CGY,25,44,0,8,8
3,8476473,Connor Murphy,D,CHI,31,43,0,8,8
3,8481789,Tye Kartye,L,SEA,23,39,6,1,7
3,8480880,Jakub Lauko,C,MIN,24,37,4,3,7
3,8480844,Grigori Denisenko,L,VGK,24,33,4,3,7
3,8481609,Vladislav Kolyachonok,D,UTA,23,43,4,3,7
3,8483630,Pavol Regenda,L,ANA,25,29,4,3,7
3,8479944,Zach Aston-Reese,C,VGK,30,52,3,4,7
3,8479543,Michael Pezzetta,L,MTL,26,47,3,4,7
3,8480192,Johnathan Kovacevic,D,NJD,27,48,3,4,7
3,8482511,Mason Lohrei,D,BOS,23,30,3,4,7
3,8482166,Shakir Mukhamadullin,D,SJS,22,55,2,5,7
3,8477527,Ross Johnston,L,ANA,30,32,2,5,7
3,8481019,David Gustafsson,C,WPG,24,41,1,6,7
3,8482784,Zach Dean,C,STL,21,39,1,6,7
3,8471709,Marc-Edouard Vlasic,D,SJS,37,62,1,6,7
3,8475750,Jon Merrill,D,MIN,32,54,1,6,7
3,8483619,Filip Roos,D,OTT,25,31,1,6,7
3,8476913,Devin Shore,C,MIN,30,27,1,6,7
3,8480845,Rasmus Kupari,C,WPG,24,40,5,1,6
3,8479536,Axel Jonsson-Fjallby,L,WPG,26,35,4,2,6
3,8476624,Barclay Goodrow,C,SJS,31,51,3,3,6
3,8482751,Ryan Winterton,C,SEA,21,33,3,3,6
3,8478409,Anthony Richard,C,PHI,28,33,3,3,6
3,8482861,Vincent Iorio,D,WSH,22,36,3,3,6
3,8474013,Ian Cole,D,UTA,35,50,3,3,6
3,8480887,Jordan Harris,D,MTL,24,55,2,4,6
3,8478017,Mark Friedman,D,VAN,29,34,2,4,6
3,8483549,Lucas Condotta,L,MTL,27,40,2,4,6
3,8481679,Maxence Guenette,D,OTT,23,38,2,4,6
3,8482858,Ryker Evans,D,SEA,23,24,2,4,6
3,8480441,Trey Fix-Wolansky,R,CBJ,25,39,1,5,6
3,8482165,Yan Kuznetsov,D,CGY,22,18,1,5,6
3,8481122,Simon Benoit,D,TOR,26,31,1,5,6
3,8477384,Joshua Brown,D,EDM,30,36,1,5,6
3,8482153,Brendan Brisson,C,VGK,23,32,4,1,5
3,8479772,Zack MacEwen,R,OTT,28,49,3,2,5
3,8482144,Jack Thompson,D,SJS,22,24,3,2,5
3,8479991,Jake Leschyshyn,C,NYR,25,24,3,2,5
3,8480267,Sammy Walker,C,MIN,25,19,3,2,5
3,8481422,Jake Lucchini,C,NSH,29,27,3,2,5
3,8480084,Nick DeSimone,D,NJD,30,21,3,2,5
3,8482172,Landon Slaggert,L,CHI,22,27,3,2,5
3,8475413,Justin Dowling,C,NJD,34,19,2,3,5
3,8480196,Jacob Bryson,D,BUF,27,38,1,4,5
3,8480834,Ty Emberson,D,SJS,24,32,1,4,5
3,8478454,Noah Juulsen,D,VAN,27,35,1,4,5
3,8480870,Bo Groulx,C,NYR,24,41,1,4,5
3,8478477,Mitchell Stephens,C,SEA,27,24,0,5,5
3,8482070,Mitchell Chaffee,R,TBL,26,48,3,1,4
3,8482713,Mackie Samoskevich,R,FLA,22,37,3,1,4
3,8479985,Cale Fleury,D,SEA,26,24,3,1,4
3,8477073,Kurtis MacDermid,L,NJD,30,27,3,1,4
3,8482765,Isak Rosen,R,BUF,21,24,3,1,4
3,8482147,Jean-Luc Foudy,C,COL,22,25,3,1,4
3,8479638,Justin Brazeau,R,BOS,26,37,2,2,4
3,8480245,Olle Lycksell,R,PHI,25,27,2,2,4
3,8471677,Jack Johnson,D,CBJ,37,65,2,2,4
3,8478874,Adam Gaudette,R,OTT,28,36,2,2,4
3,8482102,Vasily Ponomarev,C,PIT,22,23,2,2,4
3,8477887,Patrick Brown,C,BOS,32,46,1,3,4
3,8477462,Robert Hagg,D,VGK,29,27,1,3,4
3,8478450,Parker Wotherspoon,D,BOS,27,32,1,3,4
3,8481556,John Beecher,C,BOS,23,28,1,3,4
3,8478021,William Lagesson,D,DET,28,27,1,3,4
3,8474090,Brendan Smith,D,DAL,35,50,0,4,4
3,8484287,Cole McWard,D,VAN,23,25,0,4,4
3,8477401,John Hayden,C,SEA,29,32,2,1,3
3,8477971,Andreas Englund,D,LAK,28,30,2,1,3
3,8478146,Matthew Highmore,C,OTT,28,31,2,1,3
3,8479362,Riley Tufte,L,BOS,26,16,2,1,3
3,8481585,Egor Afanasyev,L,SJS,23,13,2,1,3
3,8477473,Justin Bailey,R,SJS,29,27,1,2,3
3,8479379,Givani Smith,R,SJS,26,26,1,2,3
3,8477149,Scott Sabourin,R,SJS,32,25,1,2,3
3,8482141,Lukas Cormier,D,VGK,22,25,1,2,3
3,8476952,Dominic Toninato,C,WPG,30,33,1,2,3
3,8478051,Max Willman,C,NJD,29,20,1,2,3
3,8481701,Santeri Hatakka,D,NJD,23,42,0,3,3
3,8480890,Jan Jenik,C,OTT,24,20,0,3,3
3,8481030,Jack St. Ivany,D,PIT,25,22,0,3,3
3,8477467,Gustav Olofsson,D,SEA,30,17,2,0,2
3,8481543,Nikita Alexandrov,C,STL,24,27,2,0,2
3,8482787,Nikita Chibrikov,R,WPG,31,10,2,0,2
3,8483471,Brad Lambert,C,WPG,31,17,2,0,2
3,8481726,Adam Edstrom,C,NYR,24,11,2,0,2
3,8484911,Collin Graf,R,SJS,22,38,1,1,2
3,8482733,Logan Mailloux,D,MTL,31,32,1,1,2
3,8480468,James Hamblin,L,EDM,25,20,1,1,2
3,8475795,Dylan McIlrath,D,WSH,32,17,1,1,2
3,8477320,Anton Blidh,L,NYR,29,13,1,1,2
3,8481206,John Ludvig,D,PIT,24,11,1,1,2
3,8478502,Dennis Gilbert,D,BUF,28,18,1,1,2
3,8482061,Brandon Biro,L,SEA,26,12,1,1,2
3,8482094,Daemon Hunt,D,MIN,22,14,1,1,2
3,8481024,Linus Karlsson,C,VAN,25,10,1,1,2
3,8480075,Cameron Crotty,D,MIN,25,15,1,1,2
3,8481043,Cole Koepke,L,BOS,26,19,1,1,2
3,8482118,Sam Colangelo,R,ANA,23,18,1,1,2
3,8477244,Chad Ruhwedel,D,NYR,34,30,0,2,2
3,8479320,Maxime Lajoie,D,SEA,27,20,0,2,2
3,8484258,Sam Malinski,D,COL,26,28,0,2,2
3,8479576,Vincent Desharnais,D,VAN,28,28,0,2,2
3,8481719,Maxwell Crozier,D,TBL,24,18,0,2,2
3,8481564,Ryan Johnson,D,BUF,23,16,0,2,2
3,8480032,Shane Bowers,C,NJD,25,15,0,2,2
3,8482126,Emil Andrae,D,PHI,31,4,0,2,2
3,8481065,Angus Crookshank,L,OTT,25,23,0,2,2
3,8480851,Akil Thomas,C,LAK,24,18,0,2,2
3,8483398,Declan Carlile,D,TBL,31,6,0,2,2
3,8482201,Gage Goncalves,C,TBL,23,27,0,2,2
3,8479587,Rhett Gardner,C,PHI,28,22,0,2,2
3,8478881,Brett Seney,L,CHI,28,15,1,0,1
3,8482145,Mavrik Bourque,C,DAL,22,50,1,0,1
3,8483395,Arshdeep Bains,L,VAN,23,12,1,0,1
3,8474062,Riley Nash,C,NYR,35,15,1,0,1
3,8477993,Justin Kirkland,C,CGY,28,10,1,0,1
3,8482250,Callahan Burke,C,VGK,27,21,1,0,1
3,8481699,Aku Raty,R,UTA,23,13,1,0,1
3,8475755,Alexander Petrovic,D,DAL,32,10,1,0,1
3,8478446,Glenn Gawdin,C,LAK,27,6,1,0,1
3,8484255,Jason Polin,R,COL,25,3,1,0,1
3,8483489,Fraser Minten,C,TOR,31,6,1,0,1
3,8483567,Georgii Merkulov,C,BOS,24,11,1,0,1
3,8480823,Alexander Alexeyev,D,WSH,25,19,1,0,1
3,8482177,Marat Khusnutdinov,C,MIN,22,35,0,1,1
3,8483763,Maksymilian Szuber,D,UTA,22,25,0,1,1
3,8481541,Samuel Bolduc,D,NYI,24,23,0,1,1
3,8481237,Kyle MacLean,C,NYI,25,25,0,1,1
3,8483570,Ben Meyers,C,SEA,26,29,0,1,1
3,8482929,Emil Lilleberg,D,TBL,23,21,0,1,1
3,8484325,Waltteri Merela,C,TBL,26,23,0,1,1
3,8482162,Roby Jarventie,L,EDM,22,20,0,1,1
3,8481462,Mason Morelli,L,VGK,28,11,0,1,1
3,8481743,Marc Del Gaizo,D,NSH,25,18,0,1,1
3,8481006,Tyler Tucker,D,STL,24,12,0,1,1
3,8479419,Brett Murray,L,BUF,26,20,0,1,1
3,8482197,Adam Raska,R,MIN,23,3,0,1,1
3,8483546,Marshall Rifai,D,TOR,26,6,0,1,1
3,8483920,Pierrick Dube,R,WSH,23,6,0,1,1
3,8480874,Adam Ginning,D,PHI,24,7,0,1,1
3,8483597,Milos Kelemen,L,UTA,25,12,0,1,1
3,8479367,William Lockwood,R,FLA,26,30,0,0,0
3,8481806,Louis Crevier,D,CHI,23,10,0,0,0
3,8477541,Dakota Mermis,D,TOR,30,8,0,0,0
3,8477810,Joel Hanley,D,CGY,33,20,0,0,0
3,8482516,Matthew Kessel,D,STL,24,12,0,0,0
3,8482470,Ilya Solovyov,D,CGY,24,17,0,0,0
3,8475780,Chris Wagner,R,COL,33,9,0,0,0
3,8484326,Patrik Koch,D,UTA,28,3,0,0,0
3,8478011,Louie Belpedio,D,PHI,28,8,0,0,0
3,8481593,Jayden Struble,D,MTL,23,24,0,0,0
3,8483512,Matthew Savoie,C,EDM,20,14,0,0,0
3,8480306,Grant Hutton,D,NYI,29,2,0,0,0
3,8479522,Hardy Haman Aktell,D,WSH,26,2,0,0,0
3,8476323,Max McCormick,L,SEA,32,3,0,0,0
3,8483407,Brandon Scanlin,D,NYR,25,6,0,0,0
3,8484304,Uvis Balinskis,D,FLA,28,9,0,0,0
3,8481655,Cole Schwindt,R,CGY,23,3,0,0,0
3,8483432,Luca Del Bel Belluz,C,CBJ,31,3,0,0,0
3,8482088,Justin Sourdif,R,FLA,22,19,0,0,0
3,8482460,Matt Rempe,C,NYR,22,9,0,0,0
3,8484259,Ondrej Pavel,C,COL,31,1,0,0,0
3,8481578,Graeme Clarke,R,MIN,23,10,0,0,0
3,8479421,Jacob Moverare,D,LAK,26,4,0,0,0
3,8470794,Joe Pavelski,C,,40,0,0,0,0
3,8479321,Lucas Johansen,D,,27,0,0,0,0
3,8477950,Tony DeAngelo,D,,29,0,0,0,0
3,8471218,Blake Wheeler,R,,38,0,0,0,0
3,8475197,Tyson Barrie,D,,33,0,0,0,0
3,8474157,Max Pacioretty,L,,36,0,0,0,0
3,8475744,Evgeny Kuznetsov,C,,32,0,0,0,0
3,8474037,James van Riemsdyk,L,,35,0,0,0,0
3,8476907,Mackenzie MacEachern,L,,30,0,0,0,0
3,8480216,Jacob Peterson,C,,25,0,0,0,0
3,8474602,Justin Schultz,D,,34,0,0,0,0
3,8482222,Alexander Barabanov,L,,30,0,0,0,0
3,8474031,Kevin Shattenkirk,D,,35,0,0,0,0
3,8477330,Dominik Kubalik,L,,29,0,0,0,0
3,8480884,Calen Addison,D,,24,0,0,0,0
3,8475906,John Klingberg,D,,32,0,0,0,0
3,8480008,Adam Ruzicka,C,,25,0,0,0,0
3,8476884,Derrick Pouliot,D,,30,0,0,0,0
3,8476919,Chris Tierney,C,,30,0,0,0,0
3,8479415,Michael McLeod,C,,26,0,0,0,0
3,8474870,Tyler Johnson,C,,34,0,0,0,0
3,8470604,Jeff Carter,C,,39,0,0,0,0
3,8478104,Sammy Blais,L,,28,0,0,0,0
3,8474884,Mike Hoffman,C,,35,0,0,0,0
3,8481591,Sam Poulin,R,,23,0,0,0,0
3,8471274,Alex Goligoski,D,,39,0,0,0,0
3,8476871,Tanner Pearson,L,,32,0,0,0,0
3,8476393,Nick Cousins,C,,31,0,0,0,0
3,8479977,Kailer Yamamoto,R,,26,0,0,0,0
3,8479346,Dillon Dube,C,,26,0,0,0,0
3,8480184,Gustav Lindstrom,D,,26,0,0,0,0
3,8479376,Victor Mete,D,,26,0,0,0,0
3,8473449,Kyle Okposo,R,,36,0,0,0,0
3,8481058,Jesse Ylonen,R,,25,0,0,0,0
3,8475752,Tyler Pitlick,C,,33,0,0,0,0
3,8481239,Samuel Fagemo,L,,24,0,0,0,0
3,8480821,Filip Zadina,R,,25,0,0,0,0
3,8470966,Mark Giordano,D,,41,0,0,0,0
3,8478495,Denis Gurianov,R,,27,0,0,0,0
3,8477464,Nic Petan,C,,29,0,0,0,0
3,8478099,Kevin Labanc,R,,29,0,0,0,0
3,8482241,Radim Zohorna,L,,28,0,0,0,0
3,8474040,Sam Gagner,C,,35,0,0,0,0
3,8479514,Rem Pitlick,C,,27,0,0,0,0
3,8478430,Oliver Kylington,D,,27,0,0,0,0
3,8479533,Joona Koppanen,L,,26,0,0,0,0
3,8479984,Cal Foote,D,,26,0,0,0,0
3,8477126,Jayson Megna,C,,34,0,0,0,0
3,8475164,Jakob Silfverberg,R,,34,0,0,0,0
3,8474009,Nick Bonino,C,,36,0,0,0,0
3,8479458,Nikita Zaitsev,D,,33,0,0,0,0
3,8477944,Jakub Vrana,L,,28,0,0,0,0
3,8471699,Andrew Cogliano,C,,37,0,0,0,0
3,8478067,Oskar Lindblom,L,,28,0,0,0,0
3,8471686,Marc Staal,D,,37,0,0,0,0
3,8470610,Zach Parise,L,,40,0,0,0,0
3,8478904,Steven Lorentz,C,,28,0,0,0,0
3,8473473,Milan Lucic,L,,36,0,0,0,0
3,8480031,Maxime Comtois,L,,25,0,0,0,0
3,8478512,Austin Czarnik,C,,32,0,0,0,0
3,8473504,Cal Clutterbuck,R,,37,0,0,0,0
3,8477454,Adam Erne,L,,29,0,0,0,0
3,8479383,Boris Katchouk,L,,26,0,0,0,0
3,8475825,Jani Hakanpää,D,,32,0,0,0,0
3,8477846,Ryan Carpenter,C,,33,0,0,0,0
3,8477930,Pierre-Edouard Bellemare,L,,39,0,0,0,0
3,8478400,Colin White,C,,27,0,0,0,0
3,8480226,Marián Studenic,R,,26,0,0,0,0
3,8480853,Liam Foudy,C,,24,0,0,0,0
3,8475797,Jarred Tinordi,D,,32,0,0,0,0
3,8479423,Alex Nylander,L,,26,0,0,0,0
3,8474618,Marco Scandella,D,,34,0,0,0,0
3,8478028,Fredrik Olofsson,L,,28,0,0,0,0
3,8474709,Matt Martin,L,,35,0,0,0,0
3,8481070,Hugh McGing,L,,26,0,0,0,0
3,8479546,Oskar Steen,C,,26,0,0,0,0
3,8474145,Robert Bortuzzo,D,,35,0,0,0,0
3,8476915,Jujhar Khaira,L,,30,0,0,0,0
3,8480274,Philip Kemp,D,EDM,25,2,0,0,0
3,8484321,Nikolas Matinpalo,D,OTT,26,4,0,0,0
3,8475278,Byron Froese,C,,33,0,0,0,0
3,8481812,Nikolai Knyzhov,D,,27,0,0,0,0
3,8478408,Travis Dermott,D,,28,0,0,0,0
3,8481077,John Leonard,L,,26,0,0,0,0
3,8479547,Matthew Phillips,R,,26,0,0,0,0
3,8480836,Jonathan Gruden,C,,24,0,0,0,0
3,8481690,Tyler Angle,C,,24,0,0,0,0
3,8475766,Austin Watson,L,,32,0,0,0,0
3,8478854,Ryan Shea,D,PIT,27,5,0,0,0
3,8481016,Ruslan Iskhakov,C,,24,0,0,0,0
3,8478078,Rourke Chartier,C,,28,0,0,0,0
3,8479330,Brandon Gignac,C,MTL,27,8,0,0,0
3,8483401,Marc Johnstone,R,PIT,28,4,0,0,0
3,8480776,Sheldon Rempal,R,,29,0,0,0,0
3,8478956,Samuel Laberge,L,NJD,27,0,0,0,0
3,8483609,Adam Klapka,R,CGY,24,3,0,0,0
3,8483045,Cameron Butler,R,CBJ,31,0,0,0,0
3,8481534,Raphael Lavoie,C,EDM,24,2,0,0,0
3,8478147,Bokondji Imama,L,PIT,28,7,0,0,0
3,8482476,Emil Heineman,L,MTL,23,3,0,0,0
3,8483531,Brian Halonen,L,NJD,25,5,0,0,0
3,8484314,Jiri Smejkal,L,,28,0,0,0,0
4,8476453,Nikita Kucherov,R,TBL,31,82,53,87,140
4,8478402,Connor McDavid,C,EDM,27,73,49,87,136
4,8477934,Leon Draisaitl,C,EDM,29,77,47,78,125
4,8477492,Nathan MacKinnon,C,COL,29,80,50,73,123
4,8477956,David Pastrnak,R,BOS,28,79,61,61,122
4,8481559,Jack Hughes,C,NJD,23,80,50,72,122
4,8478420,Mikko Rantanen,R,COL,28,81,44,76,120
4,8477404,Jake Guentzel,C,TBL,30,82,49,69,118
4,8479314,Matthew Tkachuk,L,FLA,27,80,44,72,116
4,8477939,William Nylander,R,TOR,28,80,51,64,115
4,8480069,Cale Makar,D,COL,26,68,32,83,115
4,8479318,Auston Matthews,C,TOR,27,80,53,52,105
4,8478864,Kirill Kaprizov,L,MIN,27,73,42,63,105
4,8477493,Aleksander Barkov,C,FLA,29,79,34,71,105
4,8477933,Sam Reinhart,C,FLA,29,76,47,52,99
4,8479407,Jesper Bratt,L,NJD,26,76,41,57,98
4,8478550,Artemi Panarin,L,NYR,33,76,34,63,97
4,8477946,Dylan Larkin,C,DET,28,81,49,46,95
4,8476454,Ryan Nugent-Hopkins,C,EDM,31,79,36,58,94
4,8476459,Mika Zibanejad,C,NYR,31,73,36,57,93
4,8476468,J.T. Miller,C,VAN,31,78,38,54,92
4,8478427,Sebastian Aho,C,CAR,27,76,38,54,92
4,8479343,Clayton Keller,R,UTA,26,76,41,50,91
4,8480027,Jason Robertson,L,DAL,25,81,32,58,90
4,8476389,Vincent Trocheck,C,NYR,31,79,29,61,90
4,8471675,Sidney Crosby,C,PIT,37,77,29,60,89
4,8478445,Mathew Barzal,C,NYI,27,79,29,60,89
4,8478483,Mitch Marner,R,TOR,27,76,27,62,89
4,8480012,Elias Pettersson,C,VAN,26,76,27,62,89
4,8475913,Mark Stone,R,VGK,32,75,28,60,88
4,8475172,Nazem Kadri,C,CGY,34,78,34,53,87
4,8482116,Tim Stützle,C,OTT,22,81,27,60,87
4,8476448,William Karlsson,C,VGK,31,76,35,51,86
4,8484144,Connor Bedard,C,CHI,19,68,32,53,85
4,8480800,Quinn Hughes,D,VAN,25,76,8,77,85
4,8478398,Kyle Connor,L,WPG,28,77,41,42,83
4,8479420,Tage Thompson,C,BUF,27,75,38,45,83
4,8479385,Jordan Kyrou,C,STL,26,76,37,45,82
4,8471685,Anze Kopitar,C,LAK,37,81,22,60,82
4,8479323,Adam Fox,D,NYR,26,74,11,71,82
4,8479675,Trevor Moore,L,LAK,29,82,43,38,81
4,8479337,Alex DeBrincat,R,DET,27,82,30,51,81
4,8480002,Nico Hischier,C,NJD,25,75,27,54,81
4,8481557,Matt Boldy,L,MIN,23,75,24,57,81
4,8473512,Claude Giroux,R,OTT,36,80,24,57,81
4,8477409,Carter Verhaeghe,C,FLA,29,78,33,47,80
4,8477402,Pavel Buchnevich,L,STL,29,74,28,52,80
4,8475184,Chris Kreider,L,NYR,33,76,49,30,79
4,8477501,Valeri Nichushkin,R,COL,29,82,36,42,78
4,8478449,Roope Hintz,C,DAL,28,81,33,45,78
4,8480830,Andrei Svechnikov,R,CAR,24,75,29,49,78
4,8474600,Roman Josi,D,NSH,34,76,20,58,78
4,8480803,Evan Bouchard,D,EDM,25,77,11,67,78
4,8476887,Filip Forsberg,L,NSH,30,75,37,40,77
4,8478403,Jack Eichel,C,VGK,28,78,33,44,77
4,8473419,Brad Marchand,L,BOS,36,77,27,50,77
4,8480865,Noah Dobson,D,NYI,24,81,18,58,76
4,8477942,Kevin Fiala,L,LAK,28,81,29,46,75
4,8474578,Erik Karlsson,D,PIT,34,81,16,59,75
4,8478493,Joel Eriksson Ek,C,MIN,27,73,36,38,74
4,8478010,Brayden Point,C,TBL,28,81,30,44,74
4,8480036,Miro Heiskanen,D,DAL,25,78,15,59,74
4,8477949,Alex Tuch,R,BUF,28,74,33,40,73
4,8474564,Steven Stamkos,C,NSH,34,74,30,43,73
4,8480023,Robert Thomas,C,STL,25,75,29,44,73
4,8475166,John Tavares,C,TOR,34,78,23,50,73
4,8471214,Alex Ovechkin,L,WSH,39,68,32,40,72
4,8480801,Brady Tkachuk,L,OTT,25,80,29,43,72
4,8478440,Dylan Strome,C,WSH,27,75,21,51,72
4,8477955,Jared McCann,L,SEA,28,75,43,28,71
4,8477960,Adrian Kempe,R,LAK,28,78,42,29,71
4,8475786,Zach Hyman,L,EDM,32,77,42,29,71
4,8482740,Wyatt Johnston,C,DAL,21,81,40,31,71
4,8471215,Evgeni Malkin,C,PIT,38,78,32,39,71
4,8479542,Brandon Hagel,L,TBL,26,82,29,41,70
4,8475168,Matt Duchene,C,DAL,33,82,21,49,70
4,8476456,Jonathan Huberdeau,C,CGY,31,79,21,49,70
4,8482113,Anton Lundell,C,FLA,23,78,37,32,69
4,8479999,Casey Mittelstadt,C,COL,26,79,20,49,69
4,8476881,Tomas Hertl,C,VGK,31,74,27,40,67
4,8476346,Johnny Gaudreau,L,CBJ,31,69,18,49,67
4,8475167,Victor Hedman,D,TBL,34,81,17,50,67
4,8482078,Lucas Raymond,L,DET,22,79,27,39,66
4,8477504,Josh Morrissey,D,WPG,29,70,14,52,66
4,8480208,Drake Batherson,R,OTT,26,80,22,43,65
4,8480839,Rasmus Dahlin,D,BUF,24,73,17,48,65
4,8478975,Mason Marchment,L,DAL,29,79,29,35,64
4,8474141,Patrick Kane,R,DET,36,81,23,41,64
4,8477416,Oliver Bjorkstrand,R,SEA,29,78,22,42,64
4,8478460,Zach Werenski,D,CBJ,27,80,16,48,64
4,8482109,Alexis Lafrenière,L,NYR,23,78,34,29,63
4,8475158,Ryan O'Reilly,C,NSH,33,77,28,35,63
4,8474679,Gustav Nyquist,C,NSH,35,73,17,46,63
4,8478439,Travis Konecny,R,PHI,27,73,30,32,62
4,8477500,Bo Horvat,C,NYI,29,80,29,33,62
4,8477496,Elias Lindholm,C,BOS,30,76,26,36,62
4,8477951,Nick Schmaltz,C,UTA,28,79,23,39,62
4,8477447,Shea Theodore,D,VGK,29,65,16,46,62
4,8475218,Mattias Ekholm,D,EDM,34,80,9,53,62
4,8476853,Morgan Rielly,D,TOR,30,69,7,55,62
4,8475765,Vladimir Tarasenko,R,DET,33,81,27,34,61
4,8481528,Dylan Cozens,C,BUF,23,65,22,39,61
4,8476905,Chandler Stephenson,C,SEA,30,81,18,43,61
4,8476906,Shayne Gostisbehere,D,CAR,31,77,11,50,61
4,8475169,Evander Kane,L,EDM,33,77,38,22,60
4,8475784,Jeff Skinner,C,EDM,32,74,30,30,60
4,8474586,Jordan Eberle,R,SEA,34,72,30,30,60
4,8477940,Nikolaj Ehlers,L,WPG,28,73,22,38,60
4,8476539,Jonathan Marchessault,R,NSH,34,69,27,32,59
4,8478414,Timo Meier,R,NJD,28,75,22,37,59
4,8478519,Anthony Cirelli,C,TBL,27,82,22,37,59
4,8482665,Matty Beniers,C,SEA,22,76,21,38,59
4,8476479,Phillip Danault,C,LAK,31,81,18,41,59
4,8482124,Quinton Byfield,R,LAK,22,80,17,42,59
4,8475745,Charlie Coyle,C,BOS,32,81,16,43,59
4,8475692,Mats Zuccarello,R,MIN,37,68,11,48,59
4,8477476,Artturi Lehkonen,L,COL,29,80,26,32,58
4,8480018,Nick Suzuki,C,MTL,25,71,16,42,58
4,8476432,Boone Jenner,C,CBJ,31,75,34,23,57
4,8482699,Dylan Guenther,R,UTA,21,77,30,27,57
4,8475754,Brock Nelson,C,NYI,33,79,27,30,57
4,8476460,Mark Scheifele,C,WPG,31,74,21,36,57
4,8475170,Brayden Schenn,C,STL,33,67,24,32,56
4,8481560,Arthur Kaliyev,R,LAK,23,78,22,34,56
4,8477503,Max Domi,C,TOR,29,80,22,34,56
4,8482720,Matthew Knies,L,TOR,22,74,19,37,56
4,8475798,Mikael Granlund,C,SJS,32,72,16,40,56
4,8482684,Luke Hughes,D,NJD,21,72,10,46,56
4,8477964,Ivan Barbashev,C,VGK,29,80,28,27,55
4,8482093,Seth Jarvis,C,CAR,22,70,26,29,55
4,8474150,Mikael Backlund,C,CGY,35,74,21,34,55
4,8479400,Pierre-Luc Dubois,L,WSH,26,71,21,34,55
4,8476462,Dougie Hamilton,D,NJD,31,69,15,40,55
4,8474590,John Carlson,D,WSH,34,70,14,41,55
4,8481581,Thomas Harley,D,DAL,23,74,13,42,55
4,8475794,Tyler Seguin,C,DAL,32,82,24,30,54
4,8477021,Alex Kerfoot,C,UTA,30,77,21,33,54
4,8477495,Seth Jones,D,CHI,30,72,20,34,54
4,8480014,Gabriel Vilardi,C,WPG,25,75,27,26,53
4,8481068,Yegor Sharangovich,C,CGY,26,75,25,28,53
4,8478444,Brock Boeser,R,VAN,27,74,24,29,53
4,8483808,Andrei Kuzmenko,L,CGY,28,75,24,29,53
4,8481596,Shane Pinto,C,OTT,24,77,23,30,53
4,8478047,Michael Bunting,L,PIT,29,72,22,31,53
4,8477497,Sean Monahan,C,CBJ,30,70,20,33,53
4,8474102,David Perron,L,OTT,36,78,15,38,53
4,8477986,Brandon Montour,D,SEA,30,74,12,41,53
4,8477346,MacKenzie Weegar,D,CGY,30,80,9,44,53
4,8476399,Blake Coleman,C,CGY,33,74,31,21,52
4,8483431,Logan Cooley,C,UTA,20,78,28,24,52
4,8475810,Bryan Rust,R,PIT,32,75,26,26,52
4,8480015,Owen Tippett,R,PHI,25,71,23,29,52
4,8479425,Filip Hronek,D,VAN,27,75,13,39,52
4,8479325,Charlie McAvoy,D,BOS,27,70,12,40,52
4,8478407,Vince Dunn,D,SEA,28,72,6,46,52
4,8478498,Jake DeBrusk,L,VAN,28,73,25,26,51
4,8473994,Jamie Benn,L,DAL,35,80,20,30,50
4,8483515,Juraj Slafkovsky,L,MTL,20,76,19,31,50
4,8476792,Torey Krug,D,STL,33,73,14,36,50
4,8475151,Kyle Palmieri,C,NYI,33,80,28,21,49
4,8480009,Eeli Tolvanen,R,SEA,25,74,18,31,49
4,8478469,Thomas Chabot,D,OTT,27,75,17,32,49
4,8479339,Patrik Laine,L,CBJ,26,70,16,33,49
4,8479525,Ross Colton,C,COL,28,78,29,19,48
4,8475314,Anders Lee,L,NYI,34,77,26,22,48
4,8477451,Ryan Hartman,R,MIN,30,69,25,23,48
4,8481540,Cole Caufield,R,MTL,23,78,25,23,48
4,8477935,Sam Bennett,C,FLA,28,76,24,24,48
4,8480064,Josh Norris,C,OTT,25,77,24,24,48
4,8477426,Nicholas Paul,L,TBL,29,81,22,26,48
4,8480039,Martin Necas,C,CAR,25,72,20,28,48
4,8477407,Anthony Duclair,L,NYI,29,81,27,20,47
4,8479365,Trent Frederic,C,BOS,26,79,23,24,47
4,8474149,Evgenii Dadonov,R,DAL,35,82,22,25,47
4,8478401,Pavel Zacha,C,BOS,27,79,19,28,47
4,8482110,Dawson Mercer,C,NJD,23,70,16,31,47
4,8481711,Matias Maccelli,L,UTA,24,72,12,35,47
4,8478856,Conor Garland,R,VAN,28,75,27,19,46
4,8475191,Reilly Smith,R,NYR,33,72,21,25,46
4,8482175,JJ Peterka,R,BUF,22,69,21,25,46
4,8478438,Tommy Novak,C,NSH,27,72,16,30,46
4,8476958,Jaccob Slavin,D,CAR,30,79,11,35,46
4,8478397,Rasmus Andersson,D,CGY,28,65,8,38,46
4,8475726,Tyler Toffoli,C,SJS,32,71,22,23,45
4,8482702,Logan Stankoven,C,DAL,21,82,19,26,45
4,8477479,Tyler Bertuzzi,L,CHI,29,61,18,27,45
4,8478458,John (Jack) Roslovic,C,CAR,27,67,17,28,45
4,8483505,Matthew Poitras,C,BOS,20,74,15,30,45
4,8478042,Viktor Arvidsson,L,EDM,31,70,15,30,45
4,8475799,Nino Niederreiter,R,WPG,32,63,24,20,44
4,8482705,Cole Sillinger,C,CBJ,21,66,23,21,44
4,8475287,Erik Haula,L,NJD,33,73,19,25,44
4,8480028,Morgan Frost,C,PHI,25,74,17,27,44
4,8478873,Troy Terry,R,ANA,27,77,14,30,44
4,8474563,Drew Doughty,D,LAK,35,74,10,34,44
4,8471724,Kris Letang,D,PIT,37,79,7,37,44
4,8481604,Pavel Dorofeyev,L,VGK,24,68,22,21,43
4,8478462,Nicolas Roy,C,VGK,27,78,21,22,43
4,8475793,Ryan Johansen,C,PHI,32,79,21,22,43
4,8479987,Morgan Geekie,C,BOS,26,77,20,23,43
4,8476880,Tom Wilson,R,WSH,30,70,20,23,43
4,8484153,Leo Carlsson,C,ANA,20,72,14,29,43
4,8477444,Andre Burakovsky,L,SEA,29,67,14,29,43
4,8476875,Mike Matheson,D,MTL,30,78,10,33,43
4,8474565,Alex Pietrangelo,D,VGK,34,63,8,35,43
4,8482159,Tyson Foerster,R,PHI,22,80,24,18,42
4,8474641,Adam Henrique,C,EDM,34,74,18,24,42
4,8476826,Yanni Gourde,C,SEA,33,70,17,25,42
4,8479351,Sam Steel,C,DAL,26,78,16,26,42
4,8477429,Andrew Copp,C,DET,30,82,8,34,42
4,8481618,Alex Newhook,C,MTL,23,72,22,19,41
4,8478474,Lawson Crouse,L,UTA,27,73,19,22,41
4,8478472,Mathieu Joseph,R,STL,27,67,18,23,41
4,8476292,Ondrej Palat,L,NJD,33,69,16,25,41
4,8480185,Eetu Luostarinen,C,FLA,26,74,15,26,41
4,8478542,Evan Rodrigues,C,FLA,31,73,14,27,41
4,8476872,Scott Laughton,C,PHI,30,68,14,27,41
4,8476419,Jean-Gabriel Pageau,C,NYI,32,80,12,29,41
4,8481703,Valtteri Puustinen,R,PIT,25,57,11,30,41
4,8477494,Jonathan Drouin,L,COL,29,80,10,31,41
4,8482712,Oskar Olausson,R,COL,22,78,9,32,41
4,8482624,Daniil Miromanov,D,CGY,27,66,7,34,41
4,8479410,Mikhail Sergachev,D,UTA,26,70,6,35,41
4,8482745,Mason McTavish,C,ANA,21,71,20,20,40
4,8481186,Logan O'Connor,R,COL,28,77,19,21,40
4,8471698,T.J. Oshie,R,WSH,38,67,18,22,40
4,8477511,Anthony Mantha,R,CGY,30,78,16,24,40
4,8477456,J.T. Compher,L,DET,29,80,16,24,40
4,8475760,Nick Bjugstad,C,UTA,32,71,15,25,40
4,8470613,Brent Burns,D,CAR,39,75,11,29,40
4,8477932,Aaron Ekblad,D,FLA,28,71,11,29,40
4,8479345,Jakob Chychrun,D,WSH,26,68,11,29,40
4,8481535,Nils Hoglander,L,VAN,24,67,26,13,39
4,8479591,Michael Eyssimont,C,TBL,28,81,23,16,39
4,8475714,Calle Jarnkrok,C,TOR,33,75,22,17,39
4,8476438,Brandon Saad,L,STL,32,74,22,17,39
4,8478366,Frank Vatrano,R,ANA,30,73,19,20,39
4,8473986,Alex Killorn,L,ANA,35,77,19,20,39
4,8484145,Zach Benson,L,BUF,19,63,18,21,39
4,8477425,Miles Wood,L,COL,29,76,18,21,39
4,8476882,Teuvo Teravainen,C,CHI,30,68,16,23,39
4,8484166,Adam Fantilli,C,CBJ,20,66,14,25,39
4,8478115,Pierre Engvall,L,NYI,28,79,13,26,39
4,8480188,Fabian Zetterlund,L,SJS,25,61,12,27,39
4,8481533,Trevor Zegras,C,ANA,23,62,10,29,39
4,8478396,Noah Hanifin,D,VGK,27,59,7,32,39
4,8477998,Warren Foegele,L,LAK,28,77,19,19,38
4,8478891,Mason Appleton,C,WPG,28,64,18,20,38
4,8475848,Brendan Gallagher,R,MTL,32,75,16,22,38
4,8480797,Joel Farabee,L,PHI,24,72,15,23,38
4,8481577,Philip Tomasino,C,NSH,23,68,11,27,38
4,8481542,Moritz Seider,D,DET,23,75,8,30,38
4,8477498,Darnell Nurse,D,EDM,29,73,8,30,38
4,8475753,Justin Faulk,D,STL,32,68,7,31,38
4,8475764,Cam Fowler,D,ANA,33,74,6,32,38
4,8482055,Drew O'Connor,L,PIT,26,66,22,15,37
4,8480813,Joe Veleno,C,DET,24,75,20,17,37
4,8475722,Jason Zucker,L,BUF,32,69,16,21,37
4,8476927,Teddy Blueger,C,VAN,30,66,16,21,37
4,8476461,Sean Couturier,C,PHI,32,71,16,21,37
4,8476885,Jacob Trouba,D,NYR,30,67,14,23,37
4,8476923,Damon Severson,D,CBJ,30,75,10,27,37
4,8482122,Brock Faber,D,MIN,22,78,4,33,37
4,8476483,Rickard Rakell,R,PIT,31,70,22,14,36
4,8480829,Jesperi Kotkaniemi,C,CAR,24,67,19,17,36
4,8480849,Barrett Hayton,C,UTA,24,63,18,18,36
4,8480835,Jack Drury,C,CAR,24,61,16,20,36
4,8478109,Victor Olofsson,L,VGK,29,68,15,21,36
4,8477989,Christian Dvorak,C,MTL,28,70,8,28,36
4,8480798,Philipp Kurashev,C,CHI,25,67,13,22,35
4,8480459,Pius Suter,C,VAN,28,69,12,23,35
4,8480145,Neal Pionk,D,WPG,29,71,6,29,35
4,8479661,Tanner Jeannot,L,LAK,27,72,21,13,34
4,8474715,Cameron Atkinson,R,TBL,35,78,17,17,34
4,8475768,Jaden Schwartz,C,SEA,32,62,15,19,34
4,8478466,Daniel Sprong,R,VAN,27,67,14,20,34
4,8476854,Hampus Lindholm,D,BOS,30,75,8,26,34
4,8478038,Devon Toews,D,COL,30,70,5,29,34
4,8482089,Jake Neighbours,L,STL,22,68,21,12,33
4,8476921,Jordan Martinook,L,CAR,32,62,19,14,33
4,8477987,Ryan Donato,C,CHI,28,64,16,17,33
4,8480113,Alex Iafallo,L,WPG,31,65,14,19,33
4,8481582,Nicholas Robertson,L,TOR,23,74,14,19,33
4,8477505,Alexander Wennberg,C,SJS,30,62,12,21,33
4,8482749,Joshua Roy,R,MTL,21,66,12,21,33
4,8476869,Brady Skjei,D,NSH,30,69,10,23,33
4,8482671,Owen Power,D,BUF,22,62,8,25,33
4,8480434,Sean Durzi,D,UTA,26,68,6,27,33
4,8483490,Pavel Mintyukov,D,ANA,21,73,6,27,33
4,8476902,Esa Lindell,D,DAL,30,75,4,29,33
4,8470621,Corey Perry,R,EDM,39,70,18,14,32
4,8483524,Shane Wright,C,SEA,20,67,16,16,32
4,8482149,Cole Perfetti,C,WPG,22,58,15,17,32
4,8478233,Andrew Mangiapane,L,WSH,28,65,14,18,32
4,8482092,Ridly Greig,C,OTT,22,75,13,19,32
4,8475763,Kevin Hayes,R,PIT,32,67,13,19,32
4,8481580,Connor McMichael,C,WSH,23,63,13,19,32
4,8481554,Kaapo Kakko,R,NYR,23,67,11,21,32
4,8477969,Marcus Pettersson,D,PIT,28,74,10,22,32
4,8478463,Anthony Beauvillier,L,PIT,27,65,9,23,32
4,8476331,Dylan DeMelo,D,WPG,31,68,6,26,32
4,8481606,Jordan Spence,D,LAK,23,62,5,27,32
4,8476917,Adam Pelech,D,NYI,30,79,5,27,32
4,8478020,Michael Amadio,R,OTT,28,74,16,15,31
4,8474189,Lars Eller,C,PIT,35,69,14,17,31
4,8479353,Brett Howden,C,VGK,26,71,14,17,31
4,8478055,Gustav Forsling,D,FLA,28,66,7,24,31
4,8482105,Jake Sanderson,D,OTT,22,70,6,25,31
4,8478500,Ivan Provorov,D,CBJ,27,78,4,27,31
4,8477506,Ryan Pulock,D,NYI,30,80,4,27,31
4,8475200,Dmitry Orlov,D,CAR,33,71,3,28,31
4,8478057,Dakota Joshua,C,VAN,28,63,15,15,30
4,8481032,Paul Cotter,C,NJD,25,58,15,15,30
4,8477919,Frederick Gaudreau,C,MIN,31,64,14,16,30
4,8482146,Luke Evangelista,R,NSH,22,71,13,17,30
4,8480078,Filip Chytil,C,NYR,25,67,12,18,30
4,8476458,Ryan Strome,C,ANA,31,67,11,19,30
4,8476463,Jonas Brodin,D,MIN,31,77,8,22,30
4,8477488,Brett Pesce,D,NJD,30,68,5,25,30
4,8479976,Juuso Valimaki,D,UTA,26,70,5,25,30
4,8475462,Radko Gudas,D,ANA,34,67,2,28,30
4,8476981,Josh Anderson,R,MTL,30,74,17,12,29
4,8476918,Jimmy Vesey,L,NYR,31,70,17,12,29
4,8477903,Garnet Hathaway,R,PHI,33,60,17,12,29
4,8482097,Jack Quinn,R,BUF,23,62,13,16,29
4,8481553,Bobby Brink,R,PHI,23,60,12,17,29
4,8473422,Nick Foligno,L,CHI,37,63,12,17,29
4,8483445,Cutter Gauthier,L,ANA,20,58,12,17,29
4,8480871,Adam Boqvist,D,FLA,24,70,11,18,29
4,8474053,Logan Couture,C,SJS,35,58,9,20,29
4,8476925,Colton Sissons,C,NSH,31,68,9,20,29
4,8480003,Jesper Boqvist,C,FLA,26,68,8,21,29
4,8479639,Dylan Coghlan,D,WPG,26,70,8,21,29
4,8476892,Colton Parayko,D,STL,31,71,4,25,29
4,8477948,Travis Sanheim,D,PHI,28,67,2,27,29
4,8476474,Stefan Noesen,R,NJD,31,68,15,13,28
4,8482679,Matt Coronato,R,CGY,22,64,15,13,28
4,8482111,Justin Barron,D,MTL,23,62,14,14,28
4,8475343,Nic Dowd,C,WSH,34,60,13,15,28
4,8482667,William Eklund,L,SJS,22,61,8,20,28
4,8480336,Sean Walker,D,CAR,30,74,8,20,28
4,8480817,K'Andre Miller,D,NYR,24,70,6,22,28
4,8479398,Samuel Girard,D,COL,26,74,4,24,28
4,8476878,Zemgus Girgensons,C,TBL,30,79,16,11,27
4,8476469,Joel Armia,R,MTL,31,66,14,13,27
4,8475220,Marcus Foligno,L,MIN,33,60,13,14,27
4,8478413,Jordan Greenway,L,BUF,27,66,12,15,27
4,8477015,Connor Brown,R,EDM,30,70,12,15,27
4,8483457,Lane Hutson,D,MTL,20,75,12,15,27
4,8478133,Jake Evans,C,MTL,28,72,11,16,27
4,8480748,Kiefer Sherwood,L,VAN,29,65,11,16,27
4,8478585,Derek Ryan,C,EDM,38,63,11,16,27
4,8477435,Ryan Graves,D,PIT,29,78,8,19,27
4,8476457,Adam Larsson,D,SEA,32,73,7,20,27
4,8481546,Cam York,D,PHI,23,70,6,21,27
4,8482730,Brandt Clarke,D,LAK,21,57,6,21,27
4,8476931,Jake McCabe,D,TOR,31,71,5,22,27
4,8476979,Erik Gustafsson,D,DET,32,72,4,23,27
4,8477450,Jason Dickinson,C,CHI,29,66,13,13,26
4,8477952,Robby Fabbri,C,ANA,28,60,13,13,26
4,8476278,Colin Blackwell,C,DAL,31,74,13,13,26
4,8479941,Justin Danforth,R,CBJ,31,61,13,13,26
4,8478043,Sam Lafferty,C,BUF,29,60,11,15,26
4,8476480,Vladislav Namestnikov,C,WPG,32,67,10,16,26
4,8481524,Bowen Byram,D,BUF,23,67,10,16,26
4,8482117,Lukas Reichel,L,CHI,22,54,10,16,26
4,8476897,Oskar Sundqvist,C,STL,30,71,9,17,26
4,8475149,Marcus Johansson,L,MIN,34,62,8,18,26
4,8479402,Jake Bean,D,CGY,26,68,8,18,26
4,8478882,Vladislav Gavrikov,D,LAK,29,75,7,19,26
4,8481014,Alexander Romanov,D,NYI,24,72,2,24,26
4,8482655,Janis Moser,D,TBL,24,72,1,25,26
4,8478508,Yakov Trenin,C,MIN,27,57,16,9,25
4,8475193,Tomas Tatar,L,NJD,34,68,12,13,25
4,8479316,Luke Kunin,C,SJS,27,65,11,14,25
4,8482133,Thomas Bordeleau,C,SJS,22,64,10,15,25
4,8480068,Ryan Poehling,C,PHI,25,71,10,15,25
4,8479368,Max Jones,L,BOS,26,67,10,15,25
4,8475171,Oliver Ekman-Larsson,D,TOR,33,67,9,16,25
4,8484203,Bradly Nadeau,L,CAR,19,52,6,19,25
4,8474716,Jared Spurgeon,D,MIN,35,75,5,20,25
4,8478178,Darren Raddysh,D,TBL,28,70,5,20,25
4,8482809,Jackson Blake,R,CAR,21,64,4,21,25
4,8479998,Mikey Anderson,D,LAK,25,61,3,22,25
4,8481704,Juuso Parssinen,C,NSH,23,63,15,9,24
4,8479393,Noah Gregor,L,OTT,26,77,14,10,24
4,8480855,Jack McBain,C,UTA,24,68,11,13,24
4,8482157,Will Cuylle,L,NYR,22,66,11,13,24
4,8479619,Michael Carcone,L,UTA,28,63,10,14,24
4,8480762,Eric Robinson,L,CAR,29,57,10,14,24
4,8478046,Danton Heinen,L,VAN,29,71,9,15,24
4,8482067,Connor Mackey,D,NYR,28,66,6,18,24
4,8477839,Conor Sheary,L,TBL,32,80,6,18,24
4,8480049,Dylan Samberg,D,WPG,25,65,3,21,24
4,8473507,Jeff Petry,D,DET,37,76,0,24,24
4,8480289,Morgan Barron,C,WPG,26,59,15,8,23
4,8482074,Connor Zary,C,CGY,23,60,13,10,23
4,8480144,David Kampf,C,TOR,29,77,13,10,23
4,8473453,Trevor Lewis,C,LAK,37,73,13,10,23
4,8480220,Noah Cates,L,PHI,25,72,12,11,23
4,8482125,Alexander Holtz,R,VGK,22,72,12,11,23
4,8483482,Tristan Luneau,D,ANA,20,58,12,11,23
4,8481656,Aliaksei Protas,C,WSH,23,58,11,12,23
4,8476329,Travis Boyd,C,MIN,31,53,11,12,23
4,8479414,Nathan Bastian,R,NJD,27,56,11,12,23
4,8477406,Mattias Janmark,C,EDM,32,66,11,12,23
4,8482660,Kent Johnson,C,CBJ,22,60,9,14,23
4,8480789,Oliver Wahlstrom,R,NYI,24,71,8,15,23
4,8482101,Danil Gushchin,L,SJS,22,51,6,17,23
4,8483565,Nick Blankenburg,D,NSH,26,64,6,17,23
4,8479324,Ryan Lindgren,D,NYR,26,70,5,18,23
4,8480891,Michael Kesselring,D,UTA,24,60,5,18,23
4,8481708,Zac Jones,D,NYR,24,46,5,18,23
4,8478851,Alexandre Carrier,D,NSH,28,64,4,19,23
4,8479983,Mario Ferraro,D,SJS,26,75,3,20,23
4,8474151,Ryan McDonagh,D,TBL,35,74,1,22,23
4,8478136,Jake Middleton,D,MIN,28,76,1,22,23
4,8476392,Adam Lowry,C,WPG,31,60,13,9,22
4,8482475,Yegor Chinakhov,R,CBJ,23,60,11,11,22
4,8483491,Ivan Miroshnichenko,L,WSH,20,58,11,11,22
4,8481441,Joe Snively,C,DET,28,63,9,13,22
4,8481523,Kirby Dach,C,MTL,23,65,8,14,22
4,8477947,Sonny Milano,L,WSH,28,57,8,14,22
4,8473563,Nicklas Backstrom,C,WSH,37,56,8,14,22
4,8480073,Erik Brannstrom,D,COL,25,65,8,14,22
4,8476525,Colin Miller,D,WPG,32,55,7,15,22
4,8477508,Curtis Lazar,C,NJD,29,57,6,16,22
4,8477499,Rasmus Ristolainen,D,PHI,30,61,5,17,22
4,8475181,Nick Leddy,D,STL,33,67,3,19,22
4,8481517,Brett Leason,R,ANA,25,64,15,6,21
4,8476889,Radek Faksa,C,STL,30,66,11,10,21
4,8480893,Kirill Marchenko,R,CBJ,24,64,10,11,21
4,8481481,Blake Lizotte,C,PIT,27,64,10,11,21
4,8479992,Michael Rasmussen,C,DET,25,78,9,12,21
4,8478432,Christian Fischer,R,DET,27,73,9,12,21
4,8477953,Kasperi Kapanen,R,STL,28,67,6,15,21
4,8478434,Keegan Kolesar,R,VGK,27,65,6,15,21
4,8481624,Ilya Mikheyev,R,CHI,30,63,5,16,21
4,8478970,Jalen Chatfield,D,CAR,28,68,5,16,21
4,8477845,Trevor van Riemsdyk,D,WSH,33,62,5,16,21
4,8479315,Joey Anderson,R,CHI,26,50,4,17,21
4,8475690,Chris Tanev,D,TOR,35,61,4,17,21
4,8476429,Scott Mayfield,D,NYI,32,72,4,17,21
4,8476879,Cody Ceci,D,EDM,31,62,3,18,21
4,8482073,Braden Schneider,D,NYR,23,62,2,19,21
4,8480448,Parker Kelly,L,COL,25,77,14,6,20
4,8475855,Jesper Fast,R,CAR,33,61,13,7,20
4,8479336,Carl Grundstrom,R,SJS,27,55,13,7,20
4,8481716,Dmitri Voronkov,L,CBJ,24,39,12,8,20
4,8479390,Taylor Raddysh,R,WSH,26,64,11,9,20
4,8482259,Bobby McMann,C,TOR,28,51,11,9,20
4,8475791,Taylor Hall,L,CHI,33,52,9,11,20
4,8474034,Patrick Maroon,L,CHI,36,53,9,11,20
4,8478569,Noel Acciari,C,PIT,33,50,8,12,20
4,8484149,Gavin Brindley,C,CBJ,20,45,8,12,20
4,8483499,Liam Ohgren,L,MIN,20,64,7,13,20
4,8477220,Nate Schmidt,D,FLA,33,71,7,13,20
4,8481521,Ronnie Attard,D,PHI,25,55,7,13,20
4,8476960,Andreas Athanasiou,C,CHI,30,56,6,14,20
4,8476467,Jamie Oleksiak,D,SEA,32,64,5,15,20
4,8479718,Alex Barré-Boulet,C,MTL,27,49,11,8,19
4,8481028,Martin Pospisil,C,CGY,25,58,8,11,19
4,8473533,Jordan Staal,C,CAR,36,60,7,12,19
4,8477478,William Carrier,L,CAR,30,53,7,12,19
4,8478911,Matt Roy,D,WSH,29,61,6,13,19
4,8481527,Kaedan Korczak,D,VGK,23,55,6,13,19
4,8480878,Nils Lundkvist,D,DAL,24,72,6,13,19
4,8482192,Isaak Phillips,D,CHI,23,59,5,14,19
4,8482245,Artem Zub,D,OTT,29,73,4,15,19
4,8479996,Cody Glass,C,NSH,25,53,14,4,18
4,8482155,Alex Laferriere,R,LAK,23,61,11,7,18
4,8478013,Jake Walman,D,SJS,28,71,10,8,18
4,8478421,A.J. Greer,L,FLA,28,67,10,8,18
4,8481477,Nico Sturm,C,SJS,29,50,9,9,18
4,8477446,Michael McCarron,R,NSH,29,50,9,9,18
4,8481617,Vasily Podkolzin,R,VAN,23,50,9,9,18
4,8480011,Klim Kostin,C,SJS,25,60,9,9,18
4,8481601,Simon Holmstrom,R,NYI,23,57,8,10,18
4,8475231,Casey Cizikas,C,NYI,33,75,8,10,18
4,8480441,Trey Fix-Wolansky,R,CBJ,25,40,8,10,18
4,8480802,Ryan McLeod,C,BUF,25,64,7,11,18
4,8477979,Nicolas Aube-Kubel,R,BUF,28,58,7,11,18
4,8477507,Nikita Zadorov,D,BOS,29,69,7,11,18
4,8482148,Hendrix Lapierre,C,WSH,22,57,6,12,18
4,8476422,Mike Reilly,D,NYI,31,75,6,12,18
4,8480074,Alexandre Texier,C,STL,25,57,6,12,18
4,8475324,Nick Jensen,D,OTT,34,67,5,13,18
4,8476988,Matt Benning,D,SJS,30,70,5,13,18
4,8480860,Kevin Bahl,D,CGY,24,57,5,13,18
4,8478468,Jeremy Lauzon,D,NSH,27,52,5,13,18
4,8475188,Brayden McNabb,D,VGK,33,54,4,14,18
4,8475790,Erik Gudbranson,D,CBJ,32,76,4,14,18
4,8475179,Dmitry Kulikov,D,FLA,34,65,4,14,18
4,8480043,Timothy Liljegren,D,TOR,25,64,4,14,18
4,8482142,Jamie Drysdale,D,PHI,22,66,3,15,18
4,8474574,Tyler Myers,D,VAN,34,74,3,15,18
4,8479980,Nicolas Hague,D,VGK,26,54,3,15,18
4,8478507,John Marino,D,UTA,27,63,2,16,18
4,8476967,Brett Kulak,D,EDM,30,65,1,17,18
4,8475225,Craig Smith,C,CHI,35,51,10,7,17
4,8481093,Rafael Harvey-Pinard,L,MTL,25,55,8,9,17
4,8480980,Connor Dewar,C,TOR,25,73,8,9,17
4,8480806,Isac Lundestrom,C,ANA,25,60,8,9,17
4,8477392,Hudson Fasching,R,NYI,29,64,8,9,17
4,8482807,Ethan Del Mastro,D,CHI,21,54,7,10,17
4,8476374,Sean Kuraly,C,CBJ,31,59,6,11,17
4,8483468,Jiri Kulich,C,BUF,20,59,6,11,17
4,8481701,Santeri Hatakka,D,NJD,23,44,6,11,17
4,8482087,Kaiden Guhle,D,MTL,22,68,5,12,17
4,8481568,Alex Vlasic,D,CHI,23,54,5,12,17
4,8479371,Dante Fabbro,D,NSH,26,64,4,13,17
4,8481550,Adam Beckman,L,NJD,23,43,4,13,17
4,8480887,Jordan Harris,D,MTL,24,53,3,14,17
4,8480222,Sebastian Aho,D,PIT,28,73,2,15,17
4,8480873,Rasmus Sandin,D,WSH,24,50,1,16,17
4,8482079,Marco Rossi,C,MIN,23,56,10,6,16
4,8480205,Emil Bemstrom,C,PIT,25,55,9,7,16
4,8479066,Ryan Lomberg,L,CGY,30,66,9,7,16
4,8477353,Tyler Motte,C,DET,29,73,6,10,16
4,8482634,Alex Steeves,C,TOR,25,45,6,10,16
4,8470600,Ryan Suter,D,STL,39,64,4,12,16
4,8475233,David Savard,D,MTL,34,65,4,12,16
4,8480246,Nick Perbix,D,TBL,26,75,4,12,16
4,8481019,David Gustafsson,C,WPG,24,43,3,13,16
4,8480950,Ilya Lyubushkin,D,DAL,30,57,2,14,16
4,8475455,Brenden Dillon,D,NJD,34,54,2,14,16
4,8481059,Scott Perunovich,D,STL,26,60,1,15,16
4,8479293,Brandon Tanev,L,SEA,33,60,10,5,15
4,8480021,Jack Studnicka,C,LAK,25,58,10,5,15
4,8481147,Reese Johnson,C,MIN,26,41,10,5,15
4,8476873,Mark Jankowski,C,NSH,30,55,8,7,15
4,8477380,Jonny Brodzinski,C,NYR,31,55,6,9,15
4,8482737,Zack Bolduc,C,STL,21,50,6,9,15
4,8477369,Carson Soucy,D,VAN,30,60,6,9,15
4,8478416,Erik Cernak,D,TBL,27,76,4,11,15
4,8478840,Will Borgen,D,SEA,28,65,4,11,15
4,8476442,Matt Nieto,L,PIT,32,49,3,12,15
4,8480281,Alexey Toropchenko,R,STL,25,51,12,2,14
4,8480995,Pontus Holmberg,R,TOR,25,57,9,5,14
4,8482077,Dylan Holloway,L,EDM,23,55,9,5,14
4,8478831,Kevin Stenlund,C,UTA,28,48,8,6,14
4,8482062,Cole Smith,L,NSH,29,58,7,7,14
4,8479520,Brandon Duhaime,R,WSH,27,59,7,7,14
4,8482166,Shakir Mukhamadullin,D,SJS,22,53,6,8,14
4,8475842,Sam Carrick,C,NYR,32,59,5,9,14
4,8480025,MacKenzie Entwistle,R,FLA,25,57,5,9,14
4,8476856,Mathew Dumba,D,DAL,30,70,4,10,14
4,8474568,Luke Schenn,D,NSH,35,46,4,10,14
4,8478399,Jonas Siegenthaler,D,NJD,27,50,3,11,14
4,8479372,Joshua Mahura,D,SEA,26,56,3,11,14
4,8482176,Wyatt Kaiser,D,CHI,22,48,3,11,14
4,8480035,Henri Jokiharju,D,BUF,25,56,2,12,14
4,8479249,Andrew Poturalski,C,SJS,30,39,2,12,14
4,8480172,Jan Rutta,D,SJS,34,61,2,12,14
4,8477034,Jaycob Megna,D,FLA,32,42,1,13,14
4,8477365,Connor Clifton,D,BUF,29,52,1,13,14
4,8481679,Maxence Guenette,D,OTT,23,38,9,4,13
4,8479370,Tyson Jost,C,CAR,26,48,8,5,13
4,8481641,Joel Kiviranta,L,COL,28,72,7,6,13
4,8479359,Beck Malenstyn,L,BUF,26,48,5,8,13
4,8476624,Barclay Goodrow,C,SJS,31,56,5,8,13
4,8479026,Philippe Myers,D,TOR,27,51,4,9,13
4,8482451,Mikael Pyyhtia,L,CBJ,23,36,4,9,13
4,8476994,Vinnie Hinostroza,C,NSH,30,46,4,9,13
4,8477931,Tomas Nosek,L,FLA,32,61,3,10,13
4,8482744,James Malatesta,L,CBJ,21,47,3,10,13
4,8481167,Brayden Pachal,D,CGY,25,43,3,10,13
4,8482751,Ryan Winterton,C,SEA,21,43,3,10,13
4,8481522,Peyton Krebs,C,BUF,23,67,2,11,13
4,8479986,Kole Lind,R,DAL,26,62,2,11,13
4,8480727,Zach Whitecloud,D,VGK,28,50,2,11,13
4,8479543,Michael Pezzetta,L,MTL,26,50,2,11,13
4,8480058,Pierre-Olivier Joseph,D,STL,25,52,1,12,13
4,8477482,Zachary Sanford,L,CHI,30,30,7,5,12
4,8476822,Luke Glendening,C,TBL,35,79,6,6,12
4,8483495,Simon Nemec,D,NJD,20,63,5,7,12
4,8477573,Nathan Walker,L,STL,30,48,5,7,12
4,8482496,Nils Aman,C,VAN,24,26,4,8,12
4,8479369,Andrew Peeke,D,BOS,26,54,3,9,12
4,8476312,Josh Manson,D,COL,33,58,3,9,12
4,8481598,Philip Broberg,D,EDM,23,43,2,10,12
4,8476891,Matthew Grzelcyk,D,PIT,30,75,1,11,12
4,8477070,Liam O'Brien,C,UTA,30,55,5,6,11
4,8477887,Patrick Brown,C,BOS,32,42,5,6,11
4,8480252,Cole Guttman,C,CHI,25,30,4,7,11
4,8483466,Kevin Korchinski,D,CHI,20,43,4,7,11
4,8480157,Calle Rosen,D,COL,30,45,4,7,11
4,8480355,Mark Kastelic,C,BOS,25,60,3,8,11
4,8474567,Zach Bogosian,D,MIN,34,55,3,8,11
4,8475762,Derek Forbort,D,VAN,32,43,3,8,11
4,8478443,Brandon Carlo,D,BOS,28,57,3,8,11
4,8477384,Joshua Brown,D,EDM,30,42,3,8,11
4,8478452,Caleb Jones,D,LAK,27,49,2,9,11
4,8479442,Troy Stecher,D,EDM,30,50,2,9,11
4,8483460,David Jiricek,D,CBJ,21,55,1,10,11
4,8475718,Justin Holl,D,DET,32,60,1,10,11
4,8475750,Jon Merrill,D,MIN,32,61,0,11,11
4,8479344,Jesse Puljujarvi,R,PIT,26,50,8,2,10
4,8479291,Kevin Rooney,C,CGY,31,47,7,3,10
4,8479772,Zack MacEwen,R,OTT,28,47,7,3,10
4,8479439,Jacob MacDonald,D,COL,31,51,6,4,10
4,8481600,Tobias Bjornfot,D,FLA,23,42,6,4,10
4,8480845,Rasmus Kupari,C,WPG,24,40,6,4,10
4,8482803,Olen Zellweger,D,ANA,21,60,5,5,10
4,8480848,Ty Dellandrea,C,SJS,24,35,5,5,10
4,8479968,Vinni Lettieri,C,BOS,29,47,5,5,10
4,8481567,Henry Thrun,D,SJS,23,45,5,5,10
4,8481013,Jonatan Berggren,R,DET,24,56,4,6,10
4,8482859,Zack Ostapchuk,C,OTT,21,47,4,6,10
4,8477018,Ben Hutton,D,VGK,31,43,4,6,10
4,8480292,Carson Meyer,R,ANA,27,34,4,6,10
4,8478451,Ethan Bear,D,WSH,27,57,3,7,10
4,8482652,Walker Duehr,R,CGY,27,48,3,7,10
4,8478211,Dryden Hunt,L,CGY,29,54,2,8,10
4,8474166,Alec Martinez,D,CHI,37,55,2,8,10
4,8474090,Brendan Smith,D,DAL,35,54,2,8,10
4,8479982,Conor Timmins,D,TOR,26,49,1,9,10
4,8480796,Martin Fehervary,D,WSH,25,56,1,9,10
4,8480807,Mattias Samuelsson,D,BUF,24,59,1,9,10
4,8476874,Olli Maatta,D,DET,30,64,1,9,10
4,8481178,Egor Zamula,D,PHI,24,58,0,10,10
4,8479985,Cale Fleury,D,SEA,26,33,6,3,9
4,8476934,Brock McGinn,L,ANA,30,48,5,4,9
4,8483493,Frank Nazar,C,CHI,20,47,4,5,9
4,8479328,Julien Gauthier,R,NYI,27,54,4,5,9
4,8482784,Zach Dean,C,STL,21,48,4,5,9
4,8482070,Mitchell Chaffee,R,TBL,26,53,4,5,9
4,8475208,Brian Dumoulin,D,ANA,33,70,2,7,9
4,8476441,Joel Edmundson,D,LAK,31,38,2,7,9
4,8477938,Haydn Fleury,D,WPG,28,49,2,7,9
4,8482659,Josh Doan,R,UTA,22,55,2,7,9
4,8477335,Kyle Burroughs,D,LAK,29,44,2,7,9
4,8483549,Lucas Condotta,L,MTL,27,32,2,7,9
4,8476372,Nick Seeler,D,PHI,31,42,1,8,9
4,8482861,Vincent Iorio,D,WSH,22,34,1,8,9
4,8474013,Ian Cole,D,UTA,35,54,1,8,9
4,8480001,Urho Vaakanainen,D,ANA,25,62,0,9,9
4,8473446,Erik Johnson,D,PHI,36,47,0,9,9
4,8479367,William Lockwood,R,FLA,26,29,7,1,8
4,8482762,Simon Edvinsson,D,DET,21,58,6,2,8
4,8479944,Zach Aston-Reese,C,VGK,30,41,5,3,8
4,8482511,Mason Lohrei,D,BOS,23,30,5,3,8
4,8481237,Kyle MacLean,C,NYI,25,28,5,3,8
4,8475235,Nicolas Deslauriers,L,PHI,33,47,4,4,8
4,8482666,Scott Morrow,D,CAR,22,48,4,4,8
4,8479972,Mason Shaw,C,WPG,26,29,4,4,8
4,8483630,Pavol Regenda,L,ANA,25,30,4,4,8
4,8483763,Maksymilian Szuber,D,UTA,22,34,3,5,8
4,8482747,Brennan Othmann,L,NYR,21,34,2,6,8
4,8479671,Mathieu Olivier,R,CBJ,27,52,2,6,8
4,8478017,Mark Friedman,D,VAN,29,41,2,6,8
4,8471677,Jack Johnson,D,CBJ,37,67,2,6,8
4,8477473,Justin Bailey,R,SJS,29,27,2,6,8
4,8475279,Ben Chiarot,D,DET,33,62,1,7,8
4,8481056,Spencer Stastney,D,NSH,24,32,1,7,8
4,8474673,TJ Brodie,D,CHI,34,58,0,8,8
4,8478424,Jansen Harkins,C,ANA,27,40,5,2,7
4,8483570,Ben Meyers,C,SEA,26,28,5,2,7
4,8482929,Emil Lilleberg,D,TBL,23,21,5,2,7
4,8481537,Nikita Okhotiuk,D,CGY,24,51,4,3,7
4,8481043,Cole Koepke,L,BOS,26,14,4,3,7
4,8481532,Alex Turcotte,C,LAK,23,45,3,4,7
4,8482964,Arber Xhekaj,D,MTL,23,46,3,4,7
4,8476867,Brendan Gaunce,C,MIN,30,42,3,4,7
4,8481592,Jakob Pelletier,L,CGY,23,45,3,4,7
4,8480880,Jakub Lauko,C,MIN,24,31,3,4,7
4,8480192,Johnathan Kovacevic,D,NJD,27,56,3,4,7
4,8479536,Axel Jonsson-Fjallby,L,WPG,26,41,3,4,7
4,8479348,Kale Clague,D,BUF,26,33,2,5,7
4,8474612,Travis Hamonic,D,OTT,34,44,2,5,7
4,8479981,Jonah Gadjovich,L,FLA,26,35,2,5,7
4,8480007,Jonas Rondbjerg,R,VGK,25,40,2,5,7
4,8481609,Vladislav Kolyachonok,D,UTA,23,29,2,5,7
4,8482858,Ryker Evans,D,SEA,23,17,2,5,7
4,8480196,Jacob Bryson,D,BUF,27,44,2,5,7
4,8479638,Justin Brazeau,R,BOS,26,45,2,5,7
4,8478874,Adam Gaudette,R,OTT,28,32,2,5,7
4,8480879,Jacob Bernard-Docker,D,OTT,24,48,1,6,7
4,8483012,Logan Morrison,C,SEA,22,37,1,6,7
4,8477971,Andreas Englund,D,LAK,28,22,1,6,7
4,8476952,Dominic Toninato,C,WPG,30,39,1,6,7
4,8479587,Rhett Gardner,C,PHI,28,19,1,6,7
4,8482145,Mavrik Bourque,C,DAL,22,40,5,1,6
4,8481518,Nolan Foote,L,NJD,24,37,4,2,6
4,8480990,Declan Chisholm,D,MIN,24,38,4,2,6
4,8481754,Nikita Nesterenko,C,ANA,23,38,4,2,6
4,8479994,Jaret Anderson-Dolan,C,WPG,25,43,3,3,6
4,8480890,Jan Jenik,C,OTT,24,27,3,3,6
4,8479320,Maxime Lajoie,D,SEA,27,19,3,3,6
4,8477962,Brendan Lemieux,L,CAR,28,39,2,4,6
4,8483619,Filip Roos,D,OTT,25,29,2,4,6
4,8477401,John Hayden,C,SEA,29,21,2,4,6
4,8471817,Ryan Reaves,R,TOR,37,51,1,5,6
4,8484254,Akito Hirose,D,VAN,25,35,1,5,6
4,8478454,Noah Juulsen,D,VAN,27,42,1,5,6
4,8478502,Dennis Gilbert,D,BUF,28,28,1,5,6
4,8478859,Niko Mikkola,D,FLA,28,56,0,6,6
4,8480070,Ian Mitchell,D,BOS,25,55,0,6,6
4,8481751,Lukas Rousek,R,BUF,25,34,0,6,6
4,8471709,Marc-Edouard Vlasic,D,SJS,37,55,0,6,6
4,8478450,Parker Wotherspoon,D,BOS,27,38,0,6,6
4,8482144,Jack Thompson,D,SJS,22,28,4,1,5
4,8476858,Phillip Di Giuseppe,L,VAN,31,38,3,2,5
4,8479991,Jake Leschyshyn,C,NYR,25,22,3,2,5
4,8480870,Bo Groulx,C,NYR,24,33,3,2,5
4,8482141,Lukas Cormier,D,VGK,22,24,3,2,5
4,8484911,Collin Graf,R,SJS,22,38,3,2,5
4,8481789,Tye Kartye,L,SEA,23,34,2,3,5
4,8478409,Anthony Richard,C,PHI,28,35,2,3,5
4,8481065,Angus Crookshank,L,OTT,25,20,2,3,5
4,8482095,Tyler Kleven,D,OTT,22,47,1,4,5
4,8481605,Jackson LaCombe,D,ANA,23,28,1,4,5
4,8481161,Jake Christiansen,D,CBJ,25,61,1,4,5
4,8481122,Simon Benoit,D,TOR,26,43,1,4,5
4,8481543,Nikita Alexandrov,C,STL,24,25,1,4,5
4,8482177,Marat Khusnutdinov,C,MIN,22,29,1,4,5
4,8483512,Matthew Savoie,C,EDM,20,19,1,4,5
4,8481599,Victor Soderstrom,D,UTA,23,42,0,5,5
4,8479378,Logan Stanley,D,WPG,26,44,0,5,5
4,8476473,Connor Murphy,D,CHI,31,36,0,5,5
4,8482147,Jean-Luc Foudy,C,COL,22,24,4,0,4
4,8482165,Yan Kuznetsov,D,CGY,22,20,2,2,4
4,8482153,Brendan Brisson,C,VGK,23,30,2,2,4
4,8478146,Matthew Highmore,C,OTT,28,32,2,2,4
4,8478011,Louie Belpedio,D,PHI,28,15,2,2,4
4,8475177,Calvin de Haan,D,COL,33,41,1,3,4
4,8480844,Grigori Denisenko,L,VGK,24,32,1,3,4
4,8477527,Ross Johnston,L,ANA,30,34,1,3,4
4,8482765,Isak Rosen,R,BUF,21,31,1,3,4
4,8477467,Gustav Olofsson,D,SEA,30,19,1,3,4
4,8481564,Ryan Johnson,D,BUF,23,18,1,3,4
4,8480851,Akil Thomas,C,LAK,24,22,1,3,4
4,8478477,Mitchell Stephens,C,SEA,27,21,0,4,4
4,8477149,Scott Sabourin,R,SJS,32,14,0,4,4
4,8480823,Alexander Alexeyev,D,WSH,25,14,0,4,4
4,8481593,Jayden Struble,D,MTL,23,20,0,4,4
4,8478021,William Lagesson,D,DET,28,25,3,0,3
4,8477851,Jordan Oesterle,D,BOS,32,44,2,1,3
4,8475958,Michael Sgarbossa,C,WSH,32,30,2,1,3
4,8479379,Givani Smith,R,SJS,26,33,2,1,3
4,8481719,Maxwell Crozier,D,TBL,24,15,2,1,3
4,8482460,Matt Rempe,C,NYR,22,15,2,1,3
4,8482713,Mackie Samoskevich,R,FLA,22,42,1,2,3
4,8482733,Logan Mailloux,D,MTL,31,25,1,2,3
4,8477320,Anton Blidh,L,NYR,29,17,1,2,3
4,8484258,Sam Malinski,D,COL,26,20,1,2,3
4,8482250,Callahan Burke,C,VGK,27,22,1,2,3
4,8481699,Aku Raty,R,UTA,23,18,1,2,3
4,8484325,Waltteri Merela,C,TBL,26,23,1,2,3
4,8482516,Matthew Kessel,D,STL,24,19,1,2,3
4,8483397,Marc McLaughlin,C,BOS,25,31,0,3,3
4,8480834,Ty Emberson,D,SJS,24,34,0,3,3
4,8480245,Olle Lycksell,R,PHI,25,32,0,3,3
4,8479362,Riley Tufte,L,BOS,26,18,0,3,3
4,8477244,Chad Ruhwedel,D,NYR,34,31,0,3,3
4,8479576,Vincent Desharnais,D,VAN,28,23,0,3,3
4,8481806,Louis Crevier,D,CHI,23,13,0,3,3
4,8477810,Joel Hanley,D,CGY,33,26,0,3,3
4,8476913,Devin Shore,C,MIN,30,33,2,0,2
4,8478051,Max Willman,C,NJD,29,17,2,0,2
4,8481726,Adam Edstrom,C,NYR,24,9,2,0,2
4,8481462,Mason Morelli,L,VGK,28,14,2,0,2
4,8480084,Nick DeSimone,D,NJD,30,16,1,1,2
4,8475413,Justin Dowling,C,NJD,34,16,1,1,2
4,8481556,John Beecher,C,BOS,23,31,1,1,2
4,8484287,Cole McWard,D,VAN,23,23,1,1,2
4,8482061,Brandon Biro,L,SEA,26,14,1,1,2
4,8481024,Linus Karlsson,C,VAN,25,14,1,1,2
4,8478881,Brett Seney,L,CHI,28,14,1,1,2
4,8481541,Samuel Bolduc,D,NYI,24,23,1,1,2
4,8482162,Roby Jarventie,L,EDM,22,17,1,1,2
4,8481743,Marc Del Gaizo,D,NSH,25,25,1,1,2
4,8479419,Brett Murray,L,BUF,26,20,1,1,2
4,8482470,Ilya Solovyov,D,CGY,24,16,1,1,2
4,8477073,Kurtis MacDermid,L,NJD,30,28,0,2,2
4,8477462,Robert Hagg,D,VGK,29,25,0,2,2
4,8481030,Jack St. Ivany,D,PIT,25,16,0,2,2
4,8480468,James Hamblin,L,EDM,25,21,0,2,2
4,8474062,Riley Nash,C,NYR,35,16,0,2,2
4,8481006,Tyler Tucker,D,STL,24,18,0,2,2
4,8477541,Dakota Mermis,D,TOR,30,13,0,2,2
4,8480267,Sammy Walker,C,MIN,25,20,1,0,1
4,8481422,Jake Lucchini,C,NSH,29,12,1,0,1
4,8482172,Landon Slaggert,L,CHI,22,27,1,0,1
4,8481585,Egor Afanasyev,L,SJS,23,12,1,0,1
4,8482094,Daemon Hunt,D,MIN,22,22,1,0,1
4,8480075,Cameron Crotty,D,MIN,25,10,1,0,1
4,8480032,Shane Bowers,C,NJD,25,16,1,0,1
4,8484255,Jason Polin,R,COL,25,6,1,0,1
4,8483489,Fraser Minten,C,TOR,31,13,1,0,1
4,8483567,Georgii Merkulov,C,BOS,24,7,1,0,1
4,8483546,Marshall Rifai,D,TOR,26,4,1,0,1
4,8483920,Pierrick Dube,R,WSH,23,6,1,0,1
4,8483597,Milos Kelemen,L,UTA,25,11,1,0,1
4,8475780,Chris Wagner,R,COL,33,13,1,0,1
4,8484304,Uvis Balinskis,D,FLA,28,9,1,0,1
4,8482476,Emil Heineman,L,MTL,23,6,1,0,1
4,8483531,Brian Halonen,L,NJD,25,2,1,0,1
4,8483471,Brad Lambert,C,WPG,31,9,0,1,1
4,8475795,Dylan McIlrath,D,WSH,32,15,0,1,1
4,8481206,John Ludvig,D,PIT,24,11,0,1,1
4,8482201,Gage Goncalves,C,TBL,23,21,0,1,1
4,8483407,Brandon Scanlin,D,NYR,25,6,0,1,1
4,8482088,Justin Sourdif,R,FLA,22,11,0,1,1
4,8481578,Graeme Clarke,R,MIN,23,12,0,1,1
4,8479421,Jacob Moverare,D,LAK,26,10,0,1,1
4,8482102,Vasily Ponomarev,C,PIT,22,16,0,0,0
4,8482787,Nikita Chibrikov,R,WPG,31,5,0,0,0
4,8482118,Sam Colangelo,R,ANA,23,19,0,0,0
4,8482126,Emil Andrae,D,PHI,31,3,0,0,0
4,8483398,Declan Carlile,D,TBL,31,8,0,0,0
4,8483395,Arshdeep Bains,L,VAN,23,12,0,0,0
4,8477993,Justin Kirkland,C,CGY,28,4,0,0,0
4,8475755,Alexander Petrovic,D,DAL,32,12,0,0,0
4,8478446,Glenn Gawdin,C,LAK,27,15,0,0,0
4,8482197,Adam Raska,R,MIN,23,2,0,0,0
4,8480874,Adam Ginning,D,PHI,24,8,0,0,0
4,8484326,Patrik Koch,D,UTA,28,2,0,0,0
4,8480306,Grant Hutton,D,NYI,29,10,0,0,0
4,8479522,Hardy Haman Aktell,D,WSH,26,5,0,0,0
4,8476323,Max McCormick,L,SEA,32,4,0,0,0
4,8481655,Cole Schwindt,R,CGY,23,4,0,0,0
4,8483432,Luca Del Bel Belluz,C,CBJ,31,5,0,0,0
4,8484259,Ondrej Pavel,C,COL,31,1,0,0,0
4,8470794,Joe Pavelski,C,,40,0,0,0,0
4,8479321,Lucas Johansen,D,,27,0,0,0,0
4,8477950,Tony DeAngelo,D,,29,0,0,0,0
4,8471218,Blake Wheeler,R,,38,0,0,0,0
4,8475197,Tyson Barrie,D,,33,0,0,0,0
4,8474157,Max Pacioretty,L,,36,0,0,0,0
4,8475744,Evgeny Kuznetsov,C,,32,0,0,0,0
4,8474037,James van Riemsdyk,L,,35,0,0,0,0
4,8476907,Mackenzie MacEachern,L,,30,0,0,0,0
4,8480216,Jacob Peterson,C,,25,0,0,0,0
4,8474602,Justin Schultz,D,,34,0,0,0,0
4,8482222,Alexander Barabanov,L,,30,0,0,0,0
4,8474031,Kevin Shattenkirk,D,,35,0,0,0,0
4,8477330,Dominik Kubalik,L,,29,0,0,0,0
4,8480884,Calen Addison,D,,24,0,0,0,0
4,8475906,John Klingberg,D,,32,0,0,0,0
4,8480008,Adam Ruzicka,C,,25,0,0,0,0
4,8476884,Derrick Pouliot,D,,30,0,0,0,0
4,8476919,Chris Tierney,C,,30,0,0,0,0
4,8479415,Michael McLeod,C,,26,0,0,0,0
4,8474870,Tyler Johnson,C,,34,0,0,0,0
4,8470604,Jeff Carter,C,,39,0,0,0,0
4,8478104,Sammy Blais,L,,28,0,0,0,0
4,8474884,Mike Hoffman,C,,35,0,0,0,0
4,8481591,Sam Poulin,R,,23,0,0,0,0
4,8471274,Alex Goligoski,D,,39,0,0,0,0
4,8476871,Tanner Pearson,L,,32,0,0,0,0
4,8476393,Nick Cousins,C,,31,0,0,0,0
4,8479977,Kailer Yamamoto,R,,26,0,0,0,0
4,8479346,Dillon Dube,C,,26,0,0,0,0
4,8480184,Gustav Lindstrom,D,,26,0,0,0,0
4,8479376,Victor Mete,D,,26,0,0,0,0
4,8473449,Kyle Okposo,R,,36,0,0,0,0
4,8481058,Jesse Ylonen,R,,25,0,0,0,0
4,8475752,Tyler Pitlick,C,,33,0,0,0,0
4,8481239,Samuel Fagemo,L,,24,0,0,0,0
4,8480821,Filip Zadina,R,,25,0,0,0,0
4,8470966,Mark Giordano,D,,41,0,0,0,0
4,8478495,Denis Gurianov,R,,27,0,0,0,0
4,8477464,Nic Petan,C,,29,0,0,0,0
4,8478099,Kevin Labanc,R,,29,0,0,0,0
4,8482241,Radim Zohorna,L,,28,0,0,0,0
4,8474040,Sam Gagner,C,,35,0,0,0,0
4,8479514,Rem Pitlick,C,,27,0,0,0,0
4,8478430,Oliver Kylington,D,,27,0,0,0,0
4,8479533,Joona Koppanen,L,,26,0,0,0,0
4,8479984,Cal Foote,D,,26,0,0,0,0
4,8477126,Jayson Megna,C,,34,0,0,0,0
4,8475164,Jakob Silfverberg,R,,34,0,0,0,0
4,8474009,Nick Bonino,C,,36,0,0,0,0
4,8479458,Nikita Zaitsev,D,,33,0,0,0,0
4,8477944,Jakub Vrana,L,,28,0,0,0,0
4,8471699,Andrew Cogliano,C,,37,0,0,0,0
4,8478067,Oskar Lindblom,L,,28,0,0,0,0
4,8471686,Marc Staal,D,,37,0,0,0,0
4,8470610,Zach Parise,L,,40,0,0,0,0
4,8478904,Steven Lorentz,C,,28,0,0,0,0
4,8473473,Milan Lucic,L,,36,0,0,0,0
4,8480031,Maxime Comtois,L,,25,0,0,0,0
4,8478512,Austin Czarnik,C,,32,0,0,0,0
4,8473504,Cal Clutterbuck,R,,37,0,0,0,0
4,8477454,Adam Erne,L,,29,0,0,0,0
4,8479383,Boris Katchouk,L,,26,0,0,0,0
4,8475825,Jani Hakanpää,D,,32,0,0,0,0
4,8477846,Ryan Carpenter,C,,33,0,0,0,0
4,8477930,Pierre-Edouard Bellemare,L,,39,0,0,0,0
4,8478400,Colin White,C,,27,0,0,0,0
4,8480226,Marián Studenic,R,,26,0,0,0,0
4,8480853,Liam Foudy,C,,24,0,0,0,0
4,8475797,Jarred Tinordi,D,,32,0,0,0,0
4,8479423,Alex Nylander,L,,26,0,0,0,0
4,8474618,Marco Scandella,D,,34,0,0,0,0
4,8478028,Fredrik Olofsson,L,,28,0,0,0,0
4,8474709,Matt Martin,L,,35,0,0,0,0
4,8481070,Hugh McGing,L,,26,0,0,0,0
4,8479546,Oskar Steen,C,,26,0,0,0,0
4,8474145,Robert Bortuzzo,D,,35,0,0,0,0
4,8476915,Jujhar Khaira,L,,30,0,0,0,0
4,8480274,Philip Kemp,D,EDM,25,0,0,0,0
4,8484321,Nikolas Matinpalo,D,OTT,26,1,0,0,0
4,8475278,Byron Froese,C,,33,0,0,0,0
4,8481812,Nikolai Knyzhov,D,,27,0,0,0,0
4,8478408,Travis Dermott,D,,28,0,0,0,0
4,8481077,John Leonard,L,,26,0,0,0,0
4,8479547,Matthew Phillips,R,,26,0,0,0,0
4,8480836,Jonathan Gruden,C,,24,0,0,0,0
4,8481690,Tyler Angle,C,,24,0,0,0,0
4,8475766,Austin Watson,L,,32,0,0,0,0
4,8478854,Ryan Shea,D,PIT,27,5,0,0,0
4,8481016,Ruslan Iskhakov,C,,24,0,0,0,0
4,8478078,Rourke Chartier,C,,28,0,0,0,0
4,8479330,Brandon Gignac,C,MTL,27,7,0,0,0
4,8483401,Marc Johnstone,R,PIT,28,2,0,0,0
4,8480776,Sheldon Rempal,R,,29,0,0,0,0
4,8478956,Samuel Laberge,L,NJD,27,0,0,0,0
4,8483609,Adam Klapka,R,CGY,24,1,0,0,0
4,8483045,Cameron Butler,R,CBJ,31,0,0,0,0
4,8481534,Raphael Lavoie,C,EDM,24,2,0,0,0
4,8478147,Bokondji Imama,L,PIT,28,2,0,0,0
4,8484314,Jiri Smejkal,L,,28,0,0,0,0
5,8479318,Auston Matthews,C,TOR,27,80,73,77,150
5,8477492,Nathan MacKinnon,C,COL,29,81,47,96,143
5,8478402,Connor McDavid,C,EDM,27,79,41,95,136
5,8477956,David Pastrnak,R,BOS,28,82,63,69,132
5,8476453,Nikita Kucherov,R,TBL,31,82,42,84,126
5,8477934,Leon Draisaitl,C,EDM,29,77,38,87,125
5,8479314,Matthew Tkachuk,L,FLA,27,81,43,76,119
5,8478550,Artemi Panarin,L,NYR,33,76,47,68,115
5,8477946,Dylan Larkin,C,DET,28,80,56,56,112
5,8480023,Robert Thomas,C,STL,25,73,22,80,102
5,8478420,Mikko Rantanen,R,COL,28,81,44,54,98
5,8471675,Sidney Crosby,C,PIT,37,75,31,67,98
5,8477404,Jake Guentzel,C,TBL,30,82,46,51,97
5,8482116,Tim Stützle,C,OTT,22,80,35,62,97
5,8478864,Kirill Kaprizov,L,MIN,27,75,38,58,96
5,8481559,Jack Hughes,C,NJD,23,78,28,68,96
5,8474600,Roman Josi,D,NSH,34,75,23,73,96
5,8476887,Filip Forsberg,L,NSH,30,75,47,48,95
5,8478483,Mitch Marner,R,TOR,27,81,34,61,95
5,8480027,Jason Robertson,L,DAL,25,82,31,64,95
5,8477942,Kevin Fiala,L,LAK,28,81,30,65,95
5,8476468,J.T. Miller,C,VAN,31,71,26,69,95
5,8478010,Brayden Point,C,TBL,28,81,44,50,94
5,8480012,Elias Pettersson,C,VAN,26,79,43,51,94
5,8477939,William Nylander,R,TOR,28,79,36,57,93
5,8478445,Mathew Barzal,C,NYI,27,80,20,72,92
5,8480801,Brady Tkachuk,L,OTT,25,80,30,61,91
5,8476459,Mika Zibanejad,C,NYR,31,71,29,62,91
5,8477501,Valeri Nichushkin,R,COL,29,82,40,49,89
5,8471685,Anze Kopitar,C,LAK,37,81,26,58,84
5,8480002,Nico Hischier,C,NJD,25,70,33,50,83
5,8477951,Nick Schmaltz,C,UTA,28,79,28,55,83
5,8477493,Aleksander Barkov,C,FLA,29,78,21,62,83
5,8479420,Tage Thompson,C,BUF,27,76,41,41,82
5,8473419,Brad Marchand,L,BOS,36,81,30,50,80
5,8475765,Vladimir Tarasenko,R,DET,33,80,26,54,80
5,8479407,Jesper Bratt,L,NJD,26,78,24,56,80
5,8477409,Carter Verhaeghe,C,FLA,29,79,39,40,79
5,8477933,Sam Reinhart,C,FLA,29,79,37,41,78
5,8478439,Travis Konecny,R,PHI,27,77,35,43,78
5,8476389,Vincent Trocheck,C,NYR,31,80,32,46,78
5,8479337,Alex DeBrincat,R,DET,27,81,32,46,78
5,8479343,Clayton Keller,R,UTA,26,75,30,48,78
5,8484144,Connor Bedard,C,CHI,19,67,25,53,78
5,8478427,Sebastian Aho,C,CAR,27,75,37,40,77
5,8477960,Adrian Kempe,R,LAK,28,80,36,41,77
5,8475166,John Tavares,C,TOR,34,81,31,46,77
5,8475184,Chris Kreider,L,NYR,33,75,50,26,76
5,8478398,Kyle Connor,L,WPG,28,78,34,42,76
5,8475913,Mark Stone,R,VGK,32,77,21,55,76
5,8482093,Seth Jarvis,C,CAR,22,73,32,43,75
5,8475726,Tyler Toffoli,C,SJS,32,66,32,43,75
5,8477949,Alex Tuch,R,BUF,28,71,28,47,75
5,8480800,Quinn Hughes,D,VAN,25,73,9,66,75
5,8475172,Nazem Kadri,C,CGY,34,80,30,44,74
5,8474564,Steven Stamkos,C,NSH,34,73,22,52,74
5,8479385,Jordan Kyrou,C,STL,26,75,38,35,73
5,8479675,Trevor Moore,L,LAK,29,79,38,35,73
5,8480208,Drake Batherson,R,OTT,26,82,28,45,73
5,8480036,Miro Heiskanen,D,DAL,25,79,9,64,73
5,8477402,Pavel Buchnevich,L,STL,29,72,28,44,72
5,8476346,Johnny Gaudreau,L,CBJ,31,77,18,54,72
5,8474578,Erik Karlsson,D,PIT,34,80,13,59,72
5,8478460,Zach Werenski,D,CBJ,27,78,13,59,72
5,8480830,Andrei Svechnikov,R,CAR,24,73,25,46,71
5,8476454,Ryan Nugent-Hopkins,C,EDM,31,81,18,53,71
5,8475158,Ryan O'Reilly,C,NSH,33,75,31,39,70
5,8477940,Nikolaj Ehlers,L,WPG,28,74,29,41,70
5,8475168,Matt Duchene,C,DAL,33,82,28,42,70
5,8481557,Matt Boldy,L,MIN,23,67,26,44,70
5,8478414,Timo Meier,R,NJD,28,78,26,44,70
5,8477500,Bo Horvat,C,NYI,29,80,32,37,69
5,8475794,Tyler Seguin,C,DAL,32,81,32,37,69
5,8482078,Lucas Raymond,L,DET,22,80,28,41,69
5,8475692,Mats Zuccarello,R,MIN,37,73,15,54,69
5,8475786,Zach Hyman,L,EDM,32,76,39,29,68
5,8478403,Jack Eichel,C,VGK,28,74,34,33,67
5,8480039,Martin Necas,C,CAR,25,75,27,40,67
5,8480839,Rasmus Dahlin,D,BUF,24,66,20,47,67
5,8475810,Bryan Rust,R,PIT,32,72,40,26,66
5,8481528,Dylan Cozens,C,BUF,23,70,31,35,66
5,8481068,Yegor Sharangovich,C,CGY,26,77,28,38,66
5,8478444,Brock Boeser,R,VAN,27,73,23,43,66
5,8477496,Elias Lindholm,C,BOS,30,80,21,45,66
5,8476853,Morgan Rielly,D,TOR,30,75,12,54,66
5,8475754,Brock Nelson,C,NYI,33,80,32,33,65
5,8471214,Alex Ovechkin,L,WSH,39,70,30,35,65
5,8475784,Jeff Skinner,C,EDM,32,74,26,39,65
5,8478440,Dylan Strome,C,WSH,27,75,20,45,65
5,8471215,Evgeni Malkin,C,PIT,38,74,28,36,64
5,8476456,Jonathan Huberdeau,C,CGY,31,79,17,47,64
5,8478449,Roope Hintz,C,DAL,28,81,31,32,63
5,8476460,Mark Scheifele,C,WPG,31,67,31,32,63
5,8474141,Patrick Kane,R,DET,36,79,26,37,63
5,8480018,Nick Suzuki,C,MTL,25,75,26,37,63
5,8480069,Cale Makar,D,COL,26,63,22,41,63
5,8479323,Adam Fox,D,NYR,26,70,14,49,63
5,8480865,Noah Dobson,D,NYI,24,79,11,52,63
5,8478366,Frank Vatrano,R,ANA,30,79,34,28,62
5,8476432,Boone Jenner,C,CBJ,31,68,33,28,61
5,8478493,Joel Eriksson Ek,C,MIN,27,73,31,30,61
5,8474641,Adam Henrique,C,EDM,34,78,28,33,61
5,8476479,Phillip Danault,C,LAK,31,82,24,37,61
5,8477476,Artturi Lehkonen,L,COL,29,81,31,29,60
5,8476539,Jonathan Marchessault,R,NSH,34,76,29,31,60
5,8477444,Andre Burakovsky,L,SEA,29,75,26,34,60
5,8475745,Charlie Coyle,C,BOS,32,78,20,40,60
5,8479999,Casey Mittelstadt,C,COL,26,82,17,43,60
5,8473994,Jamie Benn,L,DAL,35,81,28,31,59
5,8479542,Brandon Hagel,L,TBL,26,81,25,34,59
5,8481711,Matias Maccelli,L,UTA,24,71,16,43,59
5,8482684,Luke Hughes,D,NJD,21,75,14,45,59
5,8480803,Evan Bouchard,D,EDM,25,78,12,47,59
5,8477416,Oliver Bjorkstrand,R,SEA,29,70,24,34,58
5,8473986,Alex Killorn,L,ANA,35,70,23,35,58
5,8477998,Warren Foegele,L,LAK,28,79,17,41,58
5,8477504,Josh Morrissey,D,WPG,29,75,10,48,58
5,8475167,Victor Hedman,D,TBL,34,78,9,49,58
5,8471724,Kris Letang,D,PIT,37,81,9,49,58
5,8476881,Tomas Hertl,C,VGK,31,76,28,29,57
5,8480015,Owen Tippett,R,PHI,25,77,27,30,57
5,8482740,Wyatt Johnston,C,DAL,21,81,26,31,57
5,8479400,Pierre-Luc Dubois,L,WSH,26,71,26,31,57
5,8482124,Quinton Byfield,R,LAK,22,78,21,36,57
5,8475169,Evander Kane,L,EDM,33,76,31,25,56
5,8477494,Jonathan Drouin,L,COL,29,80,10,46,56
5,8476880,Tom Wilson,R,WSH,30,75,24,31,55
5,8482665,Matty Beniers,C,SEA,22,71,23,32,55
5,8476905,Chandler Stephenson,C,SEA,30,76,21,34,55
5,8475191,Reilly Smith,R,NYR,33,79,20,35,55
5,8482745,Mason McTavish,C,ANA,21,73,25,29,54
5,8482699,Dylan Guenther,R,UTA,21,77,24,30,54
5,8477935,Sam Bennett,C,FLA,28,76,22,32,54
5,8478401,Pavel Zacha,C,BOS,27,79,21,33,54
5,8473512,Claude Giroux,R,OTT,36,77,20,34,54
5,8481540,Cole Caufield,R,MTL,23,75,31,22,53
5,8477497,Sean Monahan,C,CBJ,30,63,21,32,53
5,8476399,Blake Coleman,C,CGY,33,77,21,32,53
5,8483431,Logan Cooley,C,UTA,20,78,21,32,53
5,8484166,Adam Fantilli,C,CBJ,20,74,21,32,53
5,8477986,Brandon Montour,D,SEA,30,72,15,38,53
5,8474563,Drew Doughty,D,LAK,35,74,11,42,53
5,8482702,Logan Stankoven,C,DAL,21,81,20,32,52
5,8474150,Mikael Backlund,C,CGY,35,79,17,35,52
5,8474590,John Carlson,D,WSH,34,72,14,38,52
5,8478975,Mason Marchment,L,DAL,29,82,29,22,51
5,8477955,Jared McCann,L,SEA,28,70,25,26,51
5,8477511,Anthony Mantha,R,CGY,30,74,22,29,51
5,8481596,Shane Pinto,C,OTT,24,78,19,32,51
5,8476882,Teuvo Teravainen,C,CHI,30,64,16,35,51
5,8477932,Aaron Ekblad,D,FLA,28,72,14,37,51
5,8475798,Mikael Granlund,C,SJS,32,70,12,39,51
5,8479325,Charlie McAvoy,D,BOS,27,78,7,44,51
5,8479425,Filip Hronek,D,VAN,27,72,5,46,51
5,8482110,Dawson Mercer,C,NJD,23,70,28,22,50
5,8476448,William Karlsson,C,VGK,31,75,25,25,50
5,8482113,Anton Lundell,C,FLA,23,76,22,28,50
5,8477456,J.T. Compher,L,DET,29,82,22,28,50
5,8478519,Anthony Cirelli,C,TBL,27,82,18,32,50
5,8474679,Gustav Nyquist,C,NSH,35,69,16,34,50
5,8483808,Andrei Kuzmenko,L,CGY,28,79,27,22,49
5,8482667,William Eklund,L,SJS,22,70,25,24,49
5,8482097,Jack Quinn,R,BUF,23,65,16,33,49
5,8480014,Gabriel Vilardi,C,WPG,25,68,29,19,48
5,8475314,Anders Lee,L,NYI,34,78,27,21,48
5,8482109,Alexis Lafrenière,L,NYR,23,75,24,24,48
5,8479987,Morgan Geekie,C,BOS,26,76,18,30,48
5,8482149,Cole Perfetti,C,WPG,22,65,15,33,48
5,8476875,Mike Matheson,D,MTL,30,75,9,39,48
5,8480185,Eetu Luostarinen,C,FLA,26,76,25,22,47
5,8480064,Josh Norris,C,OTT,25,76,24,23,47
5,8482720,Matthew Knies,L,TOR,22,80,19,28,47
5,8477495,Seth Jones,D,CHI,30,71,18,29,47
5,8481542,Moritz Seider,D,DET,23,76,14,33,47
5,8478474,Lawson Crouse,L,UTA,27,79,27,19,46
5,8474102,David Perron,L,OTT,36,81,21,25,46
5,8476292,Ondrej Palat,L,NJD,33,71,17,29,46
5,8476462,Dougie Hamilton,D,NJD,31,71,13,33,46
5,8480798,Philipp Kurashev,C,CHI,25,63,12,34,46
5,8481581,Thomas Harley,D,DAL,23,75,6,40,46
5,8481533,Trevor Zegras,C,ANA,23,64,24,21,45
5,8484153,Leo Carlsson,C,ANA,20,76,21,24,45
5,8481604,Pavel Dorofeyev,L,VGK,24,73,19,26,45
5,8475170,Brayden Schenn,C,STL,33,75,15,30,45
5,8480028,Morgan Frost,C,PHI,25,71,14,31,45
5,8481524,Bowen Byram,D,BUF,23,65,12,33,45
5,8477503,Max Domi,C,TOR,29,75,6,39,45
5,8477407,Anthony Duclair,L,NYI,29,77,21,23,44
5,8481560,Arthur Kaliyev,R,LAK,23,80,20,24,44
5,8481554,Kaapo Kakko,R,NYR,23,73,20,24,44
5,8477451,Ryan Hartman,R,MIN,30,70,19,25,44
5,8475287,Erik Haula,L,NJD,33,71,16,28,44
5,8476826,Yanni Gourde,C,SEA,33,73,14,30,44
5,8482671,Owen Power,D,BUF,22,73,10,34,44
5,8470613,Brent Burns,D,CAR,39,77,9,35,44
5,8478396,Noah Hanifin,D,VGK,27,66,9,35,44
5,8482122,Brock Faber,D,MIN,22,81,5,39,44
5,8476438,Brandon Saad,L,STL,32,73,31,12,43
5,8476483,Rickard Rakell,R,PIT,31,66,23,20,43
5,8475151,Kyle Palmieri,C,NYI,33,80,22,21,43
5,8475799,Nino Niederreiter,R,WPG,32,71,21,22,43
5,8475793,Ryan Johansen,C,PHI,32,76,21,22,43
5,8479339,Patrik Laine,L,CBJ,26,63,18,25,43
5,8483515,Juraj Slafkovsky,L,MTL,20,76,17,26,43
5,8474716,Jared Spurgeon,D,MIN,35,77,13,30,43
5,8479410,Mikhail Sergachev,D,UTA,26,72,12,31,43
5,8478397,Rasmus Andersson,D,CGY,28,67,8,35,43
5,8479525,Ross Colton,C,COL,28,79,26,16,42
5,8480009,Eeli Tolvanen,R,SEA,25,70,25,17,42
5,8481618,Alex Newhook,C,MTL,23,70,15,27,42
5,8478047,Michael Bunting,L,PIT,29,69,14,28,42
5,8477346,MacKenzie Weegar,D,CGY,30,79,14,28,42
5,8478873,Troy Terry,R,ANA,27,70,13,29,42
5,8475753,Justin Faulk,D,STL,32,72,10,32,42
5,8478407,Vince Dunn,D,SEA,28,71,9,33,42
5,8482089,Jake Neighbours,L,STL,22,71,25,16,41
5,8478057,Dakota Joshua,C,VAN,28,68,23,18,41
5,8484145,Zach Benson,L,BUF,19,73,20,21,41
5,8482475,Yegor Chinakhov,R,CBJ,23,66,18,23,41
5,8477839,Conor Sheary,L,TBL,32,81,16,25,41
5,8479591,Michael Eyssimont,C,TBL,28,82,15,26,41
5,8479345,Jakob Chychrun,D,WSH,26,67,12,29,41
5,8480434,Sean Durzi,D,UTA,26,69,10,31,41
5,8478055,Gustav Forsling,D,FLA,28,73,6,35,41
5,8477426,Nicholas Paul,L,TBL,29,80,23,17,40
5,8477964,Ivan Barbashev,C,VGK,29,75,22,18,40
5,8475768,Jaden Schwartz,C,SEA,32,71,20,20,40
5,8477429,Andrew Copp,C,DET,30,77,15,25,40
5,8474586,Jordan Eberle,R,SEA,34,74,12,28,40
5,8477021,Alex Kerfoot,C,UTA,30,71,12,28,40
5,8476480,Vladislav Namestnikov,C,WPG,32,67,12,28,40
5,8480817,K'Andre Miller,D,NYR,24,65,10,30,40
5,8477498,Darnell Nurse,D,EDM,29,74,9,31,40
5,8476906,Shayne Gostisbehere,D,CAR,31,73,6,34,40
5,8471698,T.J. Oshie,R,WSH,38,56,19,20,39
5,8482092,Ridly Greig,C,OTT,22,76,19,20,39
5,8480835,Jack Drury,C,CAR,24,61,14,25,39
5,8478542,Evan Rodrigues,C,FLA,31,75,13,26,39
5,8483490,Pavel Mintyukov,D,ANA,21,77,9,30,39
5,8477447,Shea Theodore,D,VGK,29,56,8,31,39
5,8476854,Hampus Lindholm,D,BOS,30,77,6,33,39
5,8476792,Torey Krug,D,STL,33,67,5,34,39
5,8483505,Matthew Poitras,C,BOS,20,79,16,22,38
5,8476458,Ryan Strome,C,ANA,31,75,15,23,38
5,8476925,Colton Sissons,C,NSH,31,70,15,23,38
5,8482159,Tyson Foerster,R,PHI,22,76,14,24,38
5,8480797,Joel Farabee,L,PHI,24,72,12,26,38
5,8474053,Logan Couture,C,SJS,35,65,12,26,38
5,8477948,Travis Sanheim,D,PHI,28,73,12,26,38
5,8480145,Neal Pionk,D,WPG,29,76,9,29,38
5,8478038,Devon Toews,D,COL,30,70,7,31,38
5,8482175,JJ Peterka,R,BUF,22,64,20,17,37
5,8480188,Fabian Zetterlund,L,SJS,25,64,20,17,37
5,8478233,Andrew Mangiapane,L,WSH,28,69,18,19,37
5,8478042,Viktor Arvidsson,L,EDM,31,72,15,22,37
5,8478466,Daniel Sprong,R,VAN,27,70,15,22,37
5,8481523,Kirby Dach,C,MTL,23,67,15,22,37
5,8478413,Jordan Greenway,L,BUF,27,69,14,23,37
5,8475714,Calle Jarnkrok,C,TOR,33,79,21,15,36
5,8480829,Jesperi Kotkaniemi,C,CAR,24,63,19,17,36
5,8480813,Joe Veleno,C,DET,24,71,18,18,36
5,8477479,Tyler Bertuzzi,L,CHI,29,64,16,20,36
5,8478438,Tommy Novak,C,NSH,27,65,13,23,36
5,8479992,Michael Rasmussen,C,DET,25,79,13,23,36
5,8481577,Philip Tomasino,C,NSH,23,65,8,28,36
5,8477969,Marcus Pettersson,D,PIT,28,81,5,31,36
5,8482055,Drew O'Connor,L,PIT,26,64,24,11,35
5,8482705,Cole Sillinger,C,CBJ,21,70,18,17,35
5,8476461,Sean Couturier,C,PHI,32,68,18,17,35
5,8478856,Conor Garland,R,VAN,28,75,15,20,35
5,8476872,Scott Laughton,C,PHI,30,70,14,21,35
5,8482105,Jake Sanderson,D,OTT,22,68,14,21,35
5,8475848,Brendan Gallagher,R,MTL,32,73,12,23,35
5,8476885,Jacob Trouba,D,NYR,30,74,8,27,35
5,8475764,Cam Fowler,D,ANA,33,73,3,32,35
5,8470621,Corey Perry,R,EDM,39,71,19,15,34
5,8479365,Trent Frederic,C,BOS,26,78,17,17,34
5,8480849,Barrett Hayton,C,UTA,24,70,15,19,34
5,8478458,John (Jack) Roslovic,C,CAR,27,71,12,22,34
5,8477987,Ryan Donato,C,CHI,28,57,12,22,34
5,8478469,Thomas Chabot,D,OTT,27,75,10,24,34
5,8478462,Nicolas Roy,C,VGK,27,78,10,24,34
5,8475218,Mattias Ekholm,D,EDM,34,65,7,27,34
5,8481703,Valtteri Puustinen,R,PIT,25,53,6,28,34
5,8476923,Damon Severson,D,CBJ,30,82,3,31,34
5,8480873,Rasmus Sandin,D,WSH,24,67,3,31,34
5,8475763,Kevin Hayes,R,PIT,32,69,22,11,33
5,8478115,Pierre Engvall,L,NYI,28,75,12,21,33
5,8476869,Brady Skjei,D,NSH,30,74,11,22,33
5,8480871,Adam Boqvist,D,FLA,24,70,11,22,33
5,8476892,Colton Parayko,D,STL,31,78,6,27,33
5,8476331,Dylan DeMelo,D,WPG,31,69,5,28,33
5,8479996,Cody Glass,C,NSH,25,60,19,13,32
5,8475722,Jason Zucker,L,BUF,32,66,18,14,32
5,8478498,Jake DeBrusk,L,VAN,28,69,17,15,32
5,8477446,Michael McCarron,R,NSH,29,58,16,16,32
5,8474715,Cameron Atkinson,R,TBL,35,82,14,18,32
5,8480113,Alex Iafallo,L,WPG,31,67,14,18,32
5,8484203,Bradly Nadeau,L,CAR,19,64,13,19,32
5,8474149,Evgenii Dadonov,R,DAL,35,82,11,21,32
5,8479398,Samuel Girard,D,COL,26,66,4,28,32
5,8480459,Pius Suter,C,VAN,28,74,22,9,31
5,8476878,Zemgus Girgensons,C,TBL,30,81,20,11,31
5,8480802,Ryan McLeod,C,BUF,25,70,15,16,31
5,8482079,Marco Rossi,C,MIN,23,50,13,18,31
5,8480220,Noah Cates,L,PHI,25,70,11,20,31
5,8476419,Jean-Gabriel Pageau,C,NYI,32,76,9,22,31
5,8478472,Mathieu Joseph,R,STL,27,68,8,23,31
5,8476917,Adam Pelech,D,NYI,30,82,5,26,31
5,8478508,Yakov Trenin,C,MIN,27,68,21,9,30
5,8481186,Logan O'Connor,R,COL,28,81,17,13,30
5,8478046,Danton Heinen,L,VAN,29,69,17,13,30
5,8477478,William Carrier,L,CAR,30,58,17,13,30
5,8481601,Simon Holmstrom,R,NYI,23,68,16,14,30
5,8482146,Luke Evangelista,R,NSH,22,66,12,18,30
5,8482133,Thomas Bordeleau,C,SJS,22,67,12,18,30
5,8479390,Taylor Raddysh,R,WSH,26,67,12,18,30
5,8477947,Sonny Milano,L,WSH,28,60,11,19,30
5,8477505,Alexander Wennberg,C,SJS,30,62,10,20,30
5,8475171,Oliver Ekman-Larsson,D,TOR,33,64,7,23,30
5,8482712,Oskar Olausson,R,COL,22,75,4,26,30
5,8476979,Erik Gustafsson,D,DET,32,72,4,26,30
5,8475760,Nick Bjugstad,C,UTA,32,73,16,13,29
5,8479661,Tanner Jeannot,L,LAK,27,78,16,13,29
5,8476981,Josh Anderson,R,MTL,30,65,13,16,29
5,8475791,Taylor Hall,L,CHI,33,54,13,16,29
5,8475200,Dmitry Orlov,D,CAR,33,71,8,21,29
5,8480078,Filip Chytil,C,NYR,25,64,8,21,29
5,8476463,Jonas Brodin,D,MIN,31,76,8,21,29
5,8478432,Christian Fischer,R,DET,27,76,8,21,29
5,8478882,Vladislav Gavrikov,D,LAK,29,71,6,23,29
5,8476958,Jaccob Slavin,D,CAR,30,75,4,25,29
5,8474189,Lars Eller,C,PIT,35,70,15,13,28
5,8475220,Marcus Foligno,L,MIN,33,61,14,14,28
5,8476392,Adam Lowry,C,WPG,31,62,13,15,28
5,8473533,Jordan Staal,C,CAR,36,68,13,15,28
5,8477989,Christian Dvorak,C,MTL,28,65,9,19,28
5,8480336,Sean Walker,D,CAR,30,74,7,21,28
5,8478970,Jalen Chatfield,D,CAR,28,69,6,22,28
5,8478109,Victor Olofsson,L,VGK,29,62,16,11,27
5,8480893,Kirill Marchenko,R,CBJ,24,62,15,12,27
5,8476474,Stefan Noesen,R,NJD,31,69,14,13,27
5,8476921,Jordan Martinook,L,CAR,32,61,12,15,27
5,8476927,Teddy Blueger,C,VAN,30,68,10,17,27
5,8481546,Cam York,D,PHI,23,67,10,17,27
5,8477952,Robby Fabbri,C,ANA,28,59,8,19,27
5,8479368,Max Jones,L,BOS,26,69,8,19,27
5,8482660,Kent Johnson,C,CBJ,22,63,6,21,27
5,8481606,Jordan Spence,D,LAK,23,64,3,24,27
5,8480043,Timothy Liljegren,D,TOR,25,63,3,24,27
5,8475193,Tomas Tatar,L,NJD,34,70,18,8,26
5,8477919,Frederick Gaudreau,C,MIN,31,64,16,10,26
5,8477953,Kasperi Kapanen,R,STL,28,63,11,15,26
5,8480878,Nils Lundkvist,D,DAL,24,78,10,16,26
5,8481656,Aliaksei Protas,C,WSH,23,59,9,17,26
5,8480748,Kiefer Sherwood,L,VAN,29,57,8,18,26
5,8479639,Dylan Coghlan,D,WPG,26,65,6,20,26
5,8477488,Brett Pesce,D,NJD,30,72,5,21,26
5,8482655,Janis Moser,D,TBL,24,78,4,22,26
5,8474151,Ryan McDonagh,D,TBL,35,75,4,22,26
5,8473422,Nick Foligno,L,CHI,37,57,14,11,25
5,8477450,Jason Dickinson,C,CHI,29,54,13,12,25
5,8480144,David Kampf,C,TOR,29,71,11,14,25
5,8479351,Sam Steel,C,DAL,26,81,10,15,25
5,8478891,Mason Appleton,C,WPG,28,63,10,15,25
5,8479941,Justin Danforth,R,CBJ,31,59,10,15,25
5,8482803,Olen Zellweger,D,ANA,21,67,10,15,25
5,8481441,Joe Snively,C,DET,28,61,9,16,25
5,8482067,Connor Mackey,D,NYR,28,63,7,18,25
5,8476525,Colin Miller,D,WPG,32,59,7,18,25
5,8477979,Nicolas Aube-Kubel,R,BUF,28,58,7,18,25
5,8475231,Casey Cizikas,C,NYI,33,65,6,19,25
5,8475149,Marcus Johansson,L,MIN,34,64,5,20,25
5,8478507,John Marino,D,UTA,27,58,3,22,25
5,8480727,Zach Whitecloud,D,VGK,28,55,3,22,25
5,8480789,Oliver Wahlstrom,R,NYI,24,72,14,10,24
5,8480448,Parker Kelly,L,COL,25,79,14,10,24
5,8481553,Bobby Brink,R,PHI,23,64,10,14,24
5,8476329,Travis Boyd,C,MIN,31,51,8,16,24
5,8478133,Jake Evans,C,MTL,28,68,7,17,24
5,8480891,Michael Kesselring,D,UTA,24,61,7,17,24
5,8482142,Jamie Drysdale,D,PHI,22,57,5,19,24
5,8477220,Nate Schmidt,D,FLA,33,64,3,21,24
5,8476467,Jamie Oleksiak,D,SEA,32,69,3,21,24
5,8481582,Nicholas Robertson,L,TOR,23,66,16,7,23
5,8482157,Will Cuylle,L,NYR,22,63,14,9,23
5,8482117,Lukas Reichel,L,CHI,22,58,12,11,23
5,8476918,Jimmy Vesey,L,NYR,31,68,11,12,23
5,8478463,Anthony Beauvillier,L,PIT,27,70,10,13,23
5,8478020,Michael Amadio,R,OTT,28,74,10,13,23
5,8481481,Blake Lizotte,C,PIT,27,67,10,13,23
5,8474034,Patrick Maroon,L,CHI,36,57,9,14,23
5,8477353,Tyler Motte,C,DET,29,78,9,14,23
5,8474565,Alex Pietrangelo,D,VGK,34,59,6,17,23
5,8482624,Daniil Miromanov,D,CGY,27,62,3,20,23
5,8473507,Jeff Petry,D,DET,37,70,3,20,23
5,8478136,Jake Middleton,D,MIN,28,71,3,20,23
5,8475181,Nick Leddy,D,STL,33,67,3,20,23
5,8478851,Alexandre Carrier,D,NSH,28,69,2,21,23
5,8479336,Carl Grundstrom,R,SJS,27,52,12,10,22
5,8481032,Paul Cotter,C,NJD,25,58,11,11,22
5,8477903,Garnet Hathaway,R,PHI,33,65,11,11,22
5,8482074,Connor Zary,C,CGY,23,57,11,11,22
5,8481624,Ilya Mikheyev,R,CHI,30,66,11,11,22
5,8477425,Miles Wood,L,COL,29,78,10,12,22
5,8475855,Jesper Fast,R,CAR,33,59,10,12,22
5,8480762,Eric Robinson,L,CAR,29,45,9,13,22
5,8483457,Lane Hutson,D,MTL,20,71,8,14,22
5,8480855,Jack McBain,C,UTA,24,66,8,14,22
5,8480021,Jack Studnicka,C,LAK,25,60,7,15,22
5,8477435,Ryan Graves,D,PIT,29,77,6,16,22
5,8474574,Tyler Myers,D,VAN,34,66,6,16,22
5,8483495,Simon Nemec,D,NJD,20,61,6,16,22
5,8476902,Esa Lindell,D,DAL,30,74,5,17,22
5,8478911,Matt Roy,D,WSH,29,62,5,17,22
5,8476931,Jake McCabe,D,TOR,31,63,2,20,22
5,8478178,Darren Raddysh,D,TBL,28,69,0,22,22
5,8479414,Nathan Bastian,R,NJD,27,53,13,8,21
5,8479293,Brandon Tanev,L,SEA,33,68,13,8,21
5,8481535,Nils Hoglander,L,VAN,24,62,12,9,21
5,8479316,Luke Kunin,C,SJS,27,57,12,9,21
5,8482125,Alexander Holtz,R,VGK,22,69,11,10,21
5,8476960,Andreas Athanasiou,C,CHI,30,45,11,10,21
5,8480355,Mark Kastelic,C,BOS,25,68,11,10,21
5,8481580,Connor McMichael,C,WSH,23,57,10,11,21
5,8477406,Mattias Janmark,C,EDM,32,68,10,11,21
5,8483468,Jiri Kulich,C,BUF,20,57,7,14,21
5,8477392,Hudson Fasching,R,NYI,29,64,6,15,21
5,8477506,Ryan Pulock,D,NYI,30,75,4,17,21
5,8480049,Dylan Samberg,D,WPG,25,63,2,19,21
5,8482073,Braden Schneider,D,NYR,23,68,2,19,21
5,8480003,Jesper Boqvist,C,FLA,26,66,12,8,20
5,8480205,Emil Bemstrom,C,PIT,25,58,12,8,20
5,8476897,Oskar Sundqvist,C,STL,30,61,11,9,20
5,8480281,Alexey Toropchenko,R,STL,25,57,11,9,20
5,8476873,Mark Jankowski,C,NSH,30,56,10,10,20
5,8476469,Joel Armia,R,MTL,31,67,9,11,20
5,8479619,Michael Carcone,L,UTA,28,63,9,11,20
5,8482809,Jackson Blake,R,CAR,21,54,8,12,20
5,8478013,Jake Walman,D,SJS,28,75,8,12,20
5,8477369,Carson Soucy,D,VAN,30,62,8,12,20
5,8478043,Sam Lafferty,C,BUF,29,55,7,13,20
5,8480068,Ryan Poehling,C,PHI,25,68,7,13,20
5,8483491,Ivan Miroshnichenko,L,WSH,20,60,6,14,20
5,8479315,Joey Anderson,R,CHI,26,49,6,14,20
5,8470600,Ryan Suter,D,STL,39,67,6,14,20
5,8481522,Peyton Krebs,C,BUF,23,56,6,14,20
5,8477507,Nikita Zadorov,D,BOS,29,73,4,16,20
5,8482245,Artem Zub,D,OTT,29,69,3,17,20
5,8475462,Radko Gudas,D,ANA,34,68,2,18,20
5,8479371,Dante Fabbro,D,NSH,26,61,2,18,20
5,8480246,Nick Perbix,D,TBL,26,72,1,19,20
5,8482155,Alex Laferriere,R,LAK,23,61,13,6,19
5,8479520,Brandon Duhaime,R,WSH,27,61,11,8,19
5,8482679,Matt Coronato,R,CGY,22,67,10,9,19
5,8475343,Nic Dowd,C,WSH,34,59,10,9,19
5,8479353,Brett Howden,C,VGK,26,72,9,10,19
5,8478421,A.J. Greer,L,FLA,28,55,9,10,19
5,8481093,Rafael Harvey-Pinard,L,MTL,25,62,9,10,19
5,8477573,Nathan Walker,L,STL,30,55,9,10,19
5,8482749,Joshua Roy,R,MTL,21,72,8,11,19
5,8483524,Shane Wright,C,SEA,20,57,8,11,19
5,8483445,Cutter Gauthier,L,ANA,20,67,8,11,19
5,8473563,Nicklas Backstrom,C,WSH,37,54,8,11,19
5,8476429,Scott Mayfield,D,NYI,32,76,7,12,19
5,8476312,Josh Manson,D,COL,33,61,7,12,19
5,8479402,Jake Bean,D,CGY,26,67,6,13,19
5,8476856,Mathew Dumba,D,DAL,30,69,6,13,19
5,8475179,Dmitry Kulikov,D,FLA,34,66,4,15,19
5,8478452,Caleb Jones,D,LAK,27,45,4,15,19
5,8479369,Andrew Peeke,D,BOS,26,65,3,16,19
5,8479976,Juuso Valimaki,D,UTA,26,67,2,17,19
5,8480073,Erik Brannstrom,D,COL,25,60,2,17,19
5,8481716,Dmitri Voronkov,L,CBJ,24,40,11,7,18
5,8480980,Connor Dewar,C,TOR,25,63,11,7,18
5,8476278,Colin Blackwell,C,DAL,31,75,9,9,18
5,8481517,Brett Leason,R,ANA,25,56,8,10,18
5,8481028,Martin Pospisil,C,CGY,25,56,8,10,18
5,8476967,Brett Kulak,D,EDM,30,68,8,10,18
5,8482166,Shakir Mukhamadullin,D,SJS,22,49,8,10,18
5,8477015,Connor Brown,R,EDM,30,63,7,11,18
5,8476422,Mike Reilly,D,NYI,31,74,7,11,18
5,8482744,James Malatesta,L,CBJ,21,48,7,11,18
5,8478500,Ivan Provorov,D,CBJ,27,79,5,13,18
5,8482111,Justin Barron,D,MTL,23,63,5,13,18
5,8475790,Erik Gudbranson,D,CBJ,32,75,4,14,18
5,8478859,Niko Mikkola,D,FLA,28,56,4,14,18
5,8474673,TJ Brodie,D,CHI,34,67,3,15,18
5,8479982,Conor Timmins,D,TOR,26,63,2,16,18
5,8479324,Ryan Lindgren,D,NYR,26,64,1,17,18
5,8476988,Matt Benning,D,SJS,30,71,1,17,18
5,8473453,Trevor Lewis,C,LAK,37,68,11,6,17
5,8482737,Zack Bolduc,C,STL,21,57,10,7,17
5,8482784,Zach Dean,C,STL,21,47,8,9,17
5,8477508,Curtis Lazar,C,NJD,29,54,7,10,17
5,8481537,Nikita Okhotiuk,D,CGY,24,63,6,11,17
5,8480074,Alexandre Texier,C,STL,25,58,5,12,17
5,8475324,Nick Jensen,D,OTT,34,66,4,13,17
5,8478399,Jonas Siegenthaler,D,NJD,27,56,4,13,17
5,8483565,Nick Blankenburg,D,NSH,26,60,3,14,17
5,8476879,Cody Ceci,D,EDM,31,73,3,14,17
5,8471709,Marc-Edouard Vlasic,D,SJS,37,63,3,14,17
5,8478840,Will Borgen,D,SEA,28,68,1,16,17
5,8481059,Scott Perunovich,D,STL,26,55,0,17,17
5,8482259,Bobby McMann,C,TOR,28,57,12,4,16
5,8482148,Hendrix Lapierre,C,WSH,22,56,9,7,16
5,8480289,Morgan Barron,C,WPG,26,51,7,9,16
5,8483482,Tristan Luneau,D,ANA,20,67,7,9,16
5,8479393,Noah Gregor,L,OTT,26,66,6,10,16
5,8480441,Trey Fix-Wolansky,R,CBJ,25,37,6,10,16
5,8482451,Mikael Pyyhtia,L,CBJ,23,44,6,10,16
5,8479439,Jacob MacDonald,D,COL,31,53,6,10,16
5,8481550,Adam Beckman,L,NJD,23,39,5,11,16
5,8482192,Isaak Phillips,D,CHI,23,47,4,12,16
5,8480806,Isac Lundestrom,C,ANA,25,58,4,12,16
5,8479370,Tyson Jost,C,CAR,26,47,3,13,16
5,8482087,Kaiden Guhle,D,MTL,22,59,2,14,16
5,8480796,Martin Fehervary,D,WSH,25,57,2,14,16
5,8480807,Mattias Samuelsson,D,BUF,24,55,1,15,16
5,8475279,Ben Chiarot,D,DET,33,66,0,16,16
5,8478585,Derek Ryan,C,EDM,38,62,9,6,15
5,8481641,Joel Kiviranta,L,COL,28,71,9,6,15
5,8481532,Alex Turcotte,C,LAK,23,49,9,6,15
5,8481704,Juuso Parssinen,C,NSH,23,53,7,8,15
5,8476994,Vinnie Hinostroza,C,NSH,30,44,7,8,15
5,8476934,Brock McGinn,L,ANA,30,50,7,8,15
5,8483493,Frank Nazar,C,CHI,20,58,7,8,15
5,8475690,Chris Tanev,D,TOR,35,54,5,10,15
5,8481019,David Gustafsson,C,WPG,24,54,5,10,15
5,8482101,Danil Gushchin,L,SJS,22,55,4,11,15
5,8482634,Alex Steeves,C,TOR,25,50,4,11,15
5,8478451,Ethan Bear,D,WSH,27,47,4,11,15
5,8476457,Adam Larsson,D,SEA,32,72,3,12,15
5,8477499,Rasmus Ristolainen,D,PHI,30,51,3,12,15
5,8476891,Matthew Grzelcyk,D,PIT,30,75,3,12,15
5,8482095,Tyler Kleven,D,OTT,22,49,3,12,15
5,8477365,Connor Clifton,D,BUF,29,55,1,14,15
5,8480001,Urho Vaakanainen,D,ANA,25,59,0,15,15
5,8476374,Sean Kuraly,C,CBJ,31,57,9,5,14
5,8478831,Kevin Stenlund,C,UTA,28,54,9,5,14
5,8477931,Tomas Nosek,L,FLA,32,60,9,5,14
5,8476858,Phillip Di Giuseppe,L,VAN,31,41,9,5,14
5,8475225,Craig Smith,C,CHI,35,52,8,6,14
5,8477070,Liam O'Brien,C,UTA,30,57,8,6,14
5,8482062,Cole Smith,L,NSH,29,61,7,7,14
5,8481599,Victor Soderstrom,D,UTA,23,49,6,8,14
5,8479944,Zach Aston-Reese,C,VGK,30,48,5,9,14
5,8481477,Nico Sturm,C,SJS,29,53,4,10,14
5,8477018,Ben Hutton,D,VGK,31,45,4,10,14
5,8477380,Jonny Brodzinski,C,NYR,31,52,3,11,14
5,8479983,Mario Ferraro,D,SJS,26,66,2,12,14
5,8479372,Joshua Mahura,D,SEA,26,58,2,12,14
5,8481014,Alexander Romanov,D,NYI,24,74,1,13,14
5,8477845,Trevor van Riemsdyk,D,WSH,33,55,1,13,14
5,8481568,Alex Vlasic,D,CHI,23,63,1,13,14
5,8481178,Egor Zamula,D,PHI,24,62,1,13,14
5,8479718,Alex Barré-Boulet,C,MTL,27,47,10,3,13
5,8482762,Simon Edvinsson,D,DET,21,56,7,6,13
5,8479066,Ryan Lomberg,L,CGY,30,64,6,7,13
5,8476822,Luke Glendening,C,TBL,35,79,6,7,13
5,8479359,Beck Malenstyn,L,BUF,26,46,5,8,13
5,8481567,Henry Thrun,D,SJS,23,42,5,8,13
5,8481013,Jonatan Berggren,R,DET,24,60,5,8,13
5,8478211,Dryden Hunt,L,CGY,29,50,5,8,13
5,8479378,Logan Stanley,D,WPG,26,41,5,8,13
5,8479980,Nicolas Hague,D,VGK,26,55,4,9,13
5,8475233,David Savard,D,MTL,34,64,4,9,13
5,8475718,Justin Holl,D,DET,32,60,4,9,13
5,8479998,Mikey Anderson,D,LAK,25,62,3,10,13
5,8481598,Philip Broberg,D,EDM,23,50,2,11,13
5,8477034,Jaycob Megna,D,FLA,32,48,1,12,13
5,8474567,Zach Bogosian,D,MIN,34,71,1,12,13
5,8483499,Liam Ohgren,L,MIN,20,58,7,5,12
5,8479671,Mathieu Olivier,R,CBJ,27,47,7,5,12
5,8480880,Jakub Lauko,C,MIN,24,36,7,5,12
5,8481592,Jakob Pelletier,L,CGY,23,43,6,6,12
5,8475455,Brenden Dillon,D,NJD,34,52,5,7,12
5,8476624,Barclay Goodrow,C,SJS,31,51,5,7,12
5,8479543,Michael Pezzetta,L,MTL,26,54,5,7,12
5,8480848,Ty Dellandrea,C,SJS,24,42,5,7,12
5,8477962,Brendan Lemieux,L,CAR,28,37,5,7,12
5,8479994,Jaret Anderson-Dolan,C,WPG,25,34,4,8,12
5,8481751,Lukas Rousek,R,BUF,25,43,4,8,12
5,8478416,Erik Cernak,D,TBL,27,75,3,9,12
5,8480995,Pontus Holmberg,R,TOR,25,60,3,9,12
5,8482176,Wyatt Kaiser,D,CHI,22,52,3,9,12
5,8480845,Rasmus Kupari,C,WPG,24,46,3,9,12
5,8479026,Philippe Myers,D,TOR,27,58,0,12,12
5,8482730,Brandt Clarke,D,LAK,21,53,5,6,11
5,8480011,Klim Kostin,C,SJS,25,51,5,6,11
5,8480157,Calle Rosen,D,COL,30,49,5,6,11
5,8484149,Gavin Brindley,C,CBJ,20,40,4,7,11
5,8481527,Kaedan Korczak,D,VGK,23,47,4,7,11
5,8480058,Pierre-Olivier Joseph,D,STL,25,47,3,8,11
5,8479344,Jesse Puljujarvi,R,PIT,26,53,3,8,11
5,8476889,Radek Faksa,C,STL,30,57,2,9,11
5,8480222,Sebastian Aho,D,PIT,28,71,2,9,11
5,8475750,Jon Merrill,D,MIN,32,61,2,9,11
5,8479348,Kale Clague,D,BUF,26,44,2,9,11
5,8475188,Brayden McNabb,D,VGK,33,56,1,10,11
5,8476874,Olli Maatta,D,DET,30,60,0,11,11
5,8480192,Johnathan Kovacevic,D,NJD,27,55,0,11,11
5,8482659,Josh Doan,R,UTA,22,51,8,2,10
5,8475842,Sam Carrick,C,NYR,32,65,6,4,10
5,8480252,Cole Guttman,C,CHI,25,35,6,4,10
5,8478443,Brandon Carlo,D,BOS,28,49,5,5,10
5,8479328,Julien Gauthier,R,NYI,27,61,4,6,10
5,8477938,Haydn Fleury,D,WPG,28,44,4,6,10
5,8478569,Noel Acciari,C,PIT,33,53,3,7,10
5,8481521,Ronnie Attard,D,PHI,25,56,3,7,10
5,8480035,Henri Jokiharju,D,BUF,25,61,3,7,10
5,8483466,Kevin Korchinski,D,CHI,20,52,3,7,10
5,8482666,Scott Morrow,D,CAR,22,53,2,8,10
5,8483763,Maksymilian Szuber,D,UTA,22,38,2,8,10
5,8475208,Brian Dumoulin,D,ANA,33,54,1,9,10
5,8481056,Spencer Stastney,D,NSH,24,39,1,9,10
5,8482077,Dylan Holloway,L,EDM,23,54,8,1,9
5,8479638,Justin Brazeau,R,BOS,26,31,8,1,9
5,8481617,Vasily Podkolzin,R,VAN,23,45,7,2,9
5,8477482,Zachary Sanford,L,CHI,30,39,6,3,9
5,8482144,Jack Thompson,D,SJS,22,29,5,4,9
5,8481708,Zac Jones,D,NYR,24,49,4,5,9
5,8481789,Tye Kartye,L,SEA,23,37,4,5,9
5,8478434,Keegan Kolesar,R,VGK,27,63,3,6,9
5,8482964,Arber Xhekaj,D,MTL,23,48,3,6,9
5,8482733,Logan Mailloux,D,MTL,31,43,3,6,9
5,8480007,Jonas Rondbjerg,R,VGK,25,37,2,7,9
5,8481609,Vladislav Kolyachonok,D,UTA,23,35,2,7,9
5,8481161,Jake Christiansen,D,CBJ,25,59,2,7,9
5,8481122,Simon Benoit,D,TOR,26,37,2,7,9
5,8482807,Ethan Del Mastro,D,CHI,21,42,1,8,9
5,8480950,Ilya Lyubushkin,D,DAL,30,59,1,8,9
5,8480070,Ian Mitchell,D,BOS,25,46,1,8,9
5,8479772,Zack MacEwen,R,OTT,28,48,5,3,8
5,8480292,Carson Meyer,R,ANA,27,35,4,4,8
5,8482145,Mavrik Bourque,C,DAL,22,50,4,4,8
5,8474568,Luke Schenn,D,NSH,35,49,3,5,8
5,8478424,Jansen Harkins,C,ANA,27,49,3,5,8
5,8480990,Declan Chisholm,D,MIN,24,35,3,5,8
5,8471817,Ryan Reaves,R,TOR,37,50,3,5,8
5,8474090,Brendan Smith,D,DAL,35,49,2,6,8
5,8480196,Jacob Bryson,D,BUF,27,40,2,6,8
5,8480860,Kevin Bahl,D,CGY,24,60,1,7,8
5,8480887,Jordan Harris,D,MTL,24,51,1,7,8
5,8482861,Vincent Iorio,D,WSH,22,36,1,7,8
5,8478874,Adam Gaudette,R,OTT,28,40,1,7,8
5,8477244,Chad Ruhwedel,D,NYR,34,35,1,7,8
5,8482070,Mitchell Chaffee,R,TBL,26,47,5,2,7
5,8482751,Ryan Winterton,C,SEA,21,35,4,3,7
5,8479291,Kevin Rooney,C,CGY,31,45,4,3,7
5,8474013,Ian Cole,D,UTA,35,39,4,3,7
5,8480870,Bo Groulx,C,NYR,24,34,4,3,7
5,8481147,Reese Johnson,C,MIN,26,45,3,4,7
5,8476442,Matt Nieto,L,PIT,32,48,3,4,7
5,8479972,Mason Shaw,C,WPG,26,35,3,4,7
5,8482859,Zack Ostapchuk,C,OTT,21,45,2,5,7
5,8476441,Joel Edmundson,D,LAK,31,38,2,5,7
5,8471677,Jack Johnson,D,CBJ,37,65,2,5,7
5,8480879,Jacob Bernard-Docker,D,OTT,24,46,2,5,7
5,8483012,Logan Morrison,C,SEA,22,40,2,5,7
5,8477527,Ross Johnston,L,ANA,30,33,2,5,7
5,8476913,Devin Shore,C,MIN,30,30,2,5,7
5,8479986,Kole Lind,R,DAL,26,45,1,6,7
5,8474166,Alec Martinez,D,CHI,37,55,1,6,7
5,8480172,Jan Rutta,D,SJS,34,61,0,7,7
5,8481518,Nolan Foote,L,NJD,24,35,5,1,6
5,8481754,Nikita Nesterenko,C,ANA,23,33,4,2,6
5,8480025,MacKenzie Entwistle,R,FLA,25,65,3,3,6
5,8482652,Walker Duehr,R,CGY,27,45,3,3,6
5,8479981,Jonah Gadjovich,L,FLA,26,38,3,3,6
5,8484254,Akito Hirose,D,VAN,25,50,3,3,6
5,8480844,Grigori Denisenko,L,VGK,24,38,3,3,6
5,8482496,Nils Aman,C,VAN,24,35,2,4,6
5,8477887,Patrick Brown,C,BOS,32,41,2,4,6
5,8483549,Lucas Condotta,L,MTL,27,39,2,4,6
5,8483570,Ben Meyers,C,SEA,26,26,2,4,6
5,8481543,Nikita Alexandrov,C,STL,24,22,2,4,6
5,8479249,Andrew Poturalski,C,SJS,30,37,1,5,6
5,8475762,Derek Forbort,D,VAN,32,37,1,5,6
5,8481600,Tobias Bjornfot,D,FLA,23,32,1,5,6
5,8478450,Parker Wotherspoon,D,BOS,27,38,1,5,6
5,8478021,William Lagesson,D,DET,28,32,1,5,6
5,8479379,Givani Smith,R,SJS,26,29,1,5,6
5,8481679,Maxence Guenette,D,OTT,23,35,3,2,5
5,8479968,Vinni Lettieri,C,BOS,29,43,3,2,5
5,8481237,Kyle MacLean,C,NYI,25,28,3,2,5
5,8479991,Jake Leschyshyn,C,NYR,25,27,3,2,5
5,8481701,Santeri Hatakka,D,NJD,23,36,2,3,5
5,8479985,Cale Fleury,D,SEA,26,26,2,3,5
5,8474612,Travis Hamonic,D,OTT,34,53,2,3,5
5,8476952,Dominic Toninato,C,WPG,30,33,2,3,5
5,8482153,Brendan Brisson,C,VGK,23,29,2,3,5
5,8478051,Max Willman,C,NJD,29,21,2,3,5
5,8477462,Robert Hagg,D,VGK,29,26,2,3,5
5,8481167,Brayden Pachal,D,CGY,25,42,1,4,5
5,8477335,Kyle Burroughs,D,LAK,29,40,1,4,5
5,8482747,Brennan Othmann,L,NYR,21,37,1,4,5
5,8479587,Rhett Gardner,C,PHI,28,23,1,4,5
5,8478409,Anthony Richard,C,PHI,28,31,1,4,5
5,8481605,Jackson LaCombe,D,ANA,23,27,1,4,5
5,8476473,Connor Murphy,D,CHI,31,33,1,4,5
5,8480834,Ty Emberson,D,SJS,24,36,1,4,5
5,8480245,Olle Lycksell,R,PHI,25,29,1,4,5
5,8483460,David Jiricek,D,CBJ,21,54,0,5,5
5,8482470,Ilya Solovyov,D,CGY,24,17,0,5,5
5,8484911,Collin Graf,R,SJS,22,43,3,1,4
5,8482460,Matt Rempe,C,NYR,22,10,3,1,4
5,8476867,Brendan Gaunce,C,MIN,30,33,2,2,4
5,8480890,Jan Jenik,C,OTT,24,25,2,2,4
5,8475958,Michael Sgarbossa,C,WSH,32,29,2,2,4
5,8481556,John Beecher,C,BOS,23,29,2,2,4
5,8482088,Justin Sourdif,R,FLA,22,20,2,2,4
5,8478468,Jeremy Lauzon,D,NSH,27,44,1,3,4
5,8479442,Troy Stecher,D,EDM,30,47,1,3,4
5,8475235,Nicolas Deslauriers,L,PHI,33,47,1,3,4
5,8483619,Filip Roos,D,OTT,25,29,1,3,4
5,8477401,John Hayden,C,SEA,29,38,1,3,4
5,8482141,Lukas Cormier,D,VGK,22,27,1,3,4
5,8478146,Matthew Highmore,C,OTT,28,37,1,3,4
5,8476372,Nick Seeler,D,PHI,31,45,0,4,4
5,8482765,Isak Rosen,R,BUF,21,28,0,4,4
5,8484258,Sam Malinski,D,COL,26,27,0,4,4
5,8483512,Matthew Savoie,C,EDM,20,23,3,0,3
5,8481585,Egor Afanasyev,L,SJS,23,14,3,0,3
5,8482511,Mason Lohrei,D,BOS,23,30,2,1,3
5,8483630,Pavol Regenda,L,ANA,25,25,2,1,3
5,8478017,Mark Friedman,D,VAN,29,32,2,1,3
5,8479536,Axel Jonsson-Fjallby,L,WPG,26,32,2,1,3
5,8477971,Andreas Englund,D,LAK,28,40,2,1,3
5,8482713,Mackie Samoskevich,R,FLA,22,37,2,1,3
5,8482516,Matthew Kessel,D,STL,24,20,2,1,3
5,8480267,Sammy Walker,C,MIN,25,17,2,1,3
5,8477149,Scott Sabourin,R,SJS,32,14,1,2,3
5,8477810,Joel Hanley,D,CGY,33,23,1,2,3
5,8482061,Brandon Biro,L,SEA,26,10,1,2,3
5,8481541,Samuel Bolduc,D,NYI,24,27,1,2,3
5,8481743,Marc Del Gaizo,D,NSH,25,21,1,2,3
5,8479419,Brett Murray,L,BUF,26,17,1,2,3
5,8474062,Riley Nash,C,NYR,35,14,1,2,3
5,8483471,Brad Lambert,C,WPG,31,10,1,2,3
5,8477384,Joshua Brown,D,EDM,30,37,0,3,3
5,8478454,Noah Juulsen,D,VAN,27,44,0,3,3
5,8478502,Dennis Gilbert,D,BUF,28,19,0,3,3
5,8481593,Jayden Struble,D,MTL,23,18,0,3,3
5,8479576,Vincent Desharnais,D,VAN,28,36,0,3,3
5,8481422,Jake Lucchini,C,NSH,29,18,2,0,2
5,8481043,Cole Koepke,L,BOS,26,14,1,1,2
5,8482177,Marat Khusnutdinov,C,MIN,22,31,1,1,2
5,8478477,Mitchell Stephens,C,SEA,27,21,1,1,2
5,8477851,Jordan Oesterle,D,BOS,32,36,1,1,2
5,8480084,Nick DeSimone,D,NJD,30,14,1,1,2
5,8480032,Shane Bowers,C,NJD,25,16,1,1,2
5,8483489,Fraser Minten,C,TOR,31,12,1,1,2
5,8483531,Brian Halonen,L,NJD,25,2,1,1,2
5,8475795,Dylan McIlrath,D,WSH,32,13,1,1,2
5,8482201,Gage Goncalves,C,TBL,23,24,1,1,2
5,8477473,Justin Bailey,R,SJS,29,22,0,2,2
5,8482858,Ryker Evans,D,SEA,23,18,0,2,2
5,8482165,Yan Kuznetsov,D,CGY,22,12,0,2,2
5,8478011,Louie Belpedio,D,PHI,28,21,0,2,2
5,8475177,Calvin de Haan,D,COL,33,43,0,2,2
5,8477467,Gustav Olofsson,D,SEA,30,17,0,2,2
5,8481564,Ryan Johnson,D,BUF,23,14,0,2,2
5,8482250,Callahan Burke,C,VGK,27,28,0,2,2
5,8483397,Marc McLaughlin,C,BOS,25,27,0,2,2
5,8481806,Louis Crevier,D,CHI,23,10,0,2,2
5,8481006,Tyler Tucker,D,STL,24,19,0,2,2
5,8482172,Landon Slaggert,L,CHI,22,27,0,2,2
5,8483567,Georgii Merkulov,C,BOS,24,11,0,2,2
5,8480874,Adam Ginning,D,PHI,24,18,0,2,2
5,8480851,Akil Thomas,C,LAK,24,14,1,0,1
5,8481719,Maxwell Crozier,D,TBL,24,15,1,0,1
5,8477541,Dakota Mermis,D,TOR,30,9,1,0,1
5,8480075,Cameron Crotty,D,MIN,25,9,1,0,1
5,8483597,Milos Kelemen,L,UTA,25,8,1,0,1
5,8484304,Uvis Balinskis,D,FLA,28,11,1,0,1
5,8481578,Graeme Clarke,R,MIN,23,12,1,0,1
5,8482102,Vasily Ponomarev,C,PIT,22,16,1,0,1
5,8483395,Arshdeep Bains,L,VAN,23,16,1,0,1
5,8484326,Patrik Koch,D,UTA,28,4,1,0,1
5,8473446,Erik Johnson,D,PHI,36,37,0,1,1
5,8479367,William Lockwood,R,FLA,26,23,0,1,1
5,8482929,Emil Lilleberg,D,TBL,23,23,0,1,1
5,8479320,Maxime Lajoie,D,SEA,27,21,0,1,1
5,8481065,Angus Crookshank,L,OTT,25,19,0,1,1
5,8482147,Jean-Luc Foudy,C,COL,22,25,0,1,1
5,8480823,Alexander Alexeyev,D,WSH,25,14,0,1,1
5,8477320,Anton Blidh,L,NYR,29,16,0,1,1
5,8481699,Aku Raty,R,UTA,23,12,0,1,1
5,8481462,Mason Morelli,L,VGK,28,10,0,1,1
5,8475413,Justin Dowling,C,NJD,34,18,0,1,1
5,8484287,Cole McWard,D,VAN,23,20,0,1,1
5,8478881,Brett Seney,L,CHI,28,18,0,1,1
5,8482162,Roby Jarventie,L,EDM,22,15,0,1,1
5,8481030,Jack St. Ivany,D,PIT,25,12,0,1,1
5,8482094,Daemon Hunt,D,MIN,22,11,0,1,1
5,8484255,Jason Polin,R,COL,25,3,0,1,1
5,8481206,John Ludvig,D,PIT,24,10,0,1,1
5,8483407,Brandon Scanlin,D,NYR,25,4,0,1,1
5,8479421,Jacob Moverare,D,LAK,26,5,0,1,1
5,8482118,Sam Colangelo,R,ANA,23,12,0,1,1
5,8477993,Justin Kirkland,C,CGY,28,3,0,1,1
5,8475755,Alexander Petrovic,D,DAL,32,9,0,1,1
5,8484325,Waltteri Merela,C,TBL,26,20,0,0,0
5,8479362,Riley Tufte,L,BOS,26,18,0,0,0
5,8481726,Adam Edstrom,C,NYR,24,5,0,0,0
5,8481024,Linus Karlsson,C,VAN,25,12,0,0,0
5,8477073,Kurtis MacDermid,L,NJD,30,30,0,0,0
5,8480468,James Hamblin,L,EDM,25,14,0,0,0
5,8483546,Marshall Rifai,D,TOR,26,6,0,0,0
5,8483920,Pierrick Dube,R,WSH,23,6,0,0,0
5,8475780,Chris Wagner,R,COL,33,5,0,0,0
5,8482476,Emil Heineman,L,MTL,23,6,0,0,0
5,8482787,Nikita Chibrikov,R,WPG,31,7,0,0,0
5,8482126,Emil Andrae,D,PHI,31,5,0,0,0
5,8483398,Declan Carlile,D,TBL,31,7,0,0,0
5,8478446,Glenn Gawdin,C,LAK,27,14,0,0,0
5,8482197,Adam Raska,R,MIN,23,6,0,0,0
5,8480306,Grant Hutton,D,NYI,29,5,0,0,0
5,8479522,Hardy Haman Aktell,D,WSH,26,2,0,0,0
5,8476323,Max McCormick,L,SEA,32,2,0,0,0
5,8481655,Cole Schwindt,R,CGY,23,7,0,0,0
5,8483432,Luca Del Bel Belluz,C,CBJ,31,6,0,0,0
5,8484259,Ondrej Pavel,C,COL,31,1,0,0,0
5,8470794,Joe Pavelski,C,,40,0,0,0,0
5,8479321,Lucas Johansen,D,,27,0,0,0,0
5,8477950,Tony DeAngelo,D,,29,0,0,0,0
5,8471218,Blake Wheeler,R,,38,0,0,0,0
5,8475197,Tyson Barrie,D,,33,0,0,0,0
5,8474157,Max Pacioretty,L,,36,0,0,0,0
5,8475744,Evgeny Kuznetsov,C,,32,0,0,0,0
5,8474037,James van Riemsdyk,L,,35,0,0,0,0
5,8476907,Mackenzie MacEachern,L,,30,0,0,0,0
5,8480216,Jacob Peterson,C,,25,0,0,0,0
5,8474602,Justin Schultz,D,,34,0,0,0,0
5,8482222,Alexander Barabanov,L,,30,0,0,0,0
5,8474031,Kevin Shattenkirk,D,,35,0,0,0,0
5,8477330,Dominik Kubalik,L,,29,0,0,0,0
5,8480884,Calen Addison,D,,24,0,0,0,0
5,8475906,John Klingberg,D,,32,0,0,0,0
5,8480008,Adam Ruzicka,C,,25,0,0,0,0
5,8476884,Derrick Pouliot,D,,30,0,0,0,0
5,8476919,Chris Tierney,C,,30,0,0,0,0
5,8479415,Michael McLeod,C,,26,0,0,0,0
5,8474870,Tyler Johnson,C,,34,0,0,0,0
5,8470604,Jeff Carter,C,,39,0,0,0,0
5,8478104,Sammy Blais,L,,28,0,0,0,0
5,8474884,Mike Hoffman,C,,35,0,0,0,0
5,8481591,Sam Poulin,R,,23,0,0,0,0
5,8471274,Alex Goligoski,D,,39,0,0,0,0
5,8476871,Tanner Pearson,L,,32,0,0,0,0
5,8476393,Nick Cousins,C,,31,0,0,0,0
5,8479977,Kailer Yamamoto,R,,26,0,0,0,0
5,8479346,Dillon Dube,C,,26,0,0,0,0
5,8480184,Gustav Lindstrom,D,,26,0,0,0,0
5,8479376,Victor Mete,D,,26,0,0,0,0
5,8473449,Kyle Okposo,R,,36,0,0,0,0
5,8481058,Jesse Ylonen,R,,25,0,0,0,0
5,8475752,Tyler Pitlick,C,,33,0,0,0,0
5,8481239,Samuel Fagemo,L,,24,0,0,0,0
5,8480821,Filip Zadina,R,,25,0,0,0,0
5,8470966,Mark Giordano,D,,41,0,0,0,0
5,8478495,Denis Gurianov,R,,27,0,0,0,0
5,8477464,Nic Petan,C,,29,0,0,0,0
5,8478099,Kevin Labanc,R,,29,0,0,0,0
5,8482241,Radim Zohorna,L,,28,0,0,0,0
5,8474040,Sam Gagner,C,,35,0,0,0,0
5,8479514,Rem Pitlick,C,,27,0,0,0,0
5,8478430,Oliver Kylington,D,,27,0,0,0,0
5,8479533,Joona Koppanen,L,,26,0,0,0,0
5,8479984,Cal Foote,D,,26,0,0,0,0
5,8477126,Jayson Megna,C,,34,0,0,0,0
5,8475164,Jakob Silfverberg,R,,34,0,0,0,0
5,8474009,Nick Bonino,C,,36,0,0,0,0
5,8479458,Nikita Zaitsev,D,,33,0,0,0,0
5,8477944,Jakub Vrana,L,,28,0,0,0,0
5,8471699,Andrew Cogliano,C,,37,0,0,0,0
5,8478067,Oskar Lindblom,L,,28,0,0,0,0
5,8471686,Marc Staal,D,,37,0,0,0,0
5,8470610,Zach Parise,L,,40,0,0,0,0
5,8478904,Steven Lorentz,C,,28,0,0,0,0
5,8473473,Milan Lucic,L,,36,0,0,0,0
5,8480031,Maxime Comtois,L,,25,0,0,0,0
5,8478512,Austin Czarnik,C,,32,0,0,0,0
5,8473504,Cal Clutterbuck,R,,37,0,0,0,0
5,8477454,Adam Erne,L,,29,0,0,0,0
5,8479383,Boris Katchouk,L,,26,0,0,0,0
5,8475825,Jani Hakanpää,D,,32,0,0,0,0
5,8477846,Ryan Carpenter,C,,33,0,0,0,0
5,8477930,Pierre-Edouard Bellemare,L,,39,0,0,0,0
5,8478400,Colin White,C,,27,0,0,0,0
5,8480226,Marián Studenic,R,,26,0,0,0,0
5,8480853,Liam Foudy,C,,24,0,0,0,0
5,8475797,Jarred Tinordi,D,,32,0,0,0,0
5,8479423,Alex Nylander,L,,26,0,0,0,0
5,8474618,Marco Scandella,D,,34,0,0,0,0
5,8478028,Fredrik Olofsson,L,,28,0,0,0,0
5,8474709,Matt Martin,L,,35,0,0,0,0
5,8481070,Hugh McGing,L,,26,0,0,0,0
5,8479546,Oskar Steen,C,,26,0,0,0,0
5,8474145,Robert Bortuzzo,D,,35,0,0,0,0
5,8476915,Jujhar Khaira,L,,30,0,0,0,0
5,8480274,Philip Kemp,D,EDM,25,0,0,0,0
5,8484321,Nikolas Matinpalo,D,OTT,26,2,0,0,0
5,8475278,Byron Froese,C,,33,0,0,0,0
5,8481812,Nikolai Knyzhov,D,,27,0,0,0,0
5,8478408,Travis Dermott,D,,28,0,0,0,0
5,8481077,John Leonard,L,,26,0,0,0,0
5,8479547,Matthew Phillips,R,,26,0,0,0,0
5,8480836,Jonathan Gruden,C,,24,0,0,0,0
5,8481690,Tyler Angle,C,,24,0,0,0,0
5,8475766,Austin Watson,L,,32,0,0,0,0
5,8478854,Ryan Shea,D,PIT,27,5,0,0,0
5,8481016,Ruslan Iskhakov,C,,24,0,0,0,0
5,8478078,Rourke Chartier,C,,28,0,0,0,0
5,8479330,Brandon Gignac,C,MTL,27,3,0,0,0
5,8483401,Marc Johnstone,R,PIT,28,1,0,0,0
5,8480776,Sheldon Rempal,R,,29,0,0,0,0
5,8478956,Samuel Laberge,L,NJD,27,3,0,0,0
5,8483609,Adam Klapka,R,CGY,24,2,0,0,0
5,8483045,Cameron Butler,R,CBJ,31,0,0,0,0
5,8481534,Raphael Lavoie,C,EDM,24,1,0,0,0
5,8478147,Bokondji Imama,L,PIT,28,6,0,0,0
5,8484314,Jiri Smejkal,L,,28,0,0,0,0
6,8478402,Connor McDavid,C,EDM,27,80,50,95,145
6,8476453,Nikita Kucherov,R,TBL,31,82,43,93,136
6,8477492,Nathan MacKinnon,C,COL,29,81,58,69,127
6,8479318,Auston Matthews,C,TOR,27,79,67,55,122
6,8481559,Jack Hughes,C,NJD,23,79,42,79,121
6,8477956,David Pastrnak,R,BOS,28,80,52,65,117
6,8477934,Leon Draisaitl,C,EDM,29,78,33,83,116
6,8479314,Matthew Tkachuk,L,FLA,27,80,39,76,115
6,8478483,Mitch Marner,R,TOR,27,77,32,82,114
6,8475172,Nazem Kadri,C,CGY,34,75,44,62,106
6,8478550,Artemi Panarin,L,NYR,33,80,27,79,106
6,8477939,William Nylander,R,TOR,28,80,46,58,104
6,8477404,Jake Guentzel,C,TBL,30,82,38,66,104
6,8478420,Mikko Rantanen,R,COL,28,81,46,57,103
6,8478864,Kirill Kaprizov,L,MIN,27,75,40,60,100
6,8478010,Brayden Point,C,TBL,28,82,53,42,95
6,8477942,Kevin Fiala,L,LAK,28,81,37,58,95
6,8476468,J.T. Miller,C,VAN,31,72,31,62,93
6,8482116,Tim Stützle,C,OTT,22,73,30,62,92
6,8477493,Aleksander Barkov,C,FLA,29,79,30,62,92
6,8475786,Zach Hyman,L,EDM,32,79,50,40,90
6,8478403,Jack Eichel,C,VGK,28,74,33,57,90
6,8480012,Elias Pettersson,C,VAN,26,74,31,59,90
6,8479407,Jesper Bratt,L,NJD,26,71,30,60,90
6,8480800,Quinn Hughes,D,VAN,25,76,11,79,90
6,8475167,Victor Hedman,D,TBL,34,81,14,75,89
6,8475166,John Tavares,C,TOR,34,75,40,48,88
6,8476887,Filip Forsberg,L,NSH,30,77,45,42,87
6,8474564,Steven Stamkos,C,NSH,34,76,32,54,86
6,8477501,Valeri Nichushkin,R,COL,29,80,42,43,85
6,8476459,Mika Zibanejad,C,NYR,31,79,31,53,84
6,8480027,Jason Robertson,L,DAL,25,82,24,60,84
6,8471675,Sidney Crosby,C,PIT,37,72,38,45,83
6,8478445,Mathew Barzal,C,NYI,27,80,28,55,83
6,8479385,Jordan Kyrou,C,STL,26,72,35,46,81
6,8476460,Mark Scheifele,C,WPG,31,74,32,49,81
6,8471214,Alex Ovechkin,L,WSH,39,74,30,51,81
6,8480002,Nico Hischier,C,NJD,25,80,29,52,81
6,8476454,Ryan Nugent-Hopkins,C,EDM,31,78,25,56,81
6,8473419,Brad Marchand,L,BOS,36,82,33,46,79
6,8476346,Johnny Gaudreau,L,CBJ,31,75,24,55,79
6,8479323,Adam Fox,D,NYR,26,74,18,61,79
6,8477409,Carter Verhaeghe,C,FLA,29,78,43,35,78
6,8480830,Andrei Svechnikov,R,CAR,24,76,34,44,78
6,8477946,Dylan Larkin,C,DET,28,82,33,45,78
6,8475765,Vladimir Tarasenko,R,DET,33,81,29,49,78
6,8476539,Jonathan Marchessault,R,NSH,34,72,37,40,77
6,8477940,Nikolaj Ehlers,L,WPG,28,73,23,53,76
6,8474141,Patrick Kane,R,DET,36,77,31,44,75
6,8475913,Mark Stone,R,VGK,32,78,29,46,75
6,8471215,Evgeni Malkin,C,PIT,38,73,29,46,75
6,8480023,Robert Thomas,C,STL,25,73,19,56,75
6,8475184,Chris Kreider,L,NYR,33,80,44,30,74
6,8475810,Bryan Rust,R,PIT,32,74,40,34,74
6,8479337,Alex DeBrincat,R,DET,27,79,26,48,74
6,8480801,Brady Tkachuk,L,OTT,25,82,37,36,73
6,8479343,Clayton Keller,R,UTA,26,74,31,42,73
6,8482078,Lucas Raymond,L,DET,22,79,23,50,73
6,8474600,Roman Josi,D,NSH,34,77,19,54,73
6,8480069,Cale Makar,D,COL,26,71,19,54,73
6,8476456,Jonathan Huberdeau,C,CGY,31,77,18,55,73
6,8480208,Drake Batherson,R,OTT,26,80,30,42,72
6,8480036,Miro Heiskanen,D,DAL,25,80,15,57,72
6,8477402,Pavel Buchnevich,L,STL,29,73,32,39,71
6,8475168,Matt Duchene,C,DAL,33,82,31,40,71
6,8477949,Alex Tuch,R,BUF,28,76,25,46,71
6,8477960,Adrian Kempe,R,LAK,28,80,24,47,71
6,8478460,Zach Werenski,D,CBJ,27,78,17,54,71
6,8481557,Matt Boldy,L,MIN,23,72,34,36,70
6,8484144,Connor Bedard,C,CHI,19,69,29,41,70
6,8476853,Morgan Rielly,D,TOR,30,74,11,59,70
6,8478427,Sebastian Aho,C,CAR,27,69,31,38,69
6,8478439,Travis Konecny,R,PHI,27,77,30,39,69
6,8475754,Brock Nelson,C,NYI,33,76,29,40,69
6,8478449,Roope Hintz,C,DAL,28,81,28,41,69
6,8478397,Rasmus Andersson,D,CGY,28,76,14,55,69
6,8478444,Brock Boeser,R,VAN,27,77,40,28,68
6,8478440,Dylan Strome,C,WSH,27,76,30,38,68
6,8476872,Scott Laughton,C,PHI,30,75,23,45,68
6,8474578,Erik Karlsson,D,PIT,34,80,20,48,68
6,8478975,Mason Marchment,L,DAL,29,81,31,36,67
6,8471685,Anze Kopitar,C,LAK,37,80,22,45,67
6,8480865,Noah Dobson,D,NYI,24,76,15,52,67
6,8480803,Evan Bouchard,D,EDM,25,75,15,52,67
6,8481540,Cole Caufield,R,MTL,23,73,31,35,66
6,8477951,Nick Schmaltz,C,UTA,28,76,21,45,66
6,8482740,Wyatt Johnston,C,DAL,21,81,35,30,65
6,8475784,Jeff Skinner,C,EDM,32,78,34,31,65
6,8482093,Seth Jarvis,C,CAR,22,73,32,33,65
6,8477500,Bo Horvat,C,NYI,29,76,32,33,65
6,8475158,Ryan O'Reilly,C,NSH,33,73,27,38,65
6,8478873,Troy Terry,R,ANA,27,76,23,42,65
6,8482665,Matty Beniers,C,SEA,22,72,29,34,63
6,8476399,Blake Coleman,C,CGY,33,79,29,34,63
6,8478407,Vince Dunn,D,SEA,28,72,9,54,63
6,8476881,Tomas Hertl,C,VGK,31,71,29,33,62
6,8478414,Timo Meier,R,NJD,28,74,28,34,62
6,8478398,Kyle Connor,L,WPG,28,72,27,35,62
6,8473512,Claude Giroux,R,OTT,36,80,25,37,62
6,8475169,Evander Kane,L,EDM,33,75,35,26,61
6,8475170,Brayden Schenn,C,STL,33,72,27,34,61
6,8470613,Brent Burns,D,CAR,39,79,13,48,61
6,8477933,Sam Reinhart,C,FLA,29,80,38,22,60
6,8479420,Tage Thompson,C,BUF,27,72,33,27,60
6,8476448,William Karlsson,C,VGK,31,81,32,28,60
6,8477955,Jared McCann,L,SEA,28,74,29,31,60
6,8482699,Dylan Guenther,R,UTA,21,80,26,34,60
6,8474102,David Perron,L,OTT,36,79,25,35,60
6,8475794,Tyler Seguin,C,DAL,32,80,24,36,60
6,8474641,Adam Henrique,C,EDM,34,78,23,37,60
6,8477504,Josh Morrissey,D,WPG,29,75,5,55,60
6,8478498,Jake DeBrusk,L,VAN,28,70,28,31,59
6,8478493,Joel Eriksson Ek,C,MIN,27,76,22,37,59
6,8476479,Phillip Danault,C,LAK,31,81,22,37,59
6,8476389,Vincent Trocheck,C,NYR,31,79,21,38,59
6,8476905,Chandler Stephenson,C,SEA,30,74,18,41,59
6,8475753,Justin Faulk,D,STL,32,76,17,42,59
6,8477935,Sam Bennett,C,FLA,28,73,20,38,58
6,8476792,Torey Krug,D,STL,33,71,15,43,58
6,8481542,Moritz Seider,D,DET,23,76,10,48,58
6,8478038,Devon Toews,D,COL,30,68,10,48,58
6,8479999,Casey Mittelstadt,C,COL,26,82,15,42,57
6,8475692,Mats Zuccarello,R,MIN,37,71,12,45,57
6,8477496,Elias Lindholm,C,BOS,30,78,21,35,56
6,8473994,Jamie Benn,L,DAL,35,80,20,36,56
6,8476906,Shayne Gostisbehere,D,CAR,31,80,9,47,56
6,8479675,Trevor Moore,L,LAK,29,81,30,25,55
6,8480039,Martin Necas,C,CAR,25,69,23,32,55
6,8482745,Mason McTavish,C,ANA,21,79,21,34,55
6,8475151,Kyle Palmieri,C,NYI,33,78,21,34,55
6,8477494,Jonathan Drouin,L,COL,29,81,14,41,55
6,8474679,Gustav Nyquist,C,NSH,35,75,13,42,55
6,8474563,Drew Doughty,D,LAK,35,72,10,45,55
6,8475726,Tyler Toffoli,C,SJS,32,71,25,29,54
6,8479542,Brandon Hagel,L,TBL,26,82,22,32,54
6,8479400,Pierre-Luc Dubois,L,WSH,26,71,19,35,54
6,8484153,Leo Carlsson,C,ANA,20,75,17,37,54
6,8478469,Thomas Chabot,D,OTT,27,78,11,43,54
6,8471724,Kris Letang,D,PIT,37,78,10,44,54
6,8481068,Yegor Sharangovich,C,CGY,26,77,27,26,53
6,8477511,Anthony Mantha,R,CGY,30,73,19,34,53
6,8483808,Andrei Kuzmenko,L,CGY,28,76,19,34,53
6,8481533,Trevor Zegras,C,ANA,23,75,15,38,53
6,8477456,J.T. Compher,L,DET,29,79,28,24,52
6,8480028,Morgan Frost,C,PHI,25,72,26,26,52
6,8481560,Arthur Kaliyev,R,LAK,23,75,24,28,52
6,8480188,Fabian Zetterlund,L,SJS,25,65,24,28,52
6,8476880,Tom Wilson,R,WSH,30,73,22,30,52
6,8477416,Oliver Bjorkstrand,R,SEA,29,77,20,32,52
6,8478047,Michael Bunting,L,PIT,29,72,20,32,52
6,8477346,MacKenzie Weegar,D,CGY,30,71,13,39,52
6,8480018,Nick Suzuki,C,MTL,25,77,15,36,51
6,8477503,Max Domi,C,TOR,29,77,15,36,51
6,8475314,Anders Lee,L,NYI,34,81,24,26,50
6,8475798,Mikael Granlund,C,SJS,32,67,13,37,50
6,8476462,Dougie Hamilton,D,NJD,31,72,11,39,50
6,8482110,Dawson Mercer,C,NJD,23,74,26,23,49
6,8481528,Dylan Cozens,C,BUF,23,69,21,28,49
6,8475745,Charlie Coyle,C,BOS,32,77,18,31,49
6,8479339,Patrik Laine,L,CBJ,26,62,17,32,49
6,8481596,Shane Pinto,C,OTT,24,75,15,34,49
6,8476875,Mike Matheson,D,MTL,30,76,13,36,49
6,8481604,Pavel Dorofeyev,L,VGK,24,71,25,23,48
6,8477407,Anthony Duclair,L,NYI,29,77,23,25,48
6,8484166,Adam Fantilli,C,CBJ,20,69,22,26,48
6,8480015,Owen Tippett,R,PHI,25,73,21,27,48
6,8473986,Alex Killorn,L,ANA,35,71,19,29,48
6,8482124,Quinton Byfield,R,LAK,22,78,19,29,48
6,8480839,Rasmus Dahlin,D,BUF,24,64,15,33,48
6,8482667,William Eklund,L,SJS,22,64,18,29,47
6,8482097,Jack Quinn,R,BUF,23,70,18,29,47
6,8478542,Evan Rodrigues,C,FLA,31,77,16,31,47
6,8478462,Nicolas Roy,C,VGK,27,75,16,31,47
6,8482684,Luke Hughes,D,NJD,21,72,14,33,47
6,8476292,Ondrej Palat,L,NJD,33,70,12,35,47
6,8479425,Filip Hronek,D,VAN,27,72,11,36,47
6,8474590,John Carlson,D,WSH,34,67,9,38,47
6,8477476,Artturi Lehkonen,L,COL,29,81,27,19,46
6,8478519,Anthony Cirelli,C,TBL,27,82,19,27,46
6,8474565,Alex Pietrangelo,D,VGK,34,67,8,38,46
6,8476432,Boone Jenner,C,CBJ,31,65,24,21,45
6,8482702,Logan Stankoven,C,DAL,21,82,21,24,45
6,8482109,Alexis Lafrenière,L,NYR,23,75,21,24,45
6,8480336,Sean Walker,D,CAR,30,73,18,27,45
6,8478856,Conor Garland,R,VAN,28,77,17,28,45
6,8478401,Pavel Zacha,C,BOS,27,76,16,29,45
6,8479345,Jakob Chychrun,D,WSH,26,66,16,29,45
6,8478458,John (Jack) Roslovic,C,CAR,27,69,15,30,45
6,8476923,Damon Severson,D,CBJ,30,81,11,34,45
6,8479325,Charlie McAvoy,D,BOS,27,72,10,35,45
6,8475764,Cam Fowler,D,ANA,33,74,10,35,45
6,8480064,Josh Norris,C,OTT,25,76,25,19,44
6,8478474,Lawson Crouse,L,UTA,27,75,21,23,44
6,8475191,Reilly Smith,R,NYR,33,74,19,25,44
6,8477986,Brandon Montour,D,SEA,30,71,16,28,44
6,8477429,Andrew Copp,C,DET,30,79,16,28,44
6,8474586,Jordan Eberle,R,SEA,34,73,16,28,44
6,8480798,Philipp Kurashev,C,CHI,25,69,13,31,44
6,8481581,Thomas Harley,D,DAL,23,70,10,34,44
6,8476854,Hampus Lindholm,D,BOS,30,75,10,34,44
6,8479525,Ross Colton,C,COL,28,76,23,20,43
6,8482092,Ridly Greig,C,OTT,22,79,22,21,43
6,8477497,Sean Monahan,C,CBJ,30,73,21,22,43
6,8477451,Ryan Hartman,R,MIN,30,71,18,25,43
6,8480459,Pius Suter,C,VAN,28,68,18,25,43
6,8481711,Matias Maccelli,L,UTA,24,80,14,29,43
6,8476419,Jean-Gabriel Pageau,C,NYI,32,78,11,32,43
6,8475722,Jason Zucker,L,BUF,32,71,20,22,42
6,8480849,Barrett Hayton,C,UTA,24,76,17,25,42
6,8476483,Rickard Rakell,R,PIT,31,69,14,28,42
6,8477932,Aaron Ekblad,D,FLA,28,72,11,31,42
6,8476869,Brady Skjei,D,NSH,30,76,9,33,42
6,8475799,Nino Niederreiter,R,WPG,32,67,28,13,41
6,8482089,Jake Neighbours,L,STL,22,73,22,19,41
6,8482159,Tyson Foerster,R,PHI,22,76,21,20,41
6,8478046,Danton Heinen,L,VAN,29,70,19,22,41
6,8474150,Mikael Backlund,C,CGY,35,78,17,24,41
6,8479591,Michael Eyssimont,C,TBL,28,81,19,21,40
6,8480797,Joel Farabee,L,PHI,24,70,19,21,40
6,8476461,Sean Couturier,C,PHI,32,68,16,24,40
6,8475287,Erik Haula,L,NJD,33,70,11,29,40
6,8476480,Vladislav Namestnikov,C,WPG,32,67,21,18,39
6,8476458,Ryan Strome,C,ANA,31,71,19,20,39
6,8478233,Andrew Mangiapane,L,WSH,28,65,17,22,39
6,8478466,Daniel Sprong,R,VAN,27,74,17,22,39
6,8475714,Calle Jarnkrok,C,TOR,33,75,17,22,39
6,8478042,Viktor Arvidsson,L,EDM,31,76,16,23,39
6,8476927,Teddy Blueger,C,VAN,30,67,14,25,39
6,8477444,Andre Burakovsky,L,SEA,29,73,13,26,39
6,8480220,Noah Cates,L,PHI,25,68,13,26,39
6,8477964,Ivan Barbashev,C,VGK,29,73,12,27,39
6,8483505,Matthew Poitras,C,BOS,20,77,11,28,39
6,8474149,Evgenii Dadonov,R,DAL,35,80,11,28,39
6,8476979,Erik Gustafsson,D,DET,32,75,9,30,39
6,8478366,Frank Vatrano,R,ANA,30,73,27,11,38
6,8475760,Nick Bjugstad,C,UTA,32,66,23,15,38
6,8480113,Alex Iafallo,L,WPG,31,71,21,17,38
6,8476474,Stefan Noesen,R,NJD,31,63,21,17,38
6,8475768,Jaden Schwartz,C,SEA,32,71,19,19,38
6,8480185,Eetu Luostarinen,C,FLA,26,76,18,20,38
6,8481582,Nicholas Robertson,L,TOR,23,68,17,21,38
6,8473563,Nicklas Backstrom,C,WSH,37,59,14,24,38
6,8484145,Zach Benson,L,BUF,19,64,13,25,38
6,8477948,Travis Sanheim,D,PHI,28,72,10,28,38
6,8475763,Kevin Hayes,R,PIT,32,67,10,28,38
6,8480009,Eeli Tolvanen,R,SEA,25,75,24,13,37
6,8482175,JJ Peterka,R,BUF,22,72,19,18,37
6,8479353,Brett Howden,C,VGK,26,68,19,18,37
6,8474053,Logan Couture,C,SJS,35,65,16,21,37
6,8474715,Cameron Atkinson,R,TBL,35,80,16,21,37
6,8482720,Matthew Knies,L,TOR,22,76,15,22,37
6,8478472,Mathieu Joseph,R,STL,27,69,13,24,37
6,8475218,Mattias Ekholm,D,EDM,34,77,10,27,37
6,8478055,Gustav Forsling,D,FLA,28,72,6,31,37
6,8479992,Michael Rasmussen,C,DET,25,81,20,16,36
6,8479987,Morgan Geekie,C,BOS,26,74,16,20,36
6,8483515,Juraj Slafkovsky,L,MTL,20,72,15,21,36
6,8478057,Dakota Joshua,C,VAN,28,68,15,21,36
6,8482113,Anton Lundell,C,FLA,23,78,14,22,36
6,8478438,Tommy Novak,C,NSH,27,62,12,24,36
6,8476958,Jaccob Slavin,D,CAR,30,78,9,27,36
6,8477447,Shea Theodore,D,VGK,29,63,7,29,36
6,8478507,John Marino,D,UTA,27,73,4,32,36
6,8477426,Nicholas Paul,L,TBL,29,82,22,13,35
6,8477021,Alex Kerfoot,C,UTA,30,74,16,19,35
6,8478463,Anthony Beauvillier,L,PIT,27,70,16,19,35
6,8481577,Philip Tomasino,C,NSH,23,63,15,20,35
6,8476882,Teuvo Teravainen,C,CHI,30,66,13,22,35
6,8480871,Adam Boqvist,D,FLA,24,64,13,22,35
6,8480813,Joe Veleno,C,DET,24,73,11,24,35
6,8484203,Bradly Nadeau,L,CAR,19,62,11,24,35
6,8476892,Colton Parayko,D,STL,31,65,6,29,35
6,8482712,Oskar Olausson,R,COL,22,74,6,29,35
6,8476438,Brandon Saad,L,STL,32,73,20,14,34
6,8478109,Victor Olofsson,L,VGK,29,70,20,14,34
6,8481535,Nils Hoglander,L,VAN,24,70,20,14,34
6,8477839,Conor Sheary,L,TBL,32,82,17,17,34
6,8482146,Luke Evangelista,R,NSH,22,64,17,17,34
6,8477998,Warren Foegele,L,LAK,28,78,16,18,34
6,8482149,Cole Perfetti,C,WPG,22,65,16,18,34
6,8479996,Cody Glass,C,NSH,25,62,16,18,34
6,8482475,Yegor Chinakhov,R,CBJ,23,63,15,19,34
6,8477919,Frederick Gaudreau,C,MIN,31,64,15,19,34
6,8478115,Pierre Engvall,L,NYI,28,77,14,20,34
6,8477495,Seth Jones,D,CHI,30,67,10,24,34
6,8481703,Valtteri Puustinen,R,PIT,25,66,4,30,34
6,8478396,Noah Hanifin,D,VGK,27,55,3,31,34
6,8474189,Lars Eller,C,PIT,35,60,18,15,33
6,8480835,Jack Drury,C,CAR,24,61,17,16,33
6,8476897,Oskar Sundqvist,C,STL,30,64,15,18,33
6,8477479,Tyler Bertuzzi,L,CHI,29,66,13,20,33
6,8480078,Filip Chytil,C,NYR,25,66,13,20,33
6,8475793,Ryan Johansen,C,PHI,32,74,12,21,33
6,8483431,Logan Cooley,C,UTA,20,75,11,22,33
6,8476885,Jacob Trouba,D,NYR,30,70,10,23,33
6,8480817,K'Andre Miller,D,NYR,24,64,7,26,33
6,8477506,Ryan Pulock,D,NYI,30,78,4,29,33
6,8480145,Neal Pionk,D,WPG,29,80,1,32,33
6,8480014,Gabriel Vilardi,C,WPG,25,65,19,13,32
6,8482055,Drew O'Connor,L,PIT,26,64,17,15,32
6,8479390,Taylor Raddysh,R,WSH,26,70,16,16,32
6,8475193,Tomas Tatar,L,NJD,34,68,15,17,32
6,8471698,T.J. Oshie,R,WSH,38,63,14,18,32
6,8477498,Darnell Nurse,D,EDM,29,70,6,26,32
6,8481441,Joe Snively,C,DET,28,69,6,26,32
6,8479941,Justin Danforth,R,CBJ,31,55,16,15,31
6,8477952,Robby Fabbri,C,ANA,28,63,15,16,31
6,8477953,Kasperi Kapanen,R,STL,28,67,15,16,31
6,8478413,Jordan Greenway,L,BUF,27,62,13,18,31
6,8481524,Bowen Byram,D,BUF,23,66,12,19,31
6,8481186,Logan O'Connor,R,COL,28,79,11,20,31
6,8482133,Thomas Bordeleau,C,SJS,22,66,11,20,31
6,8482624,Daniil Miromanov,D,CGY,27,65,10,21,31
6,8477969,Marcus Pettersson,D,PIT,28,80,4,27,31
6,8482655,Janis Moser,D,TBL,24,77,3,28,31
6,8478891,Mason Appleton,C,WPG,28,61,10,20,30
6,8479661,Tanner Jeannot,L,LAK,27,76,8,22,30
6,8476463,Jonas Brodin,D,MIN,31,77,6,24,30
6,8482122,Brock Faber,D,MIN,22,75,4,26,30
6,8478569,Noel Acciari,C,PIT,33,59,15,14,29
6,8477947,Sonny Milano,L,WSH,28,56,12,17,29
6,8477446,Michael McCarron,R,NSH,29,54,11,18,29
6,8481523,Kirby Dach,C,MTL,23,66,10,19,29
6,8478882,Vladislav Gavrikov,D,LAK,29,68,9,20,29
6,8479982,Conor Timmins,D,TOR,26,58,9,20,29
6,8483490,Pavel Mintyukov,D,ANA,21,69,8,21,29
6,8476429,Scott Mayfield,D,NYI,32,76,8,21,29
6,8478500,Ivan Provorov,D,CBJ,27,79,6,23,29
6,8482105,Jake Sanderson,D,OTT,22,73,4,25,29
6,8476392,Adam Lowry,C,WPG,31,68,19,9,28
6,8482705,Cole Sillinger,C,CBJ,21,60,15,13,28
6,8479365,Trent Frederic,C,BOS,26,77,15,13,28
6,8479368,Max Jones,L,BOS,26,73,13,15,28
6,8477425,Miles Wood,L,COL,29,79,12,16,28
6,8480068,Ryan Poehling,C,PHI,25,64,11,17,28
6,8482749,Joshua Roy,R,MTL,21,66,11,17,28
6,8479351,Sam Steel,C,DAL,26,79,8,20,28
6,8482660,Kent Johnson,C,CBJ,22,67,6,22,28
6,8476879,Cody Ceci,D,EDM,31,71,4,24,28
6,8480789,Oliver Wahlstrom,R,NYI,24,71,14,13,27
6,8473422,Nick Foligno,L,CHI,37,61,13,14,27
6,8481032,Paul Cotter,C,NJD,25,61,12,15,27
6,8482074,Connor Zary,C,CGY,23,69,11,16,27
6,8476902,Esa Lindell,D,DAL,30,72,11,16,27
6,8475200,Dmitry Orlov,D,CAR,33,72,8,19,27
6,8477015,Connor Brown,R,EDM,30,64,8,19,27
6,8475171,Oliver Ekman-Larsson,D,TOR,33,69,6,21,27
6,8476925,Colton Sissons,C,NSH,31,67,5,22,27
6,8479976,Juuso Valimaki,D,UTA,26,71,2,25,27
6,8475790,Erik Gudbranson,D,CBJ,32,74,2,25,27
6,8476878,Zemgus Girgensons,C,TBL,30,80,16,10,26
6,8480855,Jack McBain,C,UTA,24,65,12,14,26
6,8480434,Sean Durzi,D,UTA,26,63,11,15,26
6,8476329,Travis Boyd,C,MIN,31,52,10,16,26
6,8480762,Eric Robinson,L,CAR,29,61,10,16,26
6,8474716,Jared Spurgeon,D,MIN,35,77,9,17,26
6,8480748,Kiefer Sherwood,L,VAN,29,59,9,17,26
6,8476826,Yanni Gourde,C,SEA,33,77,8,18,26
6,8482671,Owen Power,D,BUF,22,71,8,18,26
6,8480878,Nils Lundkvist,D,DAL,24,73,7,19,26
6,8476917,Adam Pelech,D,NYI,30,80,4,22,26
6,8480893,Kirill Marchenko,R,CBJ,24,59,19,6,25
6,8470621,Corey Perry,R,EDM,39,74,16,9,25
6,8481554,Kaapo Kakko,R,NYR,23,61,15,10,25
6,8481618,Alex Newhook,C,MTL,23,75,14,11,25
6,8479619,Michael Carcone,L,UTA,28,59,14,11,25
6,8482117,Lukas Reichel,L,CHI,22,64,12,13,25
6,8476921,Jordan Martinook,L,CAR,32,58,9,16,25
6,8475149,Marcus Johansson,L,MIN,34,62,9,16,25
6,8477505,Alexander Wennberg,C,SJS,30,63,8,17,25
6,8478434,Keegan Kolesar,R,VGK,27,66,7,18,25
6,8480043,Timothy Liljegren,D,TOR,25,65,6,19,25
6,8482067,Connor Mackey,D,NYR,28,68,6,19,25
6,8480021,Jack Studnicka,C,LAK,25,62,6,19,25
6,8483445,Cutter Gauthier,L,ANA,20,57,6,19,25
6,8479026,Philippe Myers,D,TOR,27,59,6,19,25
6,8479410,Mikhail Sergachev,D,UTA,26,68,5,20,25
6,8483565,Nick Blankenburg,D,NSH,26,61,5,20,25
6,8478399,Jonas Siegenthaler,D,NJD,27,64,3,22,25
6,8482079,Marco Rossi,C,MIN,23,58,16,8,24
6,8478020,Michael Amadio,R,OTT,28,77,15,9,24
6,8476981,Josh Anderson,R,MTL,30,71,14,10,24
6,8481656,Aliaksei Protas,C,WSH,23,63,12,12,24
6,8482809,Jackson Blake,R,CAR,21,66,12,12,24
6,8482111,Justin Barron,D,MTL,23,68,12,12,24
6,8477508,Curtis Lazar,C,NJD,29,56,12,12,24
6,8479293,Brandon Tanev,L,SEA,33,59,11,13,24
6,8481546,Cam York,D,PHI,23,73,9,15,24
6,8483482,Tristan Luneau,D,ANA,20,62,9,15,24
6,8478013,Jake Walman,D,SJS,28,73,6,18,24
6,8482142,Jamie Drysdale,D,PHI,22,71,5,19,24
6,8480806,Isac Lundestrom,C,ANA,25,63,5,19,24
6,8482245,Artem Zub,D,OTT,29,69,4,20,24
6,8481601,Simon Holmstrom,R,NYI,23,66,14,9,23
6,8481624,Ilya Mikheyev,R,CHI,30,59,13,10,23
6,8482062,Cole Smith,L,NSH,29,56,11,12,23
6,8480802,Ryan McLeod,C,BUF,25,67,10,13,23
6,8477987,Ryan Donato,C,CHI,28,65,9,14,23
6,8477392,Hudson Fasching,R,NYI,29,67,9,14,23
6,8473533,Jordan Staal,C,CAR,36,64,8,15,23
6,8478911,Matt Roy,D,WSH,29,66,8,15,23
6,8476278,Colin Blackwell,C,DAL,31,80,8,15,23
6,8479998,Mikey Anderson,D,LAK,25,66,5,18,23
6,8481598,Philip Broberg,D,EDM,23,46,4,19,23
6,8482157,Will Cuylle,L,NYR,22,69,13,9,22
6,8476918,Jimmy Vesey,L,NYR,31,65,13,9,22
6,8480980,Connor Dewar,C,TOR,25,66,12,10,22
6,8477478,William Carrier,L,CAR,30,50,10,12,22
6,8477406,Mattias Janmark,C,EDM,32,72,10,12,22
6,8477989,Christian Dvorak,C,MTL,28,67,9,13,22
6,8481481,Blake Lizotte,C,PIT,27,65,9,13,22
6,8481580,Connor McMichael,C,WSH,23,63,9,13,22
6,8476889,Radek Faksa,C,STL,30,66,9,13,22
6,8479291,Kevin Rooney,C,CGY,31,51,9,13,22
6,8482101,Danil Gushchin,L,SJS,22,57,7,15,22
6,8481059,Scott Perunovich,D,STL,26,58,6,16,22
6,8481606,Jordan Spence,D,LAK,23,65,5,17,22
6,8479398,Samuel Girard,D,COL,26,60,4,18,22
6,8477507,Nikita Zadorov,D,BOS,29,72,4,18,22
6,8480848,Ty Dellandrea,C,SJS,24,46,12,9,21
6,8477903,Garnet Hathaway,R,PHI,33,66,11,10,21
6,8482148,Hendrix Lapierre,C,WSH,22,51,11,10,21
6,8479316,Luke Kunin,C,SJS,27,52,10,11,21
6,8482125,Alexander Holtz,R,VGK,22,67,10,11,21
6,8482259,Bobby McMann,C,TOR,28,69,10,11,21
6,8479393,Noah Gregor,L,OTT,26,67,9,12,21
6,8475231,Casey Cizikas,C,NYI,33,71,8,13,21
6,8476960,Andreas Athanasiou,C,CHI,30,47,7,14,21
6,8482634,Alex Steeves,C,TOR,25,57,7,14,21
6,8475855,Jesper Fast,R,CAR,33,52,6,15,21
6,8478211,Dryden Hunt,L,CGY,29,53,6,15,21
6,8477435,Ryan Graves,D,PIT,29,74,5,16,21
6,8476525,Colin Miller,D,WPG,32,68,4,17,21
6,8478136,Jake Middleton,D,MIN,28,68,4,17,21
6,8475181,Nick Leddy,D,STL,33,73,3,18,21
6,8480246,Nick Perbix,D,TBL,26,74,3,18,21
6,8478416,Erik Cernak,D,TBL,27,70,3,18,21
6,8480222,Sebastian Aho,D,PIT,28,70,3,18,21
6,8479324,Ryan Lindgren,D,NYR,26,61,2,19,21
6,8473453,Trevor Lewis,C,LAK,37,65,9,11,20
6,8477931,Tomas Nosek,L,FLA,32,68,9,11,20
6,8479983,Mario Ferraro,D,SJS,26,70,8,12,20
6,8477369,Carson Soucy,D,VAN,30,61,7,13,20
6,8477499,Rasmus Ristolainen,D,PHI,30,61,6,14,20
6,8478851,Alexandre Carrier,D,NSH,28,70,5,15,20
6,8475343,Nic Dowd,C,WSH,34,60,5,15,20
6,8480873,Rasmus Sandin,D,WSH,24,66,4,16,20
6,8476331,Dylan DeMelo,D,WPG,31,72,4,16,20
6,8476467,Jamie Oleksiak,D,SEA,32,71,4,16,20
6,8481014,Alexander Romanov,D,NYI,24,78,3,17,20
6,8474151,Ryan McDonagh,D,TBL,35,76,2,18,20
6,8474574,Tyler Myers,D,VAN,34,70,0,20,20
6,8478432,Christian Fischer,R,DET,27,71,10,9,19
6,8480829,Jesperi Kotkaniemi,C,CAR,24,63,9,10,19
6,8478043,Sam Lafferty,C,BUF,29,57,9,10,19
6,8477380,Jonny Brodzinski,C,NYR,31,57,9,10,19
6,8475791,Taylor Hall,L,CHI,33,61,7,12,19
6,8482803,Olen Zellweger,D,ANA,21,62,7,12,19
6,8480448,Parker Kelly,L,COL,25,76,7,12,19
6,8476994,Vinnie Hinostroza,C,NSH,30,50,7,12,19
6,8474034,Patrick Maroon,L,CHI,36,52,6,13,19
6,8473507,Jeff Petry,D,DET,37,76,6,13,19
6,8481527,Kaedan Korczak,D,VGK,23,52,6,13,19
6,8480025,MacKenzie Entwistle,R,FLA,25,64,5,14,19
6,8479315,Joey Anderson,R,CHI,26,51,3,16,19
6,8476931,Jake McCabe,D,TOR,31,63,2,17,19
6,8479402,Jake Bean,D,CGY,26,66,1,18,19
6,8476457,Adam Larsson,D,SEA,32,69,0,19,19
6,8476873,Mark Jankowski,C,NSH,30,52,13,5,18
6,8482155,Alex Laferriere,R,LAK,23,71,10,8,18
6,8475220,Marcus Foligno,L,MIN,33,63,8,10,18
6,8478970,Jalen Chatfield,D,CAR,28,63,7,11,18
6,8477353,Tyler Motte,C,DET,29,69,7,11,18
6,8483468,Jiri Kulich,C,BUF,20,56,7,11,18
6,8477034,Jaycob Megna,D,FLA,32,50,6,12,18
6,8476422,Mike Reilly,D,NYI,31,69,5,13,18
6,8482451,Mikael Pyyhtia,L,CBJ,23,46,5,13,18
6,8480950,Ilya Lyubushkin,D,DAL,30,64,5,13,18
6,8475690,Chris Tanev,D,TOR,35,50,4,14,18
6,8479639,Dylan Coghlan,D,WPG,26,57,3,15,18
6,8476858,Phillip Di Giuseppe,L,VAN,31,44,12,5,17
6,8481013,Jonatan Berggren,R,DET,24,65,12,5,17
6,8483499,Liam Ohgren,L,MIN,20,56,12,5,17
6,8476374,Sean Kuraly,C,CBJ,31,60,11,6,17
6,8479336,Carl Grundstrom,R,SJS,27,53,9,8,17
6,8483457,Lane Hutson,D,MTL,20,64,9,8,17
6,8480355,Mark Kastelic,C,BOS,25,61,9,8,17
6,8479066,Ryan Lomberg,L,CGY,30,58,9,8,17
6,8475848,Brendan Gallagher,R,MTL,32,69,8,9,17
6,8483524,Shane Wright,C,SEA,20,59,8,9,17
6,8480441,Trey Fix-Wolansky,R,CBJ,25,45,8,9,17
6,8481167,Brayden Pachal,D,CGY,25,46,8,9,17
6,8480205,Emil Bemstrom,C,PIT,25,53,7,10,17
6,8480035,Henri Jokiharju,D,BUF,25,63,5,12,17
6,8479369,Andrew Peeke,D,BOS,26,59,4,13,17
6,8480003,Jesper Boqvist,C,FLA,26,67,3,14,17
6,8477845,Trevor van Riemsdyk,D,WSH,33,60,3,14,17
6,8481019,David Gustafsson,C,WPG,24,50,2,15,17
6,8476469,Joel Armia,R,MTL,31,66,11,5,16
6,8481028,Martin Pospisil,C,CGY,25,54,10,6,16
6,8482679,Matt Coronato,R,CGY,22,64,9,7,16
6,8479439,Jacob MacDonald,D,COL,31,60,8,8,16
6,8482730,Brandt Clarke,D,LAK,21,48,8,8,16
6,8482737,Zack Bolduc,C,STL,21,47,7,9,16
6,8481477,Nico Sturm,C,SJS,29,62,7,9,16
6,8480144,David Kampf,C,TOR,29,70,6,10,16
6,8480995,Pontus Holmberg,R,TOR,25,60,6,10,16
6,8484149,Gavin Brindley,C,CBJ,20,48,5,11,16
6,8476312,Josh Manson,D,COL,33,65,4,12,16
6,8476856,Mathew Dumba,D,DAL,30,71,4,12,16
6,8479980,Nicolas Hague,D,VGK,26,55,4,12,16
6,8478133,Jake Evans,C,MTL,28,66,3,13,16
6,8482087,Kaiden Guhle,D,MTL,22,67,0,16,16
6,8479414,Nathan Bastian,R,NJD,27,61,11,4,15
6,8478421,A.J. Greer,L,FLA,28,58,9,6,15
6,8482762,Simon Edvinsson,D,DET,21,60,9,6,15
6,8481704,Juuso Parssinen,C,NSH,23,51,8,7,15
6,8481093,Rafael Harvey-Pinard,L,MTL,25,57,7,8,15
6,8482166,Shakir Mukhamadullin,D,SJS,22,62,6,9,15
6,8471709,Marc-Edouard Vlasic,D,SJS,37,61,5,10,15
6,8471677,Jack Johnson,D,CBJ,37,62,5,10,15
6,8477488,Brett Pesce,D,NJD,30,63,3,12,15
6,8477979,Nicolas Aube-Kubel,R,BUF,28,57,3,12,15
6,8470600,Ryan Suter,D,STL,39,67,3,12,15
6,8476967,Brett Kulak,D,EDM,30,59,3,12,15
6,8482192,Isaak Phillips,D,CHI,23,56,2,13,15
6,8478178,Darren Raddysh,D,TBL,28,68,0,15,15
6,8475179,Dmitry Kulikov,D,FLA,34,60,0,15,15
6,8482652,Walker Duehr,R,CGY,27,46,8,6,14
6,8480281,Alexey Toropchenko,R,STL,25,62,7,7,14
6,8481517,Brett Leason,R,ANA,25,57,6,8,14
6,8475842,Sam Carrick,C,NYR,32,60,6,8,14
6,8482807,Ethan Del Mastro,D,CHI,21,49,6,8,14
6,8476891,Matthew Grzelcyk,D,PIT,30,75,5,9,14
6,8481553,Bobby Brink,R,PHI,23,62,4,10,14
6,8477220,Nate Schmidt,D,FLA,33,63,4,10,14
6,8480807,Mattias Samuelsson,D,BUF,24,55,4,10,14
6,8476624,Barclay Goodrow,C,SJS,31,55,4,10,14
6,8480796,Martin Fehervary,D,WSH,25,55,3,11,14
6,8477070,Liam O'Brien,C,UTA,30,51,3,11,14
6,8480192,Johnathan Kovacevic,D,NJD,27,54,3,11,14
6,8481600,Tobias Bjornfot,D,FLA,23,44,3,11,14
6,8475462,Radko Gudas,D,ANA,34,67,2,12,14
6,8481178,Egor Zamula,D,PHI,24,52,2,12,14
6,8478468,Jeremy Lauzon,D,NSH,27,52,2,12,14
6,8476372,Nick Seeler,D,PHI,31,44,2,12,14
6,8480891,Michael Kesselring,D,UTA,24,52,1,13,14
6,8475279,Ben Chiarot,D,DET,33,62,1,13,14
6,8474567,Zach Bogosian,D,MIN,34,67,1,13,14
6,8480058,Pierre-Olivier Joseph,D,STL,25,53,1,13,14
6,8478585,Derek Ryan,C,EDM,38,63,8,5,13
6,8482077,Dylan Holloway,L,EDM,23,42,7,6,13
6,8477401,John Hayden,C,SEA,29,35,7,6,13
6,8483493,Frank Nazar,C,CHI,20,49,6,7,13
6,8476442,Matt Nieto,L,PIT,32,45,6,7,13
6,8479543,Michael Pezzetta,L,MTL,26,56,5,8,13
6,8481641,Joel Kiviranta,L,COL,28,72,4,9,13
6,8479372,Joshua Mahura,D,SEA,26,56,4,9,13
6,8480011,Klim Kostin,C,SJS,25,53,4,9,13
6,8480860,Kevin Bahl,D,CGY,24,53,4,9,13
6,8477851,Jordan Oesterle,D,BOS,32,42,4,9,13
6,8475324,Nick Jensen,D,OTT,34,65,2,11,13
6,8479972,Mason Shaw,C,WPG,26,39,2,11,13
6,8479442,Troy Stecher,D,EDM,30,47,2,11,13
6,8480049,Dylan Samberg,D,WPG,25,58,1,12,13
6,8480073,Erik Brannstrom,D,COL,25,58,1,12,13
6,8474673,TJ Brodie,D,CHI,34,56,1,12,13
6,8480879,Jacob Bernard-Docker,D,OTT,24,53,1,12,13
6,8480172,Jan Rutta,D,SJS,34,60,1,12,13
6,8478840,Will Borgen,D,SEA,28,67,0,13,13
6,8477450,Jason Dickinson,C,CHI,29,57,8,4,12
6,8477573,Nathan Walker,L,STL,30,55,8,4,12
6,8479328,Julien Gauthier,R,NYI,27,67,8,4,12
6,8476934,Brock McGinn,L,ANA,30,47,7,5,12
6,8476822,Luke Glendening,C,TBL,35,78,7,5,12
6,8483495,Simon Nemec,D,NJD,20,59,5,7,12
6,8478451,Ethan Bear,D,WSH,27,51,4,8,12
6,8481161,Jake Christiansen,D,CBJ,25,59,4,8,12
6,8480727,Zach Whitecloud,D,VGK,28,48,3,9,12
6,8476988,Matt Benning,D,SJS,30,63,3,9,12
6,8475208,Brian Dumoulin,D,ANA,33,64,3,9,12
6,8481522,Peyton Krebs,C,BUF,23,59,2,10,12
6,8475455,Brenden Dillon,D,NJD,34,54,2,10,12
6,8480845,Rasmus Kupari,C,WPG,24,41,2,10,12
6,8475188,Brayden McNabb,D,VGK,33,50,2,10,12
6,8480070,Ian Mitchell,D,BOS,25,50,2,10,12
6,8479371,Dante Fabbro,D,NSH,26,63,1,11,12
6,8482659,Josh Doan,R,UTA,22,56,8,3,11
6,8481518,Nolan Foote,L,NJD,24,37,6,5,11
6,8481537,Nikita Okhotiuk,D,CGY,24,49,5,6,11
6,8481550,Adam Beckman,L,NJD,23,41,5,6,11
6,8477962,Brendan Lemieux,L,CAR,28,40,5,6,11
6,8479671,Mathieu Olivier,R,CBJ,27,42,4,7,11
6,8478831,Kevin Stenlund,C,UTA,28,45,3,8,11
6,8479718,Alex Barré-Boulet,C,MTL,27,51,3,8,11
6,8481567,Henry Thrun,D,SJS,23,52,3,8,11
6,8478017,Mark Friedman,D,VAN,29,44,3,8,11
6,8482073,Braden Schneider,D,NYR,23,66,2,9,11
6,8483491,Ivan Miroshnichenko,L,WSH,20,55,2,9,11
6,8478859,Niko Mikkola,D,FLA,28,58,1,10,11
6,8481751,Lukas Rousek,R,BUF,25,37,1,10,11
6,8482784,Zach Dean,C,STL,21,43,6,4,10
6,8480880,Jakub Lauko,C,MIN,24,33,5,5,10
6,8482744,James Malatesta,L,CBJ,21,41,4,6,10
6,8479370,Tyson Jost,C,CAR,26,51,4,6,10
6,8479536,Axel Jonsson-Fjallby,L,WPG,26,34,4,6,10
6,8480074,Alexandre Texier,C,STL,25,52,3,7,10
6,8478452,Caleb Jones,D,LAK,27,56,2,8,10
6,8482176,Wyatt Kaiser,D,CHI,22,60,2,8,10
6,8482859,Zack Ostapchuk,C,OTT,21,52,2,8,10
6,8481599,Victor Soderstrom,D,UTA,23,49,1,9,10
6,8477018,Ben Hutton,D,VGK,31,43,1,9,10
6,8481521,Ronnie Attard,D,PHI,25,51,1,9,10
6,8478508,Yakov Trenin,C,MIN,27,60,5,4,9
6,8480289,Morgan Barron,C,WPG,26,49,5,4,9
6,8480157,Calle Rosen,D,COL,30,45,5,4,9
6,8481422,Jake Lucchini,C,NSH,29,30,5,4,9
6,8481532,Alex Turcotte,C,LAK,23,52,4,5,9
6,8477887,Patrick Brown,C,BOS,32,50,4,5,9
6,8483619,Filip Roos,D,OTT,25,38,4,5,9
6,8475718,Justin Holl,D,DET,32,63,3,6,9
6,8475177,Calvin de Haan,D,COL,33,43,3,6,9
6,8479344,Jesse Puljujarvi,R,PIT,26,49,2,7,9
6,8474090,Brendan Smith,D,DAL,35,52,2,7,9
6,8480887,Jordan Harris,D,MTL,24,61,2,7,9
6,8474013,Ian Cole,D,UTA,35,56,2,7,9
6,8483549,Lucas Condotta,L,MTL,27,38,2,7,9
6,8479968,Vinni Lettieri,C,BOS,29,47,2,7,9
6,8477365,Connor Clifton,D,BUF,29,50,1,8,9
6,8475233,David Savard,D,MTL,34,58,1,8,9
6,8476874,Olli Maatta,D,DET,30,61,1,8,9
6,8482153,Brendan Brisson,C,VGK,23,38,1,8,9
6,8483460,David Jiricek,D,CBJ,21,59,0,9,9
6,8477482,Zachary Sanford,L,CHI,30,42,5,3,8
6,8481679,Maxence Guenette,D,OTT,23,28,5,3,8
6,8475958,Michael Sgarbossa,C,WSH,32,30,5,3,8
6,8481789,Tye Kartye,L,SEA,23,37,4,4,8
6,8480007,Jonas Rondbjerg,R,VGK,25,37,4,4,8
6,8480001,Urho Vaakanainen,D,ANA,25,54,3,5,8
6,8481617,Vasily Podkolzin,R,VAN,23,46,3,5,8
6,8478874,Adam Gaudette,R,OTT,28,29,3,5,8
6,8482747,Brennan Othmann,L,NYR,21,41,3,5,8
6,8475235,Nicolas Deslauriers,L,PHI,33,46,3,5,8
6,8477384,Joshua Brown,D,EDM,30,46,3,5,8
6,8479359,Beck Malenstyn,L,BUF,26,48,2,6,8
6,8481708,Zac Jones,D,NYR,24,49,2,6,8
6,8473446,Erik Johnson,D,PHI,36,43,2,6,8
6,8478443,Brandon Carlo,D,BOS,28,62,1,7,8
6,8474568,Luke Schenn,D,NSH,35,44,1,7,8
6,8477938,Haydn Fleury,D,WPG,28,40,5,2,7
6,8471817,Ryan Reaves,R,TOR,37,42,4,3,7
6,8482751,Ryan Winterton,C,SEA,21,39,4,3,7
6,8481147,Reese Johnson,C,MIN,26,39,4,3,7
6,8482713,Mackie Samoskevich,R,FLA,22,35,4,3,7
6,8481716,Dmitri Voronkov,L,CBJ,24,48,3,4,7
6,8481122,Simon Benoit,D,TOR,26,44,3,4,7
6,8480245,Olle Lycksell,R,PHI,25,34,3,4,7
6,8482964,Arber Xhekaj,D,MTL,23,44,2,5,7
6,8480870,Bo Groulx,C,NYR,24,20,2,5,7
6,8482511,Mason Lohrei,D,BOS,23,33,2,5,7
6,8481568,Alex Vlasic,D,CHI,23,60,1,6,7
6,8482666,Scott Morrow,D,CAR,22,47,1,6,7
6,8482145,Mavrik Bourque,C,DAL,22,49,1,6,7
6,8482861,Vincent Iorio,D,WSH,22,32,1,6,7
6,8476441,Joel Edmundson,D,LAK,31,38,1,6,7
6,8476913,Devin Shore,C,MIN,30,35,1,6,7
6,8476867,Brendan Gaunce,C,MIN,30,37,1,6,7
6,8483012,Logan Morrison,C,SEA,22,29,5,1,6
6,8482141,Lukas Cormier,D,VGK,22,26,5,1,6
6,8479638,Justin Brazeau,R,BOS,26,33,4,2,6
6,8480252,Cole Guttman,C,CHI,25,40,3,3,6
6,8480196,Jacob Bryson,D,BUF,27,50,3,3,6
6,8479986,Kole Lind,R,DAL,26,47,3,3,6
6,8479981,Jonah Gadjovich,L,FLA,26,33,3,3,6
6,8481592,Jakob Pelletier,L,CGY,23,36,2,4,6
6,8479772,Zack MacEwen,R,OTT,28,55,2,4,6
6,8479249,Andrew Poturalski,C,SJS,30,28,2,4,6
6,8479379,Givani Smith,R,SJS,26,25,2,4,6
6,8476952,Dominic Toninato,C,WPG,30,35,2,4,6
6,8480834,Ty Emberson,D,SJS,24,29,2,4,6
6,8484911,Collin Graf,R,SJS,22,37,2,4,6
6,8482095,Tyler Kleven,D,OTT,22,42,1,5,6
6,8475225,Craig Smith,C,CHI,35,41,1,5,6
6,8479944,Zach Aston-Reese,C,VGK,30,49,1,5,6
6,8475750,Jon Merrill,D,MIN,32,67,1,5,6
6,8481543,Nikita Alexandrov,C,STL,24,23,1,5,6
6,8477462,Robert Hagg,D,VGK,29,33,1,5,6
6,8477971,Andreas Englund,D,LAK,28,31,1,5,6
6,8478454,Noah Juulsen,D,VAN,27,36,0,6,6
6,8483570,Ben Meyers,C,SEA,26,29,4,1,5
6,8481556,John Beecher,C,BOS,23,33,4,1,5
6,8483466,Kevin Korchinski,D,CHI,20,46,3,2,5
6,8481754,Nikita Nesterenko,C,ANA,23,32,3,2,5
6,8481743,Marc Del Gaizo,D,NSH,25,20,3,2,5
6,8483489,Fraser Minten,C,TOR,31,13,3,2,5
6,8482165,Yan Kuznetsov,D,CGY,22,22,3,2,5
6,8479378,Logan Stanley,D,WPG,26,42,2,3,5
6,8481056,Spencer Stastney,D,NSH,24,29,2,3,5
6,8482070,Mitchell Chaffee,R,TBL,26,43,2,3,5
6,8477527,Ross Johnston,L,ANA,30,26,2,3,5
6,8482177,Marat Khusnutdinov,C,MIN,22,30,2,3,5
6,8477467,Gustav Olofsson,D,SEA,30,15,2,3,5
6,8484287,Cole McWard,D,VAN,23,22,2,3,5
6,8480990,Declan Chisholm,D,MIN,24,36,1,4,5
6,8474166,Alec Martinez,D,CHI,37,51,1,4,5
6,8478450,Parker Wotherspoon,D,BOS,27,27,1,4,5
6,8476473,Connor Murphy,D,CHI,31,33,1,4,5
6,8481541,Samuel Bolduc,D,NYI,24,26,1,4,5
6,8478502,Dennis Gilbert,D,BUF,28,15,1,4,5
6,8475795,Dylan McIlrath,D,WSH,32,14,1,4,5
6,8483763,Maksymilian Szuber,D,UTA,22,29,3,1,4
6,8480292,Carson Meyer,R,ANA,27,28,3,1,4
6,8479348,Kale Clague,D,BUF,26,40,2,2,4
6,8478424,Jansen Harkins,C,ANA,27,39,2,2,4
6,8482496,Nils Aman,C,VAN,24,31,2,2,4
6,8474612,Travis Hamonic,D,OTT,34,43,2,2,4
6,8481564,Ryan Johnson,D,BUF,23,18,2,2,4
6,8483397,Marc McLaughlin,C,BOS,25,28,2,2,4
6,8481462,Mason Morelli,L,VGK,28,18,2,2,4
6,8484325,Waltteri Merela,C,TBL,26,21,2,2,4
6,8475762,Derek Forbort,D,VAN,32,44,1,3,4
6,8478409,Anthony Richard,C,PHI,28,41,1,3,4
6,8479576,Vincent Desharnais,D,VAN,28,31,1,3,4
6,8482102,Vasily Ponomarev,C,PIT,22,20,1,3,4
6,8479320,Maxime Lajoie,D,SEA,27,29,1,3,4
6,8477073,Kurtis MacDermid,L,NJD,30,29,1,3,4
6,8481701,Santeri Hatakka,D,NJD,23,41,0,4,4
6,8481006,Tyler Tucker,D,STL,24,18,0,4,4
6,8479994,Jaret Anderson-Dolan,C,WPG,25,36,2,1,3
6,8482144,Jack Thompson,D,SJS,22,22,2,1,3
6,8483630,Pavol Regenda,L,ANA,25,31,2,1,3
6,8480267,Sammy Walker,C,MIN,25,15,2,1,3
6,8477149,Scott Sabourin,R,SJS,32,14,2,1,3
6,8482147,Jean-Luc Foudy,C,COL,22,24,2,1,3
6,8482094,Daemon Hunt,D,MIN,22,13,2,1,3
6,8480468,James Hamblin,L,EDM,25,15,2,1,3
6,8479520,Brandon Duhaime,R,WSH,27,48,1,2,3
6,8482733,Logan Mailloux,D,MTL,31,30,1,2,3
6,8484254,Akito Hirose,D,VAN,25,36,1,2,3
6,8481237,Kyle MacLean,C,NYI,25,19,1,2,3
6,8479991,Jake Leschyshyn,C,NYR,25,32,1,2,3
6,8477335,Kyle Burroughs,D,LAK,29,44,1,2,3
6,8480890,Jan Jenik,C,OTT,24,30,1,2,3
6,8482765,Isak Rosen,R,BUF,21,27,1,2,3
6,8477810,Joel Hanley,D,CGY,33,21,1,2,3
6,8482250,Callahan Burke,C,VGK,27,26,1,2,3
6,8482172,Landon Slaggert,L,CHI,22,19,1,2,3
6,8477320,Anton Blidh,L,NYR,29,18,1,2,3
6,8477244,Chad Ruhwedel,D,NYR,34,34,0,3,3
6,8484258,Sam Malinski,D,COL,26,22,0,3,3
6,8483398,Declan Carlile,D,TBL,31,6,0,3,3
6,8482858,Ryker Evans,D,SEA,23,23,2,0,2
6,8479367,William Lockwood,R,FLA,26,24,2,0,2
6,8478881,Brett Seney,L,CHI,28,6,2,0,2
6,8481030,Jack St. Ivany,D,PIT,25,16,2,0,2
6,8481206,John Ludvig,D,PIT,24,10,2,0,2
6,8478051,Max Willman,C,NJD,29,18,1,1,2
6,8478146,Matthew Highmore,C,OTT,28,33,1,1,2
6,8481043,Cole Koepke,L,BOS,26,13,1,1,2
6,8482201,Gage Goncalves,C,TBL,23,27,1,1,2
6,8481806,Louis Crevier,D,CHI,23,14,1,1,2
6,8480851,Akil Thomas,C,LAK,24,14,1,1,2
6,8481065,Angus Crookshank,L,OTT,25,17,1,1,2
6,8483407,Brandon Scanlin,D,NYR,25,6,1,1,2
6,8482118,Sam Colangelo,R,ANA,23,21,1,1,2
6,8477993,Justin Kirkland,C,CGY,28,10,1,1,2
6,8475755,Alexander Petrovic,D,DAL,32,10,1,1,2
6,8479362,Riley Tufte,L,BOS,26,17,1,1,2
6,8483546,Marshall Rifai,D,TOR,26,6,1,1,2
6,8479587,Rhett Gardner,C,PHI,28,18,0,2,2
6,8481605,Jackson LaCombe,D,ANA,23,40,0,2,2
6,8482470,Ilya Solovyov,D,CGY,24,23,0,2,2
6,8483512,Matthew Savoie,C,EDM,20,20,0,2,2
6,8480874,Adam Ginning,D,PHI,24,10,0,2,2
6,8483395,Arshdeep Bains,L,VAN,23,9,0,2,2
6,8482162,Roby Jarventie,L,EDM,22,11,0,2,2
6,8481024,Linus Karlsson,C,VAN,25,8,0,2,2
6,8484321,Nikolas Matinpalo,D,OTT,26,3,0,2,2
6,8481609,Vladislav Kolyachonok,D,UTA,23,27,1,0,1
6,8482460,Matt Rempe,C,NYR,22,9,1,0,1
6,8482061,Brandon Biro,L,SEA,26,8,1,0,1
6,8483471,Brad Lambert,C,WPG,31,11,1,0,1
6,8478477,Mitchell Stephens,C,SEA,27,21,1,0,1
6,8478011,Louie Belpedio,D,PHI,28,14,1,0,1
6,8483567,Georgii Merkulov,C,BOS,24,8,1,0,1
6,8481578,Graeme Clarke,R,MIN,23,11,1,0,1
6,8475780,Chris Wagner,R,COL,33,12,1,0,1
6,8479985,Cale Fleury,D,SEA,26,19,0,1,1
6,8482516,Matthew Kessel,D,STL,24,11,0,1,1
6,8479419,Brett Murray,L,BUF,26,20,0,1,1
6,8481593,Jayden Struble,D,MTL,23,24,0,1,1
6,8480032,Shane Bowers,C,NJD,25,9,0,1,1
6,8480075,Cameron Crotty,D,MIN,25,12,0,1,1
6,8484304,Uvis Balinskis,D,FLA,28,9,0,1,1
6,8480844,Grigori Denisenko,L,VGK,24,22,0,0,0
6,8478021,William Lagesson,D,DET,28,19,0,0,0
6,8482088,Justin Sourdif,R,FLA,22,14,0,0,0
6,8481585,Egor Afanasyev,L,SJS,23,16,0,0,0
6,8474062,Riley Nash,C,NYR,35,13,0,0,0
6,8480084,Nick DeSimone,D,NJD,30,13,0,0,0
6,8483531,Brian Halonen,L,NJD,25,6,0,0,0
6,8477473,Justin Bailey,R,SJS,29,25,0,0,0
6,8481719,Maxwell Crozier,D,TBL,24,16,0,0,0
6,8477541,Dakota Mermis,D,TOR,30,4,0,0,0
6,8483597,Milos Kelemen,L,UTA,25,16,0,0,0
6,8484326,Patrik Koch,D,UTA,28,4,0,0,0
6,8482929,Emil Lilleberg,D,TBL,23,24,0,0,0
6,8480823,Alexander Alexeyev,D,WSH,25,12,0,0,0
6,8481699,Aku Raty,R,UTA,23,16,0,0,0
6,8475413,Justin Dowling,C,NJD,34,15,0,0,0
6,8484255,Jason Polin,R,COL,25,6,0,0,0
6,8479421,Jacob Moverare,D,LAK,26,4,0,0,0
6,8481726,Adam Edstrom,C,NYR,24,6,0,0,0
6,8483920,Pierrick Dube,R,WSH,23,7,0,0,0
6,8482476,Emil Heineman,L,MTL,23,4,0,0,0
6,8482787,Nikita Chibrikov,R,WPG,31,6,0,0,0
6,8482126,Emil Andrae,D,PHI,31,1,0,0,0
6,8478446,Glenn Gawdin,C,LAK,27,10,0,0,0
6,8482197,Adam Raska,R,MIN,23,4,0,0,0
6,8480306,Grant Hutton,D,NYI,29,9,0,0,0
6,8479522,Hardy Haman Aktell,D,WSH,26,3,0,0,0
6,8476323,Max McCormick,L,SEA,32,2,0,0,0
6,8481655,Cole Schwindt,R,CGY,23,6,0,0,0
6,8483432,Luca Del Bel Belluz,C,CBJ,31,6,0,0,0
6,8484259,Ondrej Pavel,C,COL,31,0,0,0,0
6,8470794,Joe Pavelski,C,,40,0,0,0,0
6,8479321,Lucas Johansen,D,,27,0,0,0,0
6,8477950,Tony DeAngelo,D,,29,0,0,0,0
6,8471218,Blake Wheeler,R,,38,0,0,0,0
6,8475197,Tyson Barrie,D,,33,0,0,0,0
6,8474157,Max Pacioretty,L,,36,0,0,0,0
6,8475744,Evgeny Kuznetsov,C,,32,0,0,0,0
6,8474037,James van Riemsdyk,L,,35,0,0,0,0
6,8476907,Mackenzie MacEachern,L,,30,0,0,0,0
6,8480216,Jacob Peterson,C,,25,0,0,0,0
6,8474602,Justin Schultz,D,,34,0,0,0,0
6,8482222,Alexander Barabanov,L,,30,0,0,0,0
6,8474031,Kevin Shattenkirk,D,,35,0,0,0,0
6,8477330,Dominik Kubalik,L,,29,0,0,0,0
6,8480884,Calen Addison,D,,24,0,0,0,0
6,8475906,John Klingberg,D,,32,0,0,0,0
6,8480008,Adam Ruzicka,C,,25,0,0,0,0
6,8476884,Derrick Pouliot,D,,30,0,0,0,0
6,8476919,Chris Tierney,C,,30,0,0,0,0
6,8479415,Michael McLeod,C,,26,0,0,0,0
6,8474870,Tyler Johnson,C,,34,0,0,0,0
6,8470604,Jeff Carter,C,,39,0,0,0,0
6,8478104,Sammy Blais,L,,28,0,0,0,0
6,8474884,Mike Hoffman,C,,35,0,0,0,0
6,8481591,Sam Poulin,R,,23,0,0,0,0
6,8471274,Alex Goligoski,D,,39,0,0,0,0
6,8476871,Tanner Pearson,L,,32,0,0,0,0
6,8476393,Nick Cousins,C,,31,0,0,0,0
6,8479977,Kailer Yamamoto,R,,26,0,0,0,0
6,8479346,Dillon Dube,C,,26,0,0,0,0
6,8480184,Gustav Lindstrom,D,,26,0,0,0,0
6,8479376,Victor Mete,D,,26,0,0,0,0
6,8473449,Kyle Okposo,R,,36,0,0,0,0
6,8481058,Jesse Ylonen,R,,25,0,0,0,0
6,8475752,Tyler Pitlick,C,,33,0,0,0,0
6,8481239,Samuel Fagemo,L,,24,0,0,0,0
6,8480821,Filip Zadina,R,,25,0,0,0,0
6,8470966,Mark Giordano,D,,41,0,0,0,0
6,8478495,Denis Gurianov,R,,27,0,0,0,0
6,8477464,Nic Petan,C,,29,0,0,0,0
6,8478099,Kevin Labanc,R,,29,0,0,0,0
6,8482241,Radim Zohorna,L,,28,0,0,0,0
6,8474040,Sam Gagner,C,,35,0,0,0,0
6,8479514,Rem Pitlick,C,,27,0,0,0,0
6,8478430,Oliver Kylington,D,,27,0,0,0,0
6,8479533,Joona Koppanen,L,,26,0,0,0,0
6,8479984,Cal Foote,D,,26,0,0,0,0
6,8477126,Jayson Megna,C,,34,0,0,0,0
6,8475164,Jakob Silfverberg,R,,34,0,0,0,0
6,8474009,Nick Bonino,C,,36,0,0,0,0
6,8479458,Nikita Zaitsev,D,,33,0,0,0,0
6,8477944,Jakub Vrana,L,,28,0,0,0,0
6,8471699,Andrew Cogliano,C,,37,0,0,0,0
6,8478067,Oskar Lindblom,L,,28,0,0,0,0
6,8471686,Marc Staal,D,,37,0,0,0,0
6,8470610,Zach Parise,L,,40,0,0,0,0
6,8478904,Steven Lorentz,C,,28,0,0,0,0
6,8473473,Milan Lucic,L,,36,0,0,0,0
6,8480031,Maxime Comtois,L,,25,0,0,0,0
6,8478512,Austin Czarnik,C,,32,0,0,0,0
6,8473504,Cal Clutterbuck,R,,37,0,0,0,0
6,8477454,Adam Erne,L,,29,0,0,0,0
6,8479383,Boris Katchouk,L,,26,0,0,0,0
6,8475825,Jani Hakanpää,D,,32,0,0,0,0
6,8477846,Ryan Carpenter,C,,33,0,0,0,0
6,8477930,Pierre-Edouard Bellemare,L,,39,0,0,0,0
6,8478400,Colin White,C,,27,0,0,0,0
6,8480226,Marián Studenic,R,,26,0,0,0,0
6,8480853,Liam Foudy,C,,24,0,0,0,0
6,8475797,Jarred Tinordi,D,,32,0,0,0,0
6,8479423,Alex Nylander,L,,26,0,0,0,0
6,8474618,Marco Scandella,D,,34,0,0,0,0
6,8478028,Fredrik Olofsson,L,,28,0,0,0,0
6,8474709,Matt Martin,L,,35,0,0,0,0
6,8481070,Hugh McGing,L,,26,0,0,0,0
6,8479546,Oskar Steen,C,,26,0,0,0,0
6,8474145,Robert Bortuzzo,D,,35,0,0,0,0
6,8476915,Jujhar Khaira,L,,30,0,0,0,0
6,8480274,Philip Kemp,D,EDM,25,1,0,0,0
6,8475278,Byron Froese,C,,33,0,0,0,0
6,8481812,Nikolai Knyzhov,D,,27,0,0,0,0
6,8478408,Travis Dermott,D,,28,0,0,0,0
6,8481077,John Leonard,L,,26,0,0,0,0
6,8479547,Matthew Phillips,R,,26,0,0,0,0
6,8480836,Jonathan Gruden,C,,24,0,0,0,0
6,8481690,Tyler Angle,C,,24,0,0,0,0
6,8475766,Austin Watson,L,,32,0,0,0,0
6,8478854,Ryan Shea,D,PIT,27,9,0,0,0
6,8481016,Ruslan Iskhakov,C,,24,0,0,0,0
6,8478078,Rourke Chartier,C,,28,0,0,0,0
6,8479330,Brandon Gignac,C,MTL,27,10,0,0,0
6,8483401,Marc Johnstone,R,PIT,28,1,0,0,0
6,8480776,Sheldon Rempal,R,,29,0,0,0,0
6,8478956,Samuel Laberge,L,NJD,27,2,0,0,0
6,8483609,Adam Klapka,R,CGY,24,2,0,0,0
6,8483045,Cameron Butler,R,CBJ,31,0,0,0,0
6,8481534,Raphael Lavoie,C,EDM,24,1,0,0,0
6,8478147,Bokondji Imama,L,PIT,28,5,0,0,0
6,8484314,Jiri Smejkal,L,,28,0,0,0,0
7,8478402,Connor McDavid,C,EDM,27,78,47,121,168
7,8477492,Nathan MacKinnon,C,COL,29,82,69,89,158
7,8476453,Nikita Kucherov,R,TBL,31,82,42,87,129
7,8478864,Kirill Kaprizov,L,MIN,27,75,50,70,120
7,8477934,Leon Draisaitl,C,EDM,29,76,47,73,120
7,8479314,Matthew Tkachuk,L,FLA,27,80,30,84,114
7,8477493,Aleksander Barkov,C,FLA,29,78,33,75,108
7,8479318,Auston Matthews,C,TOR,27,79,59,48,107
7,8478550,Artemi Panarin,L,NYR,33,81,33,74,107
7,8478420,Mikko Rantanen,R,COL,28,81,45,57,102
7,8477939,William Nylander,R,TOR,28,79,47,54,101
7,8478483,Mitch Marner,R,TOR,27,78,27,74,101
7,8477956,David Pastrnak,R,BOS,28,82,51,49,100
7,8477933,Sam Reinhart,C,FLA,29,79,50,50,100
7,8471675,Sidney Crosby,C,PIT,37,75,38,62,100
7,8477404,Jake Guentzel,C,TBL,30,82,49,50,99
7,8481559,Jack Hughes,C,NJD,23,80,44,51,95
7,8478010,Brayden Point,C,TBL,28,82,51,40,91
7,8475765,Vladimir Tarasenko,R,DET,33,81,42,49,91
7,8480801,Brady Tkachuk,L,OTT,25,81,41,49,90
7,8479343,Clayton Keller,R,UTA,26,78,38,52,90
7,8480027,Jason Robertson,L,DAL,25,81,30,60,90
7,8478403,Jack Eichel,C,VGK,28,77,34,55,89
7,8482116,Tim Stützle,C,OTT,22,77,30,59,89
7,8477946,Dylan Larkin,C,DET,28,80,47,41,88
7,8480012,Elias Pettersson,C,VAN,26,78,27,61,88
7,8476454,Ryan Nugent-Hopkins,C,EDM,31,80,35,52,87
7,8484144,Connor Bedard,C,CHI,19,74,30,57,87
7,8480023,Robert Thomas,C,STL,25,75,26,61,87
7,8479323,Adam Fox,D,NYR,26,74,23,64,87
7,8474600,Roman Josi,D,NSH,34,76,21,66,87
7,8478449,Roope Hintz,C,DAL,28,81,50,34,84
7,8471214,Alex Ovechkin,L,WSH,39,76,36,48,84
7,8477942,Kevin Fiala,L,LAK,28,81,29,55,84
7,8478398,Kyle Connor,L,WPG,28,71,29,54,83
7,8476456,Jonathan Huberdeau,C,CGY,31,79,17,66,83
7,8479407,Jesper Bratt,L,NJD,26,76,32,50,82
7,8478445,Mathew Barzal,C,NYI,27,77,28,54,82
7,8477504,Josh Morrissey,D,WPG,29,73,17,65,82
7,8478439,Travis Konecny,R,PHI,27,76,35,46,81
7,8475172,Nazem Kadri,C,CGY,34,79,36,44,80
7,8478427,Sebastian Aho,C,CAR,27,68,35,45,80
7,8477940,Nikolaj Ehlers,L,WPG,28,73,27,53,80
7,8482078,Lucas Raymond,L,DET,22,79,35,44,79
7,8477402,Pavel Buchnevich,L,STL,29,75,29,50,79
7,8476468,J.T. Miller,C,VAN,31,75,24,55,79
7,8476459,Mika Zibanejad,C,NYR,31,77,23,56,79
7,8476389,Vincent Trocheck,C,NYR,31,78,34,44,78
7,8477409,Carter Verhaeghe,C,FLA,29,77,36,41,77
7,8479385,Jordan Kyrou,C,STL,26,77,35,42,77
7,8475168,Matt Duchene,C,DAL,33,81,32,45,77
7,8474141,Patrick Kane,R,DET,36,82,27,50,77
7,8475913,Mark Stone,R,VGK,32,72,27,50,77
7,8475692,Mats Zuccarello,R,MIN,37,75,18,59,77
7,8479337,Alex DeBrincat,R,DET,27,80,32,44,76
7,8475184,Chris Kreider,L,NYR,33,74,48,27,75
7,8477951,Nick Schmaltz,C,UTA,28,79,32,43,75
7,8482740,Wyatt Johnston,C,DAL,21,81,45,29,74
7,8481557,Matt Boldy,L,MIN,23,73,31,43,74
7,8478873,Troy Terry,R,ANA,27,77,24,50,74
7,8480800,Quinn Hughes,D,VAN,25,74,16,58,74
7,8476887,Filip Forsberg,L,NSH,30,75,34,39,73
7,8475166,John Tavares,C,TOR,34,76,19,54,73
7,8477949,Alex Tuch,R,BUF,28,74,17,56,73
7,8480069,Cale Makar,D,COL,26,69,19,52,71
7,8477500,Bo Horvat,C,NYI,29,79,38,32,70
7,8475754,Brock Nelson,C,NYI,33,79,36,33,69
7,8479420,Tage Thompson,C,BUF,27,70,36,33,69
7,8478444,Brock Boeser,R,VAN,27,78,26,43,69
7,8481711,Matias Maccelli,L,UTA,24,76,16,53,69
7,8480036,Miro Heiskanen,D,DAL,25,79,12,57,69
7,8484166,Adam Fantilli,C,CBJ,20,72,31,37,68
7,8480865,Noah Dobson,D,NYI,24,81,13,55,68
7,8476460,Mark Scheifele,C,WPG,31,69,29,38,67
7,8474564,Steven Stamkos,C,NSH,34,76,25,42,67
7,8471685,Anze Kopitar,C,LAK,37,79,24,43,67
7,8480839,Rasmus Dahlin,D,BUF,24,71,21,46,67
7,8476346,Johnny Gaudreau,L,CBJ,31,74,17,50,67
7,8480002,Nico Hischier,C,NJD,25,74,24,41,65
7,8476853,Morgan Rielly,D,TOR,30,70,8,57,65
7,8475784,Jeff Skinner,C,EDM,32,78,35,29,64
7,8477501,Valeri Nichushkin,R,COL,29,82,28,35,63
7,8478407,Vince Dunn,D,SEA,28,71,17,46,63
7,8474578,Erik Karlsson,D,PIT,34,78,16,47,63
7,8476881,Tomas Hertl,C,VGK,31,80,16,47,63
7,8480803,Evan Bouchard,D,EDM,25,74,7,56,63
7,8480014,Gabriel Vilardi,C,WPG,25,66,39,23,62
7,8481540,Cole Caufield,R,MTL,23,76,33,29,62
7,8477416,Oliver Bjorkstrand,R,SEA,29,77,30,32,62
7,8478856,Conor Garland,R,VAN,28,72,23,39,62
7,8477447,Shea Theodore,D,VGK,29,62,19,43,62
7,8478460,Zach Werenski,D,CBJ,27,81,13,49,62
7,8476448,William Karlsson,C,VGK,31,77,25,36,61
7,8473419,Brad Marchand,L,BOS,36,82,23,38,61
7,8475786,Zach Hyman,L,EDM,32,74,29,31,60
7,8482124,Quinton Byfield,R,LAK,22,81,29,31,60
7,8471215,Evgeni Malkin,C,PIT,38,74,26,34,60
7,8477955,Jared McCann,L,SEA,28,75,28,31,59
7,8480208,Drake Batherson,R,OTT,26,81,25,34,59
7,8482699,Dylan Guenther,R,UTA,21,81,21,38,59
7,8478519,Anthony Cirelli,C,TBL,27,82,19,40,59
7,8480039,Martin Necas,C,CAR,25,71,27,31,58
7,8477494,Jonathan Drouin,L,COL,29,76,26,32,58
7,8478047,Michael Bunting,L,PIT,29,73,26,32,58
7,8479542,Brandon Hagel,L,TBL,26,81,23,35,58
7,8475158,Ryan O'Reilly,C,NSH,33,71,21,37,58
7,8481528,Dylan Cozens,C,BUF,23,70,21,37,58
7,8474679,Gustav Nyquist,C,NSH,35,75,18,40,58
7,8479675,Trevor Moore,L,LAK,29,80,16,42,58
7,8484153,Leo Carlsson,C,ANA,20,68,27,30,57
7,8482109,Alexis Lafrenière,L,NYR,23,73,25,32,57
7,8478975,Mason Marchment,L,DAL,29,80,19,38,57
7,8480018,Nick Suzuki,C,MTL,25,79,14,43,57
7,8477451,Ryan Hartman,R,MIN,30,66,28,28,56
7,8483808,Andrei Kuzmenko,L,CGY,28,78,25,31,56
7,8475794,Tyler Seguin,C,DAL,32,81,24,32,56
7,8476905,Chandler Stephenson,C,SEA,30,72,13,43,56
7,8476875,Mike Matheson,D,MTL,30,76,7,49,56
7,8474641,Adam Henrique,C,EDM,34,77,28,27,55
7,8480830,Andrei Svechnikov,R,CAR,24,72,23,32,55
7,8477496,Elias Lindholm,C,BOS,30,82,20,35,55
7,8475169,Evander Kane,L,EDM,33,76,32,22,54
7,8482665,Matty Beniers,C,SEA,22,75,21,33,54
7,8473994,Jamie Benn,L,DAL,35,79,13,41,54
7,8476432,Boone Jenner,C,CBJ,31,71,35,18,53
7,8476539,Jonathan Marchessault,R,NSH,34,72,31,22,53
7,8474586,Jordan Eberle,R,SEA,34,74,22,31,53
7,8473512,Claude Giroux,R,OTT,36,79,20,33,53
7,8478493,Joel Eriksson Ek,C,MIN,27,69,20,33,53
7,8478414,Timo Meier,R,NJD,28,72,27,25,52
7,8477407,Anthony Duclair,L,NYI,29,77,18,34,52
7,8480434,Sean Durzi,D,UTA,26,72,14,38,52
7,8479999,Casey Mittelstadt,C,COL,26,82,12,40,52
7,8477960,Adrian Kempe,R,LAK,28,82,27,24,51
7,8477476,Artturi Lehkonen,L,COL,29,80,27,24,51
7,8478438,Tommy Novak,C,NSH,27,76,27,24,51
7,8482097,Jack Quinn,R,BUF,23,65,26,25,51
7,8478233,Andrew Mangiapane,L,WSH,28,72,24,27,51
7,8475170,Brayden Schenn,C,STL,33,69,20,31,51
7,8480015,Owen Tippett,R,PHI,25,76,26,24,50
7,8482745,Mason McTavish,C,ANA,21,72,24,26,50
7,8475753,Justin Faulk,D,STL,32,74,9,41,50
7,8476906,Shayne Gostisbehere,D,CAR,31,78,9,41,50
7,8477935,Sam Bennett,C,FLA,28,77,22,27,49
7,8477964,Ivan Barbashev,C,VGK,29,77,22,27,49
7,8483515,Juraj Slafkovsky,L,MTL,20,77,22,27,49
7,8478401,Pavel Zacha,C,BOS,27,76,19,30,49
7,8477503,Max Domi,C,TOR,29,79,18,31,49
7,8481596,Shane Pinto,C,OTT,24,79,17,32,49
7,8475745,Charlie Coyle,C,BOS,32,76,16,33,49
7,8474150,Mikael Backlund,C,CGY,35,79,16,33,49
7,8477456,J.T. Compher,L,DET,29,81,15,34,49
7,8474590,John Carlson,D,WSH,34,66,12,37,49
7,8475151,Kyle Palmieri,C,NYI,33,78,24,24,48
7,8478462,Nicolas Roy,C,VGK,27,77,22,26,48
7,8476872,Scott Laughton,C,PHI,30,77,16,32,48
7,8479345,Jakob Chychrun,D,WSH,26,65,16,32,48
7,8477986,Brandon Montour,D,SEA,30,66,16,32,48
7,8480817,K'Andre Miller,D,NYR,24,66,11,37,48
7,8481542,Moritz Seider,D,DET,23,76,10,38,48
7,8475798,Mikael Granlund,C,SJS,32,62,6,42,48
7,8479525,Ross Colton,C,COL,28,82,26,21,47
7,8475768,Jaden Schwartz,C,SEA,32,71,23,24,47
7,8483431,Logan Cooley,C,UTA,20,78,21,26,47
7,8478440,Dylan Strome,C,WSH,27,67,18,29,47
7,8476479,Phillip Danault,C,LAK,31,80,18,29,47
7,8482110,Dawson Mercer,C,NJD,23,76,18,29,47
7,8477021,Alex Kerfoot,C,UTA,30,72,17,30,47
7,8477932,Aaron Ekblad,D,FLA,28,74,12,35,47
7,8479410,Mikhail Sergachev,D,UTA,26,67,7,40,47
7,8478366,Frank Vatrano,R,ANA,30,69,26,20,46
7,8479987,Morgan Geekie,C,BOS,26,74,19,27,46
7,8478042,Viktor Arvidsson,L,EDM,31,73,16,30,46
7,8475167,Victor Hedman,D,TBL,34,80,11,35,46
7,8477346,MacKenzie Weegar,D,CGY,30,75,11,35,46
7,8471724,Kris Letang,D,PIT,37,80,9,37,46
7,8478397,Rasmus Andersson,D,CGY,28,76,7,39,46
7,8475810,Bryan Rust,R,PIT,32,69,25,20,45
7,8478498,Jake DeBrusk,L,VAN,28,76,25,20,45
7,8478466,Daniel Sprong,R,VAN,27,74,22,23,45
7,8475714,Calle Jarnkrok,C,TOR,33,79,21,24,45
7,8476880,Tom Wilson,R,WSH,30,67,20,25,45
7,8479992,Michael Rasmussen,C,DET,25,78,20,25,45
7,8480188,Fabian Zetterlund,L,SJS,25,67,18,27,45
7,8475763,Kevin Hayes,R,PIT,32,73,17,28,45
7,8478115,Pierre Engvall,L,NYI,28,79,17,28,45
7,8476826,Yanni Gourde,C,SEA,33,72,17,28,45
7,8475793,Ryan Johansen,C,PHI,32,73,16,29,45
7,8480798,Philipp Kurashev,C,CHI,25,65,15,30,45
7,8478472,Mathieu Joseph,R,STL,27,70,13,32,45
7,8475218,Mattias Ekholm,D,EDM,34,72,13,32,45
7,8482684,Luke Hughes,D,NJD,21,67,9,36,45
7,8475764,Cam Fowler,D,ANA,33,76,5,40,45
7,8478474,Lawson Crouse,L,UTA,27,68,30,14,44
7,8482125,Alexander Holtz,R,VGK,22,71,28,16,44
7,8476399,Blake Coleman,C,CGY,33,74,24,20,44
7,8477479,Tyler Bertuzzi,L,CHI,29,66,18,26,44
7,8481533,Trevor Zegras,C,ANA,23,68,16,28,44
7,8484145,Zach Benson,L,BUF,19,69,15,29,44
7,8476458,Ryan Strome,C,ANA,31,67,13,31,44
7,8477998,Warren Foegele,L,LAK,28,79,21,22,43
7,8481618,Alex Newhook,C,MTL,23,72,21,22,43
7,8482720,Matthew Knies,L,TOR,22,79,19,24,43
7,8480028,Morgan Frost,C,PHI,25,68,17,26,43
7,8476792,Torey Krug,D,STL,33,69,14,29,43
7,8478458,John (Jack) Roslovic,C,CAR,27,65,12,31,43
7,8476958,Jaccob Slavin,D,CAR,30,73,9,34,43
7,8478469,Thomas Chabot,D,OTT,27,74,8,35,43
7,8481581,Thomas Harley,D,DAL,23,77,8,35,43
7,8474565,Alex Pietrangelo,D,VGK,34,61,6,37,43
7,8476483,Rickard Rakell,R,PIT,31,68,23,19,42
7,8475726,Tyler Toffoli,C,SJS,32,64,21,21,42
7,8475191,Reilly Smith,R,NYR,33,69,21,21,42
7,8482159,Tyson Foerster,R,PHI,22,76,21,21,42
7,8481604,Pavel Dorofeyev,L,VGK,24,76,18,24,42
7,8482702,Logan Stankoven,C,DAL,21,81,14,28,42
7,8476897,Oskar Sundqvist,C,STL,30,68,13,29,42
7,8478055,Gustav Forsling,D,FLA,28,72,8,34,42
7,8475314,Anders Lee,L,NYI,34,79,22,19,41
7,8476438,Brandon Saad,L,STL,32,70,22,19,41
7,8471698,T.J. Oshie,R,WSH,38,69,19,22,41
7,8475760,Nick Bjugstad,C,UTA,32,68,18,23,41
7,8475287,Erik Haula,L,NJD,33,71,17,24,41
7,8478413,Jordan Greenway,L,BUF,27,64,17,24,41
7,8474102,David Perron,L,OTT,36,82,16,25,41
7,8479400,Pierre-Luc Dubois,L,WSH,26,70,16,25,41
7,8478542,Evan Rodrigues,C,FLA,31,72,16,25,41
7,8477426,Nicholas Paul,L,TBL,29,82,19,21,40
7,8478057,Dakota Joshua,C,VAN,28,68,18,22,40
7,8473986,Alex Killorn,L,ANA,35,73,17,23,40
7,8482175,JJ Peterka,R,BUF,22,73,17,23,40
7,8470613,Brent Burns,D,CAR,39,78,12,28,40
7,8478396,Noah Hanifin,D,VGK,27,59,7,33,40
7,8478500,Ivan Provorov,D,CBJ,27,77,7,33,40
7,8481068,Yegor Sharangovich,C,CGY,26,73,23,16,39
7,8482093,Seth Jarvis,C,CAR,22,70,22,17,39
7,8480849,Barrett Hayton,C,UTA,24,71,20,19,39
7,8476461,Sean Couturier,C,PHI,32,69,17,22,39
7,8477444,Andre Burakovsky,L,SEA,29,68,17,22,39
7,8480185,Eetu Luostarinen,C,FLA,26,72,17,22,39
7,8479365,Trent Frederic,C,BOS,26,80,16,23,39
7,8482133,Thomas Bordeleau,C,SJS,22,70,15,24,39
7,8477429,Andrew Copp,C,DET,30,76,12,27,39
7,8476882,Teuvo Teravainen,C,CHI,30,63,10,29,39
7,8474563,Drew Doughty,D,LAK,35,69,9,30,39
7,8477495,Seth Jones,D,CHI,30,69,7,32,39
7,8477952,Robby Fabbri,C,ANA,28,64,19,19,38
7,8477511,Anthony Mantha,R,CGY,30,74,16,22,38
7,8480871,Adam Boqvist,D,FLA,24,74,15,23,38
7,8482705,Cole Sillinger,C,CBJ,21,68,13,25,38
7,8484203,Bradly Nadeau,L,CAR,19,64,9,29,38
7,8479425,Filip Hronek,D,VAN,27,71,8,30,38
7,8475722,Jason Zucker,L,BUF,32,67,21,16,37
7,8477425,Miles Wood,L,COL,29,78,19,18,37
7,8482667,William Eklund,L,SJS,22,63,12,25,37
7,8478038,Devon Toews,D,COL,30,68,9,28,37
7,8483490,Pavel Mintyukov,D,ANA,21,78,8,29,37
7,8482055,Drew O'Connor,L,PIT,26,68,22,14,36
7,8480064,Josh Norris,C,OTT,25,73,18,18,36
7,8482475,Yegor Chinakhov,R,CBJ,23,62,18,18,36
7,8477497,Sean Monahan,C,CBJ,30,66,14,22,36
7,8476474,Stefan Noesen,R,NJD,31,66,14,22,36
7,8482113,Anton Lundell,C,FLA,23,75,12,24,36
7,8478911,Matt Roy,D,WSH,29,66,8,28,36
7,8476854,Hampus Lindholm,D,BOS,30,71,4,32,36
7,8481703,Valtteri Puustinen,R,PIT,25,60,4,32,36
7,8478046,Danton Heinen,L,VAN,29,67,17,18,35
7,8480009,Eeli Tolvanen,R,SEA,25,72,16,19,35
7,8480797,Joel Farabee,L,PHI,24,65,15,20,35
7,8480835,Jack Drury,C,CAR,24,61,13,22,35
7,8474716,Jared Spurgeon,D,MIN,35,81,10,25,35
7,8480220,Noah Cates,L,PHI,25,64,9,26,35
7,8479325,Charlie McAvoy,D,BOS,27,76,4,31,35
7,8481582,Nicholas Robertson,L,TOR,23,65,17,17,34
7,8482149,Cole Perfetti,C,WPG,22,63,17,17,34
7,8476278,Colin Blackwell,C,DAL,31,77,16,18,34
7,8481560,Arthur Kaliyev,R,LAK,23,80,13,21,34
7,8481577,Philip Tomasino,C,NSH,23,65,11,23,34
7,8476480,Vladislav Namestnikov,C,WPG,32,66,14,19,33
7,8481524,Bowen Byram,D,BUF,23,63,13,20,33
7,8478133,Jake Evans,C,MTL,28,70,12,21,33
7,8481656,Aliaksei Protas,C,WSH,23,66,10,23,33
7,8476462,Dougie Hamilton,D,NJD,31,70,9,24,33
7,8480336,Sean Walker,D,CAR,30,70,9,24,33
7,8482660,Kent Johnson,C,CBJ,22,57,7,26,33
7,8480145,Neal Pionk,D,WPG,29,73,4,29,33
7,8482089,Jake Neighbours,L,STL,22,67,22,10,32
7,8470621,Corey Perry,R,EDM,39,70,21,11,32
7,8480068,Ryan Poehling,C,PHI,25,73,16,16,32
7,8482092,Ridly Greig,C,OTT,22,80,15,17,32
7,8474149,Evgenii Dadonov,R,DAL,35,78,15,17,32
7,8475848,Brendan Gallagher,R,MTL,32,71,15,17,32
7,8480829,Jesperi Kotkaniemi,C,CAR,24,65,14,18,32
7,8477505,Alexander Wennberg,C,SJS,30,68,12,20,32
7,8475200,Dmitry Orlov,D,CAR,33,77,9,23,32
7,8476463,Jonas Brodin,D,MIN,31,75,8,24,32
7,8480873,Rasmus Sandin,D,WSH,24,68,6,26,32
7,8477948,Travis Sanheim,D,PHI,28,61,5,27,32
7,8482079,Marco Rossi,C,MIN,23,56,17,14,31
7,8478891,Mason Appleton,C,WPG,28,63,16,15,31
7,8480113,Alex Iafallo,L,WPG,31,67,15,16,31
7,8475343,Nic Dowd,C,WSH,34,60,15,16,31
7,8483505,Matthew Poitras,C,BOS,20,72,14,17,31
7,8481186,Logan O'Connor,R,COL,28,80,14,17,31
7,8481554,Kaapo Kakko,R,NYR,23,69,14,17,31
7,8479591,Michael Eyssimont,C,TBL,28,80,12,19,31
7,8476923,Damon Severson,D,CBJ,30,80,7,24,31
7,8482712,Oskar Olausson,R,COL,22,75,7,24,31
7,8473507,Jeff Petry,D,DET,37,76,5,26,31
7,8479351,Sam Steel,C,DAL,26,79,15,15,30
7,8480893,Kirill Marchenko,R,CBJ,24,57,15,15,30
7,8480813,Joe Veleno,C,DET,24,77,11,19,30
7,8482111,Justin Barron,D,MTL,23,70,10,20,30
7,8476419,Jean-Gabriel Pageau,C,NYI,32,78,9,21,30
7,8475149,Marcus Johansson,L,MIN,34,59,9,21,30
7,8476292,Ondrej Palat,L,NJD,33,68,8,22,30
7,8475790,Erik Gudbranson,D,CBJ,32,77,6,24,30
7,8482074,Connor Zary,C,CGY,23,65,21,8,29
7,8483468,Jiri Kulich,C,BUF,20,57,14,15,29
7,8474715,Cameron Atkinson,R,TBL,35,81,12,17,29
7,8482671,Owen Power,D,BUF,22,69,10,19,29
7,8480855,Jack McBain,C,UTA,24,67,9,20,29
7,8477488,Brett Pesce,D,NJD,30,73,3,26,29
7,8477969,Marcus Pettersson,D,PIT,28,79,2,27,29
7,8481553,Bobby Brink,R,PHI,23,61,17,11,28
7,8477450,Jason Dickinson,C,CHI,29,59,14,14,28
7,8473563,Nicklas Backstrom,C,WSH,37,51,12,16,28
7,8476525,Colin Miller,D,WPG,32,63,12,16,28
7,8475791,Taylor Hall,L,CHI,33,55,12,16,28
7,8477498,Darnell Nurse,D,EDM,29,76,8,20,28
7,8477015,Connor Brown,R,EDM,30,65,7,21,28
7,8475171,Oliver Ekman-Larsson,D,TOR,33,71,7,21,28
7,8479315,Joey Anderson,R,CHI,26,55,7,21,28
7,8476902,Esa Lindell,D,DAL,30,71,4,24,28
7,8477435,Ryan Graves,D,PIT,29,73,4,24,28
7,8476312,Josh Manson,D,COL,33,68,4,24,28
7,8477506,Ryan Pulock,D,NYI,30,78,3,25,28
7,8476979,Erik Gustafsson,D,DET,32,81,1,27,28
7,8479339,Patrik Laine,L,CBJ,26,57,13,14,27
7,8475855,Jesper Fast,R,CAR,33,59,13,14,27
7,8479941,Justin Danforth,R,CBJ,31,52,12,15,27
7,8476918,Jimmy Vesey,L,NYR,31,70,11,16,27
7,8477478,William Carrier,L,CAR,30,60,11,16,27
7,8476927,Teddy Blueger,C,VAN,30,66,9,18,27
7,8479639,Dylan Coghlan,D,WPG,26,60,8,19,27
7,8482067,Connor Mackey,D,NYR,28,63,6,21,27
7,8476869,Brady Skjei,D,NSH,30,70,4,23,27
7,8482122,Brock Faber,D,MIN,22,75,3,24,27
7,8481580,Connor McMichael,C,WSH,23,69,17,9,26
7,8475799,Nino Niederreiter,R,WPG,32,70,16,10,26
7,8479393,Noah Gregor,L,OTT,26,68,12,14,26
7,8481093,Rafael Harvey-Pinard,L,MTL,25,66,7,19,26
7,8477947,Sonny Milano,L,WSH,28,59,6,20,26
7,8480802,Ryan McLeod,C,BUF,25,66,4,22,26
7,8479324,Ryan Lindgren,D,NYR,26,66,3,23,26
7,8481535,Nils Hoglander,L,VAN,24,66,18,7,25
7,8473422,Nick Foligno,L,CHI,37,56,15,10,25
7,8473533,Jordan Staal,C,CAR,36,68,13,12,25
7,8480205,Emil Bemstrom,C,PIT,25,51,13,12,25
7,8481481,Blake Lizotte,C,PIT,27,66,12,13,25
7,8482146,Luke Evangelista,R,NSH,22,69,11,14,25
7,8480003,Jesper Boqvist,C,FLA,26,71,11,14,25
7,8477919,Frederick Gaudreau,C,MIN,31,62,10,15,25
7,8480748,Kiefer Sherwood,L,VAN,29,64,10,15,25
7,8478463,Anthony Beauvillier,L,PIT,27,66,9,16,25
7,8479996,Cody Glass,C,NSH,25,49,9,16,25
7,8483445,Cutter Gauthier,L,ANA,20,57,7,18,25
7,8482073,Braden Schneider,D,NYR,23,63,6,19,25
7,8479371,Dante Fabbro,D,NSH,26,65,5,20,25
7,8476885,Jacob Trouba,D,NYR,30,66,4,21,25
7,8478882,Vladislav Gavrikov,D,LAK,29,72,4,21,25
7,8474151,Ryan McDonagh,D,TBL,35,75,3,22,25
7,8481624,Ilya Mikheyev,R,CHI,30,63,13,11,24
7,8475231,Casey Cizikas,C,NYI,33,73,9,15,24
7,8475220,Marcus Foligno,L,MIN,33,61,9,15,24
7,8477953,Kasperi Kapanen,R,STL,28,62,6,18,24
7,8481546,Cam York,D,PHI,23,67,6,18,24
7,8482192,Isaak Phillips,D,CHI,23,57,4,20,24
7,8478507,John Marino,D,UTA,27,66,3,21,24
7,8482142,Jamie Drysdale,D,PHI,22,68,3,21,24
7,8479402,Jake Bean,D,CGY,26,68,3,21,24
7,8480049,Dylan Samberg,D,WPG,25,69,3,21,24
7,8480073,Erik Brannstrom,D,COL,25,54,2,22,24
7,8480281,Alexey Toropchenko,R,STL,25,64,15,8,23
7,8479661,Tanner Jeannot,L,LAK,27,73,13,10,23
7,8477987,Ryan Donato,C,CHI,28,50,12,11,23
7,8478109,Victor Olofsson,L,VGK,29,71,11,12,23
7,8477989,Christian Dvorak,C,MTL,28,65,11,12,23
7,8480459,Pius Suter,C,VAN,28,62,10,13,23
7,8479390,Taylor Raddysh,R,WSH,26,66,10,13,23
7,8480078,Filip Chytil,C,NYR,25,62,9,14,23
7,8478013,Jake Walman,D,SJS,28,75,9,14,23
7,8476467,Jamie Oleksiak,D,SEA,32,75,8,15,23
7,8482624,Daniil Miromanov,D,CGY,27,55,7,16,23
7,8478970,Jalen Chatfield,D,CAR,28,70,6,17,23
7,8483499,Liam Ohgren,L,MIN,20,53,6,17,23
7,8481014,Alexander Romanov,D,NYI,24,75,4,19,23
7,8476967,Brett Kulak,D,EDM,30,64,4,19,23
7,8481523,Kirby Dach,C,MTL,23,61,3,20,23
7,8476917,Adam Pelech,D,NYI,30,79,2,21,23
7,8479998,Mikey Anderson,D,LAK,25,67,0,23,23
7,8479619,Michael Carcone,L,UTA,28,57,19,3,22
7,8482259,Bobby McMann,C,TOR,28,60,13,9,22
7,8478020,Michael Amadio,R,OTT,28,72,10,12,22
7,8484149,Gavin Brindley,C,CBJ,20,53,10,12,22
7,8476392,Adam Lowry,C,WPG,31,66,9,13,22
7,8477353,Tyler Motte,C,DET,29,74,7,15,22
7,8478452,Caleb Jones,D,LAK,27,54,7,15,22
7,8476457,Adam Larsson,D,SEA,32,67,5,17,22
7,8480878,Nils Lundkvist,D,DAL,24,74,4,18,22
7,8483524,Shane Wright,C,SEA,20,60,4,18,22
7,8476879,Cody Ceci,D,EDM,31,68,3,19,22
7,8479293,Brandon Tanev,L,SEA,33,63,15,6,21
7,8481601,Simon Holmstrom,R,NYI,23,72,12,9,21
7,8482803,Olen Zellweger,D,ANA,21,64,11,10,21
7,8475193,Tomas Tatar,L,NJD,34,61,9,12,21
7,8481441,Joe Snively,C,DET,28,69,9,12,21
7,8474053,Logan Couture,C,SJS,35,62,8,13,21
7,8476981,Josh Anderson,R,MTL,30,68,8,13,21
7,8481716,Dmitri Voronkov,L,CBJ,24,51,8,13,21
7,8483565,Nick Blankenburg,D,NSH,26,60,6,15,21
7,8480246,Nick Perbix,D,TBL,26,69,4,17,21
7,8482655,Janis Moser,D,TBL,24,78,2,19,21
7,8475455,Brenden Dillon,D,NJD,34,64,2,19,21
7,8482157,Will Cuylle,L,NYR,22,67,12,8,20
7,8479316,Luke Kunin,C,SJS,27,55,12,8,20
7,8476469,Joel Armia,R,MTL,31,67,11,9,20
7,8482809,Jackson Blake,R,CAR,21,55,10,10,20
7,8476960,Andreas Athanasiou,C,CHI,30,46,10,10,20
7,8478432,Christian Fischer,R,DET,27,68,10,10,20
7,8480144,David Kampf,C,TOR,29,71,9,11,20
7,8480448,Parker Kelly,L,COL,25,74,8,12,20
7,8481477,Nico Sturm,C,SJS,29,51,8,12,20
7,8479353,Brett Howden,C,VGK,26,63,7,13,20
7,8477979,Nicolas Aube-Kubel,R,BUF,28,60,7,13,20
7,8477839,Conor Sheary,L,TBL,32,82,6,14,20
7,8480789,Oliver Wahlstrom,R,NYI,24,74,6,14,20
7,8483491,Ivan Miroshnichenko,L,WSH,20,58,5,15,20
7,8475233,David Savard,D,MTL,34,62,4,16,20
7,8476429,Scott Mayfield,D,NYI,32,66,1,19,20
7,8476891,Matthew Grzelcyk,D,PIT,30,76,1,19,20
7,8482737,Zack Bolduc,C,STL,21,56,12,7,19
7,8476925,Colton Sissons,C,NSH,31,68,10,9,19
7,8478585,Derek Ryan,C,EDM,38,64,10,9,19
7,8474189,Lars Eller,C,PIT,35,57,9,10,19
7,8481032,Paul Cotter,C,NJD,25,56,9,10,19
7,8481013,Jonatan Berggren,R,DET,24,59,9,10,19
7,8479968,Vinni Lettieri,C,BOS,29,56,9,10,19
7,8476878,Zemgus Girgensons,C,TBL,30,80,8,11,19
7,8477903,Garnet Hathaway,R,PHI,33,68,8,11,19
7,8476422,Mike Reilly,D,NYI,31,75,8,11,19
7,8479066,Ryan Lomberg,L,CGY,30,64,8,11,19
7,8482679,Matt Coronato,R,CGY,22,60,8,11,19
7,8477369,Carson Soucy,D,VAN,30,69,7,12,19
7,8480806,Isac Lundestrom,C,ANA,25,58,6,13,19
7,8482087,Kaiden Guhle,D,MTL,22,63,6,13,19
7,8477070,Liam O'Brien,C,UTA,30,49,6,13,19
7,8479983,Mario Ferraro,D,SJS,26,65,4,15,19
7,8475181,Nick Leddy,D,STL,33,71,3,16,19
7,8478416,Erik Cernak,D,TBL,27,75,2,17,19
7,8476374,Sean Kuraly,C,CBJ,31,55,11,7,18
7,8482105,Jake Sanderson,D,OTT,22,69,7,11,18
7,8482749,Joshua Roy,R,MTL,21,58,7,11,18
7,8481521,Ronnie Attard,D,PHI,25,64,6,12,18
7,8476867,Brendan Gaunce,C,MIN,30,38,6,12,18
7,8480222,Sebastian Aho,D,PIT,28,63,5,13,18
7,8480289,Morgan Barron,C,WPG,26,54,5,13,18
7,8478136,Jake Middleton,D,MIN,28,72,4,14,18
7,8480043,Timothy Liljegren,D,TOR,25,60,3,15,18
7,8476331,Dylan DeMelo,D,WPG,31,70,3,15,18
7,8480172,Jan Rutta,D,SJS,34,64,3,15,18
7,8476892,Colton Parayko,D,STL,31,66,2,16,18
7,8482245,Artem Zub,D,OTT,29,69,2,16,18
7,8479249,Andrew Poturalski,C,SJS,30,35,2,16,18
7,8478840,Will Borgen,D,SEA,28,66,1,17,18
7,8482155,Alex Laferriere,R,LAK,23,64,13,4,17
7,8481517,Brett Leason,R,ANA,25,52,11,6,17
7,8480762,Eric Robinson,L,CAR,29,49,9,8,17
7,8476873,Mark Jankowski,C,NSH,30,50,9,8,17
7,8482062,Cole Smith,L,NSH,29,56,8,9,17
7,8477931,Tomas Nosek,L,FLA,32,53,7,10,17
7,8478043,Sam Lafferty,C,BUF,29,57,7,10,17
7,8477406,Mattias Janmark,C,EDM,32,64,6,11,17
7,8482101,Danil Gushchin,L,SJS,22,58,6,11,17
7,8474574,Tyler Myers,D,VAN,34,59,6,11,17
7,8475324,Nick Jensen,D,OTT,34,66,6,11,17
7,8476988,Matt Benning,D,SJS,30,66,6,11,17
7,8477220,Nate Schmidt,D,FLA,33,63,5,12,17
7,8481522,Peyton Krebs,C,BUF,23,62,5,12,17
7,8479359,Beck Malenstyn,L,BUF,26,48,5,12,17
7,8481537,Nikita Okhotiuk,D,CGY,24,53,4,13,17
7,8476931,Jake McCabe,D,TOR,31,63,3,14,17
7,8480035,Henri Jokiharju,D,BUF,25,58,3,14,17
7,8477845,Trevor van Riemsdyk,D,WSH,33,53,2,15,17
7,8476874,Olli Maatta,D,DET,30,56,2,15,17
7,8481059,Scott Perunovich,D,STL,26,63,1,16,17
7,8479398,Samuel Girard,D,COL,26,62,1,16,17
7,8481178,Egor Zamula,D,PHI,24,54,0,17,17
7,8478508,Yakov Trenin,C,MIN,27,59,10,6,16
7,8475842,Sam Carrick,C,NYR,32,59,9,7,16
7,8480021,Jack Studnicka,C,LAK,25,64,8,8,16
7,8482451,Mikael Pyyhtia,L,CBJ,23,39,8,8,16
7,8482807,Ethan Del Mastro,D,CHI,21,54,8,8,16
7,8479336,Carl Grundstrom,R,SJS,27,46,7,9,16
7,8482117,Lukas Reichel,L,CHI,22,55,6,10,16
7,8477392,Hudson Fasching,R,NYI,29,67,6,10,16
7,8470600,Ryan Suter,D,STL,39,60,6,10,16
7,8482744,James Malatesta,L,CBJ,21,54,6,10,16
7,8483482,Tristan Luneau,D,ANA,20,63,5,11,16
7,8474567,Zach Bogosian,D,MIN,34,62,4,12,16
7,8479980,Nicolas Hague,D,VGK,26,54,3,13,16
7,8475179,Dmitry Kulikov,D,FLA,34,55,3,13,16
7,8480196,Jacob Bryson,D,BUF,27,52,2,14,16
7,8480891,Michael Kesselring,D,UTA,24,55,0,16,16
7,8475225,Craig Smith,C,CHI,35,56,11,4,15
7,8478424,Jansen Harkins,C,ANA,27,46,11,4,15
7,8480074,Alexandre Texier,C,STL,25,56,10,5,15
7,8479718,Alex Barré-Boulet,C,MTL,27,52,9,6,15
7,8476329,Travis Boyd,C,MIN,31,55,8,7,15
7,8476921,Jordan Martinook,L,CAR,32,59,8,7,15
7,8480796,Martin Fehervary,D,WSH,25,56,7,8,15
7,8479671,Mathieu Olivier,R,CBJ,27,50,7,8,15
7,8479520,Brandon Duhaime,R,WSH,27,53,7,8,15
7,8477508,Curtis Lazar,C,NJD,29,59,6,9,15
7,8481028,Martin Pospisil,C,CGY,25,56,6,9,15
7,8480995,Pontus Holmberg,R,TOR,25,53,6,9,15
7,8480011,Klim Kostin,C,SJS,25,54,5,10,15
7,8476934,Brock McGinn,L,ANA,30,58,5,10,15
7,8479370,Tyson Jost,C,CAR,26,59,5,10,15
7,8478443,Brandon Carlo,D,BOS,28,60,5,10,15
7,8475279,Ben Chiarot,D,DET,33,64,4,11,15
7,8481568,Alex Vlasic,D,CHI,23,47,3,12,15
7,8479976,Juuso Valimaki,D,UTA,26,62,2,13,15
7,8480070,Ian Mitchell,D,BOS,25,54,1,14,15
7,8475462,Radko Gudas,D,ANA,34,66,0,15,15
7,8480848,Ty Dellandrea,C,SJS,24,49,11,3,14
7,8481704,Juuso Parssinen,C,NSH,23,56,9,5,14
7,8480980,Connor Dewar,C,TOR,25,70,7,7,14
7,8478211,Dryden Hunt,L,CGY,29,53,7,7,14
7,8482659,Josh Doan,R,UTA,22,52,7,7,14
7,8481617,Vasily Podkolzin,R,VAN,23,41,7,7,14
7,8477507,Nikita Zadorov,D,BOS,29,62,6,8,14
7,8481161,Jake Christiansen,D,CBJ,25,60,6,8,14
7,8482859,Zack Ostapchuk,C,OTT,21,57,6,8,14
7,8482148,Hendrix Lapierre,C,WSH,22,53,5,9,14
7,8481606,Jordan Spence,D,LAK,23,63,4,10,14
7,8481527,Kaedan Korczak,D,VGK,23,52,3,11,14
7,8480727,Zach Whitecloud,D,VGK,28,54,2,12,14
7,8478831,Kevin Stenlund,C,UTA,28,55,9,4,13
7,8479543,Michael Pezzetta,L,MTL,26,50,6,7,13
7,8479772,Zack MacEwen,R,OTT,28,55,6,7,13
7,8477446,Michael McCarron,R,NSH,29,57,5,8,13
7,8482634,Alex Steeves,C,TOR,25,46,5,8,13
7,8476889,Radek Faksa,C,STL,30,59,4,9,13
7,8476822,Luke Glendening,C,TBL,35,78,4,9,13
7,8475208,Brian Dumoulin,D,ANA,33,61,4,9,13
7,8481019,David Gustafsson,C,WPG,24,44,3,10,13
7,8482176,Wyatt Kaiser,D,CHI,22,57,3,10,13
7,8478399,Jonas Siegenthaler,D,NJD,27,62,2,11,13
7,8480860,Kevin Bahl,D,CGY,24,56,2,11,13
7,8474673,TJ Brodie,D,CHI,34,62,2,11,13
7,8478017,Mark Friedman,D,VAN,29,39,2,11,13
7,8480807,Mattias Samuelsson,D,BUF,24,59,1,12,13
7,8481599,Victor Soderstrom,D,UTA,23,47,1,12,13
7,8477380,Jonny Brodzinski,C,NYR,31,59,8,4,12
7,8479414,Nathan Bastian,R,NJD,27,57,7,5,12
7,8479328,Julien Gauthier,R,NYI,27,50,7,5,12
7,8476858,Phillip Di Giuseppe,L,VAN,31,41,6,6,12
7,8482784,Zach Dean,C,STL,21,46,6,6,12
7,8482964,Arber Xhekaj,D,MTL,23,40,6,6,12
7,8476994,Vinnie Hinostroza,C,NSH,30,54,5,7,12
7,8481550,Adam Beckman,L,NJD,23,40,5,7,12
7,8481641,Joel Kiviranta,L,COL,28,74,4,8,12
7,8479344,Jesse Puljujarvi,R,PIT,26,53,4,8,12
7,8478178,Darren Raddysh,D,TBL,28,74,3,9,12
7,8477962,Brendan Lemieux,L,CAR,28,39,3,9,12
7,8479348,Kale Clague,D,BUF,26,36,3,9,12
7,8478434,Keegan Kolesar,R,VGK,27,62,2,10,12
7,8476856,Mathew Dumba,D,DAL,30,70,2,10,12
7,8480001,Urho Vaakanainen,D,ANA,25,53,2,10,12
7,8481708,Zac Jones,D,NYR,24,48,2,10,12
7,8482095,Tyler Kleven,D,OTT,22,45,2,10,12
7,8478851,Alexandre Carrier,D,NSH,28,62,1,11,12
7,8473446,Erik Johnson,D,PHI,36,44,1,11,12
7,8476442,Matt Nieto,L,PIT,32,44,6,5,11
7,8477573,Nathan Walker,L,STL,30,45,6,5,11
7,8479982,Conor Timmins,D,TOR,26,57,5,6,11
7,8479368,Max Jones,L,BOS,26,65,5,6,11
7,8480025,MacKenzie Entwistle,R,FLA,25,60,5,6,11
7,8480355,Mark Kastelic,C,BOS,25,55,5,6,11
7,8478421,A.J. Greer,L,FLA,28,61,5,6,11
7,8482166,Shakir Mukhamadullin,D,SJS,22,54,5,6,11
7,8482077,Dylan Holloway,L,EDM,23,48,5,6,11
7,8482652,Walker Duehr,R,CGY,27,45,4,7,11
7,8483493,Frank Nazar,C,CHI,20,59,4,7,11
7,8474568,Luke Schenn,D,NSH,35,55,4,7,11
7,8475762,Derek Forbort,D,VAN,32,43,4,7,11
7,8479026,Philippe Myers,D,TOR,27,51,3,8,11
7,8481147,Reese Johnson,C,MIN,26,33,3,8,11
7,8477335,Kyle Burroughs,D,LAK,29,40,3,8,11
7,8482730,Brandt Clarke,D,LAK,21,58,2,9,11
7,8480192,Johnathan Kovacevic,D,NJD,27,49,2,9,11
7,8475718,Justin Holl,D,DET,32,57,2,9,11
7,8477365,Connor Clifton,D,BUF,29,55,2,9,11
7,8483466,Kevin Korchinski,D,CHI,20,49,2,9,11
7,8479291,Kevin Rooney,C,CGY,31,51,1,10,11
7,8471709,Marc-Edouard Vlasic,D,SJS,37,62,1,10,11
7,8480887,Jordan Harris,D,MTL,24,53,1,10,11
7,8479944,Zach Aston-Reese,C,VGK,30,48,8,2,10
7,8482762,Simon Edvinsson,D,DET,21,59,6,4,10
7,8474034,Patrick Maroon,L,CHI,36,48,5,5,10
7,8478859,Niko Mikkola,D,FLA,28,61,5,5,10
7,8481751,Lukas Rousek,R,BUF,25,42,5,5,10
7,8483457,Lane Hutson,D,MTL,20,65,4,6,10
7,8480950,Ilya Lyubushkin,D,DAL,30,60,3,7,10
7,8479369,Andrew Peeke,D,BOS,26,58,3,7,10
7,8474166,Alec Martinez,D,CHI,37,47,3,7,10
7,8476952,Dominic Toninato,C,WPG,30,39,2,8,10
7,8480058,Pierre-Olivier Joseph,D,STL,25,58,1,9,10
7,8478451,Ethan Bear,D,WSH,27,55,1,9,10
7,8475188,Brayden McNabb,D,VGK,33,60,1,9,10
7,8474013,Ian Cole,D,UTA,35,60,1,9,10
7,8475690,Chris Tanev,D,TOR,35,60,0,10,10
7,8478569,Noel Acciari,C,PIT,33,61,6,3,9
7,8481592,Jakob Pelletier,L,CGY,23,43,6,3,9
7,8476624,Barclay Goodrow,C,SJS,31,56,5,4,9
7,8481567,Henry Thrun,D,SJS,23,54,5,4,9
7,8479536,Axel Jonsson-Fjallby,L,WPG,26,38,5,4,9
7,8477018,Ben Hutton,D,VGK,31,38,5,4,9
7,8483619,Filip Roos,D,OTT,25,32,5,4,9
7,8471817,Ryan Reaves,R,TOR,37,57,5,4,9
7,8483570,Ben Meyers,C,SEA,26,32,5,4,9
7,8482666,Scott Morrow,D,CAR,22,46,4,5,9
7,8480252,Cole Guttman,C,CHI,25,41,4,5,9
7,8479981,Jonah Gadjovich,L,FLA,26,44,4,5,9
7,8478468,Jeremy Lauzon,D,NSH,27,54,3,6,9
7,8479442,Troy Stecher,D,EDM,30,57,3,6,9
7,8481701,Santeri Hatakka,D,NJD,23,38,3,6,9
7,8479439,Jacob MacDonald,D,COL,31,51,2,7,9
7,8479372,Joshua Mahura,D,SEA,26,45,2,7,9
7,8484254,Akito Hirose,D,VAN,25,40,2,7,9
7,8477499,Rasmus Ristolainen,D,PHI,30,60,1,8,9
7,8473453,Trevor Lewis,C,LAK,37,69,6,2,8
7,8481518,Nolan Foote,L,NJD,24,40,5,3,8
7,8482153,Brendan Brisson,C,VGK,23,34,5,3,8
7,8477938,Haydn Fleury,D,WPG,28,39,4,4,8
7,8477401,John Hayden,C,SEA,29,38,3,5,8
7,8481532,Alex Turcotte,C,LAK,23,41,3,5,8
7,8477482,Zachary Sanford,L,CHI,30,37,3,5,8
7,8480292,Carson Meyer,R,ANA,27,38,3,5,8
7,8476372,Nick Seeler,D,PHI,31,36,2,6,8
7,8480157,Calle Rosen,D,COL,30,51,2,6,8
7,8475750,Jon Merrill,D,MIN,32,65,2,6,8
7,8483630,Pavol Regenda,L,ANA,25,26,2,6,8
7,8480845,Rasmus Kupari,C,WPG,24,45,1,7,8
7,8483460,David Jiricek,D,CBJ,21,59,0,8,8
7,8480880,Jakub Lauko,C,MIN,24,35,6,1,7
7,8483495,Simon Nemec,D,NJD,20,48,4,3,7
7,8482747,Brennan Othmann,L,NYR,21,45,4,3,7
7,8480870,Bo Groulx,C,NYR,24,23,4,3,7
7,8481754,Nikita Nesterenko,C,ANA,23,40,4,3,7
7,8482496,Nils Aman,C,VAN,24,34,4,3,7
7,8483549,Lucas Condotta,L,MTL,27,37,3,4,7
7,8480007,Jonas Rondbjerg,R,VGK,25,40,3,4,7
7,8474612,Travis Hamonic,D,OTT,34,54,3,4,7
7,8478146,Matthew Highmore,C,OTT,28,32,3,4,7
7,8479985,Cale Fleury,D,SEA,26,30,3,4,7
7,8482141,Lukas Cormier,D,VGK,22,30,2,5,7
7,8482070,Mitchell Chaffee,R,TBL,26,53,2,5,7
7,8477073,Kurtis MacDermid,L,NJD,30,29,2,5,7
7,8477810,Joel Hanley,D,CGY,33,22,2,5,7
7,8475177,Calvin de Haan,D,COL,33,47,1,6,7
7,8483397,Marc McLaughlin,C,BOS,25,28,5,1,6
7,8481556,John Beecher,C,BOS,23,32,4,2,6
7,8480990,Declan Chisholm,D,MIN,24,40,3,3,6
7,8481600,Tobias Bjornfot,D,FLA,23,38,2,4,6
7,8481789,Tye Kartye,L,SEA,23,41,2,4,6
7,8484911,Collin Graf,R,SJS,22,35,2,4,6
7,8477527,Ross Johnston,L,ANA,30,36,2,4,6
7,8479994,Jaret Anderson-Dolan,C,WPG,25,34,2,4,6
7,8480267,Sammy Walker,C,MIN,25,24,2,4,6
7,8484258,Sam Malinski,D,COL,26,22,2,4,6
7,8482858,Ryker Evans,D,SEA,23,25,2,4,6
7,8477851,Jordan Oesterle,D,BOS,32,41,1,5,6
7,8482751,Ryan Winterton,C,SEA,21,33,1,5,6
7,8478021,William Lagesson,D,DET,28,23,1,5,6
7,8480879,Jacob Bernard-Docker,D,OTT,24,51,0,6,6
7,8478454,Noah Juulsen,D,VAN,27,38,0,6,6
7,8480441,Trey Fix-Wolansky,R,CBJ,25,38,4,1,5
7,8483012,Logan Morrison,C,SEA,22,33,4,1,5
7,8479379,Givani Smith,R,SJS,26,29,4,1,5
7,8475958,Michael Sgarbossa,C,WSH,32,24,3,2,5
7,8479991,Jake Leschyshyn,C,NYR,25,28,3,2,5
7,8479587,Rhett Gardner,C,PHI,28,21,3,2,5
7,8477034,Jaycob Megna,D,FLA,32,44,2,3,5
7,8477384,Joshua Brown,D,EDM,30,49,2,3,5
7,8479986,Kole Lind,R,DAL,26,57,2,3,5
7,8480890,Jan Jenik,C,OTT,24,29,2,3,5
7,8482470,Ilya Solovyov,D,CGY,24,20,2,3,5
7,8481122,Simon Benoit,D,TOR,26,41,1,4,5
7,8476441,Joel Edmundson,D,LAK,31,38,1,4,5
7,8479378,Logan Stanley,D,WPG,26,45,1,4,5
7,8483763,Maksymilian Szuber,D,UTA,22,30,1,4,5
7,8479320,Maxime Lajoie,D,SEA,27,28,1,4,5
7,8481585,Egor Afanasyev,L,SJS,23,16,1,4,5
7,8479972,Mason Shaw,C,WPG,26,37,0,5,5
7,8482511,Mason Lohrei,D,BOS,23,40,0,5,5
7,8481056,Spencer Stastney,D,NSH,24,30,0,5,5
7,8479638,Justin Brazeau,R,BOS,26,36,4,0,4
7,8482713,Mackie Samoskevich,R,FLA,22,44,3,1,4
7,8480245,Olle Lycksell,R,PHI,25,33,3,1,4
7,8477887,Patrick Brown,C,BOS,32,44,2,2,4
7,8478409,Anthony Richard,C,PHI,28,34,2,2,4
7,8482765,Isak Rosen,R,BUF,21,25,2,2,4
7,8478477,Mitchell Stephens,C,SEA,27,18,2,2,4
7,8479330,Brandon Gignac,C,MTL,27,11,2,2,4
7,8476913,Devin Shore,C,MIN,30,32,1,3,4
7,8481541,Samuel Bolduc,D,NYI,24,27,1,3,4
7,8475795,Dylan McIlrath,D,WSH,32,19,1,3,4
7,8482144,Jack Thompson,D,SJS,22,26,1,3,4
7,8482172,Landon Slaggert,L,CHI,22,22,1,3,4
7,8481030,Jack St. Ivany,D,PIT,25,23,1,3,4
7,8481605,Jackson LaCombe,D,ANA,23,31,1,3,4
7,8483512,Matthew Savoie,C,EDM,20,23,1,3,4
7,8481699,Aku Raty,R,UTA,23,17,1,3,4
7,8481598,Philip Broberg,D,EDM,23,32,0,4,4
7,8481167,Brayden Pachal,D,CGY,25,46,0,4,4
7,8474090,Brendan Smith,D,DAL,35,53,0,4,4
7,8478881,Brett Seney,L,CHI,28,14,3,0,3
7,8482460,Matt Rempe,C,NYR,22,7,2,1,3
7,8483471,Brad Lambert,C,WPG,31,14,2,1,3
7,8480306,Grant Hutton,D,NYI,29,11,2,1,3
7,8471677,Jack Johnson,D,CBJ,37,58,1,2,3
7,8475235,Nicolas Deslauriers,L,PHI,33,50,1,2,3
7,8480834,Ty Emberson,D,SJS,24,26,1,2,3
7,8476473,Connor Murphy,D,CHI,31,37,1,2,3
7,8482147,Jean-Luc Foudy,C,COL,22,25,1,2,3
7,8481237,Kyle MacLean,C,NYI,25,22,1,2,3
7,8479367,William Lockwood,R,FLA,26,21,1,2,3
7,8480851,Akil Thomas,C,LAK,24,22,1,2,3
7,8482516,Matthew Kessel,D,STL,24,20,1,2,3
7,8482165,Yan Kuznetsov,D,CGY,22,21,0,3,3
7,8477467,Gustav Olofsson,D,SEA,30,19,0,3,3
7,8482250,Callahan Burke,C,VGK,27,19,0,3,3
7,8477320,Anton Blidh,L,NYR,29,18,0,3,3
7,8481806,Louis Crevier,D,CHI,23,13,0,3,3
7,8479362,Riley Tufte,L,BOS,26,17,0,3,3
7,8481609,Vladislav Kolyachonok,D,UTA,23,29,0,3,3
7,8481422,Jake Lucchini,C,NSH,29,15,2,0,2
7,8481564,Ryan Johnson,D,BUF,23,11,2,0,2
7,8482118,Sam Colangelo,R,ANA,23,15,2,0,2
7,8477541,Dakota Mermis,D,TOR,30,14,2,0,2
7,8481679,Maxence Guenette,D,OTT,23,30,1,1,2
7,8482145,Mavrik Bourque,C,DAL,22,48,1,1,2
7,8481543,Nikita Alexandrov,C,STL,24,25,1,1,2
7,8481743,Marc Del Gaizo,D,NSH,25,20,1,1,2
7,8482177,Marat Khusnutdinov,C,MIN,22,41,1,1,2
7,8484287,Cole McWard,D,VAN,23,28,1,1,2
7,8484325,Waltteri Merela,C,TBL,26,17,1,1,2
7,8480468,James Hamblin,L,EDM,25,21,1,1,2
7,8478051,Max Willman,C,NJD,29,16,1,1,2
7,8480844,Grigori Denisenko,L,VGK,24,28,1,1,2
7,8480084,Nick DeSimone,D,NJD,30,21,1,1,2
7,8483597,Milos Kelemen,L,UTA,25,16,1,1,2
7,8478874,Adam Gaudette,R,OTT,28,27,0,2,2
7,8477971,Andreas Englund,D,LAK,28,27,0,2,2
7,8478450,Parker Wotherspoon,D,BOS,27,30,0,2,2
7,8478502,Dennis Gilbert,D,BUF,28,18,0,2,2
7,8477149,Scott Sabourin,R,SJS,32,19,0,2,2
7,8481206,John Ludvig,D,PIT,24,11,0,2,2
7,8480874,Adam Ginning,D,PHI,24,19,0,2,2
7,8481578,Graeme Clarke,R,MIN,23,12,0,2,2
7,8481593,Jayden Struble,D,MTL,23,21,0,2,2
7,8482929,Emil Lilleberg,D,TBL,23,20,0,2,2
7,8482861,Vincent Iorio,D,WSH,22,31,1,0,1
7,8477462,Robert Hagg,D,VGK,29,22,1,0,1
7,8481462,Mason Morelli,L,VGK,28,12,1,0,1
7,8479576,Vincent Desharnais,D,VAN,28,31,1,0,1
7,8481006,Tyler Tucker,D,STL,24,11,1,0,1
7,8481043,Cole Koepke,L,BOS,26,12,1,0,1
7,8483395,Arshdeep Bains,L,VAN,23,10,1,0,1
7,8482061,Brandon Biro,L,SEA,26,7,1,0,1
7,8478011,Louie Belpedio,D,PHI,28,18,1,0,1
7,8483567,Georgii Merkulov,C,BOS,24,15,1,0,1
7,8477473,Justin Bailey,R,SJS,29,25,1,0,1
7,8481719,Maxwell Crozier,D,TBL,24,13,1,0,1
7,8479421,Jacob Moverare,D,LAK,26,4,1,0,1
7,8481726,Adam Edstrom,C,NYR,24,8,1,0,1
7,8483609,Adam Klapka,R,CGY,24,2,1,0,1
7,8483489,Fraser Minten,C,TOR,31,13,0,1,1
7,8482102,Vasily Ponomarev,C,PIT,22,18,0,1,1
7,8482094,Daemon Hunt,D,MIN,22,16,0,1,1
7,8482733,Logan Mailloux,D,MTL,31,42,0,1,1
7,8483398,Declan Carlile,D,TBL,31,8,0,1,1
7,8482201,Gage Goncalves,C,TBL,23,22,0,1,1
7,8481065,Angus Crookshank,L,OTT,25,12,0,1,1
7,8475755,Alexander Petrovic,D,DAL,32,8,0,1,1
7,8483546,Marshall Rifai,D,TOR,26,5,0,1,1
7,8482162,Roby Jarventie,L,EDM,22,13,0,1,1
7,8481024,Linus Karlsson,C,VAN,25,12,0,1,1
7,8484321,Nikolas Matinpalo,D,OTT,26,2,0,1,1
7,8479419,Brett Murray,L,BUF,26,15,0,1,1
7,8482088,Justin Sourdif,R,FLA,22,20,0,1,1
7,8474062,Riley Nash,C,NYR,35,17,0,1,1
7,8482197,Adam Raska,R,MIN,23,6,0,1,1
7,8477244,Chad Ruhwedel,D,NYR,34,39,0,0,0
7,8483407,Brandon Scanlin,D,NYR,25,7,0,0,0
7,8477993,Justin Kirkland,C,CGY,28,2,0,0,0
7,8475780,Chris Wagner,R,COL,33,9,0,0,0
7,8480032,Shane Bowers,C,NJD,25,14,0,0,0
7,8480075,Cameron Crotty,D,MIN,25,6,0,0,0
7,8484304,Uvis Balinskis,D,FLA,28,11,0,0,0
7,8483531,Brian Halonen,L,NJD,25,6,0,0,0
7,8484326,Patrik Koch,D,UTA,28,4,0,0,0
7,8480823,Alexander Alexeyev,D,WSH,25,11,0,0,0
7,8475413,Justin Dowling,C,NJD,34,22,0,0,0
7,8484255,Jason Polin,R,COL,25,3,0,0,0
7,8483920,Pierrick Dube,R,WSH,23,4,0,0,0
7,8482476,Emil Heineman,L,MTL,23,4,0,0,0
7,8482787,Nikita Chibrikov,R,WPG,31,5,0,0,0
7,8482126,Emil Andrae,D,PHI,31,1,0,0,0
7,8478446,Glenn Gawdin,C,LAK,27,9,0,0,0
7,8479522,Hardy Haman Aktell,D,WSH,26,2,0,0,0
7,8476323,Max McCormick,L,SEA,32,3,0,0,0
7,8481655,Cole Schwindt,R,CGY,23,7,0,0,0
7,8483432,Luca Del Bel Belluz,C,CBJ,31,8,0,0,0
7,8484259,Ondrej Pavel,C,COL,31,1,0,0,0
7,8470794,Joe Pavelski,C,,40,0,0,0,0
7,8479321,Lucas Johansen,D,,27,0,0,0,0
7,8477950,Tony DeAngelo,D,,29,0,0,0,0
7,8471218,Blake Wheeler,R,,38,0,0,0,0
7,8475197,Tyson Barrie,D,,33,0,0,0,0
7,8474157,Max Pacioretty,L,,36,0,0,0,0
7,8475744,Evgeny Kuznetsov,C,,32,0,0,0,0
7,8474037,James van Riemsdyk,L,,35,0,0,0,0
7,8476907,Mackenzie MacEachern,L,,30,0,0,0,0
7,8480216,Jacob Peterson,C,,25,0,0,0,0
7,8474602,Justin Schultz,D,,34,0,0,0,0
7,8482222,Alexander Barabanov,L,,30,0,0,0,0
7,8474031,Kevin Shattenkirk,D,,35,0,0,0,0
7,8477330,Dominik Kubalik,L,,29,0,0,0,0
7,8480884,Calen Addison,D,,24,0,0,0,0
7,8475906,John Klingberg,D,,32,0,0,0,0
7,8480008,Adam Ruzicka,C,,25,0,0,0,0
7,8476884,Derrick Pouliot,D,,30,0,0,0,0
7,8476919,Chris Tierney,C,,30,0,0,0,0
7,8479415,Michael McLeod,C,,26,0,0,0,0
7,8474870,Tyler Johnson,C,,34,0,0,0,0
7,8470604,Jeff Carter,C,,39,0,0,0,0
7,8478104,Sammy Blais,L,,28,0,0,0,0
7,8474884,Mike Hoffman,C,,35,0,0,0,0
7,8481591,Sam Poulin,R,,23,0,0,0,0
7,8471274,Alex Goligoski,D,,39,0,0,0,0
7,8476871,Tanner Pearson,L,,32,0,0,0,0
7,8476393,Nick Cousins,C,,31,0,0,0,0
7,8479977,Kailer Yamamoto,R,,26,0,0,0,0
7,8479346,Dillon Dube,C,,26,0,0,0,0
7,8480184,Gustav Lindstrom,D,,26,0,0,0,0
7,8479376,Victor Mete,D,,26,0,0,0,0
7,8473449,Kyle Okposo,R,,36,0,0,0,0
7,8481058,Jesse Ylonen,R,,25,0,0,0,0
7,8475752,Tyler Pitlick,C,,33,0,0,0,0
7,8481239,Samuel Fagemo,L,,24,0,0,0,0
7,8480821,Filip Zadina,R,,25,0,0,0,0
7,8470966,Mark Giordano,D,,41,0,0,0,0
7,8478495,Denis Gurianov,R,,27,0,0,0,0
7,8477464,Nic Petan,C,,29,0,0,0,0
7,8478099,Kevin Labanc,R,,29,0,0,0,0
7,8482241,Radim Zohorna,L,,28,0,0,0,0
7,8474040,Sam Gagner,C,,35,0,0,0,0
7,8479514,Rem Pitlick,C,,27,0,0,0,0
7,8478430,Oliver Kylington,D,,27,0,0,0,0
7,8479533,Joona Koppanen,L,,26,0,0,0,0
7,8479984,Cal Foote,D,,26,0,0,0,0
7,8477126,Jayson Megna,C,,34,0,0,0,0
7,8475164,Jakob Silfverberg,R,,34,0,0,0,0
7,8474009,Nick Bonino,C,,36,0,0,0,0
7,8479458,Nikita Zaitsev,D,,33,0,0,0,0
7,8477944,Jakub Vrana,L,,28,0,0,0,0
7,8471699,Andrew Cogliano,C,,37,0,0,0,0
7,8478067,Oskar Lindblom,L,,28,0,0,0,0
7,8471686,Marc Staal,D,,37,0,0,0,0
7,8470610,Zach Parise,L,,40,0,0,0,0
7,8478904,Steven Lorentz,C,,28,0,0,0,0
7,8473473,Milan Lucic,L,,36,0,0,0,0
7,8480031,Maxime Comtois,L,,25,0,0,0,0
7,8478512,Austin Czarnik,C,,32,0,0,0,0
7,8473504,Cal Clutterbuck,R,,37,0,0,0,0
7,8477454,Adam Erne,L,,29,0,0,0,0
7,8479383,Boris Katchouk,L,,26,0,0,0,0
7,8475825,Jani Hakanpää,D,,32,0,0,0,0
7,8477846,Ryan Carpenter,C,,33,0,0,0,0
7,8477930,Pierre-Edouard Bellemare,L,,39,0,0,0,0
7,8478400,Colin White,C,,27,0,0,0,0
7,8480226,Marián Studenic,R,,26,0,0,0,0
7,8480853,Liam Foudy,C,,24,0,0,0,0
7,8475797,Jarred Tinordi,D,,32,0,0,0,0
7,8479423,Alex Nylander,L,,26,0,0,0,0
7,8474618,Marco Scandella,D,,34,0,0,0,0
7,8478028,Fredrik Olofsson,L,,28,0,0,0,0
7,8474709,Matt Martin,L,,35,0,0,0,0
7,8481070,Hugh McGing,L,,26,0,0,0,0
7,8479546,Oskar Steen,C,,26,0,0,0,0
7,8474145,Robert Bortuzzo,D,,35,0,0,0,0
7,8476915,Jujhar Khaira,L,,30,0,0,0,0
7,8480274,Philip Kemp,D,EDM,25,0,0,0,0
7,8475278,Byron Froese,C,,33,0,0,0,0
7,8481812,Nikolai Knyzhov,D,,27,0,0,0,0
7,8478408,Travis Dermott,D,,28,0,0,0,0
7,8481077,John Leonard,L,,26,0,0,0,0
7,8479547,Matthew Phillips,R,,26,0,0,0,0
7,8480836,Jonathan Gruden,C,,24,0,0,0,0
7,8481690,Tyler Angle,C,,24,0,0,0,0
7,8475766,Austin Watson,L,,32,0,0,0,0
7,8478854,Ryan Shea,D,PIT,27,9,0,0,0
7,8481016,Ruslan Iskhakov,C,,24,0,0,0,0
7,8478078,Rourke Chartier,C,,28,0,0,0,0
7,8483401,Marc Johnstone,R,PIT,28,3,0,0,0
7,8480776,Sheldon Rempal,R,,29,0,0,0,0
7,8478956,Samuel Laberge,L,NJD,27,1,0,0,0
7,8483045,Cameron Butler,R,CBJ,31,0,0,0,0
7,8481534,Raphael Lavoie,C,EDM,24,4,0,0,0
7,8478147,Bokondji Imama,L,PIT,28,5,0,0,0
7,8484314,Jiri Smejkal,L,,28,0,0,0,0
8,8478402,Connor McDavid,C,EDM,27,77,48,110,158
8,8477492,Nathan MacKinnon,C,COL,29,81,58,94,152
8,8476453,Nikita Kucherov,R,TBL,31,82,41,101,142
8,8477956,David Pastrnak,R,BOS,28,81,67,62,129
8,8481559,Jack Hughes,C,NJD,23,74,51,77,128
8,8479318,Auston Matthews,C,TOR,27,80,70,54,124
8,8477934,Leon Draisaitl,C,EDM,29,80,41,72,113
8,8479314,Matthew Tkachuk,L,FLA,27,81,39,70,109
8,8478864,Kirill Kaprizov,L,MIN,27,75,59,47,106
8,8477493,Aleksander Barkov,C,FLA,29,81,36,70,106
8,8478550,Artemi Panarin,L,NYR,33,75,40,63,103
8,8478420,Mikko Rantanen,R,COL,28,81,38,64,102
8,8478445,Mathew Barzal,C,NYI,27,80,28,74,102
8,8478483,Mitch Marner,R,TOR,27,79,35,66,101
8,8477939,William Nylander,R,TOR,28,81,39,59,98
8,8476468,J.T. Miller,C,VAN,31,75,38,55,93
8,8478439,Travis Konecny,R,PHI,27,76,39,53,92
8,8480800,Quinn Hughes,D,VAN,25,71,10,82,92
8,8480012,Elias Pettersson,C,VAN,26,69,35,56,91
8,8477404,Jake Guentzel,C,TBL,30,82,31,60,91
8,8482116,Tim Stützle,C,OTT,22,81,33,56,89
8,8480027,Jason Robertson,L,DAL,25,82,22,67,89
8,8480036,Miro Heiskanen,D,DAL,25,80,17,72,89
8,8477942,Kevin Fiala,L,LAK,28,78,35,53,88
8,8478403,Jack Eichel,C,VGK,28,78,41,46,87
8,8474564,Steven Stamkos,C,NSH,34,77,37,50,87
8,8480801,Brady Tkachuk,L,OTT,25,81,38,48,86
8,8480023,Robert Thomas,C,STL,25,76,26,60,86
8,8477933,Sam Reinhart,C,FLA,29,81,38,47,85
8,8478460,Zach Werenski,D,CBJ,27,77,24,61,85
8,8479385,Jordan Kyrou,C,STL,26,75,43,41,84
8,8478010,Brayden Point,C,TBL,28,82,42,42,84
8,8476454,Ryan Nugent-Hopkins,C,EDM,31,77,35,49,84
8,8475692,Mats Zuccarello,R,MIN,37,71,24,60,84
8,8475172,Nazem Kadri,C,CGY,34,80,35,48,83
8,8480208,Drake Batherson,R,OTT,26,79,29,53,82
8,8473419,Brad Marchand,L,BOS,36,81,25,57,82
8,8477501,Valeri Nichushkin,R,COL,29,80,41,40,81
8,8476887,Filip Forsberg,L,NSH,30,75,35,45,80
8,8475168,Matt Duchene,C,DAL,33,82,33,47,80
8,8478444,Brock Boeser,R,VAN,27,74,33,47,80
8,8475167,Victor Hedman,D,TBL,34,79,18,62,80
8,8471675,Sidney Crosby,C,PIT,37,75,42,37,79
8,8479420,Tage Thompson,C,BUF,27,75,36,43,79
8,8479337,Alex DeBrincat,R,DET,27,77,34,45,79
8,8481557,Matt Boldy,L,MIN,23,71,32,47,79
8,8478493,Joel Eriksson Ek,C,MIN,27,73,32,47,79
8,8484144,Connor Bedard,C,CHI,19,71,28,51,79
8,8476389,Vincent Trocheck,C,NYR,31,74,24,55,79
8,8476459,Mika Zibanejad,C,NYR,31,77,30,48,78
8,8478398,Kyle Connor,L,WPG,28,69,40,37,77
8,8477946,Dylan Larkin,C,DET,28,79,35,40,75
8,8477504,Josh Morrissey,D,WPG,29,77,13,62,75
8,8477949,Alex Tuch,R,BUF,28,73,22,52,74
8,8478449,Roope Hintz,C,DAL,28,82,33,40,73
8,8479343,Clayton Keller,R,UTA,26,73,30,42,72
8,8479542,Brandon Hagel,L,TBL,26,80,27,45,72
8,8474600,Roman Josi,D,NSH,34,78,19,53,72
8,8476881,Tomas Hertl,C,VGK,31,79,27,44,71
8,8475166,John Tavares,C,TOR,34,80,25,46,71
8,8479675,Trevor Moore,L,LAK,29,78,34,36,70
8,8475913,Mark Stone,R,VGK,32,75,21,49,70
8,8479323,Adam Fox,D,NYR,26,76,10,60,70
8,8475754,Brock Nelson,C,NYI,33,79,31,38,69
8,8477476,Artturi Lehkonen,L,COL,29,81,31,38,69
8,8477951,Nick Schmaltz,C,UTA,28,76,25,44,69
8,8480002,Nico Hischier,C,NJD,25,77,19,50,69
8,8476448,William Karlsson,C,VGK,31,78,34,34,68
8,8477407,Anthony Duclair,L,NYI,29,75,30,38,68
8,8477494,Jonathan Drouin,L,COL,29,82,15,53,68
8,8477496,Elias Lindholm,C,BOS,30,81,29,38,67
8,8482665,Matty Beniers,C,SEA,22,72,29,38,67
8,8471215,Evgeni Malkin,C,PIT,38,77,24,43,67
8,8474578,Erik Karlsson,D,PIT,34,78,17,50,67
8,8477402,Pavel Buchnevich,L,STL,29,76,33,33,66
8,8477409,Carter Verhaeghe,C,FLA,29,78,30,36,66
8,8471685,Anze Kopitar,C,LAK,37,80,25,41,66
8,8476456,Jonathan Huberdeau,C,CGY,31,80,22,44,66
8,8476346,Johnny Gaudreau,L,CBJ,31,72,19,47,66
8,8480865,Noah Dobson,D,NYI,24,81,5,61,66
8,8478498,Jake DeBrusk,L,VAN,28,74,41,24,65
8,8476399,Blake Coleman,C,CGY,33,79,38,27,65
8,8482093,Seth Jarvis,C,CAR,22,68,36,29,65
8,8477935,Sam Bennett,C,FLA,28,78,35,30,65
8,8478414,Timo Meier,R,NJD,28,74,32,33,65
8,8471724,Kris Letang,D,PIT,37,78,9,56,65
8,8477940,Nikolaj Ehlers,L,WPG,28,71,25,39,64
8,8473512,Claude Giroux,R,OTT,36,80,24,40,64
8,8480069,Cale Makar,D,COL,26,69,13,51,64
8,8478397,Rasmus Andersson,D,CGY,28,74,13,51,64
8,8475786,Zach Hyman,L,EDM,32,79,36,27,63
8,8475158,Ryan O'Reilly,C,NSH,33,75,31,32,63
8,8482740,Wyatt Johnston,C,DAL,21,82,30,33,63
8,8481540,Cole Caufield,R,MTL,23,73,27,36,63
8,8476460,Mark Scheifele,C,WPG,31,74,17,46,63
8,8475784,Jeff Skinner,C,EDM,32,81,26,36,62
8,8482078,Lucas Raymond,L,DET,22,82,22,40,62
8,8481711,Matias Maccelli,L,UTA,24,77,30,31,61
8,8477955,Jared McCann,L,SEA,28,74,24,37,61
8,8475170,Brayden Schenn,C,STL,33,75,21,40,61
8,8480803,Evan Bouchard,D,EDM,25,75,13,48,61
8,8478407,Vince Dunn,D,SEA,28,73,12,49,61
8,8475184,Chris Kreider,L,NYR,33,76,32,28,60
8,8474141,Patrick Kane,R,DET,36,80,26,34,60
8,8480028,Morgan Frost,C,PHI,25,77,26,34,60
8,8477960,Adrian Kempe,R,LAK,28,79,22,38,60
8,8480018,Nick Suzuki,C,MTL,25,75,21,39,60
8,8479999,Casey Mittelstadt,C,COL,26,80,17,43,60
8,8480839,Rasmus Dahlin,D,BUF,24,70,15,45,60
8,8480014,Gabriel Vilardi,C,WPG,25,70,34,25,59
8,8480830,Andrei Svechnikov,R,CAR,24,69,19,40,59
8,8478047,Michael Bunting,L,PIT,29,73,31,27,58
8,8477447,Shea Theodore,D,VGK,29,62,16,42,58
8,8471214,Alex Ovechkin,L,WSH,39,74,31,26,57
8,8475794,Tyler Seguin,C,DAL,32,82,27,30,57
8,8478873,Troy Terry,R,ANA,27,71,26,31,57
8,8475765,Vladimir Tarasenko,R,DET,33,81,18,39,57
8,8476875,Mike Matheson,D,MTL,30,73,18,39,57
8,8482684,Luke Hughes,D,NJD,21,76,11,46,57
8,8475798,Mikael Granlund,C,SJS,32,69,10,47,57
8,8476853,Morgan Rielly,D,TOR,30,75,6,51,57
8,8476880,Tom Wilson,R,WSH,30,68,25,31,56
8,8474679,Gustav Nyquist,C,NSH,35,77,20,36,56
8,8475151,Kyle Palmieri,C,NYI,33,79,32,23,55
8,8478975,Mason Marchment,L,DAL,29,81,27,28,55
8,8478440,Dylan Strome,C,WSH,27,72,25,30,55
8,8481560,Arthur Kaliyev,R,LAK,23,79,25,30,55
8,8478427,Sebastian Aho,C,CAR,27,66,22,33,55
8,8477416,Oliver Bjorkstrand,R,SEA,29,74,22,33,55
8,8480039,Martin Necas,C,CAR,25,72,22,33,55
8,8475810,Bryan Rust,R,PIT,32,75,32,22,54
8,8477500,Bo Horvat,C,NYI,29,79,20,34,54
8,8473994,Jamie Benn,L,DAL,35,81,20,34,54
8,8479325,Charlie McAvoy,D,BOS,27,74,8,46,54
8,8480064,Josh Norris,C,OTT,25,79,31,22,53
8,8476539,Jonathan Marchessault,R,NSH,34,74,30,23,53
8,8479407,Jesper Bratt,L,NJD,26,75,20,33,53
8,8476906,Shayne Gostisbehere,D,CAR,31,74,15,38,53
8,8477495,Seth Jones,D,CHI,30,72,14,39,53
8,8475191,Reilly Smith,R,NYR,33,80,24,28,52
8,8478856,Conor Garland,R,VAN,28,75,22,30,52
8,8476479,Phillip Danault,C,LAK,31,80,20,32,52
8,8477444,Andre Burakovsky,L,SEA,29,68,19,33,52
8,8482699,Dylan Guenther,R,UTA,21,76,18,34,52
8,8476792,Torey Krug,D,STL,33,77,13,39,52
8,8477503,Max Domi,C,TOR,29,78,12,40,52
8,8479410,Mikhail Sergachev,D,UTA,26,69,11,41,52
8,8475745,Charlie Coyle,C,BOS,32,76,22,29,51
8,8474150,Mikael Backlund,C,CGY,35,76,21,30,51
8,8482124,Quinton Byfield,R,LAK,22,79,15,36,51
8,8474565,Alex Pietrangelo,D,VGK,34,63,10,41,51
8,8480849,Barrett Hayton,C,UTA,24,72,24,26,50
8,8475169,Evander Kane,L,EDM,33,75,22,28,50
8,8482097,Jack Quinn,R,BUF,23,65,21,29,50
8,8476872,Scott Laughton,C,PHI,30,73,20,30,50
8,8481068,Yegor Sharangovich,C,CGY,26,76,19,31,50
8,8471698,T.J. Oshie,R,WSH,38,69,23,26,49
8,8475768,Jaden Schwartz,C,SEA,32,70,22,27,49
8,8483431,Logan Cooley,C,UTA,20,72,22,27,49
8,8474586,Jordan Eberle,R,SEA,34,71,17,32,49
8,8477986,Brandon Montour,D,SEA,30,72,16,33,49
8,8478469,Thomas Chabot,D,OTT,27,76,12,37,49
8,8473986,Alex Killorn,L,ANA,35,72,27,21,48
8,8478401,Pavel Zacha,C,BOS,27,78,21,27,48
8,8480188,Fabian Zetterlund,L,SJS,25,71,19,29,48
8,8476905,Chandler Stephenson,C,SEA,30,68,17,31,48
8,8479525,Ross Colton,C,COL,28,82,33,14,47
8,8478519,Anthony Cirelli,C,TBL,27,82,25,22,47
8,8480015,Owen Tippett,R,PHI,25,71,24,23,47
8,8482702,Logan Stankoven,C,DAL,21,81,19,28,47
8,8484166,Adam Fantilli,C,CBJ,20,73,16,31,47
8,8481528,Dylan Cozens,C,BUF,23,72,15,32,47
8,8477021,Alex Kerfoot,C,UTA,30,77,14,33,47
8,8475753,Justin Faulk,D,STL,32,71,13,34,47
8,8477948,Travis Sanheim,D,PHI,28,70,9,38,47
8,8475726,Tyler Toffoli,C,SJS,32,64,26,20,46
8,8477964,Ivan Barbashev,C,VGK,29,80,21,25,46
8,8477456,J.T. Compher,L,DET,29,79,19,27,46
8,8478038,Devon Toews,D,COL,30,67,10,36,46
8,8476419,Jean-Gabriel Pageau,C,NYI,32,78,20,25,45
8,8481618,Alex Newhook,C,MTL,23,75,18,27,45
8,8474563,Drew Doughty,D,LAK,35,72,7,38,45
8,8476438,Brandon Saad,L,STL,32,70,26,18,44
8,8481533,Trevor Zegras,C,ANA,23,72,23,21,44
8,8482745,Mason McTavish,C,ANA,21,65,22,22,44
8,8477998,Warren Foegele,L,LAK,28,79,22,22,44
8,8476882,Teuvo Teravainen,C,CHI,30,67,21,23,44
8,8479400,Pierre-Luc Dubois,L,WSH,26,73,20,24,44
8,8484153,Leo Carlsson,C,ANA,20,74,16,28,44
8,8479987,Morgan Geekie,C,BOS,26,79,16,28,44
8,8478466,Daniel Sprong,R,VAN,27,76,16,28,44
8,8476458,Ryan Strome,C,ANA,31,72,15,29,44
8,8475287,Erik Haula,L,NJD,33,69,15,29,44
8,8482122,Brock Faber,D,MIN,22,78,5,39,44
8,8478474,Lawson Crouse,L,UTA,27,68,26,17,43
8,8482092,Ridly Greig,C,OTT,22,76,23,20,43
8,8482110,Dawson Mercer,C,NJD,23,74,21,22,43
8,8478366,Frank Vatrano,R,ANA,30,72,20,23,43
8,8476869,Brady Skjei,D,NSH,30,71,11,32,43
8,8483490,Pavel Mintyukov,D,ANA,21,74,10,33,43
8,8476432,Boone Jenner,C,CBJ,31,66,22,20,42
8,8476483,Rickard Rakell,R,PIT,31,70,19,23,42
8,8481596,Shane Pinto,C,OTT,24,78,16,26,42
8,8477511,Anthony Mantha,R,CGY,30,72,16,26,42
8,8478042,Viktor Arvidsson,L,EDM,31,75,15,27,42
8,8477497,Sean Monahan,C,CBJ,30,66,14,28,42
8,8479345,Jakob Chychrun,D,WSH,26,67,9,33,42
8,8477346,MacKenzie Weegar,D,CGY,30,73,6,36,42
8,8477425,Miles Wood,L,COL,29,77,22,19,41
8,8474149,Evgenii Dadonov,R,DAL,35,80,19,22,41
8,8475760,Nick Bjugstad,C,UTA,32,69,18,23,41
8,8480434,Sean Durzi,D,UTA,26,65,8,33,41
8,8476958,Jaccob Slavin,D,CAR,30,78,5,36,41
8,8476826,Yanni Gourde,C,SEA,33,71,19,21,40
8,8478233,Andrew Mangiapane,L,WSH,28,70,18,22,40
8,8478055,Gustav Forsling,D,FLA,28,73,16,24,40
8,8480068,Ryan Poehling,C,PHI,25,69,14,26,40
8,8475793,Ryan Johansen,C,PHI,32,75,13,27,40
8,8477953,Kasperi Kapanen,R,STL,28,74,12,28,40
8,8475218,Mattias Ekholm,D,EDM,34,73,10,30,40
8,8481581,Thomas Harley,D,DAL,23,78,10,30,40
8,8470613,Brent Burns,D,CAR,39,77,9,31,40
8,8481546,Cam York,D,PHI,23,75,8,32,40
8,8482109,Alexis Lafrenière,L,NYR,23,70,24,15,39
8,8474641,Adam Henrique,C,EDM,34,75,21,18,39
8,8478109,Victor Olofsson,L,VGK,29,71,21,18,39
8,8480009,Eeli Tolvanen,R,SEA,25,71,18,21,39
8,8480797,Joel Farabee,L,PHI,24,72,18,21,39
8,8482113,Anton Lundell,C,FLA,23,76,16,23,39
8,8478472,Mathieu Joseph,R,STL,27,71,14,25,39
8,8476462,Dougie Hamilton,D,NJD,31,67,12,27,39
8,8481542,Moritz Seider,D,DET,23,76,4,35,39
8,8478115,Pierre Engvall,L,NYI,28,79,21,17,38
8,8478462,Nicolas Roy,C,VGK,27,75,18,20,38
8,8478438,Tommy Novak,C,NSH,27,67,17,21,38
8,8481604,Pavel Dorofeyev,L,VGK,24,76,16,22,38
8,8478458,John (Jack) Roslovic,C,CAR,27,67,11,27,38
8,8479339,Patrik Laine,L,CBJ,26,66,11,27,38
8,8474053,Logan Couture,C,SJS,35,64,10,28,38
8,8478500,Ivan Provorov,D,CBJ,27,81,6,32,38
8,8482175,JJ Peterka,R,BUF,22,63,20,17,37
8,8475722,Jason Zucker,L,BUF,32,72,20,17,37
8,8474102,David Perron,L,OTT,36,79,19,18,37
8,8478046,Danton Heinen,L,VAN,29,73,18,19,37
8,8482159,Tyson Foerster,R,PHI,22,77,17,20,37
8,8480798,Philipp Kurashev,C,CHI,25,62,16,21,37
8,8481554,Kaapo Kakko,R,NYR,23,70,16,21,37
8,8477429,Andrew Copp,C,DET,30,78,13,24,37
8,8477932,Aaron Ekblad,D,FLA,28,72,12,25,37
8,8478396,Noah Hanifin,D,VGK,27,61,10,27,37
8,8478133,Jake Evans,C,MTL,28,75,10,27,37
8,8483445,Cutter Gauthier,L,ANA,20,72,9,28,37
8,8479425,Filip Hronek,D,VAN,27,75,6,31,37
8,8477969,Marcus Pettersson,D,PIT,28,80,4,33,37
8,8475314,Anders Lee,L,NYI,34,75,22,14,36
8,8478413,Jordan Greenway,L,BUF,27,65,18,18,36
8,8482149,Cole Perfetti,C,WPG,22,66,18,18,36
8,8476918,Jimmy Vesey,L,NYR,31,69,17,19,36
8,8476461,Sean Couturier,C,PHI,32,70,16,20,36
8,8478542,Evan Rodrigues,C,FLA,31,74,13,23,36
8,8481577,Philip Tomasino,C,NSH,23,66,8,28,36
8,8482105,Jake Sanderson,D,OTT,22,70,6,30,36
8,8479591,Michael Eyssimont,C,TBL,28,81,20,15,35
8,8478057,Dakota Joshua,C,VAN,28,67,13,22,35
8,8476927,Teddy Blueger,C,VAN,30,66,13,22,35
8,8484145,Zach Benson,L,BUF,19,63,12,23,35
8,8482475,Yegor Chinakhov,R,CBJ,23,67,18,16,34
8,8479992,Michael Rasmussen,C,DET,25,81,16,18,34
8,8483808,Andrei Kuzmenko,L,CGY,28,77,15,19,34
8,8477479,Tyler Bertuzzi,L,CHI,29,63,14,20,34
8,8480185,Eetu Luostarinen,C,FLA,26,74,13,21,34
8,8482660,Kent Johnson,C,CBJ,22,59,13,21,34
8,8476854,Hampus Lindholm,D,BOS,30,74,7,27,34
8,8480145,Neal Pionk,D,WPG,29,72,4,30,34
8,8475763,Kevin Hayes,R,PIT,32,67,15,18,33
8,8477505,Alexander Wennberg,C,SJS,30,59,15,18,33
8,8482712,Oskar Olausson,R,COL,22,75,8,25,33
8,8480871,Adam Boqvist,D,FLA,24,66,7,26,33
8,8474590,John Carlson,D,WSH,34,63,5,28,33
8,8475714,Calle Jarnkrok,C,TOR,33,76,19,13,32
8,8479293,Brandon Tanev,L,SEA,33,62,19,13,32
8,8475799,Nino Niederreiter,R,WPG,32,63,15,17,32
8,8482667,William Eklund,L,SJS,22,70,13,19,32
8,8480829,Jesperi Kotkaniemi,C,CAR,24,66,13,19,32
8,8482133,Thomas Bordeleau,C,SJS,22,63,12,20,32
8,8480220,Noah Cates,L,PHI,25,66,11,21,32
8,8473422,Nick Foligno,L,CHI,37,56,11,21,32
8,8482146,Luke Evangelista,R,NSH,22,68,11,21,32
8,8477498,Darnell Nurse,D,EDM,29,74,8,24,32
8,8480817,K'Andre Miller,D,NYR,24,68,7,25,32
8,8473507,Jeff Petry,D,DET,37,81,6,26,32
8,8476885,Jacob Trouba,D,NYR,30,72,6,26,32
8,8478891,Mason Appleton,C,WPG,28,69,18,13,31
8,8477451,Ryan Hartman,R,MIN,30,71,16,15,31
8,8480113,Alex Iafallo,L,WPG,31,73,15,16,31
8,8474715,Cameron Atkinson,R,TBL,35,81,15,16,31
8,8480336,Sean Walker,D,CAR,30,71,9,22,31
8,8476902,Esa Lindell,D,DAL,30,72,6,25,31
8,8475764,Cam Fowler,D,ANA,33,73,5,26,31
8,8480893,Kirill Marchenko,R,CBJ,24,67,20,10,30
8,8484203,Bradly Nadeau,L,CAR,19,61,19,11,30
8,8476469,Joel Armia,R,MTL,31,64,17,13,30
8,8478463,Anthony Beauvillier,L,PIT,27,59,14,16,30
8,8478020,Michael Amadio,R,OTT,28,71,14,16,30
8,8481093,Rafael Harvey-Pinard,L,MTL,25,62,12,18,30
8,8483505,Matthew Poitras,C,BOS,20,74,11,19,30
8,8477839,Conor Sheary,L,TBL,32,82,9,21,30
8,8478882,Vladislav Gavrikov,D,LAK,29,70,8,22,30
8,8481524,Bowen Byram,D,BUF,23,60,7,23,30
8,8477488,Brett Pesce,D,NJD,30,73,7,23,30
8,8482245,Artem Zub,D,OTT,29,71,5,25,30
8,8481601,Simon Holmstrom,R,NYI,23,70,18,11,29
8,8476278,Colin Blackwell,C,DAL,31,79,16,13,29
8,8474716,Jared Spurgeon,D,MIN,35,77,13,16,29
8,8480802,Ryan McLeod,C,BUF,25,58,13,16,29
8,8483468,Jiri Kulich,C,BUF,20,62,12,17,29
8,8480813,Joe Veleno,C,DET,24,78,11,18,29
8,8483565,Nick Blankenburg,D,NSH,26,68,11,18,29
8,8482749,Joshua Roy,R,MTL,21,69,10,19,29
8,8479996,Cody Glass,C,NSH,25,61,9,20,29
8,8475220,Marcus Foligno,L,MIN,33,60,9,20,29
8,8482720,Matthew Knies,L,TOR,22,76,8,21,29
8,8480873,Rasmus Sandin,D,WSH,24,65,4,25,29
8,8481606,Jordan Spence,D,LAK,23,72,4,25,29
8,8476923,Damon Severson,D,CBJ,30,74,3,26,29
8,8479316,Luke Kunin,C,SJS,27,60,16,12,28
8,8481535,Nils Hoglander,L,VAN,24,58,15,13,28
8,8470621,Corey Perry,R,EDM,39,69,14,14,28
8,8480459,Pius Suter,C,VAN,28,65,14,14,28
8,8481186,Logan O'Connor,R,COL,28,78,11,17,28
8,8475149,Marcus Johansson,L,MIN,34,62,10,18,28
8,8480003,Jesper Boqvist,C,FLA,26,63,10,18,28
8,8479982,Conor Timmins,D,TOR,26,61,9,19,28
8,8482142,Jamie Drysdale,D,PHI,22,60,6,22,28
8,8479398,Samuel Girard,D,COL,26,66,5,23,28
8,8479941,Justin Danforth,R,CBJ,31,60,17,10,27
8,8477987,Ryan Donato,C,CHI,28,58,17,10,27
8,8477426,Nicholas Paul,L,TBL,29,81,14,13,27
8,8479661,Tanner Jeannot,L,LAK,27,79,14,13,27
8,8481704,Juuso Parssinen,C,NSH,23,56,14,13,27
8,8479351,Sam Steel,C,DAL,26,79,13,14,27
8,8477952,Robby Fabbri,C,ANA,28,64,12,15,27
8,8480078,Filip Chytil,C,NYR,25,65,12,15,27
8,8481523,Kirby Dach,C,MTL,23,69,12,15,27
8,8481481,Blake Lizotte,C,PIT,27,60,9,18,27
8,8476392,Adam Lowry,C,WPG,31,61,9,18,27
8,8477506,Ryan Pulock,D,NYI,30,79,7,20,27
8,8477989,Christian Dvorak,C,MTL,28,61,7,20,27
8,8476979,Erik Gustafsson,D,DET,32,72,6,21,27
8,8474673,TJ Brodie,D,CHI,34,67,5,22,27
8,8482259,Bobby McMann,C,TOR,28,63,18,8,26
8,8482089,Jake Neighbours,L,STL,22,59,16,10,26
8,8481582,Nicholas Robertson,L,TOR,23,65,13,13,26
8,8476480,Vladislav Namestnikov,C,WPG,32,66,12,14,26
8,8483515,Juraj Slafkovsky,L,MTL,20,71,11,15,26
8,8477947,Sonny Milano,L,WSH,28,58,11,15,26
8,8482809,Jackson Blake,R,CAR,21,58,11,15,26
8,8477478,William Carrier,L,CAR,30,59,10,16,26
8,8482117,Lukas Reichel,L,CHI,22,61,10,16,26
8,8481580,Connor McMichael,C,WSH,23,65,9,17,26
8,8482737,Zack Bolduc,C,STL,21,60,9,17,26
8,8475200,Dmitry Orlov,D,CAR,33,74,6,20,26
8,8476292,Ondrej Palat,L,NJD,33,64,6,20,26
8,8480878,Nils Lundkvist,D,DAL,24,76,6,20,26
8,8475171,Oliver Ekman-Larsson,D,TOR,33,66,5,21,26
8,8476892,Colton Parayko,D,STL,31,62,5,21,26
8,8482705,Cole Sillinger,C,CBJ,21,66,17,8,25
8,8482125,Alexander Holtz,R,VGK,22,78,14,11,25
8,8475848,Brendan Gallagher,R,MTL,32,71,14,11,25
8,8473533,Jordan Staal,C,CAR,36,63,14,11,25
8,8479390,Taylor Raddysh,R,WSH,26,64,14,11,25
8,8475791,Taylor Hall,L,CHI,33,56,11,14,25
8,8481656,Aliaksei Protas,C,WSH,23,66,10,15,25
8,8477903,Garnet Hathaway,R,PHI,33,69,10,15,25
8,8478434,Keegan Kolesar,R,VGK,27,71,9,16,25
8,8476925,Colton Sissons,C,NSH,31,64,7,18,25
8,8478911,Matt Roy,D,WSH,29,68,6,19,25
8,8482624,Daniil Miromanov,D,CGY,27,66,5,20,25
8,8476422,Mike Reilly,D,NYI,31,74,5,20,25
8,8480891,Michael Kesselring,D,UTA,24,58,3,22,25
8,8477018,Ben Hutton,D,VGK,31,54,3,22,25
8,8482055,Drew O'Connor,L,PIT,26,65,14,10,24
8,8481032,Paul Cotter,C,NJD,25,62,13,11,24
8,8481624,Ilya Mikheyev,R,CHI,30,56,12,12,24
8,8477353,Tyler Motte,C,DET,29,72,11,13,24
8,8480789,Oliver Wahlstrom,R,NYI,24,72,11,13,24
8,8476921,Jordan Martinook,L,CAR,32,64,11,13,24
8,8483524,Shane Wright,C,SEA,20,65,9,15,24
8,8475225,Craig Smith,C,CHI,35,54,6,18,24
8,8478432,Christian Fischer,R,DET,27,74,5,19,24
8,8476891,Matthew Grzelcyk,D,PIT,30,74,4,20,24
8,8479983,Mario Ferraro,D,SJS,26,73,4,20,24
8,8478970,Jalen Chatfield,D,CAR,28,67,3,21,24
8,8476474,Stefan Noesen,R,NJD,31,69,15,8,23
8,8479619,Michael Carcone,L,UTA,28,65,14,9,23
8,8478043,Sam Lafferty,C,BUF,29,67,14,9,23
8,8480835,Jack Drury,C,CAR,24,50,13,10,23
8,8480762,Eric Robinson,L,CAR,29,60,13,10,23
8,8482079,Marco Rossi,C,MIN,23,57,12,11,23
8,8479365,Trent Frederic,C,BOS,26,75,9,14,23
8,8482157,Will Cuylle,L,NYR,22,61,9,14,23
8,8483457,Lane Hutson,D,MTL,20,54,8,15,23
8,8482803,Olen Zellweger,D,ANA,21,64,7,16,23
8,8476329,Travis Boyd,C,MIN,31,55,6,17,23
8,8474189,Lars Eller,C,PIT,35,67,5,18,23
8,8480073,Erik Brannstrom,D,COL,25,65,4,19,23
8,8477220,Nate Schmidt,D,FLA,33,68,4,19,23
8,8476429,Scott Mayfield,D,NYI,32,70,3,20,23
8,8481568,Alex Vlasic,D,CHI,23,49,3,20,23
8,8480049,Dylan Samberg,D,WPG,25,64,2,21,23
8,8475181,Nick Leddy,D,STL,33,74,2,21,23
8,8477446,Michael McCarron,R,NSH,29,53,12,10,22
8,8482101,Danil Gushchin,L,SJS,22,67,11,11,22
8,8476897,Oskar Sundqvist,C,STL,30,65,10,12,22
8,8477450,Jason Dickinson,C,CHI,29,52,9,13,22
8,8482067,Connor Mackey,D,NYR,28,67,9,13,22
8,8480144,David Kampf,C,TOR,29,72,9,13,22
8,8477392,Hudson Fasching,R,NYI,29,64,9,13,22
8,8476889,Radek Faksa,C,STL,30,55,9,13,22
8,8475343,Nic Dowd,C,WSH,34,62,8,14,22
8,8475193,Tomas Tatar,L,NJD,34,66,7,15,22
8,8476856,Mathew Dumba,D,DAL,30,71,7,15,22
8,8483499,Liam Ohgren,L,MIN,20,47,6,16,22
8,8480246,Nick Perbix,D,TBL,26,77,6,16,22
8,8479371,Dante Fabbro,D,NSH,26,62,4,18,22
8,8478507,John Marino,D,UTA,27,63,3,19,22
8,8476467,Jamie Oleksiak,D,SEA,32,70,3,19,22
8,8481014,Alexander Romanov,D,NYI,24,72,3,19,22
8,8476917,Adam Pelech,D,NYI,30,79,3,19,22
8,8478851,Alexandre Carrier,D,NSH,28,70,1,21,22
8,8479976,Juuso Valimaki,D,UTA,26,70,0,22,22
8,8477015,Connor Brown,R,EDM,30,61,13,8,21
8,8480448,Parker Kelly,L,COL,25,75,11,10,21
8,8477508,Curtis Lazar,C,NJD,29,63,9,12,21
8,8476960,Andreas Athanasiou,C,CHI,30,49,8,13,21
8,8477507,Nikita Zadorov,D,BOS,29,70,8,13,21
8,8482111,Justin Barron,D,MTL,23,72,7,14,21
8,8476374,Sean Kuraly,C,CBJ,31,58,7,14,21
8,8483482,Tristan Luneau,D,ANA,20,65,6,15,21
8,8482671,Owen Power,D,BUF,22,65,5,16,21
8,8476931,Jake McCabe,D,TOR,31,63,4,17,21
8,8473563,Nicklas Backstrom,C,WSH,37,51,3,18,21
8,8480043,Timothy Liljegren,D,TOR,25,63,2,19,21
8,8482155,Alex Laferriere,R,LAK,23,66,10,10,20
8,8480855,Jack McBain,C,UTA,24,66,9,11,20
8,8473453,Trevor Lewis,C,LAK,37,75,7,13,20
8,8481703,Valtteri Puustinen,R,PIT,25,54,5,15,20
8,8479369,Andrew Peeke,D,BOS,26,55,5,15,20
8,8482655,Janis Moser,D,TBL,24,77,3,17,20
8,8480172,Jan Rutta,D,SJS,34,64,3,17,20
8,8476331,Dylan DeMelo,D,WPG,31,68,0,20,20
8,8477979,Nicolas Aube-Kubel,R,BUF,28,59,12,7,19
8,8478013,Jake Walman,D,SJS,28,68,11,8,19
8,8476981,Josh Anderson,R,MTL,30,66,11,8,19
8,8480748,Kiefer Sherwood,L,VAN,29,55,10,9,19
8,8477406,Mattias Janmark,C,EDM,32,65,10,9,19
8,8477380,Jonny Brodzinski,C,NYR,31,61,9,10,19
8,8480205,Emil Bemstrom,C,PIT,25,64,8,11,19
8,8476878,Zemgus Girgensons,C,TBL,30,78,8,11,19
8,8480222,Sebastian Aho,D,PIT,28,75,5,14,19
8,8474151,Ryan McDonagh,D,TBL,35,78,4,15,19
8,8476457,Adam Larsson,D,SEA,32,64,4,15,19
8,8479980,Nicolas Hague,D,VGK,26,50,4,15,19
8,8479639,Dylan Coghlan,D,WPG,26,64,3,16,19
8,8476463,Jonas Brodin,D,MIN,31,80,2,17,19
8,8482762,Simon Edvinsson,D,DET,21,54,13,5,18
8,8475231,Casey Cizikas,C,NYI,33,65,11,7,18
8,8481553,Bobby Brink,R,PHI,23,58,8,10,18
8,8479353,Brett Howden,C,VGK,26,61,8,10,18
8,8481028,Martin Pospisil,C,CGY,25,57,5,13,18
8,8481527,Kaedan Korczak,D,VGK,23,53,4,14,18
8,8480950,Ilya Lyubushkin,D,DAL,30,63,4,14,18
8,8470600,Ryan Suter,D,STL,39,60,3,15,18
8,8478136,Jake Middleton,D,MIN,28,72,2,16,18
8,8475324,Nick Jensen,D,OTT,34,67,1,17,18
8,8478178,Darren Raddysh,D,TBL,28,66,1,17,18
8,8480281,Alexey Toropchenko,R,STL,25,59,12,5,17
8,8479359,Beck Malenstyn,L,BUF,26,55,10,7,17
8,8477573,Nathan Walker,L,STL,30,53,9,8,17
8,8479439,Jacob MacDonald,D,COL,31,54,9,8,17
8,8475842,Sam Carrick,C,NYR,32,60,8,9,17
8,8480355,Mark Kastelic,C,BOS,25,59,8,9,17
8,8477369,Carson Soucy,D,VAN,30,60,7,10,17
8,8477931,Tomas Nosek,L,FLA,32,65,7,10,17
8,8481019,David Gustafsson,C,WPG,24,51,7,10,17
8,8477919,Frederick Gaudreau,C,MIN,31,55,6,11,17
8,8476873,Mark Jankowski,C,NSH,30,51,6,11,17
8,8479370,Tyson Jost,C,CAR,26,65,6,11,17
8,8482148,Hendrix Lapierre,C,WSH,22,55,6,11,17
8,8481532,Alex Turcotte,C,LAK,23,49,6,11,17
8,8483493,Frank Nazar,C,CHI,20,55,5,12,17
8,8484149,Gavin Brindley,C,CBJ,20,47,3,14,17
8,8475462,Radko Gudas,D,ANA,34,60,3,14,17
8,8478831,Kevin Stenlund,C,UTA,28,55,12,4,16
8,8474034,Patrick Maroon,L,CHI,36,57,9,7,16
8,8478421,A.J. Greer,L,FLA,28,66,8,8,16
8,8482062,Cole Smith,L,NSH,29,52,7,9,16
8,8479344,Jesse Puljujarvi,R,PIT,26,52,7,9,16
8,8482166,Shakir Mukhamadullin,D,SJS,22,55,7,9,16
8,8476624,Barclay Goodrow,C,SJS,31,54,7,9,16
8,8475235,Nicolas Deslauriers,L,PHI,33,50,7,9,16
8,8482077,Dylan Holloway,L,EDM,23,54,6,10,16
8,8482730,Brandt Clarke,D,LAK,21,45,6,10,16
8,8478416,Erik Cernak,D,TBL,27,76,4,12,16
8,8474567,Zach Bogosian,D,MIN,34,65,4,12,16
8,8480074,Alexandre Texier,C,STL,25,57,4,12,16
8,8476312,Josh Manson,D,COL,33,64,3,13,16
8,8481477,Nico Sturm,C,SJS,29,53,3,13,16
8,8481059,Scott Perunovich,D,STL,26,55,3,13,16
8,8482451,Mikael Pyyhtia,L,CBJ,23,39,3,13,16
8,8474013,Ian Cole,D,UTA,35,58,3,13,16
8,8475790,Erik Gudbranson,D,CBJ,32,77,2,14,16
8,8478840,Will Borgen,D,SEA,28,60,2,14,16
8,8477365,Connor Clifton,D,BUF,29,61,1,15,16
8,8477499,Rasmus Ristolainen,D,PHI,30,61,0,16,16
8,8481716,Dmitri Voronkov,L,CBJ,24,45,11,4,15
8,8479393,Noah Gregor,L,OTT,26,76,8,7,15
8,8475855,Jesper Fast,R,CAR,33,58,7,8,15
8,8481013,Jonatan Berggren,R,DET,24,56,7,8,15
8,8479066,Ryan Lomberg,L,CGY,30,70,7,8,15
8,8482074,Connor Zary,C,CGY,23,57,6,9,15
8,8476994,Vinnie Hinostroza,C,NSH,30,50,6,9,15
8,8478451,Ethan Bear,D,WSH,27,50,6,9,15
8,8478585,Derek Ryan,C,EDM,38,68,5,10,15
8,8478508,Yakov Trenin,C,MIN,27,61,5,10,15
8,8479718,Alex Barré-Boulet,C,MTL,27,50,5,10,15
8,8479026,Philippe Myers,D,TOR,27,52,5,10,15
8,8482176,Wyatt Kaiser,D,CHI,22,55,4,11,15
8,8479368,Max Jones,L,BOS,26,61,4,11,15
8,8480796,Martin Fehervary,D,WSH,25,55,2,13,15
8,8479442,Troy Stecher,D,EDM,30,60,2,13,15
8,8477845,Trevor van Riemsdyk,D,WSH,33,56,0,15,15
8,8476822,Luke Glendening,C,TBL,35,77,10,4,14
8,8482679,Matt Coronato,R,CGY,22,67,8,6,14
8,8481441,Joe Snively,C,DET,28,67,6,8,14
8,8480980,Connor Dewar,C,TOR,25,69,6,8,14
8,8480806,Isac Lundestrom,C,ANA,25,63,5,9,14
8,8476988,Matt Benning,D,SJS,30,57,5,9,14
8,8480035,Henri Jokiharju,D,BUF,25,67,5,9,14
8,8475279,Ben Chiarot,D,DET,33,64,5,9,14
8,8475455,Brenden Dillon,D,NJD,34,61,4,10,14
8,8481178,Egor Zamula,D,PHI,24,51,4,10,14
8,8479520,Brandon Duhaime,R,WSH,27,48,4,10,14
8,8480727,Zach Whitecloud,D,VGK,28,44,4,10,14
8,8475179,Dmitry Kulikov,D,FLA,34,61,1,13,14
8,8478399,Jonas Siegenthaler,D,NJD,27,61,1,13,14
8,8476525,Colin Miller,D,WPG,32,63,0,14,14
8,8471817,Ryan Reaves,R,TOR,37,60,8,5,13
8,8480995,Pontus Holmberg,R,TOR,25,57,7,6,13
8,8481617,Vasily Podkolzin,R,VAN,23,54,7,6,13
8,8481641,Joel Kiviranta,L,COL,28,72,6,7,13
8,8477401,John Hayden,C,SEA,29,38,6,7,13
8,8481522,Peyton Krebs,C,BUF,23,50,5,8,13
8,8480025,MacKenzie Entwistle,R,FLA,25,57,5,8,13
8,8481567,Henry Thrun,D,SJS,23,56,4,9,13
8,8482634,Alex Steeves,C,TOR,25,42,3,10,13
8,8480887,Jordan Harris,D,MTL,24,58,3,10,13
8,8475718,Justin Holl,D,DET,32,61,2,11,13
8,8479372,Joshua Mahura,D,SEA,26,54,2,11,13
8,8480879,Jacob Bernard-Docker,D,OTT,24,48,2,11,13
8,8481537,Nikita Okhotiuk,D,CGY,24,59,7,5,12
8,8479671,Mathieu Olivier,R,CBJ,27,44,7,5,12
8,8476934,Brock McGinn,L,ANA,30,48,6,6,12
8,8477070,Liam O'Brien,C,UTA,30,56,5,7,12
8,8483491,Ivan Miroshnichenko,L,WSH,20,54,4,8,12
8,8480252,Cole Guttman,C,CHI,25,42,4,8,12
8,8479348,Kale Clague,D,BUF,26,48,3,9,12
8,8474568,Luke Schenn,D,NSH,35,44,3,9,12
8,8477335,Kyle Burroughs,D,LAK,29,50,3,9,12
8,8479402,Jake Bean,D,CGY,26,67,2,10,12
8,8476967,Brett Kulak,D,EDM,30,68,2,10,12
8,8482087,Kaiden Guhle,D,MTL,22,67,2,10,12
8,8478443,Brandon Carlo,D,BOS,28,57,2,10,12
8,8475690,Chris Tanev,D,TOR,35,54,2,10,12
8,8477435,Ryan Graves,D,PIT,29,75,1,11,12
8,8479324,Ryan Lindgren,D,NYR,26,59,1,11,12
8,8482073,Braden Schneider,D,NYR,23,65,1,11,12
8,8475188,Brayden McNabb,D,VGK,33,61,1,11,12
8,8476879,Cody Ceci,D,EDM,31,61,0,12,12
8,8480070,Ian Mitchell,D,BOS,25,46,0,12,12
8,8480021,Jack Studnicka,C,LAK,25,54,9,2,11
8,8480848,Ty Dellandrea,C,SJS,24,38,8,3,11
8,8479414,Nathan Bastian,R,NJD,27,61,8,3,11
8,8480845,Rasmus Kupari,C,WPG,24,37,7,4,11
8,8482807,Ethan Del Mastro,D,CHI,21,50,5,6,11
8,8479291,Kevin Rooney,C,CGY,31,55,5,6,11
8,8478569,Noel Acciari,C,PIT,33,54,5,6,11
8,8481598,Philip Broberg,D,EDM,23,47,5,6,11
8,8479336,Carl Grundstrom,R,SJS,27,47,4,7,11
8,8480011,Klim Kostin,C,SJS,25,51,4,7,11
8,8482964,Arber Xhekaj,D,MTL,23,40,4,7,11
8,8481550,Adam Beckman,L,NJD,23,32,4,7,11
8,8479536,Axel Jonsson-Fjallby,L,WPG,26,44,3,8,11
8,8475177,Calvin de Haan,D,COL,33,40,3,8,11
8,8471709,Marc-Edouard Vlasic,D,SJS,37,60,2,9,11
8,8478859,Niko Mikkola,D,FLA,28,54,2,9,11
8,8475233,David Savard,D,MTL,34,67,1,10,11
8,8482659,Josh Doan,R,UTA,22,53,1,10,11
8,8480860,Kevin Bahl,D,CGY,24,47,1,10,11
8,8481600,Tobias Bjornfot,D,FLA,23,43,1,10,11
8,8478452,Caleb Jones,D,LAK,27,61,0,11,11
8,8475208,Brian Dumoulin,D,ANA,33,62,0,11,11
8,8480807,Mattias Samuelsson,D,BUF,24,52,0,11,11
8,8481147,Reese Johnson,C,MIN,26,43,5,5,10
8,8476867,Brendan Gaunce,C,MIN,30,31,4,6,10
8,8478211,Dryden Hunt,L,CGY,29,51,4,6,10
8,8479315,Joey Anderson,R,CHI,26,45,3,7,10
8,8479968,Vinni Lettieri,C,BOS,29,48,3,7,10
8,8481517,Brett Leason,R,ANA,25,59,3,7,10
8,8483466,Kevin Korchinski,D,CHI,20,50,3,7,10
8,8479944,Zach Aston-Reese,C,VGK,30,40,3,7,10
8,8480292,Carson Meyer,R,ANA,27,36,3,7,10
8,8482859,Zack Ostapchuk,C,OTT,21,56,2,8,10
8,8475762,Derek Forbort,D,VAN,32,51,2,8,10
8,8482192,Isaak Phillips,D,CHI,23,46,1,9,10
8,8479998,Mikey Anderson,D,LAK,25,56,1,9,10
8,8474574,Tyler Myers,D,VAN,34,66,1,9,10
8,8476372,Nick Seeler,D,PHI,31,41,0,10,10
8,8479772,Zack MacEwen,R,OTT,28,48,6,3,9
8,8482652,Walker Duehr,R,CGY,27,44,6,3,9
8,8479328,Julien Gauthier,R,NYI,27,61,5,4,9
8,8483763,Maksymilian Szuber,D,UTA,22,35,4,5,9
8,8480289,Morgan Barron,C,WPG,26,55,3,6,9
8,8476874,Olli Maatta,D,DET,30,61,3,6,9
8,8479378,Logan Stanley,D,WPG,26,44,3,6,9
8,8471677,Jack Johnson,D,CBJ,37,65,3,6,9
8,8474166,Alec Martinez,D,CHI,37,48,2,7,9
8,8476441,Joel Edmundson,D,LAK,31,41,2,7,9
8,8482516,Matthew Kessel,D,STL,24,25,2,7,9
8,8481521,Ronnie Attard,D,PHI,25,55,1,8,9
8,8480001,Urho Vaakanainen,D,ANA,25,60,1,8,9
8,8484254,Akito Hirose,D,VAN,25,40,1,8,9
8,8479576,Vincent Desharnais,D,VAN,28,34,1,8,9
8,8482095,Tyler Kleven,D,OTT,22,46,0,9,9
8,8474090,Brendan Smith,D,DAL,35,42,0,9,9
8,8481518,Nolan Foote,L,NJD,24,36,7,1,8
8,8479994,Jaret Anderson-Dolan,C,WPG,25,30,6,2,8
8,8477938,Haydn Fleury,D,WPG,28,40,5,3,8
8,8480880,Jakub Lauko,C,MIN,24,39,5,3,8
8,8480441,Trey Fix-Wolansky,R,CBJ,25,38,5,3,8
8,8479638,Justin Brazeau,R,BOS,26,33,5,3,8
8,8477962,Brendan Lemieux,L,CAR,28,38,4,4,8
8,8483619,Filip Roos,D,OTT,25,33,4,4,8
8,8482666,Scott Morrow,D,CAR,22,51,4,4,8
8,8481789,Tye Kartye,L,SEA,23,41,4,4,8
8,8481167,Brayden Pachal,D,CGY,25,39,4,4,8
8,8481708,Zac Jones,D,NYR,24,48,3,5,8
8,8476442,Matt Nieto,L,PIT,32,46,3,5,8
8,8482153,Brendan Brisson,C,VGK,23,31,3,5,8
8,8475750,Jon Merrill,D,MIN,32,58,3,5,8
8,8478454,Noah Juulsen,D,VAN,27,37,3,5,8
8,8482177,Marat Khusnutdinov,C,MIN,22,38,3,5,8
8,8481599,Victor Soderstrom,D,UTA,23,41,2,6,8
8,8481056,Spencer Stastney,D,NSH,24,31,2,6,8
8,8479986,Kole Lind,R,DAL,26,46,1,7,8
8,8478468,Jeremy Lauzon,D,NSH,27,49,0,8,8
8,8476858,Phillip Di Giuseppe,L,VAN,31,41,5,2,7
8,8481701,Santeri Hatakka,D,NJD,23,33,4,3,7
8,8480157,Calle Rosen,D,COL,30,42,4,3,7
8,8480870,Bo Groulx,C,NYR,24,26,4,3,7
8,8483012,Logan Morrison,C,SEA,22,37,4,3,7
8,8481754,Nikita Nesterenko,C,ANA,23,29,3,4,7
8,8482751,Ryan Winterton,C,SEA,21,30,3,4,7
8,8482147,Jean-Luc Foudy,C,COL,22,24,3,4,7
8,8478017,Mark Friedman,D,VAN,29,38,2,5,7
8,8480192,Johnathan Kovacevic,D,NJD,27,57,2,5,7
8,8480058,Pierre-Olivier Joseph,D,STL,25,52,2,5,7
8,8480007,Jonas Rondbjerg,R,VGK,25,43,2,5,7
8,8479985,Cale Fleury,D,SEA,26,37,2,5,7
8,8478450,Parker Wotherspoon,D,BOS,27,35,2,5,7
8,8477462,Robert Hagg,D,VGK,29,21,2,5,7
8,8482784,Zach Dean,C,STL,21,38,1,6,7
8,8483495,Simon Nemec,D,NJD,20,46,1,6,7
8,8474612,Travis Hamonic,D,OTT,34,47,1,6,7
8,8477851,Jordan Oesterle,D,BOS,32,45,1,6,7
8,8482861,Vincent Iorio,D,WSH,22,29,1,6,7
8,8477034,Jaycob Megna,D,FLA,32,39,0,7,7
8,8476473,Connor Murphy,D,CHI,31,43,0,7,7
8,8482070,Mitchell Chaffee,R,TBL,26,51,5,1,6
8,8481751,Lukas Rousek,R,BUF,25,32,4,2,6
8,8481609,Vladislav Kolyachonok,D,UTA,23,30,4,2,6
8,8482744,James Malatesta,L,CBJ,21,47,3,3,6
8,8476952,Dominic Toninato,C,WPG,30,40,3,3,6
8,8480267,Sammy Walker,C,MIN,25,21,3,3,6
8,8480890,Jan Jenik,C,OTT,24,24,3,3,6
8,8480245,Olle Lycksell,R,PHI,25,30,3,3,6
8,8478409,Anthony Richard,C,PHI,28,32,3,3,6
8,8481679,Maxence Guenette,D,OTT,23,32,3,3,6
8,8479543,Michael Pezzetta,L,MTL,26,53,2,4,6
8,8473446,Erik Johnson,D,PHI,36,49,2,4,6
8,8481592,Jakob Pelletier,L,CGY,23,34,2,4,6
8,8481556,John Beecher,C,BOS,23,33,2,4,6
8,8481122,Simon Benoit,D,TOR,26,43,2,4,6
8,8481605,Jackson LaCombe,D,ANA,23,34,2,4,6
8,8480196,Jacob Bryson,D,BUF,27,47,0,6,6
8,8483460,David Jiricek,D,CBJ,21,55,0,6,6
8,8484258,Sam Malinski,D,COL,26,25,0,6,6
8,8483570,Ben Meyers,C,SEA,26,36,4,1,5
8,8477482,Zachary Sanford,L,CHI,30,41,4,1,5
8,8484911,Collin Graf,R,SJS,22,41,4,1,5
8,8478424,Jansen Harkins,C,ANA,27,42,3,2,5
8,8483397,Marc McLaughlin,C,BOS,25,31,3,2,5
8,8482713,Mackie Samoskevich,R,FLA,22,34,3,2,5
8,8478874,Adam Gaudette,R,OTT,28,35,3,2,5
8,8481161,Jake Christiansen,D,CBJ,25,63,2,3,5
8,8482496,Nils Aman,C,VAN,24,42,2,3,5
8,8482141,Lukas Cormier,D,VGK,22,23,2,3,5
8,8479379,Givani Smith,R,SJS,26,27,2,3,5
8,8477887,Patrick Brown,C,BOS,32,45,2,3,5
8,8479249,Andrew Poturalski,C,SJS,30,35,1,4,5
8,8482511,Mason Lohrei,D,BOS,23,36,1,4,5
8,8482765,Isak Rosen,R,BUF,21,32,1,4,5
8,8477810,Joel Hanley,D,CGY,33,31,0,5,5
8,8479419,Brett Murray,L,BUF,26,21,0,5,5
8,8481043,Cole Koepke,L,BOS,26,20,4,0,4
8,8479981,Jonah Gadjovich,L,FLA,26,34,3,1,4
8,8481462,Mason Morelli,L,VGK,28,9,3,1,4
8,8478011,Louie Belpedio,D,PHI,28,15,3,1,4
8,8482747,Brennan Othmann,L,NYR,21,34,2,2,4
8,8482470,Ilya Solovyov,D,CGY,24,21,2,2,4
8,8484304,Uvis Balinskis,D,FLA,28,16,2,2,4
8,8483549,Lucas Condotta,L,MTL,27,36,1,3,4
8,8477384,Joshua Brown,D,EDM,30,32,1,3,4
8,8477320,Anton Blidh,L,NYR,29,23,1,3,4
8,8481422,Jake Lucchini,C,NSH,29,18,1,3,4
8,8477149,Scott Sabourin,R,SJS,32,19,1,3,4
8,8480990,Declan Chisholm,D,MIN,24,33,0,4,4
8,8478021,William Lagesson,D,DET,28,23,0,4,4
8,8479972,Mason Shaw,C,WPG,26,31,0,4,4
8,8480834,Ty Emberson,D,SJS,24,27,0,4,4
8,8483512,Matthew Savoie,C,EDM,20,19,3,0,3
8,8481719,Maxwell Crozier,D,TBL,24,19,3,0,3
8,8483630,Pavol Regenda,L,ANA,25,34,2,1,3
8,8476913,Devin Shore,C,MIN,30,39,2,1,3
8,8482144,Jack Thompson,D,SJS,22,32,2,1,3
8,8481237,Kyle MacLean,C,NYI,25,28,2,1,3
8,8482165,Yan Kuznetsov,D,CGY,22,15,2,1,3
8,8477467,Gustav Olofsson,D,SEA,30,20,1,2,3
8,8484287,Cole McWard,D,VAN,23,20,1,2,3
8,8482733,Logan Mailloux,D,MTL,31,41,1,2,3
8,8482201,Gage Goncalves,C,TBL,23,27,1,2,3
8,8481065,Angus Crookshank,L,OTT,25,16,1,2,3
8,8477527,Ross Johnston,L,ANA,30,28,0,3,3
8,8479991,Jake Leschyshyn,C,NYR,25,31,2,0,2
8,8478477,Mitchell Stephens,C,SEA,27,24,2,0,2
8,8481543,Nikita Alexandrov,C,STL,24,21,2,0,2
8,8480844,Grigori Denisenko,L,VGK,24,22,2,0,2
8,8475780,Chris Wagner,R,COL,33,8,2,0,2
8,8480032,Shane Bowers,C,NJD,25,14,2,0,2
8,8481541,Samuel Bolduc,D,NYI,24,29,1,1,2
8,8481699,Aku Raty,R,UTA,23,16,1,1,2
8,8482250,Callahan Burke,C,VGK,27,17,1,1,2
8,8479362,Riley Tufte,L,BOS,26,21,1,1,2
8,8482145,Mavrik Bourque,C,DAL,22,47,1,1,2
8,8480468,James Hamblin,L,EDM,25,15,1,1,2
8,8478051,Max Willman,C,NJD,29,22,1,1,2
8,8480874,Adam Ginning,D,PHI,24,15,1,1,2
8,8483407,Brandon Scanlin,D,NYR,25,9,1,1,2
8,8475413,Justin Dowling,C,NJD,34,18,1,1,2
8,8478147,Bokondji Imama,L,PIT,28,3,1,1,2
8,8478146,Matthew Highmore,C,OTT,28,25,0,2,2
8,8479587,Rhett Gardner,C,PHI,28,19,0,2,2
8,8479330,Brandon Gignac,C,MTL,27,9,0,2,2
8,8481743,Marc Del Gaizo,D,NSH,25,19,0,2,2
8,8481006,Tyler Tucker,D,STL,24,16,0,2,2
8,8481024,Linus Karlsson,C,VAN,25,15,0,2,2
8,8482088,Justin Sourdif,R,FLA,22,22,0,2,2
8,8477244,Chad Ruhwedel,D,NYR,34,28,0,2,2
8,8478881,Brett Seney,L,CHI,28,11,1,0,1
8,8478502,Dennis Gilbert,D,BUF,28,13,1,0,1
8,8482061,Brandon Biro,L,SEA,26,8,1,0,1
8,8482094,Daemon Hunt,D,MIN,22,20,1,0,1
8,8482162,Roby Jarventie,L,EDM,22,12,1,0,1
8,8482858,Ryker Evans,D,SEA,23,23,0,1,1
8,8479320,Maxime Lajoie,D,SEA,27,19,0,1,1
8,8475795,Dylan McIlrath,D,WSH,32,16,0,1,1
8,8482172,Landon Slaggert,L,CHI,22,28,0,1,1
8,8480306,Grant Hutton,D,NYI,29,8,0,1,1
8,8479367,William Lockwood,R,FLA,26,20,0,1,1
8,8480851,Akil Thomas,C,LAK,24,20,0,1,1
8,8481806,Louis Crevier,D,CHI,23,12,0,1,1
8,8482118,Sam Colangelo,R,ANA,23,11,0,1,1
8,8484325,Waltteri Merela,C,TBL,26,18,0,1,1
8,8480084,Nick DeSimone,D,NJD,30,18,0,1,1
8,8483597,Milos Kelemen,L,UTA,25,13,0,1,1
8,8477971,Andreas Englund,D,LAK,28,19,0,1,1
8,8481593,Jayden Struble,D,MTL,23,20,0,1,1
8,8477473,Justin Bailey,R,SJS,29,21,0,1,1
8,8483489,Fraser Minten,C,TOR,31,6,0,1,1
8,8483398,Declan Carlile,D,TBL,31,7,0,1,1
8,8475755,Alexander Petrovic,D,DAL,32,10,0,1,1
8,8474062,Riley Nash,C,NYR,35,15,0,1,1
8,8480075,Cameron Crotty,D,MIN,25,9,0,1,1
8,8480823,Alexander Alexeyev,D,WSH,25,18,0,1,1
8,8484255,Jason Polin,R,COL,25,6,0,1,1
8,8483920,Pierrick Dube,R,WSH,23,7,0,1,1
8,8478446,Glenn Gawdin,C,LAK,27,9,0,1,1
8,8481655,Cole Schwindt,R,CGY,23,4,0,1,1
8,8483432,Luca Del Bel Belluz,C,CBJ,31,4,0,1,1
8,8483401,Marc Johnstone,R,PIT,28,2,0,1,1
8,8477073,Kurtis MacDermid,L,NJD,30,29,0,0,0
8,8475958,Michael Sgarbossa,C,WSH,32,28,0,0,0
8,8481585,Egor Afanasyev,L,SJS,23,11,0,0,0
8,8481030,Jack St. Ivany,D,PIT,25,12,0,0,0
8,8482460,Matt Rempe,C,NYR,22,12,0,0,0
8,8483471,Brad Lambert,C,WPG,31,11,0,0,0
8,8481564,Ryan Johnson,D,BUF,23,9,0,0,0
8,8477541,Dakota Mermis,D,TOR,30,9,0,0,0
8,8481206,John Ludvig,D,PIT,24,12,0,0,0
8,8481578,Graeme Clarke,R,MIN,23,9,0,0,0
8,8482929,Emil Lilleberg,D,TBL,23,13,0,0,0
8,8483395,Arshdeep Bains,L,VAN,23,5,0,0,0
8,8483567,Georgii Merkulov,C,BOS,24,8,0,0,0
8,8479421,Jacob Moverare,D,LAK,26,6,0,0,0
8,8481726,Adam Edstrom,C,NYR,24,5,0,0,0
8,8483609,Adam Klapka,R,CGY,24,2,0,0,0
8,8482102,Vasily Ponomarev,C,PIT,22,21,0,0,0
8,8483546,Marshall Rifai,D,TOR,26,6,0,0,0
8,8484321,Nikolas Matinpalo,D,OTT,26,2,0,0,0
8,8482197,Adam Raska,R,MIN,23,6,0,0,0
8,8477993,Justin Kirkland,C,CGY,28,3,0,0,0
8,8483531,Brian Halonen,L,NJD,25,2,0,0,0
8,8484326,Patrik Koch,D,UTA,28,3,0,0,0
8,8482476,Emil Heineman,L,MTL,23,5,0,0,0
8,8482787,Nikita Chibrikov,R,WPG,31,3,0,0,0
8,8482126,Emil Andrae,D,PHI,31,0,0,0,0
8,8479522,Hardy Haman Aktell,D,WSH,26,5,0,0,0
8,8476323,Max McCormick,L,SEA,32,4,0,0,0
8,8484259,Ondrej Pavel,C,COL,31,2,0,0,0
8,8470794,Joe Pavelski,C,,40,0,0,0,0
8,8479321,Lucas Johansen,D,,27,0,0,0,0
8,8477950,Tony DeAngelo,D,,29,0,0,0,0
8,8471218,Blake Wheeler,R,,38,0,0,0,0
8,8475197,Tyson Barrie,D,,33,0,0,0,0
8,8474157,Max Pacioretty,L,,36,0,0,0,0
8,8475744,Evgeny Kuznetsov,C,,32,0,0,0,0
8,8474037,James van Riemsdyk,L,,35,0,0,0,0
8,8476907,Mackenzie MacEachern,L,,30,0,0,0,0
8,8480216,Jacob Peterson,C,,25,0,0,0,0
8,8474602,Justin Schultz,D,,34,0,0,0,0
8,8482222,Alexander Barabanov,L,,30,0,0,0,0
8,8474031,Kevin Shattenkirk,D,,35,0,0,0,0
8,8477330,Dominik Kubalik,L,,29,0,0,0,0
8,8480884,Calen Addison,D,,24,0,0,0,0
8,8475906,John Klingberg,D,,32,0,0,0,0
8,8480008,Adam Ruzicka,C,,25,0,0,0,0
8,8476884,Derrick Pouliot,D,,30,0,0,0,0
8,8476919,Chris Tierney,C,,30,0,0,0,0
8,8479415,Michael McLeod,C,,26,0,0,0,0
8,8474870,Tyler Johnson,C,,34,0,0,0,0
8,8470604,Jeff Carter,C,,39,0,0,0,0
8,8478104,Sammy Blais,L,,28,0,0,0,0
8,8474884,Mike Hoffman,C,,35,0,0,0,0
8,8481591,Sam Poulin,R,,23,0,0,0,0
8,8471274,Alex Goligoski,D,,39,0,0,0,0
8,8476871,Tanner Pearson,L,,32,0,0,0,0
8,8476393,Nick Cousins,C,,31,0,0,0,0
8,8479977,Kailer Yamamoto,R,,26,0,0,0,0
8,8479346,Dillon Dube,C,,26,0,0,0,0
8,8480184,Gustav Lindstrom,D,,26,0,0,0,0
8,8479376,Victor Mete,D,,26,0,0,0,0
8,8473449,Kyle Okposo,R,,36,0,0,0,0
8,8481058,Jesse Ylonen,R,,25,0,0,0,0
8,8475752,Tyler Pitlick,C,,33,0,0,0,0
8,8481239,Samuel Fagemo,L,,24,0,0,0,0
8,8480821,Filip Zadina,R,,25,0,0,0,0
8,8470966,Mark Giordano,D,,41,0,0,0,0
8,8478495,Denis Gurianov,R,,27,0,0,0,0
8,8477464,Nic Petan,C,,29,0,0,0,0
8,8478099,Kevin Labanc,R,,29,0,0,0,0
8,8482241,Radim Zohorna,L,,28,0,0,0,0
8,8474040,Sam Gagner,C,,35,0,0,0,0
8,8479514,Rem Pitlick,C,,27,0,0,0,0
8,8478430,Oliver Kylington,D,,27,0,0,0,0
8,8479533,Joona Koppanen,L,,26,0,0,0,0
8,8479984,Cal Foote,D,,26,0,0,0,0
8,8477126,Jayson Megna,C,,34,0,0,0,0
8,8475164,Jakob Silfverberg,R,,34,0,0,0,0
8,8474009,Nick Bonino,C,,36,0,0,0,0
8,8479458,Nikita Zaitsev,D,,33,0,0,0,0
8,8477944,Jakub Vrana,L,,28,0,0,0,0
8,8471699,Andrew Cogliano,C,,37,0,0,0,0
8,8478067,Oskar Lindblom,L,,28,0,0,0,0
8,8471686,Marc Staal,D,,37,0,0,0,0
8,8470610,Zach Parise,L,,40,0,0,0,0
8,8478904,Steven Lorentz,C,,28,0,0,0,0
8,8473473,Milan Lucic,L,,36,0,0,0,0
8,8480031,Maxime Comtois,L,,25,0,0,0,0
8,8478512,Austin Czarnik,C,,32,0,0,0,0
8,8473504,Cal Clutterbuck,R,,37,0,0,0,0
8,8477454,Adam Erne,L,,29,0,0,0,0
8,8479383,Boris Katchouk,L,,26,0,0,0,0
8,8475825,Jani Hakanpää,D,,32,0,0,0,0
8,8477846,Ryan Carpenter,C,,33,0,0,0,0
8,8477930,Pierre-Edouard Bellemare,L,,39,0,0,0,0
8,8478400,Colin White,C,,27,0,0,0,0
8,8480226,Marián Studenic,R,,26,0,0,0,0
8,8480853,Liam Foudy,C,,24,0,0,0,0
8,8475797,Jarred Tinordi,D,,32,0,0,0,0
8,8479423,Alex Nylander,L,,26,0,0,0,0
8,8474618,Marco Scandella,D,,34,0,0,0,0
8,8478028,Fredrik Olofsson,L,,28,0,0,0,0
8,8474709,Matt Martin,L,,35,0,0,0,0
8,8481070,Hugh McGing,L,,26,0,0,0,0
8,8479546,Oskar Steen,C,,26,0,0,0,0
8,8474145,Robert Bortuzzo,D,,35,0,0,0,0
8,8476915,Jujhar Khaira,L,,30,0,0,0,0
8,8480274,Philip Kemp,D,EDM,25,2,0,0,0
8,8475278,Byron Froese,C,,33,0,0,0,0
8,8481812,Nikolai Knyzhov,D,,27,0,0,0,0
8,8478408,Travis Dermott,D,,28,0,0,0,0
8,8481077,John Leonard,L,,26,0,0,0,0
8,8479547,Matthew Phillips,R,,26,0,0,0,0
8,8480836,Jonathan Gruden,C,,24,0,0,0,0
8,8481690,Tyler Angle,C,,24,0,0,0,0
8,8475766,Austin Watson,L,,32,0,0,0,0
8,8478854,Ryan Shea,D,PIT,27,8,0,0,0
8,8481016,Ruslan Iskhakov,C,,24,0,0,0,0
8,8478078,Rourke Chartier,C,,28,0,0,0,0
8,8480776,Sheldon Rempal,R,,29,0,0,0,0
8,8478956,Samuel Laberge,L,NJD,27,3,0,0,0
8,8483045,Cameron Butler,R,CBJ,31,0,0,0,0
8,8481534,Raphael Lavoie,C,EDM,24,2,0,0,0
8,8484314,Jiri Smejkal,L,,28,0,0,0,0
9,8478402,Connor McDavid,C,EDM,27,77,48,88,136
9,8479318,Auston Matthews,C,TOR,27,80,73,59,132
9,8479314,Matthew Tkachuk,L,FLA,27,78,37,94,131
9,8478420,Mikko Rantanen,R,COL,28,82,46,81,127
9,8481559,Jack Hughes,C,NJD,23,76,56,69,125
9,8476453,Nikita Kucherov,R,TBL,31,82,44,75,119
9,8477492,Nathan MacKinnon,C,COL,29,81,47,70,117
9,8478864,Kirill Kaprizov,L,MIN,27,74,59,55,114
9,8478483,Mitch Marner,R,TOR,27,79,32,78,110
9,8477404,Jake Guentzel,C,TBL,30,82,48,61,109
9,8477493,Aleksander Barkov,C,FLA,29,80,42,66,108
9,8477939,William Nylander,R,TOR,28,77,48,56,104
9,8479407,Jesper Bratt,L,NJD,26,79,39,60,99
9,8480027,Jason Robertson,L,DAL,25,82,31,68,99
9,8474564,Steven Stamkos,C,NSH,34,75,44,52,96
9,8477956,David Pastrnak,R,BOS,28,76,46,49,95
9,8478550,Artemi Panarin,L,NYR,33,74,28,65,93
9,8476887,Filip Forsberg,L,NSH,30,72,50,42,92
9,8471675,Sidney Crosby,C,PIT,37,77,37,55,92
9,8478398,Kyle Connor,L,WPG,28,77,35,57,92
9,8477946,Dylan Larkin,C,DET,28,79,44,47,91
9,8477934,Leon Draisaitl,C,EDM,29,78,31,60,91
9,8478403,Jack Eichel,C,VGK,28,79,46,44,90
9,8475786,Zach Hyman,L,EDM,32,78,46,44,90
9,8481557,Matt Boldy,L,MIN,23,74,28,62,90
9,8473419,Brad Marchand,L,BOS,36,79,28,61,89
9,8477933,Sam Reinhart,C,FLA,29,76,39,49,88
9,8480830,Andrei Svechnikov,R,CAR,24,76,38,50,88
9,8477409,Carter Verhaeghe,C,FLA,29,79,43,44,87
9,8476454,Ryan Nugent-Hopkins,C,EDM,31,82,24,63,87
9,8475913,Mark Stone,R,VGK,32,80,31,55,86
9,8480012,Elias Pettersson,C,VAN,26,75,27,59,86
9,8477942,Kevin Fiala,L,LAK,28,78,26,60,86
9,8480023,Robert Thomas,C,STL,25,75,34,51,85
9,8474600,Roman Josi,D,NSH,34,72,29,55,84
9,8480800,Quinn Hughes,D,VAN,25,76,13,71,84
9,8477402,Pavel Buchnevich,L,STL,29,79,36,46,82
9,8479337,Alex DeBrincat,R,DET,27,81,33,48,81
9,8475166,John Tavares,C,TOR,34,79,31,50,81
9,8480002,Nico Hischier,C,NJD,25,79,31,50,81
9,8480036,Miro Heiskanen,D,DAL,25,80,18,63,81
9,8480801,Brady Tkachuk,L,OTT,25,78,40,40,80
9,8482116,Tim Stützle,C,OTT,22,79,32,48,80
9,8476460,Mark Scheifele,C,WPG,31,72,38,41,79
9,8471215,Evgeni Malkin,C,PIT,38,78,34,45,79
9,8479385,Jordan Kyrou,C,STL,26,74,39,39,78
9,8478439,Travis Konecny,R,PHI,27,77,29,49,78
9,8476459,Mika Zibanejad,C,NYR,31,80,28,50,78
9,8478427,Sebastian Aho,C,CAR,27,73,34,43,77
9,8478414,Timo Meier,R,NJD,28,76,38,38,76
9,8478460,Zach Werenski,D,CBJ,27,82,19,57,76
9,8482740,Wyatt Johnston,C,DAL,21,82,37,38,75
9,8479343,Clayton Keller,R,UTA,26,75,39,34,73
9,8477501,Valeri Nichushkin,R,COL,29,81,36,37,73
9,8475810,Bryan Rust,R,PIT,32,72,34,39,73
9,8478449,Roope Hintz,C,DAL,28,82,33,40,73
9,8479675,Trevor Moore,L,LAK,29,82,33,40,73
9,8475168,Matt Duchene,C,DAL,33,82,31,42,73
9,8480208,Drake Batherson,R,OTT,26,77,24,49,73
9,8478445,Mathew Barzal,C,NYI,27,76,16,57,73
9,8475184,Chris Kreider,L,NYR,33,77,47,25,72
9,8478010,Brayden Point,C,TBL,28,81,31,41,72
9,8477503,Max Domi,C,TOR,29,80,21,51,72
9,8474578,Erik Karlsson,D,PIT,34,79,14,58,72
9,8476539,Jonathan Marchessault,R,NSH,34,71,41,30,71
9,8476389,Vincent Trocheck,C,NYR,31,79,26,45,71
9,8471685,Anze Kopitar,C,LAK,37,78,19,51,70
9,8475167,Victor Hedman,D,TBL,34,80,18,52,70
9,8478407,Vince Dunn,D,SEA,28,75,9,61,70
9,8475726,Tyler Toffoli,C,SJS,32,71,39,30,69
9,8482665,Matty Beniers,C,SEA,22,74,33,36,69
9,8479323,Adam Fox,D,NYR,26,73,10,59,69
9,8478975,Mason Marchment,L,DAL,29,82,33,35,68
9,8476468,J.T. Miller,C,VAN,31,75,27,41,68
9,8477496,Elias Lindholm,C,BOS,30,77,26,42,68
9,8475158,Ryan O'Reilly,C,NSH,33,69,26,42,68
9,8475172,Nazem Kadri,C,CGY,34,79,23,45,68
9,8476456,Jonathan Huberdeau,C,CGY,31,76,21,47,68
9,8480865,Noah Dobson,D,NYI,24,80,14,54,68
9,8477960,Adrian Kempe,R,LAK,28,80,32,35,67
9,8478047,Michael Bunting,L,PIT,29,72,27,40,67
9,8476881,Tomas Hertl,C,VGK,31,75,26,41,67
9,8484144,Connor Bedard,C,CHI,19,73,23,44,67
9,8475692,Mats Zuccarello,R,MIN,37,72,16,50,66
9,8480069,Cale Makar,D,COL,26,70,15,51,66
9,8477949,Alex Tuch,R,BUF,28,75,24,41,65
9,8477951,Nick Schmaltz,C,UTA,28,78,18,47,65
9,8477447,Shea Theodore,D,VGK,29,62,11,54,65
9,8475794,Tyler Seguin,C,DAL,32,81,27,37,64
9,8478440,Dylan Strome,C,WSH,27,71,26,38,64
9,8481711,Matias Maccelli,L,UTA,24,74,22,42,64
9,8482684,Luke Hughes,D,NJD,21,67,8,56,64
9,8477955,Jared McCann,L,SEA,28,78,38,25,63
9,8478462,Nicolas Roy,C,VGK,27,74,32,31,63
9,8482093,Seth Jarvis,C,CAR,22,71,30,33,63
9,8476448,William Karlsson,C,VGK,31,79,28,35,63
9,8480188,Fabian Zetterlund,L,SJS,25,68,25,38,63
9,8476905,Chandler Stephenson,C,SEA,30,74,24,39,63
9,8473994,Jamie Benn,L,DAL,35,79,22,41,63
9,8475798,Mikael Granlund,C,SJS,32,68,14,49,63
9,8471214,Alex Ovechkin,L,WSH,39,72,28,34,62
9,8477940,Nikolaj Ehlers,L,WPG,28,71,22,40,62
9,8474679,Gustav Nyquist,C,NSH,35,75,21,41,62
9,8476346,Johnny Gaudreau,L,CBJ,31,74,17,45,62
9,8475754,Brock Nelson,C,NYI,33,77,34,27,61
9,8477500,Bo Horvat,C,NYI,29,82,30,31,61
9,8475745,Charlie Coyle,C,BOS,32,80,22,39,61
9,8477407,Anthony Duclair,L,NYI,29,80,23,37,60
9,8474141,Patrick Kane,R,DET,36,80,23,37,60
9,8481068,Yegor Sharangovich,C,CGY,26,79,34,25,59
9,8479420,Tage Thompson,C,BUF,27,76,26,33,59
9,8478873,Troy Terry,R,ANA,27,71,16,43,59
9,8474586,Jordan Eberle,R,SEA,34,75,25,33,58
9,8480015,Owen Tippett,R,PHI,25,73,25,33,58
9,8478444,Brock Boeser,R,VAN,27,72,21,37,58
9,8475753,Justin Faulk,D,STL,32,75,20,38,58
9,8477504,Josh Morrissey,D,WPG,29,72,18,40,58
9,8479425,Filip Hronek,D,VAN,27,67,11,47,58
9,8477935,Sam Bennett,C,FLA,28,76,28,29,57
9,8478397,Rasmus Andersson,D,CGY,28,78,15,42,57
9,8470613,Brent Burns,D,CAR,39,76,15,42,57
9,8480803,Evan Bouchard,D,EDM,25,75,14,43,57
9,8475784,Jeff Skinner,C,EDM,32,78,25,31,56
9,8478401,Pavel Zacha,C,BOS,27,79,23,33,56
9,8481542,Moritz Seider,D,DET,23,76,5,51,56
9,8481540,Cole Caufield,R,MTL,23,74,27,28,55
9,8478493,Joel Eriksson Ek,C,MIN,27,73,25,30,55
9,8479525,Ross Colton,C,COL,28,80,25,30,55
9,8482745,Mason McTavish,C,ANA,21,76,25,30,55
9,8484153,Leo Carlsson,C,ANA,20,70,24,31,55
9,8475170,Brayden Schenn,C,STL,33,74,19,36,55
9,8475765,Vladimir Tarasenko,R,DET,33,80,22,32,54
9,8478396,Noah Hanifin,D,VGK,27,67,11,43,54
9,8482109,Alexis Lafrenière,L,NYR,23,76,27,26,53
9,8477998,Warren Foegele,L,LAK,28,80,21,32,53
9,8477444,Andre Burakovsky,L,SEA,29,70,17,36,53
9,8477494,Jonathan Drouin,L,COL,29,81,16,37,53
9,8479999,Casey Mittelstadt,C,COL,26,81,9,44,53
9,8482159,Tyson Foerster,R,PHI,22,74,22,30,52
9,8476462,Dougie Hamilton,D,NJD,31,73,20,32,52
9,8478438,Tommy Novak,C,NSH,27,73,15,37,52
9,8474590,John Carlson,D,WSH,34,69,12,40,52
9,8476826,Yanni Gourde,C,SEA,33,71,19,32,51
9,8483431,Logan Cooley,C,UTA,20,77,17,34,51
9,8477932,Aaron Ekblad,D,FLA,28,74,8,43,51
9,8480064,Josh Norris,C,OTT,25,80,29,21,50
9,8477416,Oliver Bjorkstrand,R,SEA,29,73,19,31,50
9,8481596,Shane Pinto,C,OTT,24,78,19,31,50
9,8477986,Brandon Montour,D,SEA,30,69,13,37,50
9,8478469,Thomas Chabot,D,OTT,27,75,13,37,50
9,8475169,Evander Kane,L,EDM,33,75,31,18,49
9,8477476,Artturi Lehkonen,L,COL,29,80,24,25,49
9,8478498,Jake DeBrusk,L,VAN,28,71,24,25,49
9,8479542,Brandon Hagel,L,TBL,26,79,20,29,49
9,8478542,Evan Rodrigues,C,FLA,31,75,14,35,49
9,8476853,Morgan Rielly,D,TOR,30,73,8,41,49
9,8478038,Devon Toews,D,COL,30,74,15,33,48
9,8480839,Rasmus Dahlin,D,BUF,24,68,10,38,48
9,8480145,Neal Pionk,D,WPG,29,78,9,39,48
9,8477511,Anthony Mantha,R,CGY,30,73,25,22,47
9,8476483,Rickard Rakell,R,PIT,31,77,21,26,47
9,8474102,David Perron,L,OTT,36,81,20,27,47
9,8483808,Andrei Kuzmenko,L,CGY,28,75,20,27,47
9,8483515,Juraj Slafkovsky,L,MTL,20,71,20,27,47
9,8480068,Ryan Poehling,C,PHI,25,69,19,28,47
9,8482699,Dylan Guenther,R,UTA,21,76,18,29,47
9,8480018,Nick Suzuki,C,MTL,25,74,16,31,47
9,8477346,MacKenzie Weegar,D,CGY,30,74,14,33,47
9,8482149,Cole Perfetti,C,WPG,22,70,14,33,47
9,8482113,Anton Lundell,C,FLA,23,72,25,21,46
9,8475768,Jaden Schwartz,C,SEA,32,73,22,24,46
9,8475314,Anders Lee,L,NYI,34,77,22,24,46
9,8476432,Boone Jenner,C,CBJ,31,72,21,25,46
9,8477451,Ryan Hartman,R,MIN,30,65,19,27,46
9,8482671,Owen Power,D,BUF,22,70,16,30,46
9,8479987,Morgan Geekie,C,BOS,26,78,15,31,46
9,8480014,Gabriel Vilardi,C,WPG,25,71,30,15,45
9,8476880,Tom Wilson,R,WSH,30,67,25,20,45
9,8475191,Reilly Smith,R,NYR,33,76,21,24,45
9,8478856,Conor Garland,R,VAN,28,74,19,26,45
9,8481528,Dylan Cozens,C,BUF,23,68,18,27,45
9,8477021,Alex Kerfoot,C,UTA,30,74,18,27,45
9,8482078,Lucas Raymond,L,DET,22,79,16,29,45
9,8476875,Mike Matheson,D,MTL,30,70,12,33,45
9,8476792,Torey Krug,D,STL,33,73,9,36,45
9,8476869,Brady Skjei,D,NSH,30,76,7,38,45
9,8478366,Frank Vatrano,R,ANA,30,67,28,16,44
9,8481560,Arthur Kaliyev,R,LAK,23,79,25,19,44
9,8477497,Sean Monahan,C,CBJ,30,66,23,21,44
9,8481618,Alex Newhook,C,MTL,23,74,19,25,44
9,8474149,Evgenii Dadonov,R,DAL,35,79,17,27,44
9,8478891,Mason Appleton,C,WPG,28,68,16,28,44
9,8473512,Claude Giroux,R,OTT,36,79,12,32,44
9,8474150,Mikael Backlund,C,CGY,35,79,11,33,44
9,8479325,Charlie McAvoy,D,BOS,27,74,10,34,44
9,8476906,Shayne Gostisbehere,D,CAR,31,73,9,35,44
9,8474565,Alex Pietrangelo,D,VGK,34,58,6,38,44
9,8480185,Eetu Luostarinen,C,FLA,26,78,18,25,43
9,8482110,Dawson Mercer,C,NJD,23,68,16,27,43
9,8484145,Zach Benson,L,BUF,19,71,16,27,43
9,8479410,Mikhail Sergachev,D,UTA,26,63,8,35,43
9,8476854,Hampus Lindholm,D,BOS,30,78,6,37,43
9,8484166,Adam Fantilli,C,CBJ,20,68,21,21,42
9,8479365,Trent Frederic,C,BOS,26,76,21,21,42
9,8477429,Andrew Copp,C,DET,30,78,19,23,42
9,8474053,Logan Couture,C,SJS,35,66,18,24,42
9,8482720,Matthew Knies,L,TOR,22,77,10,32,42
9,8471724,Kris Letang,D,PIT,37,82,5,37,42
9,8476958,Jaccob Slavin,D,CAR,30,77,5,37,42
9,8475799,Nino Niederreiter,R,WPG,32,69,27,14,41
9,8475151,Kyle Palmieri,C,NYI,33,75,22,19,41
9,8478474,Lawson Crouse,L,UTA,27,71,18,23,41
9,8471698,T.J. Oshie,R,WSH,38,64,17,24,41
9,8476458,Ryan Strome,C,ANA,31,71,16,25,41
9,8476872,Scott Laughton,C,PHI,30,72,15,26,41
9,8482660,Kent Johnson,C,CBJ,22,71,14,27,41
9,8482124,Quinton Byfield,R,LAK,22,78,20,20,40
9,8482702,Logan Stankoven,C,DAL,21,80,20,20,40
9,8475763,Kevin Hayes,R,PIT,32,67,19,21,40
9,8480113,Alex Iafallo,L,WPG,31,72,19,21,40
9,8477964,Ivan Barbashev,C,VGK,29,76,18,22,40
9,8476474,Stefan Noesen,R,NJD,31,68,18,22,40
9,8476399,Blake Coleman,C,CGY,33,77,16,24,40
9,8482092,Ridly Greig,C,OTT,22,76,16,24,40
9,8481524,Bowen Byram,D,BUF,23,67,15,25,40
9,8474563,Drew Doughty,D,LAK,35,74,9,31,40
9,8477426,Nicholas Paul,L,TBL,29,82,25,14,39
9,8478042,Viktor Arvidsson,L,EDM,31,76,19,20,39
9,8482667,William Eklund,L,SJS,22,59,18,21,39
9,8473986,Alex Killorn,L,ANA,35,72,17,22,39
9,8481535,Nils Hoglander,L,VAN,24,70,15,24,39
9,8476419,Jean-Gabriel Pageau,C,NYI,32,77,14,25,39
9,8480797,Joel Farabee,L,PHI,24,70,13,26,39
9,8481582,Nicholas Robertson,L,TOR,23,70,24,14,38
9,8480829,Jesperi Kotkaniemi,C,CAR,24,73,20,18,38
9,8475793,Ryan Johansen,C,PHI,32,72,18,20,38
9,8481186,Logan O'Connor,R,COL,28,79,16,22,38
9,8476882,Teuvo Teravainen,C,CHI,30,65,15,23,38
9,8477839,Conor Sheary,L,TBL,32,82,15,23,38
9,8478519,Anthony Cirelli,C,TBL,27,81,13,25,38
9,8478055,Gustav Forsling,D,FLA,28,71,11,27,38
9,8475722,Jason Zucker,L,BUF,32,70,20,17,37
9,8475714,Calle Jarnkrok,C,TOR,33,76,19,18,37
9,8479393,Noah Gregor,L,OTT,26,70,18,19,37
9,8480039,Martin Necas,C,CAR,25,69,16,21,37
9,8476479,Phillip Danault,C,LAK,31,79,16,21,37
9,8474641,Adam Henrique,C,EDM,34,70,16,21,37
9,8480871,Adam Boqvist,D,FLA,24,70,14,23,37
9,8476438,Brandon Saad,L,STL,32,73,13,24,37
9,8477456,J.T. Compher,L,DET,29,78,11,26,37
9,8481577,Philip Tomasino,C,NSH,23,62,8,29,37
9,8477495,Seth Jones,D,CHI,30,69,7,30,37
9,8480043,Timothy Liljegren,D,TOR,25,65,4,33,37
9,8482175,JJ Peterka,R,BUF,22,68,24,12,36
9,8479293,Brandon Tanev,L,SEA,33,69,18,18,36
9,8475848,Brendan Gallagher,R,MTL,32,75,16,20,36
9,8480028,Morgan Frost,C,PHI,25,76,11,25,36
9,8475218,Mattias Ekholm,D,EDM,34,73,11,25,36
9,8475287,Erik Haula,L,NJD,33,69,8,28,36
9,8481604,Pavel Dorofeyev,L,VGK,24,68,19,16,35
9,8479400,Pierre-Luc Dubois,L,WSH,26,72,15,20,35
9,8478458,John (Jack) Roslovic,C,CAR,27,67,10,25,35
9,8481704,Juuso Parssinen,C,NSH,23,61,17,17,34
9,8478233,Andrew Mangiapane,L,WSH,28,68,15,19,34
9,8478413,Jordan Greenway,L,BUF,27,68,14,20,34
9,8480434,Sean Durzi,D,UTA,26,67,10,24,34
9,8476292,Ondrej Palat,L,NJD,33,68,9,25,34
9,8482122,Brock Faber,D,MIN,22,78,6,28,34
9,8475764,Cam Fowler,D,ANA,33,76,5,29,34
9,8476923,Damon Severson,D,CBJ,30,81,3,31,34
9,8480459,Pius Suter,C,VAN,28,67,19,14,33
9,8475760,Nick Bjugstad,C,UTA,32,69,18,15,33
9,8480798,Philipp Kurashev,C,CHI,25,69,16,17,33
9,8479339,Patrik Laine,L,CBJ,26,62,10,23,33
9,8476902,Esa Lindell,D,DAL,30,75,8,25,33
9,8480049,Dylan Samberg,D,WPG,25,67,4,29,33
9,8476885,Jacob Trouba,D,NYR,30,72,2,31,33
9,8476981,Josh Anderson,R,MTL,30,72,21,11,32
9,8482259,Bobby McMann,C,TOR,28,64,20,12,32
9,8482089,Jake Neighbours,L,STL,22,64,20,12,32
9,8475193,Tomas Tatar,L,NJD,34,67,12,20,32
9,8481533,Trevor Zegras,C,ANA,23,66,11,21,32
9,8480009,Eeli Tolvanen,R,SEA,25,67,11,21,32
9,8483505,Matthew Poitras,C,BOS,20,74,9,23,32
9,8481703,Valtteri Puustinen,R,PIT,25,58,5,27,32
9,8482125,Alexander Holtz,R,VGK,22,73,19,12,31
9,8479316,Luke Kunin,C,SJS,27,56,15,16,31
9,8480835,Jack Drury,C,CAR,24,54,14,17,31
9,8479345,Jakob Chychrun,D,WSH,26,65,12,19,31
9,8477953,Kasperi Kapanen,R,STL,28,58,11,20,31
9,8478472,Mathieu Joseph,R,STL,27,65,10,21,31
9,8476897,Oskar Sundqvist,C,STL,30,66,9,22,31
9,8481581,Thomas Harley,D,DAL,23,74,8,23,31
9,8476917,Adam Pelech,D,NYI,30,78,6,25,31
9,8473563,Nicklas Backstrom,C,WSH,37,58,5,26,31
9,8478466,Daniel Sprong,R,VAN,27,69,17,13,30
9,8479941,Justin Danforth,R,CBJ,31,58,16,14,30
9,8479992,Michael Rasmussen,C,DET,25,78,15,15,30
9,8478115,Pierre Engvall,L,NYI,28,70,14,16,30
9,8480220,Noah Cates,L,PHI,25,72,14,16,30
9,8482117,Lukas Reichel,L,CHI,22,64,14,16,30
9,8476480,Vladislav Namestnikov,C,WPG,32,60,13,17,30
9,8481523,Kirby Dach,C,MTL,23,66,12,18,30
9,8474716,Jared Spurgeon,D,MIN,35,74,11,19,30
9,8481624,Ilya Mikheyev,R,CHI,30,62,11,19,30
9,8479353,Brett Howden,C,VGK,26,64,10,20,30
9,8480855,Jack McBain,C,UTA,24,73,9,21,30
9,8476461,Sean Couturier,C,PHI,32,67,8,22,30
9,8479351,Sam Steel,C,DAL,26,81,7,23,30
9,8479371,Dante Fabbro,D,NSH,26,62,4,26,30
9,8476278,Colin Blackwell,C,DAL,31,77,16,13,29
9,8477987,Ryan Donato,C,CHI,28,63,13,16,29
9,8480813,Joe Veleno,C,DET,24,73,12,17,29
9,8482055,Drew O'Connor,L,PIT,26,69,12,17,29
9,8483524,Shane Wright,C,SEA,20,57,11,18,29
9,8475171,Oliver Ekman-Larsson,D,TOR,33,69,9,20,29
9,8477948,Travis Sanheim,D,PHI,28,67,8,21,29
9,8482111,Justin Barron,D,MTL,23,69,8,21,29
9,8483445,Cutter Gauthier,L,ANA,20,68,7,22,29
9,8481656,Aliaksei Protas,C,WSH,23,62,7,22,29
9,8482073,Braden Schneider,D,NYR,23,72,7,22,29
9,8477435,Ryan Graves,D,PIT,29,77,5,24,29
9,8480873,Rasmus Sandin,D,WSH,24,65,4,25,29
9,8478020,Michael Amadio,R,OTT,28,70,18,10,28
9,8477952,Robby Fabbri,C,ANA,28,65,17,11,28
9,8481554,Kaapo Kakko,R,NYR,23,71,16,12,28
9,8478046,Danton Heinen,L,VAN,29,70,15,13,28
9,8470621,Corey Perry,R,EDM,39,74,15,13,28
9,8476469,Joel Armia,R,MTL,31,66,14,14,28
9,8478057,Dakota Joshua,C,VAN,28,66,13,15,28
9,8482705,Cole Sillinger,C,CBJ,21,64,12,16,28
9,8474189,Lars Eller,C,PIT,35,70,12,16,28
9,8479591,Michael Eyssimont,C,TBL,28,80,10,18,28
9,8482146,Luke Evangelista,R,NSH,22,68,10,18,28
9,8480802,Ryan McLeod,C,BUF,25,66,10,18,28
9,8478569,Noel Acciari,C,PIT,33,58,17,10,27
9,8482809,Jackson Blake,R,CAR,21,61,14,13,27
9,8480789,Oliver Wahlstrom,R,NYI,24,75,12,15,27
9,8477479,Tyler Bertuzzi,L,CHI,29,59,11,16,27
9,8482749,Joshua Roy,R,MTL,21,66,9,18,27
9,8475149,Marcus Johansson,L,MIN,34,66,9,18,27
9,8480878,Nils Lundkvist,D,DAL,24,75,9,18,27
9,8477931,Tomas Nosek,L,FLA,32,68,8,19,27
9,8481521,Ronnie Attard,D,PHI,25,62,8,19,27
9,8478882,Vladislav Gavrikov,D,LAK,29,67,7,20,27
9,8476457,Adam Larsson,D,SEA,32,67,7,20,27
9,8477499,Rasmus Ristolainen,D,PHI,30,60,7,20,27
9,8482097,Jack Quinn,R,BUF,23,63,6,21,27
9,8477969,Marcus Pettersson,D,PIT,28,77,5,22,27
9,8482624,Daniil Miromanov,D,CGY,27,65,5,22,27
9,8476463,Jonas Brodin,D,MIN,31,77,5,22,27
9,8482133,Thomas Bordeleau,C,SJS,22,52,4,23,27
9,8482245,Artem Zub,D,OTT,29,78,4,23,27
9,8483490,Pavel Mintyukov,D,ANA,21,67,3,24,27
9,8478133,Jake Evans,C,MTL,28,64,3,24,27
9,8474151,Ryan McDonagh,D,TBL,35,80,2,25,27
9,8477478,William Carrier,L,CAR,30,62,15,11,26
9,8481580,Connor McMichael,C,WSH,23,62,15,11,26
9,8481641,Joel Kiviranta,L,COL,28,70,13,13,26
9,8478109,Victor Olofsson,L,VGK,29,69,12,14,26
9,8475231,Casey Cizikas,C,NYI,33,72,12,14,26
9,8483468,Jiri Kulich,C,BUF,20,58,11,15,26
9,8475343,Nic Dowd,C,WSH,34,62,10,16,26
9,8482105,Jake Sanderson,D,OTT,22,73,6,20,26
9,8477507,Nikita Zadorov,D,BOS,29,69,4,22,26
9,8475324,Nick Jensen,D,OTT,34,71,4,22,26
9,8478507,John Marino,D,UTA,27,68,2,24,26
9,8481178,Egor Zamula,D,PHI,24,61,2,24,26
9,8480748,Kiefer Sherwood,L,VAN,29,55,14,11,25
9,8483493,Frank Nazar,C,CHI,20,51,13,12,25
9,8482475,Yegor Chinakhov,R,CBJ,23,55,12,13,25
9,8473422,Nick Foligno,L,CHI,37,59,10,15,25
9,8476960,Andreas Athanasiou,C,CHI,30,58,10,15,25
9,8482803,Olen Zellweger,D,ANA,21,64,9,16,25
9,8476925,Colton Sissons,C,NSH,31,72,7,18,25
9,8477220,Nate Schmidt,D,FLA,33,70,7,18,25
9,8480074,Alexandre Texier,C,STL,25,62,7,18,25
9,8475179,Dmitry Kulikov,D,FLA,34,60,7,18,25
9,8476329,Travis Boyd,C,MIN,31,55,6,19,25
9,8480246,Nick Perbix,D,TBL,26,76,5,20,25
9,8477488,Brett Pesce,D,NJD,30,65,2,23,25
9,8478013,Jake Walman,D,SJS,28,72,15,9,24
9,8482679,Matt Coronato,R,CGY,22,65,12,12,24
9,8479996,Cody Glass,C,NSH,25,64,11,13,24
9,8478911,Matt Roy,D,WSH,29,70,10,14,24
9,8475855,Jesper Fast,R,CAR,33,63,10,14,24
9,8476392,Adam Lowry,C,WPG,31,63,9,15,24
9,8476927,Teddy Blueger,C,VAN,30,66,8,16,24
9,8475200,Dmitry Orlov,D,CAR,33,75,7,17,24
9,8482101,Danil Gushchin,L,SJS,22,56,7,17,24
9,8481606,Jordan Spence,D,LAK,23,69,5,19,24
9,8479398,Samuel Girard,D,COL,26,65,5,19,24
9,8480817,K'Andre Miller,D,NYR,24,70,3,21,24
9,8476331,Dylan DeMelo,D,WPG,31,63,3,21,24
9,8482087,Kaiden Guhle,D,MTL,22,61,3,21,24
9,8480807,Mattias Samuelsson,D,BUF,24,54,2,22,24
9,8479619,Michael Carcone,L,UTA,28,57,15,8,23
9,8478432,Christian Fischer,R,DET,27,77,11,12,23
9,8477425,Miles Wood,L,COL,29,77,9,14,23
9,8482712,Oskar Olausson,R,COL,22,79,7,16,23
9,8479661,Tanner Jeannot,L,LAK,27,75,7,16,23
9,8476921,Jordan Martinook,L,CAR,32,63,7,16,23
9,8477392,Hudson Fasching,R,NYI,29,66,7,16,23
9,8477919,Frederick Gaudreau,C,MIN,31,58,7,16,23
9,8477505,Alexander Wennberg,C,SJS,30,64,5,18,23
9,8478851,Alexandre Carrier,D,NSH,28,71,4,19,23
9,8477506,Ryan Pulock,D,NYI,30,79,3,20,23
9,8475790,Erik Gudbranson,D,CBJ,32,76,3,20,23
9,8477979,Nicolas Aube-Kubel,R,BUF,28,51,14,8,22
9,8474715,Cameron Atkinson,R,TBL,35,82,13,9,22
9,8480980,Connor Dewar,C,TOR,25,61,12,10,22
9,8483457,Lane Hutson,D,MTL,20,70,10,12,22
9,8481553,Bobby Brink,R,PHI,23,64,10,12,22
9,8480849,Barrett Hayton,C,UTA,24,73,9,13,22
9,8478463,Anthony Beauvillier,L,PIT,27,61,9,13,22
9,8481093,Rafael Harvey-Pinard,L,MTL,25,58,8,14,22
9,8484203,Bradly Nadeau,L,CAR,19,58,7,15,22
9,8477498,Darnell Nurse,D,EDM,29,71,6,16,22
9,8479639,Dylan Coghlan,D,WPG,26,62,5,17,22
9,8476467,Jamie Oleksiak,D,SEA,32,72,4,18,22
9,8479372,Joshua Mahura,D,SEA,26,55,4,18,22
9,8481546,Cam York,D,PHI,23,64,3,19,22
9,8475181,Nick Leddy,D,STL,33,74,3,19,22
9,8481014,Alexander Romanov,D,NYI,24,80,3,19,22
9,8478500,Ivan Provorov,D,CBJ,27,80,2,20,22
9,8480893,Kirill Marchenko,R,CBJ,24,59,15,6,21
9,8481481,Blake Lizotte,C,PIT,27,59,11,10,21
9,8479315,Joey Anderson,R,CHI,26,48,9,12,21
9,8475220,Marcus Foligno,L,MIN,33,59,8,13,21
9,8476873,Mark Jankowski,C,NSH,30,53,8,13,21
9,8478859,Niko Mikkola,D,FLA,28,49,7,14,21
9,8476979,Erik Gustafsson,D,DET,32,72,5,16,21
9,8482451,Mikael Pyyhtia,L,CBJ,23,46,5,16,21
9,8480073,Erik Brannstrom,D,COL,25,64,3,18,21
9,8476525,Colin Miller,D,WPG,32,63,3,18,21
9,8482079,Marco Rossi,C,MIN,23,55,13,7,20
9,8476878,Zemgus Girgensons,C,TBL,30,81,13,7,20
9,8476918,Jimmy Vesey,L,NYR,31,71,12,8,20
9,8481032,Paul Cotter,C,NJD,25,61,12,8,20
9,8476374,Sean Kuraly,C,CBJ,31,54,12,8,20
9,8477947,Sonny Milano,L,WSH,28,63,11,9,20
9,8477450,Jason Dickinson,C,CHI,29,61,11,9,20
9,8473533,Jordan Staal,C,CAR,36,58,9,11,20
9,8480144,David Kampf,C,TOR,29,70,9,11,20
9,8479390,Taylor Raddysh,R,WSH,26,66,7,13,20
9,8475791,Taylor Hall,L,CHI,33,56,7,13,20
9,8483565,Nick Blankenburg,D,NSH,26,61,6,14,20
9,8481028,Martin Pospisil,C,CGY,25,61,6,14,20
9,8481522,Peyton Krebs,C,BUF,23,58,6,14,20
9,8479982,Conor Timmins,D,TOR,26,56,4,16,20
9,8475188,Brayden McNabb,D,VGK,33,56,4,16,20
9,8476891,Matthew Grzelcyk,D,PIT,30,76,3,17,20
9,8482655,Janis Moser,D,TBL,24,75,3,17,20
9,8473446,Erik Johnson,D,PHI,36,47,3,17,20
9,8479368,Max Jones,L,BOS,26,68,13,6,19
9,8479520,Brandon Duhaime,R,WSH,27,56,11,8,19
9,8477903,Garnet Hathaway,R,PHI,33,68,10,9,19
9,8480078,Filip Chytil,C,NYR,25,64,9,10,19
9,8480336,Sean Walker,D,CAR,30,67,8,11,19
9,8477015,Connor Brown,R,EDM,30,54,8,11,19
9,8477989,Christian Dvorak,C,MTL,28,66,7,12,19
9,8480762,Eric Robinson,L,CAR,29,53,7,12,19
9,8480021,Jack Studnicka,C,LAK,25,62,7,12,19
9,8480448,Parker Kelly,L,COL,25,74,6,13,19
9,8478136,Jake Middleton,D,MIN,28,77,6,13,19
9,8480011,Klim Kostin,C,SJS,25,55,6,13,19
9,8480891,Michael Kesselring,D,UTA,24,61,5,14,19
9,8482067,Connor Mackey,D,NYR,28,57,5,14,19
9,8479983,Mario Ferraro,D,SJS,26,75,4,15,19
9,8480222,Sebastian Aho,D,PIT,28,72,4,15,19
9,8481708,Zac Jones,D,NYR,24,46,3,16,19
9,8481527,Kaedan Korczak,D,VGK,23,53,2,17,19
9,8479402,Jake Bean,D,CGY,26,64,2,17,19
9,8480281,Alexey Toropchenko,R,STL,25,64,12,6,18
9,8480205,Emil Bemstrom,C,PIT,25,51,9,9,18
9,8478508,Yakov Trenin,C,MIN,27,62,9,9,18
9,8475225,Craig Smith,C,CHI,35,51,7,11,18
9,8482166,Shakir Mukhamadullin,D,SJS,22,58,7,11,18
9,8475279,Ben Chiarot,D,DET,33,71,4,14,18
9,8475718,Justin Holl,D,DET,32,61,4,14,18
9,8476892,Colton Parayko,D,STL,31,71,3,15,18
9,8479026,Philippe Myers,D,TOR,27,52,2,16,18
9,8476967,Brett Kulak,D,EDM,30,64,2,16,18
9,8473453,Trevor Lewis,C,LAK,37,67,10,7,17
9,8482074,Connor Zary,C,CGY,23,58,10,7,17
9,8478211,Dryden Hunt,L,CGY,29,61,10,7,17
9,8479328,Julien Gauthier,R,NYI,27,64,9,8,17
9,8481477,Nico Sturm,C,SJS,29,55,8,9,17
9,8476422,Mike Reilly,D,NYI,31,73,6,11,17
9,8481517,Brett Leason,R,ANA,25,60,6,11,17
9,8482737,Zack Bolduc,C,STL,21,59,5,12,17
9,8476889,Radek Faksa,C,STL,30,54,5,12,17
9,8482142,Jamie Drysdale,D,PHI,22,59,4,13,17
9,8479344,Jesse Puljujarvi,R,PIT,26,47,4,13,17
9,8478416,Erik Cernak,D,TBL,27,71,4,13,17
9,8482176,Wyatt Kaiser,D,CHI,22,48,4,13,17
9,8480860,Kevin Bahl,D,CGY,24,59,4,13,17
9,8475690,Chris Tanev,D,TOR,35,65,3,14,17
9,8479998,Mikey Anderson,D,LAK,25,63,3,14,17
9,8474673,TJ Brodie,D,CHI,34,66,2,15,17
9,8475455,Brenden Dillon,D,NJD,34,60,2,15,17
9,8482964,Arber Xhekaj,D,MTL,23,52,2,15,17
9,8476931,Jake McCabe,D,TOR,31,63,1,16,17
9,8479336,Carl Grundstrom,R,SJS,27,55,9,7,16
9,8478043,Sam Lafferty,C,BUF,29,55,8,8,16
9,8482062,Cole Smith,L,NSH,29,51,8,8,16
9,8483491,Ivan Miroshnichenko,L,WSH,20,58,8,8,16
9,8480252,Cole Guttman,C,CHI,25,38,8,8,16
9,8476858,Phillip Di Giuseppe,L,VAN,31,44,8,8,16
9,8480003,Jesper Boqvist,C,FLA,26,65,6,10,16
9,8479671,Mathieu Olivier,R,CBJ,27,40,5,11,16
9,8482859,Zack Ostapchuk,C,OTT,21,56,4,12,16
9,8479543,Michael Pezzetta,L,MTL,26,50,4,12,16
9,8481568,Alex Vlasic,D,CHI,23,58,3,13,16
9,8475462,Radko Gudas,D,ANA,34,62,3,13,16
9,8478451,Ethan Bear,D,WSH,27,50,3,13,16
9,8479291,Kevin Rooney,C,CGY,31,56,3,13,16
9,8471709,Marc-Edouard Vlasic,D,SJS,37,61,3,13,16
9,8480887,Jordan Harris,D,MTL,24,51,2,14,16
9,8481059,Scott Perunovich,D,STL,26,63,0,16,16
9,8475842,Sam Carrick,C,NYR,32,53,11,4,15
9,8479066,Ryan Lomberg,L,CGY,30,59,8,7,15
9,8481441,Joe Snively,C,DET,28,66,8,7,15
9,8480995,Pontus Holmberg,R,TOR,25,55,8,7,15
9,8481754,Nikita Nesterenko,C,ANA,23,44,8,7,15
9,8483482,Tristan Luneau,D,ANA,20,65,7,8,15
9,8477406,Mattias Janmark,C,EDM,32,72,6,9,15
9,8484149,Gavin Brindley,C,CBJ,20,47,6,9,15
9,8479369,Andrew Peeke,D,BOS,26,58,3,12,15
9,8480172,Jan Rutta,D,SJS,34,58,3,12,15
9,8476312,Josh Manson,D,COL,33,64,3,12,15
9,8477845,Trevor van Riemsdyk,D,WSH,33,61,2,13,15
9,8476988,Matt Benning,D,SJS,30,61,2,13,15
9,8478452,Caleb Jones,D,LAK,27,52,2,13,15
9,8482155,Alex Laferriere,R,LAK,23,69,10,4,14
9,8481716,Dmitri Voronkov,L,CBJ,24,52,10,4,14
9,8476867,Brendan Gaunce,C,MIN,30,42,10,4,14
9,8477573,Nathan Walker,L,STL,30,43,8,6,14
9,8481013,Jonatan Berggren,R,DET,24,65,7,7,14
9,8480025,MacKenzie Entwistle,R,FLA,25,63,7,7,14
9,8478970,Jalen Chatfield,D,CAR,28,72,5,9,14
9,8477369,Carson Soucy,D,VAN,30,56,5,9,14
9,8476822,Luke Glendening,C,TBL,35,77,5,9,14
9,8481550,Adam Beckman,L,NJD,23,40,4,10,14
9,8480058,Pierre-Olivier Joseph,D,STL,25,53,4,10,14
9,8477851,Jordan Oesterle,D,BOS,32,38,4,10,14
9,8473507,Jeff Petry,D,DET,37,70,3,11,14
9,8480727,Zach Whitecloud,D,VGK,28,45,3,11,14
9,8474574,Tyler Myers,D,VAN,34,69,3,11,14
9,8478178,Darren Raddysh,D,TBL,28,65,2,12,14
9,8476879,Cody Ceci,D,EDM,31,73,2,12,14
9,8479324,Ryan Lindgren,D,NYR,26,68,1,13,14
9,8482157,Will Cuylle,L,NYR,22,53,8,5,13
9,8480441,Trey Fix-Wolansky,R,CBJ,25,44,8,5,13
9,8482077,Dylan Holloway,L,EDM,23,51,7,6,13
9,8477508,Curtis Lazar,C,NJD,29,59,6,7,13
9,8482148,Hendrix Lapierre,C,WSH,22,45,6,7,13
9,8483499,Liam Ohgren,L,MIN,20,51,5,8,13
9,8478443,Brandon Carlo,D,BOS,28,54,5,8,13
9,8479359,Beck Malenstyn,L,BUF,26,47,4,9,13
9,8477482,Zachary Sanford,L,CHI,30,39,4,9,13
9,8477380,Jonny Brodzinski,C,NYR,31,56,3,10,13
9,8479980,Nicolas Hague,D,VGK,26,57,3,10,13
9,8479370,Tyson Jost,C,CAR,26,52,3,10,13
9,8477938,Haydn Fleury,D,WPG,28,44,3,10,13
9,8480950,Ilya Lyubushkin,D,DAL,30,67,2,11,13
9,8476624,Barclay Goodrow,C,SJS,31,56,1,12,13
9,8480806,Isac Lundestrom,C,ANA,25,61,1,12,13
9,8480035,Henri Jokiharju,D,BUF,25,57,1,12,13
9,8478421,A.J. Greer,L,FLA,28,61,7,5,12
9,8479414,Nathan Bastian,R,NJD,27,48,7,5,12
9,8483495,Simon Nemec,D,NJD,20,58,7,5,12
9,8478434,Keegan Kolesar,R,VGK,27,58,6,6,12
9,8481617,Vasily Podkolzin,R,VAN,23,52,6,6,12
9,8477353,Tyler Motte,C,DET,29,70,4,8,12
9,8482634,Alex Steeves,C,TOR,25,47,4,8,12
9,8471677,Jack Johnson,D,CBJ,37,64,4,8,12
9,8477446,Michael McCarron,R,NSH,29,54,3,9,12
9,8474568,Luke Schenn,D,NSH,35,55,3,9,12
9,8476874,Olli Maatta,D,DET,30,62,3,9,12
9,8476429,Scott Mayfield,D,NYI,32,66,2,10,12
9,8480796,Martin Fehervary,D,WSH,25,51,2,10,12
9,8481701,Santeri Hatakka,D,NJD,23,45,2,10,12
9,8483460,David Jiricek,D,CBJ,21,57,2,10,12
9,8483549,Lucas Condotta,L,MTL,27,43,2,10,12
9,8479976,Juuso Valimaki,D,UTA,26,65,1,11,12
9,8478840,Will Borgen,D,SEA,28,59,0,12,12
9,8475235,Nicolas Deslauriers,L,PHI,33,51,8,3,11
9,8480192,Johnathan Kovacevic,D,NJD,27,54,7,4,11
9,8477887,Patrick Brown,C,BOS,32,50,6,5,11
9,8482807,Ethan Del Mastro,D,CHI,21,45,4,7,11
9,8481518,Nolan Foote,L,NJD,24,40,4,7,11
9,8479536,Axel Jonsson-Fjallby,L,WPG,26,38,3,8,11
9,8475762,Derek Forbort,D,VAN,32,47,3,8,11
9,8483466,Kevin Korchinski,D,CHI,20,57,2,9,11
9,8480001,Urho Vaakanainen,D,ANA,25,64,2,9,11
9,8482095,Tyler Kleven,D,OTT,22,43,2,9,11
9,8479249,Andrew Poturalski,C,SJS,30,38,2,9,11
9,8470600,Ryan Suter,D,STL,39,60,1,10,11
9,8480879,Jacob Bernard-Docker,D,OTT,24,41,1,10,11
9,8474090,Brendan Smith,D,DAL,35,51,1,10,11
9,8482659,Josh Doan,R,UTA,22,55,7,3,10
9,8479638,Justin Brazeau,R,BOS,26,36,7,3,10
9,8478831,Kevin Stenlund,C,UTA,28,60,6,4,10
9,8480355,Mark Kastelic,C,BOS,25,53,5,5,10
9,8479718,Alex Barré-Boulet,C,MTL,27,52,4,6,10
9,8476934,Brock McGinn,L,ANA,30,55,4,6,10
9,8481609,Vladislav Kolyachonok,D,UTA,23,39,4,6,10
9,8476994,Vinnie Hinostroza,C,NSH,30,44,3,7,10
9,8478399,Jonas Siegenthaler,D,NJD,27,57,3,7,10
9,8481751,Lukas Rousek,R,BUF,25,35,3,7,10
9,8482747,Brennan Othmann,L,NYR,21,38,3,7,10
9,8477365,Connor Clifton,D,BUF,29,50,2,8,10
9,8481567,Henry Thrun,D,SJS,23,50,2,8,10
9,8480848,Ty Dellandrea,C,SJS,24,39,2,8,10
9,8483570,Ben Meyers,C,SEA,26,22,2,8,10
9,8479348,Kale Clague,D,BUF,26,48,1,9,10
9,8480070,Ian Mitchell,D,BOS,25,55,1,9,10
9,8477962,Brendan Lemieux,L,CAR,28,31,1,9,10
9,8478454,Noah Juulsen,D,VAN,27,37,1,9,10
9,8481056,Spencer Stastney,D,NSH,24,26,1,9,10
9,8478424,Jansen Harkins,C,ANA,27,39,6,3,9
9,8479968,Vinni Lettieri,C,BOS,29,48,5,4,9
9,8479994,Jaret Anderson-Dolan,C,WPG,25,36,5,4,9
9,8471817,Ryan Reaves,R,TOR,37,55,4,5,9
9,8482751,Ryan Winterton,C,SEA,21,33,4,5,9
9,8475208,Brian Dumoulin,D,ANA,33,63,3,6,9
9,8479972,Mason Shaw,C,WPG,26,35,3,6,9
9,8477018,Ben Hutton,D,VGK,31,53,2,7,9
9,8474567,Zach Bogosian,D,MIN,34,64,2,7,9
9,8480157,Calle Rosen,D,COL,30,48,2,7,9
9,8476856,Mathew Dumba,D,DAL,30,64,1,8,9
9,8482730,Brandt Clarke,D,LAK,21,54,1,8,9
9,8478017,Mark Friedman,D,VAN,29,41,1,8,9
9,8474612,Travis Hamonic,D,OTT,34,45,1,8,9
9,8480196,Jacob Bryson,D,BUF,27,53,1,8,9
9,8481161,Jake Christiansen,D,CBJ,25,52,6,2,8
9,8479439,Jacob MacDonald,D,COL,31,45,5,3,8
9,8477070,Liam O'Brien,C,UTA,30,57,5,3,8
9,8482666,Scott Morrow,D,CAR,22,52,5,3,8
9,8476952,Dominic Toninato,C,WPG,30,42,4,4,8
9,8482762,Simon Edvinsson,D,DET,21,57,3,5,8
9,8481537,Nikita Okhotiuk,D,CGY,24,48,3,5,8
9,8475177,Calvin de Haan,D,COL,33,40,3,5,8
9,8482070,Mitchell Chaffee,R,TBL,26,49,3,5,8
9,8480289,Morgan Barron,C,WPG,26,50,2,6,8
9,8481599,Victor Soderstrom,D,UTA,23,47,2,6,8
9,8479442,Troy Stecher,D,EDM,30,53,1,7,8
9,8474166,Alec Martinez,D,CHI,37,47,1,7,8
9,8475233,David Savard,D,MTL,34,69,0,8,8
9,8481167,Brayden Pachal,D,CGY,25,48,0,8,8
9,8474034,Patrick Maroon,L,CHI,36,44,6,1,7
9,8482147,Jean-Luc Foudy,C,COL,22,30,6,1,7
9,8482652,Walker Duehr,R,CGY,27,44,5,2,7
9,8482784,Zach Dean,C,STL,21,43,5,2,7
9,8481593,Jayden Struble,D,MTL,23,19,5,2,7
9,8481601,Simon Holmstrom,R,NYI,23,60,4,3,7
9,8479944,Zach Aston-Reese,C,VGK,30,53,4,3,7
9,8481789,Tye Kartye,L,SEA,23,41,4,3,7
9,8476442,Matt Nieto,L,PIT,32,39,4,3,7
9,8482144,Jack Thompson,D,SJS,22,30,4,3,7
9,8479986,Kole Lind,R,DAL,26,43,3,4,7
9,8477527,Ross Johnston,L,ANA,30,30,3,4,7
9,8482858,Ryker Evans,D,SEA,23,32,3,4,7
9,8479378,Logan Stanley,D,WPG,26,43,2,5,7
9,8484254,Akito Hirose,D,VAN,25,43,2,5,7
9,8482861,Vincent Iorio,D,WSH,22,27,2,5,7
9,8477384,Joshua Brown,D,EDM,30,44,2,5,7
9,8482192,Isaak Phillips,D,CHI,23,53,1,6,7
9,8479576,Vincent Desharnais,D,VAN,28,33,1,6,7
9,8477034,Jaycob Megna,D,FLA,32,50,1,6,7
9,8481556,John Beecher,C,BOS,23,33,4,2,6
9,8479367,William Lockwood,R,FLA,26,27,4,2,6
9,8481532,Alex Turcotte,C,LAK,23,42,3,3,6
9,8480245,Olle Lycksell,R,PHI,25,29,3,3,6
9,8478409,Anthony Richard,C,PHI,28,26,3,3,6
9,8478585,Derek Ryan,C,EDM,38,66,2,4,6
9,8479772,Zack MacEwen,R,OTT,28,49,2,4,6
9,8478468,Jeremy Lauzon,D,NSH,27,50,2,4,6
9,8479981,Jonah Gadjovich,L,FLA,26,35,2,4,6
9,8479991,Jake Leschyshyn,C,NYR,25,27,2,4,6
9,8477335,Kyle Burroughs,D,LAK,29,47,1,5,6
9,8480292,Carson Meyer,R,ANA,27,29,1,5,6
9,8475750,Jon Merrill,D,MIN,32,48,1,5,6
9,8477473,Justin Bailey,R,SJS,29,24,1,5,6
9,8475958,Michael Sgarbossa,C,WSH,32,33,0,6,6
9,8481462,Mason Morelli,L,VGK,28,17,5,0,5
9,8481147,Reese Johnson,C,MIN,26,39,4,1,5
9,8480870,Bo Groulx,C,NYR,24,28,4,1,5
9,8482744,James Malatesta,L,CBJ,21,46,4,1,5
9,8481592,Jakob Pelletier,L,CGY,23,30,4,1,5
9,8482496,Nils Aman,C,VAN,24,33,4,1,5
9,8476372,Nick Seeler,D,PHI,31,47,3,2,5
9,8483397,Marc McLaughlin,C,BOS,25,31,3,2,5
9,8482713,Mackie Samoskevich,R,FLA,22,36,3,2,5
9,8482511,Mason Lohrei,D,BOS,23,34,3,2,5
9,8482470,Ilya Solovyov,D,CGY,24,16,3,2,5
9,8477401,John Hayden,C,SEA,29,33,2,3,5
9,8480845,Rasmus Kupari,C,WPG,24,35,2,3,5
9,8483012,Logan Morrison,C,SEA,22,35,2,3,5
9,8479985,Cale Fleury,D,SEA,26,24,2,3,5
9,8477073,Kurtis MacDermid,L,NJD,30,30,2,3,5
9,8480880,Jakub Lauko,C,MIN,24,31,1,4,5
9,8476473,Connor Murphy,D,CHI,31,37,1,4,5
9,8478874,Adam Gaudette,R,OTT,28,37,1,4,5
9,8482145,Mavrik Bourque,C,DAL,22,54,1,4,5
9,8475413,Justin Dowling,C,NJD,34,17,1,4,5
9,8482929,Emil Lilleberg,D,TBL,23,25,1,4,5
9,8481598,Philip Broberg,D,EDM,23,39,0,5,5
9,8481600,Tobias Bjornfot,D,FLA,23,38,0,5,5
9,8480007,Jonas Rondbjerg,R,VGK,25,41,0,5,5
9,8482141,Lukas Cormier,D,VGK,22,25,0,5,5
9,8481679,Maxence Guenette,D,OTT,23,31,3,1,4
9,8481585,Egor Afanasyev,L,SJS,23,16,3,1,4
9,8482102,Vasily Ponomarev,C,PIT,22,24,3,1,4
9,8483763,Maksymilian Szuber,D,UTA,22,33,2,2,4
9,8482516,Matthew Kessel,D,STL,24,13,2,2,4
9,8483619,Filip Roos,D,OTT,25,35,2,2,4
9,8482765,Isak Rosen,R,BUF,21,31,2,2,4
9,8480990,Declan Chisholm,D,MIN,24,41,2,2,4
9,8478021,William Lagesson,D,DET,28,23,2,2,4
9,8483630,Pavol Regenda,L,ANA,25,25,2,2,4
9,8482165,Yan Kuznetsov,D,CGY,22,18,2,2,4
9,8480032,Shane Bowers,C,NJD,25,20,2,2,4
9,8477244,Chad Ruhwedel,D,NYR,34,26,2,2,4
9,8481030,Jack St. Ivany,D,PIT,25,10,2,2,4
9,8476441,Joel Edmundson,D,LAK,31,35,1,3,4
9,8482153,Brendan Brisson,C,VGK,23,29,1,3,4
9,8482177,Marat Khusnutdinov,C,MIN,22,37,1,3,4
9,8478450,Parker Wotherspoon,D,BOS,27,32,1,3,4
9,8476913,Devin Shore,C,MIN,30,38,1,3,4
9,8482201,Gage Goncalves,C,TBL,23,20,1,3,4
9,8478477,Mitchell Stephens,C,SEA,27,23,1,3,4
9,8481019,David Gustafsson,C,WPG,24,35,0,4,4
9,8482162,Roby Jarventie,L,EDM,22,18,0,4,4
9,8479320,Maxime Lajoie,D,SEA,27,22,0,4,4
9,8483597,Milos Kelemen,L,UTA,25,9,3,0,3
9,8479379,Givani Smith,R,SJS,26,31,2,1,3
9,8482733,Logan Mailloux,D,MTL,31,31,2,1,3
9,8481065,Angus Crookshank,L,OTT,25,13,2,1,3
9,8481543,Nikita Alexandrov,C,STL,24,31,2,1,3
9,8480844,Grigori Denisenko,L,VGK,24,33,2,1,3
9,8482118,Sam Colangelo,R,ANA,23,15,2,1,3
9,8483471,Brad Lambert,C,WPG,31,13,2,1,3
9,8481206,John Ludvig,D,PIT,24,13,2,1,3
9,8481578,Graeme Clarke,R,MIN,23,8,2,1,3
9,8474013,Ian Cole,D,UTA,35,48,1,2,3
9,8480890,Jan Jenik,C,OTT,24,29,1,2,3
9,8484911,Collin Graf,R,SJS,22,40,1,2,3
9,8478011,Louie Belpedio,D,PHI,28,11,1,2,3
9,8481422,Jake Lucchini,C,NSH,29,20,1,2,3
9,8483512,Matthew Savoie,C,EDM,20,14,1,2,3
9,8480874,Adam Ginning,D,PHI,24,11,1,2,3
9,8478146,Matthew Highmore,C,OTT,28,32,1,2,3
9,8479587,Rhett Gardner,C,PHI,28,24,1,2,3
9,8481743,Marc Del Gaizo,D,NSH,25,19,1,2,3
9,8482094,Daemon Hunt,D,MIN,22,20,1,2,3
9,8477462,Robert Hagg,D,VGK,29,16,0,3,3
9,8481122,Simon Benoit,D,TOR,26,35,0,3,3
9,8477810,Joel Hanley,D,CGY,33,22,0,3,3
9,8479419,Brett Murray,L,BUF,26,24,0,3,3
9,8480075,Cameron Crotty,D,MIN,25,13,0,3,3
9,8481237,Kyle MacLean,C,NYI,25,33,2,0,2
9,8479330,Brandon Gignac,C,MTL,27,9,2,0,2
9,8480851,Akil Thomas,C,LAK,24,18,2,0,2
9,8477149,Scott Sabourin,R,SJS,32,15,1,1,2
9,8480834,Ty Emberson,D,SJS,24,27,1,1,2
9,8477467,Gustav Olofsson,D,SEA,30,17,1,1,2
9,8484287,Cole McWard,D,VAN,23,23,1,1,2
9,8481541,Samuel Bolduc,D,NYI,24,29,1,1,2
9,8479362,Riley Tufte,L,BOS,26,23,1,1,2
9,8478051,Max Willman,C,NJD,29,15,1,1,2
9,8484325,Waltteri Merela,C,TBL,26,26,1,1,2
9,8480267,Sammy Walker,C,MIN,25,17,0,2,2
9,8481605,Jackson LaCombe,D,ANA,23,31,0,2,2
9,8481006,Tyler Tucker,D,STL,24,10,0,2,2
9,8482061,Brandon Biro,L,SEA,26,13,0,2,2
9,8475795,Dylan McIlrath,D,WSH,32,15,0,2,2
9,8480084,Nick DeSimone,D,NJD,30,13,0,2,2
9,8477971,Andreas Englund,D,LAK,28,21,0,2,2
9,8483489,Fraser Minten,C,TOR,31,14,0,2,2
9,8477320,Anton Blidh,L,NYR,29,18,1,0,1
9,8480468,James Hamblin,L,EDM,25,18,1,0,1
9,8478881,Brett Seney,L,CHI,28,8,1,0,1
9,8482172,Landon Slaggert,L,CHI,22,16,1,0,1
9,8475755,Alexander Petrovic,D,DAL,32,6,1,0,1
9,8482460,Matt Rempe,C,NYR,22,17,1,0,1
9,8483395,Arshdeep Bains,L,VAN,23,14,1,0,1
9,8476323,Max McCormick,L,SEA,32,3,1,0,1
9,8484258,Sam Malinski,D,COL,26,22,0,1,1
9,8481043,Cole Koepke,L,BOS,26,11,0,1,1
9,8483407,Brandon Scanlin,D,NYR,25,8,0,1,1
9,8481024,Linus Karlsson,C,VAN,25,11,0,1,1
9,8478502,Dennis Gilbert,D,BUF,28,13,0,1,1
9,8483398,Declan Carlile,D,TBL,31,8,0,1,1
9,8474062,Riley Nash,C,NYR,35,16,0,1,1
9,8478446,Glenn Gawdin,C,LAK,27,17,0,1,1
9,8481564,Ryan Johnson,D,BUF,23,12,0,1,1
9,8477541,Dakota Mermis,D,TOR,30,12,0,1,1
9,8482197,Adam Raska,R,MIN,23,8,0,1,1
9,8479522,Hardy Haman Aktell,D,WSH,26,6,0,1,1
9,8478854,Ryan Shea,D,PIT,27,6,0,1,1
9,8484304,Uvis Balinskis,D,FLA,28,10,0,0,0
9,8481719,Maxwell Crozier,D,TBL,24,12,0,0,0
9,8475780,Chris Wagner,R,COL,33,4,0,0,0
9,8481699,Aku Raty,R,UTA,23,6,0,0,0
9,8482250,Callahan Burke,C,VGK,27,16,0,0,0
9,8478147,Bokondji Imama,L,PIT,28,3,0,0,0
9,8482088,Justin Sourdif,R,FLA,22,15,0,0,0
9,8480306,Grant Hutton,D,NYI,29,7,0,0,0
9,8481806,Louis Crevier,D,CHI,23,12,0,0,0
9,8480823,Alexander Alexeyev,D,WSH,25,13,0,0,0
9,8484255,Jason Polin,R,COL,25,5,0,0,0
9,8483920,Pierrick Dube,R,WSH,23,5,0,0,0
9,8481655,Cole Schwindt,R,CGY,23,5,0,0,0
9,8483432,Luca Del Bel Belluz,C,CBJ,31,5,0,0,0
9,8483401,Marc Johnstone,R,PIT,28,2,0,0,0
9,8483567,Georgii Merkulov,C,BOS,24,12,0,0,0
9,8479421,Jacob Moverare,D,LAK,26,10,0,0,0
9,8481726,Adam Edstrom,C,NYR,24,10,0,0,0
9,8483609,Adam Klapka,R,CGY,24,1,0,0,0
9,8483546,Marshall Rifai,D,TOR,26,2,0,0,0
9,8484321,Nikolas Matinpalo,D,OTT,26,0,0,0,0
9,8477993,Justin Kirkland,C,CGY,28,6,0,0,0
9,8483531,Brian Halonen,L,NJD,25,3,0,0,0
9,8484326,Patrik Koch,D,UTA,28,1,0,0,0
9,8482476,Emil Heineman,L,MTL,23,4,0,0,0
9,8482787,Nikita Chibrikov,R,WPG,31,7,0,0,0
9,8482126,Emil Andrae,D,PHI,31,3,0,0,0
9,8484259,Ondrej Pavel,C,COL,31,0,0,0,0
9,8470794,Joe Pavelski,C,,40,0,0,0,0
9,8479321,Lucas Johansen,D,,27,0,0,0,0
9,8477950,Tony DeAngelo,D,,29,0,0,0,0
9,8471218,Blake Wheeler,R,,38,0,0,0,0
9,8475197,Tyson Barrie,D,,33,0,0,0,0
9,8474157,Max Pacioretty,L,,36,0,0,0,0
9,8475744,Evgeny Kuznetsov,C,,32,0,0,0,0
9,8474037,James van Riemsdyk,L,,35,0,0,0,0
9,8476907,Mackenzie MacEachern,L,,30,0,0,0,0
9,8480216,Jacob Peterson,C,,25,0,0,0,0
9,8474602,Justin Schultz,D,,34,0,0,0,0
9,8482222,Alexander Barabanov,L,,30,0,0,0,0
9,8474031,Kevin Shattenkirk,D,,35,0,0,0,0
9,8477330,Dominik Kubalik,L,,29,0,0,0,0
9,8480884,Calen Addison,D,,24,0,0,0,0
9,8475906,John Klingberg,D,,32,0,0,0,0
9,8480008,Adam Ruzicka,C,,25,0,0,0,0
9,8476884,Derrick Pouliot,D,,30,0,0,0,0
9,8476919,Chris Tierney,C,,30,0,0,0,0
9,8479415,Michael McLeod,C,,26,0,0,0,0
9,8474870,Tyler Johnson,C,,34,0,0,0,0
9,8470604,Jeff Carter,C,,39,0,0,0,0
9,8478104,Sammy Blais,L,,28,0,0,0,0
9,8474884,Mike Hoffman,C,,35,0,0,0,0
9,8481591,Sam Poulin,R,,23,0,0,0,0
9,8471274,Alex Goligoski,D,,39,0,0,0,0
9,8476871,Tanner Pearson,L,,32,0,0,0,0
9,8476393,Nick Cousins,C,,31,0,0,0,0
9,8479977,Kailer Yamamoto,R,,26,0,0,0,0
9,8479346,Dillon Dube,C,,26,0,0,0,0
9,8480184,Gustav Lindstrom,D,,26,0,0,0,0
9,8479376,Victor Mete,D,,26,0,0,0,0
9,8473449,Kyle Okposo,R,,36,0,0,0,0
9,8481058,Jesse Ylonen,R,,25,0,0,0,0
9,8475752,Tyler Pitlick,C,,33,0,0,0,0
9,8481239,Samuel Fagemo,L,,24,0,0,0,0
9,8480821,Filip Zadina,R,,25,0,0,0,0
9,8470966,Mark Giordano,D,,41,0,0,0,0
9,8478495,Denis Gurianov,R,,27,0,0,0,0
9,8477464,Nic Petan,C,,29,0,0,0,0
9,8478099,Kevin Labanc,R,,29,0,0,0,0
9,8482241,Radim Zohorna,L,,28,0,0,0,0
9,8474040,Sam Gagner,C,,35,0,0,0,0
9,8479514,Rem Pitlick,C,,27,0,0,0,0
9,8478430,Oliver Kylington,D,,27,0,0,0,0
9,8479533,Joona Koppanen,L,,26,0,0,0,0
9,8479984,Cal Foote,D,,26,0,0,0,0
9,8477126,Jayson Megna,C,,34,0,0,0,0
9,8475164,Jakob Silfverberg,R,,34,0,0,0,0
9,8474009,Nick Bonino,C,,36,0,0,0,0
9,8479458,Nikita Zaitsev,D,,33,0,0,0,0
9,8477944,Jakub Vrana,L,,28,0,0,0,0
9,8471699,Andrew Cogliano,C,,37,0,0,0,0
9,8478067,Oskar Lindblom,L,,28,0,0,0,0
9,8471686,Marc Staal,D,,37,0,0,0,0
9,8470610,Zach Parise,L,,40,0,0,0,0
9,8478904,Steven Lorentz,C,,28,0,0,0,0
9,8473473,Milan Lucic,L,,36,0,0,0,0
9,8480031,Maxime Comtois,L,,25,0,0,0,0
9,8478512,Austin Czarnik,C,,32,0,0,0,0
9,8473504,Cal Clutterbuck,R,,37,0,0,0,0
9,8477454,Adam Erne,L,,29,0,0,0,0
9,8479383,Boris Katchouk,L,,26,0,0,0,0
9,8475825,Jani Hakanpää,D,,32,0,0,0,0
9,8477846,Ryan Carpenter,C,,33,0,0,0,0
9,8477930,Pierre-Edouard Bellemare,L,,39,0,0,0,0
9,8478400,Colin White,C,,27,0,0,0,0
9,8480226,Marián Studenic,R,,26,0,0,0,0
9,8480853,Liam Foudy,C,,24,0,0,0,0
9,8475797,Jarred Tinordi,D,,32,0,0,0,0
9,8479423,Alex Nylander,L,,26,0,0,0,0
9,8474618,Marco Scandella,D,,34,0,0,0,0
9,8478028,Fredrik Olofsson,L,,28,0,0,0,0
9,8474709,Matt Martin,L,,35,0,0,0,0
9,8481070,Hugh McGing,L,,26,0,0,0,0
9,8479546,Oskar Steen,C,,26,0,0,0,0
9,8474145,Robert Bortuzzo,D,,35,0,0,0,0
9,8476915,Jujhar Khaira,L,,30,0,0,0,0
9,8480274,Philip Kemp,D,EDM,25,0,0,0,0
9,8475278,Byron Froese,C,,33,0,0,0,0
9,8481812,Nikolai Knyzhov,D,,27,0,0,0,0
9,8478408,Travis Dermott,D,,28,0,0,0,0
9,8481077,John Leonard,L,,26,0,0,0,0
9,8479547,Matthew Phillips,R,,26,0,0,0,0
9,8480836,Jonathan Gruden,C,,24,0,0,0,0
9,8481690,Tyler Angle,C,,24,0,0,0,0
9,8475766,Austin Watson,L,,32,0,0,0,0
9,8481016,Ruslan Iskhakov,C,,24,0,0,0,0
9,8478078,Rourke Chartier,C,,28,0,0,0,0
9,8480776,Sheldon Rempal,R,,29,0,0,0,0
9,8478956,Samuel Laberge,L,NJD,27,1,0,0,0
9,8483045,Cameron Butler,R,CBJ,31,1,0,0,0
9,8481534,Raphael Lavoie,C,EDM,24,3,0,0,0
9,8484314,Jiri Smejkal,L,,28,0,0,0,0
10,8478402,Connor McDavid,C,EDM,27,80,43,105,148
10,8477492,Nathan MacKinnon,C,COL,29,81,58,87,145
10,8479318,Auston Matthews,C,TOR,27,77,67,51,118
10,8476453,Nikita Kucherov,R,TBL,31,81,34,81,115
10,8480012,Elias Pettersson,C,VAN,26,76,40,74,114
10,8481559,Jack Hughes,C,NJD,23,75,48,64,112
10,8477942,Kevin Fiala,L,LAK,28,81,31,79,110
10,8477956,David Pastrnak,R,BOS,28,81,55,54,109
10,8480002,Nico Hischier,C,NJD,25,75,36,70,106
10,8477493,Aleksander Barkov,C,FLA,29,79,31,74,105
10,8478864,Kirill Kaprizov,L,MIN,27,73,38,66,104
10,8478483,Mitch Marner,R,TOR,27,78,33,71,104
10,8478420,Mikko Rantanen,R,COL,28,81,48,55,103
10,8476468,J.T. Miller,C,VAN,31,80,34,69,103
10,8477939,William Nylander,R,TOR,28,77,46,54,100
10,8480069,Cale Makar,D,COL,26,63,22,76,98
10,8477501,Valeri Nichushkin,R,COL,29,82,38,58,96
10,8482116,Tim Stützle,C,OTT,22,78,37,59,96
10,8477404,Jake Guentzel,C,TBL,30,82,34,61,95
10,8479314,Matthew Tkachuk,L,FLA,27,77,34,59,93
10,8476460,Mark Scheifele,C,WPG,31,73,26,67,93
10,8477960,Adrian Kempe,R,LAK,28,81,44,48,92
10,8478427,Sebastian Aho,C,CAR,27,73,45,46,91
10,8471675,Sidney Crosby,C,PIT,37,72,43,48,91
10,8477409,Carter Verhaeghe,C,FLA,29,80,42,49,91
10,8479337,Alex DeBrincat,R,DET,27,81,43,47,90
10,8477934,Leon Draisaitl,C,EDM,29,77,38,51,89
10,8477933,Sam Reinhart,C,FLA,29,78,39,49,88
10,8477946,Dylan Larkin,C,DET,28,80,38,50,88
10,8478550,Artemi Panarin,L,NYR,33,80,33,55,88
10,8480800,Quinn Hughes,D,VAN,25,73,8,80,88
10,8478010,Brayden Point,C,TBL,28,81,37,49,86
10,8480027,Jason Robertson,L,DAL,25,82,32,54,86
10,8473419,Brad Marchand,L,BOS,36,79,32,54,86
10,8480801,Brady Tkachuk,L,OTT,25,81,31,55,86
10,8474564,Steven Stamkos,C,NSH,34,73,36,48,84
10,8478403,Jack Eichel,C,VGK,28,75,43,38,81
10,8475166,John Tavares,C,TOR,34,79,31,50,81
10,8480865,Noah Dobson,D,NYI,24,80,18,63,81
10,8478398,Kyle Connor,L,WPG,28,74,47,32,79
10,8479385,Jordan Kyrou,C,STL,26,73,35,44,79
10,8476887,Filip Forsberg,L,NSH,30,70,32,47,79
10,8481557,Matt Boldy,L,MIN,23,72,36,42,78
10,8474600,Roman Josi,D,NSH,34,71,24,54,78
10,8478445,Mathew Barzal,C,NYI,27,79,17,61,78
10,8482093,Seth Jarvis,C,CAR,22,71,23,54,77
10,8478414,Timo Meier,R,NJD,28,71,33,43,76
10,8480023,Robert Thomas,C,STL,25,73,20,56,76
10,8479407,Jesper Bratt,L,NJD,26,79,28,47,75
10,8477949,Alex Tuch,R,BUF,28,77,28,47,75
10,8478444,Brock Boeser,R,VAN,27,73,32,41,73
10,8477494,Jonathan Drouin,L,COL,29,81,23,50,73
10,8478460,Zach Werenski,D,CBJ,27,77,21,52,73
10,8475172,Nazem Kadri,C,CGY,34,79,35,37,72
10,8479542,Brandon Hagel,L,TBL,26,82,31,41,72
10,8481540,Cole Caufield,R,MTL,23,70,41,30,71
10,8479343,Clayton Keller,R,UTA,26,77,25,46,71
10,8474141,Patrick Kane,R,DET,36,79,25,46,71
10,8471215,Evgeni Malkin,C,PIT,38,74,25,45,70
10,8471214,Alex Ovechkin,L,WSH,39,74,36,33,69
10,8477955,Jared McCann,L,SEA,28,74,32,36,68
10,8476881,Tomas Hertl,C,VGK,31,78,30,38,68
10,8476459,Mika Zibanejad,C,NYR,31,79,28,40,68
10,8476454,Ryan Nugent-Hopkins,C,EDM,31,79,23,45,68
10,8476346,Johnny Gaudreau,L,CBJ,31,73,17,51,68
10,8479420,Tage Thompson,C,BUF,27,66,34,33,67
10,8480830,Andrei Svechnikov,R,CAR,24,64,27,40,67
10,8478439,Travis Konecny,R,PHI,27,76,26,41,67
10,8477496,Elias Lindholm,C,BOS,30,81,26,41,67
10,8476479,Phillip Danault,C,LAK,31,76,24,43,67
10,8481068,Yegor Sharangovich,C,CGY,26,79,23,44,67
10,8475913,Mark Stone,R,VGK,32,79,17,50,67
10,8476456,Jonathan Huberdeau,C,CGY,31,78,14,53,67
10,8476539,Jonathan Marchessault,R,NSH,34,73,35,31,66
10,8477940,Nikolaj Ehlers,L,WPG,28,72,23,43,66
10,8479999,Casey Mittelstadt,C,COL,26,80,27,38,65
10,8479325,Charlie McAvoy,D,BOS,27,76,16,49,65
10,8480208,Drake Batherson,R,OTT,26,76,30,34,64
10,8475158,Ryan O'Reilly,C,NSH,33,70,24,40,64
10,8478440,Dylan Strome,C,WSH,27,75,24,40,64
10,8475168,Matt Duchene,C,DAL,33,82,23,41,64
10,8478407,Vince Dunn,D,SEA,28,74,13,51,64
10,8473994,Jamie Benn,L,DAL,35,82,29,34,63
10,8482124,Quinton Byfield,R,LAK,22,79,26,37,63
10,8480839,Rasmus Dahlin,D,BUF,24,73,17,46,63
10,8480036,Miro Heiskanen,D,DAL,25,80,14,49,63
10,8479323,Adam Fox,D,NYR,26,77,7,56,63
10,8476448,William Karlsson,C,VGK,31,74,29,33,62
10,8479400,Pierre-Luc Dubois,L,WSH,26,70,28,34,62
10,8477416,Oliver Bjorkstrand,R,SEA,29,74,27,35,62
10,8477402,Pavel Buchnevich,L,STL,29,78,26,36,62
10,8481528,Dylan Cozens,C,BUF,23,74,25,37,62
10,8484144,Connor Bedard,C,CHI,19,69,19,43,62
10,8474578,Erik Karlsson,D,PIT,34,78,18,44,62
10,8476853,Morgan Rielly,D,TOR,30,69,5,57,62
10,8475784,Jeff Skinner,C,EDM,32,74,29,32,61
10,8482699,Dylan Guenther,R,UTA,21,73,27,34,61
10,8478856,Conor Garland,R,VAN,28,74,27,33,60
10,8476826,Yanni Gourde,C,SEA,33,71,26,34,60
10,8482684,Luke Hughes,D,NJD,21,77,7,53,60
10,8477500,Bo Horvat,C,NYI,29,77,34,25,59
10,8477935,Sam Bennett,C,FLA,28,77,25,34,59
10,8476389,Vincent Trocheck,C,NYR,31,74,21,38,59
10,8471724,Kris Letang,D,PIT,37,79,15,44,59
10,8477504,Josh Morrissey,D,WPG,29,77,10,49,59
10,8477451,Ryan Hartman,R,MIN,30,71,28,30,58
10,8482078,Lucas Raymond,L,DET,22,82,26,32,58
10,8476432,Boone Jenner,C,CBJ,31,70,24,34,58
10,8475170,Brayden Schenn,C,STL,33,75,22,36,58
10,8482665,Matty Beniers,C,SEA,22,74,19,39,58
10,8475692,Mats Zuccarello,R,MIN,37,70,16,42,58
10,8475786,Zach Hyman,L,EDM,32,76,26,31,57
10,8478449,Roope Hintz,C,DAL,28,82,26,31,57
10,8478047,Michael Bunting,L,PIT,29,70,19,38,57
10,8480018,Nick Suzuki,C,MTL,25,75,18,39,57
10,8475184,Chris Kreider,L,NYR,33,74,34,22,56
10,8478498,Jake DeBrusk,L,VAN,28,75,29,27,56
10,8480015,Owen Tippett,R,PHI,25,76,26,30,56
10,8474586,Jordan Eberle,R,SEA,34,68,16,40,56
10,8476399,Blake Coleman,C,CGY,33,78,36,19,55
10,8479675,Trevor Moore,L,LAK,29,82,27,28,55
10,8482159,Tyson Foerster,R,PHI,22,71,21,34,55
10,8475810,Bryan Rust,R,PIT,32,75,17,38,55
10,8477456,J.T. Compher,L,DET,29,79,17,38,55
10,8474563,Drew Doughty,D,LAK,35,71,10,45,55
10,8478519,Anthony Cirelli,C,TBL,27,82,26,28,54
10,8480039,Martin Necas,C,CAR,25,74,23,31,54
10,8477964,Ivan Barbashev,C,VGK,29,74,21,33,54
10,8478975,Mason Marchment,L,DAL,29,81,18,36,54
10,8480803,Evan Bouchard,D,EDM,25,75,10,44,54
10,8474590,John Carlson,D,WSH,34,69,10,44,54
10,8476958,Jaccob Slavin,D,CAR,30,78,13,40,53
10,8475753,Justin Faulk,D,STL,32,71,11,42,53
10,8475167,Victor Hedman,D,TBL,34,80,10,43,53
10,8483808,Andrei Kuzmenko,L,CGY,28,76,22,30,52
10,8478873,Troy Terry,R,ANA,27,73,20,32,52
10,8477951,Nick Schmaltz,C,UTA,28,77,18,34,52
10,8477986,Brandon Montour,D,SEA,30,71,15,37,52
10,8475169,Evander Kane,L,EDM,33,74,28,23,51
10,8480064,Josh Norris,C,OTT,25,78,27,24,51
10,8482740,Wyatt Johnston,C,DAL,21,82,26,25,51
10,8477476,Artturi Lehkonen,L,COL,29,80,25,26,51
10,8482745,Mason McTavish,C,ANA,21,76,23,28,51
10,8478493,Joel Eriksson Ek,C,MIN,27,76,21,30,51
10,8477444,Andre Burakovsky,L,SEA,29,74,20,31,51
10,8482113,Anton Lundell,C,FLA,23,77,25,25,50
10,8481560,Arthur Kaliyev,R,LAK,23,80,24,26,50
10,8482109,Alexis Lafrenière,L,NYR,23,70,22,28,50
10,8478401,Pavel Zacha,C,BOS,27,79,20,30,50
10,8475765,Vladimir Tarasenko,R,DET,33,82,20,30,50
10,8474150,Mikael Backlund,C,CGY,35,78,19,31,50
10,8484153,Leo Carlsson,C,ANA,20,68,18,32,50
10,8475798,Mikael Granlund,C,SJS,32,71,16,34,50
10,8481533,Trevor Zegras,C,ANA,23,71,16,34,50
10,8480014,Gabriel Vilardi,C,WPG,25,73,36,13,49
10,8473986,Alex Killorn,L,ANA,35,66,24,25,49
10,8482146,Luke Evangelista,R,NSH,22,68,24,25,49
10,8478233,Andrew Mangiapane,L,WSH,28,70,17,32,49
10,8478042,Viktor Arvidsson,L,EDM,31,76,16,33,49
10,8478472,Mathieu Joseph,R,STL,27,70,15,34,49
10,8479410,Mikhail Sergachev,D,UTA,26,77,10,39,49
10,8484166,Adam Fantilli,C,CBJ,20,70,24,24,48
10,8477407,Anthony Duclair,L,NYI,29,76,22,26,48
10,8475314,Anders Lee,L,NYI,34,80,22,26,48
10,8479987,Morgan Geekie,C,BOS,26,75,20,28,48
10,8477503,Max Domi,C,TOR,29,78,15,33,48
10,8477932,Aaron Ekblad,D,FLA,28,72,14,34,48
10,8483515,Juraj Slafkovsky,L,MTL,20,75,12,36,48
10,8473512,Claude Giroux,R,OTT,36,75,11,37,48
10,8477998,Warren Foegele,L,LAK,28,80,24,23,47
10,8482092,Ridly Greig,C,OTT,22,79,24,23,47
10,8476882,Teuvo Teravainen,C,CHI,30,72,24,23,47
10,8478474,Lawson Crouse,L,UTA,27,75,22,25,47
10,8481596,Shane Pinto,C,OTT,24,73,17,30,47
10,8476905,Chandler Stephenson,C,SEA,30,70,13,34,47
10,8481186,Logan O'Connor,R,COL,28,79,23,23,46
10,8480188,Fabian Zetterlund,L,SJS,25,72,20,26,46
10,8479591,Michael Eyssimont,C,TBL,28,82,20,26,46
10,8476292,Ondrej Palat,L,NJD,33,68,19,27,46
10,8479992,Michael Rasmussen,C,DET,25,79,17,29,46
10,8474679,Gustav Nyquist,C,NSH,35,70,16,30,46
10,8482149,Cole Perfetti,C,WPG,22,72,16,30,46
10,8482720,Matthew Knies,L,TOR,22,78,14,32,46
10,8474102,David Perron,L,OTT,36,78,13,33,46
10,8474565,Alex Pietrangelo,D,VGK,34,64,10,36,46
10,8481703,Valtteri Puustinen,R,PIT,25,68,10,36,46
10,8479345,Jakob Chychrun,D,WSH,26,60,24,21,45
10,8478366,Frank Vatrano,R,ANA,30,72,23,22,45
10,8481618,Alex Newhook,C,MTL,23,72,21,24,45
10,8478542,Evan Rodrigues,C,FLA,31,73,20,25,45
10,8482110,Dawson Mercer,C,NJD,23,73,20,25,45
10,8482475,Yegor Chinakhov,R,CBJ,23,65,18,27,45
10,8481711,Matias Maccelli,L,UTA,24,77,14,31,45
10,8474641,Adam Henrique,C,EDM,34,77,23,21,44
10,8475794,Tyler Seguin,C,DAL,32,81,22,22,44
10,8475287,Erik Haula,L,NJD,33,73,19,25,44
10,8475754,Brock Nelson,C,NYI,33,79,18,26,44
10,8479525,Ross Colton,C,COL,28,80,17,27,44
10,8477346,MacKenzie Weegar,D,CGY,30,73,15,29,44
10,8477497,Sean Monahan,C,CBJ,30,72,14,30,44
10,8470613,Brent Burns,D,CAR,39,75,12,32,44
10,8479425,Filip Hronek,D,VAN,27,72,11,33,44
10,8476906,Shayne Gostisbehere,D,CAR,31,77,11,33,44
10,8476875,Mike Matheson,D,MTL,30,74,9,35,44
10,8478458,John (Jack) Roslovic,C,CAR,27,72,17,26,43
10,8481604,Pavel Dorofeyev,L,VGK,24,73,16,27,43
10,8478462,Nicolas Roy,C,VGK,27,78,15,28,43
10,8483431,Logan Cooley,C,UTA,20,73,14,29,43
10,8471685,Anze Kopitar,C,LAK,37,80,13,30,43
10,8476792,Torey Krug,D,STL,33,75,11,32,43
10,8477495,Seth Jones,D,CHI,30,68,9,34,43
10,8475714,Calle Jarnkrok,C,TOR,33,76,26,16,42
10,8476438,Brandon Saad,L,STL,32,80,26,16,42
10,8477479,Tyler Bertuzzi,L,CHI,29,62,19,23,42
10,8476854,Hampus Lindholm,D,BOS,30,75,8,34,42
10,8481535,Nils Hoglander,L,VAN,24,71,27,14,41
10,8480009,Eeli Tolvanen,R,SEA,25,72,25,16,41
10,8480797,Joel Farabee,L,PHI,24,72,14,27,41
10,8479293,Brandon Tanev,L,SEA,33,70,13,28,41
10,8475768,Jaden Schwartz,C,SEA,32,71,22,18,40
10,8479365,Trent Frederic,C,BOS,26,77,16,24,40
10,8475793,Ryan Johansen,C,PHI,32,72,16,24,40
10,8477021,Alex Kerfoot,C,UTA,30,69,9,31,40
10,8477447,Shea Theodore,D,VGK,29,58,8,32,40
10,8481542,Moritz Seider,D,DET,23,79,8,32,40
10,8475726,Tyler Toffoli,C,SJS,32,61,23,16,39
10,8480220,Noah Cates,L,PHI,25,70,18,21,39
10,8482097,Jack Quinn,R,BUF,23,62,16,23,39
10,8477511,Anthony Mantha,R,CGY,30,75,13,26,39
10,8482712,Oskar Olausson,R,COL,22,80,10,29,39
10,8481523,Kirby Dach,C,MTL,23,69,9,30,39
10,8475799,Nino Niederreiter,R,WPG,32,62,22,16,38
10,8471698,T.J. Oshie,R,WSH,38,67,22,16,38
10,8480113,Alex Iafallo,L,WPG,31,66,22,16,38
10,8478115,Pierre Engvall,L,NYI,28,77,21,17,38
10,8475191,Reilly Smith,R,NYR,33,78,19,19,38
10,8476880,Tom Wilson,R,WSH,30,69,15,23,38
10,8477429,Andrew Copp,C,DET,30,79,14,24,38
10,8474053,Logan Couture,C,SJS,35,65,13,25,38
10,8475763,Kevin Hayes,R,PIT,32,68,13,25,38
10,8481606,Jordan Spence,D,LAK,23,68,7,31,38
10,8475151,Kyle Palmieri,C,NYI,33,81,18,19,37
10,8477426,Nicholas Paul,L,TBL,29,82,18,19,37
10,8478469,Thomas Chabot,D,OTT,27,74,11,26,37
10,8481524,Bowen Byram,D,BUF,23,67,10,27,37
10,8476461,Sean Couturier,C,PHI,32,68,10,27,37
10,8478038,Devon Toews,D,COL,30,66,7,30,37
10,8480145,Neal Pionk,D,WPG,29,69,7,30,37
10,8482175,JJ Peterka,R,BUF,22,72,21,15,36
10,8476872,Scott Laughton,C,PHI,30,69,18,18,36
10,8475745,Charlie Coyle,C,BOS,32,76,14,22,36
10,8478046,Danton Heinen,L,VAN,29,69,14,22,36
10,8482125,Alexander Holtz,R,VGK,22,73,13,23,36
10,8478438,Tommy Novak,C,NSH,27,74,12,24,36
10,8477948,Travis Sanheim,D,PHI,28,72,5,31,36
10,8479398,Samuel Girard,D,COL,26,61,4,32,36
10,8480849,Barrett Hayton,C,UTA,24,72,21,14,35
10,8478109,Victor Olofsson,L,VGK,29,69,20,15,35
10,8479390,Taylor Raddysh,R,WSH,26,69,18,17,35
10,8477952,Robby Fabbri,C,ANA,28,68,17,18,35
10,8482702,Logan Stankoven,C,DAL,21,79,16,19,35
10,8481553,Bobby Brink,R,PHI,23,66,16,19,35
10,8483505,Matthew Poitras,C,BOS,20,78,14,21,35
10,8476462,Dougie Hamilton,D,NJD,31,69,12,23,35
10,8476419,Jean-Gabriel Pageau,C,NYI,32,72,12,23,35
10,8476869,Brady Skjei,D,NSH,30,74,6,29,35
10,8479661,Tanner Jeannot,L,LAK,27,79,22,12,34
10,8478463,Anthony Beauvillier,L,PIT,27,70,18,16,34
10,8476483,Rickard Rakell,R,PIT,31,67,16,18,34
10,8474149,Evgenii Dadonov,R,DAL,35,81,15,19,34
10,8482667,William Eklund,L,SJS,22,64,15,19,34
10,8477839,Conor Sheary,L,TBL,32,82,15,19,34
10,8477425,Miles Wood,L,COL,29,77,12,22,34
10,8478891,Mason Appleton,C,WPG,28,67,11,23,34
10,8482089,Jake Neighbours,L,STL,22,65,24,9,33
10,8482055,Drew O'Connor,L,PIT,26,71,19,14,33
10,8480078,Filip Chytil,C,NYR,25,69,14,19,33
10,8478466,Daniel Sprong,R,VAN,27,70,13,20,33
10,8480798,Philipp Kurashev,C,CHI,25,65,12,21,33
10,8475218,Mattias Ekholm,D,EDM,34,71,11,22,33
10,8476392,Adam Lowry,C,WPG,31,69,11,22,33
10,8480459,Pius Suter,C,VAN,28,67,10,23,33
10,8481581,Thomas Harley,D,DAL,23,80,10,23,33
10,8480871,Adam Boqvist,D,FLA,24,66,9,24,33
10,8476463,Jonas Brodin,D,MIN,31,76,4,29,33
10,8480068,Ryan Poehling,C,PHI,25,71,16,16,32
10,8479339,Patrik Laine,L,CBJ,26,60,13,19,32
10,8481577,Philip Tomasino,C,NSH,23,67,12,20,32
10,8480802,Ryan McLeod,C,BUF,25,63,10,22,32
10,8478970,Jalen Chatfield,D,CAR,28,72,10,22,32
10,8482671,Owen Power,D,BUF,22,66,6,26,32
10,8480829,Jesperi Kotkaniemi,C,CAR,24,66,19,12,31
10,8475722,Jason Zucker,L,BUF,32,67,18,13,31
10,8475848,Brendan Gallagher,R,MTL,32,70,16,15,31
10,8473533,Jordan Staal,C,CAR,36,59,16,15,31
10,8480003,Jesper Boqvist,C,FLA,26,72,16,15,31
10,8475760,Nick Bjugstad,C,UTA,32,70,15,16,31
10,8473422,Nick Foligno,L,CHI,37,59,14,17,31
10,8479393,Noah Gregor,L,OTT,26,75,13,18,31
10,8476921,Jordan Martinook,L,CAR,32,65,13,18,31
10,8484145,Zach Benson,L,BUF,19,63,11,20,31
10,8476458,Ryan Strome,C,ANA,31,66,11,20,31
10,8477506,Ryan Pulock,D,NYI,30,79,7,24,31
10,8478397,Rasmus Andersson,D,CGY,28,70,6,25,31
10,8478396,Noah Hanifin,D,VGK,27,62,5,26,31
10,8482259,Bobby McMann,C,TOR,28,66,19,11,30
10,8478057,Dakota Joshua,C,VAN,28,66,18,12,30
10,8481554,Kaapo Kakko,R,NYR,23,68,16,14,30
10,8482705,Cole Sillinger,C,CBJ,21,67,15,15,30
10,8480028,Morgan Frost,C,PHI,25,79,14,16,30
10,8480185,Eetu Luostarinen,C,FLA,26,70,13,17,30
10,8477498,Darnell Nurse,D,EDM,29,75,11,19,30
10,8480434,Sean Durzi,D,UTA,26,71,10,20,30
10,8480835,Jack Drury,C,CAR,24,61,10,20,30
10,8475149,Marcus Johansson,L,MIN,34,63,9,21,30
10,8482105,Jake Sanderson,D,OTT,22,75,9,21,30
10,8477488,Brett Pesce,D,NJD,30,67,4,26,30
10,8475764,Cam Fowler,D,ANA,33,67,0,30,30
10,8479315,Joey Anderson,R,CHI,26,57,16,13,29
10,8482074,Connor Zary,C,CGY,23,66,14,15,29
10,8476960,Andreas Athanasiou,C,CHI,30,59,13,16,29
10,8481477,Nico Sturm,C,SJS,29,61,11,18,29
10,8475200,Dmitry Orlov,D,CAR,33,76,8,21,29
10,8475791,Taylor Hall,L,CHI,33,63,8,21,29
10,8480817,K'Andre Miller,D,NYR,24,75,7,22,29
10,8478055,Gustav Forsling,D,FLA,28,75,5,24,29
10,8483490,Pavel Mintyukov,D,ANA,21,77,5,24,29
10,8476897,Oskar Sundqvist,C,STL,30,62,14,14,28
10,8476927,Teddy Blueger,C,VAN,30,68,14,14,28
10,8480855,Jack McBain,C,UTA,24,71,13,15,28
10,8481580,Connor McMichael,C,WSH,23,56,12,16,28
10,8480893,Kirill Marchenko,R,CBJ,24,58,12,16,28
10,8482660,Kent Johnson,C,CBJ,22,62,11,17,28
10,8483445,Cutter Gauthier,L,ANA,20,63,11,17,28
10,8479351,Sam Steel,C,DAL,26,79,9,19,28
10,8477987,Ryan Donato,C,CHI,28,61,9,19,28
10,8482101,Danil Gushchin,L,SJS,22,64,8,20,28
10,8478911,Matt Roy,D,WSH,29,69,7,21,28
10,8477969,Marcus Pettersson,D,PIT,28,78,5,23,28
10,8480336,Sean Walker,D,CAR,30,69,4,24,28
10,8479368,Max Jones,L,BOS,26,67,12,15,27
10,8481093,Rafael Harvey-Pinard,L,MTL,25,62,10,17,27
10,8477947,Sonny Milano,L,WSH,28,63,10,17,27
10,8473453,Trevor Lewis,C,LAK,37,76,10,17,27
10,8476457,Adam Larsson,D,SEA,32,69,8,19,27
10,8476892,Colton Parayko,D,STL,31,74,8,19,27
10,8484203,Bradly Nadeau,L,CAR,19,64,6,21,27
10,8478020,Michael Amadio,R,OTT,28,73,18,8,26
10,8476981,Josh Anderson,R,MTL,30,73,16,10,26
10,8474189,Lars Eller,C,PIT,35,61,14,12,26
10,8475343,Nic Dowd,C,WSH,34,59,14,12,26
10,8476474,Stefan Noesen,R,NJD,31,66,12,14,26
10,8478413,Jordan Greenway,L,BUF,27,58,12,14,26
10,8481032,Paul Cotter,C,NJD,25,65,12,14,26
10,8476480,Vladislav Namestnikov,C,WPG,32,66,10,16,26
10,8477903,Garnet Hathaway,R,PHI,33,67,10,16,26
10,8480049,Dylan Samberg,D,WPG,25,68,4,22,26
10,8478840,Will Borgen,D,SEA,28,64,4,22,26
10,8478500,Ivan Provorov,D,CBJ,27,81,3,23,26
10,8474151,Ryan McDonagh,D,TBL,35,80,1,25,26
10,8476878,Zemgus Girgensons,C,TBL,30,82,15,10,25
10,8483524,Shane Wright,C,SEA,20,67,14,11,25
10,8474715,Cameron Atkinson,R,TBL,35,82,14,11,25
10,8479316,Luke Kunin,C,SJS,27,59,11,14,25
10,8480995,Pontus Holmberg,R,TOR,25,58,10,15,25
10,8477573,Nathan Walker,L,STL,30,47,10,15,25
10,8481522,Peyton Krebs,C,BUF,23,69,9,16,25
10,8476469,Joel Armia,R,MTL,31,71,8,17,25
10,8476979,Erik Gustafsson,D,DET,32,73,2,23,25
10,8477953,Kasperi Kapanen,R,STL,28,70,17,7,24
10,8476278,Colin Blackwell,C,DAL,31,75,15,9,24
10,8480762,Eric Robinson,L,CAR,29,46,15,9,24
10,8482155,Alex Laferriere,R,LAK,23,61,13,11,24
10,8470621,Corey Perry,R,EDM,39,68,12,12,24
10,8478013,Jake Walman,D,SJS,28,73,12,12,24
10,8481582,Nicholas Robertson,L,TOR,23,69,11,13,24
10,8479941,Justin Danforth,R,CBJ,31,52,11,13,24
10,8482079,Marco Rossi,C,MIN,23,58,11,13,24
10,8477392,Hudson Fasching,R,NYI,29,65,10,14,24
10,8478133,Jake Evans,C,MTL,28,65,8,16,24
10,8476918,Jimmy Vesey,L,NYR,31,72,8,16,24
10,8482157,Will Cuylle,L,NYR,22,67,8,16,24
10,8476331,Dylan DeMelo,D,WPG,31,70,6,18,24
10,8482122,Brock Faber,D,MIN,22,81,5,19,24
10,8481656,Aliaksei Protas,C,WSH,23,63,5,19,24
10,8476312,Josh Manson,D,COL,33,63,5,19,24
10,8475790,Erik Gudbranson,D,CBJ,32,75,4,20,24
10,8481546,Cam York,D,PHI,23,68,4,20,24
10,8479439,Jacob MacDonald,D,COL,31,51,14,9,23
10,8479996,Cody Glass,C,NSH,25,56,11,12,23
10,8475220,Marcus Foligno,L,MIN,33,59,11,12,23
10,8483499,Liam Ohgren,L,MIN,20,55,10,13,23
10,8477989,Christian Dvorak,C,MTL,28,73,8,15,23
10,8482166,Shakir Mukhamadullin,D,SJS,22,56,8,15,23
10,8476917,Adam Pelech,D,NYI,30,79,6,17,23
10,8473563,Nicklas Backstrom,C,WSH,37,62,5,18,23
10,8482133,Thomas Bordeleau,C,SJS,22,58,5,18,23
10,8475462,Radko Gudas,D,ANA,34,70,5,18,23
10,8481019,David Gustafsson,C,WPG,24,47,5,18,23
10,8477220,Nate Schmidt,D,FLA,33,64,4,19,23
10,8476422,Mike Reilly,D,NYI,31,73,4,19,23
10,8479619,Michael Carcone,L,UTA,28,61,16,6,22
10,8482117,Lukas Reichel,L,CHI,22,57,14,8,22
10,8481624,Ilya Mikheyev,R,CHI,30,61,13,9,22
10,8476873,Mark Jankowski,C,NSH,30,60,13,9,22
10,8478043,Sam Lafferty,C,BUF,29,64,13,9,22
10,8482111,Justin Barron,D,MTL,23,65,9,13,22
10,8481521,Ronnie Attard,D,PHI,25,62,9,13,22
10,8476467,Jamie Oleksiak,D,SEA,32,71,7,15,22
10,8482148,Hendrix Lapierre,C,WSH,22,56,7,15,22
10,8474034,Patrick Maroon,L,CHI,36,48,5,17,22
10,8476923,Damon Severson,D,CBJ,30,80,4,18,22
10,8476879,Cody Ceci,D,EDM,31,74,4,18,22
10,8476885,Jacob Trouba,D,NYR,30,71,2,20,22
10,8475181,Nick Leddy,D,STL,33,72,1,21,22
10,8476374,Sean Kuraly,C,CBJ,31,65,12,9,21
10,8481517,Brett Leason,R,ANA,25,57,12,9,21
10,8478432,Christian Fischer,R,DET,27,70,11,10,21
10,8482067,Connor Mackey,D,NYR,28,53,9,12,21
10,8477478,William Carrier,L,CAR,30,60,8,13,21
10,8478178,Darren Raddysh,D,TBL,28,74,8,13,21
10,8480144,David Kampf,C,TOR,29,76,7,14,21
10,8482142,Jamie Drysdale,D,PHI,22,65,7,14,21
10,8483482,Tristan Luneau,D,ANA,20,63,7,14,21
10,8480789,Oliver Wahlstrom,R,NYI,24,67,6,15,21
10,8480878,Nils Lundkvist,D,DAL,24,72,6,15,21
10,8483565,Nick Blankenburg,D,NSH,26,64,6,15,21
10,8474166,Alec Martinez,D,CHI,37,54,6,15,21
10,8483457,Lane Hutson,D,MTL,20,68,5,16,21
10,8482655,Janis Moser,D,TBL,24,78,5,16,21
10,8476891,Matthew Grzelcyk,D,PIT,30,75,4,17,21
10,8480043,Timothy Liljegren,D,TOR,25,66,3,18,21
10,8477507,Nikita Zadorov,D,BOS,29,66,3,18,21
10,8478507,John Marino,D,UTA,27,59,3,18,21
10,8479976,Juuso Valimaki,D,UTA,26,60,3,18,21
10,8480222,Sebastian Aho,D,PIT,28,75,2,19,21
10,8478508,Yakov Trenin,C,MIN,27,54,13,7,20
10,8482679,Matt Coronato,R,CGY,22,55,11,9,20
10,8481481,Blake Lizotte,C,PIT,27,65,10,10,20
10,8482062,Cole Smith,L,NSH,29,64,10,10,20
10,8480813,Joe Veleno,C,DET,24,77,9,11,20
10,8477369,Carson Soucy,D,VAN,30,60,9,11,20
10,8481704,Juuso Parssinen,C,NSH,23,56,8,12,20
10,8476925,Colton Sissons,C,NSH,31,60,8,12,20
10,8480448,Parker Kelly,L,COL,25,76,8,12,20
10,8482737,Zack Bolduc,C,STL,21,57,7,13,20
10,8476329,Travis Boyd,C,MIN,31,54,5,15,20
10,8473507,Jeff Petry,D,DET,37,74,5,15,20
10,8475171,Oliver Ekman-Larsson,D,TOR,33,67,4,16,20
10,8476525,Colin Miller,D,WPG,32,64,4,16,20
10,8476931,Jake McCabe,D,TOR,31,62,4,16,20
10,8480246,Nick Perbix,D,TBL,26,71,3,17,20
10,8480281,Alexey Toropchenko,R,STL,25,63,13,6,19
10,8477406,Mattias Janmark,C,EDM,32,69,13,6,19
10,8481601,Simon Holmstrom,R,NYI,23,70,13,6,19
10,8477353,Tyler Motte,C,DET,29,68,12,7,19
10,8477919,Frederick Gaudreau,C,MIN,31,64,11,8,19
10,8477015,Connor Brown,R,EDM,30,57,9,10,19
10,8484149,Gavin Brindley,C,CBJ,20,50,9,10,19
10,8480074,Alexandre Texier,C,STL,25,54,8,11,19
10,8480025,MacKenzie Entwistle,R,FLA,25,62,8,11,19
10,8479353,Brett Howden,C,VGK,26,72,7,12,19
10,8483493,Frank Nazar,C,CHI,20,49,7,12,19
10,8474567,Zach Bogosian,D,MIN,34,68,6,13,19
10,8475193,Tomas Tatar,L,NJD,34,64,5,14,19
10,8483468,Jiri Kulich,C,BUF,20,51,5,14,19
10,8481014,Alexander Romanov,D,NYI,24,72,3,16,19
10,8475324,Nick Jensen,D,OTT,34,65,2,17,19
10,8481527,Kaedan Korczak,D,VGK,23,48,2,17,19
10,8481178,Egor Zamula,D,PHI,24,62,0,19,19
10,8480748,Kiefer Sherwood,L,VAN,29,58,10,8,18
10,8480205,Emil Bemstrom,C,PIT,25,53,10,8,18
10,8478434,Keegan Kolesar,R,VGK,27,63,9,9,18
10,8482809,Jackson Blake,R,CAR,21,53,8,10,18
10,8476994,Vinnie Hinostroza,C,NSH,30,51,8,10,18
10,8477505,Alexander Wennberg,C,SJS,30,62,7,11,18
10,8480355,Mark Kastelic,C,BOS,25,58,6,12,18
10,8475231,Casey Cizikas,C,NYI,33,73,5,13,18
10,8475188,Brayden McNabb,D,VGK,33,46,4,14,18
10,8476889,Radek Faksa,C,STL,30,59,4,14,18
10,8480172,Jan Rutta,D,SJS,34,67,4,14,18
10,8476429,Scott Mayfield,D,NYI,32,74,4,14,18
10,8482192,Isaak Phillips,D,CHI,23,51,4,14,18
10,8476902,Esa Lindell,D,DAL,30,74,3,15,18
10,8480891,Michael Kesselring,D,UTA,24,62,3,15,18
10,8479324,Ryan Lindgren,D,NYR,26,64,3,15,18
10,8478851,Alexandre Carrier,D,NSH,28,70,2,16,18
10,8479402,Jake Bean,D,CGY,26,68,2,16,18
10,8482176,Wyatt Kaiser,D,CHI,22,58,2,16,18
10,8479998,Mikey Anderson,D,LAK,25,62,2,16,18
10,8480873,Rasmus Sandin,D,WSH,24,62,1,17,18
10,8479983,Mario Ferraro,D,SJS,26,71,1,17,18
10,8482659,Josh Doan,R,UTA,22,51,10,7,17
10,8478569,Noel Acciari,C,PIT,33,51,8,9,17
10,8480848,Ty Dellandrea,C,SJS,24,53,8,9,17
10,8483491,Ivan Miroshnichenko,L,WSH,20,45,7,10,17
10,8479671,Mathieu Olivier,R,CBJ,27,51,7,10,17
10,8482762,Simon Edvinsson,D,DET,21,47,7,10,17
10,8478136,Jake Middleton,D,MIN,28,77,6,11,17
10,8480011,Klim Kostin,C,SJS,25,42,6,11,17
10,8480035,Henri Jokiharju,D,BUF,25,60,5,12,17
10,8483495,Simon Nemec,D,NJD,20,58,5,12,17
10,8477435,Ryan Graves,D,PIT,29,76,4,13,17
10,8480289,Morgan Barron,C,WPG,26,56,4,13,17
10,8480073,Erik Brannstrom,D,COL,25,66,3,14,17
10,8474716,Jared Spurgeon,D,MIN,35,74,2,15,17
10,8482624,Daniil Miromanov,D,CGY,27,68,2,15,17
10,8479982,Conor Timmins,D,TOR,26,55,2,15,17
10,8480001,Urho Vaakanainen,D,ANA,25,58,2,15,17
10,8479328,Julien Gauthier,R,NYI,27,61,11,5,16
10,8475225,Craig Smith,C,CHI,35,45,9,7,16
10,8481028,Martin Pospisil,C,CGY,25,55,7,9,16
10,8478443,Brandon Carlo,D,BOS,28,63,7,9,16
10,8478452,Caleb Jones,D,LAK,27,60,4,12,16
10,8478882,Vladislav Gavrikov,D,LAK,29,67,3,13,16
10,8482245,Artem Zub,D,OTT,29,67,3,13,16
10,8481708,Zac Jones,D,NYR,24,54,3,13,16
10,8481568,Alex Vlasic,D,CHI,23,60,3,13,16
10,8481059,Scott Perunovich,D,STL,26,62,3,13,16
10,8480157,Calle Rosen,D,COL,30,51,3,13,16
10,8476856,Mathew Dumba,D,DAL,30,63,3,13,16
10,8475233,David Savard,D,MTL,34,68,0,16,16
10,8479543,Michael Pezzetta,L,MTL,26,60,8,7,15
10,8482803,Olen Zellweger,D,ANA,21,60,6,9,15
10,8479336,Carl Grundstrom,R,SJS,27,49,6,9,15
10,8477070,Liam O'Brien,C,UTA,30,58,6,9,15
10,8477499,Rasmus Ristolainen,D,PHI,30,55,5,10,15
10,8480980,Connor Dewar,C,TOR,25,66,5,10,15
10,8479520,Brandon Duhaime,R,WSH,27,53,5,10,15
10,8480252,Cole Guttman,C,CHI,25,39,5,10,15
10,8482451,Mikael Pyyhtia,L,CBJ,23,41,4,11,15
10,8480021,Jack Studnicka,C,LAK,25,61,4,11,15
10,8476988,Matt Benning,D,SJS,30,65,4,11,15
10,8479371,Dante Fabbro,D,NSH,26,66,3,12,15
10,8480807,Mattias Samuelsson,D,BUF,24,53,3,12,15
10,8482087,Kaiden Guhle,D,MTL,22,68,2,13,15
10,8481567,Henry Thrun,D,SJS,23,51,2,13,15
10,8475179,Dmitry Kulikov,D,FLA,34,64,1,14,15
10,8474673,TJ Brodie,D,CHI,34,61,1,14,15
10,8475455,Brenden Dillon,D,NJD,34,63,1,14,15
10,8480806,Isac Lundestrom,C,ANA,25,56,8,6,14
10,8476442,Matt Nieto,L,PIT,32,55,8,6,14
10,8482496,Nils Aman,C,VAN,24,44,8,6,14
10,8479414,Nathan Bastian,R,NJD,27,56,7,7,14
10,8480192,Johnathan Kovacevic,D,NJD,27,44,7,7,14
10,8477931,Tomas Nosek,L,FLA,32,64,6,8,14
10,8479344,Jesse Puljujarvi,R,PIT,26,50,6,8,14
10,8478421,A.J. Greer,L,FLA,28,50,6,8,14
10,8481161,Jake Christiansen,D,CBJ,25,56,5,9,14
10,8481537,Nikita Okhotiuk,D,CGY,24,49,5,9,14
10,8477979,Nicolas Aube-Kubel,R,BUF,28,56,4,10,14
10,8479066,Ryan Lomberg,L,CGY,30,66,4,10,14
10,8479372,Joshua Mahura,D,SEA,26,54,2,12,14
10,8476967,Brett Kulak,D,EDM,30,63,2,12,14
10,8475690,Chris Tanev,D,TOR,35,62,1,13,14
10,8480058,Pierre-Olivier Joseph,D,STL,25,50,0,14,14
10,8478831,Kevin Stenlund,C,UTA,28,47,9,4,13
10,8478211,Dryden Hunt,L,CGY,29,57,7,6,13
10,8481550,Adam Beckman,L,NJD,23,39,7,6,13
10,8482747,Brennan Othmann,L,NYR,21,38,6,7,13
10,8479994,Jaret Anderson-Dolan,C,WPG,25,37,6,7,13
10,8481441,Joe Snively,C,DET,28,66,5,8,13
10,8477482,Zachary Sanford,L,CHI,30,36,5,8,13
10,8475279,Ben Chiarot,D,DET,33,74,4,9,13
10,8481013,Jonatan Berggren,R,DET,24,62,4,9,13
10,8470600,Ryan Suter,D,STL,39,56,3,10,13
10,8478859,Niko Mikkola,D,FLA,28,57,2,11,13
10,8479369,Andrew Peeke,D,BOS,26,59,2,11,13
10,8479639,Dylan Coghlan,D,WPG,26,63,1,12,13
10,8480196,Jacob Bryson,D,BUF,27,48,1,12,13
10,8480860,Kevin Bahl,D,CGY,24,62,0,13,13
10,8481716,Dmitri Voronkov,L,CBJ,24,46,8,4,12
10,8482077,Dylan Holloway,L,EDM,23,58,7,5,12
10,8477450,Jason Dickinson,C,CHI,29,53,6,6,12
10,8475855,Jesper Fast,R,CAR,33,65,5,7,12
10,8479370,Tyson Jost,C,CAR,26,47,5,7,12
10,8477446,Michael McCarron,R,NSH,29,55,5,7,12
10,8479718,Alex Barré-Boulet,C,MTL,27,42,5,7,12
10,8478399,Jonas Siegenthaler,D,NJD,27,56,4,8,12
10,8477851,Jordan Oesterle,D,BOS,32,39,3,9,12
10,8476624,Barclay Goodrow,C,SJS,31,48,3,9,12
10,8476874,Olli Maatta,D,DET,30,61,3,9,12
10,8480727,Zach Whitecloud,D,VGK,28,52,2,10,12
10,8480796,Martin Fehervary,D,WSH,25,54,2,10,12
10,8479638,Justin Brazeau,R,BOS,26,36,2,10,12
10,8481600,Tobias Bjornfot,D,FLA,23,39,2,10,12
10,8474574,Tyler Myers,D,VAN,34,61,1,11,12
10,8481167,Brayden Pachal,D,CGY,25,39,1,11,12
10,8476822,Luke Glendening,C,TBL,35,79,8,3,11
10,8483397,Marc McLaughlin,C,BOS,25,29,6,5,11
10,8480845,Rasmus Kupari,C,WPG,24,34,5,6,11
10,8479026,Philippe Myers,D,TOR,27,56,4,7,11
10,8478451,Ethan Bear,D,WSH,27,55,4,7,11
10,8471709,Marc-Edouard Vlasic,D,SJS,37,56,4,7,11
10,8477845,Trevor van Riemsdyk,D,WSH,33,52,4,7,11
10,8482751,Ryan Winterton,C,SEA,21,43,4,7,11
10,8482730,Brandt Clarke,D,LAK,21,52,4,7,11
10,8478585,Derek Ryan,C,EDM,38,64,4,7,11
10,8474090,Brendan Smith,D,DAL,35,52,3,8,11
10,8480070,Ian Mitchell,D,BOS,25,47,3,8,11
10,8482666,Scott Morrow,D,CAR,22,45,3,8,11
10,8481056,Spencer Stastney,D,NSH,24,35,2,9,11
10,8479972,Mason Shaw,C,WPG,26,36,2,9,11
10,8479442,Troy Stecher,D,EDM,30,50,2,9,11
10,8476934,Brock McGinn,L,ANA,30,57,8,2,10
10,8481599,Victor Soderstrom,D,UTA,23,47,8,2,10
10,8481641,Joel Kiviranta,L,COL,28,72,7,3,10
10,8481532,Alex Turcotte,C,LAK,23,43,6,4,10
10,8482749,Joshua Roy,R,MTL,21,59,5,5,10
10,8475842,Sam Carrick,C,NYR,32,60,5,5,10
10,8476867,Brendan Gaunce,C,MIN,30,41,5,5,10
10,8480441,Trey Fix-Wolansky,R,CBJ,25,36,5,5,10
10,8480880,Jakub Lauko,C,MIN,24,38,5,5,10
10,8482733,Logan Mailloux,D,MTL,31,43,5,5,10
10,8479968,Vinni Lettieri,C,BOS,29,48,4,6,10
10,8477018,Ben Hutton,D,VGK,31,54,4,6,10
10,8475762,Derek Forbort,D,VAN,32,44,3,7,10
10,8476441,Joel Edmundson,D,LAK,31,41,3,7,10
10,8477365,Connor Clifton,D,BUF,29,53,2,8,10
10,8479378,Logan Stanley,D,WPG,26,40,2,8,10
10,8475718,Justin Holl,D,DET,32,59,1,9,10
10,8480879,Jacob Bernard-Docker,D,OTT,24,54,1,9,10
10,8475208,Brian Dumoulin,D,ANA,33,66,1,9,10
10,8477508,Curtis Lazar,C,NJD,29,51,5,4,9
10,8482744,James Malatesta,L,CBJ,21,39,5,4,9
10,8482511,Mason Lohrei,D,BOS,23,33,5,4,9
10,8482859,Zack Ostapchuk,C,OTT,21,50,4,5,9
10,8479359,Beck Malenstyn,L,BUF,26,41,4,5,9
10,8480007,Jonas Rondbjerg,R,VGK,25,31,4,5,9
10,8483466,Kevin Korchinski,D,CHI,20,45,3,6,9
10,8476372,Nick Seeler,D,PHI,31,35,3,6,9
10,8482153,Brendan Brisson,C,VGK,23,35,3,6,9
10,8482073,Braden Schneider,D,NYR,23,64,2,7,9
10,8481617,Vasily Podkolzin,R,VAN,23,45,2,7,9
10,8477962,Brendan Lemieux,L,CAR,28,44,2,7,9
10,8480990,Declan Chisholm,D,MIN,24,30,2,7,9
10,8474568,Luke Schenn,D,NSH,35,43,0,9,9
10,8477335,Kyle Burroughs,D,LAK,29,40,0,9,9
10,8481789,Tye Kartye,L,SEA,23,32,6,2,8
10,8479980,Nicolas Hague,D,VGK,26,53,5,3,8
10,8482807,Ethan Del Mastro,D,CHI,21,46,5,3,8
10,8471817,Ryan Reaves,R,TOR,37,53,5,3,8
10,8479981,Jonah Gadjovich,L,FLA,26,44,5,3,8
10,8481592,Jakob Pelletier,L,CGY,23,43,5,3,8
10,8481754,Nikita Nesterenko,C,ANA,23,35,4,4,8
10,8482634,Alex Steeves,C,TOR,25,42,4,4,8
10,8482144,Jack Thompson,D,SJS,22,22,4,4,8
10,8481679,Maxence Guenette,D,OTT,23,36,4,4,8
10,8480890,Jan Jenik,C,OTT,24,34,4,4,8
10,8473446,Erik Johnson,D,PHI,36,44,3,5,8
10,8478416,Erik Cernak,D,TBL,27,72,3,5,8
10,8484911,Collin Graf,R,SJS,22,33,3,5,8
10,8479249,Andrew Poturalski,C,SJS,30,32,2,6,8
10,8478017,Mark Friedman,D,VAN,29,40,2,6,8
10,8482861,Vincent Iorio,D,WSH,22,39,2,6,8
10,8482070,Mitchell Chaffee,R,TBL,26,57,1,7,8
10,8475750,Jon Merrill,D,MIN,32,65,1,7,8
10,8480950,Ilya Lyubushkin,D,DAL,30,63,0,8,8
10,8483460,David Jiricek,D,CBJ,21,55,0,8,8
10,8474013,Ian Cole,D,UTA,35,46,0,8,8
10,8475235,Nicolas Deslauriers,L,PHI,33,47,5,2,7
10,8479536,Axel Jonsson-Fjallby,L,WPG,26,30,5,2,7
10,8482095,Tyler Kleven,D,OTT,22,41,4,3,7
10,8481147,Reese Johnson,C,MIN,26,38,4,3,7
10,8480245,Olle Lycksell,R,PHI,25,32,3,4,7
10,8480292,Carson Meyer,R,ANA,27,41,3,4,7
10,8477401,John Hayden,C,SEA,29,32,3,4,7
10,8477073,Kurtis MacDermid,L,NJD,30,36,3,4,7
10,8477380,Jonny Brodzinski,C,NYR,31,55,2,5,7
10,8479291,Kevin Rooney,C,CGY,31,44,1,6,7
10,8480887,Jordan Harris,D,MTL,24,43,1,6,7
10,8484254,Akito Hirose,D,VAN,25,37,1,6,7
10,8477034,Jaycob Megna,D,FLA,32,43,1,6,7
10,8476473,Connor Murphy,D,CHI,31,39,1,6,7
10,8481598,Philip Broberg,D,EDM,23,42,1,6,7
10,8483763,Maksymilian Szuber,D,UTA,22,34,1,6,7
10,8478468,Jeremy Lauzon,D,NSH,27,47,0,7,7
10,8476858,Phillip Di Giuseppe,L,VAN,31,30,4,2,6
10,8481518,Nolan Foote,L,NJD,24,41,4,2,6
10,8479991,Jake Leschyshyn,C,NYR,25,29,4,2,6
10,8479772,Zack MacEwen,R,OTT,28,46,3,3,6
10,8482145,Mavrik Bourque,C,DAL,22,47,3,3,6
10,8479379,Givani Smith,R,SJS,26,32,3,3,6
10,8484287,Cole McWard,D,VAN,23,28,3,3,6
10,8482964,Arber Xhekaj,D,MTL,23,49,2,4,6
10,8471677,Jack Johnson,D,CBJ,37,68,2,4,6
10,8477887,Patrick Brown,C,BOS,32,45,2,4,6
10,8478454,Noah Juulsen,D,VAN,27,39,2,4,6
10,8476952,Dominic Toninato,C,WPG,30,35,2,4,6
10,8480870,Bo Groulx,C,NYR,24,28,2,4,6
10,8482141,Lukas Cormier,D,VGK,22,30,2,4,6
10,8480844,Grigori Denisenko,L,VGK,24,36,2,4,6
10,8481605,Jackson LaCombe,D,ANA,23,31,2,4,6
10,8477938,Haydn Fleury,D,WPG,28,41,1,5,6
10,8475177,Calvin de Haan,D,COL,33,43,1,5,6
10,8482784,Zach Dean,C,STL,21,39,1,5,6
10,8479986,Kole Lind,R,DAL,26,51,1,5,6
10,8477527,Ross Johnston,L,ANA,30,32,1,5,6
10,8474612,Travis Hamonic,D,OTT,34,52,0,6,6
10,8478874,Adam Gaudette,R,OTT,28,43,0,6,6
10,8479944,Zach Aston-Reese,C,VGK,30,39,4,1,5
10,8483012,Logan Morrison,C,SEA,22,31,4,1,5
10,8481556,John Beecher,C,BOS,23,33,3,2,5
10,8481743,Marc Del Gaizo,D,NSH,25,22,3,2,5
10,8478424,Jansen Harkins,C,ANA,27,38,2,3,5
10,8482652,Walker Duehr,R,CGY,27,35,2,3,5
10,8483619,Filip Roos,D,OTT,25,26,2,3,5
10,8478021,William Lagesson,D,DET,28,25,2,3,5
10,8479320,Maxime Lajoie,D,SEA,27,22,2,3,5
10,8478146,Matthew Highmore,C,OTT,28,33,2,3,5
10,8481751,Lukas Rousek,R,BUF,25,39,1,4,5
10,8482858,Ryker Evans,D,SEA,23,22,1,4,5
10,8482118,Sam Colangelo,R,ANA,23,15,1,4,5
10,8477462,Robert Hagg,D,VGK,29,25,1,4,5
10,8482177,Marat Khusnutdinov,C,MIN,22,39,0,5,5
10,8481422,Jake Lucchini,C,NSH,29,17,0,5,5
10,8481122,Simon Benoit,D,TOR,26,42,0,5,5
10,8483549,Lucas Condotta,L,MTL,27,32,3,1,4
10,8480834,Ty Emberson,D,SJS,24,31,3,1,4
10,8477467,Gustav Olofsson,D,SEA,30,21,3,1,4
10,8481701,Santeri Hatakka,D,NJD,23,36,2,2,4
10,8479419,Brett Murray,L,BUF,26,25,2,2,4
10,8481609,Vladislav Kolyachonok,D,UTA,23,34,1,3,4
10,8479348,Kale Clague,D,BUF,26,43,1,3,4
10,8479576,Vincent Desharnais,D,VAN,28,38,1,3,4
10,8483630,Pavol Regenda,L,ANA,25,30,1,3,4
10,8475795,Dylan McIlrath,D,WSH,32,14,1,3,4
10,8480084,Nick DeSimone,D,NJD,30,22,1,3,4
10,8477384,Joshua Brown,D,EDM,30,41,0,4,4
10,8478409,Anthony Richard,C,PHI,28,34,2,1,3
10,8482516,Matthew Kessel,D,STL,24,21,2,1,3
10,8482765,Isak Rosen,R,BUF,21,37,2,1,3
10,8481543,Nikita Alexandrov,C,STL,24,19,2,1,3
10,8479362,Riley Tufte,L,BOS,26,22,2,1,3
10,8483570,Ben Meyers,C,SEA,26,25,1,2,3
10,8476913,Devin Shore,C,MIN,30,24,0,3,3
10,8478011,Louie Belpedio,D,PHI,28,18,0,3,3
10,8483512,Matthew Savoie,C,EDM,20,20,0,3,3
10,8481541,Samuel Bolduc,D,NYI,24,27,0,3,3
10,8480468,James Hamblin,L,EDM,25,17,0,3,3
10,8482147,Jean-Luc Foudy,C,COL,22,22,2,0,2
10,8482172,Landon Slaggert,L,CHI,22,20,2,0,2
10,8479367,William Lockwood,R,FLA,26,24,1,1,2
10,8477473,Justin Bailey,R,SJS,29,30,1,1,2
10,8482713,Mackie Samoskevich,R,FLA,22,39,1,1,2
10,8482929,Emil Lilleberg,D,TBL,23,16,1,1,2
10,8482201,Gage Goncalves,C,TBL,23,16,1,1,2
10,8482162,Roby Jarventie,L,EDM,22,13,1,1,2
10,8481578,Graeme Clarke,R,MIN,23,9,1,1,2
10,8477320,Anton Blidh,L,NYR,29,17,1,1,2
10,8484258,Sam Malinski,D,COL,26,28,1,1,2
10,8474062,Riley Nash,C,NYR,35,10,1,1,2
10,8475780,Chris Wagner,R,COL,33,8,1,1,2
10,8482088,Justin Sourdif,R,FLA,22,18,1,1,2
10,8480823,Alexander Alexeyev,D,WSH,25,16,1,1,2
10,8482165,Yan Kuznetsov,D,CGY,22,22,0,2,2
10,8477244,Chad Ruhwedel,D,NYR,34,27,0,2,2
10,8478450,Parker Wotherspoon,D,BOS,27,34,0,2,2
10,8480874,Adam Ginning,D,PHI,24,9,0,2,2
10,8477810,Joel Hanley,D,CGY,33,29,0,2,2
10,8481237,Kyle MacLean,C,NYI,25,27,0,2,2
10,8477149,Scott Sabourin,R,SJS,32,17,0,2,2
10,8478051,Max Willman,C,NJD,29,24,0,2,2
10,8478446,Glenn Gawdin,C,LAK,27,9,0,2,2
10,8481699,Aku Raty,R,UTA,23,15,0,2,2
10,8482250,Callahan Burke,C,VGK,27,24,0,2,2
10,8483567,Georgii Merkulov,C,BOS,24,9,0,2,2
10,8484326,Patrik Koch,D,UTA,28,2,0,2,2
10,8475958,Michael Sgarbossa,C,WSH,32,27,1,0,1
10,8481585,Egor Afanasyev,L,SJS,23,11,1,0,1
10,8482102,Vasily Ponomarev,C,PIT,22,11,1,0,1
10,8481030,Jack St. Ivany,D,PIT,25,14,1,0,1
10,8481006,Tyler Tucker,D,STL,24,11,1,0,1
10,8477971,Andreas Englund,D,LAK,28,24,1,0,1
10,8481043,Cole Koepke,L,BOS,26,11,1,0,1
10,8483407,Brandon Scanlin,D,NYR,25,7,1,0,1
10,8482197,Adam Raska,R,MIN,23,10,1,0,1
10,8480306,Grant Hutton,D,NYI,29,8,1,0,1
10,8481726,Adam Edstrom,C,NYR,24,7,1,0,1
10,8481462,Mason Morelli,L,VGK,28,11,0,1,1
10,8482470,Ilya Solovyov,D,CGY,24,12,0,1,1
10,8475413,Justin Dowling,C,NJD,34,10,0,1,1
10,8480032,Shane Bowers,C,NJD,25,13,0,1,1
10,8478477,Mitchell Stephens,C,SEA,27,17,0,1,1
10,8481065,Angus Crookshank,L,OTT,25,12,0,1,1
10,8483471,Brad Lambert,C,WPG,31,9,0,1,1
10,8479587,Rhett Gardner,C,PHI,28,14,0,1,1
10,8480075,Cameron Crotty,D,MIN,25,10,0,1,1
10,8479330,Brandon Gignac,C,MTL,27,10,0,1,1
10,8480267,Sammy Walker,C,MIN,25,16,0,1,1
10,8482061,Brandon Biro,L,SEA,26,10,0,1,1
10,8478881,Brett Seney,L,CHI,28,9,0,1,1
10,8482460,Matt Rempe,C,NYR,22,9,0,1,1
10,8476323,Max McCormick,L,SEA,32,9,0,1,1
10,8481564,Ryan Johnson,D,BUF,23,14,0,1,1
10,8477541,Dakota Mermis,D,TOR,30,9,0,1,1
10,8484304,Uvis Balinskis,D,FLA,28,12,0,1,1
10,8481719,Maxwell Crozier,D,TBL,24,15,0,1,1
10,8481806,Louis Crevier,D,CHI,23,10,0,1,1
10,8483920,Pierrick Dube,R,WSH,23,6,0,1,1
10,8483546,Marshall Rifai,D,TOR,26,4,0,1,1
10,8477993,Justin Kirkland,C,CGY,28,10,0,1,1
10,8481593,Jayden Struble,D,MTL,23,14,0,0,0
10,8479985,Cale Fleury,D,SEA,26,24,0,0,0
10,8483597,Milos Kelemen,L,UTA,25,18,0,0,0
10,8481206,John Ludvig,D,PIT,24,13,0,0,0
10,8482094,Daemon Hunt,D,MIN,22,11,0,0,0
10,8480851,Akil Thomas,C,LAK,24,16,0,0,0
10,8484325,Waltteri Merela,C,TBL,26,14,0,0,0
10,8483489,Fraser Minten,C,TOR,31,11,0,0,0
10,8475755,Alexander Petrovic,D,DAL,32,8,0,0,0
10,8483395,Arshdeep Bains,L,VAN,23,7,0,0,0
10,8481024,Linus Karlsson,C,VAN,25,11,0,0,0
10,8478502,Dennis Gilbert,D,BUF,28,15,0,0,0
10,8483398,Declan Carlile,D,TBL,31,6,0,0,0
10,8479522,Hardy Haman Aktell,D,WSH,26,2,0,0,0
10,8478854,Ryan Shea,D,PIT,27,4,0,0,0
10,8478147,Bokondji Imama,L,PIT,28,3,0,0,0
10,8484255,Jason Polin,R,COL,25,4,0,0,0
10,8481655,Cole Schwindt,R,CGY,23,5,0,0,0
10,8483432,Luca Del Bel Belluz,C,CBJ,31,6,0,0,0
10,8483401,Marc Johnstone,R,PIT,28,0,0,0,0
10,8479421,Jacob Moverare,D,LAK,26,7,0,0,0
10,8483609,Adam Klapka,R,CGY,24,5,0,0,0
10,8484321,Nikolas Matinpalo,D,OTT,26,2,0,0,0
10,8483531,Brian Halonen,L,NJD,25,5,0,0,0
10,8482476,Emil Heineman,L,MTL,23,6,0,0,0
10,8482787,Nikita Chibrikov,R,WPG,31,6,0,0,0
10,8482126,Emil Andrae,D,PHI,31,2,0,0,0
10,8484259,Ondrej Pavel,C,COL,31,1,0,0,0
10,8470794,Joe Pavelski,C,,40,0,0,0,0
10,8479321,Lucas Johansen,D,,27,0,0,0,0
10,8477950,Tony DeAngelo,D,,29,0,0,0,0
10,8471218,Blake Wheeler,R,,38,0,0,0,0
10,8475197,Tyson Barrie,D,,33,0,0,0,0
10,8474157,Max Pacioretty,L,,36,0,0,0,0
10,8475744,Evgeny Kuznetsov,C,,32,0,0,0,0
10,8474037,James van Riemsdyk,L,,35,0,0,0,0
10,8476907,Mackenzie MacEachern,L,,30,0,0,0,0
10,8480216,Jacob Peterson,C,,25,0,0,0,0
10,8474602,Justin Schultz,D,,34,0,0,0,0
10,8482222,Alexander Barabanov,L,,30,0,0,0,0
10,8474031,Kevin Shattenkirk,D,,35,0,0,0,0
10,8477330,Dominik Kubalik,L,,29,0,0,0,0
10,8480884,Calen Addison,D,,24,0,0,0,0
10,8475906,John Klingberg,D,,32,0,0,0,0
10,8480008,Adam Ruzicka,C,,25,0,0,0,0
10,8476884,Derrick Pouliot,D,,30,0,0,0,0
10,8476919,Chris Tierney,C,,30,0,0,0,0
10,8479415,Michael McLeod,C,,26,0,0,0,0
10,8474870,Tyler Johnson,C,,34,0,0,0,0
10,8470604,Jeff Carter,C,,39,0,0,0,0
10,8478104,Sammy Blais,L,,28,0,0,0,0
10,8474884,Mike Hoffman,C,,35,0,0,0,0
10,8481591,Sam Poulin,R,,23,0,0,0,0
10,8471274,Alex Goligoski,D,,39,0,0,0,0
10,8476871,Tanner Pearson,L,,32,0,0,0,0
10,8476393,Nick Cousins,C,,31,0,0,0,0
10,8479977,Kailer Yamamoto,R,,26,0,0,0,0
10,8479346,Dillon Dube,C,,26,0,0,0,0
10,8480184,Gustav Lindstrom,D,,26,0,0,0,0
10,8479376,Victor Mete,D,,26,0,0,0,0
10,8473449,Kyle Okposo,R,,36,0,0,0,0
10,8481058,Jesse Ylonen,R,,25,0,0,0,0
10,8475752,Tyler Pitlick,C,,33,0,0,0,0
10,8481239,Samuel Fagemo,L,,24,0,0,0,0
10,8480821,Filip Zadina,R,,25,0,0,0,0
10,8470966,Mark Giordano,D,,41,0,0,0,0
10,8478495,Denis Gurianov,R,,27,0,0,0,0
10,8477464,Nic Petan,C,,29,0,0,0,0
10,8478099,Kevin Labanc,R,,29,0,0,0,0
10,8482241,Radim Zohorna,L,,28,0,0,0,0
10,8474040,Sam Gagner,C,,35,0,0,0,0
10,8479514,Rem Pitlick,C,,27,0,0,0,0
10,8478430,Oliver Kylington,D,,27,0,0,0,0
10,8479533,Joona Koppanen,L,,26,0,0,0,0
10,8479984,Cal Foote,D,,26,0,0,0,0
10,8477126,Jayson Megna,C,,34,0,0,0,0
10,8475164,Jakob Silfverberg,R,,34,0,0,0,0
10,8474009,Nick Bonino,C,,36,0,0,0,0
10,8479458,Nikita Zaitsev,D,,33,0,0,0,0
10,8477944,Jakub Vrana,L,,28,0,0,0,0
10,8471699,Andrew Cogliano,C,,37,0,0,0,0
10,8478067,Oskar Lindblom,L,,28,0,0,0,0
10,8471686,Marc Staal,D,,37,0,0,0,0
10,8470610,Zach Parise,L,,40,0,0,0,0
10,8478904,Steven Lorentz,C,,28,0,0,0,0
10,8473473,Milan Lucic,L,,36,0,0,0,0
10,8480031,Maxime Comtois,L,,25,0,0,0,0
10,8478512,Austin Czarnik,C,,32,0,0,0,0
10,8473504,Cal Clutterbuck,R,,37,0,0,0,0
10,8477454,Adam Erne,L,,29,0,0,0,0
10,8479383,Boris Katchouk,L,,26,0,0,0,0
10,8475825,Jani Hakanpää,D,,32,0,0,0,0
10,8477846,Ryan Carpenter,C,,33,0,0,0,0
10,8477930,Pierre-Edouard Bellemare,L,,39,0,0,0,0
10,8478400,Colin White,C,,27,0,0,0,0
10,8480226,Marián Studenic,R,,26,0,0,0,0
10,8480853,Liam Foudy,C,,24,0,0,0,0
10,8475797,Jarred Tinordi,D,,32,0,0,0,0
10,8479423,Alex Nylander,L,,26,0,0,0,0
10,8474618,Marco Scandella,D,,34,0,0,0,0
10,8478028,Fredrik Olofsson,L,,28,0,0,0,0
10,8474709,Matt Martin,L,,35,0,0,0,0
10,8481070,Hugh McGing,L,,26,0,0,0,0
10,8479546,Oskar Steen,C,,26,0,0,0,0
10,8474145,Robert Bortuzzo,D,,35,0,0,0,0
10,8476915,Jujhar Khaira,L,,30,0,0,0,0
10,8480274,Philip Kemp,D,EDM,25,1,0,0,0
10,8475278,Byron Froese,C,,33,0,0,0,0
10,8481812,Nikolai Knyzhov,D,,27,0,0,0,0
10,8478408,Travis Dermott,D,,28,0,0,0,0
10,8481077,John Leonard,L,,26,0,0,0,0
10,8479547,Matthew Phillips,R,,26,0,0,0,0
10,8480836,Jonathan Gruden,C,,24,0,0,0,0
10,8481690,Tyler Angle,C,,24,0,0,0,0
10,8475766,Austin Watson,L,,32,0,0,0,0
10,8481016,Ruslan Iskhakov,C,,24,0,0,0,0
10,8478078,Rourke Chartier,C,,28,0,0,0,0
10,8480776,Sheldon Rempal,R,,29,0,0,0,0
10,8478956,Samuel Laberge,L,NJD,27,0,0,0,0
10,8483045,Cameron Butler,R,CBJ,31,1,0,0,0
10,8481534,Raphael Lavoie,C,EDM,24,5,0,0,0
10,8484314,Jiri Smejkal,L,,28,0,0,0,0
11,8476453,Nikita Kucherov,R,TBL,31,82,47,103,150
11,8477492,Nathan MacKinnon,C,COL,29,81,52,81,133
11,8477956,David Pastrnak,R,BOS,28,80,66,66,132
11,8479318,Auston Matthews,C,TOR,27,79,68,56,124
11,8480027,Jason Robertson,L,DAL,25,80,47,76,123
11,8478483,Mitch Marner,R,TOR,27,78,36,87,123
11,8478550,Artemi Panarin,L,NYR,33,79,39,77,116
11,8478402,Connor McDavid,C,EDM,27,77,33,81,114
11,8480012,Elias Pettersson,C,VAN,26,73,53,59,112
11,8477934,Leon Draisaitl,C,EDM,29,78,49,58,107
11,8477939,William Nylander,R,TOR,28,78,42,61,103
11,8479314,Matthew Tkachuk,L,FLA,27,75,22,76,98
11,8477942,Kevin Fiala,L,LAK,28,80,40,57,97
11,8476468,J.T. Miller,C,VAN,31,74,29,68,97
11,8477404,Jake Guentzel,C,TBL,30,82,40,56,96
11,8479407,Jesper Bratt,L,NJD,26,75,36,60,96
11,8478445,Mathew Barzal,C,NYI,27,79,29,67,96
11,8481559,Jack Hughes,C,NJD,23,77,32,63,95
11,8477493,Aleksander Barkov,C,FLA,29,75,24,69,93
11,8478864,Kirill Kaprizov,L,MIN,27,76,33,59,92
11,8479343,Clayton Keller,R,UTA,26,80,33,59,92
11,8471675,Sidney Crosby,C,PIT,37,76,42,48,90
11,8476887,Filip Forsberg,L,NSH,30,75,42,48,90
11,8478449,Roope Hintz,C,DAL,28,82,42,48,90
11,8471685,Anze Kopitar,C,LAK,37,81,27,62,89
11,8480023,Robert Thomas,C,STL,25,75,26,63,89
11,8480800,Quinn Hughes,D,VAN,25,75,17,71,88
11,8480801,Brady Tkachuk,L,OTT,25,81,34,53,87
11,8477955,Jared McCann,L,SEA,28,77,43,43,86
11,8476460,Mark Scheifele,C,WPG,31,66,35,51,86
11,8477946,Dylan Larkin,C,DET,28,82,34,51,85
11,8474600,Roman Josi,D,NSH,34,73,21,64,85
11,8481540,Cole Caufield,R,MTL,23,79,35,49,84
11,8480018,Nick Suzuki,C,MTL,25,78,25,58,83
11,8475168,Matt Duchene,C,DAL,33,82,30,52,82
11,8478010,Brayden Point,C,TBL,28,82,40,41,81
11,8478420,Mikko Rantanen,R,COL,28,82,39,42,81
11,8478403,Jack Eichel,C,VGK,28,78,37,43,80
11,8476881,Tomas Hertl,C,VGK,31,79,37,43,80
11,8478414,Timo Meier,R,NJD,28,76,30,50,80
11,8477501,Valeri Nichushkin,R,COL,29,81,39,40,79
11,8477409,Carter Verhaeghe,C,FLA,29,76,45,33,78
11,8475786,Zach Hyman,L,EDM,32,77,37,41,78
11,8475166,John Tavares,C,TOR,34,80,30,48,78
11,8474564,Steven Stamkos,C,NSH,34,76,43,34,77
11,8478444,Brock Boeser,R,VAN,27,77,38,39,77
11,8481557,Matt Boldy,L,MIN,23,73,28,49,77
11,8476389,Vincent Trocheck,C,NYR,31,74,28,49,77
11,8475913,Mark Stone,R,VGK,32,78,26,51,77
11,8480002,Nico Hischier,C,NJD,25,78,25,52,77
11,8477496,Elias Lindholm,C,BOS,30,77,24,53,77
11,8480036,Miro Heiskanen,D,DAL,25,80,8,69,77
11,8476454,Ryan Nugent-Hopkins,C,EDM,31,80,23,53,76
11,8479323,Adam Fox,D,NYR,26,74,13,63,76
11,8484144,Connor Bedard,C,CHI,19,63,27,48,75
11,8478398,Kyle Connor,L,WPG,28,74,42,32,74
11,8478439,Travis Konecny,R,PHI,27,77,37,37,74
11,8478975,Mason Marchment,L,DAL,29,82,34,40,74
11,8477402,Pavel Buchnevich,L,STL,29,74,26,47,73
11,8480069,Cale Makar,D,COL,26,70,17,56,73
11,8474578,Erik Karlsson,D,PIT,34,79,16,57,73
11,8475167,Victor Hedman,D,TBL,34,82,16,57,73
11,8482116,Tim Stützle,C,OTT,22,78,26,46,72
11,8476459,Mika Zibanejad,C,NYR,31,78,23,49,72
11,8479542,Brandon Hagel,L,TBL,26,81,36,35,71
11,8475172,Nazem Kadri,C,CGY,34,78,27,44,71
11,8476346,Johnny Gaudreau,L,CBJ,31,71,22,49,71
11,8480803,Evan Bouchard,D,EDM,25,78,9,62,71
11,8478493,Joel Eriksson Ek,C,MIN,27,70,37,33,70
11,8473994,Jamie Benn,L,DAL,35,81,26,44,70
11,8478427,Sebastian Aho,C,CAR,27,74,22,47,69
11,8477933,Sam Reinhart,C,FLA,29,79,32,36,68
11,8479385,Jordan Kyrou,C,STL,26,75,26,42,68
11,8480865,Noah Dobson,D,NYI,24,79,12,56,68
11,8473419,Brad Marchand,L,BOS,36,78,27,40,67
11,8482740,Wyatt Johnston,C,DAL,21,80,37,29,66
11,8478047,Michael Bunting,L,PIT,29,74,27,39,66
11,8480039,Martin Necas,C,CAR,25,68,23,43,66
11,8478401,Pavel Zacha,C,BOS,27,81,22,44,66
11,8479999,Casey Mittelstadt,C,COL,26,80,20,46,66
11,8474141,Patrick Kane,R,DET,36,80,29,36,65
11,8478873,Troy Terry,R,ANA,27,75,29,36,65
11,8475754,Brock Nelson,C,NYI,33,79,29,36,65
11,8477960,Adrian Kempe,R,LAK,28,81,23,42,65
11,8478440,Dylan Strome,C,WSH,27,71,23,42,65
11,8482684,Luke Hughes,D,NJD,21,68,12,53,65
11,8482699,Dylan Guenther,R,UTA,21,75,35,29,64
11,8477500,Bo Horvat,C,NYI,29,82,33,31,64
11,8480830,Andrei Svechnikov,R,CAR,24,65,27,37,64
11,8475158,Ryan O'Reilly,C,NSH,33,75,25,39,64
11,8482078,Lucas Raymond,L,DET,22,80,23,41,64
11,8471214,Alex Ovechkin,L,WSH,39,73,32,31,63
11,8477940,Nikolaj Ehlers,L,WPG,28,72,14,49,63
11,8479325,Charlie McAvoy,D,BOS,27,73,9,54,63
11,8479420,Tage Thompson,C,BUF,27,78,27,35,62
11,8475184,Chris Kreider,L,NYR,33,70,38,23,61
11,8482745,Mason McTavish,C,ANA,21,71,29,32,61
11,8477951,Nick Schmaltz,C,UTA,28,73,21,40,61
11,8475745,Charlie Coyle,C,BOS,32,80,17,44,61
11,8478498,Jake DeBrusk,L,VAN,28,73,30,30,60
11,8476448,William Karlsson,C,VGK,31,74,25,35,60
11,8479675,Trevor Moore,L,LAK,29,81,25,35,60
11,8473986,Alex Killorn,L,ANA,35,72,25,35,60
11,8477476,Artturi Lehkonen,L,COL,29,81,32,27,59
11,8475810,Bryan Rust,R,PIT,32,73,27,32,59
11,8480015,Owen Tippett,R,PHI,25,75,25,34,59
11,8476456,Jonathan Huberdeau,C,CGY,31,76,20,39,59
11,8482665,Matty Beniers,C,SEA,22,76,19,40,59
11,8480839,Rasmus Dahlin,D,BUF,24,69,18,41,59
11,8477494,Jonathan Drouin,L,COL,29,81,16,43,59
11,8479337,Alex DeBrincat,R,DET,27,80,29,29,58
11,8478519,Anthony Cirelli,C,TBL,27,82,27,31,58
11,8482113,Anton Lundell,C,FLA,23,76,20,38,58
11,8477949,Alex Tuch,R,BUF,28,73,14,44,58
11,8477504,Josh Morrissey,D,WPG,29,74,10,48,58
11,8475784,Jeff Skinner,C,EDM,32,77,30,27,57
11,8477456,J.T. Compher,L,DET,29,81,24,33,57
11,8482093,Seth Jarvis,C,CAR,22,69,22,35,57
11,8474150,Mikael Backlund,C,CGY,35,78,16,41,57
11,8480797,Joel Farabee,L,PHI,24,76,16,41,57
11,8475692,Mats Zuccarello,R,MIN,37,70,14,43,57
11,8478460,Zach Werenski,D,CBJ,27,79,12,45,57
11,8482159,Tyson Foerster,R,PHI,22,74,31,25,56
11,8475287,Erik Haula,L,NJD,33,67,27,28,55
11,8471215,Evgeni Malkin,C,PIT,38,74,22,33,55
11,8477416,Oliver Bjorkstrand,R,SEA,29,70,18,37,55
11,8473512,Claude Giroux,R,OTT,36,79,15,40,55
11,8478407,Vince Dunn,D,SEA,28,73,14,41,55
11,8476539,Jonathan Marchessault,R,NSH,34,72,33,21,54
11,8482109,Alexis Lafrenière,L,NYR,23,76,25,29,54
11,8474563,Drew Doughty,D,LAK,35,72,18,36,54
11,8475764,Cam Fowler,D,ANA,33,76,12,42,54
11,8479425,Filip Hronek,D,VAN,27,75,10,44,54
11,8477447,Shea Theodore,D,VGK,29,70,9,45,54
11,8477407,Anthony Duclair,L,NYI,29,79,23,30,53
11,8482124,Quinton Byfield,R,LAK,22,79,22,31,53
11,8480208,Drake Batherson,R,OTT,26,76,18,35,53
11,8475765,Vladimir Tarasenko,R,DET,33,81,18,35,53
11,8476875,Mike Matheson,D,MTL,30,72,11,42,53
11,8476853,Morgan Rielly,D,TOR,30,75,10,43,53
11,8475151,Kyle Palmieri,C,NYI,33,81,27,25,52
11,8474586,Jordan Eberle,R,SEA,34,76,21,31,52
11,8477503,Max Domi,C,TOR,29,75,21,31,52
11,8477497,Sean Monahan,C,CBJ,30,75,21,31,52
11,8480028,Morgan Frost,C,PHI,25,75,20,32,52
11,8475798,Mikael Granlund,C,SJS,32,72,13,39,52
11,8477935,Sam Bennett,C,FLA,28,77,29,22,51
11,8481068,Yegor Sharangovich,C,CGY,26,76,23,28,51
11,8483515,Juraj Slafkovsky,L,MTL,20,75,19,32,51
11,8481596,Shane Pinto,C,OTT,24,74,19,32,51
11,8482149,Cole Perfetti,C,WPG,22,70,25,25,50
11,8477986,Brandon Montour,D,SEA,30,68,20,30,50
11,8482702,Logan Stankoven,C,DAL,21,76,18,32,50
11,8476958,Jaccob Slavin,D,CAR,30,79,14,36,50
11,8481528,Dylan Cozens,C,BUF,23,73,23,26,49
11,8476882,Teuvo Teravainen,C,CHI,30,68,16,33,49
11,8482097,Jack Quinn,R,BUF,23,64,16,33,49
11,8478038,Devon Toews,D,COL,30,67,16,33,49
11,8480145,Neal Pionk,D,WPG,29,74,15,34,49
11,8481711,Matias Maccelli,L,UTA,24,76,13,36,49
11,8484153,Leo Carlsson,C,ANA,20,68,20,28,48
11,8478462,Nicolas Roy,C,VGK,27,75,17,31,48
11,8476905,Chandler Stephenson,C,SEA,30,72,16,32,48
11,8476826,Yanni Gourde,C,SEA,33,72,15,33,48
11,8481533,Trevor Zegras,C,ANA,23,73,15,33,48
11,8478396,Noah Hanifin,D,VGK,27,65,15,33,48
11,8474679,Gustav Nyquist,C,NSH,35,74,14,34,48
11,8478856,Conor Garland,R,VAN,28,66,13,35,48
11,8471724,Kris Letang,D,PIT,37,77,7,41,48
11,8481560,Arthur Kaliyev,R,LAK,23,78,24,23,47
11,8477511,Anthony Mantha,R,CGY,30,78,19,28,47
11,8474149,Evgenii Dadonov,R,DAL,35,82,19,28,47
11,8475793,Ryan Johansen,C,PHI,32,74,16,31,47
11,8481581,Thomas Harley,D,DAL,23,74,12,35,47
11,8476399,Blake Coleman,C,CGY,33,74,28,18,46
11,8475726,Tyler Toffoli,C,SJS,32,72,26,20,46
11,8483431,Logan Cooley,C,UTA,20,74,22,24,46
11,8482667,William Eklund,L,SJS,22,67,22,24,46
11,8476458,Ryan Strome,C,ANA,31,75,17,29,46
11,8477998,Warren Foegele,L,LAK,28,78,16,30,46
11,8476461,Sean Couturier,C,PHI,32,64,16,30,46
11,8476792,Torey Krug,D,STL,33,70,15,31,46
11,8478469,Thomas Chabot,D,OTT,27,75,13,33,46
11,8476432,Boone Jenner,C,CBJ,31,68,25,20,45
11,8475169,Evander Kane,L,EDM,33,76,24,21,45
11,8478542,Evan Rodrigues,C,FLA,31,77,21,24,45
11,8477964,Ivan Barbashev,C,VGK,29,77,19,26,45
11,8483808,Andrei Kuzmenko,L,CGY,28,76,17,28,45
11,8478042,Viktor Arvidsson,L,EDM,31,74,17,28,45
11,8481577,Philip Tomasino,C,NSH,23,67,15,30,45
11,8479410,Mikhail Sergachev,D,UTA,26,64,12,33,45
11,8478438,Tommy Novak,C,NSH,27,72,12,33,45
11,8474590,John Carlson,D,WSH,34,59,10,35,45
11,8480014,Gabriel Vilardi,C,WPG,25,58,25,19,44
11,8482110,Dawson Mercer,C,NJD,23,75,25,19,44
11,8482475,Yegor Chinakhov,R,CBJ,23,65,24,20,44
11,8475794,Tyler Seguin,C,DAL,32,80,21,23,44
11,8480798,Philipp Kurashev,C,CHI,25,66,21,23,44
11,8474102,David Perron,L,OTT,36,81,20,24,44
11,8475191,Reilly Smith,R,NYR,33,75,19,25,44
11,8476906,Shayne Gostisbehere,D,CAR,31,73,8,36,44
11,8478366,Frank Vatrano,R,ANA,30,71,27,16,43
11,8484166,Adam Fantilli,C,CBJ,20,72,26,17,43
11,8477426,Nicholas Paul,L,TBL,29,81,23,20,43
11,8475848,Brendan Gallagher,R,MTL,32,77,19,24,43
11,8478466,Daniel Sprong,R,VAN,27,74,17,26,43
11,8477021,Alex Kerfoot,C,UTA,30,77,14,29,43
11,8477479,Tyler Bertuzzi,L,CHI,29,60,23,19,42
11,8478046,Danton Heinen,L,VAN,29,70,20,22,42
11,8482092,Ridly Greig,C,OTT,22,75,19,23,42
11,8479525,Ross Colton,C,COL,28,80,19,23,42
11,8475714,Calle Jarnkrok,C,TOR,33,74,17,25,42
11,8477444,Andre Burakovsky,L,SEA,29,70,15,27,42
11,8476462,Dougie Hamilton,D,NJD,31,68,14,28,42
11,8475753,Justin Faulk,D,STL,32,76,13,29,42
11,8474641,Adam Henrique,C,EDM,34,76,13,29,42
11,8477495,Seth Jones,D,CHI,30,67,12,30,42
11,8478500,Ivan Provorov,D,CBJ,27,78,12,30,42
11,8476479,Phillip Danault,C,LAK,31,78,11,31,42
11,8474151,Ryan McDonagh,D,TBL,35,78,4,38,42
11,8478115,Pierre Engvall,L,NYI,28,80,21,20,41
11,8475768,Jaden Schwartz,C,SEA,32,69,20,21,41
11,8476483,Rickard Rakell,R,PIT,31,72,20,21,41
11,8475170,Brayden Schenn,C,STL,33,72,18,23,41
11,8478474,Lawson Crouse,L,UTA,27,69,18,23,41
11,8479365,Trent Frederic,C,BOS,26,78,18,23,41
11,8480188,Fabian Zetterlund,L,SJS,25,66,17,24,41
11,8476854,Hampus Lindholm,D,BOS,30,70,13,28,41
11,8478472,Mathieu Joseph,R,STL,27,69,12,29,41
11,8474565,Alex Pietrangelo,D,VGK,34,63,11,30,41
11,8481542,Moritz Seider,D,DET,23,75,10,31,41
11,8477932,Aaron Ekblad,D,FLA,28,68,9,32,41
11,8477948,Travis Sanheim,D,PHI,28,71,7,34,41
11,8478109,Victor Olofsson,L,VGK,29,71,23,17,40
11,8481618,Alex Newhook,C,MTL,23,75,19,21,40
11,8479339,Patrik Laine,L,CBJ,26,60,19,21,40
11,8480185,Eetu Luostarinen,C,FLA,26,74,19,21,40
11,8480459,Pius Suter,C,VAN,28,66,16,24,40
11,8475760,Nick Bjugstad,C,UTA,32,73,16,24,40
11,8475218,Mattias Ekholm,D,EDM,34,73,14,26,40
11,8480817,K'Andre Miller,D,NYR,24,74,9,31,40
11,8479400,Pierre-Luc Dubois,L,WSH,26,69,20,19,39
11,8476474,Stefan Noesen,R,NJD,31,63,15,24,39
11,8478397,Rasmus Andersson,D,CGY,28,72,9,30,39
11,8478055,Gustav Forsling,D,FLA,28,75,9,30,39
11,8483490,Pavel Mintyukov,D,ANA,21,70,7,32,39
11,8475314,Anders Lee,L,NYI,34,78,19,19,38
11,8477451,Ryan Hartman,R,MIN,30,70,16,22,38
11,8480220,Noah Cates,L,PHI,25,71,14,24,38
11,8479351,Sam Steel,C,DAL,26,78,13,25,38
11,8470613,Brent Burns,D,CAR,39,70,12,26,38
11,8474716,Jared Spurgeon,D,MIN,35,80,11,27,38
11,8482712,Oskar Olausson,R,COL,22,80,8,30,38
11,8477969,Marcus Pettersson,D,PIT,28,79,7,31,38
11,8476457,Adam Larsson,D,SEA,32,66,7,31,38
11,8480064,Josh Norris,C,OTT,25,73,17,20,37
11,8482089,Jake Neighbours,L,STL,22,73,17,20,37
11,8478458,John (Jack) Roslovic,C,CAR,27,73,16,21,37
11,8478463,Anthony Beauvillier,L,PIT,27,74,16,21,37
11,8476927,Teddy Blueger,C,VAN,30,71,13,24,37
11,8476292,Ondrej Palat,L,NJD,33,69,12,25,37
11,8482105,Jake Sanderson,D,OTT,22,76,12,25,37
11,8477346,MacKenzie Weegar,D,CGY,30,72,6,31,37
11,8476902,Esa Lindell,D,DAL,30,76,6,31,37
11,8480009,Eeli Tolvanen,R,SEA,25,66,19,17,36
11,8474053,Logan Couture,C,SJS,35,62,16,20,36
11,8481553,Bobby Brink,R,PHI,23,63,13,23,36
11,8476480,Vladislav Namestnikov,C,WPG,32,70,12,24,36
11,8475200,Dmitry Orlov,D,CAR,33,75,8,28,36
11,8481546,Cam York,D,PHI,23,68,6,30,36
11,8480078,Filip Chytil,C,NYR,25,71,17,18,35
11,8484145,Zach Benson,L,BUF,19,64,16,19,35
11,8477478,William Carrier,L,CAR,30,65,16,19,35
11,8478233,Andrew Mangiapane,L,WSH,28,64,14,21,35
11,8480802,Ryan McLeod,C,BUF,25,68,14,21,35
11,8478057,Dakota Joshua,C,VAN,28,64,14,21,35
11,8476463,Jonas Brodin,D,MIN,31,74,9,26,35
11,8480829,Jesperi Kotkaniemi,C,CAR,24,59,16,18,34
11,8480835,Jack Drury,C,CAR,24,61,16,18,34
11,8477498,Darnell Nurse,D,EDM,29,78,15,19,34
11,8479987,Morgan Geekie,C,BOS,26,73,13,21,34
11,8477429,Andrew Copp,C,DET,30,80,13,21,34
11,8476872,Scott Laughton,C,PHI,30,75,13,21,34
11,8479591,Michael Eyssimont,C,TBL,28,81,10,24,34
11,8479345,Jakob Chychrun,D,WSH,26,74,8,26,34
11,8482660,Kent Johnson,C,CBJ,22,66,8,26,34
11,8481554,Kaapo Kakko,R,NYR,23,70,22,11,33
11,8482737,Zack Bolduc,C,STL,21,65,21,12,33
11,8474715,Cameron Atkinson,R,TBL,35,79,19,14,33
11,8471698,T.J. Oshie,R,WSH,38,66,18,15,33
11,8482720,Matthew Knies,L,TOR,22,74,16,17,33
11,8473422,Nick Foligno,L,CHI,37,63,16,17,33
11,8480849,Barrett Hayton,C,UTA,24,72,15,18,33
11,8482117,Lukas Reichel,L,CHI,22,57,15,18,33
11,8481535,Nils Hoglander,L,VAN,24,68,14,19,33
11,8479661,Tanner Jeannot,L,LAK,27,75,13,20,33
11,8477987,Ryan Donato,C,CHI,28,62,12,21,33
11,8476869,Brady Skjei,D,NSH,30,69,10,23,33
11,8481656,Aliaksei Protas,C,WSH,23,67,9,24,33
11,8479639,Dylan Coghlan,D,WPG,26,64,9,24,33
11,8480434,Sean Durzi,D,UTA,26,73,8,25,33
11,8482122,Brock Faber,D,MIN,22,76,7,26,33
11,8482133,Thomas Bordeleau,C,SJS,22,66,7,26,33
11,8476438,Brandon Saad,L,STL,32,72,19,13,32
11,8481604,Pavel Dorofeyev,L,VGK,24,71,16,16,32
11,8477425,Miles Wood,L,COL,29,78,15,17,32
11,8481624,Ilya Mikheyev,R,CHI,30,64,13,19,32
11,8482624,Daniil Miromanov,D,CGY,27,64,13,19,32
11,8478882,Vladislav Gavrikov,D,LAK,29,72,10,22,32
11,8477506,Ryan Pulock,D,NYI,30,76,4,28,32
11,8476918,Jimmy Vesey,L,NYR,31,67,15,16,31
11,8483445,Cutter Gauthier,L,ANA,20,67,13,18,31
11,8482146,Luke Evangelista,R,NSH,22,67,12,19,31
11,8476880,Tom Wilson,R,WSH,30,63,12,19,31
11,8479992,Michael Rasmussen,C,DET,25,75,10,21,31
11,8484203,Bradly Nadeau,L,CAR,19,65,9,22,31
11,8478133,Jake Evans,C,MTL,28,69,9,22,31
11,8476422,Mike Reilly,D,NYI,31,75,8,23,31
11,8476885,Jacob Trouba,D,NYR,30,67,7,24,31
11,8475722,Jason Zucker,L,BUF,32,71,17,13,30
11,8482142,Jamie Drysdale,D,PHI,22,69,11,19,30
11,8476856,Mathew Dumba,D,DAL,30,68,10,20,30
11,8476923,Damon Severson,D,CBJ,30,80,6,24,30
11,8482671,Owen Power,D,BUF,22,66,4,26,30
11,8475193,Tomas Tatar,L,NJD,34,64,17,12,29
11,8477952,Robby Fabbri,C,ANA,28,63,14,15,29
11,8473563,Nicklas Backstrom,C,WSH,37,59,11,18,29
11,8480336,Sean Walker,D,CAR,30,75,10,19,29
11,8481704,Juuso Parssinen,C,NSH,23,53,9,20,29
11,8481186,Logan O'Connor,R,COL,28,80,7,22,29
11,8481703,Valtteri Puustinen,R,PIT,25,62,7,22,29
11,8479998,Mikey Anderson,D,LAK,25,62,3,26,29
11,8473533,Jordan Staal,C,CAR,36,66,18,10,28
11,8477450,Jason Dickinson,C,CHI,29,62,15,13,28
11,8481582,Nicholas Robertson,L,TOR,23,68,14,14,28
11,8482175,JJ Peterka,R,BUF,22,63,13,15,28
11,8476392,Adam Lowry,C,WPG,31,63,12,16,28
11,8480068,Ryan Poehling,C,PHI,25,67,12,16,28
11,8476419,Jean-Gabriel Pageau,C,NYI,32,76,10,18,28
11,8480789,Oliver Wahlstrom,R,NYI,24,64,10,18,28
11,8480871,Adam Boqvist,D,FLA,24,73,7,21,28
11,8476979,Erik Gustafsson,D,DET,32,71,6,22,28
11,8476917,Adam Pelech,D,NYI,30,77,6,22,28
11,8473507,Jeff Petry,D,DET,37,73,6,22,28
11,8475799,Nino Niederreiter,R,WPG,32,67,17,10,27
11,8480113,Alex Iafallo,L,WPG,31,68,13,14,27
11,8482749,Joshua Roy,R,MTL,21,59,13,14,27
11,8480855,Jack McBain,C,UTA,24,65,12,15,27
11,8483524,Shane Wright,C,SEA,20,70,12,15,27
11,8479293,Brandon Tanev,L,SEA,33,60,11,16,27
11,8476925,Colton Sissons,C,NSH,31,58,11,16,27
11,8481580,Connor McMichael,C,WSH,23,66,9,18,27
11,8482705,Cole Sillinger,C,CBJ,21,66,8,19,27
11,8476892,Colton Parayko,D,STL,31,67,5,22,27
11,8478507,John Marino,D,UTA,27,62,3,24,27
11,8479414,Nathan Bastian,R,NJD,27,64,16,10,26
11,8478020,Michael Amadio,R,OTT,28,72,14,12,26
11,8476278,Colin Blackwell,C,DAL,31,80,14,12,26
11,8481441,Joe Snively,C,DET,28,65,12,14,26
11,8481523,Kirby Dach,C,MTL,23,63,11,15,26
11,8476469,Joel Armia,R,MTL,31,70,11,15,26
11,8480878,Nils Lundkvist,D,DAL,24,75,9,17,26
11,8480043,Timothy Liljegren,D,TOR,25,67,3,23,26
11,8482055,Drew O'Connor,L,PIT,26,61,17,8,25
11,8480893,Kirill Marchenko,R,CBJ,24,60,17,8,25
11,8478508,Yakov Trenin,C,MIN,27,65,17,8,25
11,8481601,Simon Holmstrom,R,NYI,23,71,15,10,25
11,8475763,Kevin Hayes,R,PIT,32,66,13,12,25
11,8476878,Zemgus Girgensons,C,TBL,30,79,12,13,25
11,8479390,Taylor Raddysh,R,WSH,26,62,11,14,25
11,8476921,Jordan Martinook,L,CAR,32,60,11,14,25
11,8475149,Marcus Johansson,L,MIN,34,63,11,14,25
11,8477953,Kasperi Kapanen,R,STL,28,68,11,14,25
11,8478432,Christian Fischer,R,DET,27,75,11,14,25
11,8477505,Alexander Wennberg,C,SJS,30,69,11,14,25
11,8477947,Sonny Milano,L,WSH,28,68,10,15,25
11,8478013,Jake Walman,D,SJS,28,67,9,16,25
11,8477508,Curtis Lazar,C,NJD,29,58,8,17,25
11,8482073,Braden Schneider,D,NYR,23,59,3,22,25
11,8481524,Bowen Byram,D,BUF,23,63,11,13,24
11,8477839,Conor Sheary,L,TBL,32,80,9,15,24
11,8478891,Mason Appleton,C,WPG,28,67,8,16,24
11,8477989,Christian Dvorak,C,MTL,28,58,8,16,24
11,8474189,Lars Eller,C,PIT,35,63,7,17,24
11,8475171,Oliver Ekman-Larsson,D,TOR,33,67,6,18,24
11,8475233,David Savard,D,MTL,34,61,5,19,24
11,8475462,Radko Gudas,D,ANA,34,69,3,21,24
11,8479982,Conor Timmins,D,TOR,26,54,3,21,24
11,8476891,Matthew Grzelcyk,D,PIT,30,72,1,23,24
11,8479370,Tyson Jost,C,CAR,26,47,13,10,23
11,8479619,Michael Carcone,L,UTA,28,60,12,11,23
11,8477979,Nicolas Aube-Kubel,R,BUF,28,58,11,12,23
11,8480281,Alexey Toropchenko,R,STL,25,61,10,13,23
11,8477919,Frederick Gaudreau,C,MIN,31,60,9,14,23
11,8477446,Michael McCarron,R,NSH,29,60,9,14,23
11,8483505,Matthew Poitras,C,BOS,20,73,7,16,23
11,8481606,Jordan Spence,D,LAK,23,65,4,19,23
11,8480246,Nick Perbix,D,TBL,26,78,3,20,23
11,8482803,Olen Zellweger,D,ANA,21,66,3,20,23
11,8476981,Josh Anderson,R,MTL,30,68,14,8,22
11,8478569,Noel Acciari,C,PIT,33,59,12,10,22
11,8480144,David Kampf,C,TOR,29,71,11,11,22
11,8482074,Connor Zary,C,CGY,23,67,10,12,22
11,8476822,Luke Glendening,C,TBL,35,76,10,12,22
11,8476897,Oskar Sundqvist,C,STL,30,63,9,13,22
11,8470621,Corey Perry,R,EDM,39,64,9,13,22
11,8476873,Mark Jankowski,C,NSH,30,53,8,14,22
11,8481014,Alexander Romanov,D,NYI,24,76,4,18,22
11,8480448,Parker Kelly,L,COL,25,69,13,8,21
11,8477392,Hudson Fasching,R,NYI,29,62,12,9,21
11,8481481,Blake Lizotte,C,PIT,27,64,12,9,21
11,8480748,Kiefer Sherwood,L,VAN,29,62,12,9,21
11,8480021,Jack Studnicka,C,LAK,25,63,12,9,21
11,8480074,Alexandre Texier,C,STL,25,52,11,10,21
11,8478413,Jordan Greenway,L,BUF,27,66,10,11,21
11,8483499,Liam Ohgren,L,MIN,20,61,10,11,21
11,8480205,Emil Bemstrom,C,PIT,25,53,10,11,21
11,8479336,Carl Grundstrom,R,SJS,27,57,10,11,21
11,8479996,Cody Glass,C,NSH,25,56,9,12,21
11,8479316,Luke Kunin,C,SJS,27,66,8,13,21
11,8481517,Brett Leason,R,ANA,25,49,8,13,21
11,8483482,Tristan Luneau,D,ANA,20,63,8,13,21
11,8479315,Joey Anderson,R,CHI,26,56,7,14,21
11,8475231,Casey Cizikas,C,NYI,33,68,7,14,21
11,8477499,Rasmus Ristolainen,D,PHI,30,61,7,14,21
11,8477931,Tomas Nosek,L,FLA,32,53,7,14,21
11,8477220,Nate Schmidt,D,FLA,33,69,6,15,21
11,8479353,Brett Howden,C,VGK,26,71,5,16,21
11,8480891,Michael Kesselring,D,UTA,24,60,5,16,21
11,8482245,Artem Zub,D,OTT,29,70,4,17,21
11,8474574,Tyler Myers,D,VAN,34,73,4,17,21
11,8477488,Brett Pesce,D,NJD,30,72,3,18,21
11,8477903,Garnet Hathaway,R,PHI,33,67,13,7,20
11,8482259,Bobby McMann,C,TOR,28,63,12,8,20
11,8479368,Max Jones,L,BOS,26,66,12,8,20
11,8477015,Connor Brown,R,EDM,30,61,11,9,20
11,8473453,Trevor Lewis,C,LAK,37,72,10,10,20
11,8481032,Paul Cotter,C,NJD,25,58,10,10,20
11,8478421,A.J. Greer,L,FLA,28,61,10,10,20
11,8482079,Marco Rossi,C,MIN,23,58,8,12,20
11,8482157,Will Cuylle,L,NYR,22,57,7,13,20
11,8482067,Connor Mackey,D,NYR,28,61,7,13,20
11,8475791,Taylor Hall,L,CHI,33,48,6,14,20
11,8480806,Isac Lundestrom,C,ANA,25,58,6,14,20
11,8479398,Samuel Girard,D,COL,26,69,5,15,20
11,8475790,Erik Gudbranson,D,CBJ,32,75,5,15,20
11,8475279,Ben Chiarot,D,DET,33,67,5,15,20
11,8476312,Josh Manson,D,COL,33,60,4,16,20
11,8479976,Juuso Valimaki,D,UTA,26,55,4,16,20
11,8479324,Ryan Lindgren,D,NYR,26,58,4,16,20
11,8480049,Dylan Samberg,D,WPG,25,68,3,17,20
11,8478840,Will Borgen,D,SEA,28,61,3,17,20
11,8476879,Cody Ceci,D,EDM,31,65,3,17,20
11,8482655,Janis Moser,D,TBL,24,76,2,18,20
11,8476429,Scott Mayfield,D,NYI,32,75,2,18,20
11,8481059,Scott Perunovich,D,STL,26,63,2,18,20
11,8480222,Sebastian Aho,D,PIT,28,74,1,19,20
11,8474673,TJ Brodie,D,CHI,34,62,1,19,20
11,8482125,Alexander Holtz,R,VGK,22,69,13,6,19
11,8482744,James Malatesta,L,CBJ,21,47,10,9,19
11,8480252,Cole Guttman,C,CHI,25,42,8,11,19
11,8480003,Jesper Boqvist,C,FLA,26,68,6,13,19
11,8482111,Justin Barron,D,MTL,23,64,6,13,19
11,8476329,Travis Boyd,C,MIN,31,54,6,13,19
11,8481161,Jake Christiansen,D,CBJ,25,63,6,13,19
11,8481521,Ronnie Attard,D,PHI,25,58,5,14,19
11,8476467,Jamie Oleksiak,D,SEA,32,76,5,14,19
11,8480873,Rasmus Sandin,D,WSH,24,59,5,14,19
11,8479983,Mario Ferraro,D,SJS,26,70,4,15,19
11,8476331,Dylan DeMelo,D,WPG,31,64,1,18,19
11,8479941,Justin Danforth,R,CBJ,31,54,10,8,18
11,8479393,Noah Gregor,L,OTT,26,71,9,9,18
11,8479066,Ryan Lomberg,L,CGY,30,63,9,9,18
11,8482809,Jackson Blake,R,CAR,21,59,8,10,18
11,8476889,Radek Faksa,C,STL,30,55,8,10,18
11,8482747,Brennan Othmann,L,NYR,21,44,7,11,18
11,8475842,Sam Carrick,C,NYR,32,68,7,11,18
11,8475220,Marcus Foligno,L,MIN,33,55,6,12,18
11,8480157,Calle Rosen,D,COL,30,51,6,12,18
11,8479543,Michael Pezzetta,L,MTL,26,56,6,12,18
11,8481599,Victor Soderstrom,D,UTA,23,53,6,12,18
11,8480762,Eric Robinson,L,CAR,29,59,5,13,18
11,8474166,Alec Martinez,D,CHI,37,54,5,13,18
11,8482192,Isaak Phillips,D,CHI,23,60,5,13,18
11,8477435,Ryan Graves,D,PIT,29,74,4,14,18
11,8479369,Andrew Peeke,D,BOS,26,54,4,14,18
11,8480860,Kevin Bahl,D,CGY,24,63,3,15,18
11,8475208,Brian Dumoulin,D,ANA,33,60,8,9,17
11,8483468,Jiri Kulich,C,BUF,20,53,7,10,17
11,8483493,Frank Nazar,C,CHI,20,56,5,12,17
11,8477507,Nikita Zadorov,D,BOS,29,69,4,13,17
11,8482176,Wyatt Kaiser,D,CHI,22,49,4,13,17
11,8479402,Jake Bean,D,CGY,26,64,3,14,17
11,8478136,Jake Middleton,D,MIN,28,75,3,14,17
11,8475750,Jon Merrill,D,MIN,32,63,3,14,17
11,8478970,Jalen Chatfield,D,CAR,28,71,2,15,17
11,8478416,Erik Cernak,D,TBL,27,72,2,15,17
11,8481641,Joel Kiviranta,L,COL,28,74,10,6,16
11,8481477,Nico Sturm,C,SJS,29,61,8,8,16
11,8483457,Lane Hutson,D,MTL,20,67,7,9,16
11,8478434,Keegan Kolesar,R,VGK,27,67,7,9,16
11,8480980,Connor Dewar,C,TOR,25,71,6,10,16
11,8476988,Matt Benning,D,SJS,30,61,5,11,16
11,8482634,Alex Steeves,C,TOR,25,46,5,11,16
11,8475690,Chris Tanev,D,TOR,35,66,4,12,16
11,8471677,Jack Johnson,D,CBJ,37,64,4,12,16
11,8479986,Kole Lind,R,DAL,26,54,3,13,16
11,8480995,Pontus Holmberg,R,TOR,25,58,2,14,16
11,8475455,Brenden Dillon,D,NJD,34,56,2,14,16
11,8478851,Alexandre Carrier,D,NSH,28,68,1,15,16
11,8481568,Alex Vlasic,D,CHI,23,49,1,15,16
11,8478043,Sam Lafferty,C,BUF,29,58,10,5,15
11,8481716,Dmitri Voronkov,L,CBJ,24,42,10,5,15
11,8481518,Nolan Foote,L,NJD,24,36,10,5,15
11,8479439,Jacob MacDonald,D,COL,31,47,9,6,15
11,8481028,Martin Pospisil,C,CGY,25,57,9,6,15
11,8479968,Vinni Lettieri,C,BOS,29,50,8,7,15
11,8482101,Danil Gushchin,L,SJS,22,54,7,8,15
11,8476374,Sean Kuraly,C,CBJ,31,58,7,8,15
11,8481537,Nikita Okhotiuk,D,CGY,24,53,7,8,15
11,8477353,Tyler Motte,C,DET,29,71,6,9,15
11,8480025,MacKenzie Entwistle,R,FLA,25,61,6,9,15
11,8480292,Carson Meyer,R,ANA,27,44,6,9,15
11,8476960,Andreas Athanasiou,C,CHI,30,50,5,10,15
11,8476525,Colin Miller,D,WPG,32,61,5,10,15
11,8480192,Johnathan Kovacevic,D,NJD,27,54,5,10,15
11,8480796,Martin Fehervary,D,WSH,25,57,5,10,15
11,8478911,Matt Roy,D,WSH,29,67,4,11,15
11,8475181,Nick Leddy,D,STL,33,66,4,11,15
11,8476994,Vinnie Hinostroza,C,NSH,30,47,4,11,15
11,8477018,Ben Hutton,D,VGK,31,46,4,11,15
11,8479348,Kale Clague,D,BUF,26,46,4,11,15
11,8478452,Caleb Jones,D,LAK,27,56,3,12,15
11,8481019,David Gustafsson,C,WPG,24,47,2,13,15
11,8476931,Jake McCabe,D,TOR,31,64,2,13,15
11,8475188,Brayden McNabb,D,VGK,33,57,2,13,15
11,8480035,Henri Jokiharju,D,BUF,25,65,2,13,15
11,8479371,Dante Fabbro,D,NSH,26,66,2,13,15
11,8482451,Mikael Pyyhtia,L,CBJ,23,50,0,15,15
11,8477573,Nathan Walker,L,STL,30,53,10,4,14
11,8480813,Joe Veleno,C,DET,24,78,9,5,14
11,8481789,Tye Kartye,L,SEA,23,40,9,5,14
11,8478585,Derek Ryan,C,EDM,38,66,7,7,14
11,8483466,Kevin Korchinski,D,CHI,20,48,6,8,14
11,8479944,Zach Aston-Reese,C,VGK,30,46,6,8,14
11,8483495,Simon Nemec,D,NJD,20,55,5,9,14
11,8475855,Jesper Fast,R,CAR,33,59,5,9,14
11,8481617,Vasily Podkolzin,R,VAN,23,43,5,9,14
11,8481522,Peyton Krebs,C,BUF,23,60,4,10,14
11,8479671,Mathieu Olivier,R,CBJ,27,45,4,10,14
11,8480073,Erik Brannstrom,D,COL,25,61,4,10,14
11,8479372,Joshua Mahura,D,SEA,26,50,3,11,14
11,8482087,Kaiden Guhle,D,MTL,22,62,2,12,14
11,8480070,Ian Mitchell,D,BOS,25,47,2,12,14
11,8477365,Connor Clifton,D,BUF,29,65,2,12,14
11,8475324,Nick Jensen,D,OTT,34,70,0,14,14
11,8481178,Egor Zamula,D,PHI,24,54,0,14,14
11,8479520,Brandon Duhaime,R,WSH,27,59,8,5,13
11,8477887,Patrick Brown,C,BOS,32,41,8,5,13
11,8482964,Arber Xhekaj,D,MTL,23,48,7,6,13
11,8475343,Nic Dowd,C,WSH,34,63,6,7,13
11,8478017,Mark Friedman,D,VAN,29,40,6,7,13
11,8478178,Darren Raddysh,D,TBL,28,66,5,8,13
11,8477962,Brendan Lemieux,L,CAR,28,35,5,8,13
11,8477369,Carson Soucy,D,VAN,30,55,4,9,13
11,8481708,Zac Jones,D,NYR,24,52,4,9,13
11,8477851,Jordan Oesterle,D,BOS,32,42,4,9,13
11,8480007,Jonas Rondbjerg,R,VGK,25,37,4,9,13
11,8481527,Kaedan Korczak,D,VGK,23,43,3,10,13
11,8480011,Klim Kostin,C,SJS,25,42,3,10,13
11,8477845,Trevor van Riemsdyk,D,WSH,33,57,3,10,13
11,8476874,Olli Maatta,D,DET,30,52,2,11,13
11,8471709,Marc-Edouard Vlasic,D,SJS,37,62,2,11,13
11,8483460,David Jiricek,D,CBJ,21,53,1,12,13
11,8480807,Mattias Samuelsson,D,BUF,24,51,0,13,13
11,8482155,Alex Laferriere,R,LAK,23,65,10,2,12
11,8482659,Josh Doan,R,UTA,22,49,9,3,12
11,8479972,Mason Shaw,C,WPG,26,48,8,4,12
11,8482679,Matt Coronato,R,CGY,22,64,7,5,12
11,8479328,Julien Gauthier,R,NYI,27,61,7,5,12
11,8483491,Ivan Miroshnichenko,L,WSH,20,56,6,6,12
11,8480289,Morgan Barron,C,WPG,26,49,6,6,12
11,8482807,Ethan Del Mastro,D,CHI,21,53,6,6,12
11,8479718,Alex Barré-Boulet,C,MTL,27,47,5,7,12
11,8477380,Jonny Brodzinski,C,NYR,31,47,5,7,12
11,8482148,Hendrix Lapierre,C,WSH,22,52,4,8,12
11,8478443,Brandon Carlo,D,BOS,28,61,4,8,12
11,8476967,Brett Kulak,D,EDM,30,61,4,8,12
11,8478451,Ethan Bear,D,WSH,27,45,4,8,12
11,8475225,Craig Smith,C,CHI,35,52,3,9,12
11,8481600,Tobias Bjornfot,D,FLA,23,50,3,9,12
11,8475718,Justin Holl,D,DET,32,53,3,9,12
11,8478859,Niko Mikkola,D,FLA,28,56,2,10,12
11,8477938,Haydn Fleury,D,WPG,28,45,2,10,12
11,8475179,Dmitry Kulikov,D,FLA,34,62,1,11,12
11,8475177,Calvin de Haan,D,COL,33,49,1,11,12
11,8478831,Kevin Stenlund,C,UTA,28,60,9,2,11
11,8481013,Jonatan Berggren,R,DET,24,56,7,4,11
11,8481147,Reese Johnson,C,MIN,26,35,7,4,11
11,8481093,Rafael Harvey-Pinard,L,MTL,25,60,6,5,11
11,8480355,Mark Kastelic,C,BOS,25,58,6,5,11
11,8482762,Simon Edvinsson,D,DET,21,66,6,5,11
11,8477070,Liam O'Brien,C,UTA,30,53,6,5,11
11,8482062,Cole Smith,L,NSH,29,54,5,6,11
11,8476867,Brendan Gaunce,C,MIN,30,34,5,6,11
11,8476858,Phillip Di Giuseppe,L,VAN,31,45,4,7,11
11,8484149,Gavin Brindley,C,CBJ,20,44,3,8,11
11,8479994,Jaret Anderson-Dolan,C,WPG,25,34,3,8,11
11,8479026,Philippe Myers,D,TOR,27,48,3,8,11
11,8474090,Brendan Smith,D,DAL,35,55,3,8,11
11,8476441,Joel Edmundson,D,LAK,31,38,3,8,11
11,8474568,Luke Schenn,D,NSH,35,56,3,8,11
11,8477335,Kyle Burroughs,D,LAK,29,41,3,8,11
11,8478211,Dryden Hunt,L,CGY,29,51,2,9,11
11,8476473,Connor Murphy,D,CHI,31,31,2,9,11
11,8481701,Santeri Hatakka,D,NJD,23,40,2,9,11
11,8471817,Ryan Reaves,R,TOR,37,52,6,4,10
11,8476934,Brock McGinn,L,ANA,30,42,4,6,10
11,8482859,Zack Ostapchuk,C,OTT,21,47,4,6,10
11,8479291,Kevin Rooney,C,CGY,31,47,4,6,10
11,8478424,Jansen Harkins,C,ANA,27,42,4,6,10
11,8474034,Patrick Maroon,L,CHI,36,47,3,7,10
11,8480727,Zach Whitecloud,D,VGK,28,55,3,7,10
11,8478468,Jeremy Lauzon,D,NSH,27,53,2,8,10
11,8481122,Simon Benoit,D,TOR,26,39,2,8,10
11,8470600,Ryan Suter,D,STL,39,61,1,9,10
11,8478399,Jonas Siegenthaler,D,NJD,27,59,1,9,10
11,8484254,Akito Hirose,D,VAN,25,39,1,9,10
11,8480196,Jacob Bryson,D,BUF,27,44,0,10,10
11,8478454,Noah Juulsen,D,VAN,27,44,0,10,10
11,8477406,Mattias Janmark,C,EDM,32,62,6,3,9
11,8481532,Alex Turcotte,C,LAK,23,39,6,3,9
11,8479344,Jesse Puljujarvi,R,PIT,26,42,5,4,9
11,8482077,Dylan Holloway,L,EDM,23,46,5,4,9
11,8479772,Zack MacEwen,R,OTT,28,52,5,4,9
11,8481751,Lukas Rousek,R,BUF,25,49,4,5,9
11,8481550,Adam Beckman,L,NJD,23,40,3,6,9
11,8475235,Nicolas Deslauriers,L,PHI,33,49,3,6,9
11,8482095,Tyler Kleven,D,OTT,22,39,3,6,9
11,8476952,Dominic Toninato,C,WPG,30,40,3,6,9
11,8483549,Lucas Condotta,L,MTL,27,38,3,6,9
11,8476624,Barclay Goodrow,C,SJS,31,51,2,7,9
11,8479249,Andrew Poturalski,C,SJS,30,32,2,7,9
11,8477527,Ross Johnston,L,ANA,30,34,2,7,9
11,8481167,Brayden Pachal,D,CGY,25,45,1,8,9
11,8480950,Ilya Lyubushkin,D,DAL,30,59,1,8,9
11,8474013,Ian Cole,D,UTA,35,55,1,8,9
11,8480887,Jordan Harris,D,MTL,24,53,0,9,9
11,8477482,Zachary Sanford,L,CHI,30,35,6,2,8
11,8479359,Beck Malenstyn,L,BUF,26,42,6,2,8
11,8482166,Shakir Mukhamadullin,D,SJS,22,57,5,3,8
11,8484911,Collin Graf,R,SJS,22,35,5,3,8
11,8477971,Andreas Englund,D,LAK,28,35,4,4,8
11,8480001,Urho Vaakanainen,D,ANA,25,58,3,5,8
11,8479981,Jonah Gadjovich,L,FLA,26,40,3,5,8
11,8481754,Nikita Nesterenko,C,ANA,23,40,3,5,8
11,8483565,Nick Blankenburg,D,NSH,26,59,2,6,8
11,8480172,Jan Rutta,D,SJS,34,62,2,6,8
11,8481609,Vladislav Kolyachonok,D,UTA,23,31,2,6,8
11,8474567,Zach Bogosian,D,MIN,34,64,1,7,8
11,8480058,Pierre-Olivier Joseph,D,STL,25,55,1,7,8
11,8482861,Vincent Iorio,D,WSH,22,41,1,7,8
11,8484258,Sam Malinski,D,COL,26,18,1,7,8
11,8478450,Parker Wotherspoon,D,BOS,27,42,1,7,8
11,8481567,Henry Thrun,D,SJS,23,50,0,8,8
11,8482713,Mackie Samoskevich,R,FLA,22,44,5,2,7
11,8480990,Declan Chisholm,D,MIN,24,39,4,3,7
11,8482784,Zach Dean,C,STL,21,40,4,3,7
11,8483619,Filip Roos,D,OTT,25,36,4,3,7
11,8476442,Matt Nieto,L,PIT,32,50,3,4,7
11,8482733,Logan Mailloux,D,MTL,31,41,3,4,7
11,8483630,Pavol Regenda,L,ANA,25,23,3,4,7
11,8480848,Ty Dellandrea,C,SJS,24,40,2,5,7
11,8482496,Nils Aman,C,VAN,24,35,2,5,7
11,8480879,Jacob Bernard-Docker,D,OTT,24,52,2,5,7
11,8481679,Maxence Guenette,D,OTT,23,31,2,5,7
11,8478146,Matthew Highmore,C,OTT,28,41,2,5,7
11,8482118,Sam Colangelo,R,ANA,23,17,2,5,7
11,8476913,Devin Shore,C,MIN,30,33,2,5,7
11,8479378,Logan Stanley,D,WPG,26,42,1,6,7
11,8479980,Nicolas Hague,D,VGK,26,42,1,6,7
11,8479536,Axel Jonsson-Fjallby,L,WPG,26,33,1,6,7
11,8476372,Nick Seeler,D,PHI,31,47,0,7,7
11,8483570,Ben Meyers,C,SEA,26,23,5,1,6
11,8477401,John Hayden,C,SEA,29,34,4,2,6
11,8483763,Maksymilian Szuber,D,UTA,22,37,4,2,6
11,8479379,Givani Smith,R,SJS,26,28,3,3,6
11,8482652,Walker Duehr,R,CGY,27,37,3,3,6
11,8482765,Isak Rosen,R,BUF,21,29,3,3,6
11,8481056,Spencer Stastney,D,NSH,24,29,2,4,6
11,8482511,Mason Lohrei,D,BOS,23,34,2,4,6
11,8480245,Olle Lycksell,R,PHI,25,37,2,4,6
11,8483012,Logan Morrison,C,SEA,22,44,1,5,6
11,8477244,Chad Ruhwedel,D,NYR,34,35,1,5,6
11,8482730,Brandt Clarke,D,LAK,21,45,0,6,6
11,8479442,Troy Stecher,D,EDM,30,50,0,6,6
11,8477034,Jaycob Megna,D,FLA,32,37,0,6,6
11,8481598,Philip Broberg,D,EDM,23,37,0,6,6
11,8479320,Maxime Lajoie,D,SEA,27,27,0,6,6
11,8480834,Ty Emberson,D,SJS,24,36,0,6,6
11,8479362,Riley Tufte,L,BOS,26,20,4,1,5
11,8480441,Trey Fix-Wolansky,R,CBJ,25,37,3,2,5
11,8481592,Jakob Pelletier,L,CGY,23,43,3,2,5
11,8482070,Mitchell Chaffee,R,TBL,26,47,3,2,5
11,8478874,Adam Gaudette,R,OTT,28,38,3,2,5
11,8475958,Michael Sgarbossa,C,WSH,32,22,3,2,5
11,8483397,Marc McLaughlin,C,BOS,25,38,2,3,5
11,8482666,Scott Morrow,D,CAR,22,49,2,3,5
11,8475762,Derek Forbort,D,VAN,32,44,2,3,5
11,8478021,William Lagesson,D,DET,28,35,2,3,5
11,8481806,Louis Crevier,D,CHI,23,19,2,3,5
11,8473446,Erik Johnson,D,PHI,36,41,1,4,5
11,8477073,Kurtis MacDermid,L,NJD,30,36,1,4,5
11,8481605,Jackson LaCombe,D,ANA,23,30,1,4,5
11,8474612,Travis Hamonic,D,OTT,34,36,1,4,5
11,8481556,John Beecher,C,BOS,23,30,4,0,4
11,8478409,Anthony Richard,C,PHI,28,24,4,0,4
11,8479367,William Lockwood,R,FLA,26,33,4,0,4
11,8481422,Jake Lucchini,C,NSH,29,25,3,1,4
11,8480468,James Hamblin,L,EDM,25,27,3,1,4
11,8480844,Grigori Denisenko,L,VGK,24,26,2,2,4
11,8477810,Joel Hanley,D,CGY,33,22,2,2,4
11,8482250,Callahan Burke,C,VGK,27,21,2,2,4
11,8481043,Cole Koepke,L,BOS,26,14,2,2,4
11,8478881,Brett Seney,L,CHI,28,11,2,2,4
11,8481593,Jayden Struble,D,MTL,23,24,2,2,4
11,8482751,Ryan Winterton,C,SEA,21,35,1,3,4
11,8483471,Brad Lambert,C,WPG,31,14,1,3,4
11,8482177,Marat Khusnutdinov,C,MIN,22,29,0,4,4
11,8478477,Mitchell Stephens,C,SEA,27,18,0,4,4
11,8480870,Bo Groulx,C,NYR,24,32,3,0,3
11,8482061,Brandon Biro,L,SEA,26,10,3,0,3
11,8479638,Justin Brazeau,R,BOS,26,36,2,1,3
11,8480880,Jakub Lauko,C,MIN,24,37,2,1,3
11,8477467,Gustav Olofsson,D,SEA,30,14,2,1,3
11,8477384,Joshua Brown,D,EDM,30,49,2,1,3
11,8479985,Cale Fleury,D,SEA,26,28,2,1,3
11,8481024,Linus Karlsson,C,VAN,25,16,2,1,3
11,8482153,Brendan Brisson,C,VGK,23,32,1,2,3
11,8482145,Mavrik Bourque,C,DAL,22,47,1,2,3
11,8477462,Robert Hagg,D,VGK,29,25,1,2,3
11,8478051,Max Willman,C,NJD,29,14,1,2,3
11,8477149,Scott Sabourin,R,SJS,32,18,0,3,3
11,8481719,Maxwell Crozier,D,TBL,24,13,0,3,3
11,8483489,Fraser Minten,C,TOR,31,17,0,3,3
11,8480845,Rasmus Kupari,C,WPG,24,36,2,0,2
11,8479991,Jake Leschyshyn,C,NYR,25,25,2,0,2
11,8481541,Samuel Bolduc,D,NYI,24,25,2,0,2
11,8477473,Justin Bailey,R,SJS,29,13,2,0,2
11,8481585,Egor Afanasyev,L,SJS,23,13,2,0,2
11,8475413,Justin Dowling,C,NJD,34,15,2,0,2
11,8481065,Angus Crookshank,L,OTT,25,18,2,0,2
11,8479421,Jacob Moverare,D,LAK,26,6,2,0,2
11,8480890,Jan Jenik,C,OTT,24,28,1,1,2
11,8478011,Louie Belpedio,D,PHI,28,14,1,1,2
11,8474062,Riley Nash,C,NYR,35,14,1,1,2
11,8482165,Yan Kuznetsov,D,CGY,22,19,1,1,2
11,8481699,Aku Raty,R,UTA,23,15,1,1,2
11,8482102,Vasily Ponomarev,C,PIT,22,13,1,1,2
11,8482470,Ilya Solovyov,D,CGY,24,18,1,1,2
11,8483609,Adam Klapka,R,CGY,24,6,1,1,2
11,8482476,Emil Heineman,L,MTL,23,5,1,1,2
11,8482144,Jack Thompson,D,SJS,22,27,0,2,2
11,8482141,Lukas Cormier,D,VGK,22,26,0,2,2
11,8480084,Nick DeSimone,D,NJD,30,20,0,2,2
11,8483512,Matthew Savoie,C,EDM,20,24,0,2,2
11,8482172,Landon Slaggert,L,CHI,22,22,0,2,2
11,8475780,Chris Wagner,R,COL,33,9,0,2,2
11,8481030,Jack St. Ivany,D,PIT,25,15,0,2,2
11,8481006,Tyler Tucker,D,STL,24,14,0,2,2
11,8480267,Sammy Walker,C,MIN,25,17,0,2,2
11,8477541,Dakota Mermis,D,TOR,30,9,0,2,2
11,8483597,Milos Kelemen,L,UTA,25,13,0,2,2
11,8484287,Cole McWard,D,VAN,23,20,1,0,1
11,8482858,Ryker Evans,D,SEA,23,29,1,0,1
11,8482201,Gage Goncalves,C,TBL,23,25,1,0,1
11,8482162,Roby Jarventie,L,EDM,22,17,1,0,1
11,8481578,Graeme Clarke,R,MIN,23,14,1,0,1
11,8480823,Alexander Alexeyev,D,WSH,25,14,1,0,1
11,8481726,Adam Edstrom,C,NYR,24,8,1,0,1
11,8481462,Mason Morelli,L,VGK,28,12,1,0,1
11,8480075,Cameron Crotty,D,MIN,25,6,1,0,1
11,8478147,Bokondji Imama,L,PIT,28,7,1,0,1
11,8479419,Brett Murray,L,BUF,26,15,0,1,1
11,8479576,Vincent Desharnais,D,VAN,28,27,0,1,1
11,8475795,Dylan McIlrath,D,WSH,32,16,0,1,1
11,8482929,Emil Lilleberg,D,TBL,23,19,0,1,1
11,8477320,Anton Blidh,L,NYR,29,19,0,1,1
11,8480874,Adam Ginning,D,PHI,24,7,0,1,1
11,8481237,Kyle MacLean,C,NYI,25,24,0,1,1
11,8482197,Adam Raska,R,MIN,23,10,0,1,1
11,8480306,Grant Hutton,D,NYI,29,9,0,1,1
11,8479587,Rhett Gardner,C,PHI,28,16,0,1,1
11,8480851,Akil Thomas,C,LAK,24,21,0,1,1
11,8483395,Arshdeep Bains,L,VAN,23,7,0,1,1
11,8478502,Dennis Gilbert,D,BUF,28,18,0,1,1
11,8481743,Marc Del Gaizo,D,NSH,25,19,0,0,0
11,8482516,Matthew Kessel,D,STL,24,20,0,0,0
11,8481543,Nikita Alexandrov,C,STL,24,17,0,0,0
11,8482147,Jean-Luc Foudy,C,COL,22,19,0,0,0
11,8482088,Justin Sourdif,R,FLA,22,15,0,0,0
11,8478446,Glenn Gawdin,C,LAK,27,13,0,0,0
11,8483567,Georgii Merkulov,C,BOS,24,11,0,0,0
11,8484326,Patrik Koch,D,UTA,28,2,0,0,0
11,8483407,Brandon Scanlin,D,NYR,25,12,0,0,0
11,8480032,Shane Bowers,C,NJD,25,16,0,0,0
11,8479330,Brandon Gignac,C,MTL,27,7,0,0,0
11,8482460,Matt Rempe,C,NYR,22,10,0,0,0
11,8476323,Max McCormick,L,SEA,32,2,0,0,0
11,8481564,Ryan Johnson,D,BUF,23,5,0,0,0
11,8484304,Uvis Balinskis,D,FLA,28,2,0,0,0
11,8483920,Pierrick Dube,R,WSH,23,4,0,0,0
11,8483546,Marshall Rifai,D,TOR,26,3,0,0,0
11,8477993,Justin Kirkland,C,CGY,28,7,0,0,0
11,8481206,John Ludvig,D,PIT,24,12,0,0,0
11,8482094,Daemon Hunt,D,MIN,22,15,0,0,0
11,8484325,Waltteri Merela,C,TBL,26,27,0,0,0
11,8475755,Alexander Petrovic,D,DAL,32,5,0,0,0
11,8483398,Declan Carlile,D,TBL,31,8,0,0,0
11,8479522,Hardy Haman Aktell,D,WSH,26,3,0,0,0
11,8478854,Ryan Shea,D,PIT,27,10,0,0,0
11,8484255,Jason Polin,R,COL,25,8,0,0,0
11,8481655,Cole Schwindt,R,CGY,23,6,0,0,0
11,8483432,Luca Del Bel Belluz,C,CBJ,31,3,0,0,0
11,8483401,Marc Johnstone,R,PIT,28,1,0,0,0
11,8484321,Nikolas Matinpalo,D,OTT,26,7,0,0,0
11,8483531,Brian Halonen,L,NJD,25,2,0,0,0
11,8482787,Nikita Chibrikov,R,WPG,31,8,0,0,0
11,8482126,Emil Andrae,D,PHI,31,2,0,0,0
11,8484259,Ondrej Pavel,C,COL,31,1,0,0,0
11,8470794,Joe Pavelski,C,,40,0,0,0,0
11,8479321,Lucas Johansen,D,,27,0,0,0,0
11,8477950,Tony DeAngelo,D,,29,0,0,0,0
11,8471218,Blake Wheeler,R,,38,0,0,0,0
11,8475197,Tyson Barrie,D,,33,0,0,0,0
11,8474157,Max Pacioretty,L,,36,0,0,0,0
11,8475744,Evgeny Kuznetsov,C,,32,0,0,0,0
11,8474037,James van Riemsdyk,L,,35,0,0,0,0
11,8476907,Mackenzie MacEachern,L,,30,0,0,0,0
11,8480216,Jacob Peterson,C,,25,0,0,0,0
11,8474602,Justin Schultz,D,,34,0,0,0,0
11,8482222,Alexander Barabanov,L,,30,0,0,0,0
11,8474031,Kevin Shattenkirk,D,,35,0,0,0,0
11,8477330,Dominik Kubalik,L,,29,0,0,0,0
11,8480884,Calen Addison,D,,24,0,0,0,0
11,8475906,John Klingberg,D,,32,0,0,0,0
11,8480008,Adam Ruzicka,C,,25,0,0,0,0
11,8476884,Derrick Pouliot,D,,30,0,0,0,0
11,8476919,Chris Tierney,C,,30,0,0,0,0
11,8479415,Michael McLeod,C,,26,0,0,0,0
11,8474870,Tyler Johnson,C,,34,0,0,0,0
11,8470604,Jeff Carter,C,,39,0,0,0,0
11,8478104,Sammy Blais,L,,28,0,0,0,0
11,8474884,Mike Hoffman,C,,35,0,0,0,0
11,8481591,Sam Poulin,R,,23,0,0,0,0
11,8471274,Alex Goligoski,D,,39,0,0,0,0
11,8476871,Tanner Pearson,L,,32,0,0,0,0
11,8476393,Nick Cousins,C,,31,0,0,0,0
11,8479977,Kailer Yamamoto,R,,26,0,0,0,0
11,8479346,Dillon Dube,C,,26,0,0,0,0
11,8480184,Gustav Lindstrom,D,,26,0,0,0,0
11,8479376,Victor Mete,D,,26,0,0,0,0
11,8473449,Kyle Okposo,R,,36,0,0,0,0
11,8481058,Jesse Ylonen,R,,25,0,0,0,0
11,8475752,Tyler Pitlick,C,,33,0,0,0,0
11,8481239,Samuel Fagemo,L,,24,0,0,0,0
11,8480821,Filip Zadina,R,,25,0,0,0,0
11,8470966,Mark Giordano,D,,41,0,0,0,0
11,8478495,Denis Gurianov,R,,27,0,0,0,0
11,8477464,Nic Petan,C,,29,0,0,0,0
11,8478099,Kevin Labanc,R,,29,0,0,0,0
11,8482241,Radim Zohorna,L,,28,0,0,0,0
11,8474040,Sam Gagner,C,,35,0,0,0,0
11,8479514,Rem Pitlick,C,,27,0,0,0,0
11,8478430,Oliver Kylington,D,,27,0,0,0,0
11,8479533,Joona Koppanen,L,,26,0,0,0,0
11,8479984,Cal Foote,D,,26,0,0,0,0
11,8477126,Jayson Megna,C,,34,0,0,0,0
11,8475164,Jakob Silfverberg,R,,34,0,0,0,0
11,8474009,Nick Bonino,C,,36,0,0,0,0
11,8479458,Nikita Zaitsev,D,,33,0,0,0,0
11,8477944,Jakub Vrana,L,,28,0,0,0,0
11,8471699,Andrew Cogliano,C,,37,0,0,0,0
11,8478067,Oskar Lindblom,L,,28,0,0,0,0
11,8471686,Marc Staal,D,,37,0,0,0,0
11,8470610,Zach Parise,L,,40,0,0,0,0
11,8478904,Steven Lorentz,C,,28,0,0,0,0
11,8473473,Milan Lucic,L,,36,0,0,0,0
11,8480031,Maxime Comtois,L,,25,0,0,0,0
11,8478512,Austin Czarnik,C,,32,0,0,0,0
11,8473504,Cal Clutterbuck,R,,37,0,0,0,0
11,8477454,Adam Erne,L,,29,0,0,0,0
11,8479383,Boris Katchouk,L,,26,0,0,0,0
11,8475825,Jani Hakanpää,D,,32,0,0,0,0
11,8477846,Ryan Carpenter,C,,33,0,0,0,0
11,8477930,Pierre-Edouard Bellemare,L,,39,0,0,0,0
11,8478400,Colin White,C,,27,0,0,0,0
11,8480226,Marián Studenic,R,,26,0,0,0,0
11,8480853,Liam Foudy,C,,24,0,0,0,0
11,8475797,Jarred Tinordi,D,,32,0,0,0,0
11,8479423,Alex Nylander,L,,26,0,0,0,0
11,8474618,Marco Scandella,D,,34,0,0,0,0
11,8478028,Fredrik Olofsson,L,,28,0,0,0,0
11,8474709,Matt Martin,L,,35,0,0,0,0
11,8481070,Hugh McGing,L,,26,0,0,0,0
11,8479546,Oskar Steen,C,,26,0,0,0,0
11,8474145,Robert Bortuzzo,D,,35,0,0,0,0
11,8476915,Jujhar Khaira,L,,30,0,0,0,0
11,8480274,Philip Kemp,D,EDM,25,1,0,0,0
11,8475278,Byron Froese,C,,33,0,0,0,0
11,8481812,Nikolai Knyzhov,D,,27,0,0,0,0
11,8478408,Travis Dermott,D,,28,0,0,0,0
11,8481077,John Leonard,L,,26,0,0,0,0
11,8479547,Matthew Phillips,R,,26,0,0,0,0
11,8480836,Jonathan Gruden,C,,24,0,0,0,0
11,8481690,Tyler Angle,C,,24,0,0,0,0
11,8475766,Austin Watson,L,,32,0,0,0,0
11,8481016,Ruslan Iskhakov,C,,24,0,0,0,0
11,8478078,Rourke Chartier,C,,28,0,0,0,0
11,8480776,Sheldon Rempal,R,,29,0,0,0,0
11,8478956,Samuel Laberge,L,NJD,27,1,0,0,0
11,8483045,Cameron Butler,R,CBJ,31,1,0,0,0
11,8481534,Raphael Lavoie,C,EDM,24,2,0,0,0
11,8484314,Jiri Smejkal,L,,28,0,0,0,0
12,8476453,Nikita Kucherov,R,TBL,31,81,41,87,128
12,8477956,David Pastrnak,R,BOS,28,80,57,69,126
12,8478402,Connor McDavid,C,EDM,27,79,40,85,125
12,8477492,Nathan MacKinnon,C,COL,29,82,39,85,124
12,8478420,Mikko Rantanen,R,COL,28,79,54,66,120
12,8477934,Leon Draisaitl,C,EDM,29,81,46,72,118
12,8479314,Matthew Tkachuk,L,FLA,27,79,30,84,114
12,8479318,Auston Matthews,C,TOR,27,78,62,51,113
12,8477939,William Nylander,R,TOR,28,79,47,59,106
12,8481559,Jack Hughes,C,NJD,23,72,42,64,106
12,8477493,Aleksander Barkov,C,FLA,29,78,25,79,104
12,8475172,Nazem Kadri,C,CGY,34,80,41,59,100
12,8480069,Cale Makar,D,COL,26,70,25,75,100
12,8477946,Dylan Larkin,C,DET,28,82,50,49,99
12,8476468,J.T. Miller,C,VAN,31,75,37,62,99
12,8478483,Mitch Marner,R,TOR,27,78,28,71,99
12,8478398,Kyle Connor,L,WPG,28,71,46,51,97
12,8481557,Matt Boldy,L,MIN,23,79,47,48,95
12,8476454,Ryan Nugent-Hopkins,C,EDM,31,79,29,66,95
12,8478550,Artemi Panarin,L,NYR,33,78,34,60,94
12,8474564,Steven Stamkos,C,NSH,34,72,35,58,93
12,8476460,Mark Scheifele,C,WPG,31,77,32,58,90
12,8478864,Kirill Kaprizov,L,MIN,27,69,39,50,89
12,8480002,Nico Hischier,C,NJD,25,76,33,56,89
12,8477404,Jake Guentzel,C,TBL,30,82,36,52,88
12,8477942,Kevin Fiala,L,LAK,28,80,31,57,88
12,8476539,Jonathan Marchessault,R,NSH,34,72,45,42,87
12,8478427,Sebastian Aho,C,CAR,27,76,36,51,87
12,8477933,Sam Reinhart,C,FLA,29,79,46,40,86
12,8480801,Brady Tkachuk,L,OTT,25,81,35,51,86
12,8477501,Valeri Nichushkin,R,COL,29,79,41,44,85
12,8477960,Adrian Kempe,R,LAK,28,82,38,47,85
12,8478010,Brayden Point,C,TBL,28,82,37,47,84
12,8480027,Jason Robertson,L,DAL,25,82,29,55,84
12,8478439,Travis Konecny,R,PHI,27,78,38,45,83
12,8477949,Alex Tuch,R,BUF,28,73,29,54,83
12,8476887,Filip Forsberg,L,NSH,30,77,38,44,82
12,8478445,Mathew Barzal,C,NYI,27,78,24,58,82
12,8476881,Tomas Hertl,C,VGK,31,80,40,41,81
12,8480012,Elias Pettersson,C,VAN,26,78,33,48,81
12,8471675,Sidney Crosby,C,PIT,37,75,33,48,81
12,8474600,Roman Josi,D,NSH,34,68,23,57,80
12,8475913,Mark Stone,R,VGK,32,78,30,49,79
12,8478403,Jack Eichel,C,VGK,28,77,26,53,79
12,8484144,Connor Bedard,C,CHI,19,72,32,46,78
12,8480800,Quinn Hughes,D,VAN,25,75,14,64,78
12,8481540,Cole Caufield,R,MTL,23,74,39,38,77
12,8475786,Zach Hyman,L,EDM,32,77,40,36,76
12,8477402,Pavel Buchnevich,L,STL,29,76,33,43,76
12,8475166,John Tavares,C,TOR,34,80,31,45,76
12,8473512,Claude Giroux,R,OTT,36,79,30,46,76
12,8480023,Robert Thomas,C,STL,25,71,22,54,76
12,8474141,Patrick Kane,R,DET,36,81,28,47,75
12,8476456,Jonathan Huberdeau,C,CGY,31,76,23,52,75
12,8475726,Tyler Toffoli,C,SJS,32,74,41,33,74
12,8475168,Matt Duchene,C,DAL,33,82,23,51,74
12,8480803,Evan Bouchard,D,EDM,25,70,18,54,72
12,8479323,Adam Fox,D,NYR,26,74,15,57,72
12,8477409,Carter Verhaeghe,C,FLA,29,77,29,42,71
12,8473419,Brad Marchand,L,BOS,36,78,29,41,70
12,8477951,Nick Schmaltz,C,UTA,28,76,29,41,70
12,8475167,Victor Hedman,D,TBL,34,79,14,56,70
12,8482740,Wyatt Johnston,C,DAL,21,82,45,24,69
12,8479343,Clayton Keller,R,UTA,26,74,28,41,69
12,8480208,Drake Batherson,R,OTT,26,82,28,41,69
12,8478444,Brock Boeser,R,VAN,27,76,34,34,68
12,8477940,Nikolaj Ehlers,L,WPG,28,71,15,53,68
12,8480830,Andrei Svechnikov,R,CAR,24,71,31,36,67
12,8479385,Jordan Kyrou,C,STL,26,70,30,37,67
12,8478449,Roope Hintz,C,DAL,28,82,29,38,67
12,8479337,Alex DeBrincat,R,DET,27,76,27,39,66
12,8479407,Jesper Bratt,L,NJD,26,72,25,41,66
12,8479999,Casey Mittelstadt,C,COL,26,80,24,42,66
12,8478975,Mason Marchment,L,DAL,29,82,21,45,66
12,8479420,Tage Thompson,C,BUF,27,73,32,33,65
12,8482116,Tim Stützle,C,OTT,22,80,21,44,65
12,8474578,Erik Karlsson,D,PIT,34,79,17,48,65
12,8482684,Luke Hughes,D,NJD,21,75,11,54,65
12,8482093,Seth Jarvis,C,CAR,22,74,30,34,64
12,8479542,Brandon Hagel,L,TBL,26,82,27,37,64
12,8476459,Mika Zibanejad,C,NYR,31,76,21,43,64
12,8471685,Anze Kopitar,C,LAK,37,80,19,45,64
12,8477504,Josh Morrissey,D,WPG,29,66,13,51,64
12,8476853,Morgan Rielly,D,TOR,30,72,13,51,64
12,8478414,Timo Meier,R,NJD,28,77,37,26,63
12,8475810,Bryan Rust,R,PIT,32,75,26,37,63
12,8478401,Pavel Zacha,C,BOS,27,81,23,40,63
12,8477496,Elias Lindholm,C,BOS,30,81,37,25,62
12,8475184,Chris Kreider,L,NYR,33,75,35,27,62
12,8481068,Yegor Sharangovich,C,CGY,26,79,30,32,62
12,8477476,Artturi Lehkonen,L,COL,29,80,25,37,62
12,8477503,Max Domi,C,TOR,29,78,23,39,62
12,8478460,Zach Werenski,D,CBJ,27,79,13,49,62
12,8482078,Lucas Raymond,L,DET,22,82,24,37,61
12,8475745,Charlie Coyle,C,BOS,32,80,22,39,61
12,8477500,Bo Horvat,C,NYI,29,81,29,31,60
12,8481533,Trevor Zegras,C,ANA,23,71,25,35,60
12,8475158,Ryan O'Reilly,C,NSH,33,70,21,39,60
12,8473994,Jamie Benn,L,DAL,35,82,29,30,59
12,8482699,Dylan Guenther,R,UTA,21,75,27,32,59
12,8482665,Matty Beniers,C,SEA,22,72,23,36,59
12,8480865,Noah Dobson,D,NYI,24,79,15,44,59
12,8478407,Vince Dunn,D,SEA,28,76,12,47,59
12,8476875,Mike Matheson,D,MTL,30,75,11,48,59
12,8475784,Jeff Skinner,C,EDM,32,74,28,30,58
12,8478498,Jake DeBrusk,L,VAN,28,75,27,31,58
12,8475754,Brock Nelson,C,NYI,33,79,26,32,58
12,8480018,Nick Suzuki,C,MTL,25,71,21,37,58
12,8474679,Gustav Nyquist,C,NSH,35,72,18,40,58
12,8480839,Rasmus Dahlin,D,BUF,24,73,16,42,58
12,8482745,Mason McTavish,C,ANA,21,69,28,29,57
12,8478046,Danton Heinen,L,VAN,29,70,24,33,57
12,8478047,Michael Bunting,L,PIT,29,68,23,34,57
12,8476389,Vincent Trocheck,C,NYR,31,78,21,36,57
12,8477416,Oliver Bjorkstrand,R,SEA,29,69,21,36,57
12,8477964,Ivan Barbashev,C,VGK,29,78,29,27,56
12,8477955,Jared McCann,L,SEA,28,74,25,31,56
12,8478440,Dylan Strome,C,WSH,27,70,19,37,56
12,8475798,Mikael Granlund,C,SJS,32,72,18,38,56
12,8479325,Charlie McAvoy,D,BOS,27,76,14,42,56
12,8478856,Conor Garland,R,VAN,28,77,25,30,55
12,8481528,Dylan Cozens,C,BUF,23,71,21,34,55
12,8475765,Vladimir Tarasenko,R,DET,33,79,20,35,55
12,8482124,Quinton Byfield,R,LAK,22,80,17,38,55
12,8474590,John Carlson,D,WSH,34,65,10,45,55
12,8476399,Blake Coleman,C,CGY,33,76,27,27,54
12,8476448,William Karlsson,C,VGK,31,77,24,30,54
12,8477479,Tyler Bertuzzi,L,CHI,29,68,22,32,54
12,8476826,Yanni Gourde,C,SEA,33,70,19,35,54
12,8478042,Viktor Arvidsson,L,EDM,31,74,19,35,54
12,8476479,Phillip Danault,C,LAK,31,80,19,35,54
12,8480039,Martin Necas,C,CAR,25,75,18,36,54
12,8474102,David Perron,L,OTT,36,80,18,36,54
12,8470613,Brent Burns,D,CAR,39,79,15,39,54
12,8479525,Ross Colton,C,COL,28,77,31,22,53
12,8478542,Evan Rodrigues,C,FLA,31,77,26,27,53
12,8482720,Matthew Knies,L,TOR,22,77,22,31,53
12,8476905,Chandler Stephenson,C,SEA,30,74,20,33,53
12,8480798,Philipp Kurashev,C,CHI,25,66,19,34,53
12,8471215,Evgeni Malkin,C,PIT,38,75,18,35,53
12,8478493,Joel Eriksson Ek,C,MIN,27,68,24,28,52
12,8479675,Trevor Moore,L,LAK,29,81,24,28,52
12,8471214,Alex Ovechkin,L,WSH,39,69,23,29,52
12,8482113,Anton Lundell,C,FLA,23,79,20,32,52
12,8482702,Logan Stankoven,C,DAL,21,80,17,35,52
12,8477494,Jonathan Drouin,L,COL,29,77,13,39,52
12,8480064,Josh Norris,C,OTT,25,77,27,24,51
12,8478873,Troy Terry,R,ANA,27,76,16,35,51
12,8478462,Nicolas Roy,C,VGK,27,77,15,36,51
12,8476869,Brady Skjei,D,NSH,30,76,14,37,51
12,8475692,Mats Zuccarello,R,MIN,37,67,10,41,51
12,8480036,Miro Heiskanen,D,DAL,25,73,9,42,51
12,8477932,Aaron Ekblad,D,FLA,28,69,9,42,51
12,8474641,Adam Henrique,C,EDM,34,76,28,22,50
12,8484166,Adam Fantilli,C,CBJ,20,66,25,25,50
12,8475191,Reilly Smith,R,NYR,33,71,24,26,50
12,8476438,Brandon Saad,L,STL,32,74,23,27,50
12,8474586,Jordan Eberle,R,SEA,34,70,22,28,50
12,8476882,Teuvo Teravainen,C,CHI,30,61,21,29,50
12,8471724,Kris Letang,D,PIT,37,80,18,32,50
12,8474150,Mikael Backlund,C,CGY,35,79,15,35,50
12,8476346,Johnny Gaudreau,L,CBJ,31,71,14,36,50
12,8478055,Gustav Forsling,D,FLA,28,72,14,36,50
12,8480014,Gabriel Vilardi,C,WPG,25,68,29,20,49
12,8482109,Alexis Lafrenière,L,NYR,23,74,24,25,49
12,8482092,Ridly Greig,C,OTT,22,75,24,25,49
12,8483808,Andrei Kuzmenko,L,CGY,28,76,22,27,49
12,8476462,Dougie Hamilton,D,NJD,31,71,17,32,49
12,8477986,Brandon Montour,D,SEA,30,74,12,37,49
12,8478469,Thomas Chabot,D,OTT,27,78,11,38,49
12,8475169,Evander Kane,L,EDM,33,73,23,25,48
12,8483515,Juraj Slafkovsky,L,MTL,20,72,21,27,48
12,8482110,Dawson Mercer,C,NJD,23,75,20,28,48
12,8475794,Tyler Seguin,C,DAL,32,80,27,20,47
12,8477935,Sam Bennett,C,FLA,28,76,26,21,47
12,8480015,Owen Tippett,R,PHI,25,74,24,23,47
12,8476880,Tom Wilson,R,WSH,30,69,22,25,47
12,8484153,Leo Carlsson,C,ANA,20,74,19,28,47
12,8479345,Jakob Chychrun,D,WSH,26,62,16,31,47
12,8477495,Seth Jones,D,CHI,30,68,10,37,47
12,8476854,Hampus Lindholm,D,BOS,30,78,2,45,47
12,8482475,Yegor Chinakhov,R,CBJ,23,68,22,24,46
12,8471698,T.J. Oshie,R,WSH,38,71,21,25,46
12,8483431,Logan Cooley,C,UTA,20,74,20,26,46
12,8475287,Erik Haula,L,NJD,33,71,17,29,46
12,8477447,Shea Theodore,D,VGK,29,68,9,37,46
12,8482705,Cole Sillinger,C,CBJ,21,69,18,27,45
12,8482175,JJ Peterka,R,BUF,22,74,17,28,45
12,8477511,Anthony Mantha,R,CGY,30,71,14,31,45
12,8478397,Rasmus Andersson,D,CGY,28,70,14,31,45
12,8478438,Tommy Novak,C,NSH,27,66,11,34,45
12,8478366,Frank Vatrano,R,ANA,30,70,27,17,44
12,8476432,Boone Jenner,C,CBJ,31,74,24,20,44
12,8478472,Mathieu Joseph,R,STL,27,71,17,27,44
12,8482159,Tyson Foerster,R,PHI,22,75,16,28,44
12,8476906,Shayne Gostisbehere,D,CAR,31,79,14,30,44
12,8481711,Matias Maccelli,L,UTA,24,75,12,32,44
12,8477346,MacKenzie Weegar,D,CGY,30,76,12,32,44
12,8479410,Mikhail Sergachev,D,UTA,26,75,9,35,44
12,8475151,Kyle Palmieri,C,NYI,33,78,21,22,43
12,8477456,J.T. Compher,L,DET,29,80,19,24,43
12,8481524,Bowen Byram,D,BUF,23,70,16,27,43
12,8477429,Andrew Copp,C,DET,30,80,15,28,43
12,8482712,Oskar Olausson,R,COL,22,81,14,29,43
12,8481542,Moritz Seider,D,DET,23,77,10,33,43
12,8482122,Brock Faber,D,MIN,22,76,5,38,43
12,8482149,Cole Perfetti,C,WPG,22,64,19,23,42
12,8476483,Rickard Rakell,R,PIT,31,71,18,24,42
12,8479400,Pierre-Luc Dubois,L,WSH,26,71,16,26,42
12,8476461,Sean Couturier,C,PHI,32,73,14,28,42
12,8474563,Drew Doughty,D,LAK,35,71,11,31,42
12,8477021,Alex Kerfoot,C,UTA,30,74,10,32,42
12,8479425,Filip Hronek,D,VAN,27,75,9,33,42
12,8476979,Erik Gustafsson,D,DET,32,77,2,40,42
12,8480113,Alex Iafallo,L,WPG,31,68,23,18,41
12,8477998,Warren Foegele,L,LAK,28,79,22,19,41
12,8480009,Eeli Tolvanen,R,SEA,25,72,20,21,41
12,8478519,Anthony Cirelli,C,TBL,27,81,19,22,41
12,8475799,Nino Niederreiter,R,WPG,32,75,18,23,41
12,8477451,Ryan Hartman,R,MIN,30,66,15,26,41
12,8481596,Shane Pinto,C,OTT,24,75,14,27,41
12,8476458,Ryan Strome,C,ANA,31,71,14,27,41
12,8478396,Noah Hanifin,D,VGK,27,63,5,36,41
12,8481604,Pavel Dorofeyev,L,VGK,24,70,28,12,40
12,8475848,Brendan Gallagher,R,MTL,32,72,24,16,40
12,8475170,Brayden Schenn,C,STL,33,71,23,17,40
12,8478891,Mason Appleton,C,WPG,28,64,20,20,40
12,8480185,Eetu Luostarinen,C,FLA,26,70,16,24,40
12,8477497,Sean Monahan,C,CBJ,30,70,13,27,40
12,8475763,Kevin Hayes,R,PIT,32,66,13,27,40
12,8477444,Andre Burakovsky,L,SEA,29,69,9,31,40
12,8476792,Torey Krug,D,STL,33,76,6,34,40
12,8479992,Michael Rasmussen,C,DET,25,81,21,18,39
12,8478474,Lawson Crouse,L,UTA,27,77,18,21,39
12,8478466,Daniel Sprong,R,VAN,27,72,16,23,39
12,8480802,Ryan McLeod,C,BUF,25,68,16,23,39
12,8476872,Scott Laughton,C,PHI,30,73,15,24,39
12,8484145,Zach Benson,L,BUF,19,65,14,25,39
12,8480028,Morgan Frost,C,PHI,25,72,13,26,39
12,8478038,Devon Toews,D,COL,30,68,8,31,39
12,8481560,Arthur Kaliyev,R,LAK,23,80,21,17,38
12,8474715,Cameron Atkinson,R,TBL,35,78,20,18,38
12,8480459,Pius Suter,C,VAN,28,71,19,19,38
12,8474565,Alex Pietrangelo,D,VGK,34,57,7,31,38
12,8482089,Jake Neighbours,L,STL,22,64,23,14,37
12,8480188,Fabian Zetterlund,L,SJS,25,63,18,19,37
12,8475722,Jason Zucker,L,BUF,32,65,18,19,37
12,8477407,Anthony Duclair,L,NYI,29,80,17,20,37
12,8481523,Kirby Dach,C,MTL,23,65,13,24,37
12,8475764,Cam Fowler,D,ANA,33,74,2,35,37
12,8481554,Kaapo Kakko,R,NYR,23,71,20,16,36
12,8479987,Morgan Geekie,C,BOS,26,77,16,20,36
12,8480813,Joe Veleno,C,DET,24,75,16,20,36
12,8474149,Evgenii Dadonov,R,DAL,35,80,15,21,36
12,8480434,Sean Durzi,D,UTA,26,68,13,23,36
12,8476927,Teddy Blueger,C,VAN,30,64,12,24,36
12,8474053,Logan Couture,C,SJS,35,64,12,24,36
12,8483505,Matthew Poitras,C,BOS,20,80,8,28,36
12,8476958,Jaccob Slavin,D,CAR,30,75,6,30,36
12,8475760,Nick Bjugstad,C,UTA,32,70,22,13,35
12,8481582,Nicholas Robertson,L,TOR,23,69,17,18,35
12,8480797,Joel Farabee,L,PHI,24,75,16,19,35
12,8481186,Logan O'Connor,R,COL,28,78,16,19,35
12,8477425,Miles Wood,L,COL,29,79,15,20,35
12,8478413,Jordan Greenway,L,BUF,27,63,15,20,35
12,8477952,Robby Fabbri,C,ANA,28,66,14,21,35
12,8476292,Ondrej Palat,L,NJD,33,67,13,22,35
12,8481577,Philip Tomasino,C,NSH,23,64,11,24,35
12,8478458,John (Jack) Roslovic,C,CAR,27,59,11,24,35
12,8480849,Barrett Hayton,C,UTA,24,73,11,24,35
12,8482105,Jake Sanderson,D,OTT,22,76,10,25,35
12,8478911,Matt Roy,D,WSH,29,68,5,30,35
12,8482146,Luke Evangelista,R,NSH,22,67,20,14,34
12,8478463,Anthony Beauvillier,L,PIT,27,66,19,15,34
12,8477426,Nicholas Paul,L,TBL,29,81,17,17,34
12,8482667,William Eklund,L,SJS,22,68,16,18,34
12,8479365,Trent Frederic,C,BOS,26,76,13,21,34
12,8480220,Noah Cates,L,PHI,25,69,11,23,34
12,8475753,Justin Faulk,D,STL,32,72,9,25,34
12,8477498,Darnell Nurse,D,EDM,29,75,8,26,34
12,8473422,Nick Foligno,L,CHI,37,64,20,13,33
12,8482097,Jack Quinn,R,BUF,23,63,19,14,33
12,8476918,Jimmy Vesey,L,NYR,31,69,19,14,33
12,8480068,Ryan Poehling,C,PHI,25,72,18,15,33
12,8480835,Jack Drury,C,CAR,24,59,13,20,33
12,8479996,Cody Glass,C,NSH,25,56,13,20,33
12,8483490,Pavel Mintyukov,D,ANA,21,74,7,26,33
12,8477948,Travis Sanheim,D,PHI,28,63,4,29,33
12,8480893,Kirill Marchenko,R,CBJ,24,70,24,8,32
12,8475193,Tomas Tatar,L,NJD,34,71,17,15,32
12,8484203,Bradly Nadeau,L,CAR,19,65,16,16,32
12,8477989,Christian Dvorak,C,MTL,28,67,14,18,32
12,8478115,Pierre Engvall,L,NYI,28,75,11,21,32
12,8483468,Jiri Kulich,C,BUF,20,64,11,21,32
12,8475218,Mattias Ekholm,D,EDM,34,72,10,22,32
12,8474151,Ryan McDonagh,D,TBL,35,79,2,30,32
12,8482079,Marco Rossi,C,MIN,23,58,19,12,31
12,8482055,Drew O'Connor,L,PIT,26,69,16,15,31
12,8475714,Calle Jarnkrok,C,TOR,33,76,14,17,31
12,8475768,Jaden Schwartz,C,SEA,32,74,13,18,31
12,8479591,Michael Eyssimont,C,TBL,28,82,13,18,31
12,8480789,Oliver Wahlstrom,R,NYI,24,73,13,18,31
12,8476925,Colton Sissons,C,NSH,31,73,13,18,31
12,8473563,Nicklas Backstrom,C,WSH,37,54,12,19,31
12,8478233,Andrew Mangiapane,L,WSH,28,63,11,20,31
12,8480829,Jesperi Kotkaniemi,C,CAR,24,53,11,20,31
12,8479339,Patrik Laine,L,CBJ,26,56,9,22,31
12,8481703,Valtteri Puustinen,R,PIT,25,65,8,23,31
12,8482671,Owen Power,D,BUF,22,69,6,25,31
12,8480817,K'Andre Miller,D,NYR,24,74,5,26,31
12,8475149,Marcus Johansson,L,MIN,34,66,5,26,31
12,8480873,Rasmus Sandin,D,WSH,24,71,5,26,31
12,8476923,Damon Severson,D,CBJ,30,79,3,28,31
12,8476892,Colton Parayko,D,STL,31,72,3,28,31
12,8476981,Josh Anderson,R,MTL,30,67,16,14,30
12,8470621,Corey Perry,R,EDM,39,73,14,16,30
12,8481580,Connor McMichael,C,WSH,23,65,13,17,30
12,8481093,Rafael Harvey-Pinard,L,MTL,25,62,12,18,30
12,8480748,Kiefer Sherwood,L,VAN,29,60,10,20,30
12,8482624,Daniil Miromanov,D,CGY,27,68,7,23,30
12,8476879,Cody Ceci,D,EDM,31,70,5,25,30
12,8476931,Jake McCabe,D,TOR,31,66,5,25,30
12,8480043,Timothy Liljegren,D,TOR,25,70,2,28,30
12,8481704,Juuso Parssinen,C,NSH,23,59,15,14,29
12,8476419,Jean-Gabriel Pageau,C,NYI,32,74,15,14,29
12,8478133,Jake Evans,C,MTL,28,68,12,17,29
12,8478057,Dakota Joshua,C,VAN,28,57,11,18,29
12,8477839,Conor Sheary,L,TBL,32,80,11,18,29
12,8474189,Lars Eller,C,PIT,35,64,11,18,29
12,8475231,Casey Cizikas,C,NYI,33,76,11,18,29
12,8482133,Thomas Bordeleau,C,SJS,22,61,9,20,29
12,8481441,Joe Snively,C,DET,28,60,9,20,29
12,8476480,Vladislav Namestnikov,C,WPG,32,59,8,21,29
12,8482655,Janis Moser,D,TBL,24,77,6,23,29
12,8474716,Jared Spurgeon,D,MIN,35,75,5,24,29
12,8480336,Sean Walker,D,CAR,30,76,5,24,29
12,8480049,Dylan Samberg,D,WPG,25,71,4,25,29
12,8476885,Jacob Trouba,D,NYR,30,67,3,26,29
12,8473986,Alex Killorn,L,ANA,35,72,15,13,28
12,8475314,Anders Lee,L,NYI,34,76,15,13,28
12,8478432,Christian Fischer,R,DET,27,77,15,13,28
12,8475343,Nic Dowd,C,WSH,34,61,15,13,28
12,8482117,Lukas Reichel,L,CHI,22,62,11,17,28
12,8477947,Sonny Milano,L,WSH,28,59,11,17,28
12,8479351,Sam Steel,C,DAL,26,77,6,22,28
12,8476329,Travis Boyd,C,MIN,31,58,6,22,28
12,8481014,Alexander Romanov,D,NYI,24,76,4,24,28
12,8479402,Jake Bean,D,CGY,26,63,1,27,28
12,8479941,Justin Danforth,R,CBJ,31,58,15,12,27
12,8477446,Michael McCarron,R,NSH,29,58,13,14,27
12,8479390,Taylor Raddysh,R,WSH,26,59,12,15,27
12,8476474,Stefan Noesen,R,NJD,31,66,11,16,27
12,8473533,Jordan Staal,C,CAR,36,65,11,16,27
12,8477506,Ryan Pulock,D,NYI,30,76,8,19,27
12,8481618,Alex Newhook,C,MTL,23,71,7,20,27
12,8476392,Adam Lowry,C,WPG,31,57,6,21,27
12,8481606,Jordan Spence,D,LAK,23,69,5,22,27
12,8476917,Adam Pelech,D,NYI,30,73,4,23,27
12,8475181,Nick Leddy,D,STL,33,58,3,24,27
12,8482809,Jackson Blake,R,CAR,21,57,12,14,26
12,8477987,Ryan Donato,C,CHI,28,61,11,15,26
12,8477505,Alexander Wennberg,C,SJS,30,72,8,18,26
12,8479371,Dante Fabbro,D,NSH,26,61,6,20,26
12,8475200,Dmitry Orlov,D,CAR,33,74,5,21,26
12,8477919,Frederick Gaudreau,C,MIN,31,63,13,12,25
12,8480003,Jesper Boqvist,C,FLA,26,69,12,13,25
12,8481522,Peyton Krebs,C,BUF,23,66,12,13,25
12,8480078,Filip Chytil,C,NYR,25,60,11,14,25
12,8480074,Alexandre Texier,C,STL,25,52,11,14,25
12,8481032,Paul Cotter,C,NJD,25,60,11,14,25
12,8481656,Aliaksei Protas,C,WSH,23,72,10,15,25
12,8481624,Ilya Mikheyev,R,CHI,30,57,10,15,25
12,8479353,Brett Howden,C,VGK,26,70,10,15,25
12,8479398,Samuel Girard,D,COL,26,66,9,16,25
12,8477488,Brett Pesce,D,NJD,30,63,8,17,25
12,8477507,Nikita Zadorov,D,BOS,29,70,8,17,25
12,8481059,Scott Perunovich,D,STL,26,60,5,20,25
12,8481581,Thomas Harley,D,DAL,23,73,4,21,25
12,8483524,Shane Wright,C,SEA,20,62,17,7,24
12,8482074,Connor Zary,C,CGY,23,63,15,9,24
12,8480871,Adam Boqvist,D,FLA,24,69,14,10,24
12,8483457,Lane Hutson,D,MTL,20,62,12,12,24
12,8479293,Brandon Tanev,L,SEA,33,64,11,13,24
12,8476897,Oskar Sundqvist,C,STL,30,60,10,14,24
12,8479315,Joey Anderson,R,CHI,26,44,10,14,24
12,8480289,Morgan Barron,C,WPG,26,57,10,14,24
12,8477953,Kasperi Kapanen,R,STL,28,67,8,16,24
12,8475793,Ryan Johansen,C,PHI,32,73,7,17,24
12,8475171,Oliver Ekman-Larsson,D,TOR,33,68,7,17,24
12,8482660,Kent Johnson,C,CBJ,22,63,6,18,24
12,8475220,Marcus Foligno,L,MIN,33,64,6,18,24
12,8475455,Brenden Dillon,D,NJD,34,61,5,19,24
12,8476331,Dylan DeMelo,D,WPG,31,68,3,21,24
12,8473507,Jeff Petry,D,DET,37,75,2,22,24
12,8482073,Braden Schneider,D,NYR,23,62,2,22,24
12,8475462,Radko Gudas,D,ANA,34,67,1,23,24
12,8479619,Michael Carcone,L,UTA,28,65,14,9,23
12,8477353,Tyler Motte,C,DET,29,73,13,10,23
12,8480995,Pontus Holmberg,R,TOR,25,60,8,15,23
12,8476525,Colin Miller,D,WPG,32,60,8,15,23
12,8481553,Bobby Brink,R,PHI,23,66,7,16,23
12,8475855,Jesper Fast,R,CAR,33,71,6,17,23
12,8480145,Neal Pionk,D,WPG,29,71,5,18,23
12,8477969,Marcus Pettersson,D,PIT,28,80,5,18,23
12,8476902,Esa Lindell,D,DAL,30,69,5,18,23
12,8482101,Danil Gushchin,L,SJS,22,60,5,18,23
12,8478500,Ivan Provorov,D,CBJ,27,80,3,20,23
12,8482111,Justin Barron,D,MTL,23,66,3,20,23
12,8481535,Nils Hoglander,L,VAN,24,62,14,8,22
12,8479368,Max Jones,L,BOS,26,61,14,8,22
12,8481641,Joel Kiviranta,L,COL,28,73,14,8,22
12,8477478,William Carrier,L,CAR,30,55,11,11,22
12,8479661,Tanner Jeannot,L,LAK,27,73,11,11,22
12,8476278,Colin Blackwell,C,DAL,31,80,11,11,22
12,8478013,Jake Walman,D,SJS,28,67,10,12,22
12,8476463,Jonas Brodin,D,MIN,31,79,9,13,22
12,8480855,Jack McBain,C,UTA,24,73,9,13,22
12,8477931,Tomas Nosek,L,FLA,32,54,8,14,22
12,8476921,Jordan Martinook,L,CAR,32,66,7,15,22
12,8477015,Connor Brown,R,EDM,30,64,6,16,22
12,8482807,Ethan Del Mastro,D,CHI,21,50,6,16,22
12,8480891,Michael Kesselring,D,UTA,24,64,5,17,22
12,8474673,TJ Brodie,D,CHI,34,71,5,17,22
12,8476467,Jamie Oleksiak,D,SEA,32,69,5,17,22
12,8482245,Artem Zub,D,OTT,29,65,2,20,22
12,8478399,Jonas Siegenthaler,D,NJD,27,66,2,20,22
12,8479393,Noah Gregor,L,OTT,26,65,12,9,21
12,8478569,Noel Acciari,C,PIT,33,57,11,10,21
12,8479639,Dylan Coghlan,D,WPG,26,65,8,13,21
12,8482142,Jamie Drysdale,D,PHI,22,63,8,13,21
12,8481521,Ronnie Attard,D,PHI,25,51,8,13,21
12,8481546,Cam York,D,PHI,23,68,4,17,21
12,8476422,Mike Reilly,D,NYI,31,77,3,18,21
12,8479998,Mikey Anderson,D,LAK,25,70,3,18,21
12,8476988,Matt Benning,D,SJS,30,65,3,18,21
12,8480887,Jordan Harris,D,MTL,24,53,2,19,21
12,8482125,Alexander Holtz,R,VGK,22,65,15,5,20
12,8475225,Craig Smith,C,CHI,35,56,11,9,20
12,8476469,Joel Armia,R,MTL,31,67,10,10,20
12,8475791,Taylor Hall,L,CHI,33,49,10,10,20
12,8482749,Joshua Roy,R,MTL,21,61,9,11,20
12,8480144,David Kampf,C,TOR,29,67,9,11,20
12,8480205,Emil Bemstrom,C,PIT,25,49,9,11,20
12,8482259,Bobby McMann,C,TOR,28,58,9,11,20
12,8480980,Connor Dewar,C,TOR,25,68,9,11,20
12,8482679,Matt Coronato,R,CGY,22,64,9,11,20
12,8482803,Olen Zellweger,D,ANA,21,68,7,13,20
12,8477508,Curtis Lazar,C,NJD,29,56,5,15,20
12,8478416,Erik Cernak,D,TBL,27,75,5,15,20
12,8482087,Kaiden Guhle,D,MTL,22,59,5,15,20
12,8478882,Vladislav Gavrikov,D,LAK,29,66,4,16,20
12,8479976,Juuso Valimaki,D,UTA,26,67,4,16,20
12,8479983,Mario Ferraro,D,SJS,26,68,4,16,20
12,8480073,Erik Brannstrom,D,COL,25,54,4,16,20
12,8478840,Will Borgen,D,SEA,28,64,3,17,20
12,8477435,Ryan Graves,D,PIT,29,73,3,17,20
12,8478851,Alexandre Carrier,D,NSH,28,66,2,18,20
12,8480035,Henri Jokiharju,D,BUF,25,65,2,18,20
12,8478585,Derek Ryan,C,EDM,38,63,9,10,19
12,8479520,Brandon Duhaime,R,WSH,27,63,9,10,19
12,8476822,Luke Glendening,C,TBL,35,78,8,11,19
12,8477380,Jonny Brodzinski,C,NYR,31,61,8,11,19
12,8476960,Andreas Athanasiou,C,CHI,30,49,7,12,19
12,8481527,Kaedan Korczak,D,VGK,23,50,7,12,19
12,8483565,Nick Blankenburg,D,NSH,26,68,7,12,19
12,8476457,Adam Larsson,D,SEA,32,67,5,14,19
12,8476891,Matthew Grzelcyk,D,PIT,30,72,3,16,19
12,8475790,Erik Gudbranson,D,CBJ,32,80,2,17,19
12,8481568,Alex Vlasic,D,CHI,23,46,2,17,19
12,8476429,Scott Mayfield,D,NYI,32,77,1,18,19
12,8478507,John Marino,D,UTA,27,59,0,19,19
12,8481601,Simon Holmstrom,R,NYI,23,69,11,7,18
12,8478421,A.J. Greer,L,FLA,28,62,11,7,18
12,8478020,Michael Amadio,R,OTT,28,72,10,8,18
12,8481481,Blake Lizotte,C,PIT,27,60,10,8,18
12,8476873,Mark Jankowski,C,NSH,30,51,9,9,18
12,8476889,Radek Faksa,C,STL,30,65,9,9,18
12,8479328,Julien Gauthier,R,NYI,27,56,7,11,18
12,8480448,Parker Kelly,L,COL,25,72,5,13,18
12,8482067,Connor Mackey,D,NYR,28,64,5,13,18
12,8477220,Nate Schmidt,D,FLA,33,63,4,14,18
12,8475279,Ben Chiarot,D,DET,33,64,4,14,18
12,8475324,Nick Jensen,D,OTT,34,64,4,14,18
12,8478178,Darren Raddysh,D,TBL,28,70,4,14,18
12,8484149,Gavin Brindley,C,CBJ,20,46,4,14,18
12,8474574,Tyler Myers,D,VAN,34,62,3,15,18
12,8479980,Nicolas Hague,D,VGK,26,66,2,16,18
12,8480762,Eric Robinson,L,CAR,29,57,12,5,17
12,8479344,Jesse Puljujarvi,R,PIT,26,49,12,5,17
12,8481477,Nico Sturm,C,SJS,29,57,11,6,17
12,8482062,Cole Smith,L,NSH,29,59,11,6,17
12,8477938,Haydn Fleury,D,WPG,28,52,9,8,17
12,8477406,Mattias Janmark,C,EDM,32,59,8,9,17
12,8478109,Victor Olofsson,L,VGK,29,70,7,10,17
12,8479414,Nathan Bastian,R,NJD,27,58,7,10,17
12,8479369,Andrew Peeke,D,BOS,26,62,7,10,17
12,8478452,Caleb Jones,D,LAK,27,62,7,10,17
12,8478434,Keegan Kolesar,R,VGK,27,66,6,11,17
12,8483495,Simon Nemec,D,NJD,20,58,5,12,17
12,8483482,Tristan Luneau,D,ANA,20,62,4,13,17
12,8481161,Jake Christiansen,D,CBJ,25,56,4,13,17
12,8477369,Carson Soucy,D,VAN,30,66,4,13,17
12,8479982,Conor Timmins,D,TOR,26,66,3,14,17
12,8481550,Adam Beckman,L,NJD,23,42,2,15,17
12,8478508,Yakov Trenin,C,MIN,27,59,12,4,16
12,8475842,Sam Carrick,C,NYR,32,63,12,4,16
12,8481013,Jonatan Berggren,R,DET,24,58,9,7,16
12,8482737,Zack Bolduc,C,STL,21,62,8,8,16
12,8482157,Will Cuylle,L,NYR,22,62,8,8,16
12,8482155,Alex Laferriere,R,LAK,23,63,8,8,16
12,8477392,Hudson Fasching,R,NYI,29,59,7,9,16
12,8480355,Mark Kastelic,C,BOS,25,60,7,9,16
12,8479316,Luke Kunin,C,SJS,27,57,6,10,16
12,8479066,Ryan Lomberg,L,CGY,30,67,6,10,16
12,8482964,Arber Xhekaj,D,MTL,23,52,6,10,16
12,8477450,Jason Dickinson,C,CHI,29,53,5,11,16
12,8478970,Jalen Chatfield,D,CAR,28,69,5,11,16
12,8476624,Barclay Goodrow,C,SJS,31,56,5,11,16
12,8482511,Mason Lohrei,D,BOS,23,35,5,11,16
12,8482176,Wyatt Kaiser,D,CHI,22,54,4,12,16
12,8481567,Henry Thrun,D,SJS,23,52,4,12,16
12,8479026,Philippe Myers,D,TOR,27,48,3,13,16
12,8475233,David Savard,D,MTL,34,73,2,14,16
12,8479324,Ryan Lindgren,D,NYR,26,64,1,15,16
12,8479543,Michael Pezzetta,L,MTL,26,61,1,15,16
12,8475690,Chris Tanev,D,TOR,35,57,1,15,16
12,8480222,Sebastian Aho,D,PIT,28,71,0,16,16
12,8476374,Sean Kuraly,C,CBJ,31,50,8,7,15
12,8483491,Ivan Miroshnichenko,L,WSH,20,54,8,7,15
12,8483493,Frank Nazar,C,CHI,20,54,7,8,15
12,8475188,Brayden McNabb,D,VGK,33,55,7,8,15
12,8483466,Kevin Korchinski,D,CHI,20,57,5,10,15
12,8480834,Ty Emberson,D,SJS,24,42,5,10,15
12,8480878,Nils Lundkvist,D,DAL,24,69,4,11,15
12,8477499,Rasmus Ristolainen,D,PHI,30,65,4,11,15
12,8481599,Victor Soderstrom,D,UTA,23,40,4,11,15
12,8481019,David Gustafsson,C,WPG,24,46,4,11,15
12,8481178,Egor Zamula,D,PHI,24,52,4,11,15
12,8482148,Hendrix Lapierre,C,WSH,22,56,4,11,15
12,8470600,Ryan Suter,D,STL,39,57,4,11,15
12,8480172,Jan Rutta,D,SJS,34,60,4,11,15
12,8477034,Jaycob Megna,D,FLA,32,56,4,11,15
12,8476856,Mathew Dumba,D,DAL,30,73,3,12,15
12,8476312,Josh Manson,D,COL,33,68,3,12,15
12,8480860,Kevin Bahl,D,CGY,24,63,2,13,15
12,8478443,Brandon Carlo,D,BOS,28,53,2,13,15
12,8481716,Dmitri Voronkov,L,CBJ,24,49,10,4,14
12,8478211,Dryden Hunt,L,CGY,29,59,10,4,14
12,8479671,Mathieu Olivier,R,CBJ,27,52,8,6,14
12,8478043,Sam Lafferty,C,BUF,29,59,6,8,14
12,8476442,Matt Nieto,L,PIT,32,53,6,8,14
12,8477903,Garnet Hathaway,R,PHI,33,69,5,9,14
12,8480807,Mattias Samuelsson,D,BUF,24,49,5,9,14
12,8479536,Axel Jonsson-Fjallby,L,WPG,26,44,5,9,14
12,8483499,Liam Ohgren,L,MIN,20,49,4,10,14
12,8480157,Calle Rosen,D,COL,30,49,4,10,14
12,8480001,Urho Vaakanainen,D,ANA,25,56,4,10,14
12,8480879,Jacob Bernard-Docker,D,OTT,24,56,4,10,14
12,8478136,Jake Middleton,D,MIN,28,76,3,11,14
12,8480727,Zach Whitecloud,D,VGK,28,47,3,11,14
12,8482192,Isaak Phillips,D,CHI,23,48,2,12,14
12,8475177,Calvin de Haan,D,COL,33,46,2,12,14
12,8476994,Vinnie Hinostroza,C,NSH,30,50,1,13,14
12,8480025,MacKenzie Entwistle,R,FLA,25,62,9,4,13
12,8479336,Carl Grundstrom,R,SJS,27,44,7,6,13
12,8481517,Brett Leason,R,ANA,25,61,7,6,13
12,8473453,Trevor Lewis,C,LAK,37,71,7,6,13
12,8480011,Klim Kostin,C,SJS,25,51,6,7,13
12,8477845,Trevor van Riemsdyk,D,WSH,33,55,5,8,13
12,8480246,Nick Perbix,D,TBL,26,74,4,9,13
12,8480796,Martin Fehervary,D,WSH,25,62,3,10,13
12,8480196,Jacob Bryson,D,BUF,27,49,3,10,13
12,8475718,Justin Holl,D,DET,32,56,2,11,13
12,8471709,Marc-Edouard Vlasic,D,SJS,37,59,1,12,13
12,8480192,Johnathan Kovacevic,D,NJD,27,46,8,4,12
12,8480252,Cole Guttman,C,CHI,25,40,7,5,12
12,8474034,Patrick Maroon,L,CHI,36,54,7,5,12
12,8483445,Cutter Gauthier,L,ANA,20,59,6,6,12
12,8480281,Alexey Toropchenko,R,STL,25,66,6,6,12
12,8480806,Isac Lundestrom,C,ANA,25,55,6,6,12
12,8482744,James Malatesta,L,CBJ,21,47,6,6,12
12,8481592,Jakob Pelletier,L,CGY,23,44,5,7,12
12,8474567,Zach Bogosian,D,MIN,34,59,3,9,12
12,8477365,Connor Clifton,D,BUF,29,46,2,10,12
12,8474166,Alec Martinez,D,CHI,37,45,1,11,12
12,8476967,Brett Kulak,D,EDM,30,64,1,11,12
12,8475179,Dmitry Kulikov,D,FLA,34,59,1,11,12
12,8481537,Nikita Okhotiuk,D,CGY,24,57,0,12,12
12,8479370,Tyson Jost,C,CAR,26,49,8,3,11
12,8482070,Mitchell Chaffee,R,TBL,26,50,8,3,11
12,8479291,Kevin Rooney,C,CGY,31,53,7,4,11
12,8479718,Alex Barré-Boulet,C,MTL,27,49,6,5,11
12,8479359,Beck Malenstyn,L,BUF,26,43,5,6,11
12,8479439,Jacob MacDonald,D,COL,31,45,4,7,11
12,8483763,Maksymilian Szuber,D,UTA,22,36,4,7,11
12,8480848,Ty Dellandrea,C,SJS,24,38,2,9,11
12,8476878,Zemgus Girgensons,C,TBL,30,79,7,3,10
12,8478831,Kevin Stenlund,C,UTA,28,52,7,3,10
12,8482166,Shakir Mukhamadullin,D,SJS,22,59,7,3,10
12,8482077,Dylan Holloway,L,EDM,23,42,6,4,10
12,8477979,Nicolas Aube-Kubel,R,BUF,28,53,5,5,10
12,8481028,Martin Pospisil,C,CGY,25,46,5,5,10
12,8476858,Phillip Di Giuseppe,L,VAN,31,43,5,5,10
12,8481754,Nikita Nesterenko,C,ANA,23,31,5,5,10
12,8475750,Jon Merrill,D,MIN,32,57,4,6,10
12,8481518,Nolan Foote,L,NJD,24,41,4,6,10
12,8476934,Brock McGinn,L,ANA,30,46,4,6,10
12,8481751,Lukas Rousek,R,BUF,25,40,4,6,10
12,8482496,Nils Aman,C,VAN,24,37,4,6,10
12,8475958,Michael Sgarbossa,C,WSH,32,24,4,6,10
12,8480880,Jakub Lauko,C,MIN,24,39,4,6,10
12,8479985,Cale Fleury,D,SEA,26,28,4,6,10
12,8480021,Jack Studnicka,C,LAK,25,60,3,7,10
12,8479372,Joshua Mahura,D,SEA,26,52,3,7,10
12,8480441,Trey Fix-Wolansky,R,CBJ,25,35,3,7,10
12,8475208,Brian Dumoulin,D,ANA,33,63,1,9,10
12,8479348,Kale Clague,D,BUF,26,38,1,9,10
12,8480070,Ian Mitchell,D,BOS,25,49,1,9,10
12,8481708,Zac Jones,D,NYR,24,50,1,9,10
12,8481600,Tobias Bjornfot,D,FLA,23,39,1,9,10
12,8475762,Derek Forbort,D,VAN,32,36,1,9,10
12,8481617,Vasily Podkolzin,R,VAN,23,44,7,2,9
12,8480292,Carson Meyer,R,ANA,27,28,6,3,9
12,8482659,Josh Doan,R,UTA,22,49,6,3,9
12,8482730,Brandt Clarke,D,LAK,21,42,6,3,9
12,8482751,Ryan Winterton,C,SEA,21,35,5,4,9
12,8483512,Matthew Savoie,C,EDM,20,29,5,4,9
12,8479944,Zach Aston-Reese,C,VGK,30,47,4,5,9
12,8476867,Brendan Gaunce,C,MIN,30,42,4,5,9
12,8482859,Zack Ostapchuk,C,OTT,21,55,4,5,9
12,8480058,Pierre-Olivier Joseph,D,STL,25,62,4,5,9
12,8482177,Marat Khusnutdinov,C,MIN,22,32,4,5,9
12,8471677,Jack Johnson,D,CBJ,37,63,3,6,9
12,8478424,Jansen Harkins,C,ANA,27,43,3,6,9
12,8477401,John Hayden,C,SEA,29,36,3,6,9
12,8482451,Mikael Pyyhtia,L,CBJ,23,36,2,7,9
12,8479442,Troy Stecher,D,EDM,30,51,2,7,9
12,8480844,Grigori Denisenko,L,VGK,24,29,2,7,9
12,8477335,Kyle Burroughs,D,LAK,29,40,0,9,9
12,8478468,Jeremy Lauzon,D,NSH,27,53,0,9,9
12,8479249,Andrew Poturalski,C,SJS,30,30,0,9,9
12,8483570,Ben Meyers,C,SEA,26,30,7,1,8
12,8481147,Reese Johnson,C,MIN,26,32,6,2,8
12,8479981,Jonah Gadjovich,L,FLA,26,49,6,2,8
12,8480845,Rasmus Kupari,C,WPG,24,40,6,2,8
12,8478451,Ethan Bear,D,WSH,27,48,4,4,8
12,8479379,Givani Smith,R,SJS,26,31,4,4,8
12,8477887,Patrick Brown,C,BOS,32,45,3,5,8
12,8479772,Zack MacEwen,R,OTT,28,55,3,5,8
12,8482861,Vincent Iorio,D,WSH,22,28,3,5,8
12,8479972,Mason Shaw,C,WPG,26,36,2,6,8
12,8477482,Zachary Sanford,L,CHI,30,43,2,6,8
12,8482784,Zach Dean,C,STL,21,44,2,6,8
12,8481056,Spencer Stastney,D,NSH,24,30,2,6,8
12,8476874,Olli Maatta,D,DET,30,56,1,7,8
12,8478859,Niko Mikkola,D,FLA,28,57,1,7,8
12,8484254,Akito Hirose,D,VAN,25,49,1,7,8
12,8478454,Noah Juulsen,D,VAN,27,38,1,7,8
12,8480950,Ilya Lyubushkin,D,DAL,30,65,1,7,8
12,8481598,Philip Broberg,D,EDM,23,45,1,7,8
12,8479378,Logan Stanley,D,WPG,26,39,0,8,8
12,8481532,Alex Turcotte,C,LAK,23,48,5,2,7
12,8477018,Ben Hutton,D,VGK,31,47,3,4,7
12,8477573,Nathan Walker,L,STL,30,42,3,4,7
12,8479994,Jaret Anderson-Dolan,C,WPG,25,35,3,4,7
12,8471817,Ryan Reaves,R,TOR,37,57,3,4,7
12,8482095,Tyler Kleven,D,OTT,22,42,3,4,7
12,8477527,Ross Johnston,L,ANA,30,35,3,4,7
12,8483630,Pavol Regenda,L,ANA,25,33,3,4,7
12,8480007,Jonas Rondbjerg,R,VGK,25,34,2,5,7
12,8474568,Luke Schenn,D,NSH,35,49,2,5,7
12,8483549,Lucas Condotta,L,MTL,27,33,2,5,7
12,8477073,Kurtis MacDermid,L,NJD,30,26,2,5,7
12,8482153,Brendan Brisson,C,VGK,23,38,2,5,7
12,8474013,Ian Cole,D,UTA,35,50,1,6,7
12,8483619,Filip Roos,D,OTT,25,27,1,6,7
12,8478146,Matthew Highmore,C,OTT,28,30,1,6,7
12,8476372,Nick Seeler,D,PHI,31,47,0,7,7
12,8477384,Joshua Brown,D,EDM,30,45,0,7,7
12,8481167,Brayden Pachal,D,CGY,25,41,4,2,6
12,8482652,Walker Duehr,R,CGY,27,35,4,2,6
12,8482634,Alex Steeves,C,TOR,25,47,3,3,6
12,8479968,Vinni Lettieri,C,BOS,29,47,3,3,6
12,8483012,Logan Morrison,C,SEA,22,41,3,3,6
12,8473446,Erik Johnson,D,PHI,36,46,3,3,6
12,8477962,Brendan Lemieux,L,CAR,28,32,2,4,6
12,8477070,Liam O'Brien,C,UTA,30,52,2,4,6
12,8474612,Travis Hamonic,D,OTT,34,44,2,4,6
12,8474090,Brendan Smith,D,DAL,35,53,1,5,6
12,8476473,Connor Murphy,D,CHI,31,43,1,5,6
12,8482713,Mackie Samoskevich,R,FLA,22,39,1,5,6
12,8480990,Declan Chisholm,D,MIN,24,42,1,5,6
12,8476913,Devin Shore,C,MIN,30,42,1,5,6
12,8483397,Marc McLaughlin,C,BOS,25,31,1,5,6
12,8483460,David Jiricek,D,CBJ,21,55,0,6,6
12,8481789,Tye Kartye,L,SEA,23,35,4,1,5
12,8482762,Simon Edvinsson,D,DET,21,55,4,1,5
12,8481556,John Beecher,C,BOS,23,31,4,1,5
12,8482102,Vasily Ponomarev,C,PIT,22,14,4,1,5
12,8475235,Nicolas Deslauriers,L,PHI,33,41,3,2,5
12,8476952,Dominic Toninato,C,WPG,30,39,3,2,5
12,8481237,Kyle MacLean,C,NYI,25,30,3,2,5
12,8480032,Shane Bowers,C,NJD,25,18,3,2,5
12,8482765,Isak Rosen,R,BUF,21,25,2,3,5
12,8482666,Scott Morrow,D,CAR,22,40,2,3,5
12,8480870,Bo Groulx,C,NYR,24,26,2,3,5
12,8479986,Kole Lind,R,DAL,26,50,1,4,5
12,8477851,Jordan Oesterle,D,BOS,32,38,1,4,5
12,8481701,Santeri Hatakka,D,NJD,23,40,1,4,5
12,8482141,Lukas Cormier,D,VGK,22,21,1,4,5
12,8481122,Simon Benoit,D,TOR,26,32,3,1,4
12,8481422,Jake Lucchini,C,NSH,29,18,3,1,4
12,8479638,Justin Brazeau,R,BOS,26,34,3,1,4
12,8478051,Max Willman,C,NJD,29,17,3,1,4
12,8482147,Jean-Luc Foudy,C,COL,22,28,3,1,4
12,8482747,Brennan Othmann,L,NYR,21,42,2,2,4
12,8481609,Vladislav Kolyachonok,D,UTA,23,31,2,2,4
12,8483395,Arshdeep Bains,L,VAN,23,13,2,2,4
12,8478017,Mark Friedman,D,VAN,29,37,1,3,4
12,8477971,Andreas Englund,D,LAK,28,32,1,3,4
12,8482118,Sam Colangelo,R,ANA,23,24,1,3,4
12,8482145,Mavrik Bourque,C,DAL,22,45,1,3,4
12,8480890,Jan Jenik,C,OTT,24,21,1,3,4
12,8480267,Sammy Walker,C,MIN,25,15,1,3,4
12,8477541,Dakota Mermis,D,TOR,30,11,1,3,4
12,8478450,Parker Wotherspoon,D,BOS,27,31,0,4,4
12,8478021,William Lagesson,D,DET,28,32,0,4,4
12,8479576,Vincent Desharnais,D,VAN,28,31,0,4,4
12,8481743,Marc Del Gaizo,D,NSH,25,21,0,4,4
12,8480245,Olle Lycksell,R,PHI,25,24,3,0,3
12,8480468,James Hamblin,L,EDM,25,22,3,0,3
12,8481462,Mason Morelli,L,VGK,28,12,3,0,3
12,8484911,Collin Graf,R,SJS,22,40,2,1,3
12,8479367,William Lockwood,R,FLA,26,15,2,1,3
12,8481043,Cole Koepke,L,BOS,26,14,2,1,3
12,8482061,Brandon Biro,L,SEA,26,8,2,1,3
12,8481030,Jack St. Ivany,D,PIT,25,17,2,1,3
12,8478147,Bokondji Imama,L,PIT,28,7,2,1,3
12,8480851,Akil Thomas,C,LAK,24,17,2,1,3
12,8481679,Maxence Guenette,D,OTT,23,37,1,2,3
12,8478874,Adam Gaudette,R,OTT,28,43,1,2,3
12,8483489,Fraser Minten,C,TOR,31,12,1,2,3
12,8482858,Ryker Evans,D,SEA,23,25,1,2,3
12,8481543,Nikita Alexandrov,C,STL,24,29,1,2,3
12,8478854,Ryan Shea,D,PIT,27,14,1,2,3
12,8482787,Nikita Chibrikov,R,WPG,31,8,1,2,3
12,8482733,Logan Mailloux,D,MTL,31,36,0,3,3
12,8478409,Anthony Richard,C,PHI,28,27,0,3,3
12,8477810,Joel Hanley,D,CGY,33,25,0,3,3
12,8482250,Callahan Burke,C,VGK,27,16,0,3,3
12,8477467,Gustav Olofsson,D,SEA,30,16,0,3,3
12,8479421,Jacob Moverare,D,LAK,26,10,0,3,3
12,8482172,Landon Slaggert,L,CHI,22,23,0,3,3
12,8479419,Brett Murray,L,BUF,26,19,0,3,3
12,8482929,Emil Lilleberg,D,TBL,23,18,0,3,3
12,8479587,Rhett Gardner,C,PHI,28,23,0,3,3
12,8484325,Waltteri Merela,C,TBL,26,25,2,0,2
12,8477244,Chad Ruhwedel,D,NYR,34,31,1,1,2
12,8481593,Jayden Struble,D,MTL,23,16,1,1,2
12,8475413,Justin Dowling,C,NJD,34,17,1,1,2
12,8482470,Ilya Solovyov,D,CGY,24,13,1,1,2
12,8482144,Jack Thompson,D,SJS,22,20,1,1,2
12,8481006,Tyler Tucker,D,STL,24,16,1,1,2
12,8484287,Cole McWard,D,VAN,23,23,1,1,2
12,8480823,Alexander Alexeyev,D,WSH,25,12,1,1,2
12,8481564,Ryan Johnson,D,BUF,23,16,1,1,2
12,8476441,Joel Edmundson,D,LAK,31,30,0,2,2
12,8484258,Sam Malinski,D,COL,26,26,0,2,2
12,8479320,Maxime Lajoie,D,SEA,27,21,0,2,2
12,8481605,Jackson LaCombe,D,ANA,23,28,0,2,2
12,8477462,Robert Hagg,D,VGK,29,18,0,2,2
12,8477149,Scott Sabourin,R,SJS,32,14,0,2,2
12,8481541,Samuel Bolduc,D,NYI,24,30,0,2,2
12,8483567,Georgii Merkulov,C,BOS,24,10,0,2,2
12,8476323,Max McCormick,L,SEA,32,5,0,2,2
12,8479522,Hardy Haman Aktell,D,WSH,26,5,0,2,2
12,8479362,Riley Tufte,L,BOS,26,18,1,0,1
12,8483471,Brad Lambert,C,WPG,31,5,1,0,1
12,8481024,Linus Karlsson,C,VAN,25,10,1,0,1
12,8481719,Maxwell Crozier,D,TBL,24,17,1,0,1
12,8477473,Justin Bailey,R,SJS,29,21,1,0,1
12,8481699,Aku Raty,R,UTA,23,15,1,0,1
12,8482162,Roby Jarventie,L,EDM,22,16,1,0,1
12,8480075,Cameron Crotty,D,MIN,25,12,1,0,1
12,8480874,Adam Ginning,D,PHI,24,11,1,0,1
12,8482088,Justin Sourdif,R,FLA,22,19,1,0,1
12,8477993,Justin Kirkland,C,CGY,28,8,1,0,1
12,8484259,Ondrej Pavel,C,COL,31,3,1,0,1
12,8481806,Louis Crevier,D,CHI,23,10,0,1,1
12,8478477,Mitchell Stephens,C,SEA,27,24,0,1,1
12,8481585,Egor Afanasyev,L,SJS,23,11,0,1,1
12,8478011,Louie Belpedio,D,PHI,28,19,0,1,1
12,8482165,Yan Kuznetsov,D,CGY,22,16,0,1,1
12,8482476,Emil Heineman,L,MTL,23,10,0,1,1
12,8483597,Milos Kelemen,L,UTA,25,10,0,1,1
12,8482201,Gage Goncalves,C,TBL,23,23,0,1,1
12,8477320,Anton Blidh,L,NYR,29,24,0,1,1
12,8482197,Adam Raska,R,MIN,23,6,0,1,1
12,8480306,Grant Hutton,D,NYI,29,4,0,1,1
12,8478502,Dennis Gilbert,D,BUF,28,17,0,1,1
12,8482516,Matthew Kessel,D,STL,24,19,0,1,1
12,8484255,Jason Polin,R,COL,25,6,0,1,1
12,8481655,Cole Schwindt,R,CGY,23,6,0,1,1
12,8481534,Raphael Lavoie,C,EDM,24,3,0,1,1
12,8478881,Brett Seney,L,CHI,28,8,0,0,0
12,8479991,Jake Leschyshyn,C,NYR,25,30,0,0,0
12,8481065,Angus Crookshank,L,OTT,25,14,0,0,0
12,8474062,Riley Nash,C,NYR,35,12,0,0,0
12,8483609,Adam Klapka,R,CGY,24,2,0,0,0
12,8480084,Nick DeSimone,D,NJD,30,12,0,0,0
12,8475780,Chris Wagner,R,COL,33,10,0,0,0
12,8481578,Graeme Clarke,R,MIN,23,10,0,0,0
12,8481726,Adam Edstrom,C,NYR,24,1,0,0,0
12,8475795,Dylan McIlrath,D,WSH,32,16,0,0,0
12,8478446,Glenn Gawdin,C,LAK,27,10,0,0,0
12,8484326,Patrik Koch,D,UTA,28,2,0,0,0
12,8483407,Brandon Scanlin,D,NYR,25,6,0,0,0
12,8479330,Brandon Gignac,C,MTL,27,14,0,0,0
12,8482460,Matt Rempe,C,NYR,22,11,0,0,0
12,8484304,Uvis Balinskis,D,FLA,28,8,0,0,0
12,8483920,Pierrick Dube,R,WSH,23,4,0,0,0
12,8483546,Marshall Rifai,D,TOR,26,2,0,0,0
12,8481206,John Ludvig,D,PIT,24,6,0,0,0
12,8482094,Daemon Hunt,D,MIN,22,16,0,0,0
12,8475755,Alexander Petrovic,D,DAL,32,17,0,0,0
12,8483398,Declan Carlile,D,TBL,31,3,0,0,0
12,8483432,Luca Del Bel Belluz,C,CBJ,31,4,0,0,0
12,8483401,Marc Johnstone,R,PIT,28,1,0,0,0
12,8484321,Nikolas Matinpalo,D,OTT,26,3,0,0,0
12,8483531,Brian Halonen,L,NJD,25,2,0,0,0
12,8482126,Emil Andrae,D,PHI,31,7,0,0,0
12,8470794,Joe Pavelski,C,,40,0,0,0,0
12,8479321,Lucas Johansen,D,,27,0,0,0,0
12,8477950,Tony DeAngelo,D,,29,0,0,0,0
12,8471218,Blake Wheeler,R,,38,0,0,0,0
12,8475197,Tyson Barrie,D,,33,0,0,0,0
12,8474157,Max Pacioretty,L,,36,0,0,0,0
12,8475744,Evgeny Kuznetsov,C,,32,0,0,0,0
12,8474037,James van Riemsdyk,L,,35,0,0,0,0
12,8476907,Mackenzie MacEachern,L,,30,0,0,0,0
12,8480216,Jacob Peterson,C,,25,0,0,0,0
12,8474602,Justin Schultz,D,,34,0,0,0,0
12,8482222,Alexander Barabanov,L,,30,0,0,0,0
12,8474031,Kevin Shattenkirk,D,,35,0,0,0,0
12,8477330,Dominik Kubalik,L,,29,0,0,0,0
12,8480884,Calen Addison,D,,24,0,0,0,0
12,8475906,John Klingberg,D,,32,0,0,0,0
12,8480008,Adam Ruzicka,C,,25,0,0,0,0
12,8476884,Derrick Pouliot,D,,30,0,0,0,0
12,8476919,Chris Tierney,C,,30,0,0,0,0
12,8479415,Michael McLeod,C,,26,0,0,0,0
12,8474870,Tyler Johnson,C,,34,0,0,0,0
12,8470604,Jeff Carter,C,,39,0,0,0,0
12,8478104,Sammy Blais,L,,28,0,0,0,0
12,8474884,Mike Hoffman,C,,35,0,0,0,0
12,8481591,Sam Poulin,R,,23,0,0,0,0
12,8471274,Alex Goligoski,D,,39,0,0,0,0
12,8476871,Tanner Pearson,L,,32,0,0,0,0
12,8476393,Nick Cousins,C,,31,0,0,0,0
12,8479977,Kailer Yamamoto,R,,26,0,0,0,0
12,8479346,Dillon Dube,C,,26,0,0,0,0
12,8480184,Gustav Lindstrom,D,,26,0,0,0,0
12,8479376,Victor Mete,D,,26,0,0,0,0
12,8473449,Kyle Okposo,R,,36,0,0,0,0
12,8481058,Jesse Ylonen,R,,25,0,0,0,0
12,8475752,Tyler Pitlick,C,,33,0,0,0,0
12,8481239,Samuel Fagemo,L,,24,0,0,0,0
12,8480821,Filip Zadina,R,,25,0,0,0,0
12,8470966,Mark Giordano,D,,41,0,0,0,0
12,8478495,Denis Gurianov,R,,27,0,0,0,0
12,8477464,Nic Petan,C,,29,0,0,0,0
12,8478099,Kevin Labanc,R,,29,0,0,0,0
12,8482241,Radim Zohorna,L,,28,0,0,0,0
12,8474040,Sam Gagner,C,,35,0,0,0,0
12,8479514,Rem Pitlick,C,,27,0,0,0,0
12,8478430,Oliver Kylington,D,,27,0,0,0,0
12,8479533,Joona Koppanen,L,,26,0,0,0,0
12,8479984,Cal Foote,D,,26,0,0,0,0
12,8477126,Jayson Megna,C,,34,0,0,0,0
12,8475164,Jakob Silfverberg,R,,34,0,0,0,0
12,8474009,Nick Bonino,C,,36,0,0,0,0
12,8479458,Nikita Zaitsev,D,,33,0,0,0,0
12,8477944,Jakub Vrana,L,,28,0,0,0,0
12,8471699,Andrew Cogliano,C,,37,0,0,0,0
12,8478067,Oskar Lindblom,L,,28,0,0,0,0
12,8471686,Marc Staal,D,,37,0,0,0,0
12,8470610,Zach Parise,L,,40,0,0,0,0
12,8478904,Steven Lorentz,C,,28,0,0,0,0
12,8473473,Milan Lucic,L,,36,0,0,0,0
12,8480031,Maxime Comtois,L,,25,0,0,0,0
12,8478512,Austin Czarnik,C,,32,0,0,0,0
12,8473504,Cal Clutterbuck,R,,37,0,0,0,0
12,8477454,Adam Erne,L,,29,0,0,0,0
12,8479383,Boris Katchouk,L,,26,0,0,0,0
12,8475825,Jani Hakanpää,D,,32,0,0,0,0
12,8477846,Ryan Carpenter,C,,33,0,0,0,0
12,8477930,Pierre-Edouard Bellemare,L,,39,0,0,0,0
12,8478400,Colin White,C,,27,0,0,0,0
12,8480226,Marián Studenic,R,,26,0,0,0,0
12,8480853,Liam Foudy,C,,24,0,0,0,0
12,8475797,Jarred Tinordi,D,,32,0,0,0,0
12,8479423,Alex Nylander,L,,26,0,0,0,0
12,8474618,Marco Scandella,D,,34,0,0,0,0
12,8478028,Fredrik Olofsson,L,,28,0,0,0,0
12,8474709,Matt Martin,L,,35,0,0,0,0
12,8481070,Hugh McGing,L,,26,0,0,0,0
12,8479546,Oskar Steen,C,,26,0,0,0,0
12,8474145,Robert Bortuzzo,D,,35,0,0,0,0
12,8476915,Jujhar Khaira,L,,30,0,0,0,0
12,8480274,Philip Kemp,D,EDM,25,0,0,0,0
12,8475278,Byron Froese,C,,33,0,0,0,0
12,8481812,Nikolai Knyzhov,D,,27,0,0,0,0
12,8478408,Travis Dermott,D,,28,0,0,0,0
12,8481077,John Leonard,L,,26,0,0,0,0
12,8479547,Matthew Phillips,R,,26,0,0,0,0
12,8480836,Jonathan Gruden,C,,24,0,0,0,0
12,8481690,Tyler Angle,C,,24,0,0,0,0
12,8475766,Austin Watson,L,,32,0,0,0,0
12,8481016,Ruslan Iskhakov,C,,24,0,0,0,0
12,8478078,Rourke Chartier,C,,28,0,0,0,0
12,8480776,Sheldon Rempal,R,,29,0,0,0,0
12,8478956,Samuel Laberge,L,NJD,27,0,0,0,0
12,8483045,Cameron Butler,R,CBJ,31,0,0,0,0
12,8484314,Jiri Smejkal,L,,28,0,0,0,0
13,8478402,Connor McDavid,C,EDM,27,79,46,105,151
13,8476453,Nikita Kucherov,R,TBL,31,82,48,92,140
13,8477492,Nathan MacKinnon,C,COL,29,81,57,82,139
13,8478550,Artemi Panarin,L,NYR,33,77,49,90,139
13,8477934,Leon Draisaitl,C,EDM,29,80,40,78,118
13,8476468,J.T. Miller,C,VAN,31,78,47,69,116
13,8478420,Mikko Rantanen,R,COL,28,81,53,59,112
13,8479314,Matthew Tkachuk,L,FLA,27,78,35,76,111
13,8477956,David Pastrnak,R,BOS,28,79,49,58,107
13,8478864,Kirill Kaprizov,L,MIN,27,67,45,59,104
13,8478483,Mitch Marner,R,TOR,27,78,30,73,103
13,8481559,Jack Hughes,C,NJD,23,78,38,63,101
13,8471675,Sidney Crosby,C,PIT,37,73,45,52,97
13,8479323,Adam Fox,D,NYR,26,78,12,83,95
13,8478427,Sebastian Aho,C,CAR,27,75,44,49,93
13,8477404,Jake Guentzel,C,TBL,30,82,37,56,93
13,8480027,Jason Robertson,L,DAL,25,81,36,57,93
13,8476389,Vincent Trocheck,C,NYR,31,78,29,64,93
13,8480800,Quinn Hughes,D,VAN,25,76,14,78,92
13,8482116,Tim Stützle,C,OTT,22,79,32,59,91
13,8474600,Roman Josi,D,NSH,34,72,20,71,91
13,8477493,Aleksander Barkov,C,FLA,29,77,19,72,91
13,8475692,Mats Zuccarello,R,MIN,37,73,26,64,90
13,8479318,Auston Matthews,C,TOR,27,81,48,41,89
13,8478398,Kyle Connor,L,WPG,28,74,42,47,89
13,8475166,John Tavares,C,TOR,34,81,36,53,89
13,8484144,Connor Bedard,C,CHI,19,72,32,57,89
13,8477942,Kevin Fiala,L,LAK,28,79,36,52,88
13,8476460,Mark Scheifele,C,WPG,31,77,27,60,87
13,8474564,Steven Stamkos,C,NSH,34,70,34,52,86
13,8476887,Filip Forsberg,L,NSH,30,77,31,55,86
13,8476454,Ryan Nugent-Hopkins,C,EDM,31,79,24,62,86
13,8476539,Jonathan Marchessault,R,NSH,34,76,54,31,85
13,8480036,Miro Heiskanen,D,DAL,25,77,17,68,85
13,8480023,Robert Thomas,C,STL,25,70,23,61,84
13,8477933,Sam Reinhart,C,FLA,29,77,40,43,83
13,8480801,Brady Tkachuk,L,OTT,25,79,36,47,83
13,8478403,Jack Eichel,C,VGK,28,78,34,49,83
13,8478460,Zach Werenski,D,CBJ,27,82,16,66,82
13,8478444,Brock Boeser,R,VAN,27,79,33,48,81
13,8480865,Noah Dobson,D,NYI,24,78,11,70,81
13,8479343,Clayton Keller,R,UTA,26,73,28,52,80
13,8481557,Matt Boldy,L,MIN,23,73,35,44,79
13,8479542,Brandon Hagel,L,TBL,26,82,28,51,79
13,8478445,Mathew Barzal,C,NYI,27,80,20,59,79
13,8477939,William Nylander,R,TOR,28,80,30,48,78
13,8476456,Jonathan Huberdeau,C,CGY,31,78,16,62,78
13,8480012,Elias Pettersson,C,VAN,26,70,31,45,76
13,8475184,Chris Kreider,L,NYR,33,74,41,32,73
13,8475784,Jeff Skinner,C,EDM,32,81,35,38,73
13,8475913,Mark Stone,R,VGK,32,74,31,42,73
13,8478493,Joel Eriksson Ek,C,MIN,27,73,31,42,73
13,8478010,Brayden Point,C,TBL,28,81,39,33,72
13,8477949,Alex Tuch,R,BUF,28,79,33,39,72
13,8479420,Tage Thompson,C,BUF,27,69,33,39,72
13,8480002,Nico Hischier,C,NJD,25,73,31,41,72
13,8477955,Jared McCann,L,SEA,28,77,39,32,71
13,8477960,Adrian Kempe,R,LAK,28,81,36,35,71
13,8476448,William Karlsson,C,VGK,31,77,30,41,71
13,8477402,Pavel Buchnevich,L,STL,29,76,28,43,71
13,8478414,Timo Meier,R,NJD,28,73,36,34,70
13,8475170,Brayden Schenn,C,STL,33,80,29,41,70
13,8475172,Nazem Kadri,C,CGY,34,77,20,50,70
13,8477504,Josh Morrissey,D,WPG,29,76,13,57,70
13,8477501,Valeri Nichushkin,R,COL,29,81,32,37,69
13,8483515,Juraj Slafkovsky,L,MTL,20,73,25,44,69
13,8482740,Wyatt Johnston,C,DAL,21,81,38,30,68
13,8478449,Roope Hintz,C,DAL,28,81,35,33,68
13,8473419,Brad Marchand,L,BOS,36,80,28,40,68
13,8477940,Nikolaj Ehlers,L,WPG,28,71,26,42,68
13,8475754,Brock Nelson,C,NYI,33,80,42,25,67
13,8475168,Matt Duchene,C,DAL,33,82,25,42,67
13,8471685,Anze Kopitar,C,LAK,37,81,16,51,67
13,8480014,Gabriel Vilardi,C,WPG,25,63,44,22,66
13,8476459,Mika Zibanejad,C,NYR,31,73,28,38,66
13,8476882,Teuvo Teravainen,C,CHI,30,71,24,42,66
13,8481540,Cole Caufield,R,MTL,23,75,31,34,65
13,8480830,Andrei Svechnikov,R,CAR,24,70,28,37,65
13,8476346,Johnny Gaudreau,L,CBJ,31,70,14,51,65
13,8478407,Vince Dunn,D,SEA,28,71,11,54,65
13,8477946,Dylan Larkin,C,DET,28,81,28,36,64
13,8477496,Elias Lindholm,C,BOS,30,80,27,37,64
13,8477951,Nick Schmaltz,C,UTA,28,78,24,40,64
13,8482665,Matty Beniers,C,SEA,22,77,24,40,64
13,8474578,Erik Karlsson,D,PIT,34,80,13,51,64
13,8478439,Travis Konecny,R,PHI,27,76,28,35,63
13,8475794,Tyler Seguin,C,DAL,32,81,28,35,63
13,8480018,Nick Suzuki,C,MTL,25,75,24,39,63
13,8480839,Rasmus Dahlin,D,BUF,24,72,18,45,63
13,8477409,Carter Verhaeghe,C,FLA,29,77,36,26,62
13,8482109,Alexis Lafrenière,L,NYR,23,74,32,30,62
13,8477456,J.T. Compher,L,DET,29,81,32,30,62
13,8477407,Anthony Duclair,L,NYI,29,76,28,34,62
13,8475765,Vladimir Tarasenko,R,DET,33,81,27,35,62
13,8481533,Trevor Zegras,C,ANA,23,73,25,37,62
13,8476881,Tomas Hertl,C,VGK,31,73,23,39,62
13,8480208,Drake Batherson,R,OTT,26,79,23,39,62
13,8478401,Pavel Zacha,C,BOS,27,77,21,41,62
13,8484153,Leo Carlsson,C,ANA,20,70,20,42,62
13,8477447,Shea Theodore,D,VGK,29,62,14,48,62
13,8479425,Filip Hronek,D,VAN,27,77,12,50,62
13,8478498,Jake DeBrusk,L,VAN,28,76,31,30,61
13,8474141,Patrick Kane,R,DET,36,80,26,35,61
13,8475158,Ryan O'Reilly,C,NSH,33,71,18,43,61
13,8475786,Zach Hyman,L,EDM,32,72,35,25,60
13,8475810,Bryan Rust,R,PIT,32,66,27,33,60
13,8481068,Yegor Sharangovich,C,CGY,26,78,25,35,60
13,8477476,Artturi Lehkonen,L,COL,29,82,24,36,60
13,8475167,Victor Hedman,D,TBL,34,81,12,48,60
13,8471214,Alex Ovechkin,L,WSH,39,78,31,28,59
13,8478856,Conor Garland,R,VAN,28,73,30,29,59
13,8481528,Dylan Cozens,C,BUF,23,68,27,31,58
13,8479337,Alex DeBrincat,R,DET,27,80,22,36,58
13,8479339,Patrik Laine,L,CBJ,26,69,19,39,58
13,8474590,John Carlson,D,WSH,34,72,15,43,58
13,8480028,Morgan Frost,C,PHI,25,72,14,44,58
13,8479325,Charlie McAvoy,D,BOS,27,72,7,51,58
13,8479675,Trevor Moore,L,LAK,29,80,25,32,57
13,8479407,Jesper Bratt,L,NJD,26,75,22,35,57
13,8477416,Oliver Bjorkstrand,R,SEA,29,73,28,28,56
13,8475151,Kyle Palmieri,C,NYI,33,81,28,28,56
13,8477500,Bo Horvat,C,NYI,29,79,27,29,56
13,8471215,Evgeni Malkin,C,PIT,38,73,23,33,56
13,8482159,Tyson Foerster,R,PHI,22,76,23,33,56
13,8478873,Troy Terry,R,ANA,27,72,22,34,56
13,8473994,Jamie Benn,L,DAL,35,81,21,35,56
13,8480069,Cale Makar,D,COL,26,62,14,42,56
13,8480803,Evan Bouchard,D,EDM,25,72,14,42,56
13,8477932,Aaron Ekblad,D,FLA,28,76,14,42,56
13,8482093,Seth Jarvis,C,CAR,22,71,26,29,55
13,8473512,Claude Giroux,R,OTT,36,78,22,33,55
13,8476905,Chandler Stephenson,C,SEA,30,71,14,41,55
13,8482684,Luke Hughes,D,NJD,21,72,9,46,55
13,8480015,Owen Tippett,R,PHI,25,75,29,25,54
13,8474102,David Perron,L,OTT,36,79,27,27,54
13,8478366,Frank Vatrano,R,ANA,30,73,27,27,54
13,8479385,Jordan Kyrou,C,STL,26,74,24,30,54
13,8482149,Cole Perfetti,C,WPG,22,65,24,30,54
13,8482699,Dylan Guenther,R,UTA,21,74,22,32,54
13,8482745,Mason McTavish,C,ANA,21,73,21,33,54
13,8477503,Max Domi,C,TOR,29,78,15,39,54
13,8476399,Blake Coleman,C,CGY,33,75,30,23,53
13,8478975,Mason Marchment,L,DAL,29,82,16,37,53
13,8470613,Brent Burns,D,CAR,39,77,11,42,53
13,8482702,Logan Stankoven,C,DAL,21,78,26,26,52
13,8482124,Quinton Byfield,R,LAK,22,81,21,31,52
13,8476479,Phillip Danault,C,LAK,31,80,20,32,52
13,8474150,Mikael Backlund,C,CGY,35,78,19,33,52
13,8477986,Brandon Montour,D,SEA,30,71,15,37,52
13,8471724,Kris Letang,D,PIT,37,78,11,41,52
13,8482110,Dawson Mercer,C,NJD,23,70,25,26,51
13,8477494,Jonathan Drouin,L,COL,29,81,21,30,51
13,8477935,Sam Bennett,C,FLA,28,75,21,30,51
13,8476880,Tom Wilson,R,WSH,30,70,20,31,51
13,8478438,Tommy Novak,C,NSH,27,71,15,36,51
13,8479999,Casey Mittelstadt,C,COL,26,81,13,38,51
13,8481560,Arthur Kaliyev,R,LAK,23,80,27,23,50
13,8473986,Alex Killorn,L,ANA,35,68,22,28,50
13,8479400,Pierre-Luc Dubois,L,WSH,26,73,17,33,50
13,8480039,Martin Necas,C,CAR,25,75,16,34,50
13,8476462,Dougie Hamilton,D,NJD,31,72,12,38,50
13,8482078,Lucas Raymond,L,DET,22,80,20,29,49
13,8475768,Jaden Schwartz,C,SEA,32,66,18,31,49
13,8482097,Jack Quinn,R,BUF,23,61,14,35,49
13,8475798,Mikael Granlund,C,SJS,32,72,12,37,49
13,8476483,Rickard Rakell,R,PIT,31,69,24,24,48
13,8480064,Josh Norris,C,OTT,25,80,20,28,48
13,8475745,Charlie Coyle,C,BOS,32,77,18,30,48
13,8478042,Viktor Arvidsson,L,EDM,31,76,16,32,48
13,8476906,Shayne Gostisbehere,D,CAR,31,79,12,35,47
13,8478396,Noah Hanifin,D,VGK,27,66,7,40,47
13,8476853,Morgan Rielly,D,TOR,30,71,4,43,47
13,8477451,Ryan Hartman,R,MIN,30,72,31,15,46
13,8484166,Adam Fantilli,C,CBJ,20,64,21,25,46
13,8476474,Stefan Noesen,R,NJD,31,68,21,25,46
13,8480798,Philipp Kurashev,C,CHI,25,62,20,26,46
13,8477964,Ivan Barbashev,C,VGK,29,72,19,27,46
13,8478047,Michael Bunting,L,PIT,29,70,18,28,46
13,8475287,Erik Haula,L,NJD,33,74,16,30,46
13,8478055,Gustav Forsling,D,FLA,28,69,14,32,46
13,8476875,Mike Matheson,D,MTL,30,76,11,35,46
13,8476463,Jonas Brodin,D,MIN,31,78,9,37,46
13,8482113,Anton Lundell,C,FLA,23,77,27,18,45
13,8483808,Andrei Kuzmenko,L,CGY,28,75,22,23,45
13,8475314,Anders Lee,L,NYI,34,76,21,24,45
13,8476885,Jacob Trouba,D,NYR,30,74,18,27,45
13,8478542,Evan Rodrigues,C,FLA,31,75,11,34,45
13,8474563,Drew Doughty,D,LAK,35,77,10,35,45
13,8474716,Jared Spurgeon,D,MIN,35,77,10,35,45
13,8481542,Moritz Seider,D,DET,23,77,6,39,45
13,8478038,Devon Toews,D,COL,30,69,6,39,45
13,8475726,Tyler Toffoli,C,SJS,32,72,23,21,44
13,8478046,Danton Heinen,L,VAN,29,75,22,22,44
13,8478519,Anthony Cirelli,C,TBL,27,82,22,22,44
13,8474679,Gustav Nyquist,C,NSH,35,68,17,27,44
13,8475191,Reilly Smith,R,NYR,33,72,16,28,44
13,8479345,Jakob Chychrun,D,WSH,26,70,16,28,44
13,8477998,Warren Foegele,L,LAK,28,81,14,30,44
13,8478440,Dylan Strome,C,WSH,27,75,12,32,44
13,8477346,MacKenzie Weegar,D,CGY,30,74,10,34,44
13,8476461,Sean Couturier,C,PHI,32,74,19,24,43
13,8477021,Alex Kerfoot,C,UTA,30,76,17,26,43
13,8474586,Jordan Eberle,R,SEA,34,73,15,28,43
13,8475764,Cam Fowler,D,ANA,33,68,7,36,43
13,8478474,Lawson Crouse,L,UTA,27,72,25,17,42
13,8477497,Sean Monahan,C,CBJ,30,66,16,26,42
13,8478466,Daniel Sprong,R,VAN,27,71,10,32,42
13,8475753,Justin Faulk,D,STL,32,71,9,33,42
13,8477495,Seth Jones,D,CHI,30,67,7,35,42
13,8478469,Thomas Chabot,D,OTT,27,78,5,37,42
13,8476438,Brandon Saad,L,STL,32,74,21,20,41
13,8482089,Jake Neighbours,L,STL,22,76,21,20,41
13,8474641,Adam Henrique,C,EDM,34,73,19,22,41
13,8480871,Adam Boqvist,D,FLA,24,73,17,24,41
13,8478472,Mathieu Joseph,R,STL,27,68,16,25,41
13,8476927,Teddy Blueger,C,VAN,30,68,16,25,41
13,8478462,Nicolas Roy,C,VGK,27,76,14,27,41
13,8480336,Sean Walker,D,CAR,30,73,12,29,41
13,8482671,Owen Power,D,BUF,22,68,10,31,41
13,8476792,Torey Krug,D,STL,33,71,8,33,41
13,8475169,Evander Kane,L,EDM,33,75,28,12,40
13,8477444,Andre Burakovsky,L,SEA,29,71,17,23,40
13,8481624,Ilya Mikheyev,R,CHI,30,60,15,25,40
13,8481596,Shane Pinto,C,OTT,24,76,12,28,40
13,8484203,Bradly Nadeau,L,CAR,19,63,12,28,40
13,8476480,Vladislav Namestnikov,C,WPG,32,63,12,28,40
13,8480185,Eetu Luostarinen,C,FLA,26,73,14,25,39
13,8481711,Matias Maccelli,L,UTA,24,78,12,27,39
13,8480145,Neal Pionk,D,WPG,29,76,11,28,39
13,8476917,Adam Pelech,D,NYI,30,77,7,32,39
13,8474715,Cameron Atkinson,R,TBL,35,82,18,20,38
13,8480797,Joel Farabee,L,PHI,24,73,18,20,38
13,8475763,Kevin Hayes,R,PIT,32,68,16,22,38
13,8481524,Bowen Byram,D,BUF,23,61,15,23,38
13,8484145,Zach Benson,L,BUF,19,72,13,25,38
13,8476869,Brady Skjei,D,NSH,30,74,9,29,38
13,8476958,Jaccob Slavin,D,CAR,30,75,9,29,38
13,8476432,Boone Jenner,C,CBJ,31,66,21,16,37
13,8476918,Jimmy Vesey,L,NYR,31,68,21,16,37
13,8479525,Ross Colton,C,COL,28,79,19,18,37
13,8476458,Ryan Strome,C,ANA,31,73,15,22,37
13,8480009,Eeli Tolvanen,R,SEA,25,72,14,23,37
13,8481618,Alex Newhook,C,MTL,23,67,13,24,37
13,8476854,Hampus Lindholm,D,BOS,30,73,10,27,37
13,8482712,Oskar Olausson,R,COL,22,76,9,28,37
13,8477948,Travis Sanheim,D,PHI,28,70,3,34,37
13,8480893,Kirill Marchenko,R,CBJ,24,60,27,9,36
13,8475193,Tomas Tatar,L,NJD,34,70,17,19,36
13,8475791,Taylor Hall,L,CHI,33,57,17,19,36
13,8483431,Logan Cooley,C,UTA,20,74,16,20,36
13,8477426,Nicholas Paul,L,TBL,29,80,16,20,36
13,8481582,Nicholas Robertson,L,TOR,23,76,15,21,36
13,8482667,William Eklund,L,SJS,22,69,15,21,36
13,8479591,Michael Eyssimont,C,TBL,28,80,14,22,36
13,8480078,Filip Chytil,C,NYR,25,68,14,22,36
13,8476872,Scott Laughton,C,PHI,30,72,13,23,36
13,8478233,Andrew Mangiapane,L,WSH,28,69,13,23,36
13,8478397,Rasmus Andersson,D,CGY,28,76,10,26,36
13,8480849,Barrett Hayton,C,UTA,24,71,18,17,35
13,8482092,Ridly Greig,C,OTT,22,78,17,18,35
13,8476826,Yanni Gourde,C,SEA,33,73,16,19,35
13,8480459,Pius Suter,C,VAN,28,63,12,23,35
13,8479987,Morgan Geekie,C,BOS,26,75,12,23,35
13,8476960,Andreas Athanasiou,C,CHI,30,51,12,23,35
13,8483445,Cutter Gauthier,L,ANA,20,63,12,23,35
13,8476292,Ondrej Palat,L,NJD,33,70,11,24,35
13,8478413,Jordan Greenway,L,BUF,27,67,9,26,35
13,8476923,Damon Severson,D,CBJ,30,80,9,26,35
13,8479351,Sam Steel,C,DAL,26,80,9,26,35
13,8481581,Thomas Harley,D,DAL,23,69,9,26,35
13,8480817,K'Andre Miller,D,NYR,24,74,7,28,35
13,8481703,Valtteri Puustinen,R,PIT,25,62,6,29,35
13,8481604,Pavel Dorofeyev,L,VGK,24,71,21,13,34
13,8478109,Victor Olofsson,L,VGK,29,71,18,16,34
13,8476419,Jean-Gabriel Pageau,C,NYI,32,78,16,18,34
13,8481577,Philip Tomasino,C,NSH,23,67,13,21,34
13,8480829,Jesperi Kotkaniemi,C,CAR,24,66,11,23,34
13,8475218,Mattias Ekholm,D,EDM,34,74,10,24,34
13,8479410,Mikhail Sergachev,D,UTA,26,68,6,28,34
13,8481606,Jordan Spence,D,LAK,23,68,4,30,34
13,8478500,Ivan Provorov,D,CBJ,27,80,4,30,34
13,8479365,Trent Frederic,C,BOS,26,78,24,9,33
13,8482055,Drew O'Connor,L,PIT,26,62,22,11,33
13,8482175,JJ Peterka,R,BUF,22,68,19,14,33
13,8481186,Logan O'Connor,R,COL,28,78,19,14,33
13,8482705,Cole Sillinger,C,CBJ,21,67,18,15,33
13,8481554,Kaapo Kakko,R,NYR,23,68,18,15,33
13,8475714,Calle Jarnkrok,C,TOR,33,76,18,15,33
13,8477952,Robby Fabbri,C,ANA,28,70,15,18,33
13,8482720,Matthew Knies,L,TOR,22,76,14,19,33
13,8480188,Fabian Zetterlund,L,SJS,25,66,13,20,33
13,8482105,Jake Sanderson,D,OTT,22,71,12,21,33
13,8478115,Pierre Engvall,L,NYI,28,76,12,21,33
13,8471698,T.J. Oshie,R,WSH,38,60,11,22,33
13,8476925,Colton Sissons,C,NSH,31,68,11,22,33
13,8475149,Marcus Johansson,L,MIN,34,64,10,23,33
13,8483505,Matthew Poitras,C,BOS,20,73,9,24,33
13,8477429,Andrew Copp,C,DET,30,78,8,25,33
13,8482122,Brock Faber,D,MIN,22,77,5,28,33
13,8479353,Brett Howden,C,VGK,26,71,15,17,32
13,8475722,Jason Zucker,L,BUF,32,67,14,18,32
13,8473533,Jordan Staal,C,CAR,36,61,14,18,32
13,8483490,Pavel Mintyukov,D,ANA,21,73,12,20,32
13,8473422,Nick Foligno,L,CHI,37,59,11,21,32
13,8475171,Oliver Ekman-Larsson,D,TOR,33,68,11,21,32
13,8482660,Kent Johnson,C,CBJ,22,65,10,22,32
13,8477488,Brett Pesce,D,NJD,30,75,3,29,32
13,8480113,Alex Iafallo,L,WPG,31,68,12,19,31
13,8476392,Adam Lowry,C,WPG,31,64,12,19,31
13,8477498,Darnell Nurse,D,EDM,29,77,9,22,31
13,8476979,Erik Gustafsson,D,DET,32,74,4,27,31
13,8476331,Dylan DeMelo,D,WPG,31,71,3,28,31
13,8474149,Evgenii Dadonov,R,DAL,35,80,15,15,30
13,8482475,Yegor Chinakhov,R,CBJ,23,65,12,18,30
13,8481523,Kirby Dach,C,MTL,23,67,12,18,30
13,8480220,Noah Cates,L,PHI,25,71,10,20,30
13,8480434,Sean Durzi,D,UTA,26,72,7,23,30
13,8474151,Ryan McDonagh,D,TBL,35,72,6,24,30
13,8475799,Nino Niederreiter,R,WPG,32,59,17,12,29
13,8481704,Juuso Parssinen,C,NSH,23,60,17,12,29
13,8479293,Brandon Tanev,L,SEA,33,65,15,14,29
13,8477479,Tyler Bertuzzi,L,CHI,29,64,14,15,29
13,8482079,Marco Rossi,C,MIN,23,63,14,15,29
13,8475848,Brendan Gallagher,R,MTL,32,68,13,16,29
13,8478463,Anthony Beauvillier,L,PIT,27,69,13,16,29
13,8480802,Ryan McLeod,C,BUF,25,61,11,18,29
13,8477987,Ryan Donato,C,CHI,28,57,10,19,29
13,8480003,Jesper Boqvist,C,FLA,26,73,10,19,29
13,8481656,Aliaksei Protas,C,WSH,23,67,10,19,29
13,8482111,Justin Barron,D,MTL,23,64,9,20,29
13,8476892,Colton Parayko,D,STL,31,68,5,24,29
13,8477969,Marcus Pettersson,D,PIT,28,77,2,27,29
13,8480873,Rasmus Sandin,D,WSH,24,68,1,28,29
13,8482245,Artem Zub,D,OTT,29,63,1,28,29
13,8476981,Josh Anderson,R,MTL,30,72,14,14,28
13,8479393,Noah Gregor,L,OTT,26,73,14,14,28
13,8481535,Nils Hoglander,L,VAN,24,61,13,15,28
13,8479992,Michael Rasmussen,C,DET,25,80,12,16,28
13,8476897,Oskar Sundqvist,C,STL,30,65,12,16,28
13,8475793,Ryan Johansen,C,PHI,32,72,12,16,28
13,8477989,Christian Dvorak,C,MTL,28,65,8,20,28
13,8476525,Colin Miller,D,WPG,32,60,8,20,28
13,8477506,Ryan Pulock,D,NYI,30,78,4,24,28
13,8478136,Jake Middleton,D,MIN,28,71,2,26,28
13,8479390,Taylor Raddysh,R,WSH,26,68,15,12,27
13,8483468,Jiri Kulich,C,BUF,20,59,13,14,27
13,8475343,Nic Dowd,C,WSH,34,56,13,14,27
13,8477953,Kasperi Kapanen,R,STL,28,68,13,14,27
13,8480995,Pontus Holmberg,R,TOR,25,64,13,14,27
13,8477511,Anthony Mantha,R,CGY,30,72,11,16,27
13,8478133,Jake Evans,C,MTL,28,66,11,16,27
13,8474189,Lars Eller,C,PIT,35,68,11,16,27
13,8480855,Jack McBain,C,UTA,24,73,11,16,27
13,8477505,Alexander Wennberg,C,SJS,30,62,10,17,27
13,8479996,Cody Glass,C,NSH,25,57,8,19,27
13,8476902,Esa Lindell,D,DAL,30,78,8,19,27
13,8474053,Logan Couture,C,SJS,35,70,7,20,27
13,8476891,Matthew Grzelcyk,D,PIT,30,80,1,26,27
13,8470621,Corey Perry,R,EDM,39,74,16,10,26
13,8478508,Yakov Trenin,C,MIN,27,58,15,11,26
13,8480748,Kiefer Sherwood,L,VAN,29,65,12,14,26
13,8479941,Justin Danforth,R,CBJ,31,53,11,15,26
13,8483499,Liam Ohgren,L,MIN,20,54,11,15,26
13,8476921,Jordan Martinook,L,CAR,32,61,10,16,26
13,8478020,Michael Amadio,R,OTT,28,72,10,16,26
13,8477979,Nicolas Aube-Kubel,R,BUF,28,59,10,16,26
13,8478891,Mason Appleton,C,WPG,28,63,9,17,26
13,8477425,Miles Wood,L,COL,29,73,9,17,26
13,8478458,John (Jack) Roslovic,C,CAR,27,64,8,18,26
13,8475220,Marcus Foligno,L,MIN,33,67,8,18,26
13,8480878,Nils Lundkvist,D,DAL,24,75,7,19,26
13,8479983,Mario Ferraro,D,SJS,26,71,4,22,26
13,8482155,Alex Laferriere,R,LAK,23,63,17,8,25
13,8482259,Bobby McMann,C,TOR,28,62,14,11,25
13,8482749,Joshua Roy,R,MTL,21,66,13,12,25
13,8474565,Alex Pietrangelo,D,VGK,34,61,11,14,25
13,8477919,Frederick Gaudreau,C,MIN,31,66,11,14,25
13,8480835,Jack Drury,C,CAR,24,57,10,15,25
13,8480789,Oliver Wahlstrom,R,NYI,24,67,10,15,25
13,8479982,Conor Timmins,D,TOR,26,60,8,17,25
13,8482067,Connor Mackey,D,NYR,28,62,6,19,25
13,8479976,Juuso Valimaki,D,UTA,26,61,5,20,25
13,8475462,Radko Gudas,D,ANA,34,63,4,21,25
13,8480246,Nick Perbix,D,TBL,26,69,3,22,25
13,8478840,Will Borgen,D,SEA,28,67,2,23,25
13,8478851,Alexandre Carrier,D,NSH,28,74,2,23,25
13,8479066,Ryan Lomberg,L,CGY,30,62,14,10,24
13,8480448,Parker Kelly,L,COL,25,79,13,11,24
13,8482146,Luke Evangelista,R,NSH,22,66,11,13,24
13,8477903,Garnet Hathaway,R,PHI,33,63,10,14,24
13,8474034,Patrick Maroon,L,CHI,36,62,10,14,24
13,8482133,Thomas Bordeleau,C,SJS,22,65,9,15,24
13,8478911,Matt Roy,D,WSH,29,63,8,16,24
13,8475855,Jesper Fast,R,CAR,33,60,8,16,24
13,8475208,Brian Dumoulin,D,ANA,33,62,7,17,24
13,8476312,Josh Manson,D,COL,33,70,5,19,24
13,8476879,Cody Ceci,D,EDM,31,74,1,23,24
13,8482062,Cole Smith,L,NSH,29,58,13,10,23
13,8482125,Alexander Holtz,R,VGK,22,72,12,11,23
13,8480813,Joe Veleno,C,DET,24,80,11,12,23
13,8477839,Conor Sheary,L,TBL,32,81,11,12,23
13,8480068,Ryan Poehling,C,PHI,25,64,9,14,23
13,8481522,Peyton Krebs,C,BUF,23,65,8,15,23
13,8477508,Curtis Lazar,C,NJD,29,65,8,15,23
13,8475200,Dmitry Orlov,D,CAR,33,73,6,17,23
13,8478507,John Marino,D,UTA,27,70,4,19,23
13,8482655,Janis Moser,D,TBL,24,78,3,20,23
13,8481580,Connor McMichael,C,WSH,23,57,13,9,22
13,8477446,Michael McCarron,R,NSH,29,60,13,9,22
13,8476278,Colin Blackwell,C,DAL,31,77,11,11,22
13,8477947,Sonny Milano,L,WSH,28,58,10,12,22
13,8482074,Connor Zary,C,CGY,23,63,10,12,22
13,8476873,Mark Jankowski,C,NSH,30,51,10,12,22
13,8476878,Zemgus Girgensons,C,TBL,30,80,10,12,22
13,8482624,Daniil Miromanov,D,CGY,27,67,8,14,22
13,8476329,Travis Boyd,C,MIN,31,53,8,14,22
13,8478434,Keegan Kolesar,R,VGK,27,64,7,15,22
13,8479315,Joey Anderson,R,CHI,26,48,6,16,22
13,8480144,David Kampf,C,TOR,29,71,6,16,22
13,8480073,Erik Brannstrom,D,COL,25,60,5,17,22
13,8477435,Ryan Graves,D,PIT,29,75,5,17,22
13,8481014,Alexander Romanov,D,NYI,24,78,4,18,22
13,8481059,Scott Perunovich,D,STL,26,60,4,18,22
13,8480043,Timothy Liljegren,D,TOR,25,66,1,21,22
13,8477015,Connor Brown,R,EDM,30,60,12,9,21
13,8478569,Noel Acciari,C,PIT,33,57,12,9,21
13,8475760,Nick Bjugstad,C,UTA,32,69,10,11,21
13,8480074,Alexandre Texier,C,STL,25,47,10,11,21
13,8482803,Olen Zellweger,D,ANA,21,69,10,11,21
13,8483493,Frank Nazar,C,CHI,20,49,10,11,21
13,8482117,Lukas Reichel,L,CHI,22,53,9,12,21
13,8481553,Bobby Brink,R,PHI,23,59,9,12,21
13,8479328,Julien Gauthier,R,NYI,27,63,9,12,21
13,8477450,Jason Dickinson,C,CHI,29,57,8,13,21
13,8477499,Rasmus Ristolainen,D,PHI,30,56,8,13,21
13,8482809,Jackson Blake,R,CAR,21,61,7,14,21
13,8478970,Jalen Chatfield,D,CAR,28,70,7,14,21
13,8475233,David Savard,D,MTL,34,62,5,16,21
13,8473507,Jeff Petry,D,DET,37,72,4,17,21
13,8476457,Adam Larsson,D,SEA,32,69,4,17,21
13,8479980,Nicolas Hague,D,VGK,26,57,3,18,21
13,8479371,Dante Fabbro,D,NSH,26,65,2,19,21
13,8476889,Radek Faksa,C,STL,30,56,14,6,20
13,8478057,Dakota Joshua,C,VAN,28,62,9,11,20
13,8481617,Vasily Podkolzin,R,VAN,23,43,9,11,20
13,8482737,Zack Bolduc,C,STL,21,64,7,13,20
13,8482859,Zack Ostapchuk,C,OTT,21,51,7,13,20
13,8483457,Lane Hutson,D,MTL,20,62,6,14,20
13,8482073,Braden Schneider,D,NYR,23,62,5,15,20
13,8481546,Cam York,D,PHI,23,67,5,15,20
13,8474574,Tyler Myers,D,VAN,34,64,5,15,20
13,8479398,Samuel Girard,D,COL,26,66,4,16,20
13,8476422,Mike Reilly,D,NYI,31,73,4,16,20
13,8481019,David Gustafsson,C,WPG,24,55,4,16,20
13,8475225,Craig Smith,C,CHI,35,44,10,9,19
13,8484149,Gavin Brindley,C,CBJ,20,53,9,10,19
13,8481441,Joe Snively,C,DET,28,65,7,12,19
13,8483524,Shane Wright,C,SEA,20,59,7,12,19
13,8480205,Emil Bemstrom,C,PIT,25,60,7,12,19
13,8480025,MacKenzie Entwistle,R,FLA,25,63,7,12,19
13,8473563,Nicklas Backstrom,C,WSH,37,58,4,15,19
13,8478882,Vladislav Gavrikov,D,LAK,29,71,3,16,19
13,8475790,Erik Gudbranson,D,CBJ,32,79,3,16,19
13,8479324,Ryan Lindgren,D,NYR,26,57,3,16,19
13,8482142,Jamie Drysdale,D,PHI,22,61,2,17,19
13,8475181,Nick Leddy,D,STL,33,70,1,18,19
13,8480049,Dylan Samberg,D,WPG,25,63,0,19,19
13,8478585,Derek Ryan,C,EDM,38,64,13,5,18
13,8481032,Paul Cotter,C,NJD,25,57,11,7,18
13,8477353,Tyler Motte,C,DET,29,72,11,7,18
13,8477931,Tomas Nosek,L,FLA,32,61,11,7,18
13,8480281,Alexey Toropchenko,R,STL,25,52,11,7,18
13,8477478,William Carrier,L,CAR,30,55,9,9,18
13,8477507,Nikita Zadorov,D,BOS,29,70,8,10,18
13,8478432,Christian Fischer,R,DET,27,76,7,11,18
13,8483482,Tristan Luneau,D,ANA,20,66,7,11,18
13,8483491,Ivan Miroshnichenko,L,WSH,20,53,7,11,18
13,8481481,Blake Lizotte,C,PIT,27,63,6,12,18
13,8477369,Carson Soucy,D,VAN,30,62,5,13,18
13,8481521,Ronnie Attard,D,PHI,25,60,4,14,18
13,8477220,Nate Schmidt,D,FLA,33,66,3,15,18
13,8482087,Kaiden Guhle,D,MTL,22,68,2,16,18
13,8482148,Hendrix Lapierre,C,WSH,22,57,12,5,17
13,8482807,Ethan Del Mastro,D,CHI,21,56,11,6,17
13,8479368,Max Jones,L,BOS,26,59,10,7,17
13,8479619,Michael Carcone,L,UTA,28,55,9,8,17
13,8479661,Tanner Jeannot,L,LAK,27,74,9,8,17
13,8482101,Danil Gushchin,L,SJS,22,52,8,9,17
13,8478013,Jake Walman,D,SJS,28,67,8,9,17
13,8479316,Luke Kunin,C,SJS,27,57,7,10,17
13,8481517,Brett Leason,R,ANA,25,54,7,10,17
13,8476469,Joel Armia,R,MTL,31,61,6,11,17
13,8481527,Kaedan Korczak,D,VGK,23,44,6,11,17
13,8479344,Jesse Puljujarvi,R,PIT,26,52,5,12,17
13,8479442,Troy Stecher,D,EDM,30,50,5,12,17
13,8480891,Michael Kesselring,D,UTA,24,61,1,16,17
13,8480762,Eric Robinson,L,CAR,29,58,9,7,16
13,8481641,Joel Kiviranta,L,COL,28,72,8,8,16
13,8477406,Mattias Janmark,C,EDM,32,64,8,8,16
13,8479370,Tyson Jost,C,CAR,26,51,8,8,16
13,8482192,Isaak Phillips,D,CHI,23,46,7,9,16
13,8481601,Simon Holmstrom,R,NYI,23,69,6,10,16
13,8476994,Vinnie Hinostroza,C,NSH,30,52,6,10,16
13,8480035,Henri Jokiharju,D,BUF,25,59,5,11,16
13,8481751,Lukas Rousek,R,BUF,25,42,5,11,16
13,8482451,Mikael Pyyhtia,L,CBJ,23,43,5,11,16
13,8474673,TJ Brodie,D,CHI,34,63,4,12,16
13,8476467,Jamie Oleksiak,D,SEA,32,70,4,12,16
13,8482157,Will Cuylle,L,NYR,22,64,12,3,15
13,8482679,Matt Coronato,R,CGY,22,70,9,6,15
13,8479520,Brandon Duhaime,R,WSH,27,54,8,7,15
13,8475842,Sam Carrick,C,NYR,32,50,7,8,15
13,8480252,Cole Guttman,C,CHI,25,39,7,8,15
13,8478451,Ethan Bear,D,WSH,27,55,7,8,15
13,8475231,Casey Cizikas,C,NYI,33,70,6,9,15
13,8480806,Isac Lundestrom,C,ANA,25,63,6,9,15
13,8482747,Brennan Othmann,L,NYR,21,45,6,9,15
13,8479402,Jake Bean,D,CGY,26,66,5,10,15
13,8483495,Simon Nemec,D,NJD,20,62,5,10,15
13,8479439,Jacob MacDonald,D,COL,31,61,5,10,15
13,8478859,Niko Mikkola,D,FLA,28,49,4,11,15
13,8477034,Jaycob Megna,D,FLA,32,48,3,12,15
13,8480157,Calle Rosen,D,COL,30,48,3,12,15
13,8478416,Erik Cernak,D,TBL,27,73,2,13,15
13,8479369,Andrew Peeke,D,BOS,26,64,1,14,15
13,8475690,Chris Tanev,D,TOR,35,60,1,14,15
13,8477365,Connor Clifton,D,BUF,29,57,1,14,15
13,8476374,Sean Kuraly,C,CBJ,31,56,10,4,14
13,8481013,Jonatan Berggren,R,DET,24,50,8,6,14
13,8476988,Matt Benning,D,SJS,30,64,7,7,14
13,8481477,Nico Sturm,C,SJS,29,51,7,7,14
13,8480289,Morgan Barron,C,WPG,26,56,6,8,14
13,8479639,Dylan Coghlan,D,WPG,26,62,6,8,14
13,8477392,Hudson Fasching,R,NYI,29,62,6,8,14
13,8478043,Sam Lafferty,C,BUF,29,64,6,8,14
13,8480727,Zach Whitecloud,D,VGK,28,54,6,8,14
13,8476934,Brock McGinn,L,ANA,30,51,6,8,14
13,8481093,Rafael Harvey-Pinard,L,MTL,25,62,5,9,14
13,8471677,Jack Johnson,D,CBJ,37,61,4,10,14
13,8475279,Ben Chiarot,D,DET,33,73,2,12,14
13,8482176,Wyatt Kaiser,D,CHI,22,52,2,12,14
13,8480001,Urho Vaakanainen,D,ANA,25,58,1,13,14
13,8474567,Zach Bogosian,D,MIN,34,59,1,13,14
13,8480796,Martin Fehervary,D,WSH,25,58,0,14,14
13,8481716,Dmitri Voronkov,L,CBJ,24,47,8,5,13
13,8479026,Philippe Myers,D,TOR,27,47,7,6,13
13,8479359,Beck Malenstyn,L,BUF,26,42,7,6,13
13,8478421,A.J. Greer,L,FLA,28,56,6,7,13
13,8479543,Michael Pezzetta,L,MTL,26,58,6,7,13
13,8476442,Matt Nieto,L,PIT,32,42,5,8,13
13,8473453,Trevor Lewis,C,LAK,37,72,5,8,13
13,8481568,Alex Vlasic,D,CHI,23,58,4,9,13
13,8474166,Alec Martinez,D,CHI,37,49,4,9,13
13,8479378,Logan Stanley,D,WPG,26,48,4,9,13
13,8480355,Mark Kastelic,C,BOS,25,60,3,10,13
13,8476856,Mathew Dumba,D,DAL,30,70,3,10,13
13,8477018,Ben Hutton,D,VGK,31,45,3,10,13
13,8478452,Caleb Jones,D,LAK,27,56,2,11,13
13,8475188,Brayden McNabb,D,VGK,33,48,2,11,13
13,8481178,Egor Zamula,D,PHI,24,48,2,11,13
13,8480172,Jan Rutta,D,SJS,34,60,2,11,13
13,8479348,Kale Clague,D,BUF,26,48,1,12,13
13,8482077,Dylan Holloway,L,EDM,23,56,7,5,12
13,8481518,Nolan Foote,L,NJD,24,39,7,5,12
13,8480980,Connor Dewar,C,TOR,25,64,6,6,12
13,8477573,Nathan Walker,L,STL,30,53,6,6,12
13,8477380,Jonny Brodzinski,C,NYR,31,56,5,7,12
13,8483466,Kevin Korchinski,D,CHI,20,51,5,7,12
13,8483565,Nick Blankenburg,D,NSH,26,58,4,8,12
13,8483549,Lucas Condotta,L,MTL,27,43,4,8,12
13,8478399,Jonas Siegenthaler,D,NJD,27,62,3,9,12
13,8475324,Nick Jensen,D,OTT,34,68,3,9,12
13,8470600,Ryan Suter,D,STL,39,61,3,9,12
13,8480848,Ty Dellandrea,C,SJS,24,45,3,9,12
13,8481708,Zac Jones,D,NYR,24,50,3,9,12
13,8480058,Pierre-Olivier Joseph,D,STL,25,51,3,9,12
13,8481161,Jake Christiansen,D,CBJ,25,56,2,10,12
13,8477845,Trevor van Riemsdyk,D,WSH,33,61,2,10,12
13,8475179,Dmitry Kulikov,D,FLA,34,62,2,10,12
13,8476931,Jake McCabe,D,TOR,31,68,1,11,12
13,8480887,Jordan Harris,D,MTL,24,48,1,11,12
13,8476858,Phillip Di Giuseppe,L,VAN,31,45,6,5,11
13,8478211,Dryden Hunt,L,CGY,29,62,5,6,11
13,8479994,Jaret Anderson-Dolan,C,WPG,25,43,5,6,11
13,8476822,Luke Glendening,C,TBL,35,78,4,7,11
13,8478178,Darren Raddysh,D,TBL,28,68,4,7,11
13,8480860,Kevin Bahl,D,CGY,24,57,4,7,11
13,8474568,Luke Schenn,D,NSH,35,46,4,7,11
13,8475455,Brenden Dillon,D,NJD,34,59,3,8,11
13,8479671,Mathieu Olivier,R,CBJ,27,50,3,8,11
13,8482730,Brandt Clarke,D,LAK,21,49,3,8,11
13,8483460,David Jiricek,D,CBJ,21,54,3,8,11
13,8480222,Sebastian Aho,D,PIT,28,72,2,9,11
13,8478443,Brandon Carlo,D,BOS,28,56,2,9,11
13,8481537,Nikita Okhotiuk,D,CGY,24,49,2,9,11
13,8481599,Victor Soderstrom,D,UTA,23,40,1,10,11
13,8478468,Jeremy Lauzon,D,NSH,27,50,1,10,11
13,8476429,Scott Mayfield,D,NYI,32,73,0,11,11
13,8477887,Patrick Brown,C,BOS,32,48,6,4,10
13,8484911,Collin Graf,R,SJS,22,41,6,4,10
13,8478831,Kevin Stenlund,C,UTA,28,59,5,5,10
13,8477070,Liam O'Brien,C,UTA,30,59,5,5,10
13,8480990,Declan Chisholm,D,MIN,24,35,5,5,10
13,8482666,Scott Morrow,D,CAR,22,45,5,5,10
13,8482141,Lukas Cormier,D,VGK,22,28,5,5,10
13,8482145,Mavrik Bourque,C,DAL,22,47,5,5,10
13,8479414,Nathan Bastian,R,NJD,27,57,4,6,10
13,8476473,Connor Murphy,D,CHI,31,41,4,6,10
13,8480021,Jack Studnicka,C,LAK,25,55,3,7,10
13,8480845,Rasmus Kupari,C,WPG,24,42,3,7,10
13,8477482,Zachary Sanford,L,CHI,30,38,3,7,10
13,8481167,Brayden Pachal,D,CGY,25,38,3,7,10
13,8482166,Shakir Mukhamadullin,D,SJS,22,60,1,9,10
13,8481605,Jackson LaCombe,D,ANA,23,33,1,9,10
13,8479336,Carl Grundstrom,R,SJS,27,47,7,2,9
13,8479638,Justin Brazeau,R,BOS,26,30,7,2,9
13,8482744,James Malatesta,L,CBJ,21,48,6,3,9
13,8479968,Vinni Lettieri,C,BOS,29,44,5,4,9
13,8480292,Carson Meyer,R,ANA,27,32,4,5,9
13,8483630,Pavol Regenda,L,ANA,25,36,4,5,9
13,8483012,Logan Morrison,C,SEA,22,39,4,5,9
13,8477962,Brendan Lemieux,L,CAR,28,36,4,5,9
13,8479367,William Lockwood,R,FLA,26,31,4,5,9
13,8482964,Arber Xhekaj,D,MTL,23,48,3,6,9
13,8480192,Johnathan Kovacevic,D,NJD,27,35,3,6,9
13,8479291,Kevin Rooney,C,CGY,31,54,3,6,9
13,8481701,Santeri Hatakka,D,NJD,23,36,3,6,9
13,8480807,Mattias Samuelsson,D,BUF,24,54,2,7,9
13,8476874,Olli Maatta,D,DET,30,62,2,7,9
13,8481532,Alex Turcotte,C,LAK,23,44,2,7,9
13,8479986,Kole Lind,R,DAL,26,53,2,7,9
13,8479998,Mikey Anderson,D,LAK,25,59,1,8,9
13,8475718,Justin Holl,D,DET,32,55,1,8,9
13,8480007,Jonas Rondbjerg,R,VGK,25,39,1,8,9
13,8482751,Ryan Winterton,C,SEA,21,33,7,1,8
13,8475235,Nicolas Deslauriers,L,PHI,33,51,6,2,8
13,8478424,Jansen Harkins,C,ANA,27,40,5,3,8
13,8483397,Marc McLaughlin,C,BOS,25,39,5,3,8
13,8476624,Barclay Goodrow,C,SJS,31,46,4,4,8
13,8480880,Jakub Lauko,C,MIN,24,28,4,4,8
13,8479972,Mason Shaw,C,WPG,26,38,4,4,8
13,8474013,Ian Cole,D,UTA,35,43,4,4,8
13,8478146,Matthew Highmore,C,OTT,28,38,4,4,8
13,8481789,Tye Kartye,L,SEA,23,36,4,4,8
13,8479985,Cale Fleury,D,SEA,26,29,3,5,8
13,8478017,Mark Friedman,D,VAN,29,39,3,5,8
13,8480879,Jacob Bernard-Docker,D,OTT,24,47,2,6,8
13,8471709,Marc-Edouard Vlasic,D,SJS,37,66,2,6,8
13,8480070,Ian Mitchell,D,BOS,25,52,2,6,8
13,8481598,Philip Broberg,D,EDM,23,44,2,6,8
13,8474090,Brendan Smith,D,DAL,35,53,2,6,8
13,8481122,Simon Benoit,D,TOR,26,35,2,6,8
13,8481550,Adam Beckman,L,NJD,23,25,1,7,8
13,8479372,Joshua Mahura,D,SEA,26,52,1,7,8
13,8479944,Zach Aston-Reese,C,VGK,30,50,1,7,8
13,8484254,Akito Hirose,D,VAN,25,39,1,7,8
13,8473446,Erik Johnson,D,PHI,36,61,0,8,8
13,8482070,Mitchell Chaffee,R,TBL,26,54,5,2,7
13,8480441,Trey Fix-Wolansky,R,CBJ,25,36,5,2,7
13,8479718,Alex Barré-Boulet,C,MTL,27,46,4,3,7
13,8481600,Tobias Bjornfot,D,FLA,23,39,4,3,7
13,8481147,Reese Johnson,C,MIN,26,37,4,3,7
13,8482634,Alex Steeves,C,TOR,25,44,4,3,7
13,8482713,Mackie Samoskevich,R,FLA,22,39,4,3,7
13,8482762,Simon Edvinsson,D,DET,21,61,4,3,7
13,8476867,Brendan Gaunce,C,MIN,30,32,3,4,7
13,8477401,John Hayden,C,SEA,29,35,3,4,7
13,8479772,Zack MacEwen,R,OTT,28,46,3,4,7
13,8477971,Andreas Englund,D,LAK,28,30,3,4,7
13,8482496,Nils Aman,C,VAN,24,35,2,5,7
13,8481556,John Beecher,C,BOS,23,40,2,5,7
13,8476441,Joel Edmundson,D,LAK,31,40,2,5,7
13,8477473,Justin Bailey,R,SJS,29,25,2,5,7
13,8476967,Brett Kulak,D,EDM,30,53,1,6,7
13,8482177,Marat Khusnutdinov,C,MIN,22,40,0,7,7
13,8478454,Noah Juulsen,D,VAN,27,32,0,7,7
13,8477467,Gustav Olofsson,D,SEA,30,22,6,0,6
13,8480011,Klim Kostin,C,SJS,25,46,4,2,6
13,8481754,Nikita Nesterenko,C,ANA,23,35,4,2,6
13,8484287,Cole McWard,D,VAN,23,26,4,2,6
13,8482659,Josh Doan,R,UTA,22,43,3,3,6
13,8482153,Brendan Brisson,C,VGK,23,28,3,3,6
13,8476913,Devin Shore,C,MIN,30,32,3,3,6
13,8481679,Maxence Guenette,D,OTT,23,42,3,3,6
13,8478409,Anthony Richard,C,PHI,28,35,3,3,6
13,8481592,Jakob Pelletier,L,CGY,23,35,2,4,6
13,8475762,Derek Forbort,D,VAN,32,45,2,4,6
13,8482511,Mason Lohrei,D,BOS,23,34,1,5,6
13,8479249,Andrew Poturalski,C,SJS,30,36,1,5,6
13,8480950,Ilya Lyubushkin,D,DAL,30,58,1,5,6
13,8482095,Tyler Kleven,D,OTT,22,46,1,5,6
13,8476952,Dominic Toninato,C,WPG,30,31,1,5,6
13,8482250,Callahan Burke,C,VGK,27,30,0,6,6
13,8479981,Jonah Gadjovich,L,FLA,26,40,5,0,5
13,8482861,Vincent Iorio,D,WSH,22,24,4,1,5
13,8479536,Axel Jonsson-Fjallby,L,WPG,26,30,3,2,5
13,8483512,Matthew Savoie,C,EDM,20,17,3,2,5
13,8482784,Zach Dean,C,STL,21,37,3,2,5
13,8478874,Adam Gaudette,R,OTT,28,35,3,2,5
13,8479320,Maxime Lajoie,D,SEA,27,20,3,2,5
13,8477462,Robert Hagg,D,VGK,29,27,3,2,5
13,8477335,Kyle Burroughs,D,LAK,29,37,2,3,5
13,8480245,Olle Lycksell,R,PHI,25,29,2,3,5
13,8482733,Logan Mailloux,D,MTL,31,43,2,3,5
13,8480196,Jacob Bryson,D,BUF,27,46,1,4,5
13,8475750,Jon Merrill,D,MIN,32,63,1,4,5
13,8476372,Nick Seeler,D,PHI,31,43,1,4,5
13,8481743,Marc Del Gaizo,D,NSH,25,22,1,4,5
13,8477244,Chad Ruhwedel,D,NYR,34,31,1,4,5
13,8481567,Henry Thrun,D,SJS,23,48,0,5,5
13,8477384,Joshua Brown,D,EDM,30,43,0,5,5
13,8477320,Anton Blidh,L,NYR,29,23,0,5,5
13,8481028,Martin Pospisil,C,CGY,25,49,3,1,4
13,8482652,Walker Duehr,R,CGY,27,40,3,1,4
13,8482765,Isak Rosen,R,BUF,21,23,3,1,4
13,8480834,Ty Emberson,D,SJS,24,31,2,2,4
13,8471817,Ryan Reaves,R,TOR,37,47,2,2,4
13,8482858,Ryker Evans,D,SEA,23,21,2,2,4
13,8477073,Kurtis MacDermid,L,NJD,30,35,1,3,4
13,8483619,Filip Roos,D,OTT,25,27,1,3,4
13,8481609,Vladislav Kolyachonok,D,UTA,23,36,1,3,4
13,8479576,Vincent Desharnais,D,VAN,28,32,1,3,4
13,8482516,Matthew Kessel,D,STL,24,19,1,3,4
13,8480084,Nick DeSimone,D,NJD,30,19,1,3,4
13,8478450,Parker Wotherspoon,D,BOS,27,27,0,4,4
13,8474612,Travis Hamonic,D,OTT,34,47,3,0,3
13,8481206,John Ludvig,D,PIT,24,10,3,0,3
13,8475177,Calvin de Haan,D,COL,33,38,2,1,3
13,8479379,Givani Smith,R,SJS,26,31,2,1,3
13,8478051,Max Willman,C,NJD,29,20,2,1,3
13,8482172,Landon Slaggert,L,CHI,22,28,2,1,3
13,8484325,Waltteri Merela,C,TBL,26,22,2,1,3
13,8482144,Jack Thompson,D,SJS,22,25,2,1,3
13,8481541,Samuel Bolduc,D,NYI,24,28,2,1,3
13,8479991,Jake Leschyshyn,C,NYR,25,27,2,1,3
13,8477938,Haydn Fleury,D,WPG,28,36,1,2,3
13,8483570,Ben Meyers,C,SEA,26,20,1,2,3
13,8477851,Jordan Oesterle,D,BOS,32,44,1,2,3
13,8482147,Jean-Luc Foudy,C,COL,22,25,1,2,3
13,8482118,Sam Colangelo,R,ANA,23,13,1,2,3
13,8481462,Mason Morelli,L,VGK,28,12,1,2,3
13,8481543,Nikita Alexandrov,C,STL,24,24,1,2,3
13,8479419,Brett Murray,L,BUF,26,18,1,2,3
13,8481593,Jayden Struble,D,MTL,23,21,1,2,3
13,8481006,Tyler Tucker,D,STL,24,21,1,2,3
13,8481585,Egor Afanasyev,L,SJS,23,17,1,2,3
13,8478011,Louie Belpedio,D,PHI,28,11,1,2,3
13,8475755,Alexander Petrovic,D,DAL,32,12,1,2,3
13,8483763,Maksymilian Szuber,D,UTA,22,36,0,3,3
13,8475958,Michael Sgarbossa,C,WSH,32,26,0,3,3
13,8481056,Spencer Stastney,D,NSH,24,31,0,3,3
13,8477527,Ross Johnston,L,ANA,30,25,0,3,3
13,8480890,Jan Jenik,C,OTT,24,28,0,3,3
13,8484258,Sam Malinski,D,COL,26,18,0,3,3
13,8482102,Vasily Ponomarev,C,PIT,22,24,2,0,2
13,8481422,Jake Lucchini,C,NSH,29,12,2,0,2
13,8482061,Brandon Biro,L,SEA,26,21,2,0,2
13,8482787,Nikita Chibrikov,R,WPG,31,11,2,0,2
13,8481699,Aku Raty,R,UTA,23,18,2,0,2
13,8481578,Graeme Clarke,R,MIN,23,10,2,0,2
13,8478446,Glenn Gawdin,C,LAK,27,14,2,0,2
13,8481237,Kyle MacLean,C,NYI,25,27,1,1,2
13,8480870,Bo Groulx,C,NYR,24,26,1,1,2
13,8483395,Arshdeep Bains,L,VAN,23,11,1,1,2
13,8480267,Sammy Walker,C,MIN,25,17,1,1,2
13,8480468,James Hamblin,L,EDM,25,18,1,1,2
13,8481043,Cole Koepke,L,BOS,26,18,1,1,2
13,8480851,Akil Thomas,C,LAK,24,19,1,1,2
13,8477810,Joel Hanley,D,CGY,33,25,1,1,2
13,8481564,Ryan Johnson,D,BUF,23,12,1,1,2
13,8481719,Maxwell Crozier,D,TBL,24,22,1,1,2
13,8482162,Roby Jarventie,L,EDM,22,14,1,1,2
13,8480874,Adam Ginning,D,PHI,24,14,1,1,2
13,8478477,Mitchell Stephens,C,SEA,27,20,1,1,2
13,8482201,Gage Goncalves,C,TBL,23,18,1,1,2
13,8475780,Chris Wagner,R,COL,33,8,1,1,2
13,8483546,Marshall Rifai,D,TOR,26,6,1,1,2
13,8482094,Daemon Hunt,D,MIN,22,19,1,1,2
13,8478021,William Lagesson,D,DET,28,18,0,2,2
13,8474062,Riley Nash,C,NYR,35,19,0,2,2
13,8482460,Matt Rempe,C,NYR,22,14,0,2,2
13,8481030,Jack St. Ivany,D,PIT,25,13,1,0,1
13,8483489,Fraser Minten,C,TOR,31,6,1,0,1
13,8478854,Ryan Shea,D,PIT,27,7,1,0,1
13,8482470,Ilya Solovyov,D,CGY,24,14,1,0,1
13,8480823,Alexander Alexeyev,D,WSH,25,10,1,0,1
13,8483567,Georgii Merkulov,C,BOS,24,9,1,0,1
13,8480075,Cameron Crotty,D,MIN,25,13,1,0,1
13,8477993,Justin Kirkland,C,CGY,28,3,1,0,1
13,8481655,Cole Schwindt,R,CGY,23,8,1,0,1
13,8479330,Brandon Gignac,C,MTL,27,12,1,0,1
13,8484304,Uvis Balinskis,D,FLA,28,10,1,0,1
13,8483398,Declan Carlile,D,TBL,31,9,1,0,1
13,8480032,Shane Bowers,C,NJD,25,15,0,1,1
13,8477541,Dakota Mermis,D,TOR,30,11,0,1,1
13,8478147,Bokondji Imama,L,PIT,28,6,0,1,1
13,8482929,Emil Lilleberg,D,TBL,23,20,0,1,1
13,8475413,Justin Dowling,C,NJD,34,15,0,1,1
13,8476323,Max McCormick,L,SEA,32,3,0,1,1
13,8479362,Riley Tufte,L,BOS,26,18,0,1,1
13,8483471,Brad Lambert,C,WPG,31,11,0,1,1
13,8482088,Justin Sourdif,R,FLA,22,12,0,1,1
13,8481806,Louis Crevier,D,CHI,23,9,0,1,1
13,8482165,Yan Kuznetsov,D,CGY,22,26,0,1,1
13,8478881,Brett Seney,L,CHI,28,13,0,1,1
13,8481065,Angus Crookshank,L,OTT,25,13,0,1,1
13,8480844,Grigori Denisenko,L,VGK,24,26,0,0,0
13,8479421,Jacob Moverare,D,LAK,26,5,0,0,0
13,8479587,Rhett Gardner,C,PHI,28,22,0,0,0
13,8477149,Scott Sabourin,R,SJS,32,14,0,0,0
13,8479522,Hardy Haman Aktell,D,WSH,26,1,0,0,0
13,8481024,Linus Karlsson,C,VAN,25,9,0,0,0
13,8484259,Ondrej Pavel,C,COL,31,4,0,0,0
13,8482476,Emil Heineman,L,MTL,23,8,0,0,0
13,8483597,Milos Kelemen,L,UTA,25,12,0,0,0
13,8482197,Adam Raska,R,MIN,23,5,0,0,0
13,8480306,Grant Hutton,D,NYI,29,7,0,0,0
13,8478502,Dennis Gilbert,D,BUF,28,15,0,0,0
13,8484255,Jason Polin,R,COL,25,3,0,0,0
13,8481534,Raphael Lavoie,C,EDM,24,2,0,0,0
13,8483609,Adam Klapka,R,CGY,24,5,0,0,0
13,8481726,Adam Edstrom,C,NYR,24,8,0,0,0
13,8475795,Dylan McIlrath,D,WSH,32,10,0,0,0
13,8484326,Patrik Koch,D,UTA,28,5,0,0,0
13,8483407,Brandon Scanlin,D,NYR,25,4,0,0,0
13,8483920,Pierrick Dube,R,WSH,23,5,0,0,0
13,8483432,Luca Del Bel Belluz,C,CBJ,31,5,0,0,0
13,8483401,Marc Johnstone,R,PIT,28,0,0,0,0
13,8484321,Nikolas Matinpalo,D,OTT,26,3,0,0,0
13,8483531,Brian Halonen,L,NJD,25,5,0,0,0
13,8482126,Emil Andrae,D,PHI,31,1,0,0,0
13,8470794,Joe Pavelski,C,,40,0,0,0,0
13,8479321,Lucas Johansen,D,,27,0,0,0,0
13,8477950,Tony DeAngelo,D,,29,0,0,0,0
13,8471218,Blake Wheeler,R,,38,0,0,0,0
13,8475197,Tyson Barrie,D,,33,0,0,0,0
13,8474157,Max Pacioretty,L,,36,0,0,0,0
13,8475744,Evgeny Kuznetsov,C,,32,0,0,0,0
13,8474037,James van Riemsdyk,L,,35,0,0,0,0
13,8476907,Mackenzie MacEachern,L,,30,0,0,0,0
13,8480216,Jacob Peterson,C,,25,0,0,0,0
13,8474602,Justin Schultz,D,,34,0,0,0,0
13,8482222,Alexander Barabanov,L,,30,0,0,0,0
13,8474031,Kevin Shattenkirk,D,,35,0,0,0,0
13,8477330,Dominik Kubalik,L,,29,0,0,0,0
13,8480884,Calen Addison,D,,24,0,0,0,0
13,8475906,John Klingberg,D,,32,0,0,0,0
13,8480008,Adam Ruzicka,C,,25,0,0,0,0
13,8476884,Derrick Pouliot,D,,30,0,0,0,0
13,8476919,Chris Tierney,C,,30,0,0,0,0
13,8479415,Michael McLeod,C,,26,0,0,0,0
13,8474870,Tyler Johnson,C,,34,0,0,0,0
13,8470604,Jeff Carter,C,,39,0,0,0,0
13,8478104,Sammy Blais,L,,28,0,0,0,0
13,8474884,Mike Hoffman,C,,35,0,0,0,0
13,8481591,Sam Poulin,R,,23,0,0,0,0
13,8471274,Alex Goligoski,D,,39,0,0,0,0
13,8476871,Tanner Pearson,L,,32,0,0,0,0
13,8476393,Nick Cousins,C,,31,0,0,0,0
13,8479977,Kailer Yamamoto,R,,26,0,0,0,0
13,8479346,Dillon Dube,C,,26,0,0,0,0
13,8480184,Gustav Lindstrom,D,,26,0,0,0,0
13,8479376,Victor Mete,D,,26,0,0,0,0
13,8473449,Kyle Okposo,R,,36,0,0,0,0
13,8481058,Jesse Ylonen,R,,25,0,0,0,0
13,8475752,Tyler Pitlick,C,,33,0,0,0,0
13,8481239,Samuel Fagemo,L,,24,0,0,0,0
13,8480821,Filip Zadina,R,,25,0,0,0,0
13,8470966,Mark Giordano,D,,41,0,0,0,0
13,8478495,Denis Gurianov,R,,27,0,0,0,0
13,8477464,Nic Petan,C,,29,0,0,0,0
13,8478099,Kevin Labanc,R,,29,0,0,0,0
13,8482241,Radim Zohorna,L,,28,0,0,0,0
13,8474040,Sam Gagner,C,,35,0,0,0,0
13,8479514,Rem Pitlick,C,,27,0,0,0,0
13,8478430,Oliver Kylington,D,,27,0,0,0,0
13,8479533,Joona Koppanen,L,,26,0,0,0,0
13,8479984,Cal Foote,D,,26,0,0,0,0
13,8477126,Jayson Megna,C,,34,0,0,0,0
13,8475164,Jakob Silfverberg,R,,34,0,0,0,0
13,8474009,Nick Bonino,C,,36,0,0,0,0
13,8479458,Nikita Zaitsev,D,,33,0,0,0,0
13,8477944,Jakub Vrana,L,,28,0,0,0,0
13,8471699,Andrew Cogliano,C,,37,0,0,0,0
13,8478067,Oskar Lindblom,L,,28,0,0,0,0
13,8471686,Marc Staal,D,,37,0,0,0,0
13,8470610,Zach Parise,L,,40,0,0,0,0
13,8478904,Steven Lorentz,C,,28,0,0,0,0
13,8473473,Milan Lucic,L,,36,0,0,0,0
13,8480031,Maxime Comtois,L,,25,0,0,0,0
13,8478512,Austin Czarnik,C,,32,0,0,0,0
13,8473504,Cal Clutterbuck,R,,37,0,0,0,0
13,8477454,Adam Erne,L,,29,0,0,0,0
13,8479383,Boris Katchouk,L,,26,0,0,0,0
13,8475825,Jani Hakanpää,D,,32,0,0,0,0
13,8477846,Ryan Carpenter,C,,33,0,0,0,0
13,8477930,Pierre-Edouard Bellemare,L,,39,0,0,0,0
13,8478400,Colin White,C,,27,0,0,0,0
13,8480226,Marián Studenic,R,,26,0,0,0,0
13,8480853,Liam Foudy,C,,24,0,0,0,0
13,8475797,Jarred Tinordi,D,,32,0,0,0,0
13,8479423,Alex Nylander,L,,26,0,0,0,0
13,8474618,Marco Scandella,D,,34,0,0,0,0
13,8478028,Fredrik Olofsson,L,,28,0,0,0,0
13,8474709,Matt Martin,L,,35,0,0,0,0
13,8481070,Hugh McGing,L,,26,0,0,0,0
13,8479546,Oskar Steen,C,,26,0,0,0,0
13,8474145,Robert Bortuzzo,D,,35,0,0,0,0
13,8476915,Jujhar Khaira,L,,30,0,0,0,0
13,8480274,Philip Kemp,D,EDM,25,5,0,0,0
13,8475278,Byron Froese,C,,33,0,0,0,0
13,8481812,Nikolai Knyzhov,D,,27,0,0,0,0
13,8478408,Travis Dermott,D,,28,0,0,0,0
13,8481077,John Leonard,L,,26,0,0,0,0
13,8479547,Matthew Phillips,R,,26,0,0,0,0
13,8480836,Jonathan Gruden,C,,24,0,0,0,0
13,8481690,Tyler Angle,C,,24,0,0,0,0
13,8475766,Austin Watson,L,,32,0,0,0,0
13,8481016,Ruslan Iskhakov,C,,24,0,0,0,0
13,8478078,Rourke Chartier,C,,28,0,0,0,0
13,8480776,Sheldon Rempal,R,,29,0,0,0,0
13,8478956,Samuel Laberge,L,NJD,27,0,0,0,0
13,8483045,Cameron Butler,R,CBJ,31,1,0,0,0
13,8484314,Jiri Smejkal,L,,28,0,0,0,0
14,8477492,Nathan MacKinnon,C,COL,29,81,56,95,151
14,8478402,Connor McDavid,C,EDM,27,77,47,103,150
14,8477956,David Pastrnak,R,BOS,28,79,64,81,145
14,8476453,Nikita Kucherov,R,TBL,31,82,45,76,121
14,8479318,Auston Matthews,C,TOR,27,81,65,54,119
14,8478864,Kirill Kaprizov,L,MIN,27,74,49,66,115
14,8478420,Mikko Rantanen,R,COL,28,81,51,62,113
14,8477493,Aleksander Barkov,C,FLA,29,77,23,85,108
14,8477934,Leon Draisaitl,C,EDM,29,77,41,66,107
14,8478550,Artemi Panarin,L,NYR,33,75,29,77,106
14,8476468,J.T. Miller,C,VAN,31,73,39,66,105
14,8478483,Mitch Marner,R,TOR,27,77,34,71,105
14,8481559,Jack Hughes,C,NJD,23,71,38,65,103
14,8479314,Matthew Tkachuk,L,FLA,27,77,31,72,103
14,8475172,Nazem Kadri,C,CGY,34,80,39,61,100
14,8480027,Jason Robertson,L,DAL,25,82,35,61,96
14,8477946,Dylan Larkin,C,DET,28,79,43,52,95
14,8484144,Connor Bedard,C,CHI,19,75,30,65,95
14,8482116,Tim Stützle,C,OTT,22,79,43,51,94
14,8478440,Dylan Strome,C,WSH,27,76,31,63,94
14,8474564,Steven Stamkos,C,NSH,34,78,45,48,93
14,8478427,Sebastian Aho,C,CAR,27,77,42,51,93
14,8479407,Jesper Bratt,L,NJD,26,75,37,54,91
14,8477939,William Nylander,R,TOR,28,77,36,55,91
14,8477409,Carter Verhaeghe,C,FLA,29,75,49,41,90
14,8477501,Valeri Nichushkin,R,COL,29,80,41,49,90
14,8476887,Filip Forsberg,L,NSH,30,74,40,50,90
14,8476459,Mika Zibanejad,C,NYR,31,77,40,49,89
14,8478398,Kyle Connor,L,WPG,28,76,41,47,88
14,8471675,Sidney Crosby,C,PIT,37,74,37,51,88
14,8477940,Nikolaj Ehlers,L,WPG,28,72,37,50,87
14,8480069,Cale Makar,D,COL,26,71,23,63,86
14,8471214,Alex Ovechkin,L,WSH,39,76,48,37,85
14,8479420,Tage Thompson,C,BUF,27,73,47,37,84
14,8478010,Brayden Point,C,TBL,28,82,43,41,84
14,8477496,Elias Lindholm,C,BOS,30,79,33,51,84
14,8480839,Rasmus Dahlin,D,BUF,24,72,29,55,84
14,8475692,Mats Zuccarello,R,MIN,37,76,23,61,84
14,8475913,Mark Stone,R,VGK,32,75,22,62,84
14,8480800,Quinn Hughes,D,VAN,25,75,12,72,84
14,8477404,Jake Guentzel,C,TBL,30,81,36,47,83
14,8475166,John Tavares,C,TOR,34,78,37,45,82
14,8478439,Travis Konecny,R,PHI,27,74,33,49,82
14,8480830,Andrei Svechnikov,R,CAR,24,71,30,50,80
14,8480023,Robert Thomas,C,STL,25,78,20,60,80
14,8480801,Brady Tkachuk,L,OTT,25,82,34,45,79
14,8474600,Roman Josi,D,NSH,34,70,22,57,79
14,8478445,Mathew Barzal,C,NYI,27,79,18,61,79
14,8476389,Vincent Trocheck,C,NYR,31,81,33,45,78
14,8473419,Brad Marchand,L,BOS,36,77,32,46,78
14,8480036,Miro Heiskanen,D,DAL,25,74,17,61,78
14,8479343,Clayton Keller,R,UTA,26,78,38,39,77
14,8478873,Troy Terry,R,ANA,27,75,32,45,77
14,8474141,Patrick Kane,R,DET,36,81,29,48,77
14,8482078,Lucas Raymond,L,DET,22,77,29,48,77
14,8475167,Victor Hedman,D,TBL,34,80,16,61,77
14,8475184,Chris Kreider,L,NYR,33,76,43,32,75
14,8478444,Brock Boeser,R,VAN,27,74,42,33,75
14,8477960,Adrian Kempe,R,LAK,28,82,32,43,75
14,8480012,Elias Pettersson,C,VAN,26,73,31,44,75
14,8475168,Matt Duchene,C,DAL,33,82,30,45,75
14,8480865,Noah Dobson,D,NYI,24,80,11,64,75
14,8478403,Jack Eichel,C,VGK,28,77,33,41,74
14,8481557,Matt Boldy,L,MIN,23,68,34,39,73
14,8480208,Drake Batherson,R,OTT,26,80,19,54,73
14,8479323,Adam Fox,D,NYR,26,71,13,60,73
14,8475794,Tyler Seguin,C,DAL,32,82,37,35,72
14,8476399,Blake Coleman,C,CGY,33,78,36,36,72
14,8477942,Kevin Fiala,L,LAK,28,80,22,50,72
14,8475765,Vladimir Tarasenko,R,DET,33,80,28,43,71
14,8476875,Mike Matheson,D,MTL,30,74,11,60,71
14,8479337,Alex DeBrincat,R,DET,27,81,33,37,70
14,8477933,Sam Reinhart,C,FLA,29,79,34,35,69
14,8479385,Jordan Kyrou,C,STL,26,77,34,35,69
14,8478449,Roope Hintz,C,DAL,28,82,40,28,68
14,8476448,William Karlsson,C,VGK,31,76,29,39,68
14,8480002,Nico Hischier,C,NJD,25,69,25,43,68
14,8482740,Wyatt Johnston,C,DAL,21,82,31,36,67
14,8475810,Bryan Rust,R,PIT,32,70,31,36,67
14,8480803,Evan Bouchard,D,EDM,25,78,13,54,67
14,8475786,Zach Hyman,L,EDM,32,80,29,37,66
14,8473994,Jamie Benn,L,DAL,35,81,29,37,66
14,8476456,Jonathan Huberdeau,C,CGY,31,73,20,46,66
14,8473512,Claude Giroux,R,OTT,36,76,20,46,66
14,8476460,Mark Scheifele,C,WPG,31,71,28,37,65
14,8482665,Matty Beniers,C,SEA,22,73,23,42,65
14,8477504,Josh Morrissey,D,WPG,29,76,7,58,65
14,8476881,Tomas Hertl,C,VGK,31,77,31,32,63
14,8475754,Brock Nelson,C,NYI,33,80,30,33,63
14,8479675,Trevor Moore,L,LAK,29,80,29,34,63
14,8474578,Erik Karlsson,D,PIT,34,78,12,51,63
14,8475784,Jeff Skinner,C,EDM,32,76,29,33,62
14,8478519,Anthony Cirelli,C,TBL,27,82,29,33,62
14,8478493,Joel Eriksson Ek,C,MIN,27,69,26,36,62
14,8481596,Shane Pinto,C,OTT,24,74,26,36,62
14,8482745,Mason McTavish,C,ANA,21,75,23,39,62
14,8478460,Zach Werenski,D,CBJ,27,81,14,48,62
14,8476905,Chandler Stephenson,C,SEA,30,72,12,50,62
14,8476853,Morgan Rielly,D,TOR,30,75,12,50,62
14,8475726,Tyler Toffoli,C,SJS,32,66,35,26,61
14,8479542,Brandon Hagel,L,TBL,26,82,26,35,61
14,8482110,Dawson Mercer,C,NJD,23,74,25,36,61
14,8477494,Jonathan Drouin,L,COL,29,81,19,42,61
14,8480015,Owen Tippett,R,PHI,25,76,33,27,60
14,8477416,Oliver Bjorkstrand,R,SEA,29,74,22,38,60
14,8477451,Ryan Hartman,R,MIN,30,71,32,27,59
14,8479999,Casey Mittelstadt,C,COL,26,82,28,31,59
14,8474102,David Perron,L,OTT,36,76,27,32,59
14,8477949,Alex Tuch,R,BUF,28,75,26,33,59
14,8478975,Mason Marchment,L,DAL,29,80,25,34,59
14,8476880,Tom Wilson,R,WSH,30,67,23,36,59
14,8471685,Anze Kopitar,C,LAK,37,80,18,41,59
14,8481540,Cole Caufield,R,MTL,23,75,25,33,58
14,8480039,Martin Necas,C,CAR,25,69,24,34,58
14,8476454,Ryan Nugent-Hopkins,C,EDM,31,74,18,40,58
14,8474590,John Carlson,D,WSH,34,71,12,46,58
14,8470613,Brent Burns,D,CAR,39,77,12,46,58
14,8473986,Alex Killorn,L,ANA,35,73,30,27,57
14,8477402,Pavel Buchnevich,L,STL,29,74,27,30,57
14,8477935,Sam Bennett,C,FLA,28,79,25,32,57
14,8474679,Gustav Nyquist,C,NSH,35,72,22,35,57
14,8475191,Reilly Smith,R,NYR,33,72,17,40,57
14,8481542,Moritz Seider,D,DET,23,76,8,49,57
14,8483515,Juraj Slafkovsky,L,MTL,20,76,22,34,56
14,8480028,Morgan Frost,C,PHI,25,75,20,36,56
14,8475745,Charlie Coyle,C,BOS,32,76,19,37,56
14,8477503,Max Domi,C,TOR,29,78,16,40,56
14,8475158,Ryan O'Reilly,C,NSH,33,68,15,41,56
14,8481528,Dylan Cozens,C,BUF,23,70,14,42,56
14,8481533,Trevor Zegras,C,ANA,23,72,11,45,56
14,8480014,Gabriel Vilardi,C,WPG,25,63,33,22,55
14,8476539,Jonathan Marchessault,R,NSH,34,72,30,25,55
14,8477500,Bo Horvat,C,NYI,29,80,27,28,55
14,8483431,Logan Cooley,C,UTA,20,78,24,31,55
14,8480018,Nick Suzuki,C,MTL,25,74,21,34,55
14,8478366,Frank Vatrano,R,ANA,30,75,34,20,54
14,8483808,Andrei Kuzmenko,L,CGY,28,75,29,25,54
14,8478414,Timo Meier,R,NJD,28,75,23,31,54
14,8478401,Pavel Zacha,C,BOS,27,77,22,32,54
14,8474150,Mikael Backlund,C,CGY,35,77,19,35,54
14,8476346,Johnny Gaudreau,L,CBJ,31,72,13,41,54
14,8479425,Filip Hronek,D,VAN,27,73,12,42,54
14,8478856,Conor Garland,R,VAN,28,76,21,32,53
14,8478047,Michael Bunting,L,PIT,29,73,18,35,53
14,8479325,Charlie McAvoy,D,BOS,27,76,12,41,53
14,8480185,Eetu Luostarinen,C,FLA,26,76,29,23,52
14,8482175,JJ Peterka,R,BUF,22,72,27,25,52
14,8474641,Adam Henrique,C,EDM,34,74,25,27,52
14,8476479,Phillip Danault,C,LAK,31,82,20,32,52
14,8476432,Boone Jenner,C,CBJ,31,74,29,22,51
14,8477456,J.T. Compher,L,DET,29,77,24,27,51
14,8481068,Yegor Sharangovich,C,CGY,26,80,24,27,51
14,8476792,Torey Krug,D,STL,33,68,19,32,51
14,8482699,Dylan Guenther,R,UTA,21,75,18,33,51
14,8474565,Alex Pietrangelo,D,VGK,34,61,15,36,51
14,8477447,Shea Theodore,D,VGK,29,62,14,37,51
14,8480798,Philipp Kurashev,C,CHI,25,68,13,38,51
14,8474563,Drew Doughty,D,LAK,35,74,10,41,51
14,8477955,Jared McCann,L,SEA,28,73,26,24,50
14,8478498,Jake DeBrusk,L,VAN,28,70,26,24,50
14,8477476,Artturi Lehkonen,L,COL,29,81,24,26,50
14,8477407,Anthony Duclair,L,NYI,29,74,21,29,50
14,8477951,Nick Schmaltz,C,UTA,28,76,20,30,50
14,8482113,Anton Lundell,C,FLA,23,77,20,30,50
14,8477346,MacKenzie Weegar,D,CGY,30,74,9,41,50
14,8478115,Pierre Engvall,L,NYI,28,77,28,21,49
14,8480064,Josh Norris,C,OTT,25,75,25,24,49
14,8479992,Michael Rasmussen,C,DET,25,78,21,28,49
14,8479400,Pierre-Luc Dubois,L,WSH,26,70,19,30,49
14,8484153,Leo Carlsson,C,ANA,20,74,18,31,49
14,8478438,Tommy Novak,C,NSH,27,68,17,32,49
14,8478469,Thomas Chabot,D,OTT,27,71,9,40,49
14,8481618,Alex Newhook,C,MTL,23,75,21,27,48
14,8482159,Tyson Foerster,R,PHI,22,72,19,29,48
14,8482124,Quinton Byfield,R,LAK,22,80,19,29,48
14,8482093,Seth Jarvis,C,CAR,22,67,17,31,48
14,8484145,Zach Benson,L,BUF,19,69,16,32,48
14,8478407,Vince Dunn,D,SEA,28,73,10,38,48
14,8482109,Alexis Lafrenière,L,NYR,23,75,23,24,47
14,8475151,Kyle Palmieri,C,NYI,33,78,21,26,47
14,8482097,Jack Quinn,R,BUF,23,67,15,32,47
14,8476872,Scott Laughton,C,PHI,30,75,15,32,47
14,8471724,Kris Letang,D,PIT,37,77,13,34,47
14,8475798,Mikael Granlund,C,SJS,32,70,11,36,47
14,8482684,Luke Hughes,D,NJD,21,66,5,42,47
14,8478057,Dakota Joshua,C,VAN,28,70,21,25,46
14,8477932,Aaron Ekblad,D,FLA,28,69,12,34,46
14,8477444,Andre Burakovsky,L,SEA,29,69,26,19,45
14,8477998,Warren Foegele,L,LAK,28,81,22,23,45
14,8475799,Nino Niederreiter,R,WPG,32,69,22,23,45
14,8478042,Viktor Arvidsson,L,EDM,31,72,19,26,45
14,8476882,Teuvo Teravainen,C,CHI,30,66,18,27,45
14,8475170,Brayden Schenn,C,STL,33,72,16,29,45
14,8482702,Logan Stankoven,C,DAL,21,80,15,30,45
14,8481711,Matias Maccelli,L,UTA,24,75,13,32,45
14,8476906,Shayne Gostisbehere,D,CAR,31,75,10,35,45
14,8480797,Joel Farabee,L,PHI,24,72,24,20,44
14,8477952,Robby Fabbri,C,ANA,28,69,22,22,44
14,8479525,Ross Colton,C,COL,28,82,19,25,44
14,8478233,Andrew Mangiapane,L,WSH,28,68,16,28,44
14,8480188,Fabian Zetterlund,L,SJS,25,70,16,28,44
14,8482122,Brock Faber,D,MIN,22,78,5,39,44
14,8477479,Tyler Bertuzzi,L,CHI,29,67,27,16,43
14,8475218,Mattias Ekholm,D,EDM,34,76,17,26,43
14,8476292,Ondrej Palat,L,NJD,33,73,16,27,43
14,8480113,Alex Iafallo,L,WPG,31,70,15,28,43
14,8475287,Erik Haula,L,NJD,33,71,22,20,42
14,8483445,Cutter Gauthier,L,ANA,20,67,18,24,42
14,8484166,Adam Fantilli,C,CBJ,20,70,17,25,42
14,8478463,Anthony Beauvillier,L,PIT,27,69,17,25,42
14,8478542,Evan Rodrigues,C,FLA,31,80,16,26,42
14,8478462,Nicolas Roy,C,VGK,27,74,16,26,42
14,8474053,Logan Couture,C,SJS,35,65,15,27,42
14,8479987,Morgan Geekie,C,BOS,26,80,14,28,42
14,8480145,Neal Pionk,D,WPG,29,72,11,31,42
14,8477986,Brandon Montour,D,SEA,30,71,6,36,42
14,8475169,Evander Kane,L,EDM,33,76,25,16,41
14,8480802,Ryan McLeod,C,BUF,25,62,24,17,41
14,8482055,Drew O'Connor,L,PIT,26,71,21,20,41
14,8480829,Jesperi Kotkaniemi,C,CAR,24,65,19,22,41
14,8482149,Cole Perfetti,C,WPG,22,72,18,23,41
14,8475753,Justin Faulk,D,STL,32,72,12,29,41
14,8480893,Kirill Marchenko,R,CBJ,24,58,28,12,40
14,8481624,Ilya Mikheyev,R,CHI,30,60,21,19,40
14,8478109,Victor Olofsson,L,VGK,29,74,20,20,40
14,8480009,Eeli Tolvanen,R,SEA,25,72,18,22,40
14,8479345,Jakob Chychrun,D,WSH,26,65,16,24,40
14,8477497,Sean Monahan,C,CBJ,30,63,14,26,40
14,8482092,Ridly Greig,C,OTT,22,74,14,26,40
14,8475848,Brendan Gallagher,R,MTL,32,70,13,27,40
14,8477964,Ivan Barbashev,C,VGK,29,78,12,28,40
14,8478396,Noah Hanifin,D,VGK,27,68,11,29,40
14,8477495,Seth Jones,D,CHI,30,67,11,29,40
14,8483505,Matthew Poitras,C,BOS,20,72,11,29,40
14,8476458,Ryan Strome,C,ANA,31,69,10,30,40
14,8477948,Travis Sanheim,D,PHI,28,61,7,33,40
14,8481560,Arthur Kaliyev,R,LAK,23,79,22,17,39
14,8471215,Evgeni Malkin,C,PIT,38,70,21,18,39
14,8478474,Lawson Crouse,L,UTA,27,78,16,23,39
14,8474586,Jordan Eberle,R,SEA,34,74,15,24,39
14,8477021,Alex Kerfoot,C,UTA,30,72,14,25,39
14,8476869,Brady Skjei,D,NSH,30,78,12,27,39
14,8479591,Michael Eyssimont,C,TBL,28,81,12,27,39
14,8481581,Thomas Harley,D,DAL,23,72,6,33,39
14,8480873,Rasmus Sandin,D,WSH,24,69,5,34,39
14,8476483,Rickard Rakell,R,PIT,31,67,23,15,38
14,8477511,Anthony Mantha,R,CGY,30,78,19,19,38
14,8475793,Ryan Johansen,C,PHI,32,74,16,22,38
14,8482667,William Eklund,L,SJS,22,67,13,25,38
14,8481577,Philip Tomasino,C,NSH,23,71,10,28,38
14,8474716,Jared Spurgeon,D,MIN,35,78,9,29,38
14,8478055,Gustav Forsling,D,FLA,28,73,8,30,38
14,8476958,Jaccob Slavin,D,CAR,30,77,10,27,37
14,8479410,Mikhail Sergachev,D,UTA,26,75,9,28,37
14,8482671,Owen Power,D,BUF,22,66,8,29,37
14,8482105,Jake Sanderson,D,OTT,22,75,7,30,37
14,8476462,Dougie Hamilton,D,NJD,31,71,6,31,37
14,8478397,Rasmus Andersson,D,CGY,28,75,4,33,37
14,8481604,Pavel Dorofeyev,L,VGK,24,72,22,14,36
14,8478046,Danton Heinen,L,VAN,29,63,21,15,36
14,8474149,Evgenii Dadonov,R,DAL,35,78,19,17,36
14,8475314,Anders Lee,L,NYI,34,77,17,19,36
14,8475193,Tomas Tatar,L,NJD,34,71,17,19,36
14,8470621,Corey Perry,R,EDM,39,73,17,19,36
14,8481523,Kirby Dach,C,MTL,23,66,16,20,36
14,8476826,Yanni Gourde,C,SEA,33,71,14,22,36
14,8476463,Jonas Brodin,D,MIN,31,82,6,30,36
14,8477426,Nicholas Paul,L,TBL,29,81,17,18,35
14,8476419,Jean-Gabriel Pageau,C,NYI,32,79,15,20,35
14,8482660,Kent Johnson,C,CBJ,22,63,12,23,35
14,8477450,Jason Dickinson,C,CHI,29,65,12,23,35
14,8476461,Sean Couturier,C,PHI,32,68,11,24,35
14,8482133,Thomas Bordeleau,C,SJS,22,65,9,26,35
14,8482712,Oskar Olausson,R,COL,22,77,7,28,35
14,8481703,Valtteri Puustinen,R,PIT,25,59,5,30,35
14,8483490,Pavel Mintyukov,D,ANA,21,73,4,31,35
14,8478500,Ivan Provorov,D,CBJ,27,81,2,33,35
14,8475768,Jaden Schwartz,C,SEA,32,72,20,14,34
14,8476438,Brandon Saad,L,STL,32,63,18,16,34
14,8482146,Luke Evangelista,R,NSH,22,67,17,17,34
14,8481524,Bowen Byram,D,BUF,23,60,15,19,34
14,8475149,Marcus Johansson,L,MIN,34,68,13,21,34
14,8477989,Christian Dvorak,C,MTL,28,69,12,22,34
14,8476927,Teddy Blueger,C,VAN,30,67,10,24,34
14,8476854,Hampus Lindholm,D,BOS,30,73,9,25,34
14,8482720,Matthew Knies,L,TOR,22,80,9,25,34
14,8477969,Marcus Pettersson,D,PIT,28,79,9,25,34
14,8475760,Nick Bjugstad,C,UTA,32,68,19,14,33
14,8484203,Bradly Nadeau,L,CAR,19,65,18,15,33
14,8471698,T.J. Oshie,R,WSH,38,71,16,17,33
14,8480849,Barrett Hayton,C,UTA,24,73,14,19,33
14,8477429,Andrew Copp,C,DET,30,81,9,24,33
14,8480073,Erik Brannstrom,D,COL,25,67,6,27,33
14,8476979,Erik Gustafsson,D,DET,32,72,4,29,33
14,8479316,Luke Kunin,C,SJS,27,57,20,12,32
14,8478020,Michael Amadio,R,OTT,28,79,19,13,32
14,8482089,Jake Neighbours,L,STL,22,67,18,14,32
14,8480813,Joe Veleno,C,DET,24,74,16,16,32
14,8476480,Vladislav Namestnikov,C,WPG,32,64,15,17,32
14,8482809,Jackson Blake,R,CAR,21,60,12,20,32
14,8477498,Darnell Nurse,D,EDM,29,73,11,21,32
14,8477947,Sonny Milano,L,WSH,28,60,11,21,32
14,8478911,Matt Roy,D,WSH,29,60,9,23,32
14,8475324,Nick Jensen,D,OTT,34,68,9,23,32
14,8481546,Cam York,D,PHI,23,71,7,25,32
14,8476923,Damon Severson,D,CBJ,30,79,5,27,32
14,8480817,K'Andre Miller,D,NYR,24,70,5,27,32
14,8482655,Janis Moser,D,TBL,24,78,2,30,32
14,8479365,Trent Frederic,C,BOS,26,72,16,15,31
14,8475220,Marcus Foligno,L,MIN,33,64,16,15,31
14,8473533,Jordan Staal,C,CAR,36,59,14,17,31
14,8480835,Jack Drury,C,CAR,24,52,11,20,31
14,8480434,Sean Durzi,D,UTA,26,70,9,22,31
14,8482067,Connor Mackey,D,NYR,28,67,8,23,31
14,8474151,Ryan McDonagh,D,TBL,35,79,5,26,31
14,8476879,Cody Ceci,D,EDM,31,69,5,26,31
14,8475714,Calle Jarnkrok,C,TOR,33,74,18,12,30
14,8481535,Nils Hoglander,L,VAN,24,59,18,12,30
14,8476392,Adam Lowry,C,WPG,31,70,15,15,30
14,8480459,Pius Suter,C,VAN,28,68,14,16,30
14,8477505,Alexander Wennberg,C,SJS,30,70,13,17,30
14,8483482,Tristan Luneau,D,ANA,20,72,13,17,30
14,8480220,Noah Cates,L,PHI,25,68,12,18,30
14,8478466,Daniel Sprong,R,VAN,27,70,11,19,30
14,8473422,Nick Foligno,L,CHI,37,61,11,19,30
14,8476960,Andreas Athanasiou,C,CHI,30,49,10,20,30
14,8476921,Jordan Martinook,L,CAR,32,64,9,21,30
14,8477406,Mattias Janmark,C,EDM,32,70,9,21,30
14,8478038,Devon Toews,D,COL,30,65,7,23,30
14,8477488,Brett Pesce,D,NJD,30,70,6,24,30
14,8480043,Timothy Liljegren,D,TOR,25,68,4,26,30
14,8480891,Michael Kesselring,D,UTA,24,59,4,26,30
14,8482259,Bobby McMann,C,TOR,28,64,20,9,29
14,8474715,Cameron Atkinson,R,TBL,35,78,19,10,29
14,8481554,Kaapo Kakko,R,NYR,23,69,19,10,29
14,8476981,Josh Anderson,R,MTL,30,71,17,12,29
14,8475791,Taylor Hall,L,CHI,33,64,15,14,29
14,8481186,Logan O'Connor,R,COL,28,77,15,14,29
14,8475763,Kevin Hayes,R,PIT,32,63,14,15,29
14,8479353,Brett Howden,C,VGK,26,69,11,18,29
14,8478458,John (Jack) Roslovic,C,CAR,27,64,8,21,29
14,8476312,Josh Manson,D,COL,33,65,5,24,29
14,8475764,Cam Fowler,D,ANA,33,76,4,25,29
14,8480078,Filip Chytil,C,NYR,25,71,16,12,28
14,8480855,Jack McBain,C,UTA,24,68,16,12,28
14,8477987,Ryan Donato,C,CHI,28,60,15,13,28
14,8475343,Nic Dowd,C,WSH,34,60,13,15,28
14,8479339,Patrik Laine,L,CBJ,26,60,12,16,28
14,8478413,Jordan Greenway,L,BUF,27,65,11,17,28
14,8477953,Kasperi Kapanen,R,STL,28,68,10,18,28
14,8476885,Jacob Trouba,D,NYR,30,71,5,23,28
14,8474574,Tyler Myers,D,VAN,34,72,5,23,28
14,8479941,Justin Danforth,R,CBJ,31,61,14,13,27
14,8477839,Conor Sheary,L,TBL,32,80,14,13,27
14,8474189,Lars Eller,C,PIT,35,72,12,15,27
14,8482679,Matt Coronato,R,CGY,22,63,12,15,27
14,8481093,Rafael Harvey-Pinard,L,MTL,25,59,12,15,27
14,8476278,Colin Blackwell,C,DAL,31,76,10,17,27
14,8479351,Sam Steel,C,DAL,26,78,9,18,27
14,8479315,Joey Anderson,R,CHI,26,51,9,18,27
14,8478472,Mathieu Joseph,R,STL,27,73,7,20,27
14,8475200,Dmitry Orlov,D,CAR,33,72,7,20,27
14,8478178,Darren Raddysh,D,TBL,28,69,6,21,27
14,8477478,William Carrier,L,CAR,30,57,19,7,26
14,8482705,Cole Sillinger,C,CBJ,21,63,13,13,26
14,8476918,Jimmy Vesey,L,NYR,31,69,12,14,26
14,8480068,Ryan Poehling,C,PHI,25,71,12,14,26
14,8483524,Shane Wright,C,SEA,20,65,12,14,26
14,8473563,Nicklas Backstrom,C,WSH,37,59,12,14,26
14,8480871,Adam Boqvist,D,FLA,24,69,10,16,26
14,8478133,Jake Evans,C,MTL,28,61,9,17,26
14,8481580,Connor McMichael,C,WSH,23,60,9,17,26
14,8480336,Sean Walker,D,CAR,30,68,8,18,26
14,8477506,Ryan Pulock,D,NYI,30,77,7,19,26
14,8473507,Jeff Petry,D,DET,37,71,6,20,26
14,8479976,Juuso Valimaki,D,UTA,26,60,4,22,26
14,8479639,Dylan Coghlan,D,WPG,26,65,1,25,26
14,8481582,Nicholas Robertson,L,TOR,23,69,12,13,25
14,8476329,Travis Boyd,C,MIN,31,54,11,14,25
14,8477220,Nate Schmidt,D,FLA,33,64,9,16,25
14,8480806,Isac Lundestrom,C,ANA,25,59,6,19,25
14,8476331,Dylan DeMelo,D,WPG,31,67,5,20,25
14,8479998,Mikey Anderson,D,LAK,25,65,5,20,25
14,8482142,Jamie Drysdale,D,PHI,22,66,4,21,25
14,8480995,Pontus Holmberg,R,TOR,25,59,15,9,24
14,8479368,Max Jones,L,BOS,26,60,15,9,24
14,8475722,Jason Zucker,L,BUF,32,66,14,10,24
14,8475231,Casey Cizikas,C,NYI,33,74,14,10,24
14,8481477,Nico Sturm,C,SJS,29,59,13,11,24
14,8479393,Noah Gregor,L,OTT,26,75,12,12,24
14,8482125,Alexander Holtz,R,VGK,22,67,12,12,24
14,8480205,Emil Bemstrom,C,PIT,25,53,11,13,24
14,8480448,Parker Kelly,L,COL,25,80,9,15,24
14,8481522,Peyton Krebs,C,BUF,23,62,9,15,24
14,8475171,Oliver Ekman-Larsson,D,TOR,33,70,8,16,24
14,8476902,Esa Lindell,D,DAL,30,72,7,17,24
14,8478891,Mason Appleton,C,WPG,28,70,7,17,24
14,8478840,Will Borgen,D,SEA,28,60,6,18,24
14,8477845,Trevor van Riemsdyk,D,WSH,33,62,1,23,24
14,8482111,Justin Barron,D,MTL,23,66,11,12,23
14,8480789,Oliver Wahlstrom,R,NYI,24,78,10,13,23
14,8481656,Aliaksei Protas,C,WSH,23,63,9,14,23
14,8476422,Mike Reilly,D,NYI,31,71,8,15,23
14,8477979,Nicolas Aube-Kubel,R,BUF,28,62,7,16,23
14,8483565,Nick Blankenburg,D,NSH,26,56,7,16,23
14,8481606,Jordan Spence,D,LAK,23,60,6,17,23
14,8476467,Jamie Oleksiak,D,SEA,32,73,4,19,23
14,8480222,Sebastian Aho,D,PIT,28,72,2,21,23
14,8477903,Garnet Hathaway,R,PHI,33,62,14,8,22
14,8482749,Joshua Roy,R,MTL,21,68,13,9,22
14,8481032,Paul Cotter,C,NJD,25,62,13,9,22
14,8477425,Miles Wood,L,COL,29,76,12,10,22
14,8477919,Frederick Gaudreau,C,MIN,31,63,10,12,22
14,8483468,Jiri Kulich,C,BUF,20,55,8,14,22
14,8475855,Jesper Fast,R,CAR,33,64,6,16,22
14,8478013,Jake Walman,D,SJS,28,69,6,16,22
14,8481059,Scott Perunovich,D,STL,26,60,5,17,22
14,8481178,Egor Zamula,D,PHI,24,58,5,17,22
14,8482245,Artem Zub,D,OTT,29,66,4,18,22
14,8476457,Adam Larsson,D,SEA,32,64,4,18,22
14,8476917,Adam Pelech,D,NYI,30,80,3,19,22
14,8478507,John Marino,D,UTA,27,65,3,19,22
14,8476474,Stefan Noesen,R,NJD,31,61,12,9,21
14,8478434,Keegan Kolesar,R,VGK,27,66,12,9,21
14,8481481,Blake Lizotte,C,PIT,27,52,11,10,21
14,8476469,Joel Armia,R,MTL,31,59,11,10,21
14,8480289,Morgan Barron,C,WPG,26,48,11,10,21
14,8480748,Kiefer Sherwood,L,VAN,29,61,8,13,21
14,8482624,Daniil Miromanov,D,CGY,27,68,8,13,21
14,8478432,Christian Fischer,R,DET,27,74,8,13,21
14,8480144,David Kampf,C,TOR,29,70,7,14,21
14,8478851,Alexandre Carrier,D,NSH,28,66,6,15,21
14,8480980,Connor Dewar,C,TOR,25,63,5,16,21
14,8481553,Bobby Brink,R,PHI,23,60,3,18,21
14,8480727,Zach Whitecloud,D,VGK,28,56,3,18,21
14,8480035,Henri Jokiharju,D,BUF,25,62,1,20,21
14,8476931,Jake McCabe,D,TOR,31,66,1,20,21
14,8473453,Trevor Lewis,C,LAK,37,67,11,9,20
14,8479661,Tanner Jeannot,L,LAK,27,74,10,10,20
14,8476374,Sean Kuraly,C,CBJ,31,60,8,12,20
14,8479996,Cody Glass,C,NSH,25,53,7,13,20
14,8476873,Mark Jankowski,C,NSH,30,55,7,13,20
14,8478136,Jake Middleton,D,MIN,28,71,6,14,20
14,8482073,Braden Schneider,D,NYR,23,61,5,15,20
14,8479980,Nicolas Hague,D,VGK,26,64,4,16,20
14,8478043,Sam Lafferty,C,BUF,29,54,4,16,20
14,8476891,Matthew Grzelcyk,D,PIT,30,74,3,17,20
14,8480878,Nils Lundkvist,D,DAL,24,64,3,17,20
14,8479066,Ryan Lomberg,L,CGY,30,60,11,8,19
14,8480074,Alexandre Texier,C,STL,25,65,11,8,19
14,8479293,Brandon Tanev,L,SEA,33,56,10,9,19
14,8476925,Colton Sissons,C,NSH,31,60,9,10,19
14,8479390,Taylor Raddysh,R,WSH,26,56,9,10,19
14,8482475,Yegor Chinakhov,R,CBJ,23,58,7,12,19
14,8481521,Ronnie Attard,D,PHI,25,59,5,14,19
14,8476892,Colton Parayko,D,STL,31,67,4,15,19
14,8475455,Brenden Dillon,D,NJD,34,65,4,15,19
14,8479983,Mario Ferraro,D,SJS,26,74,3,16,19
14,8477435,Ryan Graves,D,PIT,29,76,3,16,19
14,8479324,Ryan Lindgren,D,NYR,26,65,3,16,19
14,8480860,Kevin Bahl,D,CGY,24,59,3,16,19
14,8478882,Vladislav Gavrikov,D,LAK,29,73,2,17,19
14,8479371,Dante Fabbro,D,NSH,26,62,1,18,19
14,8479619,Michael Carcone,L,UTA,28,68,11,7,18
14,8482155,Alex Laferriere,R,LAK,23,70,10,8,18
14,8477446,Michael McCarron,R,NSH,29,59,10,8,18
14,8480003,Jesper Boqvist,C,FLA,26,67,9,9,18
14,8477015,Connor Brown,R,EDM,30,63,9,9,18
14,8476889,Radek Faksa,C,STL,30,64,7,11,18
14,8481537,Nikita Okhotiuk,D,CGY,24,49,7,11,18
14,8483499,Liam Ohgren,L,MIN,20,49,6,12,18
14,8483493,Frank Nazar,C,CHI,20,51,6,12,18
14,8482148,Hendrix Lapierre,C,WSH,22,54,6,12,18
14,8482117,Lukas Reichel,L,CHI,22,48,4,14,18
14,8476994,Vinnie Hinostroza,C,NSH,30,45,4,14,18
14,8475233,David Savard,D,MTL,34,65,3,15,18
14,8475462,Radko Gudas,D,ANA,34,65,2,16,18
14,8482176,Wyatt Kaiser,D,CHI,22,55,2,16,18
14,8479026,Philippe Myers,D,TOR,27,51,1,17,18
14,8478508,Yakov Trenin,C,MIN,27,61,10,7,17
14,8480762,Eric Robinson,L,CAR,29,60,10,7,17
14,8482074,Connor Zary,C,CGY,23,62,8,9,17
14,8477931,Tomas Nosek,L,FLA,32,55,8,9,17
14,8479344,Jesse Puljujarvi,R,PIT,26,59,8,9,17
14,8481601,Simon Holmstrom,R,NYI,23,59,8,9,17
14,8477508,Curtis Lazar,C,NJD,29,65,7,10,17
14,8482803,Olen Zellweger,D,ANA,21,62,7,10,17
14,8482157,Will Cuylle,L,NYR,22,54,7,10,17
14,8476624,Barclay Goodrow,C,SJS,31,50,7,10,17
14,8481019,David Gustafsson,C,WPG,24,51,6,11,17
14,8481014,Alexander Romanov,D,NYI,24,78,5,12,17
14,8478970,Jalen Chatfield,D,CAR,28,65,5,12,17
14,8482101,Danil Gushchin,L,SJS,22,60,4,13,17
14,8475179,Dmitry Kulikov,D,FLA,34,66,4,13,17
14,8482087,Kaiden Guhle,D,MTL,22,64,3,14,17
14,8476967,Brett Kulak,D,EDM,30,64,3,14,17
14,8470600,Ryan Suter,D,STL,39,64,0,17,17
14,8482079,Marco Rossi,C,MIN,23,56,10,6,16
14,8475842,Sam Carrick,C,NYR,32,64,9,7,16
14,8482744,James Malatesta,L,CBJ,21,49,8,8,16
14,8482062,Cole Smith,L,NSH,29,61,7,9,16
14,8481617,Vasily Podkolzin,R,VAN,23,57,6,10,16
14,8483457,Lane Hutson,D,MTL,20,68,6,10,16
14,8476897,Oskar Sundqvist,C,STL,30,58,5,11,16
14,8477507,Nikita Zadorov,D,BOS,29,60,5,11,16
14,8479402,Jake Bean,D,CGY,26,64,5,11,16
14,8476442,Matt Nieto,L,PIT,32,50,5,11,16
14,8480807,Mattias Samuelsson,D,BUF,24,62,4,12,16
14,8475181,Nick Leddy,D,STL,33,60,3,13,16
14,8476988,Matt Benning,D,SJS,30,63,3,13,16
14,8478211,Dryden Hunt,L,CGY,29,58,3,13,16
14,8476525,Colin Miller,D,WPG,32,61,2,14,16
14,8480049,Dylan Samberg,D,WPG,25,66,2,14,16
14,8480001,Urho Vaakanainen,D,ANA,25,52,2,14,16
14,8476856,Mathew Dumba,D,DAL,30,72,2,14,16
14,8479398,Samuel Girard,D,COL,26,64,1,15,16
14,8474013,Ian Cole,D,UTA,35,54,1,15,16
14,8478450,Parker Wotherspoon,D,BOS,27,38,1,15,16
14,8479520,Brandon Duhaime,R,WSH,27,52,10,5,15
14,8481028,Martin Pospisil,C,CGY,25,54,8,7,15
14,8476878,Zemgus Girgensons,C,TBL,30,79,7,8,15
14,8476934,Brock McGinn,L,ANA,30,54,7,8,15
14,8480848,Ty Dellandrea,C,SJS,24,42,7,8,15
14,8482652,Walker Duehr,R,CGY,27,38,7,8,15
14,8479982,Conor Timmins,D,TOR,26,55,6,9,15
14,8482762,Simon Edvinsson,D,DET,21,60,6,9,15
14,8483491,Ivan Miroshnichenko,L,WSH,20,53,5,10,15
14,8481641,Joel Kiviranta,L,COL,28,65,5,10,15
14,8482192,Isaak Phillips,D,CHI,23,56,5,10,15
14,8476867,Brendan Gaunce,C,MIN,30,47,5,10,15
14,8480070,Ian Mitchell,D,BOS,25,51,4,11,15
14,8482634,Alex Steeves,C,TOR,25,51,4,11,15
14,8479543,Michael Pezzetta,L,MTL,26,61,3,12,15
14,8480950,Ilya Lyubushkin,D,DAL,30,66,3,12,15
14,8477499,Rasmus Ristolainen,D,PHI,30,55,2,13,15
14,8475718,Justin Holl,D,DET,32,66,2,13,15
14,8477365,Connor Clifton,D,BUF,29,57,1,14,15
14,8478421,A.J. Greer,L,FLA,28,57,8,6,14
14,8480021,Jack Studnicka,C,LAK,25,60,8,6,14
14,8479336,Carl Grundstrom,R,SJS,27,49,8,6,14
14,8480281,Alexey Toropchenko,R,STL,25,66,7,7,14
14,8480011,Klim Kostin,C,SJS,25,46,7,7,14
14,8474034,Patrick Maroon,L,CHI,36,48,6,8,14
14,8477392,Hudson Fasching,R,NYI,29,61,6,8,14
14,8481704,Juuso Parssinen,C,NSH,23,56,5,9,14
14,8478569,Noel Acciari,C,PIT,33,55,5,9,14
14,8481441,Joe Snively,C,DET,28,67,5,9,14
14,8479442,Troy Stecher,D,EDM,30,53,4,10,14
14,8482451,Mikael Pyyhtia,L,CBJ,23,45,4,10,14
14,8475790,Erik Gudbranson,D,CBJ,32,72,3,11,14
14,8480355,Mark Kastelic,C,BOS,25,66,3,11,14
14,8476429,Scott Mayfield,D,NYI,32,71,3,11,14
14,8475208,Brian Dumoulin,D,ANA,33,56,2,12,14
14,8481701,Santeri Hatakka,D,NJD,23,41,2,12,14
14,8471709,Marc-Edouard Vlasic,D,SJS,37,64,2,12,14
14,8478451,Ethan Bear,D,WSH,27,47,1,13,14
14,8475750,Jon Merrill,D,MIN,32,60,1,13,14
14,8482659,Josh Doan,R,UTA,22,44,9,4,13
14,8477353,Tyler Motte,C,DET,29,69,8,5,13
14,8479439,Jacob MacDonald,D,COL,31,45,8,5,13
14,8482859,Zack Ostapchuk,C,OTT,21,59,7,6,13
14,8481517,Brett Leason,R,ANA,25,54,7,6,13
14,8479981,Jonah Gadjovich,L,FLA,26,48,7,6,13
14,8474673,TJ Brodie,D,CHI,34,64,5,8,13
14,8484149,Gavin Brindley,C,CBJ,20,51,4,9,13
14,8479370,Tyson Jost,C,CAR,26,50,4,9,13
14,8480845,Rasmus Kupari,C,WPG,24,39,4,9,13
14,8480796,Martin Fehervary,D,WSH,25,50,3,10,13
14,8480058,Pierre-Olivier Joseph,D,STL,25,55,3,10,13
14,8482730,Brandt Clarke,D,LAK,21,52,2,11,13
14,8481599,Victor Soderstrom,D,UTA,23,51,2,11,13
14,8475177,Calvin de Haan,D,COL,33,44,2,11,13
14,8480172,Jan Rutta,D,SJS,34,60,1,12,13
14,8476874,Olli Maatta,D,DET,30,50,1,12,13
14,8478452,Caleb Jones,D,LAK,27,51,0,13,13
14,8483397,Marc McLaughlin,C,BOS,25,35,9,3,12
14,8479671,Mathieu Olivier,R,CBJ,27,47,8,4,12
14,8478585,Derek Ryan,C,EDM,38,65,5,7,12
14,8474568,Luke Schenn,D,NSH,35,49,4,8,12
14,8482166,Shakir Mukhamadullin,D,SJS,22,62,4,8,12
14,8471817,Ryan Reaves,R,TOR,37,52,4,8,12
14,8479328,Julien Gauthier,R,NYI,27,60,3,9,12
14,8481161,Jake Christiansen,D,CBJ,25,64,3,9,12
14,8481550,Adam Beckman,L,NJD,23,44,3,9,12
14,8478454,Noah Juulsen,D,VAN,27,39,3,9,12
14,8475762,Derek Forbort,D,VAN,32,46,3,9,12
14,8482095,Tyler Kleven,D,OTT,22,50,3,9,12
14,8475279,Ben Chiarot,D,DET,33,63,2,10,12
14,8479718,Alex Barré-Boulet,C,MTL,27,53,2,10,12
14,8477034,Jaycob Megna,D,FLA,32,41,1,11,12
14,8478416,Erik Cernak,D,TBL,27,73,1,11,12
14,8475690,Chris Tanev,D,TOR,35,56,1,11,12
14,8479378,Logan Stanley,D,WPG,26,45,1,11,12
14,8479972,Mason Shaw,C,WPG,26,41,1,11,12
14,8480879,Jacob Bernard-Docker,D,OTT,24,44,1,11,12
14,8475188,Brayden McNabb,D,VGK,33,52,0,12,12
14,8481716,Dmitri Voronkov,L,CBJ,24,47,8,3,11
14,8479414,Nathan Bastian,R,NJD,27,49,7,4,11
14,8481013,Jonatan Berggren,R,DET,24,66,6,5,11
14,8477962,Brendan Lemieux,L,CAR,28,40,6,5,11
14,8483630,Pavol Regenda,L,ANA,25,34,5,6,11
14,8475235,Nicolas Deslauriers,L,PHI,33,50,5,6,11
14,8482737,Zack Bolduc,C,STL,21,54,4,7,11
14,8479369,Andrew Peeke,D,BOS,26,53,4,7,11
14,8475225,Craig Smith,C,CHI,35,49,3,8,11
14,8480887,Jordan Harris,D,MTL,24,49,3,8,11
14,8481532,Alex Turcotte,C,LAK,23,31,3,8,11
14,8478443,Brandon Carlo,D,BOS,28,63,2,9,11
14,8481789,Tye Kartye,L,SEA,23,47,8,2,10
14,8482807,Ethan Del Mastro,D,CHI,21,51,6,4,10
14,8480252,Cole Guttman,C,CHI,25,33,6,4,10
14,8476822,Luke Glendening,C,TBL,35,79,6,4,10
14,8479379,Givani Smith,R,SJS,26,30,6,4,10
14,8477380,Jonny Brodzinski,C,NYR,31,50,5,5,10
14,8482964,Arber Xhekaj,D,MTL,23,55,5,5,10
14,8482153,Brendan Brisson,C,VGK,23,35,5,5,10
14,8483495,Simon Nemec,D,NJD,20,47,4,6,10
14,8478424,Jansen Harkins,C,ANA,27,36,4,6,10
14,8481592,Jakob Pelletier,L,CGY,23,40,4,6,10
14,8480844,Grigori Denisenko,L,VGK,24,29,4,6,10
14,8481527,Kaedan Korczak,D,VGK,23,45,3,7,10
14,8478017,Mark Friedman,D,VAN,29,40,3,7,10
14,8481598,Philip Broberg,D,EDM,23,38,3,7,10
14,8477851,Jordan Oesterle,D,BOS,32,42,3,7,10
14,8480157,Calle Rosen,D,COL,30,45,2,8,10
14,8479291,Kevin Rooney,C,CGY,31,53,2,8,10
14,8481122,Simon Benoit,D,TOR,26,34,2,8,10
14,8480246,Nick Perbix,D,TBL,26,73,1,9,10
14,8481751,Lukas Rousek,R,BUF,25,40,1,9,10
14,8481708,Zac Jones,D,NYR,24,45,1,9,10
14,8474166,Alec Martinez,D,CHI,37,43,0,10,10
14,8479986,Kole Lind,R,DAL,26,46,0,10,10
14,8473446,Erik Johnson,D,PHI,36,55,0,10,10
14,8480196,Jacob Bryson,D,BUF,27,44,0,10,10
14,8481679,Maxence Guenette,D,OTT,23,32,6,3,9
14,8477573,Nathan Walker,L,STL,30,43,4,5,9
14,8476858,Phillip Di Giuseppe,L,VAN,31,42,4,5,9
14,8483460,David Jiricek,D,CBJ,21,54,3,6,9
14,8479985,Cale Fleury,D,SEA,26,32,3,6,9
14,8477369,Carson Soucy,D,VAN,30,63,2,7,9
14,8478859,Niko Mikkola,D,FLA,28,60,2,7,9
14,8479359,Beck Malenstyn,L,BUF,26,44,2,7,9
14,8481568,Alex Vlasic,D,CHI,23,53,2,7,9
14,8482666,Scott Morrow,D,CAR,22,58,2,7,9
14,8477938,Haydn Fleury,D,WPG,28,40,2,7,9
14,8474567,Zach Bogosian,D,MIN,34,55,1,8,9
14,8477482,Zachary Sanford,L,CHI,30,32,1,8,9
14,8481567,Henry Thrun,D,SJS,23,50,1,8,9
14,8479249,Andrew Poturalski,C,SJS,30,32,0,9,9
14,8481518,Nolan Foote,L,NJD,24,43,6,2,8
14,8482145,Mavrik Bourque,C,DAL,22,55,6,2,8
14,8484911,Collin Graf,R,SJS,22,38,5,3,8
14,8479638,Justin Brazeau,R,BOS,26,40,4,4,8
14,8478399,Jonas Siegenthaler,D,NJD,27,62,3,5,8
14,8479372,Joshua Mahura,D,SEA,26,43,3,5,8
14,8477401,John Hayden,C,SEA,29,29,3,5,8
14,8477335,Kyle Burroughs,D,LAK,29,45,3,5,8
14,8477018,Ben Hutton,D,VGK,31,45,2,6,8
14,8480007,Jonas Rondbjerg,R,VGK,25,44,2,6,8
14,8481600,Tobias Bjornfot,D,FLA,23,42,2,6,8
14,8481147,Reese Johnson,C,MIN,26,30,2,6,8
14,8479348,Kale Clague,D,BUF,26,34,1,7,8
14,8479994,Jaret Anderson-Dolan,C,WPG,25,29,5,2,7
14,8477467,Gustav Olofsson,D,SEA,30,21,5,2,7
14,8482784,Zach Dean,C,STL,21,41,4,3,7
14,8480245,Olle Lycksell,R,PHI,25,36,4,3,7
14,8482747,Brennan Othmann,L,NYR,21,42,3,4,7
14,8483466,Kevin Korchinski,D,CHI,20,54,3,4,7
14,8477887,Patrick Brown,C,BOS,32,45,3,4,7
14,8480880,Jakub Lauko,C,MIN,24,32,3,4,7
14,8482496,Nils Aman,C,VAN,24,42,3,4,7
14,8476952,Dominic Toninato,C,WPG,30,32,3,4,7
14,8479536,Axel Jonsson-Fjallby,L,WPG,26,35,3,4,7
14,8483512,Matthew Savoie,C,EDM,20,20,3,4,7
14,8483619,Filip Roos,D,OTT,25,34,3,4,7
14,8476473,Connor Murphy,D,CHI,31,36,2,5,7
14,8477527,Ross Johnston,L,ANA,30,37,2,5,7
14,8474090,Brendan Smith,D,DAL,35,63,1,6,7
14,8477384,Joshua Brown,D,EDM,30,41,1,6,7
14,8482070,Mitchell Chaffee,R,TBL,26,47,4,2,6
14,8479576,Vincent Desharnais,D,VAN,28,35,4,2,6
14,8482861,Vincent Iorio,D,WSH,22,37,3,3,6
14,8479772,Zack MacEwen,R,OTT,28,55,2,4,6
14,8482177,Marat Khusnutdinov,C,MIN,22,36,2,4,6
14,8477244,Chad Ruhwedel,D,NYR,34,37,2,4,6
14,8481609,Vladislav Kolyachonok,D,UTA,23,27,2,4,6
14,8480292,Carson Meyer,R,ANA,27,24,1,5,6
14,8480441,Trey Fix-Wolansky,R,CBJ,25,35,1,5,6
14,8483549,Lucas Condotta,L,MTL,27,33,0,6,6
14,8476372,Nick Seeler,D,PHI,31,46,0,6,6
14,8481422,Jake Lucchini,C,NSH,29,25,4,1,5
14,8480990,Declan Chisholm,D,MIN,24,38,3,2,5
14,8482141,Lukas Cormier,D,VGK,22,18,3,2,5
14,8474612,Travis Hamonic,D,OTT,34,50,3,2,5
14,8478477,Mitchell Stephens,C,SEA,27,23,3,2,5
14,8482165,Yan Kuznetsov,D,CGY,22,20,3,2,5
14,8482077,Dylan Holloway,L,EDM,23,42,2,3,5
14,8480192,Johnathan Kovacevic,D,NJD,27,50,2,3,5
14,8482511,Mason Lohrei,D,BOS,23,36,2,3,5
14,8482765,Isak Rosen,R,BUF,21,29,2,3,5
14,8477073,Kurtis MacDermid,L,NJD,30,27,2,3,5
14,8479991,Jake Leschyshyn,C,NYR,25,31,2,3,5
14,8475958,Michael Sgarbossa,C,WSH,32,31,2,3,5
14,8478021,William Lagesson,D,DET,28,34,2,3,5
14,8479587,Rhett Gardner,C,PHI,28,24,2,3,5
14,8478502,Dennis Gilbert,D,BUF,28,21,2,3,5
14,8477070,Liam O'Brien,C,UTA,30,53,1,4,5
14,8478874,Adam Gaudette,R,OTT,28,27,1,4,5
14,8482858,Ryker Evans,D,SEA,23,26,1,4,5
14,8484258,Sam Malinski,D,COL,26,26,1,4,5
14,8480025,MacKenzie Entwistle,R,FLA,25,59,0,5,5
14,8478468,Jeremy Lauzon,D,NSH,27,58,0,5,5
14,8484254,Akito Hirose,D,VAN,25,32,0,5,5
14,8476441,Joel Edmundson,D,LAK,31,36,0,5,5
14,8480084,Nick DeSimone,D,NJD,30,20,0,5,5
14,8478831,Kevin Stenlund,C,UTA,28,54,3,1,4
14,8483012,Logan Morrison,C,SEA,22,28,3,1,4
14,8480870,Bo Groulx,C,NYR,24,22,3,1,4
14,8482751,Ryan Winterton,C,SEA,21,36,2,2,4
14,8479320,Maxime Lajoie,D,SEA,27,29,2,2,4
14,8477320,Anton Blidh,L,NYR,29,19,2,2,4
14,8481167,Brayden Pachal,D,CGY,25,42,1,3,4
14,8478146,Matthew Highmore,C,OTT,28,28,1,3,4
14,8479944,Zach Aston-Reese,C,VGK,30,37,1,3,4
14,8482713,Mackie Samoskevich,R,FLA,22,37,1,3,4
14,8481754,Nikita Nesterenko,C,ANA,23,29,1,3,4
14,8482516,Matthew Kessel,D,STL,24,20,1,3,4
14,8480267,Sammy Walker,C,MIN,25,21,1,3,4
14,8480468,James Hamblin,L,EDM,25,21,1,3,4
14,8481065,Angus Crookshank,L,OTT,25,17,1,3,4
14,8479968,Vinni Lettieri,C,BOS,29,46,0,4,4
14,8476913,Devin Shore,C,MIN,30,30,0,4,4
14,8482147,Jean-Luc Foudy,C,COL,22,25,0,4,4
14,8483570,Ben Meyers,C,SEA,26,34,3,0,3
14,8481237,Kyle MacLean,C,NYI,25,28,2,1,3
14,8480851,Akil Thomas,C,LAK,24,21,2,1,3
14,8479362,Riley Tufte,L,BOS,26,19,2,1,3
14,8480306,Grant Hutton,D,NYI,29,7,2,1,3
14,8481556,John Beecher,C,BOS,23,32,1,2,3
14,8477473,Justin Bailey,R,SJS,29,23,1,2,3
14,8482250,Callahan Burke,C,VGK,27,21,1,2,3
14,8481593,Jayden Struble,D,MTL,23,17,1,2,3
14,8481056,Spencer Stastney,D,NSH,24,35,1,2,3
14,8481719,Maxwell Crozier,D,TBL,24,15,1,2,3
14,8483567,Georgii Merkulov,C,BOS,24,13,1,2,3
14,8471677,Jack Johnson,D,CBJ,37,61,0,3,3
14,8481605,Jackson LaCombe,D,ANA,23,36,0,3,3
14,8477971,Andreas Englund,D,LAK,28,31,0,3,3
14,8477462,Robert Hagg,D,VGK,29,21,0,3,3
14,8482733,Logan Mailloux,D,MTL,31,34,0,3,3
14,8482144,Jack Thompson,D,SJS,22,17,0,3,3
14,8477810,Joel Hanley,D,CGY,33,24,0,3,3
14,8481030,Jack St. Ivany,D,PIT,25,15,0,3,3
14,8478409,Anthony Richard,C,PHI,28,27,2,0,2
14,8481578,Graeme Clarke,R,MIN,23,12,2,0,2
14,8481564,Ryan Johnson,D,BUF,23,14,2,0,2
14,8480874,Adam Ginning,D,PHI,24,10,2,0,2
14,8483489,Fraser Minten,C,TOR,31,11,2,0,2
14,8484287,Cole McWard,D,VAN,23,17,1,1,2
14,8481206,John Ludvig,D,PIT,24,15,1,1,2
14,8482118,Sam Colangelo,R,ANA,23,8,1,1,2
14,8479419,Brett Murray,L,BUF,26,19,1,1,2
14,8481006,Tyler Tucker,D,STL,24,26,1,1,2
14,8480890,Jan Jenik,C,OTT,24,28,1,1,2
14,8481699,Aku Raty,R,UTA,23,11,1,1,2
14,8478051,Max Willman,C,NJD,29,23,0,2,2
14,8481543,Nikita Alexandrov,C,STL,24,21,0,2,2
14,8474062,Riley Nash,C,NYR,35,16,0,2,2
14,8484304,Uvis Balinskis,D,FLA,28,8,0,2,2
14,8482929,Emil Lilleberg,D,TBL,23,18,0,2,2
14,8481806,Louis Crevier,D,CHI,23,13,0,2,2
14,8475795,Dylan McIlrath,D,WSH,32,15,0,2,2
14,8481585,Egor Afanasyev,L,SJS,23,15,1,0,1
14,8478011,Louie Belpedio,D,PHI,28,11,1,0,1
14,8483763,Maksymilian Szuber,D,UTA,22,31,1,0,1
14,8482061,Brandon Biro,L,SEA,26,15,1,0,1
14,8478446,Glenn Gawdin,C,LAK,27,17,1,0,1
14,8482162,Roby Jarventie,L,EDM,22,18,1,0,1
14,8475780,Chris Wagner,R,COL,33,10,1,0,1
14,8483398,Declan Carlile,D,TBL,31,7,1,0,1
14,8480032,Shane Bowers,C,NJD,25,12,1,0,1
14,8477541,Dakota Mermis,D,TOR,30,14,1,0,1
14,8478881,Brett Seney,L,CHI,28,13,1,0,1
14,8481024,Linus Karlsson,C,VAN,25,7,1,0,1
14,8482476,Emil Heineman,L,MTL,23,4,1,0,1
14,8481743,Marc Del Gaizo,D,NSH,25,18,0,1,1
14,8480834,Ty Emberson,D,SJS,24,33,0,1,1
14,8482172,Landon Slaggert,L,CHI,22,24,0,1,1
14,8484325,Waltteri Merela,C,TBL,26,24,0,1,1
14,8481541,Samuel Bolduc,D,NYI,24,28,0,1,1
14,8475755,Alexander Petrovic,D,DAL,32,9,0,1,1
14,8482201,Gage Goncalves,C,TBL,23,26,0,1,1
14,8482094,Daemon Hunt,D,MIN,22,16,0,1,1
14,8482460,Matt Rempe,C,NYR,22,12,0,1,1
14,8480823,Alexander Alexeyev,D,WSH,25,12,0,1,1
14,8480075,Cameron Crotty,D,MIN,25,14,0,1,1
14,8475413,Justin Dowling,C,NJD,34,13,0,1,1
14,8479421,Jacob Moverare,D,LAK,26,5,0,1,1
14,8483597,Milos Kelemen,L,UTA,25,13,0,1,1
14,8481726,Adam Edstrom,C,NYR,24,9,0,1,1
14,8483407,Brandon Scanlin,D,NYR,25,5,0,1,1
14,8483920,Pierrick Dube,R,WSH,23,8,0,1,1
14,8479367,William Lockwood,R,FLA,26,20,0,0,0
14,8481462,Mason Morelli,L,VGK,28,13,0,0,0
14,8482102,Vasily Ponomarev,C,PIT,22,16,0,0,0
14,8482787,Nikita Chibrikov,R,WPG,31,6,0,0,0
14,8483395,Arshdeep Bains,L,VAN,23,12,0,0,0
14,8481043,Cole Koepke,L,BOS,26,16,0,0,0
14,8483546,Marshall Rifai,D,TOR,26,3,0,0,0
14,8478854,Ryan Shea,D,PIT,27,6,0,0,0
14,8482470,Ilya Solovyov,D,CGY,24,17,0,0,0
14,8477993,Justin Kirkland,C,CGY,28,7,0,0,0
14,8481655,Cole Schwindt,R,CGY,23,5,0,0,0
14,8479330,Brandon Gignac,C,MTL,27,10,0,0,0
14,8478147,Bokondji Imama,L,PIT,28,8,0,0,0
14,8476323,Max McCormick,L,SEA,32,1,0,0,0
14,8483471,Brad Lambert,C,WPG,31,6,0,0,0
14,8482088,Justin Sourdif,R,FLA,22,21,0,0,0
14,8477149,Scott Sabourin,R,SJS,32,10,0,0,0
14,8479522,Hardy Haman Aktell,D,WSH,26,4,0,0,0
14,8484259,Ondrej Pavel,C,COL,31,2,0,0,0
14,8482197,Adam Raska,R,MIN,23,3,0,0,0
14,8484255,Jason Polin,R,COL,25,4,0,0,0
14,8481534,Raphael Lavoie,C,EDM,24,6,0,0,0
14,8483609,Adam Klapka,R,CGY,24,3,0,0,0
14,8484326,Patrik Koch,D,UTA,28,0,0,0,0
14,8483432,Luca Del Bel Belluz,C,CBJ,31,6,0,0,0
14,8483401,Marc Johnstone,R,PIT,28,3,0,0,0
14,8484321,Nikolas Matinpalo,D,OTT,26,2,0,0,0
14,8483531,Brian Halonen,L,NJD,25,5,0,0,0
14,8482126,Emil Andrae,D,PHI,31,0,0,0,0
14,8470794,Joe Pavelski,C,,40,0,0,0,0
14,8479321,Lucas Johansen,D,,27,0,0,0,0
14,8477950,Tony DeAngelo,D,,29,0,0,0,0
14,8471218,Blake Wheeler,R,,38,0,0,0,0
14,8475197,Tyson Barrie,D,,33,0,0,0,0
14,8474157,Max Pacioretty,L,,36,0,0,0,0
14,8475744,Evgeny Kuznetsov,C,,32,0,0,0,0
14,8474037,James van Riemsdyk,L,,35,0,0,0,0
14,8476907,Mackenzie MacEachern,L,,30,0,0,0,0
14,8480216,Jacob Peterson,C,,25,0,0,0,0
14,8474602,Justin Schultz,D,,34,0,0,0,0
14,8482222,Alexander Barabanov,L,,30,0,0,0,0
14,8474031,Kevin Shattenkirk,D,,35,0,0,0,0
14,8477330,Dominik Kubalik,L,,29,0,0,0,0
14,8480884,Calen Addison,D,,24,0,0,0,0
14,8475906,John Klingberg,D,,32,0,0,0,0
14,8480008,Adam Ruzicka,C,,25,0,0,0,0
14,8476884,Derrick Pouliot,D,,30,0,0,0,0
14,8476919,Chris Tierney,C,,30,0,0,0,0
14,8479415,Michael McLeod,C,,26,0,0,0,0
14,8474870,Tyler Johnson,C,,34,0,0,0,0
14,8470604,Jeff Carter,C,,39,0,0,0,0
14,8478104,Sammy Blais,L,,28,0,0,0,0
14,8474884,Mike Hoffman,C,,35,0,0,0,0
14,8481591,Sam Poulin,R,,23,0,0,0,0
14,8471274,Alex Goligoski,D,,39,0,0,0,0
14,8476871,Tanner Pearson,L,,32,0,0,0,0
14,8476393,Nick Cousins,C,,31,0,0,0,0
14,8479977,Kailer Yamamoto,R,,26,0,0,0,0
14,8479346,Dillon Dube,C,,26,0,0,0,0
14,8480184,Gustav Lindstrom,D,,26,0,0,0,0
14,8479376,Victor Mete,D,,26,0,0,0,0
14,8473449,Kyle Okposo,R,,36,0,0,0,0
14,8481058,Jesse Ylonen,R,,25,0,0,0,0
14,8475752,Tyler Pitlick,C,,33,0,0,0,0
14,8481239,Samuel Fagemo,L,,24,0,0,0,0
14,8480821,Filip Zadina,R,,25,0,0,0,0
14,8470966,Mark Giordano,D,,41,0,0,0,0
14,8478495,Denis Gurianov,R,,27,0,0,0,0
14,8477464,Nic Petan,C,,29,0,0,0,0
14,8478099,Kevin Labanc,R,,29,0,0,0,0
14,8482241,Radim Zohorna,L,,28,0,0,0,0
14,8474040,Sam Gagner,C,,35,0,0,0,0
14,8479514,Rem Pitlick,C,,27,0,0,0,0
14,8478430,Oliver Kylington,D,,27,0,0,0,0
14,8479533,Joona Koppanen,L,,26,0,0,0,0
14,8479984,Cal Foote,D,,26,0,0,0,0
14,8477126,Jayson Megna,C,,34,0,0,0,0
14,8475164,Jakob Silfverberg,R,,34,0,0,0,0
14,8474009,Nick Bonino,C,,36,0,0,0,0
14,8479458,Nikita Zaitsev,D,,33,0,0,0,0
14,8477944,Jakub Vrana,L,,28,0,0,0,0
14,8471699,Andrew Cogliano,C,,37,0,0,0,0
14,8478067,Oskar Lindblom,L,,28,0,0,0,0
14,8471686,Marc Staal,D,,37,0,0,0,0
14,8470610,Zach Parise,L,,40,0,0,0,0
14,8478904,Steven Lorentz,C,,28,0,0,0,0
14,8473473,Milan Lucic,L,,36,0,0,0,0
14,8480031,Maxime Comtois,L,,25,0,0,0,0
14,8478512,Austin Czarnik,C,,32,0,0,0,0
14,8473504,Cal Clutterbuck,R,,37,0,0,0,0
14,8477454,Adam Erne,L,,29,0,0,0,0
14,8479383,Boris Katchouk,L,,26,0,0,0,0
14,8475825,Jani Hakanpää,D,,32,0,0,0,0
14,8477846,Ryan Carpenter,C,,33,0,0,0,0
14,8477930,Pierre-Edouard Bellemare,L,,39,0,0,0,0
14,8478400,Colin White,C,,27,0,0,0,0
14,8480226,Marián Studenic,R,,26,0,0,0,0
14,8480853,Liam Foudy,C,,24,0,0,0,0
14,8475797,Jarred Tinordi,D,,32,0,0,0,0
14,8479423,Alex Nylander,L,,26,0,0,0,0
14,8474618,Marco Scandella,D,,34,0,0,0,0
14,8478028,Fredrik Olofsson,L,,28,0,0,0,0
14,8474709,Matt Martin,L,,35,0,0,0,0
14,8481070,Hugh McGing,L,,26,0,0,0,0
14,8479546,Oskar Steen,C,,26,0,0,0,0
14,8474145,Robert Bortuzzo,D,,35,0,0,0,0
14,8476915,Jujhar Khaira,L,,30,0,0,0,0
14,8480274,Philip Kemp,D,EDM,25,0,0,0,0
14,8475278,Byron Froese,C,,33,0,0,0,0
14,8481812,Nikolai Knyzhov,D,,27,0,0,0,0
14,8478408,Travis Dermott,D,,28,0,0,0,0
14,8481077,John Leonard,L,,26,0,0,0,0
14,8479547,Matthew Phillips,R,,26,0,0,0,0
14,8480836,Jonathan Gruden,C,,24,0,0,0,0
14,8481690,Tyler Angle,C,,24,0,0,0,0
14,8475766,Austin Watson,L,,32,0,0,0,0
14,8481016,Ruslan Iskhakov,C,,24,0,0,0,0
14,8478078,Rourke Chartier,C,,28,0,0,0,0
14,8480776,Sheldon Rempal,R,,29,0,0,0,0
14,8478956,Samuel Laberge,L,NJD,27,1,0,0,0
14,8483045,Cameron Butler,R,CBJ,31,2,0,0,0
14,8484314,Jiri Smejkal,L,,28,0,0,0,0
15,8478402,Connor McDavid,C,EDM,27,78,38,130,168
15,8476453,Nikita Kucherov,R,TBL,31,81,38,107,145
15,8477956,David Pastrnak,R,BOS,28,80,58,77,135
15,8477492,Nathan MacKinnon,C,COL,29,80,54,79,133
15,8479318,Auston Matthews,C,TOR,27,79,74,57,131
15,8478420,Mikko Rantanen,R,COL,28,82,61,68,129
15,8477939,William Nylander,R,TOR,28,80,46,77,123
15,8480027,Jason Robertson,L,DAL,25,81,37,84,121
15,8481559,Jack Hughes,C,NJD,23,77,42,77,119
15,8477946,Dylan Larkin,C,DET,28,82,51,54,105
15,8477934,Leon Draisaitl,C,EDM,29,78,39,64,103
15,8478864,Kirill Kaprizov,L,MIN,27,71,40,62,102
15,8478483,Mitch Marner,R,TOR,27,78,31,70,101
15,8471214,Alex Ovechkin,L,WSH,39,72,43,57,100
15,8477942,Kevin Fiala,L,LAK,28,82,36,64,100
15,8478445,Mathew Barzal,C,NYI,27,78,32,67,99
15,8476468,J.T. Miller,C,VAN,31,77,33,65,98
15,8478550,Artemi Panarin,L,NYR,33,74,18,77,95
15,8477404,Jake Guentzel,C,TBL,30,82,42,51,93
15,8477493,Aleksander Barkov,C,FLA,29,80,36,56,92
15,8471675,Sidney Crosby,C,PIT,37,74,34,58,92
15,8474564,Steven Stamkos,C,NSH,34,73,34,57,91
15,8482116,Tim Stützle,C,OTT,22,80,31,60,91
15,8478010,Brayden Point,C,TBL,28,81,44,46,90
15,8475172,Nazem Kadri,C,CGY,34,77,30,55,85
15,8475166,John Tavares,C,TOR,34,77,37,47,84
15,8478427,Sebastian Aho,C,CAR,27,74,36,48,84
15,8477960,Adrian Kempe,R,LAK,28,79,43,40,83
15,8476887,Filip Forsberg,L,NSH,30,72,40,43,83
15,8479385,Jordan Kyrou,C,STL,26,73,34,48,82
15,8473419,Brad Marchand,L,BOS,36,78,29,52,81
15,8479337,Alex DeBrincat,R,DET,27,81,34,46,80
15,8480865,Noah Dobson,D,NYI,24,79,13,66,79
15,8480803,Evan Bouchard,D,EDM,25,74,13,66,79
15,8480018,Nick Suzuki,C,MTL,25,78,24,54,78
15,8480023,Robert Thomas,C,STL,25,75,20,58,78
15,8480002,Nico Hischier,C,NJD,25,79,32,45,77
15,8479314,Matthew Tkachuk,L,FLA,27,77,26,51,77
15,8478403,Jack Eichel,C,VGK,28,71,39,37,76
15,8476539,Jonathan Marchessault,R,NSH,34,72,39,37,76
15,8474141,Patrick Kane,R,DET,36,78,32,43,75
15,8477500,Bo Horvat,C,NYI,29,80,39,35,74
15,8475754,Brock Nelson,C,NYI,33,80,31,43,74
15,8478439,Travis Konecny,R,PHI,27,77,27,47,74
15,8476454,Ryan Nugent-Hopkins,C,EDM,31,81,25,49,74
15,8475798,Mikael Granlund,C,SJS,32,70,24,50,74
15,8479323,Adam Fox,D,NYR,26,69,14,60,74
15,8478449,Roope Hintz,C,DAL,28,82,33,40,73
15,8477501,Valeri Nichushkin,R,COL,29,81,32,41,73
15,8476456,Jonathan Huberdeau,C,CGY,31,79,22,51,73
15,8480036,Miro Heiskanen,D,DAL,25,79,18,55,73
15,8479542,Brandon Hagel,L,TBL,26,82,31,41,72
15,8478440,Dylan Strome,C,WSH,27,67,30,42,72
15,8476389,Vincent Trocheck,C,NYR,31,75,24,48,72
15,8478398,Kyle Connor,L,WPG,28,75,34,37,71
15,8480012,Elias Pettersson,C,VAN,26,75,31,40,71
15,8481557,Matt Boldy,L,MIN,23,70,31,40,71
15,8478493,Joel Eriksson Ek,C,MIN,27,73,28,43,71
15,8471215,Evgeni Malkin,C,PIT,38,75,28,43,71
15,8480830,Andrei Svechnikov,R,CAR,24,71,26,45,71
15,8481540,Cole Caufield,R,MTL,23,76,37,33,70
15,8475786,Zach Hyman,L,EDM,32,80,36,34,70
15,8476459,Mika Zibanejad,C,NYR,31,74,29,41,70
15,8479407,Jesper Bratt,L,NJD,26,74,19,51,70
15,8480069,Cale Makar,D,COL,26,66,17,53,70
15,8476853,Morgan Rielly,D,TOR,30,74,15,55,70
15,8475184,Chris Kreider,L,NYR,33,73,45,24,69
15,8476881,Tomas Hertl,C,VGK,31,76,28,41,69
15,8477494,Jonathan Drouin,L,COL,29,79,19,50,69
15,8474590,John Carlson,D,WSH,34,71,11,58,69
15,8482078,Lucas Raymond,L,DET,22,81,29,39,68
15,8471685,Anze Kopitar,C,LAK,37,82,24,44,68
15,8479325,Charlie McAvoy,D,BOS,27,75,11,57,68
15,8478414,Timo Meier,R,NJD,28,77,44,23,67
15,8477933,Sam Reinhart,C,FLA,29,75,24,43,67
15,8480839,Rasmus Dahlin,D,BUF,24,70,15,52,67
15,8477496,Elias Lindholm,C,BOS,30,82,32,34,66
15,8480208,Drake Batherson,R,OTT,26,75,31,35,66
15,8478460,Zach Werenski,D,CBJ,27,80,22,44,66
15,8474600,Roman Josi,D,NSH,34,71,18,48,66
15,8480800,Quinn Hughes,D,VAN,25,72,13,53,66
15,8477955,Jared McCann,L,SEA,28,72,36,29,65
15,8479420,Tage Thompson,C,BUF,27,79,32,33,65
15,8475726,Tyler Toffoli,C,SJS,32,65,32,33,65
15,8484144,Connor Bedard,C,CHI,19,68,27,38,65
15,8478873,Troy Terry,R,ANA,27,71,25,40,65
15,8475765,Vladimir Tarasenko,R,DET,33,78,23,42,65
15,8478975,Mason Marchment,L,DAL,29,81,20,45,65
15,8474679,Gustav Nyquist,C,NSH,35,75,19,46,65
15,8478401,Pavel Zacha,C,BOS,27,77,30,34,64
15,8475692,Mats Zuccarello,R,MIN,37,69,14,50,64
15,8477949,Alex Tuch,R,BUF,28,73,22,41,63
15,8476460,Mark Scheifele,C,WPG,31,71,24,38,62
15,8474578,Erik Karlsson,D,PIT,34,79,15,47,62
15,8477503,Max Domi,C,TOR,29,76,14,48,62
15,8476346,Johnny Gaudreau,L,CBJ,31,71,13,49,62
15,8482740,Wyatt Johnston,C,DAL,21,81,32,29,61
15,8483515,Juraj Slafkovsky,L,MTL,20,77,29,32,61
15,8473512,Claude Giroux,R,OTT,36,80,26,35,61
15,8479343,Clayton Keller,R,UTA,26,77,25,36,61
15,8477402,Pavel Buchnevich,L,STL,29,78,25,36,61
15,8475158,Ryan O'Reilly,C,NSH,33,74,22,39,61
15,8475913,Mark Stone,R,VGK,32,74,20,41,61
15,8475167,Victor Hedman,D,TBL,34,79,12,49,61
15,8475169,Evander Kane,L,EDM,33,79,36,24,60
15,8475168,Matt Duchene,C,DAL,33,82,31,29,60
15,8479675,Trevor Moore,L,LAK,29,81,26,34,60
15,8481068,Yegor Sharangovich,C,CGY,26,75,29,30,59
15,8474102,David Perron,L,OTT,36,78,22,37,59
15,8477456,J.T. Compher,L,DET,29,79,21,38,59
15,8474586,Jordan Eberle,R,SEA,34,74,30,28,58
15,8475784,Jeff Skinner,C,EDM,32,74,29,29,58
15,8478444,Brock Boeser,R,VAN,27,76,26,32,58
15,8476479,Phillip Danault,C,LAK,31,81,22,36,58
15,8482159,Tyson Foerster,R,PHI,22,72,21,36,57
15,8477409,Carter Verhaeghe,C,FLA,29,76,31,25,56
15,8475794,Tyler Seguin,C,DAL,32,79,28,28,56
15,8480801,Brady Tkachuk,L,OTT,25,77,23,33,56
15,8476875,Mike Matheson,D,MTL,30,71,11,45,56
15,8482093,Seth Jarvis,C,CAR,22,70,24,31,55
15,8477504,Josh Morrissey,D,WPG,29,75,17,38,55
15,8479999,Casey Mittelstadt,C,COL,26,78,14,41,55
15,8482684,Luke Hughes,D,NJD,21,71,12,43,55
15,8476399,Blake Coleman,C,CGY,33,79,30,24,54
15,8476880,Tom Wilson,R,WSH,30,69,29,25,54
15,8477998,Warren Foegele,L,LAK,28,80,25,29,54
15,8478519,Anthony Cirelli,C,TBL,27,82,23,31,54
15,8476906,Shayne Gostisbehere,D,CAR,31,72,17,37,54
15,8474150,Mikael Backlund,C,CGY,35,79,12,42,54
15,8483808,Andrei Kuzmenko,L,CGY,28,78,31,22,53
15,8475314,Anders Lee,L,NYI,34,75,30,23,53
15,8477444,Andre Burakovsky,L,SEA,29,68,22,31,53
15,8478466,Daniel Sprong,R,VAN,27,70,21,32,53
15,8477416,Oliver Bjorkstrand,R,SEA,29,70,20,33,53
15,8477951,Nick Schmaltz,C,UTA,28,74,20,33,53
15,8484166,Adam Fantilli,C,CBJ,20,67,30,22,52
15,8477407,Anthony Duclair,L,NYI,29,76,23,29,52
15,8482699,Dylan Guenther,R,UTA,21,75,26,25,51
15,8480064,Josh Norris,C,OTT,25,80,26,25,51
15,8478042,Viktor Arvidsson,L,EDM,31,78,23,28,51
15,8484153,Leo Carlsson,C,ANA,20,80,16,35,51
15,8476923,Damon Severson,D,CBJ,30,77,16,35,51
15,8477346,MacKenzie Weegar,D,CGY,30,71,12,39,51
15,8476905,Chandler Stephenson,C,SEA,30,72,8,43,51
15,8477476,Artturi Lehkonen,L,COL,29,79,26,24,50
15,8482109,Alexis Lafrenière,L,NYR,23,72,26,24,50
15,8482667,William Eklund,L,SJS,22,70,22,28,50
15,8481186,Logan O'Connor,R,COL,28,80,21,29,50
15,8480039,Martin Necas,C,CAR,25,73,18,32,50
15,8482124,Quinton Byfield,R,LAK,22,80,16,34,50
15,8480028,Morgan Frost,C,PHI,25,76,22,27,49
15,8482113,Anton Lundell,C,FLA,23,76,20,29,49
15,8478397,Rasmus Andersson,D,CGY,28,76,10,39,49
15,8476448,William Karlsson,C,VGK,31,78,29,19,48
15,8480014,Gabriel Vilardi,C,WPG,25,66,26,22,48
15,8477451,Ryan Hartman,R,MIN,30,71,25,23,48
15,8477940,Nikolaj Ehlers,L,WPG,28,69,23,25,48
15,8475151,Kyle Palmieri,C,NYI,33,79,23,25,48
15,8477511,Anthony Mantha,R,CGY,30,77,23,25,48
15,8477964,Ivan Barbashev,C,VGK,29,70,20,28,48
15,8481524,Bowen Byram,D,BUF,23,67,19,29,48
15,8479992,Michael Rasmussen,C,DET,25,79,18,30,48
15,8477932,Aaron Ekblad,D,FLA,28,66,18,30,48
15,8478856,Conor Garland,R,VAN,28,72,15,33,48
15,8476458,Ryan Strome,C,ANA,31,70,14,34,48
15,8477497,Sean Monahan,C,CBJ,30,68,13,35,48
15,8476438,Brandon Saad,L,STL,32,65,33,14,47
15,8473994,Jamie Benn,L,DAL,35,81,25,22,47
15,8478498,Jake DeBrusk,L,VAN,28,74,25,22,47
15,8473986,Alex Killorn,L,ANA,35,76,23,24,47
15,8482665,Matty Beniers,C,SEA,22,77,21,26,47
15,8482745,Mason McTavish,C,ANA,21,71,20,27,47
15,8480336,Sean Walker,D,CAR,30,69,15,32,47
15,8474641,Adam Henrique,C,EDM,34,70,25,21,46
15,8479400,Pierre-Luc Dubois,L,WSH,26,73,23,23,46
15,8478438,Tommy Novak,C,NSH,27,66,16,30,46
15,8478407,Vince Dunn,D,SEA,28,78,7,39,46
15,8483431,Logan Cooley,C,UTA,20,76,18,27,45
15,8475810,Bryan Rust,R,PIT,32,71,16,29,45
15,8479345,Jakob Chychrun,D,WSH,26,68,15,30,45
15,8479987,Morgan Geekie,C,BOS,26,79,14,31,45
15,8481656,Aliaksei Protas,C,WSH,23,66,14,31,45
15,8479425,Filip Hronek,D,VAN,27,73,12,33,45
15,8478047,Michael Bunting,L,PIT,29,73,24,20,44
15,8480188,Fabian Zetterlund,L,SJS,25,65,23,21,44
15,8480015,Owen Tippett,R,PHI,25,71,22,22,44
15,8475768,Jaden Schwartz,C,SEA,32,71,22,22,44
15,8475714,Calle Jarnkrok,C,TOR,33,78,17,27,44
15,8474563,Drew Doughty,D,LAK,35,74,11,33,44
15,8479351,Sam Steel,C,DAL,26,80,10,34,44
15,8471724,Kris Letang,D,PIT,37,77,9,35,44
15,8475753,Justin Faulk,D,STL,32,75,9,35,44
15,8476882,Teuvo Teravainen,C,CHI,30,64,21,22,43
15,8477935,Sam Bennett,C,FLA,28,75,20,23,43
15,8475793,Ryan Johansen,C,PHI,32,76,19,24,43
15,8477498,Darnell Nurse,D,EDM,29,76,18,25,43
15,8475170,Brayden Schenn,C,STL,33,76,17,26,43
15,8475191,Reilly Smith,R,NYR,33,75,16,27,43
15,8475745,Charlie Coyle,C,BOS,32,79,15,28,43
15,8470613,Brent Burns,D,CAR,39,78,14,29,43
15,8476869,Brady Skjei,D,NSH,30,70,13,30,43
15,8476432,Boone Jenner,C,CBJ,31,66,25,17,42
15,8479525,Ross Colton,C,COL,28,80,22,20,42
15,8477426,Nicholas Paul,L,TBL,29,82,19,23,42
15,8480068,Ryan Poehling,C,PHI,25,74,19,23,42
15,8477479,Tyler Bertuzzi,L,CHI,29,65,18,24,42
15,8478046,Danton Heinen,L,VAN,29,71,17,25,42
15,8481618,Alex Newhook,C,MTL,23,75,16,26,42
15,8474053,Logan Couture,C,SJS,35,64,13,29,42
15,8478469,Thomas Chabot,D,OTT,27,70,9,33,42
15,8477495,Seth Jones,D,CHI,30,67,8,34,42
15,8483490,Pavel Mintyukov,D,ANA,21,73,8,34,42
15,8481560,Arthur Kaliyev,R,LAK,23,77,19,22,41
15,8484145,Zach Benson,L,BUF,19,69,17,24,41
15,8478366,Frank Vatrano,R,ANA,30,69,16,25,41
15,8480798,Philipp Kurashev,C,CHI,25,55,16,25,41
15,8478233,Andrew Mangiapane,L,WSH,28,65,16,25,41
15,8481542,Moritz Seider,D,DET,23,77,7,34,41
15,8478038,Devon Toews,D,COL,30,72,4,37,41
15,8475848,Brendan Gallagher,R,MTL,32,75,23,17,40
15,8478115,Pierre Engvall,L,NYI,28,78,18,22,40
15,8476483,Rickard Rakell,R,PIT,31,73,16,24,40
15,8477429,Andrew Copp,C,DET,30,78,15,25,40
15,8480185,Eetu Luostarinen,C,FLA,26,76,14,26,40
15,8481581,Thomas Harley,D,DAL,23,82,13,27,40
15,8481546,Cam York,D,PHI,23,66,11,29,40
15,8481711,Matias Maccelli,L,UTA,24,73,9,31,40
15,8476462,Dougie Hamilton,D,NJD,31,66,8,32,40
15,8476979,Erik Gustafsson,D,DET,32,73,6,34,40
15,8482092,Ridly Greig,C,OTT,22,75,21,18,39
15,8480849,Barrett Hayton,C,UTA,24,68,20,19,39
15,8475799,Nino Niederreiter,R,WPG,32,64,17,22,39
15,8482702,Logan Stankoven,C,DAL,21,82,17,22,39
15,8483505,Matthew Poitras,C,BOS,20,75,16,23,39
15,8477947,Sonny Milano,L,WSH,28,67,15,24,39
15,8478458,John (Jack) Roslovic,C,CAR,27,69,15,24,39
15,8476872,Scott Laughton,C,PHI,30,76,14,25,39
15,8480797,Joel Farabee,L,PHI,24,72,14,25,39
15,8480434,Sean Durzi,D,UTA,26,64,7,32,39
15,8476981,Josh Anderson,R,MTL,30,71,21,17,38
15,8482110,Dawson Mercer,C,NJD,23,70,16,22,38
15,8474149,Evgenii Dadonov,R,DAL,35,80,16,22,38
15,8476461,Sean Couturier,C,PHI,32,68,15,23,38
15,8480459,Pius Suter,C,VAN,28,74,15,23,38
15,8478396,Noah Hanifin,D,VGK,27,64,10,28,38
15,8481577,Philip Tomasino,C,NSH,23,68,9,29,38
15,8481596,Shane Pinto,C,OTT,24,73,19,18,37
15,8479365,Trent Frederic,C,BOS,26,78,19,18,37
15,8482146,Luke Evangelista,R,NSH,22,69,17,20,37
15,8482720,Matthew Knies,L,TOR,22,78,16,21,37
15,8475218,Mattias Ekholm,D,EDM,34,73,12,25,37
15,8482475,Yegor Chinakhov,R,CBJ,23,67,12,25,37
15,8481582,Nicholas Robertson,L,TOR,23,70,23,13,36
15,8481533,Trevor Zegras,C,ANA,23,70,18,18,36
15,8481554,Kaapo Kakko,R,NYR,23,68,18,18,36
15,8479591,Michael Eyssimont,C,TBL,28,81,15,21,36
15,8478542,Evan Rodrigues,C,FLA,31,76,14,22,36
15,8477986,Brandon Montour,D,SEA,30,70,13,23,36
15,8480829,Jesperi Kotkaniemi,C,CAR,24,65,13,23,36
15,8476927,Teddy Blueger,C,VAN,30,65,10,26,36
15,8477447,Shea Theodore,D,VGK,29,67,9,27,36
15,8482105,Jake Sanderson,D,OTT,22,73,5,31,36
15,8478413,Jordan Greenway,L,BUF,27,67,16,19,35
15,8481093,Rafael Harvey-Pinard,L,MTL,25,63,15,20,35
15,8476826,Yanni Gourde,C,SEA,33,68,13,22,35
15,8483445,Cutter Gauthier,L,ANA,20,59,11,24,35
15,8482133,Thomas Bordeleau,C,SJS,22,62,8,27,35
15,8478500,Ivan Provorov,D,CBJ,27,76,4,31,35
15,8476792,Torey Krug,D,STL,33,70,3,32,35
15,8476958,Jaccob Slavin,D,CAR,30,76,3,32,35
15,8477952,Robby Fabbri,C,ANA,28,69,21,13,34
15,8481604,Pavel Dorofeyev,L,VGK,24,71,19,15,34
15,8482097,Jack Quinn,R,BUF,23,65,15,19,34
15,8482149,Cole Perfetti,C,WPG,22,70,14,20,34
15,8480220,Noah Cates,L,PHI,25,72,14,20,34
15,8480113,Alex Iafallo,L,WPG,31,68,12,22,34
15,8476917,Adam Pelech,D,NYI,30,78,9,25,34
15,8476463,Jonas Brodin,D,MIN,31,77,6,28,34
15,8476854,Hampus Lindholm,D,BOS,30,70,5,29,34
15,8481580,Connor McMichael,C,WSH,23,68,19,14,33
15,8473422,Nick Foligno,L,CHI,37,59,17,16,33
15,8479393,Noah Gregor,L,OTT,26,71,15,18,33
15,8476897,Oskar Sundqvist,C,STL,30,65,15,18,33
15,8471698,T.J. Oshie,R,WSH,38,60,14,19,33
15,8480802,Ryan McLeod,C,BUF,25,67,12,21,33
15,8480855,Jack McBain,C,UTA,24,68,12,21,33
15,8482067,Connor Mackey,D,NYR,28,64,10,23,33
15,8478891,Mason Appleton,C,WPG,28,65,10,23,33
15,8482712,Oskar Olausson,R,COL,22,79,8,25,33
15,8475764,Cam Fowler,D,ANA,33,69,3,30,33
15,8478474,Lawson Crouse,L,UTA,27,79,16,16,32
15,8478057,Dakota Joshua,C,VAN,28,62,15,17,32
15,8478020,Michael Amadio,R,OTT,28,75,15,17,32
15,8475287,Erik Haula,L,NJD,33,63,14,18,32
15,8477989,Christian Dvorak,C,MTL,28,63,11,21,32
15,8478462,Nicolas Roy,C,VGK,27,72,9,23,32
15,8480145,Neal Pionk,D,WPG,29,72,7,25,32
15,8482101,Danil Gushchin,L,SJS,22,61,6,26,32
15,8482089,Jake Neighbours,L,STL,22,70,22,9,31
15,8474715,Cameron Atkinson,R,TBL,35,79,18,13,31
15,8482705,Cole Sillinger,C,CBJ,21,70,14,17,31
15,8475760,Nick Bjugstad,C,UTA,32,72,13,18,31
15,8477021,Alex Kerfoot,C,UTA,30,73,12,19,31
15,8481523,Kirby Dach,C,MTL,23,68,11,20,31
15,8476474,Stefan Noesen,R,NJD,31,69,11,20,31
15,8484203,Bradly Nadeau,L,CAR,19,67,10,21,31
15,8476480,Vladislav Namestnikov,C,WPG,32,65,9,22,31
15,8475171,Oliver Ekman-Larsson,D,TOR,33,71,8,23,31
15,8482749,Joshua Roy,R,MTL,21,72,8,23,31
15,8481703,Valtteri Puustinen,R,PIT,25,60,6,25,31
15,8480817,K'Andre Miller,D,NYR,24,71,6,25,31
15,8480873,Rasmus Sandin,D,WSH,24,68,5,26,31
15,8470621,Corey Perry,R,EDM,39,70,19,11,30
15,8477478,William Carrier,L,CAR,30,58,15,15,30
15,8477987,Ryan Donato,C,CHI,28,61,14,16,30
15,8482117,Lukas Reichel,L,CHI,22,60,14,16,30
15,8478472,Mathieu Joseph,R,STL,27,69,9,21,30
15,8476467,Jamie Oleksiak,D,SEA,32,69,9,21,30
15,8476931,Jake McCabe,D,TOR,31,68,7,23,30
15,8477839,Conor Sheary,L,TBL,32,79,6,24,30
15,8477969,Marcus Pettersson,D,PIT,28,80,4,26,30
15,8480813,Joe Veleno,C,DET,24,76,17,12,29
15,8475722,Jason Zucker,L,BUF,32,62,15,14,29
15,8480078,Filip Chytil,C,NYR,25,68,14,15,29
15,8475220,Marcus Foligno,L,MIN,33,62,13,16,29
15,8481528,Dylan Cozens,C,BUF,23,67,11,18,29
15,8481553,Bobby Brink,R,PHI,23,56,11,18,29
15,8476885,Jacob Trouba,D,NYR,30,69,8,21,29
15,8482122,Brock Faber,D,MIN,22,73,7,22,29
15,8477953,Kasperi Kapanen,R,STL,28,70,7,22,29
15,8474565,Alex Pietrangelo,D,VGK,34,58,6,23,29
15,8482671,Owen Power,D,BUF,22,64,6,23,29
15,8475200,Dmitry Orlov,D,CAR,33,74,6,23,29
15,8482079,Marco Rossi,C,MIN,23,61,18,10,28
15,8480893,Kirill Marchenko,R,CBJ,24,62,17,11,28
15,8476278,Colin Blackwell,C,DAL,31,77,14,14,28
15,8480835,Jack Drury,C,CAR,24,63,13,15,28
15,8474189,Lars Eller,C,PIT,35,64,13,15,28
15,8482624,Daniil Miromanov,D,CGY,27,68,12,16,28
15,8477425,Miles Wood,L,COL,29,78,11,17,28
15,8479328,Julien Gauthier,R,NYI,27,62,11,17,28
15,8474716,Jared Spurgeon,D,MIN,35,77,9,19,28
15,8480073,Erik Brannstrom,D,COL,25,60,8,20,28
15,8480043,Timothy Liljegren,D,TOR,25,68,7,21,28
15,8482175,JJ Peterka,R,BUF,22,70,17,10,27
15,8477450,Jason Dickinson,C,CHI,29,63,14,13,27
15,8483468,Jiri Kulich,C,BUF,20,63,12,15,27
15,8479996,Cody Glass,C,NSH,25,58,12,15,27
15,8476925,Colton Sissons,C,NSH,31,65,12,15,27
15,8482660,Kent Johnson,C,CBJ,22,63,10,17,27
15,8476392,Adam Lowry,C,WPG,31,68,10,17,27
15,8478882,Vladislav Gavrikov,D,LAK,29,66,6,21,27
15,8479410,Mikhail Sergachev,D,UTA,26,67,4,23,27
15,8477220,Nate Schmidt,D,FLA,33,71,4,23,27
15,8474151,Ryan McDonagh,D,TBL,35,74,2,25,27
15,8475188,Brayden McNabb,D,VGK,33,60,2,25,27
15,8481535,Nils Hoglander,L,VAN,24,63,17,9,26
15,8480074,Alexandre Texier,C,STL,25,57,16,10,26
15,8479316,Luke Kunin,C,SJS,27,58,14,12,26
15,8481704,Juuso Parssinen,C,NSH,23,51,12,14,26
15,8475763,Kevin Hayes,R,PIT,32,66,11,15,26
15,8476419,Jean-Gabriel Pageau,C,NYI,32,75,10,16,26
15,8479315,Joey Anderson,R,CHI,26,50,7,19,26
15,8478911,Matt Roy,D,WSH,29,67,6,20,26
15,8473563,Nicklas Backstrom,C,WSH,37,54,5,21,26
15,8476902,Esa Lindell,D,DAL,30,75,4,22,26
15,8479661,Tanner Jeannot,L,LAK,27,77,4,22,26
15,8477506,Ryan Pulock,D,NYI,30,80,2,24,26
15,8475193,Tomas Tatar,L,NJD,34,64,9,16,25
15,8479339,Patrik Laine,L,CBJ,26,58,8,17,25
15,8476292,Ondrej Palat,L,NJD,33,65,7,18,25
15,8476329,Travis Boyd,C,MIN,31,59,7,18,25
15,8477948,Travis Sanheim,D,PHI,28,67,6,19,25
15,8479398,Samuel Girard,D,COL,26,66,4,21,25
15,8482055,Drew O'Connor,L,PIT,26,63,16,8,24
15,8483524,Shane Wright,C,SEA,20,61,13,11,24
15,8480806,Isac Lundestrom,C,ANA,25,65,13,11,24
15,8480789,Oliver Wahlstrom,R,NYI,24,71,13,11,24
15,8480009,Eeli Tolvanen,R,SEA,25,67,10,14,24
15,8480144,David Kampf,C,TOR,29,63,10,14,24
15,8479293,Brandon Tanev,L,SEA,33,62,10,14,24
15,8475231,Casey Cizikas,C,NYI,33,67,9,15,24
15,8476994,Vinnie Hinostroza,C,NSH,30,57,7,17,24
15,8482142,Jamie Drysdale,D,PHI,22,67,6,18,24
15,8476988,Matt Benning,D,SJS,30,68,6,18,24
15,8479390,Taylor Raddysh,R,WSH,26,65,5,19,24
15,8481527,Kaedan Korczak,D,VGK,23,54,5,19,24
15,8482073,Braden Schneider,D,NYR,23,62,3,21,24
15,8480172,Jan Rutta,D,SJS,34,61,3,21,24
15,8481032,Paul Cotter,C,NJD,25,67,14,9,23
15,8481624,Ilya Mikheyev,R,CHI,30,51,12,11,23
15,8481641,Joel Kiviranta,L,COL,28,70,12,11,23
15,8482077,Dylan Holloway,L,EDM,23,57,12,11,23
15,8476469,Joel Armia,R,MTL,31,64,11,12,23
15,8478463,Anthony Beauvillier,L,PIT,27,61,10,13,23
15,8478970,Jalen Chatfield,D,CAR,28,72,9,14,23
15,8476960,Andreas Athanasiou,C,CHI,30,52,8,15,23
15,8479353,Brett Howden,C,VGK,26,69,6,17,23
15,8477903,Garnet Hathaway,R,PHI,33,64,6,17,23
15,8481178,Egor Zamula,D,PHI,24,51,5,18,23
15,8481606,Jordan Spence,D,LAK,23,65,4,19,23
15,8479369,Andrew Peeke,D,BOS,26,68,3,20,23
15,8475181,Nick Leddy,D,STL,33,73,2,21,23
15,8479639,Dylan Coghlan,D,WPG,26,66,1,22,23
15,8481568,Alex Vlasic,D,CHI,23,62,0,23,23
15,8476918,Jimmy Vesey,L,NYR,31,64,14,8,22
15,8479368,Max Jones,L,BOS,26,67,12,10,22
15,8483493,Frank Nazar,C,CHI,20,53,11,11,22
15,8481477,Nico Sturm,C,SJS,29,61,10,12,22
15,8475791,Taylor Hall,L,CHI,33,61,9,13,22
15,8482803,Olen Zellweger,D,ANA,21,62,8,14,22
15,8480891,Michael Kesselring,D,UTA,24,57,7,15,22
15,8480980,Connor Dewar,C,TOR,25,70,6,16,22
15,8479324,Ryan Lindgren,D,NYR,26,60,6,16,22
15,8478416,Erik Cernak,D,TBL,27,73,5,17,22
15,8473507,Jeff Petry,D,DET,37,75,3,19,22
15,8477845,Trevor van Riemsdyk,D,WSH,33,52,3,19,22
15,8480049,Dylan Samberg,D,WPG,25,70,1,21,22
15,8482259,Bobby McMann,C,TOR,28,65,13,8,21
15,8477406,Mattias Janmark,C,EDM,32,67,12,9,21
15,8476889,Radek Faksa,C,STL,30,62,12,9,21
15,8482074,Connor Zary,C,CGY,23,61,11,10,21
15,8476921,Jordan Martinook,L,CAR,32,60,10,11,21
15,8483457,Lane Hutson,D,MTL,20,60,10,11,21
15,8479414,Nathan Bastian,R,NJD,27,60,10,11,21
15,8482111,Justin Barron,D,MTL,23,63,9,12,21
15,8473533,Jordan Staal,C,CAR,36,61,8,13,21
15,8483565,Nick Blankenburg,D,NSH,26,65,8,13,21
15,8482125,Alexander Holtz,R,VGK,22,70,7,14,21
15,8478434,Keegan Kolesar,R,VGK,27,66,7,14,21
15,8480003,Jesper Boqvist,C,FLA,26,72,7,14,21
15,8478055,Gustav Forsling,D,FLA,28,67,6,15,21
15,8477015,Connor Brown,R,EDM,30,51,5,16,21
15,8476879,Cody Ceci,D,EDM,31,72,4,17,21
15,8475179,Dmitry Kulikov,D,FLA,34,66,3,18,21
15,8474673,TJ Brodie,D,CHI,34,66,3,18,21
15,8478399,Jonas Siegenthaler,D,NJD,27,61,3,18,21
15,8473453,Trevor Lewis,C,LAK,37,72,12,8,20
15,8481716,Dmitri Voronkov,L,CBJ,24,48,12,8,20
15,8481013,Jonatan Berggren,R,DET,24,62,12,8,20
15,8477508,Curtis Lazar,C,NJD,29,60,10,10,20
15,8477488,Brett Pesce,D,NJD,30,73,9,11,20
15,8477353,Tyler Motte,C,DET,29,71,9,11,20
15,8478013,Jake Walman,D,SJS,28,71,7,13,20
15,8478451,Ethan Bear,D,WSH,27,49,7,13,20
15,8479980,Nicolas Hague,D,VGK,26,52,6,14,20
15,8478585,Derek Ryan,C,EDM,38,68,6,14,20
15,8478507,John Marino,D,UTA,27,72,4,16,20
15,8477435,Ryan Graves,D,PIT,29,79,4,16,20
15,8481441,Joe Snively,C,DET,28,65,4,16,20
15,8480222,Sebastian Aho,D,PIT,28,68,3,17,20
15,8476331,Dylan DeMelo,D,WPG,31,68,2,18,20
15,8478840,Will Borgen,D,SEA,28,68,1,19,20
15,8482737,Zack Bolduc,C,STL,21,54,14,5,19
15,8478508,Yakov Trenin,C,MIN,27,58,12,7,19
15,8477446,Michael McCarron,R,NSH,29,60,11,8,19
15,8475149,Marcus Johansson,L,MIN,34,64,9,10,19
15,8480995,Pontus Holmberg,R,TOR,25,55,9,10,19
15,8476878,Zemgus Girgensons,C,TBL,30,79,9,10,19
15,8481601,Simon Holmstrom,R,NYI,23,66,8,11,19
15,8482809,Jackson Blake,R,CAR,21,62,7,12,19
15,8477392,Hudson Fasching,R,NYI,29,64,7,12,19
15,8482192,Isaak Phillips,D,CHI,23,54,6,13,19
15,8481708,Zac Jones,D,NYR,24,60,6,13,19
15,8478136,Jake Middleton,D,MIN,28,76,5,14,19
15,8479983,Mario Ferraro,D,SJS,26,78,4,15,19
15,8476429,Scott Mayfield,D,NYI,32,72,4,15,19
15,8480001,Urho Vaakanainen,D,ANA,25,65,3,16,19
15,8475790,Erik Gudbranson,D,CBJ,32,78,3,16,19
15,8482245,Artem Zub,D,OTT,29,73,2,17,19
15,8476457,Adam Larsson,D,SEA,32,64,2,17,19
15,8481014,Alexander Romanov,D,NYI,24,79,2,17,19
15,8479998,Mikey Anderson,D,LAK,25,68,1,18,19
15,8476892,Colton Parayko,D,STL,31,69,1,18,19
15,8475233,David Savard,D,MTL,34,74,1,18,19
15,8475855,Jesper Fast,R,CAR,33,54,11,7,18
15,8480281,Alexey Toropchenko,R,STL,25,54,11,7,18
15,8480762,Eric Robinson,L,CAR,29,51,8,10,18
15,8477018,Ben Hutton,D,VGK,31,50,8,10,18
15,8481521,Ronnie Attard,D,PHI,25,57,7,11,18
15,8480021,Jack Studnicka,C,LAK,25,67,7,11,18
15,8477507,Nikita Zadorov,D,BOS,29,64,5,13,18
15,8478133,Jake Evans,C,MTL,28,60,3,15,18
15,8480035,Henri Jokiharju,D,BUF,25,58,3,15,18
15,8479402,Jake Bean,D,CGY,26,68,3,15,18
15,8480807,Mattias Samuelsson,D,BUF,24,51,3,15,18
15,8482157,Will Cuylle,L,NYR,22,63,12,5,17
15,8479941,Justin Danforth,R,CBJ,31,54,11,6,17
15,8482155,Alex Laferriere,R,LAK,23,65,11,6,17
15,8479543,Michael Pezzetta,L,MTL,26,49,10,7,17
15,8478109,Victor Olofsson,L,VGK,29,62,9,8,17
15,8476422,Mike Reilly,D,NYI,31,74,8,9,17
15,8476312,Josh Manson,D,COL,33,69,7,10,17
15,8476873,Mark Jankowski,C,NSH,30,51,7,10,17
15,8476891,Matthew Grzelcyk,D,PIT,30,76,7,10,17
15,8483482,Tristan Luneau,D,ANA,20,63,6,11,17
15,8474574,Tyler Myers,D,VAN,34,69,6,11,17
15,8478043,Sam Lafferty,C,BUF,29,50,6,11,17
15,8477499,Rasmus Ristolainen,D,PHI,30,59,6,11,17
15,8483491,Ivan Miroshnichenko,L,WSH,20,63,5,12,17
15,8476822,Luke Glendening,C,TBL,35,79,5,12,17
15,8481522,Peyton Krebs,C,BUF,23,57,4,13,17
15,8475462,Radko Gudas,D,ANA,34,59,4,13,17
15,8479976,Juuso Valimaki,D,UTA,26,66,3,14,17
15,8481019,David Gustafsson,C,WPG,24,43,3,14,17
15,8480887,Jordan Harris,D,MTL,24,55,3,14,17
15,8479249,Andrew Poturalski,C,SJS,30,38,3,14,17
15,8478851,Alexandre Carrier,D,NSH,28,66,2,15,17
15,8475279,Ben Chiarot,D,DET,33,68,2,15,17
15,8480205,Emil Bemstrom,C,PIT,25,52,11,5,16
15,8480748,Kiefer Sherwood,L,VAN,29,59,11,5,16
15,8475343,Nic Dowd,C,WSH,34,61,10,6,16
15,8482679,Matt Coronato,R,CGY,22,64,8,8,16
15,8479619,Michael Carcone,L,UTA,28,55,8,8,16
15,8479344,Jesse Puljujarvi,R,PIT,26,56,8,8,16
15,8482807,Ethan Del Mastro,D,CHI,21,49,8,8,16
15,8477573,Nathan Walker,L,STL,30,54,8,8,16
15,8480448,Parker Kelly,L,COL,25,73,6,10,16
15,8476374,Sean Kuraly,C,CBJ,31,57,6,10,16
15,8479718,Alex Barré-Boulet,C,MTL,27,49,6,10,16
15,8482730,Brandt Clarke,D,LAK,21,59,5,11,16
15,8482176,Wyatt Kaiser,D,CHI,22,58,3,13,16
15,8482087,Kaiden Guhle,D,MTL,22,68,3,13,16
15,8475324,Nick Jensen,D,OTT,34,65,2,14,16
15,8481059,Scott Perunovich,D,STL,26,60,1,15,16
15,8471709,Marc-Edouard Vlasic,D,SJS,37,60,1,15,16
15,8475718,Justin Holl,D,DET,32,57,0,16,16
15,8480289,Morgan Barron,C,WPG,26,53,10,5,15
15,8475842,Sam Carrick,C,NYR,32,66,10,5,15
15,8481617,Vasily Podkolzin,R,VAN,23,50,8,7,15
15,8476934,Brock McGinn,L,ANA,30,56,8,7,15
15,8481751,Lukas Rousek,R,BUF,25,44,8,7,15
15,8481532,Alex Turcotte,C,LAK,23,38,7,8,15
15,8478432,Christian Fischer,R,DET,27,74,6,9,15
15,8483499,Liam Ohgren,L,MIN,20,58,6,9,15
15,8479439,Jacob MacDonald,D,COL,31,56,6,9,15
15,8477505,Alexander Wennberg,C,SJS,30,64,5,10,15
15,8482062,Cole Smith,L,NSH,29,50,5,10,15
15,8478443,Brandon Carlo,D,BOS,28,64,5,10,15
15,8479026,Philippe Myers,D,TOR,27,51,4,11,15
15,8476525,Colin Miller,D,WPG,32,58,4,11,15
15,8474034,Patrick Maroon,L,CHI,36,59,4,11,15
15,8484149,Gavin Brindley,C,CBJ,20,51,4,11,15
15,8475690,Chris Tanev,D,TOR,35,56,4,11,15
15,8480871,Adam Boqvist,D,FLA,24,67,3,12,15
15,8477365,Connor Clifton,D,BUF,29,61,3,12,15
15,8476856,Mathew Dumba,D,DAL,30,68,2,13,15
15,8479982,Conor Timmins,D,TOR,26,59,2,13,15
15,8475225,Craig Smith,C,CHI,35,52,9,5,14
15,8480025,MacKenzie Entwistle,R,FLA,25,66,6,8,14
15,8478178,Darren Raddysh,D,TBL,28,73,5,9,14
15,8477919,Frederick Gaudreau,C,MIN,31,60,5,9,14
15,8480246,Nick Perbix,D,TBL,26,73,4,10,14
15,8482655,Janis Moser,D,TBL,24,80,3,11,14
15,8482964,Arber Xhekaj,D,MTL,23,46,3,11,14
15,8476372,Nick Seeler,D,PHI,31,52,3,11,14
15,8476874,Olli Maatta,D,DET,30,59,2,12,14
15,8470600,Ryan Suter,D,STL,39,61,1,13,14
15,8482634,Alex Steeves,C,TOR,25,52,1,13,14
15,8479336,Carl Grundstrom,R,SJS,27,51,10,3,13
15,8480845,Rasmus Kupari,C,WPG,24,49,8,5,13
15,8476624,Barclay Goodrow,C,SJS,31,50,6,7,13
15,8476442,Matt Nieto,L,PIT,32,53,6,7,13
15,8482762,Simon Edvinsson,D,DET,21,59,6,7,13
15,8479968,Vinni Lettieri,C,BOS,29,45,6,7,13
15,8481517,Brett Leason,R,ANA,25,54,5,8,13
15,8480058,Pierre-Olivier Joseph,D,STL,25,54,5,8,13
15,8481789,Tye Kartye,L,SEA,23,41,5,8,13
15,8482747,Brennan Othmann,L,NYR,21,40,4,9,13
15,8480878,Nils Lundkvist,D,DAL,24,71,3,10,13
15,8477369,Carson Soucy,D,VAN,30,60,3,10,13
15,8482784,Zach Dean,C,STL,21,41,3,10,13
15,8481167,Brayden Pachal,D,CGY,25,48,3,10,13
15,8480196,Jacob Bryson,D,BUF,27,39,2,11,13
15,8480192,Johnathan Kovacevic,D,NJD,27,53,2,11,13
15,8477938,Haydn Fleury,D,WPG,28,37,8,4,12
15,8481481,Blake Lizotte,C,PIT,27,59,7,5,12
15,8478211,Dryden Hunt,L,CGY,29,52,7,5,12
15,8480441,Trey Fix-Wolansky,R,CBJ,25,41,7,5,12
15,8481028,Martin Pospisil,C,CGY,25,52,5,7,12
15,8479370,Tyson Jost,C,CAR,26,49,4,8,12
15,8481592,Jakob Pelletier,L,CGY,23,37,4,8,12
15,8480157,Calle Rosen,D,COL,30,41,4,8,12
15,8480990,Declan Chisholm,D,MIN,24,41,4,8,12
15,8476867,Brendan Gaunce,C,MIN,30,41,3,9,12
15,8482095,Tyler Kleven,D,OTT,22,48,3,9,12
15,8483466,Kevin Korchinski,D,CHI,20,47,3,9,12
15,8480860,Kevin Bahl,D,CGY,24,53,2,10,12
15,8474568,Luke Schenn,D,NSH,35,46,2,10,12
15,8479986,Kole Lind,R,DAL,26,51,2,10,12
15,8475455,Brenden Dillon,D,NJD,34,63,1,11,12
15,8481122,Simon Benoit,D,TOR,26,32,1,11,12
15,8481537,Nikita Okhotiuk,D,CGY,24,54,6,5,11
15,8478569,Noel Acciari,C,PIT,33,59,6,5,11
15,8484911,Collin Graf,R,SJS,22,41,6,5,11
15,8479371,Dante Fabbro,D,NSH,26,66,5,6,11
15,8482744,James Malatesta,L,CBJ,21,51,5,6,11
15,8480011,Klim Kostin,C,SJS,25,50,5,6,11
15,8481518,Nolan Foote,L,NJD,24,38,5,6,11
15,8477380,Jonny Brodzinski,C,NYR,31,54,4,7,11
15,8482666,Scott Morrow,D,CAR,22,51,4,7,11
15,8474166,Alec Martinez,D,CHI,37,41,2,9,11
15,8477887,Patrick Brown,C,BOS,32,52,2,9,11
15,8481605,Jackson LaCombe,D,ANA,23,34,2,9,11
15,8480796,Martin Fehervary,D,WSH,25,51,1,10,11
15,8484254,Akito Hirose,D,VAN,25,39,0,11,11
15,8479638,Justin Brazeau,R,BOS,26,36,9,1,10
15,8478831,Kevin Stenlund,C,UTA,28,61,9,1,10
15,8482148,Hendrix Lapierre,C,WSH,22,52,6,4,10
15,8483495,Simon Nemec,D,NJD,20,49,6,4,10
15,8481754,Nikita Nesterenko,C,ANA,23,36,6,4,10
15,8482496,Nils Aman,C,VAN,24,34,5,5,10
15,8475177,Calvin de Haan,D,COL,33,40,4,6,10
15,8481161,Jake Christiansen,D,CBJ,25,53,4,6,10
15,8480355,Mark Kastelic,C,BOS,25,55,3,7,10
15,8478421,A.J. Greer,L,FLA,28,63,2,8,10
15,8475750,Jon Merrill,D,MIN,32,66,2,8,10
15,8481598,Philip Broberg,D,EDM,23,43,2,8,10
15,8477851,Jordan Oesterle,D,BOS,32,40,2,8,10
15,8476952,Dominic Toninato,C,WPG,30,44,2,8,10
15,8478409,Anthony Richard,C,PHI,28,27,1,9,10
15,8478468,Jeremy Lauzon,D,NSH,27,55,0,10,10
15,8479520,Brandon Duhaime,R,WSH,27,51,7,2,9
15,8478017,Mark Friedman,D,VAN,29,46,7,2,9
15,8477931,Tomas Nosek,L,FLA,32,60,6,3,9
15,8479066,Ryan Lomberg,L,CGY,30,66,5,4,9
15,8481147,Reese Johnson,C,MIN,26,45,5,4,9
15,8481556,John Beecher,C,BOS,23,34,5,4,9
15,8479442,Troy Stecher,D,EDM,30,53,4,5,9
15,8481599,Victor Soderstrom,D,UTA,23,52,3,6,9
15,8473446,Erik Johnson,D,PHI,36,50,3,6,9
15,8480007,Jonas Rondbjerg,R,VGK,25,46,3,6,9
15,8481600,Tobias Bjornfot,D,FLA,23,50,3,6,9
15,8479348,Kale Clague,D,BUF,26,48,3,6,9
15,8474090,Brendan Smith,D,DAL,35,47,3,6,9
15,8471677,Jack Johnson,D,CBJ,37,66,3,6,9
15,8478859,Niko Mikkola,D,FLA,28,50,2,7,9
15,8476473,Connor Murphy,D,CHI,31,34,2,7,9
15,8474612,Travis Hamonic,D,OTT,34,50,2,7,9
15,8482751,Ryan Winterton,C,SEA,21,42,2,7,9
15,8477979,Nicolas Aube-Kubel,R,BUF,28,54,1,8,9
15,8481701,Santeri Hatakka,D,NJD,23,36,1,8,9
15,8476441,Joel Edmundson,D,LAK,31,42,0,9,9
15,8479981,Jonah Gadjovich,L,FLA,26,40,7,1,8
15,8481567,Henry Thrun,D,SJS,23,51,5,3,8
15,8480870,Bo Groulx,C,NYR,24,37,5,3,8
15,8482659,Josh Doan,R,UTA,22,50,4,4,8
15,8477962,Brendan Lemieux,L,CAR,28,37,4,4,8
15,8482166,Shakir Mukhamadullin,D,SJS,22,47,3,5,8
15,8481550,Adam Beckman,L,NJD,23,37,3,5,8
15,8477482,Zachary Sanford,L,CHI,30,36,3,5,8
15,8479536,Axel Jonsson-Fjallby,L,WPG,26,24,3,5,8
15,8482652,Walker Duehr,R,CGY,27,41,2,6,8
15,8480950,Ilya Lyubushkin,D,DAL,30,63,2,6,8
15,8482451,Mikael Pyyhtia,L,CBJ,23,39,2,6,8
15,8482859,Zack Ostapchuk,C,OTT,21,48,2,6,8
15,8478452,Caleb Jones,D,LAK,27,44,2,6,8
15,8480879,Jacob Bernard-Docker,D,OTT,24,44,2,6,8
15,8483619,Filip Roos,D,OTT,25,36,2,6,8
15,8482177,Marat Khusnutdinov,C,MIN,22,34,2,6,8
15,8478146,Matthew Highmore,C,OTT,28,39,2,6,8
15,8480070,Ian Mitchell,D,BOS,25,48,1,7,8
15,8479372,Joshua Mahura,D,SEA,26,49,0,8,8
15,8471817,Ryan Reaves,R,TOR,37,52,5,2,7
15,8479994,Jaret Anderson-Dolan,C,WPG,25,37,5,2,7
15,8477034,Jaycob Megna,D,FLA,32,41,4,3,7
15,8479378,Logan Stanley,D,WPG,26,46,4,3,7
15,8482061,Brandon Biro,L,SEA,26,22,4,3,7
15,8483630,Pavol Regenda,L,ANA,25,31,3,4,7
15,8483460,David Jiricek,D,CBJ,21,62,3,4,7
15,8479985,Cale Fleury,D,SEA,26,36,3,4,7
15,8479772,Zack MacEwen,R,OTT,28,54,3,4,7
15,8479379,Givani Smith,R,SJS,26,27,2,5,7
15,8477401,John Hayden,C,SEA,29,29,2,5,7
15,8482861,Vincent Iorio,D,WSH,22,31,2,5,7
15,8480727,Zach Whitecloud,D,VGK,28,39,1,6,7
15,8479671,Mathieu Olivier,R,CBJ,27,49,1,6,7
15,8479291,Kevin Rooney,C,CGY,31,54,1,6,7
15,8479359,Beck Malenstyn,L,BUF,26,48,1,6,7
15,8478874,Adam Gaudette,R,OTT,28,37,1,6,7
15,8482858,Ryker Evans,D,SEA,23,20,1,6,7
15,8475208,Brian Dumoulin,D,ANA,33,67,0,7,7
15,8482153,Brendan Brisson,C,VGK,23,40,5,1,6
15,8475235,Nicolas Deslauriers,L,PHI,33,48,4,2,6
15,8482201,Gage Goncalves,C,TBL,23,21,4,2,6
15,8480848,Ty Dellandrea,C,SJS,24,41,3,3,6
15,8483397,Marc McLaughlin,C,BOS,25,26,3,3,6
15,8474567,Zach Bogosian,D,MIN,34,60,3,3,6
15,8482765,Isak Rosen,R,BUF,21,31,3,3,6
15,8479944,Zach Aston-Reese,C,VGK,30,44,3,3,6
15,8482733,Logan Mailloux,D,MTL,31,30,3,3,6
15,8479587,Rhett Gardner,C,PHI,28,24,1,5,6
15,8478454,Noah Juulsen,D,VAN,27,36,0,6,6
15,8475762,Derek Forbort,D,VAN,32,43,0,6,6
15,8478424,Jansen Harkins,C,ANA,27,48,4,1,5
15,8482145,Mavrik Bourque,C,DAL,22,47,4,1,5
15,8482070,Mitchell Chaffee,R,TBL,26,51,4,1,5
15,8483570,Ben Meyers,C,SEA,26,30,4,1,5
15,8476858,Phillip Di Giuseppe,L,VAN,31,44,3,2,5
15,8481065,Angus Crookshank,L,OTT,25,16,3,2,5
15,8480844,Grigori Denisenko,L,VGK,24,35,2,3,5
15,8478021,William Lagesson,D,DET,28,24,2,3,5
15,8481743,Marc Del Gaizo,D,NSH,25,25,2,3,5
15,8478450,Parker Wotherspoon,D,BOS,27,33,1,4,5
15,8479972,Mason Shaw,C,WPG,26,38,1,4,5
15,8483549,Lucas Condotta,L,MTL,27,33,1,4,5
15,8480267,Sammy Walker,C,MIN,25,18,1,4,5
15,8476967,Brett Kulak,D,EDM,30,59,0,5,5
15,8474013,Ian Cole,D,UTA,35,55,0,5,5
15,8477244,Chad Ruhwedel,D,NYR,34,32,0,5,5
15,8480084,Nick DeSimone,D,NJD,30,20,0,5,5
15,8483012,Logan Morrison,C,SEA,22,35,3,1,4
15,8481237,Kyle MacLean,C,NYI,25,33,3,1,4
15,8480252,Cole Guttman,C,CHI,25,36,2,2,4
15,8481609,Vladislav Kolyachonok,D,UTA,23,29,2,2,4
15,8481422,Jake Lucchini,C,NSH,29,23,2,2,4
15,8477073,Kurtis MacDermid,L,NJD,30,24,2,2,4
15,8477070,Liam O'Brien,C,UTA,30,56,2,2,4
15,8481679,Maxence Guenette,D,OTT,23,30,1,3,4
15,8480245,Olle Lycksell,R,PHI,25,31,1,3,4
15,8477527,Ross Johnston,L,ANA,30,25,1,3,4
15,8482511,Mason Lohrei,D,BOS,23,30,1,3,4
15,8475958,Michael Sgarbossa,C,WSH,32,28,1,3,4
15,8484258,Sam Malinski,D,COL,26,22,1,3,4
15,8481056,Spencer Stastney,D,NSH,24,28,1,3,4
15,8475795,Dylan McIlrath,D,WSH,32,19,1,3,4
15,8483763,Maksymilian Szuber,D,UTA,22,28,1,3,4
15,8480834,Ty Emberson,D,SJS,24,30,1,3,4
15,8477384,Joshua Brown,D,EDM,30,42,0,4,4
15,8479576,Vincent Desharnais,D,VAN,28,39,0,4,4
15,8480292,Carson Meyer,R,ANA,27,22,0,4,4
15,8479991,Jake Leschyshyn,C,NYR,25,30,0,4,4
15,8477810,Joel Hanley,D,CGY,33,17,0,4,4
15,8481543,Nikita Alexandrov,C,STL,24,21,3,0,3
15,8482141,Lukas Cormier,D,VGK,22,21,2,1,3
15,8482147,Jean-Luc Foudy,C,COL,22,24,2,1,3
15,8481719,Maxwell Crozier,D,TBL,24,15,2,1,3
15,8477462,Robert Hagg,D,VGK,29,27,2,1,3
15,8482172,Landon Slaggert,L,CHI,22,28,2,1,3
15,8480880,Jakub Lauko,C,MIN,24,26,1,2,3
15,8482713,Mackie Samoskevich,R,FLA,22,36,1,2,3
15,8480032,Shane Bowers,C,NJD,25,17,1,2,3
15,8481541,Samuel Bolduc,D,NYI,24,27,1,2,3
15,8478502,Dennis Gilbert,D,BUF,28,18,0,3,3
15,8481593,Jayden Struble,D,MTL,23,25,0,3,3
15,8477971,Andreas Englund,D,LAK,28,29,0,3,3
15,8480890,Jan Jenik,C,OTT,24,26,0,3,3
15,8479362,Riley Tufte,L,BOS,26,17,2,0,2
15,8484325,Waltteri Merela,C,TBL,26,25,2,0,2
15,8482088,Justin Sourdif,R,FLA,22,17,2,0,2
15,8477335,Kyle Burroughs,D,LAK,29,36,1,1,2
15,8477320,Anton Blidh,L,NYR,29,17,1,1,2
15,8480851,Akil Thomas,C,LAK,24,16,1,1,2
15,8481206,John Ludvig,D,PIT,24,11,1,1,2
15,8481699,Aku Raty,R,UTA,23,15,1,1,2
15,8480075,Cameron Crotty,D,MIN,25,9,1,1,2
15,8482102,Vasily Ponomarev,C,PIT,22,16,1,1,2
15,8479320,Maxime Lajoie,D,SEA,27,16,0,2,2
15,8476913,Devin Shore,C,MIN,30,28,0,2,2
15,8481564,Ryan Johnson,D,BUF,23,16,0,2,2
15,8483489,Fraser Minten,C,TOR,31,11,0,2,2
15,8479419,Brett Murray,L,BUF,26,18,0,2,2
15,8474062,Riley Nash,C,NYR,35,16,0,2,2
15,8484304,Uvis Balinskis,D,FLA,28,14,0,2,2
15,8480823,Alexander Alexeyev,D,WSH,25,12,0,2,2
15,8475413,Justin Dowling,C,NJD,34,21,0,2,2
15,8483395,Arshdeep Bains,L,VAN,23,11,0,2,2
15,8483471,Brad Lambert,C,WPG,31,13,0,2,2
15,8483512,Matthew Savoie,C,EDM,20,20,1,0,1
15,8482165,Yan Kuznetsov,D,CGY,22,14,1,0,1
15,8480306,Grant Hutton,D,NYI,29,3,1,0,1
15,8477473,Justin Bailey,R,SJS,29,24,1,0,1
15,8482144,Jack Thompson,D,SJS,22,26,1,0,1
15,8481578,Graeme Clarke,R,MIN,23,10,1,0,1
15,8484287,Cole McWard,D,VAN,23,15,1,0,1
15,8478051,Max Willman,C,NJD,29,19,1,0,1
15,8481585,Egor Afanasyev,L,SJS,23,13,1,0,1
15,8482162,Roby Jarventie,L,EDM,22,14,1,0,1
15,8475780,Chris Wagner,R,COL,33,12,1,0,1
15,8481024,Linus Karlsson,C,VAN,25,7,1,0,1
15,8482476,Emil Heineman,L,MTL,23,5,1,0,1
15,8481726,Adam Edstrom,C,NYR,24,2,1,0,1
15,8482470,Ilya Solovyov,D,CGY,24,23,1,0,1
15,8477993,Justin Kirkland,C,CGY,28,5,1,0,1
15,8479522,Hardy Haman Aktell,D,WSH,26,4,1,0,1
15,8483531,Brian Halonen,L,NJD,25,3,1,0,1
15,8478477,Mitchell Stephens,C,SEA,27,21,0,1,1
15,8482250,Callahan Burke,C,VGK,27,30,0,1,1
15,8480874,Adam Ginning,D,PHI,24,8,0,1,1
15,8482929,Emil Lilleberg,D,TBL,23,21,0,1,1
15,8477541,Dakota Mermis,D,TOR,30,11,0,1,1
15,8483920,Pierrick Dube,R,WSH,23,3,0,1,1
15,8479367,William Lockwood,R,FLA,26,19,0,1,1
15,8482787,Nikita Chibrikov,R,WPG,31,2,0,1,1
15,8481043,Cole Koepke,L,BOS,26,16,0,1,1
15,8477149,Scott Sabourin,R,SJS,32,9,0,1,1
15,8484255,Jason Polin,R,COL,25,4,0,1,1
15,8483609,Adam Klapka,R,CGY,24,2,0,1,1
15,8484326,Patrik Koch,D,UTA,28,2,0,1,1
15,8477467,Gustav Olofsson,D,SEA,30,22,0,0,0
15,8482516,Matthew Kessel,D,STL,24,17,0,0,0
15,8480468,James Hamblin,L,EDM,25,16,0,0,0
15,8483567,Georgii Merkulov,C,BOS,24,8,0,0,0
15,8481030,Jack St. Ivany,D,PIT,25,12,0,0,0
15,8482118,Sam Colangelo,R,ANA,23,12,0,0,0
15,8481006,Tyler Tucker,D,STL,24,13,0,0,0
15,8481806,Louis Crevier,D,CHI,23,14,0,0,0
15,8478011,Louie Belpedio,D,PHI,28,13,0,0,0
15,8478446,Glenn Gawdin,C,LAK,27,7,0,0,0
15,8483398,Declan Carlile,D,TBL,31,4,0,0,0
15,8478881,Brett Seney,L,CHI,28,11,0,0,0
15,8475755,Alexander Petrovic,D,DAL,32,7,0,0,0
15,8482094,Daemon Hunt,D,MIN,22,13,0,0,0
15,8482460,Matt Rempe,C,NYR,22,16,0,0,0
15,8479421,Jacob Moverare,D,LAK,26,9,0,0,0
15,8483597,Milos Kelemen,L,UTA,25,12,0,0,0
15,8483407,Brandon Scanlin,D,NYR,25,5,0,0,0
15,8481462,Mason Morelli,L,VGK,28,10,0,0,0
15,8483546,Marshall Rifai,D,TOR,26,2,0,0,0
15,8478854,Ryan Shea,D,PIT,27,10,0,0,0
15,8481655,Cole Schwindt,R,CGY,23,6,0,0,0
15,8479330,Brandon Gignac,C,MTL,27,6,0,0,0
15,8478147,Bokondji Imama,L,PIT,28,5,0,0,0
15,8476323,Max McCormick,L,SEA,32,2,0,0,0
15,8484259,Ondrej Pavel,C,COL,31,5,0,0,0
15,8482197,Adam Raska,R,MIN,23,6,0,0,0
15,8481534,Raphael Lavoie,C,EDM,24,3,0,0,0
15,8483432,Luca Del Bel Belluz,C,CBJ,31,2,0,0,0
15,8483401,Marc Johnstone,R,PIT,28,4,0,0,0
15,8484321,Nikolas Matinpalo,D,OTT,26,3,0,0,0
15,8482126,Emil Andrae,D,PHI,31,2,0,0,0
15,8470794,Joe Pavelski,C,,40,0,0,0,0
15,8479321,Lucas Johansen,D,,27,0,0,0,0
15,8477950,Tony DeAngelo,D,,29,0,0,0,0
15,8471218,Blake Wheeler,R,,38,0,0,0,0
15,8475197,Tyson Barrie,D,,33,0,0,0,0
15,8474157,Max Pacioretty,L,,36,0,0,0,0
15,8475744,Evgeny Kuznetsov,C,,32,0,0,0,0
15,8474037,James van Riemsdyk,L,,35,0,0,0,0
15,8476907,Mackenzie MacEachern,L,,30,0,0,0,0
15,8480216,Jacob Peterson,C,,25,0,0,0,0
15,8474602,Justin Schultz,D,,34,0,0,0,0
15,8482222,Alexander Barabanov,L,,30,0,0,0,0
15,8474031,Kevin Shattenkirk,D,,35,0,0,0,0
15,8477330,Dominik Kubalik,L,,29,0,0,0,0
15,8480884,Calen Addison,D,,24,0,0,0,0
15,8475906,John Klingberg,D,,32,0,0,0,0
15,8480008,Adam Ruzicka,C,,25,0,0,0,0
15,8476884,Derrick Pouliot,D,,30,0,0,0,0
15,8476919,Chris Tierney,C,,30,0,0,0,0
15,8479415,Michael McLeod,C,,26,0,0,0,0
15,8474870,Tyler Johnson,C,,34,0,0,0,0
15,8470604,Jeff Carter,C,,39,0,0,0,0
15,8478104,Sammy Blais,L,,28,0,0,0,0
15,8474884,Mike Hoffman,C,,35,0,0,0,0
15,8481591,Sam Poulin,R,,23,0,0,0,0
15,8471274,Alex Goligoski,D,,39,0,0,0,0
15,8476871,Tanner Pearson,L,,32,0,0,0,0
15,8476393,Nick Cousins,C,,31,0,0,0,0
15,8479977,Kailer Yamamoto,R,,26,0,0,0,0
15,8479346,Dillon Dube,C,,26,0,0,0,0
15,8480184,Gustav Lindstrom,D,,26,0,0,0,0
15,8479376,Victor Mete,D,,26,0,0,0,0
15,8473449,Kyle Okposo,R,,36,0,0,0,0
15,8481058,Jesse Ylonen,R,,25,0,0,0,0
15,8475752,Tyler Pitlick,C,,33,0,0,0,0
15,8481239,Samuel Fagemo,L,,24,0,0,0,0
15,8480821,Filip Zadina,R,,25,0,0,0,0
15,8470966,Mark Giordano,D,,41,0,0,0,0
15,8478495,Denis Gurianov,R,,27,0,0,0,0
15,8477464,Nic Petan,C,,29,0,0,0,0
15,8478099,Kevin Labanc,R,,29,0,0,0,0
15,8482241,Radim Zohorna,L,,28,0,0,0,0
15,8474040,Sam Gagner,C,,35,0,0,0,0
15,8479514,Rem Pitlick,C,,27,0,0,0,0
15,8478430,Oliver Kylington,D,,27,0,0,0,0
15,8479533,Joona Koppanen,L,,26,0,0,0,0
15,8479984,Cal Foote,D,,26,0,0,0,0
15,8477126,Jayson Megna,C,,34,0,0,0,0
15,8475164,Jakob Silfverberg,R,,34,0,0,0,0
15,8474009,Nick Bonino,C,,36,0,0,0,0
15,8479458,Nikita Zaitsev,D,,33,0,0,0,0
15,8477944,Jakub Vrana,L,,28,0,0,0,0
15,8471699,Andrew Cogliano,C,,37,0,0,0,0
15,8478067,Oskar Lindblom,L,,28,0,0,0,0
15,8471686,Marc Staal,D,,37,0,0,0,0
15,8470610,Zach Parise,L,,40,0,0,0,0
15,8478904,Steven Lorentz,C,,28,0,0,0,0
15,8473473,Milan Lucic,L,,36,0,0,0,0
15,8480031,Maxime Comtois,L,,25,0,0,0,0
15,8478512,Austin Czarnik,C,,32,0,0,0,0
15,8473504,Cal Clutterbuck,R,,37,0,0,0,0
15,8477454,Adam Erne,L,,29,0,0,0,0
15,8479383,Boris Katchouk,L,,26,0,0,0,0
15,8475825,Jani Hakanpää,D,,32,0,0,0,0
15,8477846,Ryan Carpenter,C,,33,0,0,0,0
15,8477930,Pierre-Edouard Bellemare,L,,39,0,0,0,0
15,8478400,Colin White,C,,27,0,0,0,0
15,8480226,Marián Studenic,R,,26,0,0,0,0
15,8480853,Liam Foudy,C,,24,0,0,0,0
15,8475797,Jarred Tinordi,D,,32,0,0,0,0
15,8479423,Alex Nylander,L,,26,0,0,0,0
15,8474618,Marco Scandella,D,,34,0,0,0,0
15,8478028,Fredrik Olofsson,L,,28,0,0,0,0
15,8474709,Matt Martin,L,,35,0,0,0,0
15,8481070,Hugh McGing,L,,26,0,0,0,0
15,8479546,Oskar Steen,C,,26,0,0,0,0
15,8474145,Robert Bortuzzo,D,,35,0,0,0,0
15,8476915,Jujhar Khaira,L,,30,0,0,0,0
15,8480274,Philip Kemp,D,EDM,25,0,0,0,0
15,8475278,Byron Froese,C,,33,0,0,0,0
15,8481812,Nikolai Knyzhov,D,,27,0,0,0,0
15,8478408,Travis Dermott,D,,28,0,0,0,0
15,8481077,John Leonard,L,,26,0,0,0,0
15,8479547,Matthew Phillips,R,,26,0,0,0,0
15,8480836,Jonathan Gruden,C,,24,0,0,0,0
15,8481690,Tyler Angle,C,,24,0,0,0,0
15,8475766,Austin Watson,L,,32,0,0,0,0
15,8481016,Ruslan Iskhakov,C,,24,0,0,0,0
15,8478078,Rourke Chartier,C,,28,0,0,0,0
15,8480776,Sheldon Rempal,R,,29,0,0,0,0
15,8478956,Samuel Laberge,L,NJD,27,0,0,0,0
15,8483045,Cameron Butler,R,CBJ,31,0,0,0,0
15,8484314,Jiri Smejkal,L,,28,0,0,0,0
16,8478402,Connor McDavid,C,EDM,27,79,39,99,138
16,8477934,Leon Draisaitl,C,EDM,29,79,57,76,133
16,8476453,Nikita Kucherov,R,TBL,31,81,46,82,128
16,8477492,Nathan MacKinnon,C,COL,29,82,49,74,123
16,8479314,Matthew Tkachuk,L,FLA,27,80,40,81,121
16,8477956,David Pastrnak,R,BOS,28,81,58,62,120
16,8478864,Kirill Kaprizov,L,MIN,27,70,54,59,113
16,8477939,William Nylander,R,TOR,28,80,48,60,108
16,8478483,Mitch Marner,R,TOR,27,79,31,77,108
16,8479318,Auston Matthews,C,TOR,27,81,65,42,107
16,8478420,Mikko Rantanen,R,COL,28,81,45,58,103
16,8477404,Jake Guentzel,C,TBL,30,81,45,58,103
16,8480027,Jason Robertson,L,DAL,25,82,37,66,103
16,8478550,Artemi Panarin,L,NYR,33,74,44,57,101
16,8481559,Jack Hughes,C,NJD,23,74,35,66,101
16,8476468,J.T. Miller,C,VAN,31,75,29,68,97
16,8482116,Tim Stützle,C,OTT,22,80,28,69,97
16,8475184,Chris Kreider,L,NYR,33,79,54,41,95
16,8477942,Kevin Fiala,L,LAK,28,81,29,66,95
16,8478010,Brayden Point,C,TBL,28,82,52,40,92
16,8480012,Elias Pettersson,C,VAN,26,73,39,53,92
16,8480801,Brady Tkachuk,L,OTT,25,79,32,60,92
16,8476887,Filip Forsberg,L,NSH,30,75,43,48,91
16,8478403,Jack Eichel,C,VGK,28,75,43,48,91
16,8478445,Mathew Barzal,C,NYI,27,81,20,71,91
16,8478398,Kyle Connor,L,WPG,28,72,46,43,89
16,8475172,Nazem Kadri,C,CGY,34,81,35,54,89
16,8477946,Dylan Larkin,C,DET,28,80,52,36,88
16,8480069,Cale Makar,D,COL,26,72,26,62,88
16,8480830,Andrei Svechnikov,R,CAR,24,78,40,47,87
16,8480023,Robert Thomas,C,STL,25,71,26,61,87
16,8477949,Alex Tuch,R,BUF,28,74,31,55,86
16,8477409,Carter Verhaeghe,C,FLA,29,79,42,43,85
16,8479420,Tage Thompson,C,BUF,27,73,45,39,84
16,8479323,Adam Fox,D,NYR,26,73,20,64,84
16,8481557,Matt Boldy,L,MIN,23,72,35,48,83
16,8473419,Brad Marchand,L,BOS,36,81,31,52,83
16,8484144,Connor Bedard,C,CHI,19,73,29,54,83
16,8476454,Ryan Nugent-Hopkins,C,EDM,31,79,28,54,82
16,8478439,Travis Konecny,R,PHI,27,78,27,55,82
16,8475784,Jeff Skinner,C,EDM,32,77,38,43,81
16,8477933,Sam Reinhart,C,FLA,29,77,40,40,80
16,8478427,Sebastian Aho,C,CAR,27,72,36,44,80
16,8476881,Tomas Hertl,C,VGK,31,80,35,45,80
16,8480002,Nico Hischier,C,NJD,25,75,29,50,79
16,8477960,Adrian Kempe,R,LAK,28,82,41,37,78
16,8479343,Clayton Keller,R,UTA,26,76,29,49,78
16,8475168,Matt Duchene,C,DAL,33,82,25,53,78
16,8477493,Aleksander Barkov,C,FLA,29,79,24,54,78
16,8477501,Valeri Nichushkin,R,COL,29,82,37,40,77
16,8476456,Jonathan Huberdeau,C,CGY,31,80,20,57,77
16,8476459,Mika Zibanejad,C,NYR,31,80,26,50,76
16,8476389,Vincent Trocheck,C,NYR,31,76,31,43,74
16,8474600,Roman Josi,D,NSH,34,70,25,49,74
16,8480800,Quinn Hughes,D,VAN,25,75,8,66,74
16,8475754,Brock Nelson,C,NYI,33,78,36,37,73
16,8480208,Drake Batherson,R,OTT,26,80,31,42,73
16,8475166,John Tavares,C,TOR,34,80,30,43,73
16,8475692,Mats Zuccarello,R,MIN,37,76,17,56,73
16,8475786,Zach Hyman,L,EDM,32,78,32,40,72
16,8475810,Bryan Rust,R,PIT,32,74,34,37,71
16,8481528,Dylan Cozens,C,BUF,23,70,30,41,71
16,8477402,Pavel Buchnevich,L,STL,29,69,31,39,70
16,8477951,Nick Schmaltz,C,UTA,28,75,25,45,70
16,8474679,Gustav Nyquist,C,NSH,35,72,24,46,70
16,8473512,Claude Giroux,R,OTT,36,78,24,46,70
16,8471685,Anze Kopitar,C,LAK,37,82,21,49,70
16,8471214,Alex Ovechkin,L,WSH,39,72,36,33,69
16,8478460,Zach Werenski,D,CBJ,27,81,11,58,69
16,8478873,Troy Terry,R,ANA,27,75,30,38,68
16,8476346,Johnny Gaudreau,L,CBJ,31,73,18,50,68
16,8477940,Nikolaj Ehlers,L,WPG,28,74,18,50,68
16,8480865,Noah Dobson,D,NYI,24,80,16,52,68
16,8475794,Tyler Seguin,C,DAL,32,82,35,32,67
16,8471675,Sidney Crosby,C,PIT,37,74,26,41,67
16,8476905,Chandler Stephenson,C,SEA,30,76,23,44,67
16,8478856,Conor Garland,R,VAN,28,76,22,45,67
16,8475913,Mark Stone,R,VGK,32,76,16,51,67
16,8480036,Miro Heiskanen,D,DAL,25,79,11,56,67
16,8482740,Wyatt Johnston,C,DAL,21,81,40,26,66
16,8478449,Roope Hintz,C,DAL,28,82,30,36,66
16,8478493,Joel Eriksson Ek,C,MIN,27,76,25,41,66
16,8478975,Mason Marchment,L,DAL,29,81,24,42,66
16,8475167,Victor Hedman,D,TBL,34,79,11,55,66
16,8474564,Steven Stamkos,C,NSH,34,73,27,38,65
16,8474141,Patrick Kane,R,DET,36,81,23,42,65
16,8471215,Evgeni Malkin,C,PIT,38,75,20,45,65
16,8477500,Bo Horvat,C,NYI,29,77,34,30,64
16,8478444,Brock Boeser,R,VAN,27,67,31,33,64
16,8479542,Brandon Hagel,L,TBL,26,82,35,28,63
16,8476399,Blake Coleman,C,CGY,33,77,34,29,63
16,8477496,Elias Lindholm,C,BOS,30,80,29,34,63
16,8478440,Dylan Strome,C,WSH,27,68,26,37,63
16,8478414,Timo Meier,R,NJD,28,75,34,28,62
16,8479385,Jordan Kyrou,C,STL,26,76,23,39,62
16,8480839,Rasmus Dahlin,D,BUF,24,71,17,45,62
16,8475314,Anders Lee,L,NYI,34,80,34,27,61
16,8480015,Owen Tippett,R,PHI,25,76,33,28,61
16,8474102,David Perron,L,OTT,36,75,28,33,61
16,8482093,Seth Jarvis,C,CAR,22,65,28,33,61
16,8478462,Nicolas Roy,C,VGK,27,77,24,37,61
16,8477416,Oliver Bjorkstrand,R,SEA,29,76,23,38,61
16,8482078,Lucas Raymond,L,DET,22,82,21,40,61
16,8475765,Vladimir Tarasenko,R,DET,33,81,18,43,61
16,8475798,Mikael Granlund,C,SJS,32,72,17,44,61
16,8475726,Tyler Toffoli,C,SJS,32,73,34,26,60
16,8482699,Dylan Guenther,R,UTA,21,77,26,34,60
16,8479407,Jesper Bratt,L,NJD,26,72,22,38,60
16,8478519,Anthony Cirelli,C,TBL,27,82,18,42,60
16,8474578,Erik Karlsson,D,PIT,34,78,8,52,60
16,8482665,Matty Beniers,C,SEA,22,77,23,36,59
16,8484145,Zach Benson,L,BUF,19,69,18,41,59
16,8476460,Mark Scheifele,C,WPG,31,75,36,22,58
16,8475151,Kyle Palmieri,C,NYI,33,77,31,27,58
16,8478401,Pavel Zacha,C,BOS,27,78,22,36,58
16,8473994,Jamie Benn,L,DAL,35,81,22,36,58
16,8479999,Casey Mittelstadt,C,COL,26,79,16,42,58
16,8476479,Phillip Danault,C,LAK,31,82,15,43,58
16,8482684,Luke Hughes,D,NJD,21,70,13,45,58
16,8476853,Morgan Rielly,D,TOR,30,73,9,49,58
16,8474150,Mikael Backlund,C,CGY,35,78,24,33,57
16,8478469,Thomas Chabot,D,OTT,27,79,21,36,57
16,8476906,Shayne Gostisbehere,D,CAR,31,79,13,44,57
16,8476882,Teuvo Teravainen,C,CHI,30,71,26,30,56
16,8480018,Nick Suzuki,C,MTL,25,75,25,31,56
16,8482109,Alexis Lafrenière,L,NYR,23,78,24,32,56
16,8480803,Evan Bouchard,D,EDM,25,75,7,49,56
16,8479337,Alex DeBrincat,R,DET,27,79,23,32,55
16,8478047,Michael Bunting,L,PIT,29,75,32,22,54
16,8479675,Trevor Moore,L,LAK,29,80,29,25,54
16,8476438,Brandon Saad,L,STL,32,75,29,25,54
16,8481068,Yegor Sharangovich,C,CGY,26,75,28,26,54
16,8477935,Sam Bennett,C,FLA,28,77,27,27,54
16,8477964,Ivan Barbashev,C,VGK,29,78,25,29,54
16,8477429,Andrew Copp,C,DET,30,77,20,34,54
16,8476462,Dougie Hamilton,D,NJD,31,68,19,35,54
16,8475158,Ryan O'Reilly,C,NSH,33,74,17,37,54
16,8477447,Shea Theodore,D,VGK,29,61,9,45,54
16,8474641,Adam Henrique,C,EDM,34,76,28,25,53
16,8482745,Mason McTavish,C,ANA,21,70,27,26,53
16,8481540,Cole Caufield,R,MTL,23,73,23,30,53
16,8476539,Jonathan Marchessault,R,NSH,34,75,22,31,53
16,8476448,William Karlsson,C,VGK,31,76,21,32,53
16,8478542,Evan Rodrigues,C,FLA,31,76,20,33,53
16,8476483,Rickard Rakell,R,PIT,31,68,33,19,52
16,8478498,Jake DeBrusk,L,VAN,28,72,29,23,52
16,8480064,Josh Norris,C,OTT,25,73,27,25,52
16,8477955,Jared McCann,L,SEA,28,71,23,29,52
16,8476419,Jean-Gabriel Pageau,C,NYI,32,77,22,30,52
16,8475170,Brayden Schenn,C,STL,33,74,17,35,52
16,8477497,Sean Monahan,C,CBJ,30,70,16,36,52
16,8475745,Charlie Coyle,C,BOS,32,80,15,37,52
16,8482712,Oskar Olausson,R,COL,22,77,11,41,52
16,8474565,Alex Pietrangelo,D,VGK,34,61,17,34,51
16,8477504,Josh Morrissey,D,WPG,29,73,11,40,51
16,8477346,MacKenzie Weegar,D,CGY,30,76,8,43,51
16,8479425,Filip Hronek,D,VAN,27,75,8,43,51
16,8482159,Tyson Foerster,R,PHI,22,76,28,22,50
16,8480798,Philipp Kurashev,C,CHI,25,58,19,31,50
16,8483515,Juraj Slafkovsky,L,MTL,20,76,15,35,50
16,8480188,Fabian Zetterlund,L,SJS,25,66,15,35,50
16,8478038,Devon Toews,D,COL,30,65,14,36,50
16,8474586,Jordan Eberle,R,SEA,34,74,19,30,49
16,8477998,Warren Foegele,L,LAK,28,82,23,25,48
16,8484153,Leo Carlsson,C,ANA,20,68,23,25,48
16,8478042,Viktor Arvidsson,L,EDM,31,69,20,28,48
16,8477456,J.T. Compher,L,DET,29,78,17,31,48
16,8484166,Adam Fantilli,C,CBJ,20,72,21,26,47
16,8483431,Logan Cooley,C,UTA,20,76,21,26,47
16,8477479,Tyler Bertuzzi,L,CHI,29,66,20,27,47
16,8480039,Martin Necas,C,CAR,25,73,17,30,47
16,8477503,Max Domi,C,TOR,29,77,12,35,47
16,8479410,Mikhail Sergachev,D,UTA,26,67,11,36,47
16,8478366,Frank Vatrano,R,ANA,30,69,26,20,46
16,8481560,Arthur Kaliyev,R,LAK,23,76,22,24,46
16,8477451,Ryan Hartman,R,MIN,30,62,21,25,46
16,8479525,Ross Colton,C,COL,28,81,21,25,46
16,8476875,Mike Matheson,D,MTL,30,78,12,34,46
16,8478407,Vince Dunn,D,SEA,28,71,7,39,46
16,8477407,Anthony Duclair,L,NYI,29,76,20,25,45
16,8482124,Quinton Byfield,R,LAK,22,76,20,25,45
16,8477511,Anthony Mantha,R,CGY,30,76,20,25,45
16,8475753,Justin Faulk,D,STL,32,71,7,38,45
16,8476880,Tom Wilson,R,WSH,30,64,23,21,44
16,8476432,Boone Jenner,C,CBJ,31,67,23,21,44
16,8475714,Calle Jarnkrok,C,TOR,33,76,20,24,44
16,8477495,Seth Jones,D,CHI,30,69,8,36,44
16,8475169,Evander Kane,L,EDM,33,75,20,23,43
16,8482113,Anton Lundell,C,FLA,23,76,15,28,43
16,8471724,Kris Letang,D,PIT,37,80,13,30,43
16,8479345,Jakob Chychrun,D,WSH,26,69,12,31,43
16,8483490,Pavel Mintyukov,D,ANA,21,76,12,31,43
16,8478055,Gustav Forsling,D,FLA,28,66,11,32,43
16,8474590,John Carlson,D,WSH,34,65,9,34,43
16,8479325,Charlie McAvoy,D,BOS,27,75,5,38,43
16,8478463,Anthony Beauvillier,L,PIT,27,72,22,20,42
16,8482110,Dawson Mercer,C,NJD,23,74,20,22,42
16,8477426,Nicholas Paul,L,TBL,29,82,19,23,42
16,8482667,William Eklund,L,SJS,22,67,18,24,42
16,8481711,Matias Maccelli,L,UTA,24,76,15,27,42
16,8478396,Noah Hanifin,D,VGK,27,64,14,28,42
16,8479987,Morgan Geekie,C,BOS,26,79,12,30,42
16,8477444,Andre Burakovsky,L,SEA,29,77,11,31,42
16,8478438,Tommy Novak,C,NSH,27,67,10,32,42
16,8478397,Rasmus Andersson,D,CGY,28,72,9,33,42
16,8475764,Cam Fowler,D,ANA,33,78,5,37,42
16,8483808,Andrei Kuzmenko,L,CGY,28,73,24,17,41
16,8481596,Shane Pinto,C,OTT,24,80,23,18,41
16,8479992,Michael Rasmussen,C,DET,25,79,21,20,41
16,8481618,Alex Newhook,C,MTL,23,77,21,20,41
16,8482092,Ridly Greig,C,OTT,22,77,20,21,41
16,8477494,Jonathan Drouin,L,COL,29,82,19,22,41
16,8481604,Pavel Dorofeyev,L,VGK,24,72,18,23,41
16,8480028,Morgan Frost,C,PHI,25,72,12,29,41
16,8478472,Mathieu Joseph,R,STL,27,72,12,29,41
16,8476292,Ondrej Palat,L,NJD,33,67,12,29,41
16,8476923,Damon Severson,D,CBJ,30,81,9,32,41
16,8477948,Travis Sanheim,D,PHI,28,68,5,36,41
16,8482175,JJ Peterka,R,BUF,22,72,21,19,40
16,8476826,Yanni Gourde,C,SEA,33,69,18,22,40
16,8475768,Jaden Schwartz,C,SEA,32,67,17,23,40
16,8477021,Alex Kerfoot,C,UTA,30,78,15,25,40
16,8481581,Thomas Harley,D,DAL,23,76,13,27,40
16,8477986,Brandon Montour,D,SEA,30,68,12,28,40
16,8474053,Logan Couture,C,SJS,35,64,9,31,40
16,8481546,Cam York,D,PHI,23,69,9,31,40
16,8476792,Torey Krug,D,STL,33,70,8,32,40
16,8479400,Pierre-Luc Dubois,L,WSH,26,71,17,22,39
16,8480185,Eetu Luostarinen,C,FLA,26,72,17,22,39
16,8482097,Jack Quinn,R,BUF,23,66,10,29,39
16,8482671,Owen Power,D,BUF,22,67,10,29,39
16,8477969,Marcus Pettersson,D,PIT,28,79,7,32,39
16,8474563,Drew Doughty,D,LAK,35,70,6,33,39
16,8477476,Artturi Lehkonen,L,COL,29,78,19,19,38
16,8480220,Noah Cates,L,PHI,25,77,18,20,38
16,8476458,Ryan Strome,C,ANA,31,69,16,22,38
16,8481577,Philip Tomasino,C,NSH,23,68,13,25,38
16,8470613,Brent Burns,D,CAR,39,76,7,31,38
16,8476958,Jaccob Slavin,D,CAR,30,76,6,32,38
16,8478466,Daniel Sprong,R,VAN,27,69,21,16,37
16,8480459,Pius Suter,C,VAN,28,69,20,17,37
16,8475799,Nino Niederreiter,R,WPG,32,67,18,19,37
16,8474149,Evgenii Dadonov,R,DAL,35,80,18,19,37
16,8479365,Trent Frederic,C,BOS,26,72,18,19,37
16,8479316,Luke Kunin,C,SJS,27,59,18,19,37
16,8480014,Gabriel Vilardi,C,WPG,25,67,17,20,37
16,8482702,Logan Stankoven,C,DAL,21,79,17,20,37
16,8480797,Joel Farabee,L,PHI,24,71,15,22,37
16,8471698,T.J. Oshie,R,WSH,38,67,12,25,37
16,8478115,Pierre Engvall,L,NYI,28,78,11,26,37
16,8482122,Brock Faber,D,MIN,22,76,5,32,37
16,8476917,Adam Pelech,D,NYI,30,81,4,33,37
16,8482475,Yegor Chinakhov,R,CBJ,23,65,15,21,36
16,8477505,Alexander Wennberg,C,SJS,30,64,15,21,36
16,8479591,Michael Eyssimont,C,TBL,28,82,12,24,36
16,8482720,Matthew Knies,L,TOR,22,73,11,25,36
16,8477498,Darnell Nurse,D,EDM,29,79,10,26,36
16,8481533,Trevor Zegras,C,ANA,23,70,10,26,36
16,8475722,Jason Zucker,L,BUF,32,73,15,20,35
16,8482146,Luke Evangelista,R,NSH,22,66,14,21,35
16,8475763,Kevin Hayes,R,PIT,32,65,14,21,35
16,8479339,Patrik Laine,L,CBJ,26,68,14,21,35
16,8480043,Timothy Liljegren,D,TOR,25,69,6,29,35
16,8478474,Lawson Crouse,L,UTA,27,75,18,16,34
16,8480789,Oliver Wahlstrom,R,NYI,24,75,17,17,34
16,8480009,Eeli Tolvanen,R,SEA,25,71,17,17,34
16,8480802,Ryan McLeod,C,BUF,25,64,16,18,34
16,8476480,Vladislav Namestnikov,C,WPG,32,63,16,18,34
16,8477947,Sonny Milano,L,WSH,28,65,15,19,34
16,8476392,Adam Lowry,C,WPG,31,67,15,19,34
16,8473533,Jordan Staal,C,CAR,36,61,15,19,34
16,8478020,Michael Amadio,R,OTT,28,72,13,21,34
16,8476872,Scott Laughton,C,PHI,30,76,11,23,34
16,8476854,Hampus Lindholm,D,BOS,30,77,11,23,34
16,8480145,Neal Pionk,D,WPG,29,76,10,24,34
16,8475218,Mattias Ekholm,D,EDM,34,70,9,25,34
16,8481606,Jordan Spence,D,LAK,23,65,8,26,34
16,8475287,Erik Haula,L,NJD,33,73,16,17,33
16,8481580,Connor McMichael,C,WSH,23,69,15,18,33
16,8479661,Tanner Jeannot,L,LAK,27,79,15,18,33
16,8475791,Taylor Hall,L,CHI,33,56,14,19,33
16,8476461,Sean Couturier,C,PHI,32,74,13,20,33
16,8484203,Bradly Nadeau,L,CAR,19,64,12,21,33
16,8481542,Moritz Seider,D,DET,23,78,6,27,33
16,8482624,Daniil Miromanov,D,CGY,27,65,6,27,33
16,8475848,Brendan Gallagher,R,MTL,32,68,14,18,32
16,8478891,Mason Appleton,C,WPG,28,62,14,18,32
16,8481535,Nils Hoglander,L,VAN,24,71,14,18,32
16,8473986,Alex Killorn,L,ANA,35,70,13,19,32
16,8479315,Joey Anderson,R,CHI,26,60,13,19,32
16,8477987,Ryan Donato,C,CHI,28,64,12,20,32
16,8480336,Sean Walker,D,CAR,30,75,11,21,32
16,8474716,Jared Spurgeon,D,MIN,35,76,11,21,32
16,8481656,Aliaksei Protas,C,WSH,23,59,10,22,32
16,8477952,Robby Fabbri,C,ANA,28,64,8,24,32
16,8478046,Danton Heinen,L,VAN,29,70,15,16,31
16,8482074,Connor Zary,C,CGY,23,69,13,18,31
16,8475191,Reilly Smith,R,NYR,33,73,12,19,31
16,8476885,Jacob Trouba,D,NYR,30,71,8,23,31
16,8473507,Jeff Petry,D,DET,37,67,5,26,31
16,8480434,Sean Durzi,D,UTA,26,68,4,27,31
16,8483505,Matthew Poitras,C,BOS,20,79,15,15,30
16,8482125,Alexander Holtz,R,VGK,22,71,15,15,30
16,8480113,Alex Iafallo,L,WPG,31,66,13,17,30
16,8480829,Jesperi Kotkaniemi,C,CAR,24,61,12,18,30
16,8482679,Matt Coronato,R,CGY,22,64,12,18,30
16,8481524,Bowen Byram,D,BUF,23,61,10,20,30
16,8478458,John (Jack) Roslovic,C,CAR,27,64,10,20,30
16,8475200,Dmitry Orlov,D,CAR,33,77,9,21,30
16,8479351,Sam Steel,C,DAL,26,80,8,22,30
16,8482660,Kent Johnson,C,CBJ,22,64,8,22,30
16,8477932,Aaron Ekblad,D,FLA,28,73,7,23,30
16,8480817,K'Andre Miller,D,NYR,24,72,5,25,30
16,8478507,John Marino,D,UTA,27,69,4,26,30
16,8476967,Brett Kulak,D,EDM,30,68,4,26,30
16,8482055,Drew O'Connor,L,PIT,26,65,19,10,29
16,8482089,Jake Neighbours,L,STL,22,71,17,12,29
16,8477839,Conor Sheary,L,TBL,32,81,14,15,29
16,8475193,Tomas Tatar,L,NJD,34,71,12,17,29
16,8477488,Brett Pesce,D,NJD,30,72,10,19,29
16,8481523,Kirby Dach,C,MTL,23,63,9,20,29
16,8478413,Jordan Greenway,L,BUF,27,55,8,21,29
16,8474189,Lars Eller,C,PIT,35,62,8,21,29
16,8476891,Matthew Grzelcyk,D,PIT,30,76,7,22,29
16,8481014,Alexander Romanov,D,NYI,24,78,5,24,29
16,8482655,Janis Moser,D,TBL,24,72,5,24,29
16,8474151,Ryan McDonagh,D,TBL,35,78,2,27,29
16,8481186,Logan O'Connor,R,COL,28,79,17,11,28
16,8475760,Nick Bjugstad,C,UTA,32,70,16,12,28
16,8480074,Alexandre Texier,C,STL,25,57,15,13,28
16,8480078,Filip Chytil,C,NYR,25,69,14,14,28
16,8481601,Simon Holmstrom,R,NYI,23,66,14,14,28
16,8477353,Tyler Motte,C,DET,29,76,13,15,28
16,8478013,Jake Walman,D,SJS,28,69,13,15,28
16,8480068,Ryan Poehling,C,PHI,25,69,11,17,28
16,8482101,Danil Gushchin,L,SJS,22,57,11,17,28
16,8482749,Joshua Roy,R,MTL,21,64,11,17,28
16,8479353,Brett Howden,C,VGK,26,67,11,17,28
16,8476474,Stefan Noesen,R,NJD,31,67,10,18,28
16,8482149,Cole Perfetti,C,WPG,22,67,9,19,28
16,8477392,Hudson Fasching,R,NYI,29,64,9,19,28
16,8479639,Dylan Coghlan,D,WPG,26,69,5,23,28
16,8478882,Vladislav Gavrikov,D,LAK,29,71,3,25,28
16,8476925,Colton Sissons,C,NSH,31,62,12,15,27
16,8475149,Marcus Johansson,L,MIN,34,63,12,15,27
16,8478109,Victor Olofsson,L,VGK,29,67,12,15,27
16,8482133,Thomas Bordeleau,C,SJS,22,60,8,19,27
16,8481703,Valtteri Puustinen,R,PIT,25,60,5,22,27
16,8477506,Ryan Pulock,D,NYI,30,80,5,22,27
16,8479398,Samuel Girard,D,COL,26,68,2,25,27
16,8482705,Cole Sillinger,C,CBJ,21,64,18,8,26
16,8481554,Kaapo Kakko,R,NYR,23,66,15,11,26
16,8475220,Marcus Foligno,L,MIN,33,58,15,11,26
16,8478233,Andrew Mangiapane,L,WSH,28,67,14,12,26
16,8480813,Joe Veleno,C,DET,24,79,13,13,26
16,8476374,Sean Kuraly,C,CBJ,31,57,13,13,26
16,8479996,Cody Glass,C,NSH,25,56,12,14,26
16,8479293,Brandon Tanev,L,SEA,33,63,12,14,26
16,8473422,Nick Foligno,L,CHI,37,65,9,17,26
16,8480849,Barrett Hayton,C,UTA,24,68,8,18,26
16,8480835,Jack Drury,C,CAR,24,62,7,19,26
16,8476869,Brady Skjei,D,NSH,30,70,6,20,26
16,8475181,Nick Leddy,D,STL,33,71,6,20,26
16,8476902,Esa Lindell,D,DAL,30,76,4,22,26
16,8476979,Erik Gustafsson,D,DET,32,72,3,23,26
16,8470621,Corey Perry,R,EDM,39,70,14,11,25
16,8474715,Cameron Atkinson,R,TBL,35,80,13,12,25
16,8476918,Jimmy Vesey,L,NYR,31,63,13,12,25
16,8482259,Bobby McMann,C,TOR,28,62,13,12,25
16,8483524,Shane Wright,C,SEA,20,63,12,13,25
16,8476278,Colin Blackwell,C,DAL,31,76,11,14,25
16,8479066,Ryan Lomberg,L,CGY,30,64,11,14,25
16,8477015,Connor Brown,R,EDM,30,61,7,18,25
16,8482067,Connor Mackey,D,NYR,28,70,6,19,25
16,8476422,Mike Reilly,D,NYI,31,77,5,20,25
16,8477369,Carson Soucy,D,VAN,30,64,5,20,25
16,8475793,Ryan Johansen,C,PHI,32,63,13,11,24
16,8482079,Marco Rossi,C,MIN,23,53,13,11,24
16,8480893,Kirill Marchenko,R,CBJ,24,63,13,11,24
16,8477903,Garnet Hathaway,R,PHI,33,67,13,11,24
16,8475855,Jesper Fast,R,CAR,33,67,13,11,24
16,8480748,Kiefer Sherwood,L,VAN,29,58,11,13,24
16,8478432,Christian Fischer,R,DET,27,74,11,13,24
16,8476927,Teddy Blueger,C,VAN,30,65,9,15,24
16,8475231,Casey Cizikas,C,NYI,33,75,8,16,24
16,8475171,Oliver Ekman-Larsson,D,TOR,33,70,6,18,24
16,8476988,Matt Benning,D,SJS,30,68,6,18,24
16,8480871,Adam Boqvist,D,FLA,24,72,6,18,24
16,8470600,Ryan Suter,D,STL,39,67,6,18,24
16,8479976,Juuso Valimaki,D,UTA,26,61,4,20,24
16,8482105,Jake Sanderson,D,OTT,22,73,3,21,24
16,8478500,Ivan Provorov,D,CBJ,27,79,1,23,24
16,8476897,Oskar Sundqvist,C,STL,30,62,12,11,23
16,8483468,Jiri Kulich,C,BUF,20,61,12,11,23
16,8481624,Ilya Mikheyev,R,CHI,30,55,12,11,23
16,8479414,Nathan Bastian,R,NJD,27,59,11,12,23
16,8477953,Kasperi Kapanen,R,STL,28,72,10,13,23
16,8481582,Nicholas Robertson,L,TOR,23,66,9,14,23
16,8478508,Yakov Trenin,C,MIN,27,55,8,15,23
16,8477507,Nikita Zadorov,D,BOS,29,73,7,16,23
16,8480073,Erik Brannstrom,D,COL,25,61,6,17,23
16,8481704,Juuso Parssinen,C,NSH,23,59,6,17,23
16,8478133,Jake Evans,C,MTL,28,65,6,17,23
16,8481568,Alex Vlasic,D,CHI,23,60,5,18,23
16,8477220,Nate Schmidt,D,FLA,33,71,3,20,23
16,8477425,Miles Wood,L,COL,29,73,17,5,22
16,8479941,Justin Danforth,R,CBJ,31,53,14,8,22
16,8478057,Dakota Joshua,C,VAN,28,69,13,9,22
16,8477446,Michael McCarron,R,NSH,29,58,13,9,22
16,8481093,Rafael Harvey-Pinard,L,MTL,25,60,10,12,22
16,8477478,William Carrier,L,CAR,30,57,10,12,22
16,8481522,Peyton Krebs,C,BUF,23,58,10,12,22
16,8481527,Kaedan Korczak,D,VGK,23,51,8,14,22
16,8477989,Christian Dvorak,C,MTL,28,63,7,15,22
16,8476429,Scott Mayfield,D,NYI,32,71,5,17,22
16,8475233,David Savard,D,MTL,34,66,5,17,22
16,8478178,Darren Raddysh,D,TBL,28,69,5,17,22
16,8479983,Mario Ferraro,D,SJS,26,67,4,18,22
16,8474673,TJ Brodie,D,CHI,34,59,3,19,22
16,8480246,Nick Perbix,D,TBL,26,78,3,19,22
16,8476331,Dylan DeMelo,D,WPG,31,64,1,21,22
16,8478443,Brandon Carlo,D,BOS,28,59,1,21,22
16,8479393,Noah Gregor,L,OTT,26,77,13,8,21
16,8481641,Joel Kiviranta,L,COL,28,72,12,9,21
16,8477406,Mattias Janmark,C,EDM,32,65,11,10,21
16,8480448,Parker Kelly,L,COL,25,76,10,11,21
16,8475343,Nic Dowd,C,WSH,34,57,8,13,21
16,8480980,Connor Dewar,C,TOR,25,66,7,14,21
16,8476960,Andreas Athanasiou,C,CHI,30,55,6,15,21
16,8483457,Lane Hutson,D,MTL,20,67,6,15,21
16,8476892,Colton Parayko,D,STL,31,67,5,16,21
16,8478970,Jalen Chatfield,D,CAR,28,65,4,17,21
16,8482451,Mikael Pyyhtia,L,CBJ,23,54,4,17,21
16,8480049,Dylan Samberg,D,WPG,25,67,3,18,21
16,8475179,Dmitry Kulikov,D,FLA,34,62,2,19,21
16,8482245,Artem Zub,D,OTT,29,72,1,20,21
16,8476921,Jordan Martinook,L,CAR,32,63,12,8,20
16,8482062,Cole Smith,L,NSH,29,56,12,8,20
16,8479336,Carl Grundstrom,R,SJS,27,50,11,9,20
16,8476878,Zemgus Girgensons,C,TBL,30,79,9,11,20
16,8483565,Nick Blankenburg,D,NSH,26,59,8,12,20
16,8482803,Olen Zellweger,D,ANA,21,74,7,13,20
16,8476931,Jake McCabe,D,TOR,31,67,5,15,20
16,8478911,Matt Roy,D,WSH,29,65,5,15,20
16,8476329,Travis Boyd,C,MIN,31,54,5,15,20
16,8476312,Josh Manson,D,COL,33,59,4,16,20
16,8479370,Tyson Jost,C,CAR,26,46,4,16,20
16,8478416,Erik Cernak,D,TBL,27,75,3,17,20
16,8479998,Mikey Anderson,D,LAK,25,65,1,19,20
16,8478421,A.J. Greer,L,FLA,28,55,11,8,19
16,8482809,Jackson Blake,R,CAR,21,56,10,9,19
16,8481521,Ronnie Attard,D,PHI,25,65,8,11,19
16,8477919,Frederick Gaudreau,C,MIN,31,64,8,11,19
16,8481553,Bobby Brink,R,PHI,23,57,7,12,19
16,8474034,Patrick Maroon,L,CHI,36,53,7,12,19
16,8483445,Cutter Gauthier,L,ANA,20,62,5,14,19
16,8476879,Cody Ceci,D,EDM,31,72,4,15,19
16,8478136,Jake Middleton,D,MIN,28,72,4,15,19
16,8480035,Henri Jokiharju,D,BUF,25,61,4,15,19
16,8479439,Jacob MacDonald,D,COL,31,53,3,16,19
16,8482073,Braden Schneider,D,NYR,23,63,2,17,19
16,8479368,Max Jones,L,BOS,26,64,12,6,18
16,8480205,Emil Bemstrom,C,PIT,25,59,12,6,18
16,8476981,Josh Anderson,R,MTL,30,65,11,7,18
16,8477450,Jason Dickinson,C,CHI,29,57,10,8,18
16,8481032,Paul Cotter,C,NJD,25,53,10,8,18
16,8480003,Jesper Boqvist,C,FLA,26,74,10,8,18
16,8479390,Taylor Raddysh,R,WSH,26,62,8,10,18
16,8476469,Joel Armia,R,MTL,31,65,7,11,18
16,8480144,David Kampf,C,TOR,29,69,5,13,18
16,8481481,Blake Lizotte,C,PIT,27,63,5,13,18
16,8476463,Jonas Brodin,D,MIN,31,72,4,14,18
16,8476467,Jamie Oleksiak,D,SEA,32,67,4,14,18
16,8474574,Tyler Myers,D,VAN,34,70,4,14,18
16,8479324,Ryan Lindgren,D,NYR,26,63,3,15,18
16,8480878,Nils Lundkvist,D,DAL,24,74,3,15,18
16,8475208,Brian Dumoulin,D,ANA,33,57,3,15,18
16,8475324,Nick Jensen,D,OTT,34,62,2,16,18
16,8479328,Julien Gauthier,R,NYI,27,59,12,5,17
16,8481477,Nico Sturm,C,SJS,29,52,11,6,17
16,8476889,Radek Faksa,C,STL,30,62,10,7,17
16,8480011,Klim Kostin,C,SJS,25,55,9,8,17
16,8480021,Jack Studnicka,C,LAK,25,65,8,9,17
16,8480762,Eric Robinson,L,CAR,29,53,7,10,17
16,8475225,Craig Smith,C,CHI,35,44,7,10,17
16,8483495,Simon Nemec,D,NJD,20,53,6,11,17
16,8475279,Ben Chiarot,D,DET,33,69,5,12,17
16,8475790,Erik Gudbranson,D,CBJ,32,76,4,13,17
16,8477380,Jonny Brodzinski,C,NYR,31,57,4,13,17
16,8480873,Rasmus Sandin,D,WSH,24,57,3,14,17
16,8482142,Jamie Drysdale,D,PHI,22,53,3,14,17
16,8482192,Isaak Phillips,D,CHI,23,56,3,14,17
16,8479982,Conor Timmins,D,TOR,26,59,3,14,17
16,8478452,Caleb Jones,D,LAK,27,51,3,14,17
16,8479402,Jake Bean,D,CGY,26,68,2,15,17
16,8480281,Alexey Toropchenko,R,STL,25,61,11,5,16
16,8473453,Trevor Lewis,C,LAK,37,70,10,6,16
16,8478585,Derek Ryan,C,EDM,38,63,9,7,16
16,8476873,Mark Jankowski,C,NSH,30,51,9,7,16
16,8476856,Mathew Dumba,D,DAL,30,67,7,9,16
16,8483499,Liam Ohgren,L,MIN,20,56,6,10,16
16,8482087,Kaiden Guhle,D,MTL,22,63,5,11,16
16,8481599,Victor Soderstrom,D,UTA,23,47,5,11,16
16,8480806,Isac Lundestrom,C,ANA,25,65,4,12,16
16,8480157,Calle Rosen,D,COL,30,47,3,13,16
16,8478859,Niko Mikkola,D,FLA,28,59,3,13,16
16,8475188,Brayden McNabb,D,VGK,33,57,2,14,16
16,8477435,Ryan Graves,D,PIT,29,75,2,14,16
16,8478840,Will Borgen,D,SEA,28,64,2,14,16
16,8481019,David Gustafsson,C,WPG,24,45,2,14,16
16,8480058,Pierre-Olivier Joseph,D,STL,25,56,1,15,16
16,8482155,Alex Laferriere,R,LAK,23,62,11,4,15
16,8482762,Simon Edvinsson,D,DET,21,60,11,4,15
16,8482117,Lukas Reichel,L,CHI,22,50,8,7,15
16,8477508,Curtis Lazar,C,NJD,29,51,8,7,15
16,8480855,Jack McBain,C,UTA,24,69,7,8,15
16,8482111,Justin Barron,D,MTL,23,65,6,9,15
16,8479718,Alex Barré-Boulet,C,MTL,27,50,5,10,15
16,8481592,Jakob Pelletier,L,CGY,23,37,5,10,15
16,8480887,Jordan Harris,D,MTL,24,55,4,11,15
16,8481059,Scott Perunovich,D,STL,26,55,4,11,15
16,8483466,Kevin Korchinski,D,CHI,20,41,4,11,15
16,8483493,Frank Nazar,C,CHI,20,44,3,12,15
16,8480807,Mattias Samuelsson,D,BUF,24,54,3,12,15
16,8475690,Chris Tanev,D,TOR,35,58,3,12,15
16,8480860,Kevin Bahl,D,CGY,24,67,3,12,15
16,8478468,Jeremy Lauzon,D,NSH,27,49,3,12,15
16,8479371,Dante Fabbro,D,NSH,26,68,2,13,15
16,8480796,Martin Fehervary,D,WSH,25,53,2,13,15
16,8475455,Brenden Dillon,D,NJD,34,59,1,14,15
16,8482077,Dylan Holloway,L,EDM,23,58,9,5,14
16,8480995,Pontus Holmberg,R,TOR,25,64,9,5,14
16,8481518,Nolan Foote,L,NJD,24,41,9,5,14
16,8479638,Justin Brazeau,R,BOS,26,42,9,5,14
16,8481441,Joe Snively,C,DET,28,61,8,6,14
16,8479619,Michael Carcone,L,UTA,28,63,8,6,14
16,8481147,Reese Johnson,C,MIN,26,43,8,6,14
16,8482157,Will Cuylle,L,NYR,22,52,6,8,14
16,8478043,Sam Lafferty,C,BUF,29,60,6,8,14
16,8482744,James Malatesta,L,CBJ,21,46,6,8,14
16,8482859,Zack Ostapchuk,C,OTT,21,51,6,8,14
16,8481751,Lukas Rousek,R,BUF,25,37,5,9,14
16,8480727,Zach Whitecloud,D,VGK,28,54,5,9,14
16,8477070,Liam O'Brien,C,UTA,30,53,5,9,14
16,8477938,Haydn Fleury,D,WPG,28,42,4,10,14
16,8480950,Ilya Lyubushkin,D,DAL,30,64,4,10,14
16,8476442,Matt Nieto,L,PIT,32,48,3,11,14
16,8479986,Kole Lind,R,DAL,26,50,3,11,14
16,8473563,Nicklas Backstrom,C,WSH,37,60,2,12,14
16,8476874,Olli Maatta,D,DET,30,65,0,14,14
16,8476858,Phillip Di Giuseppe,L,VAN,31,44,10,3,13
16,8479671,Mathieu Olivier,R,CBJ,27,36,8,5,13
16,8481716,Dmitri Voronkov,L,CBJ,24,40,7,6,13
16,8484149,Gavin Brindley,C,CBJ,20,48,7,6,13
16,8479981,Jonah Gadjovich,L,FLA,26,53,7,6,13
16,8480441,Trey Fix-Wolansky,R,CBJ,25,37,6,7,13
16,8481537,Nikita Okhotiuk,D,CGY,24,48,6,7,13
16,8477931,Tomas Nosek,L,FLA,32,51,6,7,13
16,8481754,Nikita Nesterenko,C,ANA,23,44,5,8,13
16,8483491,Ivan Miroshnichenko,L,WSH,20,54,4,9,13
16,8482176,Wyatt Kaiser,D,CHI,22,47,4,9,13
16,8481550,Adam Beckman,L,NJD,23,41,4,9,13
16,8480070,Ian Mitchell,D,BOS,25,53,4,9,13
16,8476994,Vinnie Hinostroza,C,NSH,30,47,3,10,13
16,8480222,Sebastian Aho,D,PIT,28,69,3,10,13
16,8478399,Jonas Siegenthaler,D,NJD,27,58,2,11,13
16,8475762,Derek Forbort,D,VAN,32,51,2,11,13
16,8475750,Jon Merrill,D,MIN,32,62,1,12,13
16,8482659,Josh Doan,R,UTA,22,51,11,1,12
16,8483482,Tristan Luneau,D,ANA,20,55,8,4,12
16,8482807,Ethan Del Mastro,D,CHI,21,47,8,4,12
16,8478569,Noel Acciari,C,PIT,33,54,8,4,12
16,8480289,Morgan Barron,C,WPG,26,58,7,5,12
16,8476624,Barclay Goodrow,C,SJS,31,58,7,5,12
16,8479968,Vinni Lettieri,C,BOS,29,43,7,5,12
16,8480844,Grigori Denisenko,L,VGK,24,30,7,5,12
16,8481609,Vladislav Kolyachonok,D,UTA,23,36,6,6,12
16,8480891,Michael Kesselring,D,UTA,24,57,5,7,12
16,8479980,Nicolas Hague,D,VGK,26,52,5,7,12
16,8481517,Brett Leason,R,ANA,25,47,5,7,12
16,8477979,Nicolas Aube-Kubel,R,BUF,28,62,5,7,12
16,8480001,Urho Vaakanainen,D,ANA,25,52,4,8,12
16,8477499,Rasmus Ristolainen,D,PHI,30,60,4,8,12
16,8478851,Alexandre Carrier,D,NSH,28,67,4,8,12
16,8479772,Zack MacEwen,R,OTT,28,51,4,8,12
16,8481178,Egor Zamula,D,PHI,24,50,3,9,12
16,8479994,Jaret Anderson-Dolan,C,WPG,25,34,3,9,12
16,8479985,Cale Fleury,D,SEA,26,30,3,9,12
16,8471709,Marc-Edouard Vlasic,D,SJS,37,55,2,10,12
16,8474166,Alec Martinez,D,CHI,37,53,2,10,12
16,8474567,Zach Bogosian,D,MIN,34,60,2,10,12
16,8479369,Andrew Peeke,D,BOS,26,53,1,11,12
16,8476525,Colin Miller,D,WPG,32,55,1,11,12
16,8477365,Connor Clifton,D,BUF,29,58,1,11,12
16,8482737,Zack Bolduc,C,STL,21,49,8,3,11
16,8479344,Jesse Puljujarvi,R,PIT,26,44,6,5,11
16,8476934,Brock McGinn,L,ANA,30,61,6,5,11
16,8482666,Scott Morrow,D,CAR,22,44,6,5,11
16,8479291,Kevin Rooney,C,CGY,31,44,6,5,11
16,8480025,MacKenzie Entwistle,R,FLA,25,58,4,7,11
16,8482148,Hendrix Lapierre,C,WSH,22,57,4,7,11
16,8479379,Givani Smith,R,SJS,26,27,4,7,11
16,8480848,Ty Dellandrea,C,SJS,24,44,4,7,11
16,8478434,Keegan Kolesar,R,VGK,27,69,3,8,11
16,8475177,Calvin de Haan,D,COL,33,44,3,8,11
16,8480007,Jonas Rondbjerg,R,VGK,25,43,3,8,11
16,8482166,Shakir Mukhamadullin,D,SJS,22,59,3,8,11
16,8479378,Logan Stanley,D,WPG,26,46,3,8,11
16,8478454,Noah Juulsen,D,VAN,27,36,3,8,11
16,8473446,Erik Johnson,D,PHI,36,48,1,10,11
16,8480172,Jan Rutta,D,SJS,34,63,0,11,11
16,8482496,Nils Aman,C,VAN,24,34,6,4,10
16,8478424,Jansen Harkins,C,ANA,27,43,6,4,10
16,8481161,Jake Christiansen,D,CBJ,25,57,5,5,10
16,8479944,Zach Aston-Reese,C,VGK,30,44,5,5,10
16,8478451,Ethan Bear,D,WSH,27,58,4,6,10
16,8482730,Brandt Clarke,D,LAK,21,52,4,6,10
16,8481617,Vasily Podkolzin,R,VAN,23,49,4,6,10
16,8476952,Dominic Toninato,C,WPG,30,32,4,6,10
16,8479520,Brandon Duhaime,R,WSH,27,59,4,6,10
16,8474090,Brendan Smith,D,DAL,35,48,4,6,10
16,8481013,Jonatan Berggren,R,DET,24,57,3,7,10
16,8475462,Radko Gudas,D,ANA,34,70,3,7,10
16,8478211,Dryden Hunt,L,CGY,29,59,3,7,10
16,8477034,Jaycob Megna,D,FLA,32,52,3,7,10
16,8477887,Patrick Brown,C,BOS,32,51,2,8,10
16,8482751,Ryan Winterton,C,SEA,21,33,2,8,10
16,8483630,Pavol Regenda,L,ANA,25,31,2,8,10
16,8481708,Zac Jones,D,NYR,24,51,1,9,10
16,8475718,Justin Holl,D,DET,32,62,1,9,10
16,8474013,Ian Cole,D,UTA,35,53,1,9,10
16,8481789,Tye Kartye,L,SEA,23,35,7,2,9
16,8476867,Brendan Gaunce,C,MIN,30,38,5,4,9
16,8480355,Mark Kastelic,C,BOS,25,56,5,4,9
16,8478409,Anthony Richard,C,PHI,28,38,5,4,9
16,8477401,John Hayden,C,SEA,29,33,5,4,9
16,8479026,Philippe Myers,D,TOR,27,43,4,5,9
16,8482747,Brennan Othmann,L,NYR,21,45,4,5,9
16,8481028,Martin Pospisil,C,CGY,25,55,4,5,9
16,8479442,Troy Stecher,D,EDM,30,51,4,5,9
16,8480252,Cole Guttman,C,CHI,25,37,4,5,9
16,8476457,Adam Larsson,D,SEA,32,70,3,6,9
16,8483619,Filip Roos,D,OTT,25,38,3,6,9
16,8479372,Joshua Mahura,D,SEA,26,60,3,6,9
16,8480880,Jakub Lauko,C,MIN,24,37,3,6,9
16,8477335,Kyle Burroughs,D,LAK,29,40,3,6,9
16,8475842,Sam Carrick,C,NYR,32,60,2,7,9
16,8482634,Alex Steeves,C,TOR,25,40,2,7,9
16,8477845,Trevor van Riemsdyk,D,WSH,33,55,1,8,9
16,8479543,Michael Pezzetta,L,MTL,26,65,1,8,9
16,8480192,Johnathan Kovacevic,D,NJD,27,51,1,8,9
16,8484254,Akito Hirose,D,VAN,25,38,1,8,9
16,8481701,Santeri Hatakka,D,NJD,23,40,1,8,9
16,8475235,Nicolas Deslauriers,L,PHI,33,44,6,2,8
16,8478831,Kevin Stenlund,C,UTA,28,48,4,4,8
16,8479359,Beck Malenstyn,L,BUF,26,44,4,4,8
16,8482145,Mavrik Bourque,C,DAL,22,48,4,4,8
16,8477573,Nathan Walker,L,STL,30,50,3,5,8
16,8476473,Connor Murphy,D,CHI,31,49,3,5,8
16,8477482,Zachary Sanford,L,CHI,30,39,3,5,8
16,8482095,Tyler Kleven,D,OTT,22,48,2,6,8
16,8474568,Luke Schenn,D,NSH,35,53,2,6,8
16,8481598,Philip Broberg,D,EDM,23,41,2,6,8
16,8481600,Tobias Bjornfot,D,FLA,23,31,2,6,8
16,8478146,Matthew Highmore,C,OTT,28,31,2,6,8
16,8474612,Travis Hamonic,D,OTT,34,42,1,7,8
16,8482784,Zach Dean,C,STL,21,41,4,3,7
16,8481122,Simon Benoit,D,TOR,26,43,4,3,7
16,8482858,Ryker Evans,D,SEA,23,24,4,3,7
16,8481567,Henry Thrun,D,SJS,23,57,3,4,7
16,8480870,Bo Groulx,C,NYR,24,31,3,4,7
16,8477962,Brendan Lemieux,L,CAR,28,42,3,4,7
16,8482652,Walker Duehr,R,CGY,27,40,3,4,7
16,8482861,Vincent Iorio,D,WSH,22,39,3,4,7
16,8477527,Ross Johnston,L,ANA,30,30,3,4,7
16,8480292,Carson Meyer,R,ANA,27,31,3,4,7
16,8484287,Cole McWard,D,VAN,23,26,3,4,7
16,8481532,Alex Turcotte,C,LAK,23,39,2,5,7
16,8482153,Brendan Brisson,C,VGK,23,26,2,5,7
16,8479991,Jake Leschyshyn,C,NYR,25,32,2,5,7
16,8476441,Joel Edmundson,D,LAK,31,38,1,6,7
16,8471817,Ryan Reaves,R,TOR,37,59,1,6,7
16,8478450,Parker Wotherspoon,D,BOS,27,31,1,6,7
16,8483012,Logan Morrison,C,SEA,22,38,1,6,7
16,8477384,Joshua Brown,D,EDM,30,36,1,6,7
16,8476822,Luke Glendening,C,TBL,35,80,5,1,6
16,8480990,Declan Chisholm,D,MIN,24,43,3,3,6
16,8479536,Axel Jonsson-Fjallby,L,WPG,26,32,3,3,6
16,8482070,Mitchell Chaffee,R,TBL,26,45,3,3,6
16,8479972,Mason Shaw,C,WPG,26,40,3,3,6
16,8480245,Olle Lycksell,R,PHI,25,31,3,3,6
16,8484911,Collin Graf,R,SJS,22,29,2,4,6
16,8477851,Jordan Oesterle,D,BOS,32,40,2,4,6
16,8478874,Adam Gaudette,R,OTT,28,37,2,4,6
16,8482765,Isak Rosen,R,BUF,21,25,2,4,6
16,8483570,Ben Meyers,C,SEA,26,27,2,4,6
16,8482964,Arber Xhekaj,D,MTL,23,48,1,5,6
16,8481167,Brayden Pachal,D,CGY,25,42,1,5,6
16,8480196,Jacob Bryson,D,BUF,27,52,1,5,6
16,8479348,Kale Clague,D,BUF,26,38,1,5,6
16,8481556,John Beecher,C,BOS,23,32,3,2,5
16,8483397,Marc McLaughlin,C,BOS,25,28,3,2,5
16,8482713,Mackie Samoskevich,R,FLA,22,41,3,2,5
16,8483460,David Jiricek,D,CBJ,21,57,2,3,5
16,8481543,Nikita Alexandrov,C,STL,24,22,2,3,5
16,8480834,Ty Emberson,D,SJS,24,31,1,4,5
16,8479576,Vincent Desharnais,D,VAN,28,30,1,4,5
16,8477462,Robert Hagg,D,VGK,29,23,1,4,5
16,8476372,Nick Seeler,D,PHI,31,53,0,5,5
16,8480879,Jacob Bernard-Docker,D,OTT,24,46,0,5,5
16,8478017,Mark Friedman,D,VAN,29,27,3,1,4
16,8482177,Marat Khusnutdinov,C,MIN,22,34,3,1,4
16,8483549,Lucas Condotta,L,MTL,27,36,3,1,4
16,8481679,Maxence Guenette,D,OTT,23,29,3,1,4
16,8478881,Brett Seney,L,CHI,28,16,3,1,4
16,8482733,Logan Mailloux,D,MTL,31,31,2,2,4
16,8475958,Michael Sgarbossa,C,WSH,32,25,2,2,4
16,8480851,Akil Thomas,C,LAK,24,17,2,2,4
16,8478051,Max Willman,C,NJD,29,23,2,2,4
16,8478477,Mitchell Stephens,C,SEA,27,21,2,2,4
16,8480845,Rasmus Kupari,C,WPG,24,46,1,3,4
16,8480267,Sammy Walker,C,MIN,25,18,1,3,4
16,8482144,Jack Thompson,D,SJS,22,23,1,3,4
16,8477018,Ben Hutton,D,VGK,31,39,0,4,4
16,8479249,Andrew Poturalski,C,SJS,30,36,0,4,4
16,8471677,Jack Johnson,D,CBJ,37,61,0,4,4
16,8479587,Rhett Gardner,C,PHI,28,15,0,4,4
16,8481065,Angus Crookshank,L,OTT,25,16,0,4,4
16,8482511,Mason Lohrei,D,BOS,23,31,0,4,4
16,8481056,Spencer Stastney,D,NSH,24,35,0,4,4
16,8476913,Devin Shore,C,MIN,30,37,0,4,4
16,8481719,Maxwell Crozier,D,TBL,24,12,3,0,3
16,8477467,Gustav Olofsson,D,SEA,30,19,3,0,3
16,8483763,Maksymilian Szuber,D,UTA,22,31,2,1,3
16,8477473,Justin Bailey,R,SJS,29,26,2,1,3
16,8480468,James Hamblin,L,EDM,25,22,2,1,3
16,8481605,Jackson LaCombe,D,ANA,23,30,1,2,3
16,8477244,Chad Ruhwedel,D,NYR,34,23,1,2,3
16,8480084,Nick DeSimone,D,NJD,30,21,1,2,3
16,8480890,Jan Jenik,C,OTT,24,27,1,2,3
16,8478021,William Lagesson,D,DET,28,19,0,3,3
16,8482141,Lukas Cormier,D,VGK,22,30,0,3,3
16,8478502,Dennis Gilbert,D,BUF,28,18,0,3,3
16,8482088,Justin Sourdif,R,FLA,22,16,0,3,3
16,8482165,Yan Kuznetsov,D,CGY,22,18,0,3,3
16,8482250,Callahan Burke,C,VGK,27,23,0,3,3
16,8482516,Matthew Kessel,D,STL,24,19,0,3,3
16,8478011,Louie Belpedio,D,PHI,28,15,0,3,3
16,8481422,Jake Lucchini,C,NSH,29,25,2,0,2
16,8482147,Jean-Luc Foudy,C,COL,22,25,2,0,2
16,8479367,William Lockwood,R,FLA,26,20,2,0,2
16,8475755,Alexander Petrovic,D,DAL,32,8,2,0,2
16,8480032,Shane Bowers,C,NJD,25,15,1,1,2
16,8479362,Riley Tufte,L,BOS,26,15,1,1,2
16,8481206,John Ludvig,D,PIT,24,9,1,1,2
16,8480075,Cameron Crotty,D,MIN,25,15,1,1,2
16,8474062,Riley Nash,C,NYR,35,21,1,1,2
16,8481578,Graeme Clarke,R,MIN,23,10,1,1,2
16,8483567,Georgii Merkulov,C,BOS,24,11,1,1,2
16,8483597,Milos Kelemen,L,UTA,25,18,1,1,2
16,8477073,Kurtis MacDermid,L,NJD,30,33,0,2,2
16,8475795,Dylan McIlrath,D,WSH,32,15,0,2,2
16,8477810,Joel Hanley,D,CGY,33,22,0,2,2
16,8482172,Landon Slaggert,L,CHI,22,21,0,2,2
16,8477971,Andreas Englund,D,LAK,28,29,0,2,2
16,8484325,Waltteri Merela,C,TBL,26,17,0,2,2
16,8479320,Maxime Lajoie,D,SEA,27,19,0,2,2
16,8479419,Brett Murray,L,BUF,26,21,0,2,2
16,8480874,Adam Ginning,D,PHI,24,9,0,2,2
16,8481043,Cole Koepke,L,BOS,26,12,0,2,2
16,8481030,Jack St. Ivany,D,PIT,25,17,0,2,2
16,8481806,Louis Crevier,D,CHI,23,11,0,2,2
16,8482061,Brandon Biro,L,SEA,26,9,1,0,1
16,8482102,Vasily Ponomarev,C,PIT,22,17,1,0,1
16,8483489,Fraser Minten,C,TOR,31,12,1,0,1
16,8480823,Alexander Alexeyev,D,WSH,25,11,1,0,1
16,8483395,Arshdeep Bains,L,VAN,23,12,1,0,1
16,8481585,Egor Afanasyev,L,SJS,23,12,1,0,1
16,8475780,Chris Wagner,R,COL,33,9,1,0,1
16,8482470,Ilya Solovyov,D,CGY,24,14,1,0,1
16,8477541,Dakota Mermis,D,TOR,30,9,1,0,1
16,8483920,Pierrick Dube,R,WSH,23,8,1,0,1
16,8482787,Nikita Chibrikov,R,WPG,31,8,1,0,1
16,8478446,Glenn Gawdin,C,LAK,27,11,1,0,1
16,8483398,Declan Carlile,D,TBL,31,5,1,0,1
16,8482094,Daemon Hunt,D,MIN,22,16,1,0,1
16,8484259,Ondrej Pavel,C,COL,31,3,1,0,1
16,8481743,Marc Del Gaizo,D,NSH,25,21,0,1,1
16,8484258,Sam Malinski,D,COL,26,23,0,1,1
16,8481593,Jayden Struble,D,MTL,23,19,0,1,1
16,8481564,Ryan Johnson,D,BUF,23,12,0,1,1
16,8483512,Matthew Savoie,C,EDM,20,19,0,1,1
16,8480306,Grant Hutton,D,NYI,29,4,0,1,1
16,8481024,Linus Karlsson,C,VAN,25,11,0,1,1
16,8479522,Hardy Haman Aktell,D,WSH,26,5,0,1,1
16,8482929,Emil Lilleberg,D,TBL,23,24,0,1,1
16,8477149,Scott Sabourin,R,SJS,32,13,0,1,1
16,8483609,Adam Klapka,R,CGY,24,2,0,1,1
16,8482118,Sam Colangelo,R,ANA,23,15,0,1,1
16,8478854,Ryan Shea,D,PIT,27,9,0,1,1
16,8484321,Nikolas Matinpalo,D,OTT,26,3,0,1,1
16,8482201,Gage Goncalves,C,TBL,23,30,0,0,0
16,8481237,Kyle MacLean,C,NYI,25,21,0,0,0
16,8481541,Samuel Bolduc,D,NYI,24,21,0,0,0
16,8477320,Anton Blidh,L,NYR,29,11,0,0,0
16,8481699,Aku Raty,R,UTA,23,11,0,0,0
16,8484304,Uvis Balinskis,D,FLA,28,6,0,0,0
16,8475413,Justin Dowling,C,NJD,34,16,0,0,0
16,8483471,Brad Lambert,C,WPG,31,9,0,0,0
16,8482162,Roby Jarventie,L,EDM,22,11,0,0,0
16,8482476,Emil Heineman,L,MTL,23,8,0,0,0
16,8481726,Adam Edstrom,C,NYR,24,11,0,0,0
16,8477993,Justin Kirkland,C,CGY,28,6,0,0,0
16,8483531,Brian Halonen,L,NJD,25,2,0,0,0
16,8484255,Jason Polin,R,COL,25,5,0,0,0
16,8484326,Patrik Koch,D,UTA,28,3,0,0,0
16,8481006,Tyler Tucker,D,STL,24,16,0,0,0
16,8482460,Matt Rempe,C,NYR,22,6,0,0,0
16,8479421,Jacob Moverare,D,LAK,26,11,0,0,0
16,8483407,Brandon Scanlin,D,NYR,25,6,0,0,0
16,8481462,Mason Morelli,L,VGK,28,10,0,0,0
16,8483546,Marshall Rifai,D,TOR,26,1,0,0,0
16,8481655,Cole Schwindt,R,CGY,23,4,0,0,0
16,8479330,Brandon Gignac,C,MTL,27,11,0,0,0
16,8478147,Bokondji Imama,L,PIT,28,6,0,0,0
16,8476323,Max McCormick,L,SEA,32,4,0,0,0
16,8482197,Adam Raska,R,MIN,23,8,0,0,0
16,8481534,Raphael Lavoie,C,EDM,24,3,0,0,0
16,8483432,Luca Del Bel Belluz,C,CBJ,31,6,0,0,0
16,8483401,Marc Johnstone,R,PIT,28,3,0,0,0
16,8482126,Emil Andrae,D,PHI,31,2,0,0,0
16,8470794,Joe Pavelski,C,,40,0,0,0,0
16,8479321,Lucas Johansen,D,,27,0,0,0,0
16,8477950,Tony DeAngelo,D,,29,0,0,0,0
16,8471218,Blake Wheeler,R,,38,0,0,0,0
16,8475197,Tyson Barrie,D,,33,0,0,0,0
16,8474157,Max Pacioretty,L,,36,0,0,0,0
16,8475744,Evgeny Kuznetsov,C,,32,0,0,0,0
16,8474037,James van Riemsdyk,L,,35,0,0,0,0
16,8476907,Mackenzie MacEachern,L,,30,0,0,0,0
16,8480216,Jacob Peterson,C,,25,0,0,0,0
16,8474602,Justin Schultz,D,,34,0,0,0,0
16,8482222,Alexander Barabanov,L,,30,0,0,0,0
16,8474031,Kevin Shattenkirk,D,,35,0,0,0,0
16,8477330,Dominik Kubalik,L,,29,0,0,0,0
16,8480884,Calen Addison,D,,24,0,0,0,0
16,8475906,John Klingberg,D,,32,0,0,0,0
16,8480008,Adam Ruzicka,C,,25,0,0,0,0
16,8476884,Derrick Pouliot,D,,30,0,0,0,0
16,8476919,Chris Tierney,C,,30,0,0,0,0
16,8479415,Michael McLeod,C,,26,0,0,0,0
16,8474870,Tyler Johnson,C,,34,0,0,0,0
16,8470604,Jeff Carter,C,,39,0,0,0,0
16,8478104,Sammy Blais,L,,28,0,0,0,0
16,8474884,Mike Hoffman,C,,35,0,0,0,0
16,8481591,Sam Poulin,R,,23,0,0,0,0
16,8471274,Alex Goligoski,D,,39,0,0,0,0
16,8476871,Tanner Pearson,L,,32,0,0,0,0
16,8476393,Nick Cousins,C,,31,0,0,0,0
16,8479977,Kailer Yamamoto,R,,26,0,0,0,0
16,8479346,Dillon Dube,C,,26,0,0,0,0
16,8480184,Gustav Lindstrom,D,,26,0,0,0,0
16,8479376,Victor Mete,D,,26,0,0,0,0
16,8473449,Kyle Okposo,R,,36,0,0,0,0
16,8481058,Jesse Ylonen,R,,25,0,0,0,0
16,8475752,Tyler Pitlick,C,,33,0,0,0,0
16,8481239,Samuel Fagemo,L,,24,0,0,0,0
16,8480821,Filip Zadina,R,,25,0,0,0,0
16,8470966,Mark Giordano,D,,41,0,0,0,0
16,8478495,Denis Gurianov,R,,27,0,0,0,0
16,8477464,Nic Petan,C,,29,0,0,0,0
16,8478099,Kevin Labanc,R,,29,0,0,0,0
16,8482241,Radim Zohorna,L,,28,0,0,0,0
16,8474040,Sam Gagner,C,,35,0,0,0,0
16,8479514,Rem Pitlick,C,,27,0,0,0,0
16,8478430,Oliver Kylington,D,,27,0,0,0,0
16,8479533,Joona Koppanen,L,,26,0,0,0,0
16,8479984,Cal Foote,D,,26,0,0,0,0
16,8477126,Jayson Megna,C,,34,0,0,0,0
16,8475164,Jakob Silfverberg,R,,34,0,0,0,0
16,8474009,Nick Bonino,C,,36,0,0,0,0
16,8479458,Nikita Zaitsev,D,,33,0,0,0,0
16,8477944,Jakub Vrana,L,,28,0,0,0,0
16,8471699,Andrew Cogliano,C,,37,0,0,0,0
16,8478067,Oskar Lindblom,L,,28,0,0,0,0
16,8471686,Marc Staal,D,,37,0,0,0,0
16,8470610,Zach Parise,L,,40,0,0,0,0
16,8478904,Steven Lorentz,C,,28,0,0,0,0
16,8473473,Milan Lucic,L,,36,0,0,0,0
16,8480031,Maxime Comtois,L,,25,0,0,0,0
16,8478512,Austin Czarnik,C,,32,0,0,0,0
16,8473504,Cal Clutterbuck,R,,37,0,0,0,0
16,8477454,Adam Erne,L,,29,0,0,0,0
16,8479383,Boris Katchouk,L,,26,0,0,0,0
16,8475825,Jani Hakanpää,D,,32,0,0,0,0
16,8477846,Ryan Carpenter,C,,33,0,0,0,0
16,8477930,Pierre-Edouard Bellemare,L,,39,0,0,0,0
16,8478400,Colin White,C,,27,0,0,0,0
16,8480226,Marián Studenic,R,,26,0,0,0,0
16,8480853,Liam Foudy,C,,24,0,0,0,0
16,8475797,Jarred Tinordi,D,,32,0,0,0,0
16,8479423,Alex Nylander,L,,26,0,0,0,0
16,8474618,Marco Scandella,D,,34,0,0,0,0
16,8478028,Fredrik Olofsson,L,,28,0,0,0,0
16,8474709,Matt Martin,L,,35,0,0,0,0
16,8481070,Hugh McGing,L,,26,0,0,0,0
16,8479546,Oskar Steen,C,,26,0,0,0,0
16,8474145,Robert Bortuzzo,D,,35,0,0,0,0
16,8476915,Jujhar Khaira,L,,30,0,0,0,0
16,8480274,Philip Kemp,D,EDM,25,0,0,0,0
16,8475278,Byron Froese,C,,33,0,0,0,0
16,8481812,Nikolai Knyzhov,D,,27,0,0,0,0
16,8478408,Travis Dermott,D,,28,0,0,0,0
16,8481077,John Leonard,L,,26,0,0,0,0
16,8479547,Matthew Phillips,R,,26,0,0,0,0
16,8480836,Jonathan Gruden,C,,24,0,0,0,0
16,8481690,Tyler Angle,C,,24,0,0,0,0
16,8475766,Austin Watson,L,,32,0,0,0,0
16,8481016,Ruslan Iskhakov,C,,24,0,0,0,0
16,8478078,Rourke Chartier,C,,28,0,0,0,0
16,8480776,Sheldon Rempal,R,,29,0,0,0,0
16,8478956,Samuel Laberge,L,NJD,27,2,0,0,0
16,8483045,Cameron Butler,R,CBJ,31,1,0,0,0
16,8484314,Jiri Smejkal,L,,28,0,0,0,0
17,8477492,Nathan MacKinnon,C,COL,29,82,60,94,154
17,8476453,Nikita Kucherov,R,TBL,31,81,42,96,138
17,8478402,Connor McDavid,C,EDM,27,77,40,95,135
17,8477934,Leon Draisaitl,C,EDM,29,79,45,85,130
17,8477939,William Nylander,R,TOR,28,78,49,61,110
17,8477956,David Pastrnak,R,BOS,28,79,53,55,108
17,8478010,Brayden Point,C,TBL,28,82,56,48,104
17,8478420,Mikko Rantanen,R,COL,28,82,37,66,103
17,8480027,Jason Robertson,L,DAL,25,82,36,67,103
17,8477404,Jake Guentzel,C,TBL,30,82,44,58,102
17,8476454,Ryan Nugent-Hopkins,C,EDM,31,79,33,69,102
17,8476468,J.T. Miller,C,VAN,31,74,31,71,102
17,8474600,Roman Josi,D,NSH,34,74,31,71,102
17,8479343,Clayton Keller,R,UTA,26,78,43,58,101
17,8478483,Mitch Marner,R,TOR,27,76,27,72,99
17,8480012,Elias Pettersson,C,VAN,26,69,36,62,98
17,8481559,Jack Hughes,C,NJD,23,81,35,63,98
17,8476887,Filip Forsberg,L,NSH,30,72,48,47,95
17,8479314,Matthew Tkachuk,L,FLA,27,78,31,64,95
17,8477942,Kevin Fiala,L,LAK,28,82,29,65,94
17,8480800,Quinn Hughes,D,VAN,25,81,12,82,94
17,8478550,Artemi Panarin,L,NYR,33,73,35,58,93
17,8477946,Dylan Larkin,C,DET,28,78,41,51,92
17,8474564,Steven Stamkos,C,NSH,34,77,39,53,92
17,8478445,Mathew Barzal,C,NYI,27,79,25,66,91
17,8478439,Travis Konecny,R,PHI,27,76,31,59,90
17,8478864,Kirill Kaprizov,L,MIN,27,73,34,54,88
17,8481557,Matt Boldy,L,MIN,23,73,34,54,88
17,8479407,Jesper Bratt,L,NJD,26,76,34,53,87
17,8479318,Auston Matthews,C,TOR,27,76,47,39,86
17,8478427,Sebastian Aho,C,CAR,27,72,31,55,86
17,8477501,Valeri Nichushkin,R,COL,29,82,42,43,85
17,8480023,Robert Thomas,C,STL,25,76,32,52,84
17,8477493,Aleksander Barkov,C,FLA,29,77,28,56,84
17,8480036,Miro Heiskanen,D,DAL,25,76,21,63,84
17,8482116,Tim Stützle,C,OTT,22,76,26,57,83
17,8476346,Johnny Gaudreau,L,CBJ,31,68,22,61,83
17,8473994,Jamie Benn,L,DAL,35,82,27,55,82
17,8480069,Cale Makar,D,COL,26,70,18,62,80
17,8471675,Sidney Crosby,C,PIT,37,74,33,46,79
17,8479675,Trevor Moore,L,LAK,29,82,33,46,79
17,8479542,Brandon Hagel,L,TBL,26,81,30,49,79
17,8477416,Oliver Bjorkstrand,R,SEA,29,74,29,49,78
17,8474141,Patrick Kane,R,DET,36,80,28,50,78
17,8478460,Zach Werenski,D,CBJ,27,81,23,55,78
17,8477504,Josh Morrissey,D,WPG,29,77,16,62,78
17,8480801,Brady Tkachuk,L,OTT,25,75,38,39,77
17,8480002,Nico Hischier,C,NJD,25,73,31,46,77
17,8482665,Matty Beniers,C,SEA,22,73,34,42,76
17,8484144,Connor Bedard,C,CHI,19,64,24,52,76
17,8479323,Adam Fox,D,NYR,26,70,13,63,76
17,8480830,Andrei Svechnikov,R,CAR,24,76,32,43,75
17,8479420,Tage Thompson,C,BUF,27,72,31,44,75
17,8476389,Vincent Trocheck,C,NYR,31,78,31,44,75
17,8478398,Kyle Connor,L,WPG,28,70,33,41,74
17,8475913,Mark Stone,R,VGK,32,80,25,49,74
17,8477494,Jonathan Drouin,L,COL,29,80,19,55,74
17,8477933,Sam Reinhart,C,FLA,29,79,42,31,73
17,8477500,Bo Horvat,C,NYI,29,81,40,33,73
17,8479385,Jordan Kyrou,C,STL,26,74,25,48,73
17,8484166,Adam Fantilli,C,CBJ,20,74,39,33,72
17,8478449,Roope Hintz,C,DAL,28,82,36,36,72
17,8477402,Pavel Buchnevich,L,STL,29,74,26,46,72
17,8475166,John Tavares,C,TOR,34,80,34,37,71
17,8482078,Lucas Raymond,L,DET,22,82,27,44,71
17,8475172,Nazem Kadri,C,CGY,34,79,25,46,71
17,8480803,Evan Bouchard,D,EDM,25,76,11,60,71
17,8471214,Alex Ovechkin,L,WSH,39,76,32,38,70
17,8474578,Erik Karlsson,D,PIT,34,79,13,57,70
17,8475167,Victor Hedman,D,TBL,34,81,12,58,70
17,8475810,Bryan Rust,R,PIT,32,66,39,30,69
17,8477960,Adrian Kempe,R,LAK,28,79,27,42,69
17,8477940,Nikolaj Ehlers,L,WPG,28,72,33,35,68
17,8476456,Jonathan Huberdeau,C,CGY,31,80,20,48,68
17,8482093,Seth Jarvis,C,CAR,22,69,34,33,67
17,8475765,Vladimir Tarasenko,R,DET,33,79,27,40,67
17,8478873,Troy Terry,R,ANA,27,70,18,49,67
17,8476881,Tomas Hertl,C,VGK,31,78,34,32,66
17,8478403,Jack Eichel,C,VGK,28,79,32,34,66
17,8473512,Claude Giroux,R,OTT,36,78,26,40,66
17,8478440,Dylan Strome,C,WSH,27,73,25,41,66
17,8473419,Brad Marchand,L,BOS,36,79,21,45,66
17,8480865,Noah Dobson,D,NYI,24,81,13,53,66
17,8478975,Mason Marchment,L,DAL,29,81,31,34,65
17,8477496,Elias Lindholm,C,BOS,30,79,31,34,65
17,8478047,Michael Bunting,L,PIT,29,71,29,36,65
17,8477998,Warren Foegele,L,LAK,28,79,27,37,64
17,8477951,Nick Schmaltz,C,UTA,28,75,20,44,64
17,8475786,Zach Hyman,L,EDM,32,76,28,35,63
17,8482699,Dylan Guenther,R,UTA,21,73,24,39,63
17,8476432,Boone Jenner,C,CBJ,31,67,33,29,62
17,8477409,Carter Verhaeghe,C,FLA,29,76,27,35,62
17,8475784,Jeff Skinner,C,EDM,32,75,25,37,62
17,8471215,Evgeni Malkin,C,PIT,38,70,25,37,62
17,8477407,Anthony Duclair,L,NYI,29,78,25,37,62
17,8474641,Adam Henrique,C,EDM,34,76,32,29,61
17,8476459,Mika Zibanejad,C,NYR,31,78,29,32,61
17,8482745,Mason McTavish,C,ANA,21,72,27,34,61
17,8475170,Brayden Schenn,C,STL,33,74,26,35,61
17,8476479,Phillip Danault,C,LAK,31,79,20,41,61
17,8479325,Charlie McAvoy,D,BOS,27,76,5,56,61
17,8476448,William Karlsson,C,VGK,31,73,31,29,60
17,8475754,Brock Nelson,C,NYI,33,80,29,31,60
17,8481540,Cole Caufield,R,MTL,23,73,27,33,60
17,8475158,Ryan O'Reilly,C,NSH,33,77,22,38,60
17,8475168,Matt Duchene,C,DAL,33,80,21,39,60
17,8477456,J.T. Compher,L,DET,29,80,32,27,59
17,8471724,Kris Letang,D,PIT,37,79,13,46,59
17,8480839,Rasmus Dahlin,D,BUF,24,68,12,47,59
17,8482740,Wyatt Johnston,C,DAL,21,81,29,29,58
17,8478519,Anthony Cirelli,C,TBL,27,81,22,36,58
17,8475692,Mats Zuccarello,R,MIN,37,73,12,46,58
17,8476875,Mike Matheson,D,MTL,30,78,12,46,58
17,8478444,Brock Boeser,R,VAN,27,77,29,28,57
17,8476460,Mark Scheifele,C,WPG,31,70,29,28,57
17,8480188,Fabian Zetterlund,L,SJS,25,70,29,28,57
17,8483808,Andrei Kuzmenko,L,CGY,28,77,27,30,57
17,8474102,David Perron,L,OTT,36,77,26,31,57
17,8479337,Alex DeBrincat,R,DET,27,78,21,36,57
17,8481711,Matias Maccelli,L,UTA,24,74,17,40,57
17,8480018,Nick Suzuki,C,MTL,25,73,16,41,57
17,8474679,Gustav Nyquist,C,NSH,35,75,15,42,57
17,8475798,Mikael Granlund,C,SJS,32,72,13,44,57
17,8475169,Evander Kane,L,EDM,33,76,33,23,56
17,8484153,Leo Carlsson,C,ANA,20,72,26,30,56
17,8481528,Dylan Cozens,C,BUF,23,73,17,39,56
17,8477447,Shea Theodore,D,VGK,29,62,9,47,56
17,8481068,Yegor Sharangovich,C,CGY,26,78,26,29,55
17,8477949,Alex Tuch,R,BUF,28,70,25,30,55
17,8482124,Quinton Byfield,R,LAK,22,82,22,33,55
17,8479999,Casey Mittelstadt,C,COL,26,79,20,35,55
17,8478856,Conor Garland,R,VAN,28,70,19,36,55
17,8476853,Morgan Rielly,D,TOR,30,69,10,45,55
17,8478414,Timo Meier,R,NJD,28,76,29,25,54
17,8475726,Tyler Toffoli,C,SJS,32,71,29,25,54
17,8477955,Jared McCann,L,SEA,28,75,26,28,54
17,8480039,Martin Necas,C,CAR,25,71,22,32,54
17,8482159,Tyson Foerster,R,PHI,22,70,18,36,54
17,8476826,Yanni Gourde,C,SEA,33,66,16,38,54
17,8482684,Luke Hughes,D,NJD,21,74,8,46,54
17,8478397,Rasmus Andersson,D,CGY,28,74,7,47,54
17,8480208,Drake Batherson,R,OTT,26,76,23,30,53
17,8475745,Charlie Coyle,C,BOS,32,79,21,32,53
17,8478407,Vince Dunn,D,SEA,28,74,12,41,53
17,8477476,Artturi Lehkonen,L,COL,29,79,30,22,52
17,8475314,Anders Lee,L,NYI,34,76,27,25,52
17,8481533,Trevor Zegras,C,ANA,23,78,24,28,52
17,8475191,Reilly Smith,R,NYR,33,75,22,30,52
17,8482667,William Eklund,L,SJS,22,71,20,32,52
17,8471685,Anze Kopitar,C,LAK,37,81,11,41,52
17,8475794,Tyler Seguin,C,DAL,32,82,23,28,51
17,8479987,Morgan Geekie,C,BOS,26,78,20,31,51
17,8478038,Devon Toews,D,COL,30,72,13,38,51
17,8476792,Torey Krug,D,STL,33,70,13,38,51
17,8477346,MacKenzie Weegar,D,CGY,30,75,11,40,51
17,8476539,Jonathan Marchessault,R,NSH,34,71,32,18,50
17,8481560,Arthur Kaliyev,R,LAK,23,74,31,19,50
17,8480014,Gabriel Vilardi,C,WPG,25,66,30,20,50
17,8482110,Dawson Mercer,C,NJD,23,76,25,25,50
17,8478042,Viktor Arvidsson,L,EDM,31,69,18,32,50
17,8470613,Brent Burns,D,CAR,39,76,11,39,50
17,8474565,Alex Pietrangelo,D,VGK,34,65,9,41,50
17,8476958,Jaccob Slavin,D,CAR,30,75,9,41,50
17,8474590,John Carlson,D,WSH,34,74,7,43,50
17,8480015,Owen Tippett,R,PHI,25,74,22,27,49
17,8480185,Eetu Luostarinen,C,FLA,26,73,18,31,49
17,8477497,Sean Monahan,C,CBJ,30,67,16,33,49
17,8473986,Alex Killorn,L,ANA,35,74,13,36,49
17,8474563,Drew Doughty,D,LAK,35,71,11,38,49
17,8476399,Blake Coleman,C,CGY,33,78,29,19,48
17,8475184,Chris Kreider,L,NYR,33,73,27,21,48
17,8478493,Joel Eriksson Ek,C,MIN,27,66,23,25,48
17,8478466,Daniel Sprong,R,VAN,27,67,22,26,48
17,8482146,Luke Evangelista,R,NSH,22,73,21,27,48
17,8483431,Logan Cooley,C,UTA,20,74,20,28,48
17,8479339,Patrik Laine,L,CBJ,26,63,19,29,48
17,8482109,Alexis Lafrenière,L,NYR,23,74,18,30,48
17,8476872,Scott Laughton,C,PHI,30,72,13,35,48
17,8476905,Chandler Stephenson,C,SEA,30,68,12,36,48
17,8479410,Mikhail Sergachev,D,UTA,26,70,12,36,48
17,8477426,Nicholas Paul,L,TBL,29,81,29,18,47
17,8478498,Jake DeBrusk,L,VAN,28,75,25,22,47
17,8478462,Nicolas Roy,C,VGK,27,75,18,29,47
17,8477935,Sam Bennett,C,FLA,28,77,18,29,47
17,8474150,Mikael Backlund,C,CGY,35,77,13,34,47
17,8479425,Filip Hronek,D,VAN,27,72,13,34,47
17,8477948,Travis Sanheim,D,PHI,28,68,11,36,47
17,8480434,Sean Durzi,D,UTA,26,72,9,38,47
17,8481542,Moritz Seider,D,DET,23,74,7,40,47
17,8475151,Kyle Palmieri,C,NYI,33,80,22,24,46
17,8477479,Tyler Bertuzzi,L,CHI,29,66,22,24,46
17,8475760,Nick Bjugstad,C,UTA,32,77,21,25,46
17,8475793,Ryan Johansen,C,PHI,32,73,29,16,45
17,8476483,Rickard Rakell,R,PIT,31,68,24,21,45
17,8478366,Frank Vatrano,R,ANA,30,75,24,21,45
17,8480797,Joel Farabee,L,PHI,24,79,22,23,45
17,8475768,Jaden Schwartz,C,SEA,32,71,20,25,45
17,8478458,John (Jack) Roslovic,C,CAR,27,65,20,25,45
17,8482149,Cole Perfetti,C,WPG,22,66,18,27,45
17,8481186,Logan O'Connor,R,COL,28,80,17,28,45
17,8477021,Alex Kerfoot,C,UTA,30,75,15,30,45
17,8481577,Philip Tomasino,C,NSH,23,68,13,32,45
17,8476869,Brady Skjei,D,NSH,30,75,7,38,45
17,8482122,Brock Faber,D,MIN,22,75,6,39,45
17,8480893,Kirill Marchenko,R,CBJ,24,65,28,16,44
17,8476880,Tom Wilson,R,WSH,30,67,22,22,44
17,8483515,Juraj Slafkovsky,L,MTL,20,73,19,25,44
17,8476419,Jean-Gabriel Pageau,C,NYI,32,76,17,27,44
17,8482720,Matthew Knies,L,TOR,22,75,14,30,44
17,8481618,Alex Newhook,C,MTL,23,75,13,31,44
17,8478474,Lawson Crouse,L,UTA,27,73,23,20,43
17,8476458,Ryan Strome,C,ANA,31,71,17,26,43
17,8480009,Eeli Tolvanen,R,SEA,25,76,15,28,43
17,8476923,Damon Severson,D,CBJ,30,82,6,37,43
17,8474586,Jordan Eberle,R,SEA,34,73,18,24,42
17,8478046,Danton Heinen,L,VAN,29,68,17,25,42
17,8477953,Kasperi Kapanen,R,STL,28,59,17,25,42
17,8478057,Dakota Joshua,C,VAN,28,72,16,26,42
17,8477986,Brandon Montour,D,SEA,30,71,13,29,42
17,8476906,Shayne Gostisbehere,D,CAR,31,77,11,31,42
17,8482702,Logan Stankoven,C,DAL,21,80,23,18,41
17,8476392,Adam Lowry,C,WPG,31,70,21,20,41
17,8479992,Michael Rasmussen,C,DET,25,78,17,24,41
17,8475753,Justin Faulk,D,STL,32,73,13,28,41
17,8482671,Owen Power,D,BUF,22,71,11,30,41
17,8477498,Darnell Nurse,D,EDM,29,75,10,31,41
17,8482475,Yegor Chinakhov,R,CBJ,23,62,22,18,40
17,8480064,Josh Norris,C,OTT,25,73,21,19,40
17,8479365,Trent Frederic,C,BOS,26,81,20,20,40
17,8477444,Andre Burakovsky,L,SEA,29,67,18,22,40
17,8478401,Pavel Zacha,C,BOS,27,80,15,25,40
17,8481703,Valtteri Puustinen,R,PIT,25,60,6,34,40
17,8478109,Victor Olofsson,L,VGK,29,73,24,15,39
17,8480798,Philipp Kurashev,C,CHI,25,62,19,20,39
17,8471698,T.J. Oshie,R,WSH,38,64,19,20,39
17,8475149,Marcus Johansson,L,MIN,34,71,19,20,39
17,8479591,Michael Eyssimont,C,TBL,28,80,17,22,39
17,8479525,Ross Colton,C,COL,28,79,16,23,39
17,8477511,Anthony Mantha,R,CGY,30,77,15,24,39
17,8482113,Anton Lundell,C,FLA,23,76,14,25,39
17,8481581,Thomas Harley,D,DAL,23,74,12,27,39
17,8482712,Oskar Olausson,R,COL,22,80,11,28,39
17,8480459,Pius Suter,C,VAN,28,68,26,12,38
17,8481535,Nils Hoglander,L,VAN,24,64,24,14,38
17,8483524,Shane Wright,C,SEA,20,64,21,17,38
17,8474715,Cameron Atkinson,R,TBL,35,81,17,21,38
17,8475791,Taylor Hall,L,CHI,33,61,16,22,38
17,8481596,Shane Pinto,C,OTT,24,72,14,24,38
17,8475799,Nino Niederreiter,R,WPG,32,69,14,24,38
17,8478469,Thomas Chabot,D,OTT,27,76,9,29,38
17,8474053,Logan Couture,C,SJS,35,58,14,23,37
17,8481524,Bowen Byram,D,BUF,23,69,14,23,37
17,8481546,Cam York,D,PHI,23,69,12,25,37
17,8476461,Sean Couturier,C,PHI,32,72,12,25,37
17,8478133,Jake Evans,C,MTL,28,70,12,25,37
17,8482092,Ridly Greig,C,OTT,22,73,11,26,37
17,8476979,Erik Gustafsson,D,DET,32,75,7,30,37
17,8479345,Jakob Chychrun,D,WSH,26,67,6,31,37
17,8478500,Ivan Provorov,D,CBJ,27,78,3,34,37
17,8475848,Brendan Gallagher,R,MTL,32,75,17,19,36
17,8478542,Evan Rodrigues,C,FLA,31,76,16,20,36
17,8481604,Pavel Dorofeyev,L,VGK,24,70,16,20,36
17,8479400,Pierre-Luc Dubois,L,WSH,26,61,16,20,36
17,8475287,Erik Haula,L,NJD,33,73,16,20,36
17,8477429,Andrew Copp,C,DET,30,79,14,22,36
17,8480028,Morgan Frost,C,PHI,25,71,13,23,36
17,8480829,Jesperi Kotkaniemi,C,CAR,24,71,13,23,36
17,8476854,Hampus Lindholm,D,BOS,30,71,8,28,36
17,8475764,Cam Fowler,D,ANA,33,71,3,33,36
17,8478043,Sam Lafferty,C,BUF,29,59,18,17,35
17,8477425,Miles Wood,L,COL,29,78,15,20,35
17,8478438,Tommy Novak,C,NSH,27,75,13,22,35
17,8475763,Kevin Hayes,R,PIT,32,65,13,22,35
17,8480113,Alex Iafallo,L,WPG,31,70,13,22,35
17,8477932,Aaron Ekblad,D,FLA,28,70,12,23,35
17,8477503,Max Domi,C,TOR,29,81,9,26,35
17,8476292,Ondrej Palat,L,NJD,33,67,9,26,35
17,8482133,Thomas Bordeleau,C,SJS,22,65,9,26,35
17,8478055,Gustav Forsling,D,FLA,28,75,4,31,35
17,8478233,Andrew Mangiapane,L,WSH,28,67,18,16,34
17,8480068,Ryan Poehling,C,PHI,25,66,14,20,34
17,8478020,Michael Amadio,R,OTT,28,71,13,21,34
17,8475218,Mattias Ekholm,D,EDM,34,74,12,22,34
17,8480336,Sean Walker,D,CAR,30,73,11,23,34
17,8479351,Sam Steel,C,DAL,26,77,10,24,34
17,8480817,K'Andre Miller,D,NYR,24,72,9,25,34
17,8476882,Teuvo Teravainen,C,CHI,30,76,6,28,34
17,8477969,Marcus Pettersson,D,PIT,28,80,4,30,34
17,8481580,Connor McMichael,C,WSH,23,62,20,13,33
17,8480849,Barrett Hayton,C,UTA,24,75,17,16,33
17,8476897,Oskar Sundqvist,C,STL,30,65,17,16,33
17,8474189,Lars Eller,C,PIT,35,62,16,17,33
17,8476921,Jordan Martinook,L,CAR,32,64,13,20,33
17,8477505,Alexander Wennberg,C,SJS,30,64,12,21,33
17,8474716,Jared Spurgeon,D,MIN,35,78,12,21,33
17,8481606,Jordan Spence,D,LAK,23,67,9,24,33
17,8476462,Dougie Hamilton,D,NJD,31,65,7,26,33
17,8473507,Jeff Petry,D,DET,37,74,6,27,33
17,8482125,Alexander Holtz,R,VGK,22,65,17,15,32
17,8481554,Kaapo Kakko,R,NYR,23,68,17,15,32
17,8479619,Michael Carcone,L,UTA,28,60,17,15,32
17,8476981,Josh Anderson,R,MTL,30,66,16,16,32
17,8480813,Joe Veleno,C,DET,24,76,15,17,32
17,8481523,Kirby Dach,C,MTL,23,70,14,18,32
17,8482097,Jack Quinn,R,BUF,23,63,13,19,32
17,8476474,Stefan Noesen,R,NJD,31,66,13,19,32
17,8477964,Ivan Barbashev,C,VGK,29,78,11,21,32
17,8484203,Bradly Nadeau,L,CAR,19,62,9,23,32
17,8477495,Seth Jones,D,CHI,30,62,8,24,32
17,8482105,Jake Sanderson,D,OTT,22,73,7,25,32
17,8475200,Dmitry Orlov,D,CAR,33,76,4,28,32
17,8476422,Mike Reilly,D,NYI,31,75,3,29,32
17,8478396,Noah Hanifin,D,VGK,27,64,2,30,32
17,8477987,Ryan Donato,C,CHI,28,64,17,14,31
17,8477451,Ryan Hartman,R,MIN,30,67,16,15,31
17,8480078,Filip Chytil,C,NYR,25,65,14,17,31
17,8480871,Adam Boqvist,D,FLA,24,72,11,20,31
17,8481656,Aliaksei Protas,C,WSH,23,70,9,22,31
17,8476438,Brandon Saad,L,STL,32,69,18,12,30
17,8475714,Calle Jarnkrok,C,TOR,33,70,17,13,30
17,8480220,Noah Cates,L,PHI,25,69,16,14,30
17,8480789,Oliver Wahlstrom,R,NYI,24,72,14,16,30
17,8477947,Sonny Milano,L,WSH,28,70,14,16,30
17,8478115,Pierre Engvall,L,NYI,28,72,12,18,30
17,8478891,Mason Appleton,C,WPG,28,62,12,18,30
17,8477839,Conor Sheary,L,TBL,32,81,12,18,30
17,8478413,Jordan Greenway,L,BUF,27,66,12,18,30
17,8480246,Nick Perbix,D,TBL,26,75,4,26,30
17,8481014,Alexander Romanov,D,NYI,24,79,2,28,30
17,8476902,Esa Lindell,D,DAL,30,74,2,28,30
17,8482089,Jake Neighbours,L,STL,22,65,18,11,29
17,8482175,JJ Peterka,R,BUF,22,73,16,13,29
17,8478463,Anthony Beauvillier,L,PIT,27,60,15,14,29
17,8480835,Jack Drury,C,CAR,24,57,14,15,29
17,8474149,Evgenii Dadonov,R,DAL,35,81,13,16,29
17,8478472,Mathieu Joseph,R,STL,27,61,10,19,29
17,8477919,Frederick Gaudreau,C,MIN,31,62,8,21,29
17,8482705,Cole Sillinger,C,CBJ,21,63,17,11,28
17,8479996,Cody Glass,C,NSH,25,65,16,12,28
17,8475722,Jason Zucker,L,BUF,32,65,11,17,28
17,8484145,Zach Benson,L,BUF,19,70,10,18,28
17,8483505,Matthew Poitras,C,BOS,20,74,10,18,28
17,8476480,Vladislav Namestnikov,C,WPG,32,62,8,20,28
17,8479390,Taylor Raddysh,R,WSH,26,67,8,20,28
17,8476917,Adam Pelech,D,NYI,30,77,6,22,28
17,8479398,Samuel Girard,D,COL,26,64,6,22,28
17,8475171,Oliver Ekman-Larsson,D,TOR,33,63,6,22,28
17,8479402,Jake Bean,D,CGY,26,63,5,23,28
17,8474151,Ryan McDonagh,D,TBL,35,80,3,25,28
17,8482737,Zack Bolduc,C,STL,21,64,14,13,27
17,8475855,Jesper Fast,R,CAR,33,66,12,15,27
17,8480748,Kiefer Sherwood,L,VAN,29,65,10,17,27
17,8480873,Rasmus Sandin,D,WSH,24,60,3,24,27
17,8482655,Janis Moser,D,TBL,24,78,2,25,27
17,8477478,William Carrier,L,CAR,30,56,17,9,26
17,8479368,Max Jones,L,BOS,26,64,14,12,26
17,8475193,Tomas Tatar,L,NJD,34,69,12,14,26
17,8481624,Ilya Mikheyev,R,CHI,30,58,11,15,26
17,8480205,Emil Bemstrom,C,PIT,25,64,10,16,26
17,8480855,Jack McBain,C,UTA,24,64,10,16,26
17,8479293,Brandon Tanev,L,SEA,33,69,8,18,26
17,8483445,Cutter Gauthier,L,ANA,20,60,8,18,26
17,8480145,Neal Pionk,D,WPG,29,74,6,20,26
17,8478178,Darren Raddysh,D,TBL,28,64,6,20,26
17,8477506,Ryan Pulock,D,NYI,30,77,4,22,26
17,8476892,Colton Parayko,D,STL,31,75,3,23,26
17,8470621,Corey Perry,R,EDM,39,70,16,9,25
17,8481582,Nicholas Robertson,L,TOR,23,68,14,11,25
17,8473533,Jordan Staal,C,CAR,36,58,13,12,25
17,8480762,Eric Robinson,L,CAR,29,59,13,12,25
17,8479353,Brett Howden,C,VGK,26,68,12,13,25
17,8475231,Casey Cizikas,C,NYI,33,71,12,13,25
17,8479941,Justin Danforth,R,CBJ,31,61,12,13,25
17,8481601,Simon Holmstrom,R,NYI,23,74,11,14,25
17,8482809,Jackson Blake,R,CAR,21,60,11,14,25
17,8476925,Colton Sissons,C,NSH,31,58,9,16,25
17,8476329,Travis Boyd,C,MIN,31,56,9,16,25
17,8478434,Keegan Kolesar,R,VGK,27,73,9,16,25
17,8480802,Ryan McLeod,C,BUF,25,65,8,17,25
17,8474034,Patrick Maroon,L,CHI,36,55,8,17,25
17,8478432,Christian Fischer,R,DET,27,78,7,18,25
17,8477435,Ryan Graves,D,PIT,29,75,6,19,25
17,8482624,Daniil Miromanov,D,CGY,27,70,5,20,25
17,8478399,Jonas Siegenthaler,D,NJD,27,62,2,23,25
17,8481178,Egor Zamula,D,PHI,24,55,2,23,25
17,8476331,Dylan DeMelo,D,WPG,31,73,1,24,25
17,8473422,Nick Foligno,L,CHI,37,61,16,8,24
17,8476878,Zemgus Girgensons,C,TBL,30,77,16,8,24
17,8478569,Noel Acciari,C,PIT,33,64,13,11,24
17,8476278,Colin Blackwell,C,DAL,31,81,10,14,24
17,8481093,Rafael Harvey-Pinard,L,MTL,25,64,9,15,24
17,8482660,Kent Johnson,C,CBJ,22,61,8,16,24
17,8481522,Peyton Krebs,C,BUF,23,56,8,16,24
17,8475462,Radko Gudas,D,ANA,34,58,8,16,24
17,8477488,Brett Pesce,D,NJD,30,64,5,19,24
17,8482067,Connor Mackey,D,NYR,28,60,5,19,24
17,8478911,Matt Roy,D,WSH,29,67,5,19,24
17,8476463,Jonas Brodin,D,MIN,31,76,3,21,24
17,8483490,Pavel Mintyukov,D,ANA,21,70,2,22,24
17,8476885,Jacob Trouba,D,NYR,30,69,1,23,24
17,8482079,Marco Rossi,C,MIN,23,58,18,5,23
17,8477952,Robby Fabbri,C,ANA,28,61,14,9,23
17,8480144,David Kampf,C,TOR,29,67,14,9,23
17,8482259,Bobby McMann,C,TOR,28,60,13,10,23
17,8476873,Mark Jankowski,C,NSH,30,56,12,11,23
17,8475343,Nic Dowd,C,WSH,34,59,11,12,23
17,8482157,Will Cuylle,L,NYR,22,64,11,12,23
17,8476927,Teddy Blueger,C,VAN,30,71,10,13,23
17,8477989,Christian Dvorak,C,MTL,28,61,9,14,23
17,8483457,Lane Hutson,D,MTL,20,68,9,14,23
17,8477979,Nicolas Aube-Kubel,R,BUF,28,58,9,14,23
17,8483468,Jiri Kulich,C,BUF,20,64,7,16,23
17,8476457,Adam Larsson,D,SEA,32,65,7,16,23
17,8479983,Mario Ferraro,D,SJS,26,73,4,19,23
17,8476467,Jamie Oleksiak,D,SEA,32,66,4,19,23
17,8478507,John Marino,D,UTA,27,71,2,21,23
17,8482451,Mikael Pyyhtia,L,CBJ,23,41,2,21,23
17,8479661,Tanner Jeannot,L,LAK,27,71,18,4,22
17,8481641,Joel Kiviranta,L,COL,28,73,12,10,22
17,8480289,Morgan Barron,C,WPG,26,57,11,11,22
17,8482634,Alex Steeves,C,TOR,25,50,9,13,22
17,8479639,Dylan Coghlan,D,WPG,26,62,7,15,22
17,8476960,Andreas Athanasiou,C,CHI,30,49,7,15,22
17,8482055,Drew O'Connor,L,PIT,26,58,6,16,22
17,8475790,Erik Gudbranson,D,CBJ,32,77,4,18,22
17,8479982,Conor Timmins,D,TOR,26,62,4,18,22
17,8482074,Connor Zary,C,CGY,23,69,14,7,21
17,8481032,Paul Cotter,C,NJD,25,59,12,9,21
17,8483482,Tristan Luneau,D,ANA,20,68,9,12,21
17,8482148,Hendrix Lapierre,C,WSH,22,58,9,12,21
17,8477903,Garnet Hathaway,R,PHI,33,53,7,14,21
17,8479998,Mikey Anderson,D,LAK,25,63,5,16,21
17,8481568,Alex Vlasic,D,CHI,23,63,4,17,21
17,8480049,Dylan Samberg,D,WPG,25,63,2,19,21
17,8479371,Dante Fabbro,D,NSH,26,59,1,20,21
17,8478840,Will Borgen,D,SEA,28,71,0,21,21
17,8479316,Luke Kunin,C,SJS,27,47,14,6,20
17,8480281,Alexey Toropchenko,R,STL,25,59,13,7,20
17,8482749,Joshua Roy,R,MTL,21,60,12,8,20
17,8483499,Liam Ohgren,L,MIN,20,51,11,9,20
17,8479393,Noah Gregor,L,OTT,26,72,10,10,20
17,8477406,Mattias Janmark,C,EDM,32,62,9,11,20
17,8473563,Nicklas Backstrom,C,WSH,37,56,9,11,20
17,8480025,MacKenzie Entwistle,R,FLA,25,65,9,11,20
17,8477353,Tyler Motte,C,DET,29,72,8,12,20
17,8476918,Jimmy Vesey,L,NYR,31,68,8,12,20
17,8482111,Justin Barron,D,MTL,23,69,8,12,20
17,8483493,Frank Nazar,C,CHI,20,53,7,13,20
17,8478416,Erik Cernak,D,TBL,27,71,6,14,20
17,8478136,Jake Middleton,D,MIN,28,77,5,15,20
17,8481441,Joe Snively,C,DET,28,66,5,15,20
17,8480073,Erik Brannstrom,D,COL,25,67,4,16,20
17,8480043,Timothy Liljegren,D,TOR,25,74,2,18,20
17,8482087,Kaiden Guhle,D,MTL,22,72,2,18,20
17,8481059,Scott Perunovich,D,STL,26,61,2,18,20
17,8480891,Michael Kesselring,D,UTA,24,60,1,19,20
17,8481013,Jonatan Berggren,R,DET,24,58,12,7,19
17,8481716,Dmitri Voronkov,L,CBJ,24,52,11,8,19
17,8480074,Alexandre Texier,C,STL,25,59,9,10,19
17,8482176,Wyatt Kaiser,D,CHI,22,59,9,10,19
17,8477450,Jason Dickinson,C,CHI,29,54,8,11,19
17,8482803,Olen Zellweger,D,ANA,21,67,7,12,19
17,8480995,Pontus Holmberg,R,TOR,25,65,7,12,19
17,8480003,Jesper Boqvist,C,FLA,26,71,6,13,19
17,8483491,Ivan Miroshnichenko,L,WSH,20,53,6,13,19
17,8478882,Vladislav Gavrikov,D,LAK,29,74,5,14,19
17,8482073,Braden Schneider,D,NYR,23,64,5,14,19
17,8475455,Brenden Dillon,D,NJD,34,56,4,15,19
17,8476856,Mathew Dumba,D,DAL,30,67,3,16,19
17,8470600,Ryan Suter,D,STL,39,62,2,17,19
17,8476624,Barclay Goodrow,C,SJS,31,60,12,6,18
17,8479336,Carl Grundstrom,R,SJS,27,51,11,7,18
17,8476469,Joel Armia,R,MTL,31,63,11,7,18
17,8477508,Curtis Lazar,C,NJD,29,60,11,7,18
17,8473453,Trevor Lewis,C,LAK,37,75,10,8,18
17,8479520,Brandon Duhaime,R,WSH,27,55,10,8,18
17,8481521,Ronnie Attard,D,PHI,25,54,9,9,18
17,8481481,Blake Lizotte,C,PIT,27,66,9,9,18
17,8477931,Tomas Nosek,L,FLA,32,61,9,9,18
17,8477015,Connor Brown,R,EDM,30,61,7,11,18
17,8478585,Derek Ryan,C,EDM,38,70,7,11,18
17,8480807,Mattias Samuelsson,D,BUF,24,54,7,11,18
17,8481553,Bobby Brink,R,PHI,23,64,6,12,18
17,8477573,Nathan Walker,L,STL,30,55,6,12,18
17,8482101,Danil Gushchin,L,SJS,22,60,5,13,18
17,8479976,Juuso Valimaki,D,UTA,26,61,5,13,18
17,8475188,Brayden McNabb,D,VGK,33,52,5,13,18
17,8475690,Chris Tanev,D,TOR,35,61,5,13,18
17,8480001,Urho Vaakanainen,D,ANA,25,58,4,14,18
17,8478443,Brandon Carlo,D,BOS,28,67,3,15,18
17,8480887,Jordan Harris,D,MTL,24,54,3,15,18
17,8479980,Nicolas Hague,D,VGK,26,59,2,16,18
17,8480172,Jan Rutta,D,SJS,34,60,2,16,18
17,8477845,Trevor van Riemsdyk,D,WSH,33,61,2,16,18
17,8475181,Nick Leddy,D,STL,33,67,0,18,18
17,8479344,Jesse Puljujarvi,R,PIT,26,59,10,7,17
17,8481517,Brett Leason,R,ANA,25,56,9,8,17
17,8480011,Klim Kostin,C,SJS,25,49,6,11,17
17,8475279,Ben Chiarot,D,DET,33,64,6,11,17
17,8471817,Ryan Reaves,R,TOR,37,59,6,11,17
17,8478013,Jake Walman,D,SJS,28,67,5,12,17
17,8478970,Jalen Chatfield,D,CAR,28,65,5,12,17
17,8480806,Isac Lundestrom,C,ANA,25,59,4,13,17
17,8476429,Scott Mayfield,D,NYI,32,73,3,14,17
17,8474166,Alec Martinez,D,CHI,37,50,3,14,17
17,8478851,Alexandre Carrier,D,NSH,28,67,1,16,17
17,8476931,Jake McCabe,D,TOR,31,61,0,17,17
17,8482155,Alex Laferriere,R,LAK,23,63,10,6,16
17,8481028,Martin Pospisil,C,CGY,25,47,10,6,16
17,8482679,Matt Coronato,R,CGY,22,64,9,7,16
17,8477392,Hudson Fasching,R,NYI,29,60,9,7,16
17,8475220,Marcus Foligno,L,MIN,33,56,8,8,16
17,8479414,Nathan Bastian,R,NJD,27,58,7,9,16
17,8478508,Yakov Trenin,C,MIN,27,60,7,9,16
17,8483565,Nick Blankenburg,D,NSH,26,54,7,9,16
17,8476374,Sean Kuraly,C,CBJ,31,60,6,10,16
17,8483495,Simon Nemec,D,NJD,20,62,6,10,16
17,8475842,Sam Carrick,C,NYR,32,62,6,10,16
17,8482142,Jamie Drysdale,D,PHI,22,64,5,11,16
17,8480950,Ilya Lyubushkin,D,DAL,30,60,3,13,16
17,8476967,Brett Kulak,D,EDM,30,66,2,14,16
17,8471709,Marc-Edouard Vlasic,D,SJS,37,59,2,14,16
17,8482077,Dylan Holloway,L,EDM,23,49,10,5,15
17,8481704,Juuso Parssinen,C,NSH,23,48,7,8,15
17,8480980,Connor Dewar,C,TOR,25,70,7,8,15
17,8477499,Rasmus Ristolainen,D,PHI,30,62,7,8,15
17,8478831,Kevin Stenlund,C,UTA,28,52,7,8,15
17,8482192,Isaak Phillips,D,CHI,23,55,6,9,15
17,8476988,Matt Benning,D,SJS,30,67,5,10,15
17,8475324,Nick Jensen,D,OTT,34,68,5,10,15
17,8480021,Jack Studnicka,C,LAK,25,60,5,10,15
17,8477369,Carson Soucy,D,VAN,30,57,4,11,15
17,8479324,Ryan Lindgren,D,NYR,26,64,4,11,15
17,8477380,Jonny Brodzinski,C,NYR,31,54,4,11,15
17,8481527,Kaedan Korczak,D,VGK,23,47,3,12,15
17,8482245,Artem Zub,D,OTT,29,71,3,12,15
17,8478452,Caleb Jones,D,LAK,27,56,3,12,15
17,8476525,Colin Miller,D,WPG,32,65,3,12,15
17,8480878,Nils Lundkvist,D,DAL,24,74,2,13,15
17,8476879,Cody Ceci,D,EDM,31,61,1,14,15
17,8478454,Noah Juulsen,D,VAN,27,43,1,14,15
17,8478421,A.J. Greer,L,FLA,28,59,7,7,14
17,8482062,Cole Smith,L,NSH,29,54,6,8,14
17,8479439,Jacob MacDonald,D,COL,31,46,6,8,14
17,8482166,Shakir Mukhamadullin,D,SJS,22,53,6,8,14
17,8482666,Scott Morrow,D,CAR,22,50,5,9,14
17,8480035,Henri Jokiharju,D,BUF,25,67,4,10,14
17,8484254,Akito Hirose,D,VAN,25,41,4,10,14
17,8479315,Joey Anderson,R,CHI,26,49,2,12,14
17,8477507,Nikita Zadorov,D,BOS,29,74,2,12,14
17,8475179,Dmitry Kulikov,D,FLA,34,62,1,13,14
17,8475225,Craig Smith,C,CHI,35,49,9,4,13
17,8479638,Justin Brazeau,R,BOS,26,37,8,5,13
17,8479359,Beck Malenstyn,L,BUF,26,47,8,5,13
17,8482117,Lukas Reichel,L,CHI,22,53,7,6,13
17,8481751,Lukas Rousek,R,BUF,25,37,7,6,13
17,8477070,Liam O'Brien,C,UTA,30,61,7,6,13
17,8474574,Tyler Myers,D,VAN,34,65,6,7,13
17,8479543,Michael Pezzetta,L,MTL,26,55,5,8,13
17,8479348,Kale Clague,D,BUF,26,39,5,8,13
17,8482807,Ethan Del Mastro,D,CHI,21,42,4,9,13
17,8482733,Logan Mailloux,D,MTL,31,35,4,9,13
17,8476312,Josh Manson,D,COL,33,57,3,10,13
17,8482859,Zack Ostapchuk,C,OTT,21,57,3,10,13
17,8476822,Luke Glendening,C,TBL,35,77,3,10,13
17,8483460,David Jiricek,D,CBJ,21,51,3,10,13
17,8475233,David Savard,D,MTL,34,59,1,12,13
17,8481019,David Gustafsson,C,WPG,24,46,1,12,13
17,8480355,Mark Kastelic,C,BOS,25,62,8,4,12
17,8479370,Tyson Jost,C,CAR,26,51,5,7,12
17,8476994,Vinnie Hinostroza,C,NSH,30,47,5,7,12
17,8479718,Alex Barré-Boulet,C,MTL,27,50,4,8,12
17,8484149,Gavin Brindley,C,CBJ,20,51,4,8,12
17,8477446,Michael McCarron,R,NSH,29,50,3,9,12
17,8475208,Brian Dumoulin,D,ANA,33,64,3,9,12
17,8481567,Henry Thrun,D,SJS,23,49,3,9,12
17,8480845,Rasmus Kupari,C,WPG,24,40,3,9,12
17,8479249,Andrew Poturalski,C,SJS,30,33,3,9,12
17,8474673,TJ Brodie,D,CHI,34,59,2,10,12
17,8476891,Matthew Grzelcyk,D,PIT,30,74,1,11,12
17,8480058,Pierre-Olivier Joseph,D,STL,25,53,1,11,12
17,8475235,Nicolas Deslauriers,L,PHI,33,49,8,3,11
17,8479066,Ryan Lomberg,L,CGY,30,64,7,4,11
17,8480448,Parker Kelly,L,COL,25,78,7,4,11
17,8479291,Kevin Rooney,C,CGY,31,46,6,5,11
17,8482751,Ryan Winterton,C,SEA,21,35,6,5,11
17,8481592,Jakob Pelletier,L,CGY,23,44,5,6,11
17,8479986,Kole Lind,R,DAL,26,49,5,6,11
17,8479372,Joshua Mahura,D,SEA,26,46,5,6,11
17,8477482,Zachary Sanford,L,CHI,30,34,5,6,11
17,8477851,Jordan Oesterle,D,BOS,32,37,5,6,11
17,8481518,Nolan Foote,L,NJD,24,37,4,7,11
17,8474567,Zach Bogosian,D,MIN,34,64,4,7,11
17,8481161,Jake Christiansen,D,CBJ,25,55,4,7,11
17,8478211,Dryden Hunt,L,CGY,29,52,3,8,11
17,8480727,Zach Whitecloud,D,VGK,28,48,2,9,11
17,8480848,Ty Dellandrea,C,SJS,24,47,2,9,11
17,8483763,Maksymilian Szuber,D,UTA,22,26,2,9,11
17,8479369,Andrew Peeke,D,BOS,26,58,0,11,11
17,8475177,Calvin de Haan,D,COL,33,45,0,11,11
17,8482659,Josh Doan,R,UTA,22,46,8,2,10
17,8476889,Radek Faksa,C,STL,30,58,7,3,10
17,8481532,Alex Turcotte,C,LAK,23,40,5,5,10
17,8476934,Brock McGinn,L,ANA,30,55,4,6,10
17,8479972,Mason Shaw,C,WPG,26,33,4,6,10
17,8481537,Nikita Okhotiuk,D,CGY,24,54,3,7,10
17,8482496,Nils Aman,C,VAN,24,42,3,7,10
17,8482730,Brandt Clarke,D,LAK,21,53,3,7,10
17,8481617,Vasily Podkolzin,R,VAN,23,42,3,7,10
17,8476867,Brendan Gaunce,C,MIN,30,36,3,7,10
17,8481598,Philip Broberg,D,EDM,23,38,3,7,10
17,8483549,Lucas Condotta,L,MTL,27,38,3,7,10
17,8481701,Santeri Hatakka,D,NJD,23,42,2,8,10
17,8477220,Nate Schmidt,D,FLA,33,58,1,9,10
17,8476874,Olli Maatta,D,DET,30,66,1,9,10
17,8480222,Sebastian Aho,D,PIT,28,73,1,9,10
17,8477034,Jaycob Megna,D,FLA,32,40,1,9,10
17,8475718,Justin Holl,D,DET,32,55,1,9,10
17,8482070,Mitchell Chaffee,R,TBL,26,50,8,1,9
17,8479328,Julien Gauthier,R,NYI,27,60,6,3,9
17,8482762,Simon Edvinsson,D,DET,21,61,6,3,9
17,8479968,Vinni Lettieri,C,BOS,29,44,5,4,9
17,8483012,Logan Morrison,C,SEA,22,38,5,4,9
17,8484911,Collin Graf,R,SJS,22,41,5,4,9
17,8478017,Mark Friedman,D,VAN,29,36,5,4,9
17,8479772,Zack MacEwen,R,OTT,28,57,4,5,9
17,8479944,Zach Aston-Reese,C,VGK,30,47,4,5,9
17,8478409,Anthony Richard,C,PHI,28,36,4,5,9
17,8483466,Kevin Korchinski,D,CHI,20,46,3,6,9
17,8478468,Jeremy Lauzon,D,NSH,27,55,3,6,9
17,8475750,Jon Merrill,D,MIN,32,61,3,6,9
17,8474090,Brendan Smith,D,DAL,35,56,3,6,9
17,8477401,John Hayden,C,SEA,29,30,3,6,9
17,8482964,Arber Xhekaj,D,MTL,23,41,3,6,9
17,8481056,Spencer Stastney,D,NSH,24,31,3,6,9
17,8474013,Ian Cole,D,UTA,35,48,2,7,9
17,8479442,Troy Stecher,D,EDM,30,55,2,7,9
17,8477335,Kyle Burroughs,D,LAK,29,47,2,7,9
17,8478146,Matthew Highmore,C,OTT,28,45,2,7,9
17,8480879,Jacob Bernard-Docker,D,OTT,24,46,2,7,9
17,8479026,Philippe Myers,D,TOR,27,52,1,8,9
17,8476372,Nick Seeler,D,PHI,31,47,1,8,9
17,8481609,Vladislav Kolyachonok,D,UTA,23,35,7,1,8
17,8481147,Reese Johnson,C,MIN,26,40,5,3,8
17,8480252,Cole Guttman,C,CHI,25,36,5,3,8
17,8481679,Maxence Guenette,D,OTT,23,36,5,3,8
17,8480441,Trey Fix-Wolansky,R,CBJ,25,40,4,4,8
17,8478424,Jansen Harkins,C,ANA,27,41,3,5,8
17,8476952,Dominic Toninato,C,WPG,30,38,3,5,8
17,8480860,Kevin Bahl,D,CGY,24,59,2,6,8
17,8480192,Johnathan Kovacevic,D,NJD,27,47,2,6,8
17,8471677,Jack Johnson,D,CBJ,37,68,2,6,8
17,8482141,Lukas Cormier,D,VGK,22,28,2,6,8
17,8480796,Martin Fehervary,D,WSH,25,51,1,7,8
17,8476473,Connor Murphy,D,CHI,31,36,1,7,8
17,8482095,Tyler Kleven,D,OTT,22,45,1,7,8
17,8474568,Luke Schenn,D,NSH,35,52,1,7,8
17,8477244,Chad Ruhwedel,D,NYR,34,37,1,7,8
17,8482747,Brennan Othmann,L,NYR,21,43,7,0,7
17,8482784,Zach Dean,C,STL,21,47,6,1,7
17,8481600,Tobias Bjornfot,D,FLA,23,51,5,2,7
17,8481754,Nikita Nesterenko,C,ANA,23,32,4,3,7
17,8483619,Filip Roos,D,OTT,25,29,4,3,7
17,8480870,Bo Groulx,C,NYR,24,35,4,3,7
17,8480245,Olle Lycksell,R,PHI,25,40,4,3,7
17,8476858,Phillip Di Giuseppe,L,VAN,31,38,3,4,7
17,8480990,Declan Chisholm,D,MIN,24,33,3,4,7
17,8477018,Ben Hutton,D,VGK,31,46,3,4,7
17,8478859,Niko Mikkola,D,FLA,28,55,2,5,7
17,8477938,Haydn Fleury,D,WPG,28,41,2,5,7
17,8481708,Zac Jones,D,NYR,24,53,2,5,7
17,8481122,Simon Benoit,D,TOR,26,37,2,5,7
17,8481599,Victor Soderstrom,D,UTA,23,46,1,6,7
17,8479671,Mathieu Olivier,R,CBJ,27,42,1,6,7
17,8479379,Givani Smith,R,SJS,26,33,1,6,7
17,8483630,Pavol Regenda,L,ANA,25,23,1,6,7
17,8474612,Travis Hamonic,D,OTT,34,47,1,6,7
17,8476441,Joel Edmundson,D,LAK,31,37,1,6,7
17,8477971,Andreas Englund,D,LAK,28,20,1,6,7
17,8477365,Connor Clifton,D,BUF,29,51,0,7,7
17,8479981,Jonah Gadjovich,L,FLA,26,44,5,1,6
17,8482145,Mavrik Bourque,C,DAL,22,46,4,2,6
17,8477527,Ross Johnston,L,ANA,30,38,4,2,6
17,8482744,James Malatesta,L,CBJ,21,40,3,3,6
17,8475762,Derek Forbort,D,VAN,32,49,3,3,6
17,8481789,Tye Kartye,L,SEA,23,37,3,3,6
17,8483397,Marc McLaughlin,C,BOS,25,33,3,3,6
17,8482713,Mackie Samoskevich,R,FLA,22,34,3,3,6
17,8480084,Nick DeSimone,D,NJD,30,20,3,3,6
17,8481550,Adam Beckman,L,NJD,23,36,2,4,6
17,8481167,Brayden Pachal,D,CGY,25,45,2,4,6
17,8481237,Kyle MacLean,C,NYI,25,25,2,4,6
17,8476442,Matt Nieto,L,PIT,32,49,0,6,6
17,8473446,Erik Johnson,D,PHI,36,41,0,6,6
17,8477887,Patrick Brown,C,BOS,32,43,0,6,6
17,8475958,Michael Sgarbossa,C,WSH,32,19,4,1,5
17,8481477,Nico Sturm,C,SJS,29,45,3,2,5
17,8482652,Walker Duehr,R,CGY,27,39,3,2,5
17,8480292,Carson Meyer,R,ANA,27,33,3,2,5
17,8483570,Ben Meyers,C,SEA,26,28,3,2,5
17,8476913,Devin Shore,C,MIN,30,34,3,2,5
17,8480844,Grigori Denisenko,L,VGK,24,27,2,3,5
17,8479994,Jaret Anderson-Dolan,C,WPG,25,35,2,3,5
17,8479985,Cale Fleury,D,SEA,26,30,2,3,5
17,8480880,Jakub Lauko,C,MIN,24,34,2,3,5
17,8478450,Parker Wotherspoon,D,BOS,27,27,2,3,5
17,8482765,Isak Rosen,R,BUF,21,24,2,3,5
17,8477462,Robert Hagg,D,VGK,29,21,2,3,5
17,8477467,Gustav Olofsson,D,SEA,30,20,2,3,5
17,8477320,Anton Blidh,L,NYR,29,26,2,3,5
17,8478451,Ethan Bear,D,WSH,27,48,1,4,5
17,8482858,Ryker Evans,D,SEA,23,20,1,4,5
17,8477962,Brendan Lemieux,L,CAR,28,27,1,4,5
17,8479991,Jake Leschyshyn,C,NYR,25,25,1,4,5
17,8478477,Mitchell Stephens,C,SEA,27,21,1,4,5
17,8482511,Mason Lohrei,D,BOS,23,39,1,4,5
17,8478011,Louie Belpedio,D,PHI,28,17,1,4,5
17,8482861,Vincent Iorio,D,WSH,22,30,0,5,5
17,8477384,Joshua Brown,D,EDM,30,46,0,5,5
17,8480196,Jacob Bryson,D,BUF,27,43,0,5,5
17,8479576,Vincent Desharnais,D,VAN,28,31,0,5,5
17,8480032,Shane Bowers,C,NJD,25,13,4,0,4
17,8480468,James Hamblin,L,EDM,25,19,3,1,4
17,8474062,Riley Nash,C,NYR,35,14,3,1,4
17,8479320,Maxime Lajoie,D,SEA,27,29,3,1,4
17,8479419,Brett Murray,L,BUF,26,22,3,1,4
17,8480007,Jonas Rondbjerg,R,VGK,25,24,2,2,4
17,8478051,Max Willman,C,NJD,29,14,2,2,4
17,8482144,Jack Thompson,D,SJS,22,31,2,2,4
17,8481605,Jackson LaCombe,D,ANA,23,36,2,2,4
17,8482172,Landon Slaggert,L,CHI,22,26,2,2,4
17,8480823,Alexander Alexeyev,D,WSH,25,15,2,2,4
17,8484258,Sam Malinski,D,COL,26,26,2,2,4
17,8480157,Calle Rosen,D,COL,30,45,1,3,4
17,8480834,Ty Emberson,D,SJS,24,33,1,3,4
17,8482177,Marat Khusnutdinov,C,MIN,22,33,1,3,4
17,8479587,Rhett Gardner,C,PHI,28,20,1,3,4
17,8477073,Kurtis MacDermid,L,NJD,30,26,1,3,4
17,8477149,Scott Sabourin,R,SJS,32,15,0,4,4
17,8475413,Justin Dowling,C,NJD,34,19,0,4,4
17,8482147,Jean-Luc Foudy,C,COL,22,18,3,0,3
17,8479362,Riley Tufte,L,BOS,26,19,3,0,3
17,8481556,John Beecher,C,BOS,23,29,2,1,3
17,8480851,Akil Thomas,C,LAK,24,21,2,1,3
17,8480890,Jan Jenik,C,OTT,24,29,2,1,3
17,8479367,William Lockwood,R,FLA,26,20,2,1,3
17,8481699,Aku Raty,R,UTA,23,14,2,1,3
17,8479536,Axel Jonsson-Fjallby,L,WPG,26,36,1,2,3
17,8478874,Adam Gaudette,R,OTT,28,36,1,2,3
17,8481543,Nikita Alexandrov,C,STL,24,25,1,2,3
17,8481719,Maxwell Crozier,D,TBL,24,9,1,2,3
17,8479522,Hardy Haman Aktell,D,WSH,26,5,1,2,3
17,8480070,Ian Mitchell,D,BOS,25,43,0,3,3
17,8480267,Sammy Walker,C,MIN,25,17,0,3,3
17,8482250,Callahan Burke,C,VGK,27,22,0,3,3
17,8475795,Dylan McIlrath,D,WSH,32,14,0,3,3
17,8481043,Cole Koepke,L,BOS,26,14,0,3,3
17,8481743,Marc Del Gaizo,D,NSH,25,25,0,3,3
17,8483512,Matthew Savoie,C,EDM,20,27,0,3,3
17,8478881,Brett Seney,L,CHI,28,14,2,0,2
17,8483567,Georgii Merkulov,C,BOS,24,10,2,0,2
17,8481593,Jayden Struble,D,MTL,23,16,2,0,2
17,8479330,Brandon Gignac,C,MTL,27,7,2,0,2
17,8479378,Logan Stanley,D,WPG,26,37,1,1,2
17,8481065,Angus Crookshank,L,OTT,25,17,1,1,2
17,8482165,Yan Kuznetsov,D,CGY,22,15,1,1,2
17,8480075,Cameron Crotty,D,MIN,25,11,1,1,2
17,8483597,Milos Kelemen,L,UTA,25,13,1,1,2
17,8481030,Jack St. Ivany,D,PIT,25,13,1,1,2
17,8482102,Vasily Ponomarev,C,PIT,22,22,1,1,2
17,8483489,Fraser Minten,C,TOR,31,9,1,1,2
17,8481541,Samuel Bolduc,D,NYI,24,23,1,1,2
17,8483407,Brandon Scanlin,D,NYR,25,3,1,1,2
17,8481462,Mason Morelli,L,VGK,28,15,1,1,2
17,8476323,Max McCormick,L,SEA,32,3,1,1,2
17,8477473,Justin Bailey,R,SJS,29,25,0,2,2
17,8481422,Jake Lucchini,C,NSH,29,18,0,2,2
17,8477810,Joel Hanley,D,CGY,33,25,0,2,2
17,8481806,Louis Crevier,D,CHI,23,20,0,2,2
17,8482929,Emil Lilleberg,D,TBL,23,26,0,2,2
17,8478854,Ryan Shea,D,PIT,27,9,0,2,2
17,8484287,Cole McWard,D,VAN,23,17,1,0,1
17,8482061,Brandon Biro,L,SEA,26,16,1,0,1
17,8477541,Dakota Mermis,D,TOR,30,10,1,0,1
17,8483920,Pierrick Dube,R,WSH,23,7,1,0,1
17,8478446,Glenn Gawdin,C,LAK,27,16,1,0,1
17,8482118,Sam Colangelo,R,ANA,23,14,1,0,1
17,8482162,Roby Jarventie,L,EDM,22,12,1,0,1
17,8483546,Marshall Rifai,D,TOR,26,3,1,0,1
17,8482197,Adam Raska,R,MIN,23,11,1,0,1
17,8482153,Brendan Brisson,C,VGK,23,37,0,1,1
17,8478021,William Lagesson,D,DET,28,23,0,1,1
17,8478502,Dennis Gilbert,D,BUF,28,21,0,1,1
17,8482516,Matthew Kessel,D,STL,24,20,0,1,1
17,8481206,John Ludvig,D,PIT,24,10,0,1,1
17,8483395,Arshdeep Bains,L,VAN,23,10,0,1,1
17,8482787,Nikita Chibrikov,R,WPG,31,9,0,1,1
17,8482094,Daemon Hunt,D,MIN,22,17,0,1,1
17,8481564,Ryan Johnson,D,BUF,23,9,0,1,1
17,8483609,Adam Klapka,R,CGY,24,3,0,1,1
17,8482201,Gage Goncalves,C,TBL,23,25,0,1,1
17,8483471,Brad Lambert,C,WPG,31,13,0,1,1
17,8477993,Justin Kirkland,C,CGY,28,5,0,1,1
17,8481006,Tyler Tucker,D,STL,24,11,0,1,1
17,8483432,Luca Del Bel Belluz,C,CBJ,31,7,0,1,1
17,8482088,Justin Sourdif,R,FLA,22,18,0,0,0
17,8475755,Alexander Petrovic,D,DAL,32,11,0,0,0
17,8481578,Graeme Clarke,R,MIN,23,13,0,0,0
17,8484325,Waltteri Merela,C,TBL,26,25,0,0,0
17,8480874,Adam Ginning,D,PHI,24,11,0,0,0
17,8481585,Egor Afanasyev,L,SJS,23,7,0,0,0
17,8475780,Chris Wagner,R,COL,33,9,0,0,0
17,8482470,Ilya Solovyov,D,CGY,24,12,0,0,0
17,8483398,Declan Carlile,D,TBL,31,8,0,0,0
17,8484259,Ondrej Pavel,C,COL,31,2,0,0,0
17,8480306,Grant Hutton,D,NYI,29,7,0,0,0
17,8481024,Linus Karlsson,C,VAN,25,12,0,0,0
17,8484321,Nikolas Matinpalo,D,OTT,26,1,0,0,0
17,8484304,Uvis Balinskis,D,FLA,28,9,0,0,0
17,8482476,Emil Heineman,L,MTL,23,11,0,0,0
17,8481726,Adam Edstrom,C,NYR,24,4,0,0,0
17,8483531,Brian Halonen,L,NJD,25,2,0,0,0
17,8484255,Jason Polin,R,COL,25,3,0,0,0
17,8484326,Patrik Koch,D,UTA,28,3,0,0,0
17,8482460,Matt Rempe,C,NYR,22,5,0,0,0
17,8479421,Jacob Moverare,D,LAK,26,4,0,0,0
17,8481655,Cole Schwindt,R,CGY,23,5,0,0,0
17,8478147,Bokondji Imama,L,PIT,28,5,0,0,0
17,8481534,Raphael Lavoie,C,EDM,24,7,0,0,0
17,8483401,Marc Johnstone,R,PIT,28,1,0,0,0
17,8482126,Emil Andrae,D,PHI,31,4,0,0,0
17,8470794,Joe Pavelski,C,,40,0,0,0,0
17,8479321,Lucas Johansen,D,,27,0,0,0,0
17,8477950,Tony DeAngelo,D,,29,0,0,0,0
17,8471218,Blake Wheeler,R,,38,0,0,0,0
17,8475197,Tyson Barrie,D,,33,0,0,0,0
17,8474157,Max Pacioretty,L,,36,0,0,0,0
17,8475744,Evgeny Kuznetsov,C,,32,0,0,0,0
17,8474037,James van Riemsdyk,L,,35,0,0,0,0
17,8476907,Mackenzie MacEachern,L,,30,0,0,0,0
17,8480216,Jacob Peterson,C,,25,0,0,0,0
17,8474602,Justin Schultz,D,,34,0,0,0,0
17,8482222,Alexander Barabanov,L,,30,0,0,0,0
17,8474031,Kevin Shattenkirk,D,,35,0,0,0,0
17,8477330,Dominik Kubalik,L,,29,0,0,0,0
17,8480884,Calen Addison,D,,24,0,0,0,0
17,8475906,John Klingberg,D,,32,0,0,0,0
17,8480008,Adam Ruzicka,C,,25,0,0,0,0
17,8476884,Derrick Pouliot,D,,30,0,0,0,0
17,8476919,Chris Tierney,C,,30,0,0,0,0
17,8479415,Michael McLeod,C,,26,0,0,0,0
17,8474870,Tyler Johnson,C,,34,0,0,0,0
17,8470604,Jeff Carter,C,,39,0,0,0,0
17,8478104,Sammy Blais,L,,28,0,0,0,0
17,8474884,Mike Hoffman,C,,35,0,0,0,0
17,8481591,Sam Poulin,R,,23,0,0,0,0
17,8471274,Alex Goligoski,D,,39,0,0,0,0
17,8476871,Tanner Pearson,L,,32,0,0,0,0
17,8476393,Nick Cousins,C,,31,0,0,0,0
17,8479977,Kailer Yamamoto,R,,26,0,0,0,0
17,8479346,Dillon Dube,C,,26,0,0,0,0
17,8480184,Gustav Lindstrom,D,,26,0,0,0,0
17,8479376,Victor Mete,D,,26,0,0,0,0
17,8473449,Kyle Okposo,R,,36,0,0,0,0
17,8481058,Jesse Ylonen,R,,25,0,0,0,0
17,8475752,Tyler Pitlick,C,,33,0,0,0,0
17,8481239,Samuel Fagemo,L,,24,0,0,0,0
17,8480821,Filip Zadina,R,,25,0,0,0,0
17,8470966,Mark Giordano,D,,41,0,0,0,0
17,8478495,Denis Gurianov,R,,27,0,0,0,0
17,8477464,Nic Petan,C,,29,0,0,0,0
17,8478099,Kevin Labanc,R,,29,0,0,0,0
17,8482241,Radim Zohorna,L,,28,0,0,0,0
17,8474040,Sam Gagner,C,,35,0,0,0,0
17,8479514,Rem Pitlick,C,,27,0,0,0,0
17,8478430,Oliver Kylington,D,,27,0,0,0,0
17,8479533,Joona Koppanen,L,,26,0,0,0,0
17,8479984,Cal Foote,D,,26,0,0,0,0
17,8477126,Jayson Megna,C,,34,0,0,0,0
17,8475164,Jakob Silfverberg,R,,34,0,0,0,0
17,8474009,Nick Bonino,C,,36,0,0,0,0
17,8479458,Nikita Zaitsev,D,,33,0,0,0,0
17,8477944,Jakub Vrana,L,,28,0,0,0,0
17,8471699,Andrew Cogliano,C,,37,0,0,0,0
17,8478067,Oskar Lindblom,L,,28,0,0,0,0
17,8471686,Marc Staal,D,,37,0,0,0,0
17,8470610,Zach Parise,L,,40,0,0,0,0
17,8478904,Steven Lorentz,C,,28,0,0,0,0
17,8473473,Milan Lucic,L,,36,0,0,0,0
17,8480031,Maxime Comtois,L,,25,0,0,0,0
17,8478512,Austin Czarnik,C,,32,0,0,0,0
17,8473504,Cal Clutterbuck,R,,37,0,0,0,0
17,8477454,Adam Erne,L,,29,0,0,0,0
17,8479383,Boris Katchouk,L,,26,0,0,0,0
17,8475825,Jani Hakanpää,D,,32,0,0,0,0
17,8477846,Ryan Carpenter,C,,33,0,0,0,0
17,8477930,Pierre-Edouard Bellemare,L,,39,0,0,0,0
17,8478400,Colin White,C,,27,0,0,0,0
17,8480226,Marián Studenic,R,,26,0,0,0,0
17,8480853,Liam Foudy,C,,24,0,0,0,0
17,8475797,Jarred Tinordi,D,,32,0,0,0,0
17,8479423,Alex Nylander,L,,26,0,0,0,0
17,8474618,Marco Scandella,D,,34,0,0,0,0
17,8478028,Fredrik Olofsson,L,,28,0,0,0,0
17,8474709,Matt Martin,L,,35,0,0,0,0
17,8481070,Hugh McGing,L,,26,0,0,0,0
17,8479546,Oskar Steen,C,,26,0,0,0,0
17,8474145,Robert Bortuzzo,D,,35,0,0,0,0
17,8476915,Jujhar Khaira,L,,30,0,0,0,0
17,8480274,Philip Kemp,D,EDM,25,1,0,0,0
17,8475278,Byron Froese,C,,33,0,0,0,0
17,8481812,Nikolai Knyzhov,D,,27,0,0,0,0
17,8478408,Travis Dermott,D,,28,0,0,0,0
17,8481077,John Leonard,L,,26,0,0,0,0
17,8479547,Matthew Phillips,R,,26,0,0,0,0
17,8480836,Jonathan Gruden,C,,24,0,0,0,0
17,8481690,Tyler Angle,C,,24,0,0,0,0
17,8475766,Austin Watson,L,,32,0,0,0,0
17,8481016,Ruslan Iskhakov,C,,24,0,0,0,0
17,8478078,Rourke Chartier,C,,28,0,0,0,0
17,8480776,Sheldon Rempal,R,,29,0,0,0,0
17,8478956,Samuel Laberge,L,NJD,27,3,0,0,0
17,8483045,Cameron Butler,R,CBJ,31,0,0,0,0
17,8484314,Jiri Smejkal,L,,28,0,0,0,0
18,8478402,Connor McDavid,C,EDM,27,75,43,105,148
18,8476453,Nikita Kucherov,R,TBL,31,82,48,90,138
18,8479314,Matthew Tkachuk,L,FLA,27,77,35,102,137
18,8477492,Nathan MacKinnon,C,COL,29,82,45,87,132
18,8477934,Leon Draisaitl,C,EDM,29,77,49,77,126
18,8478550,Artemi Panarin,L,NYR,33,80,31,83,114
18,8478483,Mitch Marner,R,TOR,27,80,32,80,112
18,8477493,Aleksander Barkov,C,FLA,29,79,37,73,110
18,8477956,David Pastrnak,R,BOS,28,82,50,58,108
18,8478864,Kirill Kaprizov,L,MIN,27,69,47,59,106
18,8479318,Auston Matthews,C,TOR,27,81,56,49,105
18,8478420,Mikko Rantanen,R,COL,28,82,43,58,101
18,8477404,Jake Guentzel,C,TBL,30,82,44,56,100
18,8476459,Mika Zibanejad,C,NYR,31,78,37,63,100
18,8480027,Jason Robertson,L,DAL,25,82,34,66,100
18,8480002,Nico Hischier,C,NJD,25,76,43,56,99
18,8477939,William Nylander,R,TOR,28,78,43,54,97
18,8480012,Elias Pettersson,C,VAN,26,77,35,60,95
18,8481559,Jack Hughes,C,NJD,23,74,33,62,95
18,8478403,Jack Eichel,C,VGK,28,81,49,45,94
18,8476887,Filip Forsberg,L,NSH,30,74,40,54,94
18,8481557,Matt Boldy,L,MIN,23,75,36,58,94
18,8478445,Mathew Barzal,C,NYI,27,80,31,62,93
18,8474564,Steven Stamkos,C,NSH,34,73,34,58,92
18,8477942,Kevin Fiala,L,LAK,28,81,37,53,90
18,8477933,Sam Reinhart,C,FLA,29,78,45,44,89
18,8477501,Valeri Nichushkin,R,COL,29,82,46,41,87
18,8476468,J.T. Miller,C,VAN,31,76,39,48,87
18,8480036,Miro Heiskanen,D,DAL,25,79,23,63,86
18,8482116,Tim Stützle,C,OTT,22,78,31,54,85
18,8475172,Nazem Kadri,C,CGY,34,74,34,50,84
18,8478427,Sebastian Aho,C,CAR,27,70,33,50,83
18,8480023,Robert Thomas,C,STL,25,77,18,65,83
18,8479343,Clayton Keller,R,UTA,26,77,37,45,82
18,8479337,Alex DeBrincat,R,DET,27,81,28,53,81
18,8476456,Jonathan Huberdeau,C,CGY,31,80,17,64,81
18,8471675,Sidney Crosby,C,PIT,37,72,35,45,80
18,8478439,Travis Konecny,R,PHI,27,75,30,50,80
18,8479323,Adam Fox,D,NYR,26,78,22,58,80
18,8478010,Brayden Point,C,TBL,28,82,41,38,79
18,8475167,Victor Hedman,D,TBL,34,81,12,67,79
18,8478398,Kyle Connor,L,WPG,28,71,33,45,78
18,8480801,Brady Tkachuk,L,OTT,25,79,31,47,78
18,8480069,Cale Makar,D,COL,26,81,17,61,78
18,8475786,Zach Hyman,L,EDM,32,81,36,41,77
18,8474578,Erik Karlsson,D,PIT,34,82,21,56,77
18,8475166,John Tavares,C,TOR,34,80,33,43,76
18,8480208,Drake Batherson,R,OTT,26,78,33,43,76
18,8477409,Carter Verhaeghe,C,FLA,29,75,30,46,76
18,8478460,Zach Werenski,D,CBJ,27,76,20,56,76
18,8477402,Pavel Buchnevich,L,STL,29,79,18,58,76
18,8477960,Adrian Kempe,R,LAK,28,82,38,37,75
18,8479542,Brandon Hagel,L,TBL,26,82,32,43,75
18,8479385,Jordan Kyrou,C,STL,26,76,28,47,75
18,8475168,Matt Duchene,C,DAL,33,81,27,48,75
18,8477494,Jonathan Drouin,L,COL,29,81,25,50,75
18,8479407,Jesper Bratt,L,NJD,26,75,22,53,75
18,8480803,Evan Bouchard,D,EDM,25,75,18,57,75
18,8471214,Alex Ovechkin,L,WSH,39,76,40,34,74
18,8473419,Brad Marchand,L,BOS,36,79,32,42,74
18,8484144,Connor Bedard,C,CHI,19,68,29,45,74
18,8476389,Vincent Trocheck,C,NYR,31,75,27,46,73
18,8473512,Claude Giroux,R,OTT,36,82,26,47,73
18,8478493,Joel Eriksson Ek,C,MIN,27,70,25,48,73
18,8480018,Nick Suzuki,C,MTL,25,80,23,50,73
18,8475692,Mats Zuccarello,R,MIN,37,67,18,55,73
18,8477946,Dylan Larkin,C,DET,28,79,40,31,71
18,8475158,Ryan O'Reilly,C,NSH,33,75,31,40,71
18,8478975,Mason Marchment,L,DAL,29,81,27,44,71
18,8474600,Roman Josi,D,NSH,34,71,13,58,71
18,8480800,Quinn Hughes,D,VAN,25,75,11,60,71
18,8476460,Mark Scheifele,C,WPG,31,74,38,32,70
18,8477935,Sam Bennett,C,FLA,28,80,35,35,70
18,8475810,Bryan Rust,R,PIT,32,71,31,38,69
18,8476905,Chandler Stephenson,C,SEA,30,78,23,46,69
18,8475913,Mark Stone,R,VGK,32,73,21,48,69
18,8477940,Nikolaj Ehlers,L,WPG,28,74,21,48,69
18,8476454,Ryan Nugent-Hopkins,C,EDM,31,81,20,49,69
18,8474141,Patrick Kane,R,DET,36,78,27,41,68
18,8477951,Nick Schmaltz,C,UTA,28,77,27,41,68
18,8477955,Jared McCann,L,SEA,28,78,32,35,67
18,8477500,Bo Horvat,C,NYI,29,77,34,32,66
18,8477949,Alex Tuch,R,BUF,28,72,24,42,66
18,8477496,Elias Lindholm,C,BOS,30,79,22,44,66
18,8471685,Anze Kopitar,C,LAK,37,78,20,46,66
18,8475765,Vladimir Tarasenko,R,DET,33,81,19,47,66
18,8479325,Charlie McAvoy,D,BOS,27,74,9,57,66
18,8481711,Matias Maccelli,L,UTA,24,78,19,46,65
18,8474679,Gustav Nyquist,C,NSH,35,75,16,49,65
18,8480865,Noah Dobson,D,NYI,24,80,10,55,65
18,8476432,Boone Jenner,C,CBJ,31,70,33,31,64
18,8475151,Kyle Palmieri,C,NYI,33,81,29,35,64
18,8476882,Teuvo Teravainen,C,CHI,30,71,28,36,64
18,8479420,Tage Thompson,C,BUF,27,69,25,39,64
18,8477407,Anthony Duclair,L,NYI,29,79,23,41,64
18,8482740,Wyatt Johnston,C,DAL,21,79,35,28,63
18,8482665,Matty Beniers,C,SEA,22,77,30,33,63
18,8477504,Josh Morrissey,D,WPG,29,78,8,55,63
18,8478414,Timo Meier,R,NJD,28,76,31,31,62
18,8475726,Tyler Toffoli,C,SJS,32,71,28,34,62
18,8480830,Andrei Svechnikov,R,CAR,24,65,22,40,62
18,8475754,Brock Nelson,C,NYI,33,73,28,33,61
18,8478444,Brock Boeser,R,VAN,27,77,31,29,60
18,8480039,Martin Necas,C,CAR,25,74,28,32,60
18,8477497,Sean Monahan,C,CBJ,30,73,27,33,60
18,8482699,Dylan Guenther,R,UTA,21,76,22,38,60
18,8476881,Tomas Hertl,C,VGK,31,79,32,27,59
18,8475184,Chris Kreider,L,NYR,33,77,32,27,59
18,8481528,Dylan Cozens,C,BUF,23,73,20,39,59
18,8476346,Johnny Gaudreau,L,CBJ,31,65,16,43,59
18,8475169,Evander Kane,L,EDM,33,73,34,24,58
18,8482078,Lucas Raymond,L,DET,22,77,30,28,58
18,8480014,Gabriel Vilardi,C,WPG,25,70,28,30,58
18,8478047,Michael Bunting,L,PIT,29,74,27,31,58
18,8476479,Phillip Danault,C,LAK,31,80,15,43,58
18,8478397,Rasmus Andersson,D,CGY,28,75,14,44,58
18,8474590,John Carlson,D,WSH,34,71,12,46,58
18,8479410,Mikhail Sergachev,D,UTA,26,72,10,48,58
18,8476853,Morgan Rielly,D,TOR,30,75,5,53,58
18,8475170,Brayden Schenn,C,STL,33,75,26,31,57
18,8475784,Jeff Skinner,C,EDM,32,75,24,33,57
18,8482159,Tyson Foerster,R,PHI,22,76,24,33,57
18,8479999,Casey Mittelstadt,C,COL,26,81,21,36,57
18,8475794,Tyler Seguin,C,DAL,32,81,21,36,57
18,8482684,Luke Hughes,D,NJD,21,71,10,47,57
18,8476539,Jonathan Marchessault,R,NSH,34,75,29,27,56
18,8473986,Alex Killorn,L,ANA,35,73,28,28,56
18,8475745,Charlie Coyle,C,BOS,32,77,25,31,56
18,8473994,Jamie Benn,L,DAL,35,82,24,32,56
18,8471215,Evgeni Malkin,C,PIT,38,68,22,34,56
18,8482745,Mason McTavish,C,ANA,21,74,20,36,56
18,8470613,Brent Burns,D,CAR,39,79,10,46,56
18,8475314,Anders Lee,L,NYI,34,78,23,32,55
18,8474150,Mikael Backlund,C,CGY,35,79,23,32,55
18,8478449,Roope Hintz,C,DAL,28,80,20,35,55
18,8482109,Alexis Lafrenière,L,NYR,23,80,33,21,54
18,8481540,Cole Caufield,R,MTL,23,74,30,24,54
18,8478519,Anthony Cirelli,C,TBL,27,81,25,29,54
18,8478873,Troy Terry,R,ANA,27,72,20,34,54
18,8484153,Leo Carlsson,C,ANA,20,75,19,35,54
18,8475191,Reilly Smith,R,NYR,33,73,18,36,54
18,8478542,Evan Rodrigues,C,FLA,31,78,18,36,54
18,8477495,Seth Jones,D,CHI,30,70,16,38,54
18,8479675,Trevor Moore,L,LAK,29,78,25,28,53
18,8477476,Artturi Lehkonen,L,COL,29,82,25,28,53
18,8477429,Andrew Copp,C,DET,30,81,23,30,53
18,8477456,J.T. Compher,L,DET,29,81,21,32,53
18,8482124,Quinton Byfield,R,LAK,22,81,18,35,53
18,8480839,Rasmus Dahlin,D,BUF,24,68,16,37,53
18,8476826,Yanni Gourde,C,SEA,33,71,16,37,53
18,8477447,Shea Theodore,D,VGK,29,62,13,40,53
18,8479400,Pierre-Luc Dubois,L,WSH,26,70,22,30,52
18,8476458,Ryan Strome,C,ANA,31,77,20,32,52
18,8479345,Jakob Chychrun,D,WSH,26,71,18,34,52
18,8478440,Dylan Strome,C,WSH,27,74,15,37,52
18,8478469,Thomas Chabot,D,OTT,27,72,14,38,52
18,8476483,Rickard Rakell,R,PIT,31,75,27,24,51
18,8482093,Seth Jarvis,C,CAR,22,69,26,25,51
18,8483431,Logan Cooley,C,UTA,20,77,22,29,51
18,8478401,Pavel Zacha,C,BOS,27,79,17,34,51
18,8476906,Shayne Gostisbehere,D,CAR,31,75,8,43,51
18,8477426,Nicholas Paul,L,TBL,29,81,27,23,50
18,8478233,Andrew Mangiapane,L,WSH,28,69,24,26,50
18,8481068,Yegor Sharangovich,C,CGY,26,76,29,20,49
18,8476399,Blake Coleman,C,CGY,33,77,26,23,49
18,8480064,Josh Norris,C,OTT,25,76,25,24,49
18,8480188,Fabian Zetterlund,L,SJS,25,61,22,27,49
18,8479425,Filip Hronek,D,VAN,27,77,8,41,49
18,8475798,Mikael Granlund,C,SJS,32,69,13,35,48
18,8471724,Kris Letang,D,PIT,37,79,9,39,48
18,8480015,Owen Tippett,R,PHI,25,75,35,12,47
18,8479525,Ross Colton,C,COL,28,80,28,19,47
18,8479365,Trent Frederic,C,BOS,26,78,26,21,47
18,8482110,Dawson Mercer,C,NJD,23,73,25,22,47
18,8482149,Cole Perfetti,C,WPG,22,73,23,24,47
18,8474102,David Perron,L,OTT,36,77,21,26,47
18,8484145,Zach Benson,L,BUF,19,75,16,31,47
18,8483808,Andrei Kuzmenko,L,CGY,28,73,25,21,46
18,8474641,Adam Henrique,C,EDM,34,78,22,24,46
18,8474586,Jordan Eberle,R,SEA,34,75,20,26,46
18,8476872,Scott Laughton,C,PHI,30,73,18,28,46
18,8477451,Ryan Hartman,R,MIN,30,68,16,30,46
18,8481596,Shane Pinto,C,OTT,24,75,14,32,46
18,8478407,Vince Dunn,D,SEA,28,71,10,36,46
18,8476958,Jaccob Slavin,D,CAR,30,71,10,36,46
18,8480185,Eetu Luostarinen,C,FLA,26,78,17,28,45
18,8477986,Brandon Montour,D,SEA,30,71,15,30,45
18,8481604,Pavel Dorofeyev,L,VGK,24,77,25,19,44
18,8478366,Frank Vatrano,R,ANA,30,68,23,21,44
18,8475799,Nino Niederreiter,R,WPG,32,72,23,21,44
18,8475763,Kevin Hayes,R,PIT,32,68,20,24,44
18,8476292,Ondrej Palat,L,NJD,33,64,20,24,44
18,8471698,T.J. Oshie,R,WSH,38,72,19,25,44
18,8476448,William Karlsson,C,VGK,31,78,15,29,44
18,8478856,Conor Garland,R,VAN,28,73,15,29,44
18,8482667,William Eklund,L,SJS,22,68,14,30,44
18,8480797,Joel Farabee,L,PHI,24,74,13,31,44
18,8477503,Max Domi,C,TOR,29,77,11,33,44
18,8477416,Oliver Bjorkstrand,R,SEA,29,72,18,25,43
18,8482720,Matthew Knies,L,TOR,22,78,17,26,43
18,8477511,Anthony Mantha,R,CGY,30,75,17,26,43
18,8482097,Jack Quinn,R,BUF,23,68,17,26,43
18,8476869,Brady Skjei,D,NSH,30,76,16,27,43
18,8477444,Andre Burakovsky,L,SEA,29,68,15,28,43
18,8482105,Jake Sanderson,D,OTT,22,74,10,33,43
18,8477346,MacKenzie Weegar,D,CGY,30,73,8,35,43
18,8479339,Patrik Laine,L,CBJ,26,68,21,21,42
18,8475793,Ryan Johansen,C,PHI,32,74,21,21,42
18,8475768,Jaden Schwartz,C,SEA,32,71,17,25,42
18,8478498,Jake DeBrusk,L,VAN,28,73,16,26,42
18,8477021,Alex Kerfoot,C,UTA,30,80,14,28,42
18,8477932,Aaron Ekblad,D,FLA,28,71,12,30,42
18,8483515,Juraj Slafkovsky,L,MTL,20,76,11,31,42
18,8482113,Anton Lundell,C,FLA,23,74,26,15,41
18,8481560,Arthur Kaliyev,R,LAK,23,79,18,23,41
18,8477998,Warren Foegele,L,LAK,28,77,15,26,41
18,8476875,Mike Matheson,D,MTL,30,74,13,28,41
18,8481533,Trevor Zegras,C,ANA,23,65,13,28,41
18,8476462,Dougie Hamilton,D,NJD,31,68,13,28,41
18,8482089,Jake Neighbours,L,STL,22,68,23,17,40
18,8478474,Lawson Crouse,L,UTA,27,78,22,18,40
18,8478891,Mason Appleton,C,WPG,28,66,18,22,40
18,8475287,Erik Haula,L,NJD,33,72,17,23,40
18,8480849,Barrett Hayton,C,UTA,24,70,17,23,40
18,8474149,Evgenii Dadonov,R,DAL,35,81,17,23,40
18,8478463,Anthony Beauvillier,L,PIT,27,72,16,24,40
18,8478472,Mathieu Joseph,R,STL,27,72,14,26,40
18,8480068,Ryan Poehling,C,PHI,25,72,23,16,39
18,8477964,Ivan Barbashev,C,VGK,29,74,20,19,39
18,8482705,Cole Sillinger,C,CBJ,21,60,18,21,39
18,8475753,Justin Faulk,D,STL,32,68,15,24,39
18,8480028,Morgan Frost,C,PHI,25,70,13,26,39
18,8474563,Drew Doughty,D,LAK,35,71,11,28,39
18,8475218,Mattias Ekholm,D,EDM,34,72,11,28,39
18,8476419,Jean-Gabriel Pageau,C,NYI,32,79,10,29,39
18,8478055,Gustav Forsling,D,FLA,28,68,10,29,39
18,8474565,Alex Pietrangelo,D,VGK,34,57,8,31,39
18,8477948,Travis Sanheim,D,PHI,28,74,7,32,39
18,8476918,Jimmy Vesey,L,NYR,31,69,24,14,38
18,8480829,Jesperi Kotkaniemi,C,CAR,24,65,23,15,38
18,8476438,Brandon Saad,L,STL,32,76,23,15,38
18,8475848,Brendan Gallagher,R,MTL,32,68,16,22,38
18,8481624,Ilya Mikheyev,R,CHI,30,59,16,22,38
18,8479987,Morgan Geekie,C,BOS,26,79,14,24,38
18,8477919,Frederick Gaudreau,C,MIN,31,68,13,25,38
18,8476792,Torey Krug,D,STL,33,71,10,28,38
18,8476854,Hampus Lindholm,D,BOS,30,70,5,33,38
18,8478046,Danton Heinen,L,VAN,29,72,15,22,37
18,8479992,Michael Rasmussen,C,DET,25,80,15,22,37
18,8482749,Joshua Roy,R,MTL,21,73,15,22,37
18,8481577,Philip Tomasino,C,NSH,23,71,14,23,37
18,8480798,Philipp Kurashev,C,CHI,25,65,14,23,37
18,8484203,Bradly Nadeau,L,CAR,19,65,14,23,37
18,8478438,Tommy Novak,C,NSH,27,69,9,28,37
18,8482702,Logan Stankoven,C,DAL,21,82,20,16,36
18,8475714,Calle Jarnkrok,C,TOR,33,77,20,16,36
18,8476480,Vladislav Namestnikov,C,WPG,32,62,18,18,36
18,8478115,Pierre Engvall,L,NYI,28,76,16,20,36
18,8484166,Adam Fantilli,C,CBJ,20,71,12,24,36
18,8478042,Viktor Arvidsson,L,EDM,31,77,12,24,36
18,8480220,Noah Cates,L,PHI,25,65,11,25,36
18,8481542,Moritz Seider,D,DET,23,78,8,28,36
18,8480835,Jack Drury,C,CAR,24,60,22,13,35
18,8477479,Tyler Bertuzzi,L,CHI,29,62,20,15,35
18,8481554,Kaapo Kakko,R,NYR,23,69,19,16,35
18,8480078,Filip Chytil,C,NYR,25,68,19,16,35
18,8481186,Logan O'Connor,R,COL,28,79,16,19,35
18,8482671,Owen Power,D,BUF,22,71,13,22,35
18,8476885,Jacob Trouba,D,NYR,30,70,10,25,35
18,8476923,Damon Severson,D,CBJ,30,78,8,27,35
18,8480817,K'Andre Miller,D,NYR,24,71,6,29,35
18,8476880,Tom Wilson,R,WSH,30,68,19,15,34
18,8480205,Emil Bemstrom,C,PIT,25,58,18,16,34
18,8475791,Taylor Hall,L,CHI,33,58,15,19,34
18,8479351,Sam Steel,C,DAL,26,78,13,21,34
18,8481582,Nicholas Robertson,L,TOR,23,64,12,22,34
18,8481703,Valtteri Puustinen,R,PIT,25,59,10,24,34
18,8482122,Brock Faber,D,MIN,22,80,7,27,34
18,8478396,Noah Hanifin,D,VGK,27,68,5,29,34
18,8482146,Luke Evangelista,R,NSH,22,60,21,12,33
18,8478020,Michael Amadio,R,OTT,28,72,19,14,33
18,8480893,Kirill Marchenko,R,CBJ,24,62,17,16,33
18,8476392,Adam Lowry,C,WPG,31,66,13,20,33
18,8478038,Devon Toews,D,COL,30,60,10,23,33
18,8480762,Eric Robinson,L,CAR,29,62,10,23,33
18,8478882,Vladislav Gavrikov,D,LAK,29,69,3,30,33
18,8482125,Alexander Holtz,R,VGK,22,70,15,17,32
18,8482175,JJ Peterka,R,BUF,22,68,15,17,32
18,8478057,Dakota Joshua,C,VAN,28,68,12,20,32
18,8481032,Paul Cotter,C,NJD,25,62,12,20,32
18,8482092,Ridly Greig,C,OTT,22,74,11,21,32
18,8476474,Stefan Noesen,R,NJD,31,68,11,21,32
18,8477498,Darnell Nurse,D,EDM,29,77,10,22,32
18,8482133,Thomas Bordeleau,C,SJS,22,61,8,24,32
18,8480871,Adam Boqvist,D,FLA,24,77,8,24,32
18,8481581,Thomas Harley,D,DAL,23,76,6,26,32
18,8478500,Ivan Provorov,D,CBJ,27,80,4,28,32
18,8475193,Tomas Tatar,L,NJD,34,67,16,15,31
18,8481524,Bowen Byram,D,BUF,23,60,15,16,31
18,8477953,Kasperi Kapanen,R,STL,28,68,12,19,31
18,8474716,Jared Spurgeon,D,MIN,35,77,10,21,31
18,8479591,Michael Eyssimont,C,TBL,28,80,8,23,31
18,8483505,Matthew Poitras,C,BOS,20,75,8,23,31
18,8482624,Daniil Miromanov,D,CGY,27,62,8,23,31
18,8482259,Bobby McMann,C,TOR,28,65,21,9,30
18,8474715,Cameron Atkinson,R,TBL,35,79,19,11,30
18,8482475,Yegor Chinakhov,R,CBJ,23,68,16,14,30
18,8474053,Logan Couture,C,SJS,35,63,13,17,30
18,8478462,Nicolas Roy,C,VGK,27,74,9,21,30
18,8477839,Conor Sheary,L,TBL,32,81,9,21,30
18,8481546,Cam York,D,PHI,23,72,8,22,30
18,8480434,Sean Durzi,D,UTA,26,71,7,23,30
18,8480336,Sean Walker,D,CAR,30,77,7,23,30
18,8476979,Erik Gustafsson,D,DET,32,72,4,26,30
18,8476981,Josh Anderson,R,MTL,30,62,21,8,29
18,8477353,Tyler Motte,C,DET,29,69,16,13,29
18,8482055,Drew O'Connor,L,PIT,26,64,15,14,29
18,8480113,Alex Iafallo,L,WPG,31,69,12,17,29
18,8474189,Lars Eller,C,PIT,35,60,12,17,29
18,8475231,Casey Cizikas,C,NYI,33,76,12,17,29
18,8480009,Eeli Tolvanen,R,SEA,25,64,11,18,29
18,8476925,Colton Sissons,C,NSH,31,68,10,19,29
18,8476461,Sean Couturier,C,PHI,32,69,7,22,29
18,8482660,Kent Johnson,C,CBJ,22,58,7,22,29
18,8476927,Teddy Blueger,C,VAN,30,67,6,23,29
18,8480246,Nick Perbix,D,TBL,26,73,4,25,29
18,8477220,Nate Schmidt,D,FLA,33,72,4,25,29
18,8476463,Jonas Brodin,D,MIN,31,81,3,26,29
18,8476469,Joel Armia,R,MTL,31,69,18,10,28
18,8477425,Miles Wood,L,COL,29,74,16,12,28
18,8476897,Oskar Sundqvist,C,STL,30,56,16,12,28
18,8475149,Marcus Johansson,L,MIN,34,65,14,14,28
18,8473453,Trevor Lewis,C,LAK,37,74,13,15,28
18,8481704,Juuso Parssinen,C,NSH,23,56,13,15,28
18,8480802,Ryan McLeod,C,BUF,25,73,10,18,28
18,8482142,Jamie Drysdale,D,PHI,22,64,9,19,28
18,8476902,Esa Lindell,D,DAL,30,75,6,22,28
18,8478970,Jalen Chatfield,D,CAR,28,70,5,23,28
18,8482712,Oskar Olausson,R,COL,22,80,4,24,28
18,8482809,Jackson Blake,R,CAR,21,59,4,24,28
18,8475764,Cam Fowler,D,ANA,33,74,3,25,28
18,8476917,Adam Pelech,D,NYI,30,75,3,25,28
18,8482079,Marco Rossi,C,MIN,23,65,17,10,27
18,8475722,Jason Zucker,L,BUF,32,70,16,11,27
18,8479661,Tanner Jeannot,L,LAK,27,76,15,12,27
18,8478413,Jordan Greenway,L,BUF,27,69,13,14,27
18,8482101,Danil Gushchin,L,SJS,22,61,13,14,27
18,8478466,Daniel Sprong,R,VAN,27,70,12,15,27
18,8481553,Bobby Brink,R,PHI,23,63,12,15,27
18,8476921,Jordan Martinook,L,CAR,32,70,11,16,27
18,8480813,Joe Veleno,C,DET,24,75,10,17,27
18,8475200,Dmitry Orlov,D,CAR,33,76,9,18,27
18,8477369,Carson Soucy,D,VAN,30,59,9,18,27
18,8477446,Michael McCarron,R,NSH,29,54,9,18,27
18,8475171,Oliver Ekman-Larsson,D,TOR,33,70,7,20,27
18,8478133,Jake Evans,C,MTL,28,68,5,22,27
18,8480145,Neal Pionk,D,WPG,29,71,5,22,27
18,8480873,Rasmus Sandin,D,WSH,24,66,3,24,27
18,8483565,Nick Blankenburg,D,NSH,26,60,3,24,27
18,8482655,Janis Moser,D,TBL,24,75,0,27,27
18,8481601,Simon Holmstrom,R,NYI,23,66,17,9,26
18,8476329,Travis Boyd,C,MIN,31,54,15,11,26
18,8477987,Ryan Donato,C,CHI,28,66,12,14,26
18,8479353,Brett Howden,C,VGK,26,67,12,14,26
18,8477505,Alexander Wennberg,C,SJS,30,61,11,15,26
18,8482117,Lukas Reichel,L,CHI,22,55,10,16,26
18,8482087,Kaiden Guhle,D,MTL,22,67,8,18,26
18,8474151,Ryan McDonagh,D,TBL,35,76,7,19,26
18,8476988,Matt Benning,D,SJS,30,69,7,19,26
18,8474574,Tyler Myers,D,VAN,34,65,7,19,26
18,8478416,Erik Cernak,D,TBL,27,72,5,21,26
18,8480049,Dylan Samberg,D,WPG,25,65,4,22,26
18,8479398,Samuel Girard,D,COL,26,57,3,23,26
18,8479619,Michael Carcone,L,UTA,28,64,17,8,25
18,8479393,Noah Gregor,L,OTT,26,72,16,9,25
18,8476878,Zemgus Girgensons,C,TBL,30,76,14,11,25
18,8482074,Connor Zary,C,CGY,23,65,13,12,25
18,8480003,Jesper Boqvist,C,FLA,26,66,13,12,25
18,8480459,Pius Suter,C,VAN,28,59,12,13,25
18,8480748,Kiefer Sherwood,L,VAN,29,54,11,14,25
18,8473533,Jordan Staal,C,CAR,36,61,9,16,25
18,8481523,Kirby Dach,C,MTL,23,67,8,17,25
18,8479639,Dylan Coghlan,D,WPG,26,64,8,17,25
18,8481618,Alex Newhook,C,MTL,23,75,5,20,25
18,8483490,Pavel Mintyukov,D,ANA,21,76,4,21,25
18,8477478,William Carrier,L,CAR,30,56,17,7,24
18,8481580,Connor McMichael,C,WSH,23,69,14,10,24
18,8476278,Colin Blackwell,C,DAL,31,77,14,10,24
18,8479293,Brandon Tanev,L,SEA,33,62,13,11,24
18,8475760,Nick Bjugstad,C,UTA,32,68,12,12,24
18,8477903,Garnet Hathaway,R,PHI,33,62,12,12,24
18,8479390,Taylor Raddysh,R,WSH,26,63,11,13,24
18,8483445,Cutter Gauthier,L,ANA,20,67,10,14,24
18,8473422,Nick Foligno,L,CHI,37,59,10,14,24
18,8480144,David Kampf,C,TOR,29,59,10,14,24
18,8475343,Nic Dowd,C,WSH,34,62,8,16,24
18,8476856,Mathew Dumba,D,DAL,30,69,8,16,24
18,8475220,Marcus Foligno,L,MIN,33,59,8,16,24
18,8477450,Jason Dickinson,C,CHI,29,53,7,17,24
18,8479402,Jake Bean,D,CGY,26,64,5,19,24
18,8482073,Braden Schneider,D,NYR,23,66,5,19,24
18,8478136,Jake Middleton,D,MIN,28,73,3,21,24
18,8478458,John (Jack) Roslovic,C,CAR,27,66,12,11,23
18,8478109,Victor Olofsson,L,VGK,29,70,9,14,23
18,8482679,Matt Coronato,R,CGY,22,69,9,14,23
18,8477989,Christian Dvorak,C,MTL,28,63,6,17,23
18,8484149,Gavin Brindley,C,CBJ,20,44,6,17,23
18,8473507,Jeff Petry,D,DET,37,73,5,18,23
18,8477506,Ryan Pulock,D,NYI,30,78,5,18,23
18,8481059,Scott Perunovich,D,STL,26,60,4,19,23
18,8479371,Dante Fabbro,D,NSH,26,70,3,20,23
18,8479996,Cody Glass,C,NSH,25,54,12,10,22
18,8479316,Luke Kunin,C,SJS,27,58,11,11,22
18,8479414,Nathan Bastian,R,NJD,27,62,11,11,22
18,8481481,Blake Lizotte,C,PIT,27,58,10,12,22
18,8477392,Hudson Fasching,R,NYI,29,62,9,13,22
18,8474034,Patrick Maroon,L,CHI,36,56,8,14,22
18,8481013,Jonatan Berggren,R,DET,24,62,7,15,22
18,8481606,Jordan Spence,D,LAK,23,62,6,16,22
18,8479344,Jesse Puljujarvi,R,PIT,26,55,6,16,22
18,8477488,Brett Pesce,D,NJD,30,71,5,17,22
18,8478507,John Marino,D,UTA,27,68,5,17,22
18,8480043,Timothy Liljegren,D,TOR,25,62,5,17,22
18,8475181,Nick Leddy,D,STL,33,72,4,18,22
18,8482067,Connor Mackey,D,NYR,28,63,2,20,22
18,8479976,Juuso Valimaki,D,UTA,26,62,2,20,22
18,8476525,Colin Miller,D,WPG,32,63,1,21,22
18,8478508,Yakov Trenin,C,MIN,27,58,15,6,21
18,8479941,Justin Danforth,R,CBJ,31,62,12,9,21
18,8476873,Mark Jankowski,C,NSH,30,59,10,11,21
18,8482062,Cole Smith,L,NSH,29,55,10,11,21
18,8482744,James Malatesta,L,CBJ,21,42,10,11,21
18,8482111,Justin Barron,D,MTL,23,71,8,13,21
18,8482803,Olen Zellweger,D,ANA,21,66,8,13,21
18,8475225,Craig Smith,C,CHI,35,47,6,15,21
18,8479982,Conor Timmins,D,TOR,26,55,3,18,21
18,8481521,Ronnie Attard,D,PHI,25,48,3,18,21
18,8477969,Marcus Pettersson,D,PIT,28,76,2,19,21
18,8476879,Cody Ceci,D,EDM,31,71,2,19,21
18,8477435,Ryan Graves,D,PIT,29,77,1,20,21
18,8483493,Frank Nazar,C,CHI,20,56,12,8,20
18,8479328,Julien Gauthier,R,NYI,27,66,12,8,20
18,8481093,Rafael Harvey-Pinard,L,MTL,25,57,9,11,20
18,8477380,Jonny Brodzinski,C,NYR,31,49,9,11,20
18,8477979,Nicolas Aube-Kubel,R,BUF,28,55,8,12,20
18,8477947,Sonny Milano,L,WSH,28,61,7,13,20
18,8470621,Corey Perry,R,EDM,39,67,7,13,20
18,8481522,Peyton Krebs,C,BUF,23,59,7,13,20
18,8479671,Mathieu Olivier,R,CBJ,27,56,7,13,20
18,8476467,Jamie Oleksiak,D,SEA,32,65,6,14,20
18,8476429,Scott Mayfield,D,NYI,32,71,6,14,20
18,8476422,Mike Reilly,D,NYI,31,73,5,15,20
18,8482192,Isaak Phillips,D,CHI,23,47,3,17,20
18,8482245,Artem Zub,D,OTT,29,66,3,17,20
18,8476891,Matthew Grzelcyk,D,PIT,30,71,3,17,20
18,8479998,Mikey Anderson,D,LAK,25,66,2,18,20
18,8481178,Egor Zamula,D,PHI,24,61,0,20,20
18,8481568,Alex Vlasic,D,CHI,23,59,0,20,20
18,8479066,Ryan Lomberg,L,CGY,30,63,14,5,19
18,8482077,Dylan Holloway,L,EDM,23,50,12,7,19
18,8476889,Radek Faksa,C,STL,30,55,12,7,19
18,8481535,Nils Hoglander,L,VAN,24,64,11,8,19
18,8482155,Alex Laferriere,R,LAK,23,59,11,8,19
18,8482737,Zack Bolduc,C,STL,21,59,10,9,19
18,8478421,A.J. Greer,L,FLA,28,52,9,10,19
18,8476994,Vinnie Hinostroza,C,NSH,30,47,7,12,19
18,8475279,Ben Chiarot,D,DET,33,71,5,14,19
18,8480073,Erik Brannstrom,D,COL,25,64,4,15,19
18,8476892,Colton Parayko,D,STL,31,70,3,16,19
18,8478911,Matt Roy,D,WSH,29,68,3,16,19
18,8475790,Erik Gudbranson,D,CBJ,32,75,2,17,19
18,8473563,Nicklas Backstrom,C,WSH,37,58,2,17,19
18,8475233,David Savard,D,MTL,34,61,1,18,19
18,8481556,John Beecher,C,BOS,23,40,15,3,18
18,8478569,Noel Acciari,C,PIT,33,61,10,8,18
18,8478432,Christian Fischer,R,DET,27,74,8,10,18
18,8483499,Liam Ohgren,L,MIN,20,48,7,11,18
18,8483524,Shane Wright,C,SEA,20,51,5,13,18
18,8481527,Kaedan Korczak,D,VGK,23,43,5,13,18
18,8480448,Parker Kelly,L,COL,25,76,5,13,18
18,8476331,Dylan DeMelo,D,WPG,31,63,4,14,18
18,8481014,Alexander Romanov,D,NYI,24,74,2,16,18
18,8476931,Jake McCabe,D,TOR,31,64,1,17,18
18,8480025,MacKenzie Entwistle,R,FLA,25,62,10,7,17
18,8480441,Trey Fix-Wolansky,R,CBJ,25,45,10,7,17
18,8479368,Max Jones,L,BOS,26,63,9,8,17
18,8481641,Joel Kiviranta,L,COL,28,68,9,8,17
18,8480995,Pontus Holmberg,R,TOR,25,54,9,8,17
18,8478585,Derek Ryan,C,EDM,38,60,9,8,17
18,8478043,Sam Lafferty,C,BUF,29,60,7,10,17
18,8477406,Mattias Janmark,C,EDM,32,62,7,10,17
18,8481517,Brett Leason,R,ANA,25,59,6,11,17
18,8478851,Alexandre Carrier,D,NSH,28,67,6,11,17
18,8480855,Jack McBain,C,UTA,24,67,5,12,17
18,8476374,Sean Kuraly,C,CBJ,31,60,4,13,17
18,8480878,Nils Lundkvist,D,DAL,24,75,4,13,17
18,8477507,Nikita Zadorov,D,BOS,29,69,4,13,17
18,8480891,Michael Kesselring,D,UTA,24,58,2,15,17
18,8477499,Rasmus Ristolainen,D,PHI,30,61,1,16,17
18,8476858,Phillip Di Giuseppe,L,VAN,31,50,13,3,16
18,8477931,Tomas Nosek,L,FLA,32,58,11,5,16
18,8480289,Morgan Barron,C,WPG,26,43,10,6,16
18,8480980,Connor Dewar,C,TOR,25,69,9,7,16
18,8475855,Jesper Fast,R,CAR,33,51,8,8,16
18,8478178,Darren Raddysh,D,TBL,28,70,8,8,16
18,8475842,Sam Carrick,C,NYR,32,63,8,8,16
18,8483457,Lane Hutson,D,MTL,20,62,7,9,16
18,8481028,Martin Pospisil,C,CGY,25,49,7,9,16
18,8479543,Michael Pezzetta,L,MTL,26,54,7,9,16
18,8477952,Robby Fabbri,C,ANA,28,58,6,10,16
18,8477508,Curtis Lazar,C,NJD,29,53,6,10,16
18,8478013,Jake Walman,D,SJS,28,66,6,10,16
18,8482807,Ethan Del Mastro,D,CHI,21,46,6,10,16
18,8474568,Luke Schenn,D,NSH,35,45,6,10,16
18,8483466,Kevin Korchinski,D,CHI,20,52,5,11,16
18,8478840,Will Borgen,D,SEA,28,65,3,13,16
18,8475324,Nick Jensen,D,OTT,34,63,3,13,16
18,8482176,Wyatt Kaiser,D,CHI,22,55,2,14,16
18,8475179,Dmitry Kulikov,D,FLA,34,57,2,14,16
18,8481708,Zac Jones,D,NYR,24,39,2,14,16
18,8477365,Connor Clifton,D,BUF,29,59,2,14,16
18,8474673,TJ Brodie,D,CHI,34,65,1,15,16
18,8479980,Nicolas Hague,D,VGK,26,57,0,16,16
18,8479336,Carl Grundstrom,R,SJS,27,54,10,5,15
18,8482148,Hendrix Lapierre,C,WSH,22,55,8,7,15
18,8481477,Nico Sturm,C,SJS,29,52,8,7,15
18,8483482,Tristan Luneau,D,ANA,20,60,7,8,15
18,8483491,Ivan Miroshnichenko,L,WSH,20,55,6,9,15
18,8481656,Aliaksei Protas,C,WSH,23,56,4,11,15
18,8478443,Brandon Carlo,D,BOS,28,63,4,11,15
18,8480035,Henri Jokiharju,D,BUF,25,58,4,11,15
18,8477018,Ben Hutton,D,VGK,31,47,4,11,15
18,8479983,Mario Ferraro,D,SJS,26,67,3,12,15
18,8482634,Alex Steeves,C,TOR,25,49,3,12,15
18,8470600,Ryan Suter,D,STL,39,66,3,12,15
18,8481161,Jake Christiansen,D,CBJ,25,62,3,12,15
18,8479324,Ryan Lindgren,D,NYR,26,66,2,13,15
18,8481019,David Gustafsson,C,WPG,24,46,2,13,15
18,8477845,Trevor van Riemsdyk,D,WSH,33,50,1,14,15
18,8482157,Will Cuylle,L,NYR,22,57,9,5,14
18,8477573,Nathan Walker,L,STL,30,51,8,6,14
18,8478434,Keegan Kolesar,R,VGK,27,64,7,7,14
18,8476960,Andreas Athanasiou,C,CHI,30,44,7,7,14
18,8479718,Alex Barré-Boulet,C,MTL,27,42,7,7,14
18,8482730,Brandt Clarke,D,LAK,21,42,7,7,14
18,8476822,Luke Glendening,C,TBL,35,79,6,8,14
18,8480252,Cole Guttman,C,CHI,25,39,6,8,14
18,8480806,Isac Lundestrom,C,ANA,25,48,5,9,14
18,8477015,Connor Brown,R,EDM,30,58,4,10,14
18,8479370,Tyson Jost,C,CAR,26,54,4,10,14
18,8479291,Kevin Rooney,C,CGY,31,49,4,10,14
18,8474567,Zach Bogosian,D,MIN,34,64,4,10,14
18,8481600,Tobias Bjornfot,D,FLA,23,37,4,10,14
18,8478451,Ethan Bear,D,WSH,27,50,4,10,14
18,8483468,Jiri Kulich,C,BUF,20,56,3,11,14
18,8480001,Urho Vaakanainen,D,ANA,25,56,3,11,14
18,8476312,Josh Manson,D,COL,33,68,3,11,14
18,8480727,Zach Whitecloud,D,VGK,28,50,3,11,14
18,8480222,Sebastian Aho,D,PIT,28,74,3,11,14
18,8476457,Adam Larsson,D,SEA,32,64,2,12,14
18,8480860,Kevin Bahl,D,CGY,24,55,2,12,14
18,8480807,Mattias Samuelsson,D,BUF,24,54,1,13,14
18,8482659,Josh Doan,R,UTA,22,52,11,2,13
18,8479968,Vinni Lettieri,C,BOS,29,50,9,4,13
18,8476624,Barclay Goodrow,C,SJS,31,43,6,7,13
18,8476442,Matt Nieto,L,PIT,32,51,6,7,13
18,8480074,Alexandre Texier,C,STL,25,51,5,8,13
18,8481598,Philip Broberg,D,EDM,23,46,5,8,13
18,8477938,Haydn Fleury,D,WPG,28,46,5,8,13
18,8480950,Ilya Lyubushkin,D,DAL,30,59,3,10,13
18,8471709,Marc-Edouard Vlasic,D,SJS,37,59,1,12,13
18,8475235,Nicolas Deslauriers,L,PHI,33,55,7,5,12
18,8482070,Mitchell Chaffee,R,TBL,26,50,7,5,12
18,8477482,Zachary Sanford,L,CHI,30,43,5,7,12
18,8478211,Dryden Hunt,L,CGY,29,59,5,7,12
18,8476934,Brock McGinn,L,ANA,30,56,5,7,12
18,8475208,Brian Dumoulin,D,ANA,33,62,4,8,12
18,8478454,Noah Juulsen,D,VAN,27,39,3,9,12
18,8481537,Nikita Okhotiuk,D,CGY,24,48,3,9,12
18,8474013,Ian Cole,D,UTA,35,41,3,9,12
18,8481609,Vladislav Kolyachonok,D,UTA,23,40,3,9,12
18,8471677,Jack Johnson,D,CBJ,37,66,3,9,12
18,8481599,Victor Soderstrom,D,UTA,23,38,3,9,12
18,8475462,Radko Gudas,D,ANA,34,63,2,10,12
18,8476874,Olli Maatta,D,DET,30,66,2,10,12
18,8478859,Niko Mikkola,D,FLA,28,52,2,10,12
18,8477851,Jordan Oesterle,D,BOS,32,46,1,11,12
18,8477335,Kyle Burroughs,D,LAK,29,46,1,11,12
18,8479026,Philippe Myers,D,TOR,27,56,1,11,12
18,8475690,Chris Tanev,D,TOR,35,59,0,12,12
18,8473446,Erik Johnson,D,PHI,36,44,0,12,12
18,8480281,Alexey Toropchenko,R,STL,25,53,8,3,11
18,8480848,Ty Dellandrea,C,SJS,24,48,7,4,11
18,8480789,Oliver Wahlstrom,R,NYI,24,70,6,5,11
18,8479439,Jacob MacDonald,D,COL,31,50,4,7,11
18,8482859,Zack Ostapchuk,C,OTT,21,55,4,7,11
18,8480355,Mark Kastelic,C,BOS,25,51,4,7,11
18,8478450,Parker Wotherspoon,D,BOS,27,35,4,7,11
18,8475188,Brayden McNabb,D,VGK,33,51,3,8,11
18,8478452,Caleb Jones,D,LAK,27,59,3,8,11
18,8482666,Scott Morrow,D,CAR,22,44,3,8,11
18,8477070,Liam O'Brien,C,UTA,30,49,3,8,11
18,8481617,Vasily Podkolzin,R,VAN,23,47,3,8,11
18,8480887,Jordan Harris,D,MTL,24,53,2,9,11
18,8475718,Justin Holl,D,DET,32,52,2,9,11
18,8474090,Brendan Smith,D,DAL,35,54,2,9,11
18,8480157,Calle Rosen,D,COL,30,50,1,10,11
18,8478424,Jansen Harkins,C,ANA,27,42,6,4,10
18,8481754,Nikita Nesterenko,C,ANA,23,36,6,4,10
18,8481789,Tye Kartye,L,SEA,23,35,6,4,10
18,8479520,Brandon Duhaime,R,WSH,27,46,5,5,10
18,8479315,Joey Anderson,R,CHI,26,49,5,5,10
18,8483549,Lucas Condotta,L,MTL,27,42,5,5,10
18,8478017,Mark Friedman,D,VAN,29,41,5,5,10
18,8478468,Jeremy Lauzon,D,NSH,27,53,5,5,10
18,8480880,Jakub Lauko,C,MIN,24,36,5,5,10
18,8483763,Maksymilian Szuber,D,UTA,22,41,4,6,10
18,8482964,Arber Xhekaj,D,MTL,23,42,4,6,10
18,8480192,Johnathan Kovacevic,D,NJD,27,49,4,6,10
18,8479994,Jaret Anderson-Dolan,C,WPG,25,39,4,6,10
18,8480007,Jonas Rondbjerg,R,VGK,25,37,4,6,10
18,8480011,Klim Kostin,C,SJS,25,48,3,7,10
18,8479348,Kale Clague,D,BUF,26,44,3,7,10
18,8482166,Shakir Mukhamadullin,D,SJS,22,49,2,8,10
18,8482762,Simon Edvinsson,D,DET,21,58,2,8,10
18,8477462,Robert Hagg,D,VGK,29,27,2,8,10
18,8480070,Ian Mitchell,D,BOS,25,43,1,9,10
18,8481541,Samuel Bolduc,D,NYI,24,38,6,3,9
18,8481716,Dmitri Voronkov,L,CBJ,24,41,5,4,9
18,8479359,Beck Malenstyn,L,BUF,26,43,5,4,9
18,8483630,Pavol Regenda,L,ANA,25,33,4,5,9
18,8483570,Ben Meyers,C,SEA,26,28,4,5,9
18,8483495,Simon Nemec,D,NJD,20,59,3,6,9
18,8479986,Kole Lind,R,DAL,26,48,3,6,9
18,8479369,Andrew Peeke,D,BOS,26,57,3,6,9
18,8481056,Spencer Stastney,D,NSH,24,32,3,6,9
18,8479442,Troy Stecher,D,EDM,30,59,3,6,9
18,8482652,Walker Duehr,R,CGY,27,33,3,6,9
18,8482153,Brendan Brisson,C,VGK,23,33,3,6,9
18,8482451,Mikael Pyyhtia,L,CBJ,23,36,2,7,9
18,8481441,Joe Snively,C,DET,28,66,2,7,9
18,8475750,Jon Merrill,D,MIN,32,56,2,7,9
18,8482784,Zach Dean,C,STL,21,39,2,7,9
18,8482861,Vincent Iorio,D,WSH,22,35,2,7,9
18,8477034,Jaycob Megna,D,FLA,32,47,1,8,9
18,8479249,Andrew Poturalski,C,SJS,30,38,0,9,9
18,8481532,Alex Turcotte,C,LAK,23,42,5,3,8
18,8481679,Maxence Guenette,D,OTT,23,45,5,3,8
18,8480021,Jack Studnicka,C,LAK,25,61,4,4,8
18,8481592,Jakob Pelletier,L,CGY,23,43,4,4,8
18,8478409,Anthony Richard,C,PHI,28,34,4,4,8
18,8482747,Brennan Othmann,L,NYR,21,46,4,4,8
18,8481122,Simon Benoit,D,TOR,26,36,4,4,8
18,8476913,Devin Shore,C,MIN,30,35,4,4,8
18,8478146,Matthew Highmore,C,OTT,28,37,3,5,8
18,8477887,Patrick Brown,C,BOS,32,40,3,5,8
18,8476967,Brett Kulak,D,EDM,30,57,2,6,8
18,8476372,Nick Seeler,D,PHI,31,38,2,6,8
18,8479981,Jonah Gadjovich,L,FLA,26,41,2,6,8
18,8479378,Logan Stanley,D,WPG,26,42,2,6,8
18,8475177,Calvin de Haan,D,COL,33,47,1,7,8
18,8479972,Mason Shaw,C,WPG,26,30,1,7,8
18,8476473,Connor Murphy,D,CHI,31,34,1,7,8
18,8480844,Grigori Denisenko,L,VGK,24,31,1,7,8
18,8480196,Jacob Bryson,D,BUF,27,45,1,7,8
18,8475455,Brenden Dillon,D,NJD,34,56,0,8,8
18,8478831,Kevin Stenlund,C,UTA,28,41,7,0,7
18,8471817,Ryan Reaves,R,TOR,37,57,5,2,7
18,8480058,Pierre-Olivier Joseph,D,STL,25,48,4,3,7
18,8481605,Jackson LaCombe,D,ANA,23,35,4,3,7
18,8479536,Axel Jonsson-Fjallby,L,WPG,26,37,4,3,7
18,8477962,Brendan Lemieux,L,CAR,28,37,3,4,7
18,8478399,Jonas Siegenthaler,D,NJD,27,56,2,5,7
18,8479638,Justin Brazeau,R,BOS,26,36,2,5,7
18,8483012,Logan Morrison,C,SEA,22,49,2,5,7
18,8479772,Zack MacEwen,R,OTT,28,59,2,5,7
18,8481550,Adam Beckman,L,NJD,23,40,2,5,7
18,8480292,Carson Meyer,R,ANA,27,31,2,5,7
18,8478874,Adam Gaudette,R,OTT,28,35,2,5,7
18,8479372,Joshua Mahura,D,SEA,26,60,1,6,7
18,8480870,Bo Groulx,C,NYR,24,23,1,6,7
18,8479379,Givani Smith,R,SJS,26,31,1,6,7
18,8480834,Ty Emberson,D,SJS,24,29,1,6,7
18,8479587,Rhett Gardner,C,PHI,28,24,1,6,7
18,8481567,Henry Thrun,D,SJS,23,51,0,7,7
18,8482496,Nils Aman,C,VAN,24,40,4,2,6
18,8480172,Jan Rutta,D,SJS,34,68,3,3,6
18,8476867,Brendan Gaunce,C,MIN,30,36,3,3,6
18,8484911,Collin Graf,R,SJS,22,40,3,3,6
18,8481701,Santeri Hatakka,D,NJD,23,42,2,4,6
18,8477401,John Hayden,C,SEA,29,29,2,4,6
18,8482144,Jack Thompson,D,SJS,22,34,2,4,6
18,8479362,Riley Tufte,L,BOS,26,26,2,4,6
18,8474166,Alec Martinez,D,CHI,37,50,1,5,6
18,8482751,Ryan Winterton,C,SEA,21,43,1,5,6
18,8480796,Martin Fehervary,D,WSH,25,52,1,5,6
18,8477244,Chad Ruhwedel,D,NYR,34,34,1,5,6
18,8481006,Tyler Tucker,D,STL,24,19,1,5,6
18,8474612,Travis Hamonic,D,OTT,34,45,0,6,6
18,8481751,Lukas Rousek,R,BUF,25,34,3,2,5
18,8482141,Lukas Cormier,D,VGK,22,30,3,2,5
18,8482145,Mavrik Bourque,C,DAL,22,52,3,2,5
18,8482765,Isak Rosen,R,BUF,21,23,3,2,5
18,8482733,Logan Mailloux,D,MTL,31,38,2,3,5
18,8482095,Tyler Kleven,D,OTT,22,46,2,3,5
18,8483619,Filip Roos,D,OTT,25,33,2,3,5
18,8483460,David Jiricek,D,CBJ,21,55,1,4,5
18,8476952,Dominic Toninato,C,WPG,30,33,1,4,5
18,8477384,Joshua Brown,D,EDM,30,34,1,4,5
18,8480845,Rasmus Kupari,C,WPG,24,41,0,5,5
18,8479576,Vincent Desharnais,D,VAN,28,34,0,5,5
18,8481743,Marc Del Gaizo,D,NSH,25,18,0,5,5
18,8480990,Declan Chisholm,D,MIN,24,31,3,1,4
18,8481543,Nikita Alexandrov,C,STL,24,29,3,1,4
18,8482470,Ilya Solovyov,D,CGY,24,25,3,1,4
18,8484254,Akito Hirose,D,VAN,25,37,2,2,4
18,8479944,Zach Aston-Reese,C,VGK,30,42,2,2,4
18,8480851,Akil Thomas,C,LAK,24,18,2,2,4
18,8483489,Fraser Minten,C,TOR,31,16,2,2,4
18,8477473,Justin Bailey,R,SJS,29,27,2,2,4
18,8475762,Derek Forbort,D,VAN,32,46,1,3,4
18,8479985,Cale Fleury,D,SEA,26,31,1,3,4
18,8482511,Mason Lohrei,D,BOS,23,35,1,3,4
18,8479320,Maxime Lajoie,D,SEA,27,28,1,3,4
18,8481699,Aku Raty,R,UTA,23,17,1,3,4
18,8482250,Callahan Burke,C,VGK,27,21,1,3,4
18,8481593,Jayden Struble,D,MTL,23,24,1,3,4
18,8484287,Cole McWard,D,VAN,23,19,1,3,4
18,8478446,Glenn Gawdin,C,LAK,27,18,1,3,4
18,8478021,William Lagesson,D,DET,28,22,1,3,4
18,8475958,Michael Sgarbossa,C,WSH,32,28,0,4,4
18,8482858,Ryker Evans,D,SEA,23,26,0,4,4
18,8482929,Emil Lilleberg,D,TBL,23,26,0,4,4
18,8481167,Brayden Pachal,D,CGY,25,45,2,1,3
18,8482172,Landon Slaggert,L,CHI,22,24,2,1,3
18,8480267,Sammy Walker,C,MIN,25,22,2,1,3
18,8480879,Jacob Bernard-Docker,D,OTT,24,46,1,2,3
18,8481147,Reese Johnson,C,MIN,26,35,1,2,3
18,8477527,Ross Johnston,L,ANA,30,36,1,2,3
18,8477320,Anton Blidh,L,NYR,29,22,1,2,3
18,8478477,Mitchell Stephens,C,SEA,27,15,1,2,3
18,8484258,Sam Malinski,D,COL,26,15,1,2,3
18,8479367,William Lockwood,R,FLA,26,31,1,2,3
18,8482165,Yan Kuznetsov,D,CGY,22,20,1,2,3
18,8482102,Vasily Ponomarev,C,PIT,22,14,1,2,3
18,8481462,Mason Morelli,L,VGK,28,13,1,2,3
18,8476441,Joel Edmundson,D,LAK,31,44,0,3,3
18,8479991,Jake Leschyshyn,C,NYR,25,25,0,3,3
18,8478051,Max Willman,C,NJD,29,20,0,3,3
18,8480890,Jan Jenik,C,OTT,24,22,0,3,3
18,8475795,Dylan McIlrath,D,WSH,32,14,0,3,3
18,8484325,Waltteri Merela,C,TBL,26,22,0,3,3
18,8481518,Nolan Foote,L,NJD,24,40,2,0,2
18,8483397,Marc McLaughlin,C,BOS,25,30,2,0,2
18,8482713,Mackie Samoskevich,R,FLA,22,37,2,0,2
18,8481806,Louis Crevier,D,CHI,23,14,2,0,2
18,8482162,Roby Jarventie,L,EDM,22,25,1,1,2
18,8478502,Dennis Gilbert,D,BUF,28,23,1,1,2
18,8481206,John Ludvig,D,PIT,24,8,1,1,2
18,8481585,Egor Afanasyev,L,SJS,23,12,1,1,2
18,8482460,Matt Rempe,C,NYR,22,12,1,1,2
18,8480245,Olle Lycksell,R,PHI,25,23,0,2,2
18,8477971,Andreas Englund,D,LAK,28,24,0,2,2
18,8480084,Nick DeSimone,D,NJD,30,20,0,2,2
18,8482177,Marat Khusnutdinov,C,MIN,22,38,0,2,2
18,8477073,Kurtis MacDermid,L,NJD,30,31,0,2,2
18,8483597,Milos Kelemen,L,UTA,25,13,0,2,2
18,8477810,Joel Hanley,D,CGY,33,25,0,2,2
18,8482094,Daemon Hunt,D,MIN,22,17,0,2,2
18,8481564,Ryan Johnson,D,BUF,23,10,0,2,2
18,8484259,Ondrej Pavel,C,COL,31,2,0,2,2
18,8480468,James Hamblin,L,EDM,25,20,1,0,1
18,8482147,Jean-Luc Foudy,C,COL,22,19,1,0,1
18,8477541,Dakota Mermis,D,TOR,30,10,1,0,1
18,8482516,Matthew Kessel,D,STL,24,18,1,0,1
18,8482787,Nikita Chibrikov,R,WPG,31,8,1,0,1
18,8482088,Justin Sourdif,R,FLA,22,18,1,0,1
18,8483398,Declan Carlile,D,TBL,31,4,1,0,1
18,8484304,Uvis Balinskis,D,FLA,28,11,1,0,1
18,8480274,Philip Kemp,D,EDM,25,1,1,0,1
18,8478011,Louie Belpedio,D,PHI,28,17,0,1,1
18,8474062,Riley Nash,C,NYR,35,11,0,1,1
18,8479419,Brett Murray,L,BUF,26,17,0,1,1
18,8480823,Alexander Alexeyev,D,WSH,25,12,0,1,1
18,8481043,Cole Koepke,L,BOS,26,10,0,1,1
18,8483512,Matthew Savoie,C,EDM,20,22,0,1,1
18,8481030,Jack St. Ivany,D,PIT,25,17,0,1,1
18,8483407,Brandon Scanlin,D,NYR,25,5,0,1,1
18,8482118,Sam Colangelo,R,ANA,23,14,0,1,1
18,8483546,Marshall Rifai,D,TOR,26,5,0,1,1
18,8483609,Adam Klapka,R,CGY,24,3,0,1,1
18,8483471,Brad Lambert,C,WPG,31,10,0,1,1
18,8481578,Graeme Clarke,R,MIN,23,11,0,1,1
18,8481024,Linus Karlsson,C,VAN,25,7,0,1,1
18,8481726,Adam Edstrom,C,NYR,24,7,0,1,1
18,8483531,Brian Halonen,L,NJD,25,4,0,1,1
18,8484255,Jason Polin,R,COL,25,6,0,1,1
18,8483401,Marc Johnstone,R,PIT,28,1,0,1,1
18,8481237,Kyle MacLean,C,NYI,25,21,0,0,0
18,8477467,Gustav Olofsson,D,SEA,30,11,0,0,0
18,8480032,Shane Bowers,C,NJD,25,9,0,0,0
18,8477149,Scott Sabourin,R,SJS,32,18,0,0,0
18,8475413,Justin Dowling,C,NJD,34,18,0,0,0
18,8481719,Maxwell Crozier,D,TBL,24,15,0,0,0
18,8479522,Hardy Haman Aktell,D,WSH,26,3,0,0,0
18,8478881,Brett Seney,L,CHI,28,10,0,0,0
18,8483567,Georgii Merkulov,C,BOS,24,10,0,0,0
18,8479330,Brandon Gignac,C,MTL,27,9,0,0,0
18,8481065,Angus Crookshank,L,OTT,25,13,0,0,0
18,8480075,Cameron Crotty,D,MIN,25,13,0,0,0
18,8476323,Max McCormick,L,SEA,32,5,0,0,0
18,8481422,Jake Lucchini,C,NSH,29,19,0,0,0
18,8478854,Ryan Shea,D,PIT,27,8,0,0,0
18,8482061,Brandon Biro,L,SEA,26,13,0,0,0
18,8483920,Pierrick Dube,R,WSH,23,2,0,0,0
18,8482197,Adam Raska,R,MIN,23,5,0,0,0
18,8483395,Arshdeep Bains,L,VAN,23,10,0,0,0
18,8482201,Gage Goncalves,C,TBL,23,27,0,0,0
18,8477993,Justin Kirkland,C,CGY,28,11,0,0,0
18,8483432,Luca Del Bel Belluz,C,CBJ,31,2,0,0,0
18,8475755,Alexander Petrovic,D,DAL,32,5,0,0,0
18,8480874,Adam Ginning,D,PHI,24,11,0,0,0
18,8475780,Chris Wagner,R,COL,33,10,0,0,0
18,8480306,Grant Hutton,D,NYI,29,3,0,0,0
18,8484321,Nikolas Matinpalo,D,OTT,26,2,0,0,0
18,8482476,Emil Heineman,L,MTL,23,5,0,0,0
18,8484326,Patrik Koch,D,UTA,28,1,0,0,0
18,8479421,Jacob Moverare,D,LAK,26,9,0,0,0
18,8481655,Cole Schwindt,R,CGY,23,6,0,0,0
18,8478147,Bokondji Imama,L,PIT,28,3,0,0,0
18,8481534,Raphael Lavoie,C,EDM,24,3,0,0,0
18,8482126,Emil Andrae,D,PHI,31,2,0,0,0
18,8470794,Joe Pavelski,C,,40,0,0,0,0
18,8479321,Lucas Johansen,D,,27,0,0,0,0
18,8477950,Tony DeAngelo,D,,29,0,0,0,0
18,8471218,Blake Wheeler,R,,38,0,0,0,0
18,8475197,Tyson Barrie,D,,33,0,0,0,0
18,8474157,Max Pacioretty,L,,36,0,0,0,0
18,8475744,Evgeny Kuznetsov,C,,32,0,0,0,0
18,8474037,James van Riemsdyk,L,,35,0,0,0,0
18,8476907,Mackenzie MacEachern,L,,30,0,0,0,0
18,8480216,Jacob Peterson,C,,25,0,0,0,0
18,8474602,Justin Schultz,D,,34,0,0,0,0
18,8482222,Alexander Barabanov,L,,30,0,0,0,0
18,8474031,Kevin Shattenkirk,D,,35,0,0,0,0
18,8477330,Dominik Kubalik,L,,29,0,0,0,0
18,8480884,Calen Addison,D,,24,0,0,0,0
18,8475906,John Klingberg,D,,32,0,0,0,0
18,8480008,Adam Ruzicka,C,,25,0,0,0,0
18,8476884,Derrick Pouliot,D,,30,0,0,0,0
18,8476919,Chris Tierney,C,,30,0,0,0,0
18,8479415,Michael McLeod,C,,26,0,0,0,0
18,8474870,Tyler Johnson,C,,34,0,0,0,0
18,8470604,Jeff Carter,C,,39,0,0,0,0
18,8478104,Sammy Blais,L,,28,0,0,0,0
18,8474884,Mike Hoffman,C,,35,0,0,0,0
18,8481591,Sam Poulin,R,,23,0,0,0,0
18,8471274,Alex Goligoski,D,,39,0,0,0,0
18,8476871,Tanner Pearson,L,,32,0,0,0,0
18,8476393,Nick Cousins,C,,31,0,0,0,0
18,8479977,Kailer Yamamoto,R,,26,0,0,0,0
18,8479346,Dillon Dube,C,,26,0,0,0,0
18,8480184,Gustav Lindstrom,D,,26,0,0,0,0
18,8479376,Victor Mete,D,,26,0,0,0,0
18,8473449,Kyle Okposo,R,,36,0,0,0,0
18,8481058,Jesse Ylonen,R,,25,0,0,0,0
18,8475752,Tyler Pitlick,C,,33,0,0,0,0
18,8481239,Samuel Fagemo,L,,24,0,0,0,0
18,8480821,Filip Zadina,R,,25,0,0,0,0
18,8470966,Mark Giordano,D,,41,0,0,0,0
18,8478495,Denis Gurianov,R,,27,0,0,0,0
18,8477464,Nic Petan,C,,29,0,0,0,0
18,8478099,Kevin Labanc,R,,29,0,0,0,0
18,8482241,Radim Zohorna,L,,28,0,0,0,0
18,8474040,Sam Gagner,C,,35,0,0,0,0
18,8479514,Rem Pitlick,C,,27,0,0,0,0
18,8478430,Oliver Kylington,D,,27,0,0,0,0
18,8479533,Joona Koppanen,L,,26,0,0,0,0
18,8479984,Cal Foote,D,,26,0,0,0,0
18,8477126,Jayson Megna,C,,34,0,0,0,0
18,8475164,Jakob Silfverberg,R,,34,0,0,0,0
18,8474009,Nick Bonino,C,,36,0,0,0,0
18,8479458,Nikita Zaitsev,D,,33,0,0,0,0
18,8477944,Jakub Vrana,L,,28,0,0,0,0
18,8471699,Andrew Cogliano,C,,37,0,0,0,0
18,8478067,Oskar Lindblom,L,,28,0,0,0,0
18,8471686,Marc Staal,D,,37,0,0,0,0
18,8470610,Zach Parise,L,,40,0,0,0,0
18,8478904,Steven Lorentz,C,,28,0,0,0,0
18,8473473,Milan Lucic,L,,36,0,0,0,0
18,8480031,Maxime Comtois,L,,25,0,0,0,0
18,8478512,Austin Czarnik,C,,32,0,0,0,0
18,8473504,Cal Clutterbuck,R,,37,0,0,0,0
18,8477454,Adam Erne,L,,29,0,0,0,0
18,8479383,Boris Katchouk,L,,26,0,0,0,0
18,8475825,Jani Hakanpää,D,,32,0,0,0,0
18,8477846,Ryan Carpenter,C,,33,0,0,0,0
18,8477930,Pierre-Edouard Bellemare,L,,39,0,0,0,0
18,8478400,Colin White,C,,27,0,0,0,0
18,8480226,Marián Studenic,R,,26,0,0,0,0
18,8480853,Liam Foudy,C,,24,0,0,0,0
18,8475797,Jarred Tinordi,D,,32,0,0,0,0
18,8479423,Alex Nylander,L,,26,0,0,0,0
18,8474618,Marco Scandella,D,,34,0,0,0,0
18,8478028,Fredrik Olofsson,L,,28,0,0,0,0
18,8474709,Matt Martin,L,,35,0,0,0,0
18,8481070,Hugh McGing,L,,26,0,0,0,0
18,8479546,Oskar Steen,C,,26,0,0,0,0
18,8474145,Robert Bortuzzo,D,,35,0,0,0,0
18,8476915,Jujhar Khaira,L,,30,0,0,0,0
18,8475278,Byron Froese,C,,33,0,0,0,0
18,8481812,Nikolai Knyzhov,D,,27,0,0,0,0
18,8478408,Travis Dermott,D,,28,0,0,0,0
18,8481077,John Leonard,L,,26,0,0,0,0
18,8479547,Matthew Phillips,R,,26,0,0,0,0
18,8480836,Jonathan Gruden,C,,24,0,0,0,0
18,8481690,Tyler Angle,C,,24,0,0,0,0
18,8475766,Austin Watson,L,,32,0,0,0,0
18,8481016,Ruslan Iskhakov,C,,24,0,0,0,0
18,8478078,Rourke Chartier,C,,28,0,0,0,0
18,8480776,Sheldon Rempal,R,,29,0,0,0,0
18,8478956,Samuel Laberge,L,NJD,27,0,0,0,0
18,8483045,Cameron Butler,R,CBJ,31,1,0,0,0
18,8484314,Jiri Smejkal,L,,28,0,0,0,0
19,8477492,Nathan MacKinnon,C,COL,29,82,48,82,130
19,8476453,Nikita Kucherov,R,TBL,31,82,39,90,129
19,8477956,David Pastrnak,R,BOS,28,80,59,68,127
19,8478402,Connor McDavid,C,EDM,27,76,31,86,117
19,8477934,Leon Draisaitl,C,EDM,29,71,41,74,115
19,8477946,Dylan Larkin,C,DET,28,81,48,66,114
19,8479318,Auston Matthews,C,TOR,27,77,57,55,112
19,8481559,Jack Hughes,C,NJD,23,68,47,64,111
19,8477942,Kevin Fiala,L,LAK,28,82,37,72,109
19,8478550,Artemi Panarin,L,NYR,33,77,33,76,109
19,8478483,Mitch Marner,R,TOR,27,79,32,76,108
19,8479337,Alex DeBrincat,R,DET,27,80,45,62,107
19,8477933,Sam Reinhart,C,FLA,29,80,51,55,106
19,8477939,William Nylander,R,TOR,28,78,46,60,106
19,8478864,Kirill Kaprizov,L,MIN,27,73,49,50,99
19,8480801,Brady Tkachuk,L,OTT,25,78,43,56,99
19,8476468,J.T. Miller,C,VAN,31,78,28,71,99
19,8479407,Jesper Bratt,L,NJD,26,74,37,61,98
19,8479314,Matthew Tkachuk,L,FLA,27,79,17,80,97
19,8478445,Mathew Barzal,C,NYI,27,81,27,69,96
19,8480800,Quinn Hughes,D,VAN,25,75,12,83,95
19,8480012,Elias Pettersson,C,VAN,26,78,29,62,91
19,8478403,Jack Eichel,C,VGK,28,78,38,51,89
19,8471675,Sidney Crosby,C,PIT,37,77,33,55,88
19,8478420,Mikko Rantanen,R,COL,28,79,33,53,86
19,8478010,Brayden Point,C,TBL,28,82,41,44,85
19,8477493,Aleksander Barkov,C,FLA,29,77,27,58,85
19,8471685,Anze Kopitar,C,LAK,37,80,31,53,84
19,8480023,Robert Thomas,C,STL,25,80,30,53,83
19,8475692,Mats Zuccarello,R,MIN,37,72,20,63,83
19,8480036,Miro Heiskanen,D,DAL,25,81,16,67,83
19,8477404,Jake Guentzel,C,TBL,30,82,37,45,82
19,8477409,Carter Verhaeghe,C,FLA,29,78,41,40,81
19,8480830,Andrei Svechnikov,R,CAR,24,78,28,53,81
19,8479542,Brandon Hagel,L,TBL,26,82,34,46,80
19,8478398,Kyle Connor,L,WPG,28,77,30,50,80
19,8480027,Jason Robertson,L,DAL,25,82,28,52,80
19,8480069,Cale Makar,D,COL,26,70,27,53,80
19,8477949,Alex Tuch,R,BUF,28,73,27,53,80
19,8474600,Roman Josi,D,NSH,34,75,20,60,80
19,8474564,Steven Stamkos,C,NSH,34,79,38,41,79
19,8475172,Nazem Kadri,C,CGY,34,76,28,50,78
19,8476389,Vincent Trocheck,C,NYR,31,75,24,54,78
19,8476346,Johnny Gaudreau,L,CBJ,31,74,16,62,78
19,8479420,Tage Thompson,C,BUF,27,76,43,34,77
19,8478439,Travis Konecny,R,PHI,27,77,37,40,77
19,8478444,Brock Boeser,R,VAN,27,76,35,42,77
19,8477402,Pavel Buchnevich,L,STL,29,74,30,47,77
19,8480002,Nico Hischier,C,NJD,25,74,29,48,77
19,8482116,Tim Stützle,C,OTT,22,79,28,49,77
19,8473419,Brad Marchand,L,BOS,36,80,28,49,77
19,8478449,Roope Hintz,C,DAL,28,82,32,44,76
19,8476887,Filip Forsberg,L,NSH,30,72,31,45,76
19,8484144,Connor Bedard,C,CHI,19,71,30,46,76
19,8479385,Jordan Kyrou,C,STL,26,78,38,37,75
19,8471214,Alex Ovechkin,L,WSH,39,79,34,41,75
19,8475166,John Tavares,C,TOR,34,80,33,42,75
19,8479343,Clayton Keller,R,UTA,26,77,29,46,75
19,8480839,Rasmus Dahlin,D,BUF,24,77,20,55,75
19,8474578,Erik Karlsson,D,PIT,34,78,14,61,75
19,8473512,Claude Giroux,R,OTT,36,80,24,50,74
19,8475754,Brock Nelson,C,NYI,33,80,35,38,73
19,8475810,Bryan Rust,R,PIT,32,71,40,32,72
19,8482740,Wyatt Johnston,C,DAL,21,79,40,32,72
19,8482078,Lucas Raymond,L,DET,22,80,33,39,72
19,8478427,Sebastian Aho,C,CAR,27,73,30,42,72
19,8476853,Morgan Rielly,D,TOR,30,72,10,62,72
19,8476539,Jonathan Marchessault,R,NSH,34,72,30,41,71
19,8477504,Josh Morrissey,D,WPG,29,72,15,56,71
19,8480039,Martin Necas,C,CAR,25,72,33,37,70
19,8477501,Valeri Nichushkin,R,COL,29,82,35,34,69
19,8478493,Joel Eriksson Ek,C,MIN,27,69,32,37,69
19,8475913,Mark Stone,R,VGK,32,76,32,37,69
19,8476460,Mark Scheifele,C,WPG,31,72,27,42,69
19,8478873,Troy Terry,R,ANA,27,77,18,51,69
19,8478460,Zach Werenski,D,CBJ,27,79,14,55,69
19,8479323,Adam Fox,D,NYR,26,72,13,56,69
19,8474141,Patrick Kane,R,DET,36,81,34,34,68
19,8479675,Trevor Moore,L,LAK,29,80,30,38,68
19,8475765,Vladimir Tarasenko,R,DET,33,82,22,46,68
19,8475184,Chris Kreider,L,NYR,33,77,43,24,67
19,8477960,Adrian Kempe,R,LAK,28,82,33,34,67
19,8478414,Timo Meier,R,NJD,28,78,29,38,67
19,8475784,Jeff Skinner,C,EDM,32,80,29,38,67
19,8475168,Matt Duchene,C,DAL,33,82,28,39,67
19,8471215,Evgeni Malkin,C,PIT,38,72,27,40,67
19,8481557,Matt Boldy,L,MIN,23,67,26,40,66
19,8477503,Max Domi,C,TOR,29,81,21,45,66
19,8480865,Noah Dobson,D,NYI,24,82,14,52,66
19,8475786,Zach Hyman,L,EDM,32,76,37,28,65
19,8480208,Drake Batherson,R,OTT,26,81,29,36,65
19,8477447,Shea Theodore,D,VGK,29,59,14,51,65
19,8476881,Tomas Hertl,C,VGK,31,75,32,32,64
19,8478498,Jake DeBrusk,L,VAN,28,66,32,32,64
19,8481540,Cole Caufield,R,MTL,23,75,27,37,64
19,8480018,Nick Suzuki,C,MTL,25,81,25,39,64
19,8477951,Nick Schmaltz,C,UTA,28,75,19,45,64
19,8475798,Mikael Granlund,C,SJS,32,71,14,50,64
19,8476459,Mika Zibanejad,C,NYR,31,76,22,41,63
19,8474679,Gustav Nyquist,C,NSH,35,69,18,45,63
19,8477476,Artturi Lehkonen,L,COL,29,81,38,24,62
19,8477496,Elias Lindholm,C,BOS,30,79,27,35,62
19,8476448,William Karlsson,C,VGK,31,78,26,36,62
19,8477407,Anthony Duclair,L,NYI,29,79,26,35,61
19,8482684,Luke Hughes,D,NJD,21,70,11,50,61
19,8475726,Tyler Toffoli,C,SJS,32,74,23,37,60
19,8481528,Dylan Cozens,C,BUF,23,67,22,38,60
19,8476905,Chandler Stephenson,C,SEA,30,73,16,44,60
19,8476454,Ryan Nugent-Hopkins,C,EDM,31,79,14,46,60
19,8477955,Jared McCann,L,SEA,28,75,29,30,59
19,8482109,Alexis Lafrenière,L,NYR,23,71,29,30,59
19,8477494,Jonathan Drouin,L,COL,29,79,14,45,59
19,8480015,Owen Tippett,R,PHI,25,79,30,28,58
19,8478462,Nicolas Roy,C,VGK,27,74,24,34,58
19,8477940,Nikolaj Ehlers,L,WPG,28,68,23,35,58
19,8474102,David Perron,L,OTT,36,78,20,38,58
19,8478401,Pavel Zacha,C,BOS,27,80,19,39,58
19,8477935,Sam Bennett,C,FLA,28,79,33,24,57
19,8475170,Brayden Schenn,C,STL,33,72,19,38,57
19,8478975,Mason Marchment,L,DAL,29,82,18,39,57
19,8478856,Conor Garland,R,VAN,28,75,25,31,56
19,8478472,Mathieu Joseph,R,STL,27,71,16,40,56
19,8479325,Charlie McAvoy,D,BOS,27,71,6,50,56
19,8477500,Bo Horvat,C,NYI,29,74,32,23,55
19,8481533,Trevor Zegras,C,ANA,23,71,21,34,55
19,8482093,Seth Jarvis,C,CAR,22,71,29,25,54
19,8475158,Ryan O'Reilly,C,NSH,33,75,26,28,54
19,8475794,Tyler Seguin,C,DAL,32,81,26,28,54
19,8479992,Michael Rasmussen,C,DET,25,80,22,32,54
19,8473994,Jamie Benn,L,DAL,35,81,19,35,54
19,8475167,Victor Hedman,D,TBL,34,78,8,46,54
19,8476432,Boone Jenner,C,CBJ,31,68,23,30,53
19,8484166,Adam Fantilli,C,CBJ,20,71,23,30,53
19,8482665,Matty Beniers,C,SEA,22,74,19,34,53
19,8474565,Alex Pietrangelo,D,VGK,34,71,13,40,53
19,8474590,John Carlson,D,WSH,34,70,12,41,53
19,8475191,Reilly Smith,R,NYR,33,75,23,29,52
19,8479999,Casey Mittelstadt,C,COL,26,81,20,32,52
19,8478440,Dylan Strome,C,WSH,27,70,18,34,52
19,8476456,Jonathan Huberdeau,C,CGY,31,80,17,35,52
19,8480803,Evan Bouchard,D,EDM,25,73,13,39,52
19,8483808,Andrei Kuzmenko,L,CGY,28,73,24,27,51
19,8478542,Evan Rodrigues,C,FLA,31,76,22,29,51
19,8476479,Phillip Danault,C,LAK,31,78,19,32,51
19,8476875,Mike Matheson,D,MTL,30,75,16,35,51
19,8477986,Brandon Montour,D,SEA,30,74,13,38,51
19,8476792,Torey Krug,D,STL,33,72,12,39,51
19,8478038,Devon Toews,D,COL,30,73,11,40,51
19,8471724,Kris Letang,D,PIT,37,79,9,42,51
19,8480064,Josh Norris,C,OTT,25,77,24,26,50
19,8478115,Pierre Engvall,L,NYI,28,75,23,27,50
19,8479525,Ross Colton,C,COL,28,80,19,31,50
19,8475745,Charlie Coyle,C,BOS,32,77,16,34,50
19,8475151,Kyle Palmieri,C,NYI,33,81,28,21,49
19,8477451,Ryan Hartman,R,MIN,30,66,22,27,49
19,8477021,Alex Kerfoot,C,UTA,30,71,18,31,49
19,8477932,Aaron Ekblad,D,FLA,28,71,14,35,49
19,8482745,Mason McTavish,C,ANA,21,74,25,23,48
19,8484153,Leo Carlsson,C,ANA,20,72,20,28,48
19,8477479,Tyler Bertuzzi,L,CHI,29,69,20,28,48
19,8475287,Erik Haula,L,NJD,33,73,14,34,48
19,8479425,Filip Hronek,D,VAN,27,73,11,37,48
19,8476958,Jaccob Slavin,D,CAR,30,77,10,38,48
19,8478366,Frank Vatrano,R,ANA,30,74,26,21,47
19,8479365,Trent Frederic,C,BOS,26,80,24,23,47
19,8482110,Dawson Mercer,C,NJD,23,70,23,24,47
19,8476399,Blake Coleman,C,CGY,33,76,22,25,47
19,8482124,Quinton Byfield,R,LAK,22,82,21,26,47
19,8475169,Evander Kane,L,EDM,33,79,20,27,47
19,8476462,Dougie Hamilton,D,NJD,31,70,19,28,47
19,8477953,Kasperi Kapanen,R,STL,28,70,19,28,47
19,8474150,Mikael Backlund,C,CGY,35,74,16,31,47
19,8477346,MacKenzie Weegar,D,CGY,30,79,9,38,47
19,8483431,Logan Cooley,C,UTA,20,70,22,24,46
19,8481596,Shane Pinto,C,OTT,24,77,22,24,46
19,8477416,Oliver Bjorkstrand,R,SEA,29,71,17,29,46
19,8478397,Rasmus Andersson,D,CGY,28,74,11,35,46
19,8481524,Bowen Byram,D,BUF,23,73,11,35,46
19,8476438,Brandon Saad,L,STL,32,73,25,20,45
19,8473986,Alex Killorn,L,ANA,35,75,22,23,45
19,8482699,Dylan Guenther,R,UTA,21,76,21,24,45
19,8477964,Ivan Barbashev,C,VGK,29,74,17,28,45
19,8478438,Tommy Novak,C,NSH,27,70,17,28,45
19,8477429,Andrew Copp,C,DET,30,76,13,32,45
19,8475753,Justin Faulk,D,STL,32,74,13,32,45
19,8481711,Matias Maccelli,L,UTA,24,79,12,33,45
19,8479400,Pierre-Luc Dubois,L,WSH,26,71,21,23,44
19,8478519,Anthony Cirelli,C,TBL,27,80,17,27,44
19,8479987,Morgan Geekie,C,BOS,26,78,17,27,44
19,8482092,Ridly Greig,C,OTT,22,78,17,27,44
19,8480802,Ryan McLeod,C,BUF,25,63,17,27,44
19,8477497,Sean Monahan,C,CBJ,30,68,15,29,44
19,8476906,Shayne Gostisbehere,D,CAR,31,71,14,30,44
19,8482720,Matthew Knies,L,TOR,22,70,12,32,44
19,8480014,Gabriel Vilardi,C,WPG,25,67,31,12,43
19,8480849,Barrett Hayton,C,UTA,24,70,24,19,43
19,8473422,Nick Foligno,L,CHI,37,66,21,22,43
19,8474586,Jordan Eberle,R,SEA,34,74,20,23,43
19,8477444,Andre Burakovsky,L,SEA,29,72,20,23,43
19,8479591,Michael Eyssimont,C,TBL,28,81,19,24,43
19,8475722,Jason Zucker,L,BUF,32,66,18,25,43
19,8479339,Patrik Laine,L,CBJ,26,64,17,26,43
19,8480871,Adam Boqvist,D,FLA,24,75,14,29,43
19,8476826,Yanni Gourde,C,SEA,33,69,13,30,43
19,8481542,Moritz Seider,D,DET,23,76,7,36,43
19,8482149,Cole Perfetti,C,WPG,22,63,25,17,42
19,8476880,Tom Wilson,R,WSH,30,70,25,17,42
19,8481068,Yegor Sharangovich,C,CGY,26,77,21,21,42
19,8476483,Rickard Rakell,R,PIT,31,77,20,22,42
19,8477511,Anthony Mantha,R,CGY,30,76,19,23,42
19,8482113,Anton Lundell,C,FLA,23,80,17,25,42
19,8481560,Arthur Kaliyev,R,LAK,23,77,16,26,42
19,8478047,Michael Bunting,L,PIT,29,71,15,27,42
19,8480188,Fabian Zetterlund,L,SJS,25,59,15,27,42
19,8483515,Juraj Slafkovsky,L,MTL,20,79,12,30,42
19,8477426,Nicholas Paul,L,TBL,29,82,21,20,41
19,8474641,Adam Henrique,C,EDM,34,74,21,20,41
19,8482671,Owen Power,D,BUF,22,62,15,26,41
19,8481581,Thomas Harley,D,DAL,23,77,12,29,41
19,8482105,Jake Sanderson,D,OTT,22,76,9,32,41
19,8478469,Thomas Chabot,D,OTT,27,76,4,37,41
19,8475314,Anders Lee,L,NYI,34,77,21,19,40
19,8481577,Philip Tomasino,C,NSH,23,70,20,20,40
19,8484145,Zach Benson,L,BUF,19,70,18,22,40
19,8482159,Tyson Foerster,R,PHI,22,75,16,24,40
19,8475218,Mattias Ekholm,D,EDM,34,70,16,24,40
19,8480185,Eetu Luostarinen,C,FLA,26,74,14,26,40
19,8478042,Viktor Arvidsson,L,EDM,31,75,14,26,40
19,8479345,Jakob Chychrun,D,WSH,26,71,13,27,40
19,8474563,Drew Doughty,D,LAK,35,66,11,29,40
19,8480336,Sean Walker,D,CAR,30,81,10,30,40
19,8476917,Adam Pelech,D,NYI,30,77,4,36,40
19,8475768,Jaden Schwartz,C,SEA,32,75,26,13,39
19,8481604,Pavel Dorofeyev,L,VGK,24,69,21,18,39
19,8482705,Cole Sillinger,C,CBJ,21,64,19,20,39
19,8477998,Warren Foegele,L,LAK,28,80,18,21,39
19,8477498,Darnell Nurse,D,EDM,29,76,15,24,39
19,8475848,Brendan Gallagher,R,MTL,32,73,14,25,39
19,8476292,Ondrej Palat,L,NJD,33,69,12,27,39
19,8481618,Alex Newhook,C,MTL,23,77,12,27,39
19,8470613,Brent Burns,D,CAR,39,77,10,29,39
19,8482712,Oskar Olausson,R,COL,22,76,9,30,39
19,8476923,Damon Severson,D,CBJ,30,82,7,32,39
19,8481554,Kaapo Kakko,R,NYR,23,71,21,17,38
19,8478046,Danton Heinen,L,VAN,29,70,20,18,38
19,8480434,Sean Durzi,D,UTA,26,70,13,25,38
19,8480797,Joel Farabee,L,PHI,24,71,11,27,38
19,8476458,Ryan Strome,C,ANA,31,68,10,28,38
19,8476419,Jean-Gabriel Pageau,C,NYI,32,78,10,28,38
19,8478407,Vince Dunn,D,SEA,28,67,9,29,38
19,8478396,Noah Hanifin,D,VGK,27,58,8,30,38
19,8479410,Mikhail Sergachev,D,UTA,26,70,7,31,38
19,8475799,Nino Niederreiter,R,WPG,32,62,22,15,37
19,8475714,Calle Jarnkrok,C,TOR,33,72,19,18,37
19,8482702,Logan Stankoven,C,DAL,21,81,16,21,37
19,8480748,Kiefer Sherwood,L,VAN,29,61,14,23,37
19,8482660,Kent Johnson,C,CBJ,22,68,11,26,37
19,8476918,Jimmy Vesey,L,NYR,31,74,23,13,36
19,8482175,JJ Peterka,R,BUF,22,66,22,14,36
19,8482055,Drew O'Connor,L,PIT,26,68,22,14,36
19,8482146,Luke Evangelista,R,NSH,22,69,17,19,36
19,8479351,Sam Steel,C,DAL,26,80,16,20,36
19,8480028,Morgan Frost,C,PHI,25,77,13,23,36
19,8483505,Matthew Poitras,C,BOS,20,77,13,23,36
19,8477456,J.T. Compher,L,DET,29,75,11,25,36
19,8480798,Philipp Kurashev,C,CHI,25,61,11,25,36
19,8476981,Josh Anderson,R,MTL,30,72,21,14,35
19,8479619,Michael Carcone,L,UTA,28,60,19,16,35
19,8481477,Nico Sturm,C,SJS,29,57,18,17,35
19,8478043,Sam Lafferty,C,BUF,29,70,17,18,35
19,8481535,Nils Hoglander,L,VAN,24,69,16,19,35
19,8482667,William Eklund,L,SJS,22,70,12,23,35
19,8476480,Vladislav Namestnikov,C,WPG,32,69,11,24,35
19,8478458,John (Jack) Roslovic,C,CAR,27,64,9,26,35
19,8477495,Seth Jones,D,CHI,30,73,8,27,35
19,8478055,Gustav Forsling,D,FLA,28,71,7,28,35
19,8482089,Jake Neighbours,L,STL,22,67,22,12,34
19,8478474,Lawson Crouse,L,UTA,27,77,20,14,34
19,8482475,Yegor Chinakhov,R,CBJ,23,64,18,16,34
19,8482133,Thomas Bordeleau,C,SJS,22,63,13,21,34
19,8474053,Logan Couture,C,SJS,35,62,11,23,34
19,8482097,Jack Quinn,R,BUF,23,61,9,25,34
19,8481523,Kirby Dach,C,MTL,23,70,9,25,34
19,8478882,Vladislav Gavrikov,D,LAK,29,67,8,26,34
19,8476869,Brady Skjei,D,NSH,30,70,7,27,34
19,8483490,Pavel Mintyukov,D,ANA,21,76,7,27,34
19,8476331,Dylan DeMelo,D,WPG,31,69,7,27,34
19,8480893,Kirill Marchenko,R,CBJ,24,64,24,9,33
19,8471698,T.J. Oshie,R,WSH,38,72,17,16,33
19,8481704,Juuso Parssinen,C,NSH,23,63,17,16,33
19,8477425,Miles Wood,L,COL,29,76,16,17,33
19,8480459,Pius Suter,C,VAN,28,71,16,17,33
19,8480220,Noah Cates,L,PHI,25,68,15,18,33
19,8479353,Brett Howden,C,VGK,26,64,15,18,33
19,8478891,Mason Appleton,C,WPG,28,67,13,20,33
19,8479390,Taylor Raddysh,R,WSH,26,63,13,20,33
19,8474716,Jared Spurgeon,D,MIN,35,76,12,21,33
19,8481580,Connor McMichael,C,WSH,23,60,11,22,33
19,8477947,Sonny Milano,L,WSH,28,66,11,22,33
19,8484203,Bradly Nadeau,L,CAR,19,61,10,23,33
19,8478500,Ivan Provorov,D,CBJ,27,79,9,24,33
19,8479639,Dylan Coghlan,D,WPG,26,65,8,25,33
19,8476872,Scott Laughton,C,PHI,30,72,6,27,33
19,8479941,Justin Danforth,R,CBJ,31,64,18,14,32
19,8473533,Jordan Staal,C,CAR,36,64,17,15,32
19,8476921,Jordan Martinook,L,CAR,32,63,16,16,32
19,8478466,Daniel Sprong,R,VAN,27,63,14,18,32
19,8481186,Logan O'Connor,R,COL,28,82,13,19,32
19,8475171,Oliver Ekman-Larsson,D,TOR,33,68,13,19,32
19,8474149,Evgenii Dadonov,R,DAL,35,78,12,20,32
19,8475343,Nic Dowd,C,WSH,34,59,12,20,32
19,8481481,Blake Lizotte,C,PIT,27,60,11,21,32
19,8475181,Nick Leddy,D,STL,33,71,4,28,32
19,8478463,Anthony Beauvillier,L,PIT,27,64,18,13,31
19,8476278,Colin Blackwell,C,DAL,31,78,13,18,31
19,8475763,Kevin Hayes,R,PIT,32,66,8,23,31
19,8481703,Valtteri Puustinen,R,PIT,25,61,8,23,31
19,8476463,Jonas Brodin,D,MIN,31,76,7,24,31
19,8482122,Brock Faber,D,MIN,22,79,1,30,31
19,8481522,Peyton Krebs,C,BUF,23,61,13,17,30
19,8476854,Hampus Lindholm,D,BOS,30,74,11,19,30
19,8480829,Jesperi Kotkaniemi,C,CAR,24,64,10,20,30
19,8476885,Jacob Trouba,D,NYR,30,71,8,22,30
19,8480817,K'Andre Miller,D,NYR,24,71,8,22,30
19,8482067,Connor Mackey,D,NYR,28,66,7,23,30
19,8482073,Braden Schneider,D,NYR,23,64,6,24,30
19,8482245,Artem Zub,D,OTT,29,64,6,24,30
19,8481582,Nicholas Robertson,L,TOR,23,70,17,12,29
19,8476474,Stefan Noesen,R,NJD,31,60,15,14,29
19,8476927,Teddy Blueger,C,VAN,30,60,14,15,29
19,8475760,Nick Bjugstad,C,UTA,32,75,12,17,29
19,8476882,Teuvo Teravainen,C,CHI,30,57,11,18,29
19,8477919,Frederick Gaudreau,C,MIN,31,65,11,18,29
19,8477505,Alexander Wennberg,C,SJS,30,61,11,18,29
19,8475200,Dmitry Orlov,D,CAR,33,73,6,23,29
19,8477987,Ryan Donato,C,CHI,28,58,6,23,29
19,8476897,Oskar Sundqvist,C,STL,30,62,12,16,28
19,8482809,Jackson Blake,R,CAR,21,53,12,16,28
19,8476392,Adam Lowry,C,WPG,31,63,11,17,28
19,8478413,Jordan Greenway,L,BUF,27,64,9,19,28
19,8480049,Dylan Samberg,D,WPG,25,67,4,24,28
19,8480145,Neal Pionk,D,WPG,29,74,1,27,28
19,8478020,Michael Amadio,R,OTT,28,72,16,11,27
19,8480068,Ryan Poehling,C,PHI,25,73,15,12,27
19,8480835,Jack Drury,C,CAR,24,59,12,15,27
19,8480113,Alex Iafallo,L,WPG,31,64,12,15,27
19,8481606,Jordan Spence,D,LAK,23,63,7,20,27
19,8478911,Matt Roy,D,WSH,29,60,6,21,27
19,8479316,Luke Kunin,C,SJS,27,55,18,8,26
19,8478233,Andrew Mangiapane,L,WSH,28,64,15,11,26
19,8480009,Eeli Tolvanen,R,SEA,25,63,14,12,26
19,8479393,Noah Gregor,L,OTT,26,71,14,12,26
19,8478109,Victor Olofsson,L,VGK,29,70,12,14,26
19,8480078,Filip Chytil,C,NYR,25,64,10,16,26
19,8483524,Shane Wright,C,SEA,20,63,9,17,26
19,8476892,Colton Parayko,D,STL,31,69,6,20,26
19,8477506,Ryan Pulock,D,NYI,30,79,4,22,26
19,8481059,Scott Perunovich,D,STL,26,53,3,23,26
19,8478057,Dakota Joshua,C,VAN,28,64,14,11,25
19,8477353,Tyler Motte,C,DET,29,77,14,11,25
19,8475793,Ryan Johansen,C,PHI,32,70,11,14,25
19,8475193,Tomas Tatar,L,NJD,34,73,11,14,25
19,8476461,Sean Couturier,C,PHI,32,64,10,15,25
19,8479996,Cody Glass,C,NSH,25,68,10,15,25
19,8479328,Julien Gauthier,R,NYI,27,65,10,15,25
19,8483482,Tristan Luneau,D,ANA,20,59,10,15,25
19,8482624,Daniil Miromanov,D,CGY,27,67,9,16,25
19,8479066,Ryan Lomberg,L,CGY,30,68,9,16,25
19,8476979,Erik Gustafsson,D,DET,32,74,7,18,25
19,8482101,Danil Gushchin,L,SJS,22,59,7,18,25
19,8483565,Nick Blankenburg,D,NSH,26,72,6,19,25
19,8476312,Josh Manson,D,COL,33,60,6,19,25
19,8480789,Oliver Wahlstrom,R,NYI,24,67,6,19,25
19,8473507,Jeff Petry,D,DET,37,73,4,21,25
19,8475690,Chris Tanev,D,TOR,35,55,4,21,25
19,8477969,Marcus Pettersson,D,PIT,28,73,3,22,25
19,8470621,Corey Perry,R,EDM,39,74,16,8,24
19,8481641,Joel Kiviranta,L,COL,28,76,16,8,24
19,8480813,Joe Veleno,C,DET,24,79,13,11,24
19,8482125,Alexander Holtz,R,VGK,22,71,12,12,24
19,8474189,Lars Eller,C,PIT,35,61,12,12,24
19,8480003,Jesper Boqvist,C,FLA,26,68,12,12,24
19,8477952,Robby Fabbri,C,ANA,28,64,12,12,24
19,8481656,Aliaksei Protas,C,WSH,23,59,12,12,24
19,8478432,Christian Fischer,R,DET,27,72,11,13,24
19,8476925,Colton Sissons,C,NSH,31,65,10,14,24
19,8483457,Lane Hutson,D,MTL,20,66,10,14,24
19,8477948,Travis Sanheim,D,PHI,28,65,9,15,24
19,8477989,Christian Dvorak,C,MTL,28,65,9,15,24
19,8481546,Cam York,D,PHI,23,69,8,16,24
19,8479983,Mario Ferraro,D,SJS,26,74,5,19,24
19,8475764,Cam Fowler,D,ANA,33,71,3,21,24
19,8474151,Ryan McDonagh,D,TBL,35,77,2,22,24
19,8481624,Ilya Mikheyev,R,CHI,30,62,13,10,23
19,8475231,Casey Cizikas,C,NYI,33,72,10,13,23
19,8483493,Frank Nazar,C,CHI,20,56,10,13,23
19,8476422,Mike Reilly,D,NYI,31,73,10,13,23
19,8479370,Tyson Jost,C,CAR,26,58,10,13,23
19,8479661,Tanner Jeannot,L,LAK,27,79,9,14,23
19,8481521,Ronnie Attard,D,PHI,25,57,9,14,23
19,8481093,Rafael Harvey-Pinard,L,MTL,25,55,9,14,23
19,8479315,Joey Anderson,R,CHI,26,55,8,15,23
19,8482111,Justin Barron,D,MTL,23,71,7,16,23
19,8475149,Marcus Johansson,L,MIN,34,65,6,17,23
19,8481441,Joe Snively,C,DET,28,60,6,17,23
19,8477845,Trevor van Riemsdyk,D,WSH,33,55,5,18,23
19,8482451,Mikael Pyyhtia,L,CBJ,23,45,5,18,23
19,8477488,Brett Pesce,D,NJD,30,69,4,19,23
19,8481599,Victor Soderstrom,D,UTA,23,51,4,19,23
19,8481014,Alexander Romanov,D,NYI,24,80,3,20,23
19,8480043,Timothy Liljegren,D,TOR,25,69,2,21,23
19,8479998,Mikey Anderson,D,LAK,25,68,2,21,23
19,8473453,Trevor Lewis,C,LAK,37,76,14,8,22
19,8480205,Emil Bemstrom,C,PIT,25,54,13,9,22
19,8476469,Joel Armia,R,MTL,31,66,12,10,22
19,8477839,Conor Sheary,L,TBL,32,80,10,12,22
19,8482679,Matt Coronato,R,CGY,22,61,10,12,22
19,8483495,Simon Nemec,D,NJD,20,52,9,13,22
19,8482117,Lukas Reichel,L,CHI,22,57,7,15,22
19,8480021,Jack Studnicka,C,LAK,25,63,7,15,22
19,8475233,David Savard,D,MTL,34,65,6,16,22
19,8474166,Alec Martinez,D,CHI,37,51,5,17,22
19,8479369,Andrew Peeke,D,BOS,26,60,4,18,22
19,8479976,Juuso Valimaki,D,UTA,26,68,3,19,22
19,8475855,Jesper Fast,R,CAR,33,59,13,8,21
19,8478508,Yakov Trenin,C,MIN,27,64,11,10,21
19,8482074,Connor Zary,C,CGY,23,55,10,11,21
19,8478569,Noel Acciari,C,PIT,33,58,10,11,21
19,8483499,Liam Ohgren,L,MIN,20,57,9,12,21
19,8480144,David Kampf,C,TOR,29,68,8,13,21
19,8477392,Hudson Fasching,R,NYI,29,66,8,13,21
19,8478434,Keegan Kolesar,R,VGK,27,63,8,13,21
19,8475220,Marcus Foligno,L,MIN,33,60,7,14,21
19,8478136,Jake Middleton,D,MIN,28,76,5,16,21
19,8476525,Colin Miller,D,WPG,32,62,4,17,21
19,8477499,Rasmus Ristolainen,D,PHI,30,52,3,18,21
19,8476457,Adam Larsson,D,SEA,32,68,3,18,21
19,8482737,Zack Bolduc,C,STL,21,50,11,9,20
19,8482259,Bobby McMann,C,TOR,28,65,9,11,20
19,8476878,Zemgus Girgensons,C,TBL,30,80,9,11,20
19,8475791,Taylor Hall,L,CHI,33,47,8,12,20
19,8476889,Radek Faksa,C,STL,30,58,8,12,20
19,8477573,Nathan Walker,L,STL,30,48,8,12,20
19,8481553,Bobby Brink,R,PHI,23,60,6,14,20
19,8479982,Conor Timmins,D,TOR,26,60,5,15,20
19,8482192,Isaak Phillips,D,CHI,23,52,5,15,20
19,8477507,Nikita Zadorov,D,BOS,29,67,5,15,20
19,8478507,John Marino,D,UTA,27,68,0,20,20
19,8482079,Marco Rossi,C,MIN,23,60,10,9,19
19,8481517,Brett Leason,R,ANA,25,59,10,9,19
19,8480855,Jack McBain,C,UTA,24,65,10,9,19
19,8480980,Connor Dewar,C,TOR,25,68,10,9,19
19,8478013,Jake Walman,D,SJS,28,70,10,9,19
19,8473563,Nicklas Backstrom,C,WSH,37,57,7,12,19
19,8481527,Kaedan Korczak,D,VGK,23,49,7,12,19
19,8476960,Andreas Athanasiou,C,CHI,30,53,6,13,19
19,8476856,Mathew Dumba,D,DAL,30,74,5,14,19
19,8477979,Nicolas Aube-Kubel,R,BUF,28,56,5,14,19
19,8480246,Nick Perbix,D,TBL,26,73,4,15,19
19,8477220,Nate Schmidt,D,FLA,33,68,4,15,19
19,8476429,Scott Mayfield,D,NYI,32,71,4,15,19
19,8480807,Mattias Samuelsson,D,BUF,24,51,4,15,19
19,8476931,Jake McCabe,D,TOR,31,61,3,16,19
19,8480891,Michael Kesselring,D,UTA,24,64,2,17,19
19,8478416,Erik Cernak,D,TBL,27,73,1,18,19
19,8479336,Carl Grundstrom,R,SJS,27,55,12,6,18
19,8481617,Vasily Podkolzin,R,VAN,23,51,12,6,18
19,8482155,Alex Laferriere,R,LAK,23,67,11,7,18
19,8477450,Jason Dickinson,C,CHI,29,56,10,8,18
19,8474715,Cameron Atkinson,R,TBL,35,81,9,9,18
19,8483468,Jiri Kulich,C,BUF,20,55,8,10,18
19,8480074,Alexandre Texier,C,STL,25,59,8,10,18
19,8477508,Curtis Lazar,C,NJD,29,64,7,11,18
19,8477435,Ryan Graves,D,PIT,29,79,5,13,18
19,8476467,Jamie Oleksiak,D,SEA,32,69,4,14,18
19,8475179,Dmitry Kulikov,D,FLA,34,61,4,14,18
19,8477015,Connor Brown,R,EDM,30,62,4,14,18
19,8482655,Janis Moser,D,TBL,24,74,2,16,18
19,8479439,Jacob MacDonald,D,COL,31,51,2,16,18
19,8475188,Brayden McNabb,D,VGK,33,58,2,16,18
19,8476967,Brett Kulak,D,EDM,30,59,2,16,18
19,8476879,Cody Ceci,D,EDM,31,71,1,17,18
19,8480289,Morgan Barron,C,WPG,26,50,9,8,17
19,8477446,Michael McCarron,R,NSH,29,50,8,9,17
19,8479414,Nathan Bastian,R,NJD,27,58,8,9,17
19,8476624,Barclay Goodrow,C,SJS,31,49,8,9,17
19,8477931,Tomas Nosek,L,FLA,32,55,5,12,17
19,8478451,Ethan Bear,D,WSH,27,47,5,12,17
19,8475750,Jon Merrill,D,MIN,32,60,5,12,17
19,8476988,Matt Benning,D,SJS,30,71,4,13,17
19,8476891,Matthew Grzelcyk,D,PIT,30,75,4,13,17
19,8478840,Will Borgen,D,SEA,28,67,2,15,17
19,8482807,Ethan Del Mastro,D,CHI,21,49,12,4,16
19,8475225,Craig Smith,C,CHI,35,52,11,5,16
19,8477938,Haydn Fleury,D,WPG,28,42,10,6,16
19,8481032,Paul Cotter,C,NJD,25,67,9,7,16
19,8477406,Mattias Janmark,C,EDM,32,63,9,7,16
19,8479968,Vinni Lettieri,C,BOS,29,48,8,8,16
19,8482749,Joshua Roy,R,MTL,21,59,7,9,16
19,8482157,Will Cuylle,L,NYR,22,60,7,9,16
19,8481537,Nikita Okhotiuk,D,CGY,24,47,7,9,16
19,8476442,Matt Nieto,L,PIT,32,47,6,10,16
19,8479293,Brandon Tanev,L,SEA,33,63,5,11,16
19,8483445,Cutter Gauthier,L,ANA,20,58,5,11,16
19,8476374,Sean Kuraly,C,CBJ,31,61,5,11,16
19,8481701,Santeri Hatakka,D,NJD,23,42,5,11,16
19,8476902,Esa Lindell,D,DAL,30,73,4,12,16
19,8477018,Ben Hutton,D,VGK,31,44,4,12,16
19,8480796,Martin Fehervary,D,WSH,25,61,4,12,16
19,8480192,Johnathan Kovacevic,D,NJD,27,53,3,13,16
19,8478399,Jonas Siegenthaler,D,NJD,27,65,3,13,16
19,8480873,Rasmus Sandin,D,WSH,24,63,1,15,16
19,8480222,Sebastian Aho,D,PIT,28,70,1,15,16
19,8479368,Max Jones,L,BOS,26,62,10,5,15
19,8481716,Dmitri Voronkov,L,CBJ,24,41,10,5,15
19,8478133,Jake Evans,C,MTL,28,60,9,6,15
19,8479344,Jesse Puljujarvi,R,PIT,26,47,9,6,15
19,8480806,Isac Lundestrom,C,ANA,25,64,9,6,15
19,8480995,Pontus Holmberg,R,TOR,25,60,6,9,15
19,8477851,Jordan Oesterle,D,BOS,32,43,6,9,15
19,8476329,Travis Boyd,C,MIN,31,57,5,10,15
19,8483466,Kevin Korchinski,D,CHI,20,47,5,10,15
19,8482730,Brandt Clarke,D,LAK,21,57,5,10,15
19,8482176,Wyatt Kaiser,D,CHI,22,57,4,11,15
19,8475790,Erik Gudbranson,D,CBJ,32,78,3,12,15
19,8479324,Ryan Lindgren,D,NYR,26,57,3,12,15
19,8475462,Radko Gudas,D,ANA,34,65,3,12,15
19,8478452,Caleb Jones,D,LAK,27,56,3,12,15
19,8476994,Vinnie Hinostroza,C,NSH,30,44,2,13,15
19,8478851,Alexandre Carrier,D,NSH,28,62,2,13,15
19,8481019,David Gustafsson,C,WPG,24,53,2,13,15
19,8480727,Zach Whitecloud,D,VGK,28,54,2,13,15
19,8480058,Pierre-Olivier Joseph,D,STL,25,58,2,13,15
19,8474673,TJ Brodie,D,CHI,34,63,1,14,15
19,8482659,Josh Doan,R,UTA,22,49,10,4,14
19,8479398,Samuel Girard,D,COL,26,68,6,8,14
19,8479671,Mathieu Olivier,R,CBJ,27,47,6,8,14
19,8482142,Jamie Drysdale,D,PHI,22,62,4,10,14
19,8474568,Luke Schenn,D,NSH,35,46,4,10,14
19,8480035,Henri Jokiharju,D,BUF,25,58,3,11,14
19,8480001,Urho Vaakanainen,D,ANA,25,62,3,11,14
19,8481568,Alex Vlasic,D,CHI,23,52,2,12,14
19,8479371,Dante Fabbro,D,NSH,26,63,1,13,14
19,8480073,Erik Brannstrom,D,COL,25,65,0,14,14
19,8480878,Nils Lundkvist,D,DAL,24,68,0,14,14
19,8475842,Sam Carrick,C,NYR,32,62,9,4,13
19,8480281,Alexey Toropchenko,R,STL,25,55,9,4,13
19,8479536,Axel Jonsson-Fjallby,L,WPG,26,39,8,5,13
19,8483491,Ivan Miroshnichenko,L,WSH,20,56,7,6,13
19,8479543,Michael Pezzetta,L,MTL,26,50,6,7,13
19,8478211,Dryden Hunt,L,CGY,29,59,5,8,13
19,8480172,Jan Rutta,D,SJS,34,54,5,8,13
19,8480252,Cole Guttman,C,CHI,25,41,4,9,13
19,8479291,Kevin Rooney,C,CGY,31,57,4,9,13
19,8474574,Tyler Myers,D,VAN,34,68,3,10,13
19,8475279,Ben Chiarot,D,DET,33,67,3,10,13
19,8471709,Marc-Edouard Vlasic,D,SJS,37,59,2,11,13
19,8476874,Olli Maatta,D,DET,30,61,1,12,13
19,8479348,Kale Clague,D,BUF,26,47,1,12,13
19,8478585,Derek Ryan,C,EDM,38,60,10,2,12
19,8478831,Kevin Stenlund,C,UTA,28,53,9,3,12
19,8481754,Nikita Nesterenko,C,ANA,23,40,7,5,12
19,8477478,William Carrier,L,CAR,30,61,6,6,12
19,8481161,Jake Christiansen,D,CBJ,25,56,6,6,12
19,8482713,Mackie Samoskevich,R,FLA,22,36,6,6,12
19,8477903,Garnet Hathaway,R,PHI,33,55,5,7,12
19,8482148,Hendrix Lapierre,C,WSH,22,54,5,7,12
19,8480448,Parker Kelly,L,COL,25,78,3,9,12
19,8478443,Brandon Carlo,D,BOS,28,60,3,9,12
19,8478859,Niko Mikkola,D,FLA,28,55,3,9,12
19,8479026,Philippe Myers,D,TOR,27,55,3,9,12
19,8481550,Adam Beckman,L,NJD,23,40,3,9,12
19,8478970,Jalen Chatfield,D,CAR,28,73,1,11,12
19,8477369,Carson Soucy,D,VAN,30,56,1,11,12
19,8479402,Jake Bean,D,CGY,26,68,1,11,12
19,8470600,Ryan Suter,D,STL,39,58,1,11,12
19,8478468,Jeremy Lauzon,D,NSH,27,55,1,11,12
19,8481567,Henry Thrun,D,SJS,23,46,1,11,12
19,8479359,Beck Malenstyn,L,BUF,26,47,8,3,11
19,8481601,Simon Holmstrom,R,NYI,23,63,6,5,11
19,8478421,A.J. Greer,L,FLA,28,58,6,5,11
19,8479718,Alex Barré-Boulet,C,MTL,27,47,6,5,11
19,8480011,Klim Kostin,C,SJS,25,54,6,5,11
19,8481592,Jakob Pelletier,L,CGY,23,49,6,5,11
19,8482859,Zack Ostapchuk,C,OTT,21,45,5,6,11
19,8482747,Brennan Othmann,L,NYR,21,40,5,6,11
19,8479772,Zack MacEwen,R,OTT,28,60,5,6,11
19,8476822,Luke Glendening,C,TBL,35,79,4,7,11
19,8476867,Brendan Gaunce,C,MIN,30,36,4,7,11
19,8479576,Vincent Desharnais,D,VAN,28,37,4,7,11
19,8481013,Jonatan Berggren,R,DET,24,61,3,8,11
19,8480887,Jordan Harris,D,MTL,24,49,3,8,11
19,8482095,Tyler Kleven,D,OTT,22,41,3,8,11
19,8482087,Kaiden Guhle,D,MTL,22,67,2,9,11
19,8479442,Troy Stecher,D,EDM,30,56,2,9,11
19,8479980,Nicolas Hague,D,VGK,26,50,1,10,11
19,8481178,Egor Zamula,D,PHI,24,60,0,11,11
19,8482762,Simon Edvinsson,D,DET,21,51,8,2,10
19,8476873,Mark Jankowski,C,NSH,30,50,7,3,10
19,8479944,Zach Aston-Reese,C,VGK,30,43,7,3,10
19,8471677,Jack Johnson,D,CBJ,37,67,6,4,10
19,8480762,Eric Robinson,L,CAR,29,54,5,5,10
19,8484149,Gavin Brindley,C,CBJ,20,41,5,5,10
19,8479981,Jonah Gadjovich,L,FLA,26,37,5,5,10
19,8481751,Lukas Rousek,R,BUF,25,37,5,5,10
19,8474034,Patrick Maroon,L,CHI,36,46,4,6,10
19,8477380,Jonny Brodzinski,C,NYR,31,52,4,6,10
19,8480441,Trey Fix-Wolansky,R,CBJ,25,37,4,6,10
19,8481598,Philip Broberg,D,EDM,23,45,4,6,10
19,8477482,Zachary Sanford,L,CHI,30,41,4,6,10
19,8480879,Jacob Bernard-Docker,D,OTT,24,47,3,7,10
19,8474090,Brendan Smith,D,DAL,35,55,2,8,10
19,8478424,Jansen Harkins,C,ANA,27,35,2,8,10
19,8475324,Nick Jensen,D,OTT,34,69,0,10,10
19,8478454,Noah Juulsen,D,VAN,27,34,0,10,10
19,8481147,Reese Johnson,C,MIN,26,34,7,2,9
19,8480025,MacKenzie Entwistle,R,FLA,25,62,5,4,9
19,8482803,Olen Zellweger,D,ANA,21,65,4,5,9
19,8482077,Dylan Holloway,L,EDM,23,51,4,5,9
19,8481028,Martin Pospisil,C,CGY,25,49,4,5,9
19,8482634,Alex Steeves,C,TOR,25,53,4,5,9
19,8482751,Ryan Winterton,C,SEA,21,41,4,5,9
19,8482744,James Malatesta,L,CBJ,21,36,3,6,9
19,8480848,Ty Dellandrea,C,SJS,24,38,3,6,9
19,8483549,Lucas Condotta,L,MTL,27,39,3,6,9
19,8482166,Shakir Mukhamadullin,D,SJS,22,50,3,6,9
19,8480292,Carson Meyer,R,ANA,27,31,3,6,9
19,8482250,Callahan Burke,C,VGK,27,27,3,6,9
19,8478178,Darren Raddysh,D,TBL,28,69,2,7,9
19,8481600,Tobias Bjornfot,D,FLA,23,34,2,7,9
19,8474013,Ian Cole,D,UTA,35,53,2,7,9
19,8482666,Scott Morrow,D,CAR,22,40,2,7,9
19,8479520,Brandon Duhaime,R,WSH,27,49,2,7,9
19,8480070,Ian Mitchell,D,BOS,25,42,2,7,9
19,8479378,Logan Stanley,D,WPG,26,41,2,7,9
19,8476952,Dominic Toninato,C,WPG,30,36,2,7,9
19,8480157,Calle Rosen,D,COL,30,46,1,8,9
19,8479249,Andrew Poturalski,C,SJS,30,34,1,8,9
19,8482511,Mason Lohrei,D,BOS,23,34,1,8,9
19,8476441,Joel Edmundson,D,LAK,31,42,1,8,9
19,8476372,Nick Seeler,D,PHI,31,49,0,9,9
19,8482733,Logan Mailloux,D,MTL,31,34,6,2,8
19,8476934,Brock McGinn,L,ANA,30,47,5,3,8
19,8477887,Patrick Brown,C,BOS,32,39,4,4,8
19,8475762,Derek Forbort,D,VAN,32,50,4,4,8
19,8482062,Cole Smith,L,NSH,29,50,3,5,8
19,8483570,Ben Meyers,C,SEA,26,34,3,5,8
19,8481679,Maxence Guenette,D,OTT,23,36,3,5,8
19,8475455,Brenden Dillon,D,NJD,34,60,3,5,8
19,8477401,John Hayden,C,SEA,29,32,3,5,8
19,8475958,Michael Sgarbossa,C,WSH,32,30,3,5,8
19,8480950,Ilya Lyubushkin,D,DAL,30,58,2,6,8
19,8480355,Mark Kastelic,C,BOS,25,56,2,6,8
19,8482964,Arber Xhekaj,D,MTL,23,49,2,6,8
19,8481605,Jackson LaCombe,D,ANA,23,33,2,6,8
19,8481518,Nolan Foote,L,NJD,24,40,2,6,8
19,8481708,Zac Jones,D,NYR,24,49,1,7,8
19,8480196,Jacob Bryson,D,BUF,27,36,1,7,8
19,8479372,Joshua Mahura,D,SEA,26,56,0,8,8
19,8476858,Phillip Di Giuseppe,L,VAN,31,39,6,1,7
19,8479994,Jaret Anderson-Dolan,C,WPG,25,38,5,2,7
19,8482652,Walker Duehr,R,CGY,27,40,5,2,7
19,8481789,Tye Kartye,L,SEA,23,35,4,3,7
19,8480007,Jonas Rondbjerg,R,VGK,25,36,4,3,7
19,8471817,Ryan Reaves,R,TOR,37,54,4,3,7
19,8482784,Zach Dean,C,STL,21,42,3,4,7
19,8481532,Alex Turcotte,C,LAK,23,44,3,4,7
19,8481122,Simon Benoit,D,TOR,26,38,3,4,7
19,8478409,Anthony Richard,C,PHI,28,34,2,5,7
19,8483619,Filip Roos,D,OTT,25,40,2,5,7
19,8478021,William Lagesson,D,DET,28,30,2,5,7
19,8478450,Parker Wotherspoon,D,BOS,27,41,1,6,7
19,8477070,Liam O'Brien,C,UTA,30,53,1,6,7
19,8476913,Devin Shore,C,MIN,30,32,1,6,7
19,8479972,Mason Shaw,C,WPG,26,34,1,6,7
19,8481167,Brayden Pachal,D,CGY,25,39,1,6,7
19,8475208,Brian Dumoulin,D,ANA,33,61,0,7,7
19,8481556,John Beecher,C,BOS,23,32,5,1,6
19,8482070,Mitchell Chaffee,R,TBL,26,50,5,1,6
19,8481237,Kyle MacLean,C,NYI,25,26,4,2,6
19,8474567,Zach Bogosian,D,MIN,34,61,3,3,6
19,8482153,Brendan Brisson,C,VGK,23,41,3,3,6
19,8478874,Adam Gaudette,R,OTT,28,34,3,3,6
19,8482765,Isak Rosen,R,BUF,21,31,3,3,6
19,8484287,Cole McWard,D,VAN,23,20,3,3,6
19,8483763,Maksymilian Szuber,D,UTA,22,24,2,4,6
19,8480845,Rasmus Kupari,C,WPG,24,46,2,4,6
19,8481543,Nikita Alexandrov,C,STL,24,25,2,4,6
19,8484258,Sam Malinski,D,COL,26,19,2,4,6
19,8484254,Akito Hirose,D,VAN,25,37,1,5,6
19,8479985,Cale Fleury,D,SEA,26,28,1,5,6
19,8479991,Jake Leschyshyn,C,NYR,25,24,1,5,6
19,8473446,Erik Johnson,D,PHI,36,46,0,6,6
19,8480870,Bo Groulx,C,NYR,24,32,0,6,6
19,8475235,Nicolas Deslauriers,L,PHI,33,53,4,1,5
19,8482144,Jack Thompson,D,SJS,22,34,4,1,5
19,8479367,William Lockwood,R,FLA,26,25,4,1,5
19,8477467,Gustav Olofsson,D,SEA,30,23,4,1,5
19,8479986,Kole Lind,R,DAL,26,55,3,2,5
19,8478146,Matthew Highmore,C,OTT,28,28,3,2,5
19,8479638,Justin Brazeau,R,BOS,26,46,3,2,5
19,8483012,Logan Morrison,C,SEA,22,37,3,2,5
19,8484911,Collin Graf,R,SJS,22,43,3,2,5
19,8480990,Declan Chisholm,D,MIN,24,38,3,2,5
19,8483397,Marc McLaughlin,C,BOS,25,32,3,2,5
19,8481056,Spencer Stastney,D,NSH,24,32,2,3,5
19,8482496,Nils Aman,C,VAN,24,33,2,3,5
19,8483460,David Jiricek,D,CBJ,21,51,2,3,5
19,8479320,Maxime Lajoie,D,SEA,27,17,2,3,5
19,8480245,Olle Lycksell,R,PHI,25,36,2,3,5
19,8482094,Daemon Hunt,D,MIN,22,19,2,3,5
19,8483512,Matthew Savoie,C,EDM,20,28,2,3,5
19,8477365,Connor Clifton,D,BUF,29,59,1,4,5
19,8480860,Kevin Bahl,D,CGY,24,52,1,4,5
19,8475718,Justin Holl,D,DET,32,60,1,4,5
19,8480880,Jakub Lauko,C,MIN,24,41,1,4,5
19,8477034,Jaycob Megna,D,FLA,32,44,1,4,5
19,8481726,Adam Edstrom,C,NYR,24,12,1,4,5
19,8476473,Connor Murphy,D,CHI,31,37,0,5,5
19,8477384,Joshua Brown,D,EDM,30,42,0,5,5
19,8481743,Marc Del Gaizo,D,NSH,25,17,0,5,5
19,8482141,Lukas Cormier,D,VGK,22,27,3,1,4
19,8481024,Linus Karlsson,C,VAN,25,17,3,1,4
19,8480834,Ty Emberson,D,SJS,24,34,2,2,4
19,8480823,Alexander Alexeyev,D,WSH,25,16,2,2,4
19,8481065,Angus Crookshank,L,OTT,25,16,2,2,4
19,8481422,Jake Lucchini,C,NSH,29,18,2,2,4
19,8477335,Kyle Burroughs,D,LAK,29,35,1,3,4
19,8477244,Chad Ruhwedel,D,NYR,34,36,1,3,4
19,8477473,Justin Bailey,R,SJS,29,24,1,3,4
19,8477527,Ross Johnston,L,ANA,30,32,1,3,4
19,8482861,Vincent Iorio,D,WSH,22,29,0,4,4
19,8477962,Brendan Lemieux,L,CAR,28,30,0,4,4
19,8474612,Travis Hamonic,D,OTT,34,40,0,4,4
19,8477971,Andreas Englund,D,LAK,28,35,0,4,4
19,8477149,Scott Sabourin,R,SJS,32,16,0,4,4
19,8480844,Grigori Denisenko,L,VGK,24,32,2,1,3
19,8481006,Tyler Tucker,D,STL,24,19,2,1,3
19,8482172,Landon Slaggert,L,CHI,22,25,2,1,3
19,8480468,James Hamblin,L,EDM,25,20,2,1,3
19,8482147,Jean-Luc Foudy,C,COL,22,20,2,1,3
19,8481609,Vladislav Kolyachonok,D,UTA,23,22,1,2,3
19,8483630,Pavol Regenda,L,ANA,25,25,1,2,3
19,8479379,Givani Smith,R,SJS,26,30,1,2,3
19,8483597,Milos Kelemen,L,UTA,25,20,1,2,3
19,8482088,Justin Sourdif,R,FLA,22,20,1,2,3
19,8481030,Jack St. Ivany,D,PIT,25,17,1,2,3
19,8483567,Georgii Merkulov,C,BOS,24,9,1,2,3
19,8483395,Arshdeep Bains,L,VAN,23,13,1,2,3
19,8481541,Samuel Bolduc,D,NYI,24,23,0,3,3
19,8479587,Rhett Gardner,C,PHI,28,20,0,3,3
19,8480890,Jan Jenik,C,OTT,24,30,0,3,3
19,8477073,Kurtis MacDermid,L,NJD,30,33,0,3,3
19,8478011,Louie Belpedio,D,PHI,28,17,0,3,3
19,8479419,Brett Murray,L,BUF,26,21,0,3,3
19,8482476,Emil Heineman,L,MTL,23,7,0,3,3
19,8482102,Vasily Ponomarev,C,PIT,22,26,2,0,2
19,8481043,Cole Koepke,L,BOS,26,13,2,0,2
19,8482061,Brandon Biro,L,SEA,26,12,2,0,2
19,8475177,Calvin de Haan,D,COL,33,40,1,1,2
19,8481699,Aku Raty,R,UTA,23,14,1,1,2
19,8481593,Jayden Struble,D,MTL,23,16,1,1,2
19,8482858,Ryker Evans,D,SEA,23,23,1,1,2
19,8484325,Waltteri Merela,C,TBL,26,19,1,1,2
19,8481806,Louis Crevier,D,CHI,23,11,1,1,2
19,8482177,Marat Khusnutdinov,C,MIN,22,29,1,1,2
19,8481564,Ryan Johnson,D,BUF,23,11,1,1,2
19,8480032,Shane Bowers,C,NJD,25,10,1,1,2
19,8480075,Cameron Crotty,D,MIN,25,7,1,1,2
19,8482201,Gage Goncalves,C,TBL,23,24,1,1,2
19,8482145,Mavrik Bourque,C,DAL,22,43,0,2,2
19,8482470,Ilya Solovyov,D,CGY,24,25,0,2,2
19,8477320,Anton Blidh,L,NYR,29,16,0,2,2
19,8478477,Mitchell Stephens,C,SEA,27,18,0,2,2
19,8482165,Yan Kuznetsov,D,CGY,22,13,0,2,2
19,8475795,Dylan McIlrath,D,WSH,32,19,0,2,2
19,8477810,Joel Hanley,D,CGY,33,28,0,2,2
19,8484304,Uvis Balinskis,D,FLA,28,13,0,2,2
19,8479330,Brandon Gignac,C,MTL,27,9,0,2,2
19,8478854,Ryan Shea,D,PIT,27,10,0,2,2
19,8479362,Riley Tufte,L,BOS,26,16,1,0,1
19,8483489,Fraser Minten,C,TOR,31,9,1,0,1
19,8478446,Glenn Gawdin,C,LAK,27,5,1,0,1
19,8481462,Mason Morelli,L,VGK,28,13,1,0,1
19,8478051,Max Willman,C,NJD,29,18,1,0,1
19,8481585,Egor Afanasyev,L,SJS,23,10,1,0,1
19,8482787,Nikita Chibrikov,R,WPG,31,4,1,0,1
19,8483609,Adam Klapka,R,CGY,24,3,1,0,1
19,8481719,Maxwell Crozier,D,TBL,24,13,1,0,1
19,8478881,Brett Seney,L,CHI,28,11,1,0,1
19,8477993,Justin Kirkland,C,CGY,28,5,1,0,1
19,8480306,Grant Hutton,D,NYI,29,7,1,0,1
19,8478017,Mark Friedman,D,VAN,29,42,0,1,1
19,8477462,Robert Hagg,D,VGK,29,22,0,1,1
19,8480267,Sammy Walker,C,MIN,25,21,0,1,1
19,8482460,Matt Rempe,C,NYR,22,11,0,1,1
19,8482516,Matthew Kessel,D,STL,24,18,0,1,1
19,8482118,Sam Colangelo,R,ANA,23,18,0,1,1
19,8483471,Brad Lambert,C,WPG,31,12,0,1,1
19,8481578,Graeme Clarke,R,MIN,23,11,0,1,1
19,8475780,Chris Wagner,R,COL,33,10,0,1,1
19,8484326,Patrik Koch,D,UTA,28,2,0,1,1
19,8480851,Akil Thomas,C,LAK,24,9,0,0,0
19,8482929,Emil Lilleberg,D,TBL,23,28,0,0,0
19,8482162,Roby Jarventie,L,EDM,22,13,0,0,0
19,8478502,Dennis Gilbert,D,BUF,28,18,0,0,0
19,8481206,John Ludvig,D,PIT,24,11,0,0,0
19,8480084,Nick DeSimone,D,NJD,30,11,0,0,0
19,8484259,Ondrej Pavel,C,COL,31,0,0,0,0
19,8477541,Dakota Mermis,D,TOR,30,8,0,0,0
19,8483398,Declan Carlile,D,TBL,31,7,0,0,0
19,8480274,Philip Kemp,D,EDM,25,0,0,0,0
19,8474062,Riley Nash,C,NYR,35,15,0,0,0
19,8483407,Brandon Scanlin,D,NYR,25,6,0,0,0
19,8483546,Marshall Rifai,D,TOR,26,6,0,0,0
19,8483531,Brian Halonen,L,NJD,25,3,0,0,0
19,8484255,Jason Polin,R,COL,25,2,0,0,0
19,8483401,Marc Johnstone,R,PIT,28,0,0,0,0
19,8475413,Justin Dowling,C,NJD,34,10,0,0,0
19,8479522,Hardy Haman Aktell,D,WSH,26,1,0,0,0
19,8476323,Max McCormick,L,SEA,32,3,0,0,0
19,8483920,Pierrick Dube,R,WSH,23,5,0,0,0
19,8482197,Adam Raska,R,MIN,23,5,0,0,0
19,8483432,Luca Del Bel Belluz,C,CBJ,31,5,0,0,0
19,8475755,Alexander Petrovic,D,DAL,32,6,0,0,0
19,8480874,Adam Ginning,D,PHI,24,11,0,0,0
19,8484321,Nikolas Matinpalo,D,OTT,26,3,0,0,0
19,8479421,Jacob Moverare,D,LAK,26,3,0,0,0
19,8481655,Cole Schwindt,R,CGY,23,6,0,0,0
19,8478147,Bokondji Imama,L,PIT,28,4,0,0,0
19,8481534,Raphael Lavoie,C,EDM,24,3,0,0,0
19,8482126,Emil Andrae,D,PHI,31,4,0,0,0
19,8470794,Joe Pavelski,C,,40,0,0,0,0
19,8479321,Lucas Johansen,D,,27,0,0,0,0
19,8477950,Tony DeAngelo,D,,29,0,0,0,0
19,8471218,Blake Wheeler,R,,38,0,0,0,0
19,8475197,Tyson Barrie,D,,33,0,0,0,0
19,8474157,Max Pacioretty,L,,36,0,0,0,0
19,8475744,Evgeny Kuznetsov,C,,32,0,0,0,0
19,8474037,James van Riemsdyk,L,,35,0,0,0,0
19,8476907,Mackenzie MacEachern,L,,30,0,0,0,0
19,8480216,Jacob Peterson,C,,25,0,0,0,0
19,8474602,Justin Schultz,D,,34,0,0,0,0
19,8482222,Alexander Barabanov,L,,30,0,0,0,0
19,8474031,Kevin Shattenkirk,D,,35,0,0,0,0
19,8477330,Dominik Kubalik,L,,29,0,0,0,0
19,8480884,Calen Addison,D,,24,0,0,0,0
19,8475906,John Klingberg,D,,32,0,0,0,0
19,8480008,Adam Ruzicka,C,,25,0,0,0,0
19,8476884,Derrick Pouliot,D,,30,0,0,0,0
19,8476919,Chris Tierney,C,,30,0,0,0,0
19,8479415,Michael McLeod,C,,26,0,0,0,0
19,8474870,Tyler Johnson,C,,34,0,0,0,0
19,8470604,Jeff Carter,C,,39,0,0,0,0
19,8478104,Sammy Blais,L,,28,0,0,0,0
19,8474884,Mike Hoffman,C,,35,0,0,0,0
19,8481591,Sam Poulin,R,,23,0,0,0,0
19,8471274,Alex Goligoski,D,,39,0,0,0,0
19,8476871,Tanner Pearson,L,,32,0,0,0,0
19,8476393,Nick Cousins,C,,31,0,0,0,0
19,8479977,Kailer Yamamoto,R,,26,0,0,0,0
19,8479346,Dillon Dube,C,,26,0,0,0,0
19,8480184,Gustav Lindstrom,D,,26,0,0,0,0
19,8479376,Victor Mete,D,,26,0,0,0,0
19,8473449,Kyle Okposo,R,,36,0,0,0,0
19,8481058,Jesse Ylonen,R,,25,0,0,0,0
19,8475752,Tyler Pitlick,C,,33,0,0,0,0
19,8481239,Samuel Fagemo,L,,24,0,0,0,0
19,8480821,Filip Zadina,R,,25,0,0,0,0
19,8470966,Mark Giordano,D,,41,0,0,0,0
19,8478495,Denis Gurianov,R,,27,0,0,0,0
19,8477464,Nic Petan,C,,29,0,0,0,0
19,8478099,Kevin Labanc,R,,29,0,0,0,0
19,8482241,Radim Zohorna,L,,28,0,0,0,0
19,8474040,Sam Gagner,C,,35,0,0,0,0
19,8479514,Rem Pitlick,C,,27,0,0,0,0
19,8478430,Oliver Kylington,D,,27,0,0,0,0
19,8479533,Joona Koppanen,L,,26,0,0,0,0
19,8479984,Cal Foote,D,,26,0,0,0,0
19,8477126,Jayson Megna,C,,34,0,0,0,0
19,8475164,Jakob Silfverberg,R,,34,0,0,0,0
19,8474009,Nick Bonino,C,,36,0,0,0,0
19,8479458,Nikita Zaitsev,D,,33,0,0,0,0
19,8477944,Jakub Vrana,L,,28,0,0,0,0
19,8471699,Andrew Cogliano,C,,37,0,0,0,0
19,8478067,Oskar Lindblom,L,,28,0,0,0,0
19,8471686,Marc Staal,D,,37,0,0,0,0
19,8470610,Zach Parise,L,,40,0,0,0,0
19,8478904,Steven Lorentz,C,,28,0,0,0,0
19,8473473,Milan Lucic,L,,36,0,0,0,0
19,8480031,Maxime Comtois,L,,25,0,0,0,0
19,8478512,Austin Czarnik,C,,32,0,0,0,0
19,8473504,Cal Clutterbuck,R,,37,0,0,0,0
19,8477454,Adam Erne,L,,29,0,0,0,0
19,8479383,Boris Katchouk,L,,26,0,0,0,0
19,8475825,Jani Hakanpää,D,,32,0,0,0,0
19,8477846,Ryan Carpenter,C,,33,0,0,0,0
19,8477930,Pierre-Edouard Bellemare,L,,39,0,0,0,0
19,8478400,Colin White,C,,27,0,0,0,0
19,8480226,Marián Studenic,R,,26,0,0,0,0
19,8480853,Liam Foudy,C,,24,0,0,0,0
19,8475797,Jarred Tinordi,D,,32,0,0,0,0
19,8479423,Alex Nylander,L,,26,0,0,0,0
19,8474618,Marco Scandella,D,,34,0,0,0,0
19,8478028,Fredrik Olofsson,L,,28,0,0,0,0
19,8474709,Matt Martin,L,,35,0,0,0,0
19,8481070,Hugh McGing,L,,26,0,0,0,0
19,8479546,Oskar Steen,C,,26,0,0,0,0
19,8474145,Robert Bortuzzo,D,,35,0,0,0,0
19,8476915,Jujhar Khaira,L,,30,0,0,0,0
19,8475278,Byron Froese,C,,33,0,0,0,0
19,8481812,Nikolai Knyzhov,D,,27,0,0,0,0
19,8478408,Travis Dermott,D,,28,0,0,0,0
19,8481077,John Leonard,L,,26,0,0,0,0
19,8479547,Matthew Phillips,R,,26,0,0,0,0
19,8480836,Jonathan Gruden,C,,24,0,0,0,0
19,8481690,Tyler Angle,C,,24,0,0,0,0
19,8475766,Austin Watson,L,,32,0,0,0,0
19,8481016,Ruslan Iskhakov,C,,24,0,0,0,0
19,8478078,Rourke Chartier,C,,28,0,0,0,0
19,8480776,Sheldon Rempal,R,,29,0,0,0,0
19,8478956,Samuel Laberge,L,NJD,27,2,0,0,0
19,8483045,Cameron Butler,R,CBJ,31,2,0,0,0
19,8484314,Jiri Smejkal,L,,28,0,0,0,0
20,8478402,Connor McDavid,C,EDM,27,78,42,114,156
20,8476453,Nikita Kucherov,R,TBL,31,82,40,104,144
20,8477492,Nathan MacKinnon,C,COL,29,82,55,85,140
20,8479318,Auston Matthews,C,TOR,27,79,68,59,127
20,8478550,Artemi Panarin,L,NYR,33,78,41,81,122
20,8478420,Mikko Rantanen,R,COL,28,82,51,69,120
20,8477404,Jake Guentzel,C,TBL,30,82,56,61,117
20,8477956,David Pastrnak,R,BOS,28,81,53,60,113
20,8477934,Leon Draisaitl,C,EDM,29,77,48,64,112
20,8479314,Matthew Tkachuk,L,FLA,27,79,30,78,108
20,8482116,Tim Stützle,C,OTT,22,81,29,75,104
20,8480069,Cale Makar,D,COL,26,73,25,74,99
20,8477939,William Nylander,R,TOR,28,80,39,58,97
20,8478483,Mitch Marner,R,TOR,27,81,27,70,97
20,8480027,Jason Robertson,L,DAL,25,82,35,61,96
20,8477946,Dylan Larkin,C,DET,28,79,43,52,95
20,8480012,Elias Pettersson,C,VAN,26,76,32,63,95
20,8480023,Robert Thomas,C,STL,25,76,30,65,95
20,8478439,Travis Konecny,R,PHI,27,74,35,58,93
20,8480801,Brady Tkachuk,L,OTT,25,79,37,55,92
20,8477942,Kevin Fiala,L,LAK,28,81,35,57,92
20,8480865,Noah Dobson,D,NYI,24,80,17,75,92
20,8479343,Clayton Keller,R,UTA,26,79,32,58,90
20,8478427,Sebastian Aho,C,CAR,27,72,46,43,89
20,8477933,Sam Reinhart,C,FLA,29,79,41,48,89
20,8481559,Jack Hughes,C,NJD,23,73,34,55,89
20,8475184,Chris Kreider,L,NYR,33,76,47,41,88
20,8476468,J.T. Miller,C,VAN,31,79,31,57,88
20,8476459,Mika Zibanejad,C,NYR,31,81,31,56,87
20,8477500,Bo Horvat,C,NYI,29,82,44,42,86
20,8473419,Brad Marchand,L,BOS,36,81,34,52,86
20,8476389,Vincent Trocheck,C,NYR,31,80,33,52,85
20,8484144,Connor Bedard,C,CHI,19,74,33,52,85
20,8478873,Troy Terry,R,ANA,27,74,37,47,84
20,8478010,Brayden Point,C,TBL,28,82,40,43,83
20,8478398,Kyle Connor,L,WPG,28,76,38,45,83
20,8477493,Aleksander Barkov,C,FLA,29,78,28,55,83
20,8480800,Quinn Hughes,D,VAN,25,75,11,72,83
20,8481557,Matt Boldy,L,MIN,23,74,36,46,82
20,8477960,Adrian Kempe,R,LAK,28,82,35,47,82
20,8471675,Sidney Crosby,C,PIT,37,70,28,54,82
20,8478445,Mathew Barzal,C,NYI,27,82,15,67,82
20,8475786,Zach Hyman,L,EDM,32,78,42,39,81
20,8478449,Roope Hintz,C,DAL,28,79,39,42,81
20,8475810,Bryan Rust,R,PIT,32,74,35,46,81
20,8482078,Lucas Raymond,L,DET,22,79,28,53,81
20,8476887,Filip Forsberg,L,NSH,30,75,43,37,80
20,8477402,Pavel Buchnevich,L,STL,29,78,34,46,80
20,8476460,Mark Scheifele,C,WPG,31,72,32,48,80
20,8476346,Johnny Gaudreau,L,CBJ,31,75,24,56,80
20,8480036,Miro Heiskanen,D,DAL,25,77,12,68,80
20,8482699,Dylan Guenther,R,UTA,21,75,39,40,79
20,8478864,Kirill Kaprizov,L,MIN,27,69,33,46,79
20,8476479,Phillip Danault,C,LAK,31,79,29,50,79
20,8475170,Brayden Schenn,C,STL,33,75,26,53,79
20,8478403,Jack Eichel,C,VGK,28,78,33,45,78
20,8479407,Jesper Bratt,L,NJD,26,77,34,43,77
20,8480830,Andrei Svechnikov,R,CAR,24,72,32,45,77
20,8478414,Timo Meier,R,NJD,28,77,39,37,76
20,8479323,Adam Fox,D,NYR,26,74,22,54,76
20,8475692,Mats Zuccarello,R,MIN,37,74,21,55,76
20,8476454,Ryan Nugent-Hopkins,C,EDM,31,76,25,48,73
20,8480002,Nico Hischier,C,NJD,25,78,21,52,73
20,8474564,Steven Stamkos,C,NSH,34,73,27,45,72
20,8477501,Valeri Nichushkin,R,COL,29,80,45,26,71
20,8479337,Alex DeBrincat,R,DET,27,81,34,37,71
20,8471685,Anze Kopitar,C,LAK,37,81,32,39,71
20,8479385,Jordan Kyrou,C,STL,26,78,29,42,71
20,8474600,Roman Josi,D,NSH,34,74,23,48,71
20,8479420,Tage Thompson,C,BUF,27,73,37,33,70
20,8477951,Nick Schmaltz,C,UTA,28,79,25,45,70
20,8481540,Cole Caufield,R,MTL,23,72,37,32,69
20,8478444,Brock Boeser,R,VAN,27,74,29,40,69
20,8476456,Jonathan Huberdeau,C,CGY,31,79,15,54,69
20,8479542,Brandon Hagel,L,TBL,26,82,31,37,68
20,8477940,Nikolaj Ehlers,L,WPG,28,76,30,38,68
20,8475913,Mark Stone,R,VGK,32,79,27,41,68
20,8483515,Juraj Slafkovsky,L,MTL,20,76,25,43,68
20,8473994,Jamie Benn,L,DAL,35,81,23,45,68
20,8477503,Max Domi,C,TOR,29,74,20,48,68
20,8477949,Alex Tuch,R,BUF,28,72,30,37,67
20,8480208,Drake Batherson,R,OTT,26,80,27,40,67
20,8480015,Owen Tippett,R,PHI,25,76,32,34,66
20,8478460,Zach Werenski,D,CBJ,27,79,25,41,66
20,8475166,John Tavares,C,TOR,34,77,15,51,66
20,8474578,Erik Karlsson,D,PIT,34,79,14,52,66
20,8477955,Jared McCann,L,SEA,28,74,32,33,65
20,8480839,Rasmus Dahlin,D,BUF,24,69,15,50,65
20,8471724,Kris Letang,D,PIT,37,80,11,54,65
20,8475754,Brock Nelson,C,NYI,33,77,29,35,64
20,8476881,Tomas Hertl,C,VGK,31,79,25,39,64
20,8475172,Nazem Kadri,C,CGY,34,78,21,43,64
20,8471214,Alex Ovechkin,L,WSH,39,71,32,31,63
20,8477456,J.T. Compher,L,DET,29,82,22,41,63
20,8473512,Claude Giroux,R,OTT,36,81,20,43,63
20,8477504,Josh Morrissey,D,WPG,29,73,14,49,63
20,8477409,Carter Verhaeghe,C,FLA,29,81,33,29,62
20,8475784,Jeff Skinner,C,EDM,32,76,31,31,62
20,8475765,Vladimir Tarasenko,R,DET,33,81,30,32,62
20,8480018,Nick Suzuki,C,MTL,25,73,24,38,62
20,8477496,Elias Lindholm,C,BOS,30,77,26,35,61
20,8478975,Mason Marchment,L,DAL,29,81,24,37,61
20,8474141,Patrick Kane,R,DET,36,79,23,38,61
20,8480798,Philipp Kurashev,C,CHI,25,69,23,38,61
20,8475168,Matt Duchene,C,DAL,33,81,22,38,60
20,8475745,Charlie Coyle,C,BOS,32,75,19,41,60
20,8477494,Jonathan Drouin,L,COL,29,81,17,43,60
20,8474590,John Carlson,D,WSH,34,71,16,44,60
20,8476539,Jonathan Marchessault,R,NSH,34,70,34,25,59
20,8482093,Seth Jarvis,C,CAR,22,66,30,29,59
20,8480797,Joel Farabee,L,PHI,24,75,20,39,59
20,8478038,Devon Toews,D,COL,30,70,11,48,59
20,8475167,Victor Hedman,D,TBL,34,80,10,49,59
20,8480014,Gabriel Vilardi,C,WPG,25,71,35,23,58
20,8476432,Boone Jenner,C,CBJ,31,67,28,30,58
20,8475158,Ryan O'Reilly,C,NSH,33,77,26,32,58
20,8479675,Trevor Moore,L,LAK,29,81,24,34,58
20,8482665,Matty Beniers,C,SEA,22,75,16,42,58
20,8476875,Mike Matheson,D,MTL,30,77,8,50,58
20,8477935,Sam Bennett,C,FLA,28,78,28,29,57
20,8478047,Michael Bunting,L,PIT,29,72,25,32,57
20,8475794,Tyler Seguin,C,DAL,32,81,27,29,56
20,8478519,Anthony Cirelli,C,TBL,27,82,26,30,56
20,8474149,Evgenii Dadonov,R,DAL,35,82,26,30,56
20,8478366,Frank Vatrano,R,ANA,30,75,25,31,56
20,8474586,Jordan Eberle,R,SEA,34,71,23,33,56
20,8477416,Oliver Bjorkstrand,R,SEA,29,70,21,35,56
20,8476905,Chandler Stephenson,C,SEA,30,77,15,41,56
20,8479325,Charlie McAvoy,D,BOS,27,74,10,45,55
20,8478397,Rasmus Andersson,D,CGY,28,70,10,45,55
20,8476399,Blake Coleman,C,CGY,33,79,31,23,54
20,8478498,Jake DeBrusk,L,VAN,28,69,26,28,54
20,8476882,Teuvo Teravainen,C,CHI,30,67,19,35,54
20,8474679,Gustav Nyquist,C,NSH,35,67,17,37,54
20,8479400,Pierre-Luc Dubois,L,WSH,26,69,17,37,54
20,8482720,Matthew Knies,L,TOR,22,77,16,38,54
20,8475798,Mikael Granlund,C,SJS,32,73,13,41,54
20,8476853,Morgan Rielly,D,TOR,30,67,10,44,54
20,8479425,Filip Hronek,D,VAN,27,75,10,44,54
20,8471215,Evgeni Malkin,C,PIT,38,71,25,28,53
20,8475151,Kyle Palmieri,C,NYI,33,78,34,18,52
20,8482740,Wyatt Johnston,C,DAL,21,81,25,27,52
20,8477407,Anthony Duclair,L,NYI,29,80,23,29,52
20,8478493,Joel Eriksson Ek,C,MIN,27,69,22,30,52
20,8484153,Leo Carlsson,C,ANA,20,70,18,34,52
20,8480803,Evan Bouchard,D,EDM,25,74,10,42,52
20,8482684,Luke Hughes,D,NJD,21,72,9,43,52
20,8478407,Vince Dunn,D,SEA,28,74,8,44,52
20,8477476,Artturi Lehkonen,L,COL,29,79,20,31,51
20,8475191,Reilly Smith,R,NYR,33,78,20,31,51
20,8483505,Matthew Poitras,C,BOS,20,77,19,32,51
20,8478440,Dylan Strome,C,WSH,27,72,18,33,51
20,8475287,Erik Haula,L,NJD,33,77,18,33,51
20,8479999,Casey Mittelstadt,C,COL,26,78,13,38,51
20,8477447,Shea Theodore,D,VGK,29,63,12,39,51
20,8476483,Rickard Rakell,R,PIT,31,72,26,24,50
20,8474641,Adam Henrique,C,EDM,34,74,24,26,50
20,8482110,Dawson Mercer,C,NJD,23,75,20,30,50
20,8478042,Viktor Arvidsson,L,EDM,31,77,19,31,50
20,8477479,Tyler Bertuzzi,L,CHI,29,68,18,32,50
20,8479365,Trent Frederic,C,BOS,26,74,18,32,50
20,8481528,Dylan Cozens,C,BUF,23,71,16,34,50
20,8478401,Pavel Zacha,C,BOS,27,78,14,36,50
20,8470613,Brent Burns,D,CAR,39,75,11,39,50
20,8482109,Alexis Lafrenière,L,NYR,23,79,32,17,49
20,8482745,Mason McTavish,C,ANA,21,78,23,26,49
20,8478856,Conor Garland,R,VAN,28,77,22,27,49
20,8478046,Danton Heinen,L,VAN,29,65,21,27,48
20,8481068,Yegor Sharangovich,C,CGY,26,74,17,31,48
20,8480039,Martin Necas,C,CAR,25,75,16,32,48
20,8475799,Nino Niederreiter,R,WPG,32,67,32,15,47
20,8475314,Anders Lee,L,NYI,34,78,25,22,47
20,8479339,Patrik Laine,L,CBJ,26,67,24,23,47
20,8480185,Eetu Luostarinen,C,FLA,26,71,18,29,47
20,8476458,Ryan Strome,C,ANA,31,63,16,31,47
20,8475726,Tyler Toffoli,C,SJS,32,66,30,16,46
20,8475760,Nick Bjugstad,C,UTA,32,71,26,20,46
20,8481533,Trevor Zegras,C,ANA,23,73,21,25,46
20,8476880,Tom Wilson,R,WSH,30,68,20,26,46
20,8481618,Alex Newhook,C,MTL,23,75,27,18,45
20,8478233,Andrew Mangiapane,L,WSH,28,68,24,21,45
20,8471698,T.J. Oshie,R,WSH,38,67,21,24,45
20,8482149,Cole Perfetti,C,WPG,22,70,18,27,45
20,8477986,Brandon Montour,D,SEA,30,71,15,30,45
20,8482705,Cole Sillinger,C,CBJ,21,63,14,31,45
20,8477932,Aaron Ekblad,D,FLA,28,66,13,32,45
20,8478469,Thomas Chabot,D,OTT,27,73,11,34,45
20,8474102,David Perron,L,OTT,36,76,22,22,44
20,8478542,Evan Rodrigues,C,FLA,31,74,21,23,44
20,8482113,Anton Lundell,C,FLA,23,79,20,24,44
20,8481711,Matias Maccelli,L,UTA,24,72,17,27,44
20,8480028,Morgan Frost,C,PHI,25,75,17,27,44
20,8476448,William Karlsson,C,VGK,31,78,15,29,44
20,8476792,Torey Krug,D,STL,33,75,15,29,44
20,8477429,Andrew Copp,C,DET,30,79,15,29,44
20,8478466,Daniel Sprong,R,VAN,27,74,15,29,44
20,8476958,Jaccob Slavin,D,CAR,30,74,9,35,44
20,8476869,Brady Skjei,D,NSH,30,72,9,35,44
20,8475169,Evander Kane,L,EDM,33,74,23,20,43
20,8475753,Justin Faulk,D,STL,32,70,17,26,43
20,8478462,Nicolas Roy,C,VGK,27,74,15,28,43
20,8477444,Andre Burakovsky,L,SEA,29,72,14,29,43
20,8476462,Dougie Hamilton,D,NJD,31,68,12,31,43
20,8481542,Moritz Seider,D,DET,23,74,9,34,43
20,8477495,Seth Jones,D,CHI,30,67,5,38,43
20,8478057,Dakota Joshua,C,VAN,28,63,21,21,42
20,8474053,Logan Couture,C,SJS,35,63,14,28,42
20,8484166,Adam Fantilli,C,CBJ,20,64,21,20,41
20,8479987,Morgan Geekie,C,BOS,26,74,20,21,41
20,8482124,Quinton Byfield,R,LAK,22,80,17,24,41
20,8476925,Colton Sissons,C,NSH,31,67,15,26,41
20,8476906,Shayne Gostisbehere,D,CAR,31,76,14,27,41
20,8478438,Tommy Novak,C,NSH,27,71,12,29,41
20,8477964,Ivan Barbashev,C,VGK,29,77,23,17,40
20,8482702,Logan Stankoven,C,DAL,21,81,19,21,40
20,8477346,MacKenzie Weegar,D,CGY,30,72,16,24,40
20,8483431,Logan Cooley,C,UTA,20,75,15,25,40
20,8478458,John (Jack) Roslovic,C,CAR,27,69,15,25,40
20,8480220,Noah Cates,L,PHI,25,75,14,26,40
20,8474565,Alex Pietrangelo,D,VGK,34,65,10,30,40
20,8477948,Travis Sanheim,D,PHI,28,75,7,33,40
20,8477426,Nicholas Paul,L,TBL,29,81,21,18,39
20,8483808,Andrei Kuzmenko,L,CGY,28,73,19,20,39
20,8473986,Alex Killorn,L,ANA,35,70,18,21,39
20,8482475,Yegor Chinakhov,R,CBJ,23,62,17,22,39
20,8480829,Jesperi Kotkaniemi,C,CAR,24,66,17,22,39
20,8477498,Darnell Nurse,D,EDM,29,77,13,26,39
20,8476419,Jean-Gabriel Pageau,C,NYI,32,73,13,26,39
20,8474150,Mikael Backlund,C,CGY,35,78,12,27,39
20,8481577,Philip Tomasino,C,NSH,23,69,12,27,39
20,8481581,Thomas Harley,D,DAL,23,70,10,29,39
20,8476463,Jonas Brodin,D,MIN,31,77,9,30,39
20,8481546,Cam York,D,PHI,23,68,8,31,39
20,8480064,Josh Norris,C,OTT,25,74,23,15,38
20,8476872,Scott Laughton,C,PHI,30,74,20,18,38
20,8479525,Ross Colton,C,COL,28,82,16,22,38
20,8476292,Ondrej Palat,L,NJD,33,70,16,22,38
20,8477451,Ryan Hartman,R,MIN,30,73,12,26,38
20,8478891,Mason Appleton,C,WPG,28,56,9,29,38
20,8480817,K'Andre Miller,D,NYR,24,72,5,33,38
20,8478474,Lawson Crouse,L,UTA,27,74,21,16,37
20,8475793,Ryan Johansen,C,PHI,32,72,17,20,37
20,8481560,Arthur Kaliyev,R,LAK,23,81,13,24,37
20,8478396,Noah Hanifin,D,VGK,27,61,7,30,37
20,8475764,Cam Fowler,D,ANA,33,71,6,31,37
20,8481596,Shane Pinto,C,OTT,24,78,16,20,36
20,8477497,Sean Monahan,C,CBJ,30,68,13,23,36
20,8477021,Alex Kerfoot,C,UTA,30,74,11,25,36
20,8481524,Bowen Byram,D,BUF,23,68,9,27,36
20,8479410,Mikhail Sergachev,D,UTA,26,62,7,29,36
20,8476854,Hampus Lindholm,D,BOS,30,78,7,29,36
20,8478413,Jordan Greenway,L,BUF,27,71,20,15,35
20,8476826,Yanni Gourde,C,SEA,33,69,16,19,35
20,8477998,Warren Foegele,L,LAK,28,82,16,19,35
20,8478115,Pierre Engvall,L,NYI,28,78,14,21,35
20,8480871,Adam Boqvist,D,FLA,24,69,14,21,35
20,8475768,Jaden Schwartz,C,SEA,32,64,10,25,35
20,8478055,Gustav Forsling,D,FLA,28,75,10,25,35
20,8477969,Marcus Pettersson,D,PIT,28,78,8,27,35
20,8476923,Damon Severson,D,CBJ,30,82,6,29,35
20,8476392,Adam Lowry,C,WPG,31,69,20,14,34
20,8481032,Paul Cotter,C,NJD,25,64,19,15,34
20,8475149,Marcus Johansson,L,MIN,34,70,13,21,34
20,8482117,Lukas Reichel,L,CHI,22,55,11,23,34
20,8480434,Sean Durzi,D,UTA,26,70,8,26,34
20,8481523,Kirby Dach,C,MTL,23,64,6,28,34
20,8474563,Drew Doughty,D,LAK,35,68,3,31,34
20,8481186,Logan O'Connor,R,COL,28,80,19,14,33
20,8480009,Eeli Tolvanen,R,SEA,25,69,18,15,33
20,8481604,Pavel Dorofeyev,L,VGK,24,57,17,16,33
20,8480078,Filip Chytil,C,NYR,25,66,16,17,33
20,8479992,Michael Rasmussen,C,DET,25,79,14,19,33
20,8480748,Kiefer Sherwood,L,VAN,29,64,12,21,33
20,8480188,Fabian Zetterlund,L,SJS,25,65,11,22,33
20,8482055,Drew O'Connor,L,PIT,26,61,19,13,32
20,8482146,Luke Evangelista,R,NSH,22,66,17,15,32
20,8475763,Kevin Hayes,R,PIT,32,72,14,18,32
20,8480789,Oliver Wahlstrom,R,NYI,24,71,13,19,32
20,8475791,Taylor Hall,L,CHI,33,50,12,20,32
20,8479591,Michael Eyssimont,C,TBL,28,82,11,21,32
20,8476892,Colton Parayko,D,STL,31,69,6,26,32
20,8475714,Calle Jarnkrok,C,TOR,33,68,22,9,31
20,8480802,Ryan McLeod,C,BUF,25,67,18,13,31
20,8473533,Jordan Staal,C,CAR,36,57,15,16,31
20,8482159,Tyson Foerster,R,PHI,22,78,13,18,31
20,8482660,Kent Johnson,C,CBJ,22,72,12,19,31
20,8482097,Jack Quinn,R,BUF,23,63,11,20,31
20,8481704,Juuso Parssinen,C,NSH,23,59,10,21,31
20,8482671,Owen Power,D,BUF,22,67,8,23,31
20,8482133,Thomas Bordeleau,C,SJS,22,62,7,24,31
20,8478472,Mathieu Joseph,R,STL,27,71,6,25,31
20,8475181,Nick Leddy,D,STL,33,70,3,28,31
20,8481703,Valtteri Puustinen,R,PIT,25,61,3,28,31
20,8474151,Ryan McDonagh,D,TBL,35,81,3,28,31
20,8478463,Anthony Beauvillier,L,PIT,27,69,19,11,30
20,8476438,Brandon Saad,L,STL,32,72,13,17,30
20,8481656,Aliaksei Protas,C,WSH,23,61,13,17,30
20,8476461,Sean Couturier,C,PHI,32,69,11,19,30
20,8481553,Bobby Brink,R,PHI,23,56,11,19,30
20,8477450,Jason Dickinson,C,CHI,29,56,11,19,30
20,8475848,Brendan Gallagher,R,MTL,32,74,9,21,30
20,8474716,Jared Spurgeon,D,MIN,35,81,8,22,30
20,8482122,Brock Faber,D,MIN,22,80,8,22,30
20,8478133,Jake Evans,C,MTL,28,67,8,22,30
20,8477506,Ryan Pulock,D,NYI,30,80,6,24,30
20,8483490,Pavel Mintyukov,D,ANA,21,74,5,25,30
20,8482142,Jamie Drysdale,D,PHI,22,66,5,25,30
20,8480145,Neal Pionk,D,WPG,29,71,4,26,30
20,8476917,Adam Pelech,D,NYI,30,78,3,27,30
20,8480873,Rasmus Sandin,D,WSH,24,65,3,27,30
20,8477903,Garnet Hathaway,R,PHI,33,61,15,14,29
20,8482105,Jake Sanderson,D,OTT,22,74,12,17,29
20,8479345,Jakob Chychrun,D,WSH,26,64,12,17,29
20,8478043,Sam Lafferty,C,BUF,29,65,12,17,29
20,8477505,Alexander Wennberg,C,SJS,30,63,12,17,29
20,8477947,Sonny Milano,L,WSH,28,61,11,18,29
20,8482101,Danil Gushchin,L,SJS,22,58,8,21,29
20,8478136,Jake Middleton,D,MIN,28,78,6,23,29
20,8481606,Jordan Spence,D,LAK,23,71,5,24,29
20,8476891,Matthew Grzelcyk,D,PIT,30,76,5,24,29
20,8481624,Ilya Mikheyev,R,CHI,30,57,17,11,28
20,8476927,Teddy Blueger,C,VAN,30,70,15,13,28
20,8474189,Lars Eller,C,PIT,35,67,15,13,28
20,8477953,Kasperi Kapanen,R,STL,28,66,14,14,28
20,8478109,Victor Olofsson,L,VGK,29,73,14,14,28
20,8477425,Miles Wood,L,COL,29,79,13,15,28
20,8478020,Michael Amadio,R,OTT,28,73,13,15,28
20,8483468,Jiri Kulich,C,BUF,20,59,13,15,28
20,8480459,Pius Suter,C,VAN,28,65,12,16,28
20,8475171,Oliver Ekman-Larsson,D,TOR,33,68,12,16,28
20,8483524,Shane Wright,C,SEA,20,66,12,16,28
20,8477839,Conor Sheary,L,TBL,32,81,12,16,28
20,8476979,Erik Gustafsson,D,DET,32,76,11,17,28
20,8476480,Vladislav Namestnikov,C,WPG,32,59,6,22,28
20,8482087,Kaiden Guhle,D,MTL,22,58,6,22,28
20,8482712,Oskar Olausson,R,COL,22,78,4,24,28
20,8475179,Dmitry Kulikov,D,FLA,34,65,4,24,28
20,8479976,Juuso Valimaki,D,UTA,26,72,1,27,28
20,8481580,Connor McMichael,C,WSH,23,65,19,8,27
20,8481582,Nicholas Robertson,L,TOR,23,65,16,11,27
20,8477478,William Carrier,L,CAR,30,59,16,11,27
20,8480980,Connor Dewar,C,TOR,25,72,15,12,27
20,8480893,Kirill Marchenko,R,CBJ,24,56,14,13,27
20,8476878,Zemgus Girgensons,C,TBL,30,80,12,15,27
20,8476469,Joel Armia,R,MTL,31,64,10,17,27
20,8477488,Brett Pesce,D,NJD,30,73,9,18,27
20,8479996,Cody Glass,C,NSH,25,65,8,19,27
20,8478507,John Marino,D,UTA,27,59,6,21,27
20,8478911,Matt Roy,D,WSH,29,63,5,22,27
20,8476981,Josh Anderson,R,MTL,30,64,16,10,26
20,8482074,Connor Zary,C,CGY,23,64,16,10,26
20,8480068,Ryan Poehling,C,PHI,25,63,14,12,26
20,8482679,Matt Coronato,R,CGY,22,66,14,12,26
20,8476960,Andreas Athanasiou,C,CHI,30,55,14,12,26
20,8480849,Barrett Hayton,C,UTA,24,64,13,13,26
20,8479520,Brandon Duhaime,R,WSH,27,61,12,14,26
20,8473422,Nick Foligno,L,CHI,37,57,11,15,26
20,8475722,Jason Zucker,L,BUF,32,68,11,15,26
20,8480205,Emil Bemstrom,C,PIT,25,57,11,15,26
20,8476474,Stefan Noesen,R,NJD,31,61,10,16,26
20,8483445,Cutter Gauthier,L,ANA,20,66,10,16,26
20,8474715,Cameron Atkinson,R,TBL,35,80,9,17,26
20,8484145,Zach Benson,L,BUF,19,64,8,18,26
20,8475218,Mattias Ekholm,D,EDM,34,71,5,21,26
20,8484203,Bradly Nadeau,L,CAR,19,62,5,21,26
20,8481014,Alexander Romanov,D,NYI,24,77,5,21,26
20,8478500,Ivan Provorov,D,CBJ,27,77,2,24,26
20,8470621,Corey Perry,R,EDM,39,72,16,9,25
20,8477952,Robby Fabbri,C,ANA,28,63,14,11,25
20,8483457,Lane Hutson,D,MTL,20,65,13,12,25
20,8482667,William Eklund,L,SJS,22,57,12,13,25
20,8479941,Justin Danforth,R,CBJ,31,53,12,13,25
20,8476918,Jimmy Vesey,L,NYR,31,59,11,14,25
20,8481554,Kaapo Kakko,R,NYR,23,69,10,15,25
20,8480113,Alex Iafallo,L,WPG,31,67,10,15,25
20,8480813,Joe Veleno,C,DET,24,77,10,15,25
20,8482749,Joshua Roy,R,MTL,21,66,9,16,25
20,8473563,Nicklas Backstrom,C,WSH,37,47,8,17,25
20,8479026,Philippe Myers,D,TOR,27,63,8,17,25
20,8477380,Jonny Brodzinski,C,NYR,31,57,8,17,25
20,8475790,Erik Gudbranson,D,CBJ,32,77,6,19,25
20,8483565,Nick Blankenburg,D,NSH,26,65,5,20,25
20,8475462,Radko Gudas,D,ANA,34,68,4,21,25
20,8476331,Dylan DeMelo,D,WPG,31,64,3,22,25
20,8477511,Anthony Mantha,R,CGY,30,72,14,10,24
20,8476374,Sean Kuraly,C,CBJ,31,60,14,10,24
20,8481535,Nils Hoglander,L,VAN,24,60,13,11,24
20,8476897,Oskar Sundqvist,C,STL,30,55,13,11,24
20,8479393,Noah Gregor,L,OTT,26,76,12,12,24
20,8480835,Jack Drury,C,CAR,24,56,11,13,24
20,8477987,Ryan Donato,C,CHI,28,57,10,14,24
20,8482175,JJ Peterka,R,BUF,22,60,9,15,24
20,8475200,Dmitry Orlov,D,CAR,33,73,8,16,24
20,8473507,Jeff Petry,D,DET,37,69,4,20,24
20,8481601,Simon Holmstrom,R,NYI,23,63,17,6,23
20,8482737,Zack Bolduc,C,STL,21,60,13,10,23
20,8476278,Colin Blackwell,C,DAL,31,81,12,11,23
20,8479293,Brandon Tanev,L,SEA,33,68,11,12,23
20,8477989,Christian Dvorak,C,MTL,28,65,10,13,23
20,8482079,Marco Rossi,C,MIN,23,51,9,14,23
20,8476312,Josh Manson,D,COL,33,58,7,16,23
20,8481708,Zac Jones,D,NYR,24,61,5,18,23
20,8480246,Nick Perbix,D,TBL,26,71,4,19,23
20,8478882,Vladislav Gavrikov,D,LAK,29,71,3,20,23
20,8480043,Timothy Liljegren,D,TOR,25,61,3,20,23
20,8476885,Jacob Trouba,D,NYR,30,58,2,21,23
20,8482089,Jake Neighbours,L,STL,22,68,16,6,22
20,8483499,Liam Ohgren,L,MIN,20,55,13,9,22
20,8477508,Curtis Lazar,C,NJD,29,66,12,10,22
20,8479661,Tanner Jeannot,L,LAK,27,80,11,11,22
20,8475220,Marcus Foligno,L,MIN,33,59,11,11,22
20,8479414,Nathan Bastian,R,NJD,27,59,11,11,22
20,8482092,Ridly Greig,C,OTT,22,73,10,12,22
20,8482125,Alexander Holtz,R,VGK,22,65,10,12,22
20,8482157,Will Cuylle,L,NYR,22,66,10,12,22
20,8478432,Christian Fischer,R,DET,27,77,8,14,22
20,8476467,Jamie Oleksiak,D,SEA,32,68,7,15,22
20,8482634,Alex Steeves,C,TOR,25,48,6,16,22
20,8482067,Connor Mackey,D,NYR,28,65,5,17,22
20,8478970,Jalen Chatfield,D,CAR,28,73,5,17,22
20,8476921,Jordan Martinook,L,CAR,32,65,4,18,22
20,8482259,Bobby McMann,C,TOR,28,64,15,6,21
20,8479390,Taylor Raddysh,R,WSH,26,53,13,8,21
20,8480144,David Kampf,C,TOR,29,73,10,11,21
20,8475231,Casey Cizikas,C,NYI,33,69,9,12,21
20,8481093,Rafael Harvey-Pinard,L,MTL,25,60,9,12,21
20,8477392,Hudson Fasching,R,NYI,29,66,9,12,21
20,8482803,Olen Zellweger,D,ANA,21,65,9,12,21
20,8478434,Keegan Kolesar,R,VGK,27,73,8,13,21
20,8479543,Michael Pezzetta,L,MTL,26,57,7,14,21
20,8480073,Erik Brannstrom,D,COL,25,68,6,15,21
20,8482111,Justin Barron,D,MTL,23,67,5,16,21
20,8479402,Jake Bean,D,CGY,26,70,4,17,21
20,8478178,Darren Raddysh,D,TBL,28,73,4,17,21
20,8482073,Braden Schneider,D,NYR,23,68,3,18,21
20,8480222,Sebastian Aho,D,PIT,28,74,3,18,21
20,8480891,Michael Kesselring,D,UTA,24,63,2,19,21
20,8475193,Tomas Tatar,L,NJD,34,61,12,8,20
20,8475343,Nic Dowd,C,WSH,34,67,8,12,20
20,8477369,Carson Soucy,D,VAN,30,73,8,12,20
20,8481522,Peyton Krebs,C,BUF,23,69,7,13,20
20,8481641,Joel Kiviranta,L,COL,28,74,7,13,20
20,8479315,Joey Anderson,R,CHI,26,48,7,13,20
20,8476873,Mark Jankowski,C,NSH,30,54,7,13,20
20,8483482,Tristan Luneau,D,ANA,20,56,6,14,20
20,8476422,Mike Reilly,D,NYI,31,70,6,14,20
20,8483491,Ivan Miroshnichenko,L,WSH,20,60,5,15,20
20,8482624,Daniil Miromanov,D,CGY,27,62,4,16,20
20,8479982,Conor Timmins,D,TOR,26,52,4,16,20
20,8480807,Mattias Samuelsson,D,BUF,24,62,4,16,20
20,8479639,Dylan Coghlan,D,WPG,26,70,2,18,20
20,8475690,Chris Tanev,D,TOR,35,61,2,18,20
20,8478569,Noel Acciari,C,PIT,33,57,13,6,19
20,8480448,Parker Kelly,L,COL,25,75,10,9,19
20,8479353,Brett Howden,C,VGK,26,69,7,12,19
20,8481521,Ronnie Attard,D,PHI,25,53,7,12,19
20,8476457,Adam Larsson,D,SEA,32,61,7,12,19
20,8474574,Tyler Myers,D,VAN,34,68,5,14,19
20,8476525,Colin Miller,D,WPG,32,66,3,16,19
20,8477220,Nate Schmidt,D,FLA,33,66,3,16,19
20,8482655,Janis Moser,D,TBL,24,77,1,18,19
20,8478840,Will Borgen,D,SEA,28,63,1,18,19
20,8479324,Ryan Lindgren,D,NYR,26,65,1,18,19
20,8479336,Carl Grundstrom,R,SJS,27,49,14,4,18
20,8477353,Tyler Motte,C,DET,29,67,11,7,18
20,8477446,Michael McCarron,R,NSH,29,57,11,7,18
20,8483493,Frank Nazar,C,CHI,20,55,8,10,18
20,8480855,Jack McBain,C,UTA,24,67,8,10,18
20,8482148,Hendrix Lapierre,C,WSH,22,58,8,10,18
20,8479369,Andrew Peeke,D,BOS,26,64,5,13,18
20,8476879,Cody Ceci,D,EDM,31,66,5,13,18
20,8480762,Eric Robinson,L,CAR,29,62,5,13,18
20,8476902,Esa Lindell,D,DAL,30,70,4,14,18
20,8484149,Gavin Brindley,C,CBJ,20,54,4,14,18
20,8481059,Scott Perunovich,D,STL,26,64,3,15,18
20,8477845,Trevor van Riemsdyk,D,WSH,33,52,3,15,18
20,8476429,Scott Mayfield,D,NYI,32,75,3,15,18
20,8480172,Jan Rutta,D,SJS,34,64,3,15,18
20,8482451,Mikael Pyyhtia,L,CBJ,23,48,2,16,18
20,8480860,Kevin Bahl,D,CGY,24,59,2,16,18
20,8478421,A.J. Greer,L,FLA,28,58,12,5,17
20,8481481,Blake Lizotte,C,PIT,27,59,10,7,17
20,8479316,Luke Kunin,C,SJS,27,57,9,8,17
20,8481013,Jonatan Berggren,R,DET,24,58,9,8,17
20,8483495,Simon Nemec,D,NJD,20,67,8,9,17
20,8475855,Jesper Fast,R,CAR,33,59,8,9,17
20,8477015,Connor Brown,R,EDM,30,62,7,10,17
20,8475225,Craig Smith,C,CHI,35,47,7,10,17
20,8479328,Julien Gauthier,R,NYI,27,61,6,11,17
20,8477573,Nathan Walker,L,STL,30,52,6,11,17
20,8475455,Brenden Dillon,D,NJD,34,56,6,11,17
20,8478851,Alexandre Carrier,D,NSH,28,70,5,12,17
20,8479351,Sam Steel,C,DAL,26,79,3,14,17
20,8476931,Jake McCabe,D,TOR,31,68,3,14,17
20,8480035,Henri Jokiharju,D,BUF,25,64,3,14,17
20,8480001,Urho Vaakanainen,D,ANA,25,60,3,14,17
20,8479398,Samuel Girard,D,COL,26,65,2,15,17
20,8480049,Dylan Samberg,D,WPG,25,63,1,16,17
20,8477435,Ryan Graves,D,PIT,29,76,1,16,17
20,8481617,Vasily Podkolzin,R,VAN,23,51,11,5,16
20,8478211,Dryden Hunt,L,CGY,29,50,10,6,16
20,8482077,Dylan Holloway,L,EDM,23,56,10,6,16
20,8481028,Martin Pospisil,C,CGY,25,57,10,6,16
20,8482062,Cole Smith,L,NSH,29,47,10,6,16
20,8476329,Travis Boyd,C,MIN,31,56,9,7,16
20,8479619,Michael Carcone,L,UTA,28,58,8,8,16
20,8473453,Trevor Lewis,C,LAK,37,73,7,9,16
20,8481716,Dmitri Voronkov,L,CBJ,24,45,7,9,16
20,8480806,Isac Lundestrom,C,ANA,25,58,7,9,16
20,8479291,Kevin Rooney,C,CGY,31,58,7,9,16
20,8482809,Jackson Blake,R,CAR,21,56,6,10,16
20,8478451,Ethan Bear,D,WSH,27,58,6,10,16
20,8480848,Ty Dellandrea,C,SJS,24,46,6,10,16
20,8482666,Scott Morrow,D,CAR,22,59,6,10,16
20,8481527,Kaedan Korczak,D,VGK,23,56,5,11,16
20,8481477,Nico Sturm,C,SJS,29,54,4,12,16
20,8477851,Jordan Oesterle,D,BOS,32,46,4,12,16
20,8474673,TJ Brodie,D,CHI,34,64,4,12,16
20,8477365,Connor Clifton,D,BUF,29,61,4,12,16
20,8481599,Victor Soderstrom,D,UTA,23,49,3,13,16
20,8475208,Brian Dumoulin,D,ANA,33,68,2,14,16
20,8475233,David Savard,D,MTL,34,64,1,15,16
20,8478399,Jonas Siegenthaler,D,NJD,27,61,1,15,16
20,8480355,Mark Kastelic,C,BOS,25,68,11,4,15
20,8479066,Ryan Lomberg,L,CGY,30,63,10,5,15
20,8477919,Frederick Gaudreau,C,MIN,31,61,8,7,15
20,8480003,Jesper Boqvist,C,FLA,26,68,8,7,15
20,8476442,Matt Nieto,L,PIT,32,48,8,7,15
20,8482762,Simon Edvinsson,D,DET,21,61,8,7,15
20,8477482,Zachary Sanford,L,CHI,30,38,8,7,15
20,8483549,Lucas Condotta,L,MTL,27,41,8,7,15
20,8476889,Radek Faksa,C,STL,30,56,7,8,15
20,8474034,Patrick Maroon,L,CHI,36,49,7,8,15
20,8478508,Yakov Trenin,C,MIN,27,59,6,9,15
20,8478013,Jake Walman,D,SJS,28,62,6,9,15
20,8479983,Mario Ferraro,D,SJS,26,73,5,10,15
20,8477931,Tomas Nosek,L,FLA,32,63,5,10,15
20,8483466,Kevin Korchinski,D,CHI,20,46,5,10,15
20,8476994,Vinnie Hinostroza,C,NSH,30,49,5,10,15
20,8479998,Mikey Anderson,D,LAK,25,63,4,11,15
20,8478416,Erik Cernak,D,TBL,27,80,4,11,15
20,8475324,Nick Jensen,D,OTT,34,66,4,11,15
20,8475762,Derek Forbort,D,VAN,32,38,3,12,15
20,8480336,Sean Walker,D,CAR,30,62,2,13,15
20,8474166,Alec Martinez,D,CHI,37,52,2,13,15
20,8477499,Rasmus Ristolainen,D,PHI,30,57,2,13,15
20,8480796,Martin Fehervary,D,WSH,25,54,2,13,15
20,8482747,Brennan Othmann,L,NYR,21,36,2,13,15
20,8480845,Rasmus Kupari,C,WPG,24,44,2,13,15
20,8479371,Dante Fabbro,D,NSH,26,64,1,14,15
20,8475279,Ben Chiarot,D,DET,33,67,1,14,15
20,8476874,Olli Maatta,D,DET,30,54,1,14,15
20,8482730,Brandt Clarke,D,LAK,21,50,0,15,15
20,8482659,Josh Doan,R,UTA,22,56,8,6,14
20,8483397,Marc McLaughlin,C,BOS,25,33,8,6,14
20,8480995,Pontus Holmberg,R,TOR,25,56,7,7,14
20,8479439,Jacob MacDonald,D,COL,31,52,6,8,14
20,8479994,Jaret Anderson-Dolan,C,WPG,25,38,6,8,14
20,8476856,Mathew Dumba,D,DAL,30,75,5,9,14
20,8478831,Kevin Stenlund,C,UTA,28,56,5,9,14
20,8471709,Marc-Edouard Vlasic,D,SJS,37,55,4,10,14
20,8477406,Mattias Janmark,C,EDM,32,65,3,11,14
20,8480058,Pierre-Olivier Joseph,D,STL,25,49,2,12,14
20,8482245,Artem Zub,D,OTT,29,65,1,13,14
20,8480192,Johnathan Kovacevic,D,NJD,27,46,1,13,14
20,8481568,Alex Vlasic,D,CHI,23,61,1,13,14
20,8481178,Egor Zamula,D,PHI,24,54,0,14,14
20,8480281,Alexey Toropchenko,R,STL,25,60,10,3,13
20,8480021,Jack Studnicka,C,LAK,25,51,9,4,13
20,8482155,Alex Laferriere,R,LAK,23,63,9,4,13
20,8476624,Barclay Goodrow,C,SJS,31,55,8,5,13
20,8475842,Sam Carrick,C,NYR,32,57,8,5,13
20,8475177,Calvin de Haan,D,COL,33,48,6,7,13
20,8477507,Nikita Zadorov,D,BOS,29,66,5,8,13
20,8481441,Joe Snively,C,DET,28,66,4,9,13
20,8479344,Jesse Puljujarvi,R,PIT,26,49,4,9,13
20,8481537,Nikita Okhotiuk,D,CGY,24,54,3,10,13
20,8480887,Jordan Harris,D,MTL,24,60,3,10,13
20,8476952,Dominic Toninato,C,WPG,30,41,3,10,13
20,8479980,Nicolas Hague,D,VGK,26,49,2,11,13
20,8480878,Nils Lundkvist,D,DAL,24,77,1,12,13
20,8470600,Ryan Suter,D,STL,39,61,1,12,13
20,8480289,Morgan Barron,C,WPG,26,47,9,3,12
20,8480252,Cole Guttman,C,CHI,25,41,8,4,12
20,8482807,Ethan Del Mastro,D,CHI,21,46,7,5,12
20,8477979,Nicolas Aube-Kubel,R,BUF,28,53,4,8,12
20,8476988,Matt Benning,D,SJS,30,59,4,8,12
20,8481550,Adam Beckman,L,NJD,23,37,4,8,12
20,8482166,Shakir Mukhamadullin,D,SJS,22,60,4,8,12
20,8480157,Calle Rosen,D,COL,30,40,4,8,12
20,8474567,Zach Bogosian,D,MIN,34,63,4,8,12
20,8476967,Brett Kulak,D,EDM,30,61,2,10,12
20,8481600,Tobias Bjornfot,D,FLA,23,45,2,10,12
20,8478450,Parker Wotherspoon,D,BOS,27,30,2,10,12
20,8484254,Akito Hirose,D,VAN,25,35,1,11,12
20,8481056,Spencer Stastney,D,NSH,24,33,0,12,12
20,8479944,Zach Aston-Reese,C,VGK,30,45,7,4,11
20,8482859,Zack Ostapchuk,C,OTT,21,51,6,5,11
20,8476934,Brock McGinn,L,ANA,30,60,6,5,11
20,8481517,Brett Leason,R,ANA,25,55,5,6,11
20,8471817,Ryan Reaves,R,TOR,37,53,5,6,11
20,8478452,Caleb Jones,D,LAK,27,60,4,7,11
20,8481567,Henry Thrun,D,SJS,23,54,4,7,11
20,8482192,Isaak Phillips,D,CHI,23,53,3,8,11
20,8478443,Brandon Carlo,D,BOS,28,53,3,8,11
20,8479378,Logan Stanley,D,WPG,26,43,3,8,11
20,8477070,Liam O'Brien,C,UTA,30,59,3,8,11
20,8479972,Mason Shaw,C,WPG,26,31,3,8,11
20,8479372,Joshua Mahura,D,SEA,26,58,2,9,11
20,8475718,Justin Holl,D,DET,32,62,2,9,11
20,8479249,Andrew Poturalski,C,SJS,30,37,1,10,11
20,8479359,Beck Malenstyn,L,BUF,26,48,7,3,10
20,8480074,Alexandre Texier,C,STL,25,54,6,4,10
20,8477887,Patrick Brown,C,BOS,32,45,6,4,10
20,8481161,Jake Christiansen,D,CBJ,25,59,5,5,10
20,8478859,Niko Mikkola,D,FLA,28,54,5,5,10
20,8481592,Jakob Pelletier,L,CGY,23,38,5,5,10
20,8482652,Walker Duehr,R,CGY,27,38,5,5,10
20,8479368,Max Jones,L,BOS,26,60,4,6,10
20,8478424,Jansen Harkins,C,ANA,27,43,4,6,10
20,8480025,MacKenzie Entwistle,R,FLA,25,62,4,6,10
20,8480007,Jonas Rondbjerg,R,VGK,25,38,4,6,10
20,8478468,Jeremy Lauzon,D,NSH,27,47,3,7,10
20,8481167,Brayden Pachal,D,CGY,25,40,3,7,10
20,8477034,Jaycob Megna,D,FLA,32,46,3,7,10
20,8475188,Brayden McNabb,D,VGK,33,54,2,8,10
20,8481019,David Gustafsson,C,WPG,24,44,2,8,10
20,8482095,Tyler Kleven,D,OTT,22,48,2,8,10
20,8477938,Haydn Fleury,D,WPG,28,42,1,9,10
20,8481789,Tye Kartye,L,SEA,23,37,6,3,9
20,8477320,Anton Blidh,L,NYR,29,17,6,3,9
20,8481751,Lukas Rousek,R,BUF,25,36,5,4,9
20,8482744,James Malatesta,L,CBJ,21,39,5,4,9
20,8481518,Nolan Foote,L,NJD,24,42,5,4,9
20,8476822,Luke Glendening,C,TBL,35,77,4,5,9
20,8479442,Troy Stecher,D,EDM,30,47,4,5,9
20,8474013,Ian Cole,D,UTA,35,56,4,5,9
20,8479986,Kole Lind,R,DAL,26,49,4,5,9
20,8479370,Tyson Jost,C,CAR,26,46,3,6,9
20,8479772,Zack MacEwen,R,OTT,28,48,3,6,9
20,8477335,Kyle Burroughs,D,LAK,29,42,3,6,9
20,8480727,Zach Whitecloud,D,VGK,28,54,2,7,9
20,8480950,Ilya Lyubushkin,D,DAL,30,61,2,7,9
20,8480070,Ian Mitchell,D,BOS,25,49,1,8,9
20,8483460,David Jiricek,D,CBJ,21,56,1,8,9
20,8476858,Phillip Di Giuseppe,L,VAN,31,41,6,2,8
20,8480441,Trey Fix-Wolansky,R,CBJ,25,39,5,3,8
20,8482496,Nils Aman,C,VAN,24,32,5,3,8
20,8482145,Mavrik Bourque,C,DAL,22,46,5,3,8
20,8476867,Brendan Gaunce,C,MIN,30,33,4,4,8
20,8479981,Jonah Gadjovich,L,FLA,26,35,4,4,8
20,8482733,Logan Mailloux,D,MTL,31,38,4,4,8
20,8480245,Olle Lycksell,R,PHI,25,33,4,4,8
20,8477962,Brendan Lemieux,L,CAR,28,42,4,4,8
20,8479968,Vinni Lettieri,C,BOS,29,46,3,5,8
20,8479671,Mathieu Olivier,R,CBJ,27,47,3,5,8
20,8479348,Kale Clague,D,BUF,26,36,3,5,8
20,8479718,Alex Barré-Boulet,C,MTL,27,48,2,6,8
20,8471677,Jack Johnson,D,CBJ,37,62,2,6,8
20,8481598,Philip Broberg,D,EDM,23,52,2,6,8
20,8480890,Jan Jenik,C,OTT,24,30,2,6,8
20,8475750,Jon Merrill,D,MIN,32,60,1,7,8
20,8474090,Brendan Smith,D,DAL,35,53,1,7,8
20,8478021,William Lagesson,D,DET,28,29,1,7,8
20,8480196,Jacob Bryson,D,BUF,27,40,0,8,8
20,8483630,Pavol Regenda,L,ANA,25,22,5,2,7
20,8478585,Derek Ryan,C,EDM,38,62,4,3,7
20,8482964,Arber Xhekaj,D,MTL,23,44,3,4,7
20,8478409,Anthony Richard,C,PHI,28,33,3,4,7
20,8479536,Axel Jonsson-Fjallby,L,WPG,26,40,2,5,7
20,8480011,Klim Kostin,C,SJS,25,34,2,5,7
20,8478017,Mark Friedman,D,VAN,29,33,2,5,7
20,8481701,Santeri Hatakka,D,NJD,23,32,1,6,7
20,8480879,Jacob Bernard-Docker,D,OTT,24,52,1,6,7
20,8476441,Joel Edmundson,D,LAK,31,39,0,7,7
20,8481556,John Beecher,C,BOS,23,35,5,1,6
20,8479991,Jake Leschyshyn,C,NYR,25,28,5,1,6
20,8481754,Nikita Nesterenko,C,ANA,23,38,4,2,6
20,8477401,John Hayden,C,SEA,29,32,4,2,6
20,8481237,Kyle MacLean,C,NYI,25,26,4,2,6
20,8484911,Collin Graf,R,SJS,22,42,4,2,6
20,8480844,Grigori Denisenko,L,VGK,24,28,4,2,6
20,8479576,Vincent Desharnais,D,VAN,28,34,3,3,6
20,8482153,Brendan Brisson,C,VGK,23,32,3,3,6
20,8475235,Nicolas Deslauriers,L,PHI,33,43,3,3,6
20,8483012,Logan Morrison,C,SEA,22,41,3,3,6
20,8483512,Matthew Savoie,C,EDM,20,26,3,3,6
20,8480880,Jakub Lauko,C,MIN,24,31,3,3,6
20,8478454,Noah Juulsen,D,VAN,27,36,2,4,6
20,8482511,Mason Lohrei,D,BOS,23,32,2,4,6
20,8475958,Michael Sgarbossa,C,WSH,32,31,2,4,6
20,8483763,Maksymilian Szuber,D,UTA,22,26,2,4,6
20,8473446,Erik Johnson,D,PHI,36,48,2,4,6
20,8477384,Joshua Brown,D,EDM,30,43,2,4,6
20,8474612,Travis Hamonic,D,OTT,34,47,2,4,6
20,8481609,Vladislav Kolyachonok,D,UTA,23,31,2,4,6
20,8482784,Zach Dean,C,STL,21,40,1,5,6
20,8481122,Simon Benoit,D,TOR,26,45,1,5,6
20,8477473,Justin Bailey,R,SJS,29,27,1,5,6
20,8478502,Dennis Gilbert,D,BUF,28,15,1,5,6
20,8481147,Reese Johnson,C,MIN,26,40,0,6,6
20,8482751,Ryan Winterton,C,SEA,21,35,4,1,5
20,8481605,Jackson LaCombe,D,ANA,23,30,3,2,5
20,8482070,Mitchell Chaffee,R,TBL,26,45,3,2,5
20,8483619,Filip Roos,D,OTT,25,31,2,3,5
20,8482177,Marat Khusnutdinov,C,MIN,22,43,2,3,5
20,8482470,Ilya Solovyov,D,CGY,24,22,2,3,5
20,8480874,Adam Ginning,D,PHI,24,12,2,3,5
20,8477018,Ben Hutton,D,VGK,31,44,1,4,5
20,8482176,Wyatt Kaiser,D,CHI,22,50,1,4,5
20,8482713,Mackie Samoskevich,R,FLA,22,40,1,4,5
20,8480292,Carson Meyer,R,ANA,27,33,1,4,5
20,8476372,Nick Seeler,D,PHI,31,36,1,4,5
20,8481679,Maxence Guenette,D,OTT,23,35,1,4,5
20,8480834,Ty Emberson,D,SJS,24,29,1,4,5
20,8478477,Mitchell Stephens,C,SEA,27,23,1,4,5
20,8474568,Luke Schenn,D,NSH,35,45,0,5,5
20,8482144,Jack Thompson,D,SJS,22,36,3,1,4
20,8477467,Gustav Olofsson,D,SEA,30,21,3,1,4
20,8479379,Givani Smith,R,SJS,26,30,3,1,4
20,8481532,Alex Turcotte,C,LAK,23,37,2,2,4
20,8478146,Matthew Highmore,C,OTT,28,36,2,2,4
20,8481593,Jayden Struble,D,MTL,23,19,2,2,4
20,8481543,Nikita Alexandrov,C,STL,24,23,1,3,4
20,8479985,Cale Fleury,D,SEA,26,23,1,3,4
20,8480990,Declan Chisholm,D,MIN,24,32,1,3,4
20,8481541,Samuel Bolduc,D,NYI,24,24,1,3,4
20,8475795,Dylan McIlrath,D,WSH,32,18,1,3,4
20,8482250,Callahan Burke,C,VGK,27,22,0,4,4
20,8478874,Adam Gaudette,R,OTT,28,33,0,4,4
20,8482765,Isak Rosen,R,BUF,21,25,0,4,4
20,8482861,Vincent Iorio,D,WSH,22,35,0,4,4
20,8477462,Robert Hagg,D,VGK,29,24,0,4,4
20,8482141,Lukas Cormier,D,VGK,22,22,3,0,3
20,8482147,Jean-Luc Foudy,C,COL,22,25,3,0,3
20,8479362,Riley Tufte,L,BOS,26,19,3,0,3
20,8483570,Ben Meyers,C,SEA,26,24,2,1,3
20,8484287,Cole McWard,D,VAN,23,25,2,1,3
20,8479320,Maxime Lajoie,D,SEA,27,27,2,1,3
20,8484258,Sam Malinski,D,COL,26,18,1,2,3
20,8480870,Bo Groulx,C,NYR,24,21,1,2,3
20,8479638,Justin Brazeau,R,BOS,26,39,1,2,3
20,8476473,Connor Murphy,D,CHI,31,39,1,2,3
20,8477244,Chad Ruhwedel,D,NYR,34,25,1,2,3
20,8477971,Andreas Englund,D,LAK,28,23,1,2,3
20,8477149,Scott Sabourin,R,SJS,32,22,1,2,3
20,8477073,Kurtis MacDermid,L,NJD,30,21,1,2,3
20,8482118,Sam Colangelo,R,ANA,23,14,1,2,3
20,8477527,Ross Johnston,L,ANA,30,29,0,3,3
20,8482858,Ryker Evans,D,SEA,23,26,0,3,3
20,8478051,Max Willman,C,NJD,29,16,0,3,3
20,8483597,Milos Kelemen,L,UTA,25,15,2,0,2
20,8481462,Mason Morelli,L,VGK,28,17,2,0,2
20,8482061,Brandon Biro,L,SEA,26,15,1,1,2
20,8480075,Cameron Crotty,D,MIN,25,8,1,1,2
20,8478446,Glenn Gawdin,C,LAK,27,15,1,1,2
20,8482929,Emil Lilleberg,D,TBL,23,15,1,1,2
20,8480084,Nick DeSimone,D,NJD,30,17,1,1,2
20,8479367,William Lockwood,R,FLA,26,21,0,2,2
20,8482172,Landon Slaggert,L,CHI,22,28,0,2,2
20,8480468,James Hamblin,L,EDM,25,17,0,2,2
20,8484325,Waltteri Merela,C,TBL,26,23,0,2,2
20,8481806,Louis Crevier,D,CHI,23,14,0,2,2
20,8482201,Gage Goncalves,C,TBL,23,25,0,2,2
20,8482165,Yan Kuznetsov,D,CGY,22,22,0,2,2
20,8482516,Matthew Kessel,D,STL,24,22,0,2,2
20,8483471,Brad Lambert,C,WPG,31,10,0,2,2
20,8481206,John Ludvig,D,PIT,24,13,0,2,2
20,8482094,Daemon Hunt,D,MIN,22,13,1,0,1
20,8481726,Adam Edstrom,C,NYR,24,9,1,0,1
20,8483395,Arshdeep Bains,L,VAN,23,12,1,0,1
20,8480032,Shane Bowers,C,NJD,25,13,1,0,1
20,8479330,Brandon Gignac,C,MTL,27,12,1,0,1
20,8478854,Ryan Shea,D,PIT,27,5,1,0,1
20,8483489,Fraser Minten,C,TOR,31,17,1,0,1
20,8481585,Egor Afanasyev,L,SJS,23,24,1,0,1
20,8477541,Dakota Mermis,D,TOR,30,7,1,0,1
20,8475413,Justin Dowling,C,NJD,34,14,1,0,1
20,8475755,Alexander Petrovic,D,DAL,32,9,1,0,1
20,8481743,Marc Del Gaizo,D,NSH,25,22,0,1,1
20,8481024,Linus Karlsson,C,VAN,25,12,0,1,1
20,8481422,Jake Lucchini,C,NSH,29,18,0,1,1
20,8481006,Tyler Tucker,D,STL,24,12,0,1,1
20,8482088,Justin Sourdif,R,FLA,22,18,0,1,1
20,8483567,Georgii Merkulov,C,BOS,24,9,0,1,1
20,8479587,Rhett Gardner,C,PHI,28,27,0,1,1
20,8478011,Louie Belpedio,D,PHI,28,17,0,1,1
20,8482102,Vasily Ponomarev,C,PIT,22,18,0,1,1
20,8481043,Cole Koepke,L,BOS,26,13,0,1,1
20,8481699,Aku Raty,R,UTA,23,10,0,1,1
20,8481564,Ryan Johnson,D,BUF,23,10,0,1,1
20,8477810,Joel Hanley,D,CGY,33,21,0,1,1
20,8481719,Maxwell Crozier,D,TBL,24,12,0,1,1
20,8480306,Grant Hutton,D,NYI,29,8,0,1,1
20,8480267,Sammy Walker,C,MIN,25,19,0,1,1
20,8482162,Roby Jarventie,L,EDM,22,13,0,1,1
20,8483398,Declan Carlile,D,TBL,31,3,0,1,1
20,8483407,Brandon Scanlin,D,NYR,25,4,0,1,1
20,8483432,Luca Del Bel Belluz,C,CBJ,31,5,0,1,1
20,8476913,Devin Shore,C,MIN,30,37,0,0,0
20,8480823,Alexander Alexeyev,D,WSH,25,9,0,0,0
20,8481065,Angus Crookshank,L,OTT,25,15,0,0,0
20,8481030,Jack St. Ivany,D,PIT,25,11,0,0,0
20,8479419,Brett Murray,L,BUF,26,20,0,0,0
20,8482476,Emil Heineman,L,MTL,23,6,0,0,0
20,8484304,Uvis Balinskis,D,FLA,28,6,0,0,0
20,8482787,Nikita Chibrikov,R,WPG,31,6,0,0,0
20,8483609,Adam Klapka,R,CGY,24,4,0,0,0
20,8478881,Brett Seney,L,CHI,28,13,0,0,0
20,8477993,Justin Kirkland,C,CGY,28,10,0,0,0
20,8482460,Matt Rempe,C,NYR,22,9,0,0,0
20,8481578,Graeme Clarke,R,MIN,23,6,0,0,0
20,8475780,Chris Wagner,R,COL,33,5,0,0,0
20,8484326,Patrik Koch,D,UTA,28,4,0,0,0
20,8480851,Akil Thomas,C,LAK,24,18,0,0,0
20,8484259,Ondrej Pavel,C,COL,31,2,0,0,0
20,8480274,Philip Kemp,D,EDM,25,1,0,0,0
20,8474062,Riley Nash,C,NYR,35,18,0,0,0
20,8483546,Marshall Rifai,D,TOR,26,0,0,0,0
20,8483531,Brian Halonen,L,NJD,25,2,0,0,0
20,8484255,Jason Polin,R,COL,25,2,0,0,0
20,8483401,Marc Johnstone,R,PIT,28,1,0,0,0
20,8479522,Hardy Haman Aktell,D,WSH,26,3,0,0,0
20,8476323,Max McCormick,L,SEA,32,2,0,0,0
20,8483920,Pierrick Dube,R,WSH,23,5,0,0,0
20,8482197,Adam Raska,R,MIN,23,5,0,0,0
20,8484321,Nikolas Matinpalo,D,OTT,26,1,0,0,0
20,8479421,Jacob Moverare,D,LAK,26,5,0,0,0
20,8481655,Cole Schwindt,R,CGY,23,3,0,0,0
20,8478147,Bokondji Imama,L,PIT,28,6,0,0,0
20,8481534,Raphael Lavoie,C,EDM,24,1,0,0,0
20,8482126,Emil Andrae,D,PHI,31,6,0,0,0
20,8470794,Joe Pavelski,C,,40,0,0,0,0
20,8479321,Lucas Johansen,D,,27,0,0,0,0
20,8477950,Tony DeAngelo,D,,29,0,0,0,0
20,8471218,Blake Wheeler,R,,38,0,0,0,0
20,8475197,Tyson Barrie,D,,33,0,0,0,0
20,8474157,Max Pacioretty,L,,36,0,0,0,0
20,8475744,Evgeny Kuznetsov,C,,32,0,0,0,0
20,8474037,James van Riemsdyk,L,,35,0,0,0,0
20,8476907,Mackenzie MacEachern,L,,30,0,0,0,0
20,8480216,Jacob Peterson,C,,25,0,0,0,0
20,8474602,Justin Schultz,D,,34,0,0,0,0
20,8482222,Alexander Barabanov,L,,30,0,0,0,0
20,8474031,Kevin Shattenkirk,D,,35,0,0,0,0
20,8477330,Dominik Kubalik,L,,29,0,0,0,0
20,8480884,Calen Addison,D,,24,0,0,0,0
20,8475906,John Klingberg,D,,32,0,0,0,0
20,8480008,Adam Ruzicka,C,,25,0,0,0,0
20,8476884,Derrick Pouliot,D,,30,0,0,0,0
20,8476919,Chris Tierney,C,,30,0,0,0,0
20,8479415,Michael McLeod,C,,26,0,0,0,0
20,8474870,Tyler Johnson,C,,34,0,0,0,0
20,8470604,Jeff Carter,C,,39,0,0,0,0
20,8478104,Sammy Blais,L,,28,0,0,0,0
20,8474884,Mike Hoffman,C,,35,0,0,0,0
20,8481591,Sam Poulin,R,,23,0,0,0,0
20,8471274,Alex Goligoski,D,,39,0,0,0,0
20,8476871,Tanner Pearson,L,,32,0,0,0,0
20,8476393,Nick Cousins,C,,31,0,0,0,0
20,8479977,Kailer Yamamoto,R,,26,0,0,0,0
20,8479346,Dillon Dube,C,,26,0,0,0,0
20,8480184,Gustav Lindstrom,D,,26,0,0,0,0
20,8479376,Victor Mete,D,,26,0,0,0,0
20,8473449,Kyle Okposo,R,,36,0,0,0,0
20,8481058,Jesse Ylonen,R,,25,0,0,0,0
20,8475752,Tyler Pitlick,C,,33,0,0,0,0
20,8481239,Samuel Fagemo,L,,24,0,0,0,0
20,8480821,Filip Zadina,R,,25,0,0,0,0
20,8470966,Mark Giordano,D,,41,0,0,0,0
20,8478495,Denis Gurianov,R,,27,0,0,0,0
20,8477464,Nic Petan,C,,29,0,0,0,0
20,8478099,Kevin Labanc,R,,29,0,0,0,0
20,8482241,Radim Zohorna,L,,28,0,0,0,0
20,8474040,Sam Gagner,C,,35,0,0,0,0
20,8479514,Rem Pitlick,C,,27,0,0,0,0
20,8478430,Oliver Kylington,D,,27,0,0,0,0
20,8479533,Joona Koppanen,L,,26,0,0,0,0
20,8479984,Cal Foote,D,,26,0,0,0,0
20,8477126,Jayson Megna,C,,34,0,0,0,0
20,8475164,Jakob Silfverberg,R,,34,0,0,0,0
20,8474009,Nick Bonino,C,,36,0,0,0,0
20,8479458,Nikita Zaitsev,D,,33,0,0,0,0
20,8477944,Jakub Vrana,L,,28,0,0,0,0
20,8471699,Andrew Cogliano,C,,37,0,0,0,0
20,8478067,Oskar Lindblom,L,,28,0,0,0,0
20,8471686,Marc Staal,D,,37,0,0,0,0
20,8470610,Zach Parise,L,,40,0,0,0,0
20,8478904,Steven Lorentz,C,,28,0,0,0,0
20,8473473,Milan Lucic,L,,36,0,0,0,0
20,8480031,Maxime Comtois,L,,25,0,0,0,0
20,8478512,Austin Czarnik,C,,32,0,0,0,0
20,8473504,Cal Clutterbuck,R,,37,0,0,0,0
20,8477454,Adam Erne,L,,29,0,0,0,0
20,8479383,Boris Katchouk,L,,26,0,0,0,0
20,8475825,Jani Hakanpää,D,,32,0,0,0,0
20,8477846,Ryan Carpenter,C,,33,0,0,0,0
20,8477930,Pierre-Edouard Bellemare,L,,39,0,0,0,0
20,8478400,Colin White,C,,27,0,0,0,0
20,8480226,Marián Studenic,R,,26,0,0,0,0
20,8480853,Liam Foudy,C,,24,0,0,0,0
20,8475797,Jarred Tinordi,D,,32,0,0,0,0
20,8479423,Alex Nylander,L,,26,0,0,0,0
20,8474618,Marco Scandella,D,,34,0,0,0,0
20,8478028,Fredrik Olofsson,L,,28,0,0,0,0
20,8474709,Matt Martin,L,,35,0,0,0,0
20,8481070,Hugh McGing,L,,26,0,0,0,0
20,8479546,Oskar Steen,C,,26,0,0,0,0
20,8474145,Robert Bortuzzo,D,,35,0,0,0,0
20,8476915,Jujhar Khaira,L,,30,0,0,0,0
20,8475278,Byron Froese,C,,33,0,0,0,0
20,8481812,Nikolai Knyzhov,D,,27,0,0,0,0
20,8478408,Travis Dermott,D,,28,0,0,0,0
20,8481077,John Leonard,L,,26,0,0,0,0
20,8479547,Matthew Phillips,R,,26,0,0,0,0
20,8480836,Jonathan Gruden,C,,24,0,0,0,0
20,8481690,Tyler Angle,C,,24,0,0,0,0
20,8475766,Austin Watson,L,,32,0,0,0,0
20,8481016,Ruslan Iskhakov,C,,24,0,0,0,0
20,8478078,Rourke Chartier,C,,28,0,0,0,0
20,8480776,Sheldon Rempal,R,,29,0,0,0,0
20,8478956,Samuel Laberge,L,NJD,27,1,0,0,0
20,8483045,Cameron Butler,R,CBJ,31,0,0,0,0
20,8484314,Jiri Smejkal,L,,28,0,0,0,0
21,8478402,Connor McDavid,C,EDM,27,79,47,105,152
21,8477934,Leon Draisaitl,C,EDM,29,78,64,72,136
21,8477492,Nathan MacKinnon,C,COL,29,82,51,76,127
21,8476453,Nikita Kucherov,R,TBL,31,82,37,85,122
21,8478550,Artemi Panarin,L,NYR,33,73,34,88,122
21,8477942,Kevin Fiala,L,LAK,28,82,35,76,111
21,8478483,Mitch Marner,R,TOR,27,77,31,79,110
21,8478420,Mikko Rantanen,R,COL,28,81,52,57,109
21,8479318,Auston Matthews,C,TOR,27,79,62,46,108
21,8481559,Jack Hughes,C,NJD,23,76,39,68,107
21,8480069,Cale Makar,D,COL,26,72,30,75,105
21,8479314,Matthew Tkachuk,L,FLA,27,79,36,66,102
21,8476460,Mark Scheifele,C,WPG,31,78,31,69,100
21,8477946,Dylan Larkin,C,DET,28,81,39,60,99
21,8476887,Filip Forsberg,L,NSH,30,70,44,54,98
21,8477956,David Pastrnak,R,BOS,28,79,34,64,98
21,8476389,Vincent Trocheck,C,NYR,31,80,44,53,97
21,8478427,Sebastian Aho,C,CAR,27,75,43,52,95
21,8477493,Aleksander Barkov,C,FLA,29,77,33,62,95
21,8476468,J.T. Miller,C,VAN,31,78,35,58,93
21,8477933,Sam Reinhart,C,FLA,29,78,45,47,92
21,8479323,Adam Fox,D,NYR,26,75,13,79,92
21,8480801,Brady Tkachuk,L,OTT,25,80,36,54,90
21,8473419,Brad Marchand,L,BOS,36,79,36,54,90
21,8480027,Jason Robertson,L,DAL,25,82,33,57,90
21,8476459,Mika Zibanejad,C,NYR,31,77,27,62,89
21,8478445,Mathew Barzal,C,NYI,27,82,24,65,89
21,8474141,Patrick Kane,R,DET,36,78,33,54,87
21,8475913,Mark Stone,R,VGK,32,79,35,51,86
21,8476456,Jonathan Huberdeau,C,CGY,31,76,20,66,86
21,8479343,Clayton Keller,R,UTA,26,76,39,46,85
21,8478439,Travis Konecny,R,PHI,27,77,37,48,85
21,8476539,Jonathan Marchessault,R,NSH,34,77,37,48,85
21,8475786,Zach Hyman,L,EDM,32,79,32,53,85
21,8474600,Roman Josi,D,NSH,34,72,20,65,85
21,8477501,Valeri Nichushkin,R,COL,29,80,42,41,83
21,8482116,Tim Stützle,C,OTT,22,79,31,51,82
21,8480023,Robert Thomas,C,STL,25,73,19,63,82
21,8475184,Chris Kreider,L,NYR,33,75,52,29,81
21,8478010,Brayden Point,C,TBL,28,81,46,35,81
21,8477939,William Nylander,R,TOR,28,79,40,41,81
21,8479420,Tage Thompson,C,BUF,27,70,37,44,81
21,8477402,Pavel Buchnevich,L,STL,29,76,40,40,80
21,8480800,Quinn Hughes,D,VAN,25,77,9,71,80
21,8477409,Carter Verhaeghe,C,FLA,29,78,36,43,79
21,8477960,Adrian Kempe,R,LAK,28,79,35,44,79
21,8477404,Jake Guentzel,C,TBL,30,81,35,43,78
21,8471215,Evgeni Malkin,C,PIT,38,75,30,48,78
21,8475172,Nazem Kadri,C,CGY,34,78,24,54,78
21,8474679,Gustav Nyquist,C,NSH,35,76,22,56,78
21,8477504,Josh Morrissey,D,WPG,29,77,10,68,78
21,8474564,Steven Stamkos,C,NSH,34,77,36,41,77
21,8479407,Jesper Bratt,L,NJD,26,75,33,44,77
21,8479337,Alex DeBrincat,R,DET,27,81,33,44,77
21,8478403,Jack Eichel,C,VGK,28,73,31,46,77
21,8480012,Elias Pettersson,C,VAN,26,76,25,52,77
21,8480015,Owen Tippett,R,PHI,25,76,33,43,76
21,8475754,Brock Nelson,C,NYI,33,81,33,43,76
21,8471685,Anze Kopitar,C,LAK,37,80,26,50,76
21,8482740,Wyatt Johnston,C,DAL,21,82,39,36,75
21,8480002,Nico Hischier,C,NJD,25,76,30,45,75
21,8478864,Kirill Kaprizov,L,MIN,27,72,29,46,75
21,8484144,Connor Bedard,C,CHI,19,72,30,44,74
21,8476454,Ryan Nugent-Hopkins,C,EDM,31,77,22,52,74
21,8473994,Jamie Benn,L,DAL,35,81,31,42,73
21,8478873,Troy Terry,R,ANA,27,78,23,50,73
21,8478444,Brock Boeser,R,VAN,27,74,40,32,72
21,8473512,Claude Giroux,R,OTT,36,81,26,46,72
21,8480036,Miro Heiskanen,D,DAL,25,77,12,60,72
21,8477500,Bo Horvat,C,NYI,29,76,37,34,71
21,8478449,Roope Hintz,C,DAL,28,82,31,40,71
21,8471214,Alex Ovechkin,L,WSH,39,70,28,43,71
21,8476346,Johnny Gaudreau,L,CBJ,31,72,20,51,71
21,8479385,Jordan Kyrou,C,STL,26,76,31,39,70
21,8477955,Jared McCann,L,SEA,28,74,28,42,70
21,8471675,Sidney Crosby,C,PIT,37,71,30,39,69
21,8482078,Lucas Raymond,L,DET,22,77,30,39,69
21,8480208,Drake Batherson,R,OTT,26,76,22,47,69
21,8474578,Erik Karlsson,D,PIT,34,81,18,51,69
21,8475166,John Tavares,C,TOR,34,77,31,37,68
21,8478440,Dylan Strome,C,WSH,27,72,27,41,68
21,8478414,Timo Meier,R,NJD,28,79,31,36,67
21,8481068,Yegor Sharangovich,C,CGY,26,78,31,36,67
21,8479542,Brandon Hagel,L,TBL,26,82,29,38,67
21,8477940,Nikolaj Ehlers,L,WPG,28,72,31,35,66
21,8479675,Trevor Moore,L,LAK,29,81,31,35,66
21,8480830,Andrei Svechnikov,R,CAR,24,70,27,39,66
21,8474590,John Carlson,D,WSH,34,73,18,48,66
21,8475765,Vladimir Tarasenko,R,DET,33,81,21,44,65
21,8477494,Jonathan Drouin,L,COL,29,80,16,49,65
21,8477407,Anthony Duclair,L,NYI,29,78,29,35,64
21,8475692,Mats Zuccarello,R,MIN,37,71,20,44,64
21,8475168,Matt Duchene,C,DAL,33,82,19,45,64
21,8480839,Rasmus Dahlin,D,BUF,24,68,17,47,64
21,8475798,Mikael Granlund,C,SJS,32,74,15,49,64
21,8475810,Bryan Rust,R,PIT,32,71,37,26,63
21,8481557,Matt Boldy,L,MIN,23,65,26,37,63
21,8476881,Tomas Hertl,C,VGK,31,80,25,38,63
21,8475726,Tyler Toffoli,C,SJS,32,67,33,29,62
21,8475158,Ryan O'Reilly,C,NSH,33,72,28,34,62
21,8478398,Kyle Connor,L,WPG,28,67,25,37,62
21,8476448,William Karlsson,C,VGK,31,75,24,38,62
21,8477949,Alex Tuch,R,BUF,28,75,18,44,62
21,8478460,Zach Werenski,D,CBJ,27,79,13,49,62
21,8475167,Victor Hedman,D,TBL,34,80,11,51,62
21,8476399,Blake Coleman,C,CGY,33,80,33,28,61
21,8481560,Arthur Kaliyev,R,LAK,23,78,30,31,61
21,8482093,Seth Jarvis,C,CAR,22,71,27,34,61
21,8481540,Cole Caufield,R,MTL,23,68,24,37,61
21,8481711,Matias Maccelli,L,UTA,24,75,23,38,61
21,8478047,Michael Bunting,L,PIT,29,71,20,41,61
21,8477986,Brandon Montour,D,SEA,30,74,17,44,61
21,8480865,Noah Dobson,D,NYI,24,79,10,51,61
21,8482745,Mason McTavish,C,ANA,21,74,30,30,60
21,8476479,Phillip Danault,C,LAK,31,81,28,32,60
21,8478493,Joel Eriksson Ek,C,MIN,27,66,28,32,60
21,8473986,Alex Killorn,L,ANA,35,73,26,33,59
21,8480028,Morgan Frost,C,PHI,25,76,21,38,59
21,8480797,Joel Farabee,L,PHI,24,80,20,39,59
21,8475784,Jeff Skinner,C,EDM,32,77,29,29,58
21,8476483,Rickard Rakell,R,PIT,31,70,32,25,57
21,8482665,Matty Beniers,C,SEA,22,75,26,31,57
21,8479999,Casey Mittelstadt,C,COL,26,81,19,38,57
21,8476853,Morgan Rielly,D,TOR,30,73,13,44,57
21,8480803,Evan Bouchard,D,EDM,25,75,11,46,57
21,8477416,Oliver Bjorkstrand,R,SEA,29,75,30,26,56
21,8478975,Mason Marchment,L,DAL,29,80,20,36,56
21,8475170,Brayden Schenn,C,STL,33,69,19,37,56
21,8477476,Artturi Lehkonen,L,COL,29,80,28,27,55
21,8477935,Sam Bennett,C,FLA,28,78,27,28,55
21,8475151,Kyle Palmieri,C,NYI,33,78,21,34,55
21,8477951,Nick Schmaltz,C,UTA,28,77,17,38,55
21,8481524,Bowen Byram,D,BUF,23,70,13,42,55
21,8478038,Devon Toews,D,COL,30,76,12,43,55
21,8477496,Elias Lindholm,C,BOS,30,78,27,27,54
21,8478498,Jake DeBrusk,L,VAN,28,75,26,28,54
21,8475191,Reilly Smith,R,NYR,33,72,26,28,54
21,8476882,Teuvo Teravainen,C,CHI,30,69,23,31,54
21,8478466,Daniel Sprong,R,VAN,27,66,18,36,54
21,8482124,Quinton Byfield,R,LAK,22,81,15,39,54
21,8480220,Noah Cates,L,PHI,25,72,27,26,53
21,8482149,Cole Perfetti,C,WPG,22,73,25,28,53
21,8476905,Chandler Stephenson,C,SEA,30,78,17,36,53
21,8474641,Adam Henrique,C,EDM,34,75,29,23,52
21,8474102,David Perron,L,OTT,36,78,22,30,52
21,8478519,Anthony Cirelli,C,TBL,27,82,19,33,52
21,8474586,Jordan Eberle,R,SEA,34,73,18,34,52
21,8478856,Conor Garland,R,VAN,28,72,18,34,52
21,8478469,Thomas Chabot,D,OTT,27,71,10,42,52
21,8476880,Tom Wilson,R,WSH,30,70,24,27,51
21,8478046,Danton Heinen,L,VAN,29,76,22,29,51
21,8479987,Morgan Geekie,C,BOS,26,79,22,29,51
21,8481528,Dylan Cozens,C,BUF,23,76,17,34,51
21,8478396,Noah Hanifin,D,VGK,27,66,12,39,51
21,8480434,Sean Durzi,D,UTA,26,77,12,39,51
21,8479325,Charlie McAvoy,D,BOS,27,72,9,42,51
21,8480014,Gabriel Vilardi,C,WPG,25,69,32,18,50
21,8483808,Andrei Kuzmenko,L,CGY,28,74,32,18,50
21,8482097,Jack Quinn,R,BUF,23,68,24,26,50
21,8482113,Anton Lundell,C,FLA,23,75,22,27,49
21,8480039,Martin Necas,C,CAR,25,71,21,28,49
21,8476906,Shayne Gostisbehere,D,CAR,31,76,12,37,49
21,8477447,Shea Theodore,D,VGK,29,61,9,40,49
21,8479400,Pierre-Luc Dubois,L,WSH,26,71,20,28,48
21,8478401,Pavel Zacha,C,BOS,27,79,20,28,48
21,8478438,Tommy Novak,C,NSH,27,68,18,30,48
21,8480018,Nick Suzuki,C,MTL,25,74,17,31,48
21,8474563,Drew Doughty,D,LAK,35,71,12,36,48
21,8482699,Dylan Guenther,R,UTA,21,79,22,25,47
21,8478233,Andrew Mangiapane,L,WSH,28,75,22,25,47
21,8478042,Viktor Arvidsson,L,EDM,31,74,19,28,47
21,8477497,Sean Monahan,C,CBJ,30,69,19,28,47
21,8474150,Mikael Backlund,C,CGY,35,76,15,32,47
21,8482660,Kent Johnson,C,CBJ,22,66,13,34,47
21,8476462,Dougie Hamilton,D,NJD,31,74,11,36,47
21,8471698,T.J. Oshie,R,WSH,38,66,24,22,46
21,8480813,Joe Veleno,C,DET,24,77,24,22,46
21,8482159,Tyson Foerster,R,PHI,22,77,22,24,46
21,8477511,Anthony Mantha,R,CGY,30,75,21,25,46
21,8480849,Barrett Hayton,C,UTA,24,74,20,26,46
21,8478474,Lawson Crouse,L,UTA,27,76,19,27,46
21,8479425,Filip Hronek,D,VAN,27,73,13,33,46
21,8476875,Mike Matheson,D,MTL,30,74,12,34,46
21,8482684,Luke Hughes,D,NJD,21,72,9,37,46
21,8476958,Jaccob Slavin,D,CAR,30,77,8,38,46
21,8480064,Josh Norris,C,OTT,25,75,27,18,45
21,8476432,Boone Jenner,C,CBJ,31,68,23,22,45
21,8477964,Ivan Barbashev,C,VGK,29,70,20,25,45
21,8479992,Michael Rasmussen,C,DET,25,78,20,25,45
21,8477456,J.T. Compher,L,DET,29,79,18,27,45
21,8475794,Tyler Seguin,C,DAL,32,82,18,27,45
21,8476872,Scott Laughton,C,PHI,30,74,17,28,45
21,8476826,Yanni Gourde,C,SEA,33,73,16,29,45
21,8475763,Kevin Hayes,R,PIT,32,76,16,29,45
21,8479339,Patrik Laine,L,CBJ,26,60,15,30,45
21,8477429,Andrew Copp,C,DET,30,78,15,30,45
21,8476869,Brady Skjei,D,NSH,30,73,15,30,45
21,8471724,Kris Letang,D,PIT,37,81,14,31,45
21,8477498,Darnell Nurse,D,EDM,29,77,12,33,45
21,8477969,Marcus Pettersson,D,PIT,28,77,7,38,45
21,8482109,Alexis Lafrenière,L,NYR,23,76,23,21,44
21,8479525,Ross Colton,C,COL,28,81,20,24,44
21,8481604,Pavel Dorofeyev,L,VGK,24,70,19,25,44
21,8480798,Philipp Kurashev,C,CHI,25,70,15,29,44
21,8477021,Alex Kerfoot,C,UTA,30,76,13,31,44
21,8484153,Leo Carlsson,C,ANA,20,74,12,32,44
21,8475799,Nino Niederreiter,R,WPG,32,67,22,21,43
21,8480009,Eeli Tolvanen,R,SEA,25,73,22,21,43
21,8484166,Adam Fantilli,C,CBJ,20,73,19,24,43
21,8483431,Logan Cooley,C,UTA,20,74,19,24,43
21,8477479,Tyler Bertuzzi,L,CHI,29,67,18,25,43
21,8475745,Charlie Coyle,C,BOS,32,78,17,26,43
21,8483515,Juraj Slafkovsky,L,MTL,20,77,14,29,43
21,8476923,Damon Severson,D,CBJ,30,80,13,30,43
21,8478407,Vince Dunn,D,SEA,28,74,7,36,43
21,8479410,Mikhail Sergachev,D,UTA,26,67,7,36,43
21,8481703,Valtteri Puustinen,R,PIT,25,68,6,37,43
21,8475314,Anders Lee,L,NYI,34,78,24,18,42
21,8478462,Nicolas Roy,C,VGK,27,77,18,24,42
21,8474565,Alex Pietrangelo,D,VGK,34,57,13,29,42
21,8478366,Frank Vatrano,R,ANA,30,75,28,13,41
21,8476438,Brandon Saad,L,STL,32,78,24,17,41
21,8482175,JJ Peterka,R,BUF,22,72,22,19,41
21,8477998,Warren Foegele,L,LAK,28,80,21,20,41
21,8482720,Matthew Knies,L,TOR,22,74,20,21,41
21,8475722,Jason Zucker,L,BUF,32,66,16,25,41
21,8475753,Justin Faulk,D,STL,32,74,15,26,41
21,8470613,Brent Burns,D,CAR,39,76,14,27,41
21,8476792,Torey Krug,D,STL,33,71,10,31,41
21,8478500,Ivan Provorov,D,CBJ,27,77,8,33,41
21,8481542,Moritz Seider,D,DET,23,72,7,34,41
21,8484145,Zach Benson,L,BUF,19,63,22,18,40
21,8478458,John (Jack) Roslovic,C,CAR,27,73,20,20,40
21,8475768,Jaden Schwartz,C,SEA,32,69,20,20,40
21,8480188,Fabian Zetterlund,L,SJS,25,60,14,26,40
21,8477346,MacKenzie Weegar,D,CGY,30,71,12,28,40
21,8481656,Aliaksei Protas,C,WSH,23,65,12,28,40
21,8475218,Mattias Ekholm,D,EDM,34,76,8,32,40
21,8478542,Evan Rodrigues,C,FLA,31,73,20,19,39
21,8478472,Mathieu Joseph,R,STL,27,71,16,23,39
21,8477503,Max Domi,C,TOR,29,77,15,24,39
21,8481533,Trevor Zegras,C,ANA,23,72,14,25,39
21,8475287,Erik Haula,L,NJD,33,73,13,26,39
21,8478891,Mason Appleton,C,WPG,28,64,11,28,39
21,8479345,Jakob Chychrun,D,WSH,26,68,11,28,39
21,8476292,Ondrej Palat,L,NJD,33,68,10,29,39
21,8480871,Adam Boqvist,D,FLA,24,69,8,31,39
21,8478055,Gustav Forsling,D,FLA,28,74,7,32,39
21,8475169,Evander Kane,L,EDM,33,71,20,18,38
21,8482110,Dawson Mercer,C,NJD,23,71,17,21,38
21,8482705,Cole Sillinger,C,CBJ,21,70,17,21,38
21,8480113,Alex Iafallo,L,WPG,31,67,17,21,38
21,8483505,Matthew Poitras,C,BOS,20,73,16,22,38
21,8477932,Aaron Ekblad,D,FLA,28,66,15,23,38
21,8477444,Andre Burakovsky,L,SEA,29,71,14,24,38
21,8481596,Shane Pinto,C,OTT,24,74,14,24,38
21,8481577,Philip Tomasino,C,NSH,23,64,13,25,38
21,8477495,Seth Jones,D,CHI,30,71,6,32,38
21,8478115,Pierre Engvall,L,NYI,28,75,23,14,37
21,8475793,Ryan Johansen,C,PHI,32,72,21,16,37
21,8479365,Trent Frederic,C,BOS,26,77,16,21,37
21,8480078,Filip Chytil,C,NYR,25,69,16,21,37
21,8477987,Ryan Donato,C,CHI,28,62,15,22,37
21,8477505,Alexander Wennberg,C,SJS,30,64,14,23,37
21,8476854,Hampus Lindholm,D,BOS,30,73,3,34,37
21,8481624,Ilya Mikheyev,R,CHI,30,58,18,18,36
21,8476458,Ryan Strome,C,ANA,31,68,11,25,36
21,8481546,Cam York,D,PHI,23,70,7,29,36
21,8476979,Erik Gustafsson,D,DET,32,75,5,31,36
21,8479591,Michael Eyssimont,C,TBL,28,80,18,17,35
21,8480829,Jesperi Kotkaniemi,C,CAR,24,66,16,19,35
21,8483524,Shane Wright,C,SEA,20,62,15,20,35
21,8480185,Eetu Luostarinen,C,FLA,26,74,10,25,35
21,8478397,Rasmus Andersson,D,CGY,28,69,5,30,35
21,8479398,Samuel Girard,D,COL,26,69,4,31,35
21,8480893,Kirill Marchenko,R,CBJ,24,67,19,15,34
21,8482089,Jake Neighbours,L,STL,22,69,19,15,34
21,8481186,Logan O'Connor,R,COL,28,80,17,17,34
21,8481618,Alex Newhook,C,MTL,23,72,16,18,34
21,8475714,Calle Jarnkrok,C,TOR,33,76,14,20,34
21,8478463,Anthony Beauvillier,L,PIT,27,69,10,24,34
21,8480336,Sean Walker,D,CAR,30,71,6,28,34
21,8476917,Adam Pelech,D,NYI,30,79,5,29,34
21,8482055,Drew O'Connor,L,PIT,26,61,19,14,33
21,8478013,Jake Walman,D,SJS,28,68,18,15,33
21,8477451,Ryan Hartman,R,MIN,30,69,16,17,33
21,8480459,Pius Suter,C,VAN,28,66,16,17,33
21,8474715,Cameron Atkinson,R,TBL,35,79,16,17,33
21,8474149,Evgenii Dadonov,R,DAL,35,81,14,19,33
21,8482146,Luke Evangelista,R,NSH,22,59,14,19,33
21,8477947,Sonny Milano,L,WSH,28,66,14,19,33
21,8484203,Bradly Nadeau,L,CAR,19,71,14,19,33
21,8482092,Ridly Greig,C,OTT,22,72,13,20,33
21,8475171,Oliver Ekman-Larsson,D,TOR,33,62,6,27,33
21,8476878,Zemgus Girgensons,C,TBL,30,80,16,16,32
21,8482702,Logan Stankoven,C,DAL,21,78,15,17,32
21,8480068,Ryan Poehling,C,PHI,25,67,15,17,32
21,8481582,Nicholas Robertson,L,TOR,23,65,14,18,32
21,8482475,Yegor Chinakhov,R,CBJ,23,60,13,19,32
21,8476921,Jordan Martinook,L,CAR,32,59,13,19,32
21,8482105,Jake Sanderson,D,OTT,22,70,11,21,32
21,8476392,Adam Lowry,C,WPG,31,63,9,23,32
21,8477488,Brett Pesce,D,NJD,30,70,4,28,32
21,8483457,Lane Hutson,D,MTL,20,73,15,16,31
21,8475193,Tomas Tatar,L,NJD,34,64,15,16,31
21,8473422,Nick Foligno,L,CHI,37,62,14,17,31
21,8476474,Stefan Noesen,R,NJD,31,68,14,17,31
21,8476927,Teddy Blueger,C,VAN,30,67,11,20,31
21,8482671,Owen Power,D,BUF,22,69,8,23,31
21,8482122,Brock Faber,D,MIN,22,77,4,27,31
21,8477353,Tyler Motte,C,DET,29,74,18,12,30
21,8475760,Nick Bjugstad,C,UTA,32,67,15,15,30
21,8479390,Taylor Raddysh,R,WSH,26,61,15,15,30
21,8482133,Thomas Bordeleau,C,SJS,22,61,10,20,30
21,8476461,Sean Couturier,C,PHI,32,67,9,21,30
21,8482712,Oskar Olausson,R,COL,22,76,5,25,30
21,8479371,Dante Fabbro,D,NSH,26,67,4,26,30
21,8477426,Nicholas Paul,L,TBL,29,81,18,11,29
21,8482079,Marco Rossi,C,MIN,23,51,17,12,29
21,8478057,Dakota Joshua,C,VAN,28,68,16,13,29
21,8481581,Thomas Harley,D,DAL,23,72,13,16,29
21,8476480,Vladislav Namestnikov,C,WPG,32,66,12,17,29
21,8475343,Nic Dowd,C,WSH,34,61,12,17,29
21,8479351,Sam Steel,C,DAL,26,77,12,17,29
21,8474053,Logan Couture,C,SJS,35,68,10,19,29
21,8480748,Kiefer Sherwood,L,VAN,29,53,10,19,29
21,8477450,Jason Dickinson,C,CHI,29,65,10,19,29
21,8475791,Taylor Hall,L,CHI,33,58,9,20,29
21,8476463,Jonas Brodin,D,MIN,31,79,8,21,29
21,8480817,K'Andre Miller,D,NYR,24,68,8,21,29
21,8481601,Simon Holmstrom,R,NYI,23,68,15,13,28
21,8477989,Christian Dvorak,C,MTL,28,64,14,14,28
21,8483491,Ivan Miroshnichenko,L,WSH,20,53,14,14,28
21,8479316,Luke Kunin,C,SJS,27,55,14,14,28
21,8480003,Jesper Boqvist,C,FLA,26,68,12,16,28
21,8476419,Jean-Gabriel Pageau,C,NYI,32,76,11,17,28
21,8477953,Kasperi Kapanen,R,STL,28,61,11,17,28
21,8476960,Andreas Athanasiou,C,CHI,30,50,11,17,28
21,8478413,Jordan Greenway,L,BUF,27,62,10,18,28
21,8481481,Blake Lizotte,C,PIT,27,66,10,18,28
21,8482667,William Eklund,L,SJS,22,63,9,19,28
21,8479393,Noah Gregor,L,OTT,26,73,9,19,28
21,8480145,Neal Pionk,D,WPG,29,72,8,20,28
21,8481441,Joe Snively,C,DET,28,69,7,21,28
21,8475231,Casey Cizikas,C,NYI,33,79,6,22,28
21,8482655,Janis Moser,D,TBL,24,76,2,26,28
21,8482259,Bobby McMann,C,TOR,28,64,17,10,27
21,8475225,Craig Smith,C,CHI,35,49,14,13,27
21,8477478,William Carrier,L,CAR,30,61,13,14,27
21,8476994,Vinnie Hinostroza,C,NSH,30,58,11,16,27
21,8480802,Ryan McLeod,C,BUF,25,60,10,17,27
21,8477425,Miles Wood,L,COL,29,75,10,17,27
21,8475200,Dmitry Orlov,D,CAR,33,75,8,19,27
21,8478970,Jalen Chatfield,D,CAR,28,68,8,19,27
21,8483468,Jiri Kulich,C,BUF,20,59,7,20,27
21,8476885,Jacob Trouba,D,NYR,30,67,5,22,27
21,8476931,Jake McCabe,D,TOR,31,72,4,23,27
21,8481554,Kaapo Kakko,R,NYR,23,68,16,10,26
21,8483499,Liam Ohgren,L,MIN,20,59,12,14,26
21,8479996,Cody Glass,C,NSH,25,61,10,16,26
21,8479293,Brandon Tanev,L,SEA,33,68,9,17,26
21,8476312,Josh Manson,D,COL,33,58,7,19,26
21,8473507,Jeff Petry,D,DET,37,70,5,21,26
21,8480806,Isac Lundestrom,C,ANA,25,62,4,22,26
21,8481606,Jordan Spence,D,LAK,23,67,3,23,26
21,8478508,Yakov Trenin,C,MIN,27,62,18,7,25
21,8482117,Lukas Reichel,L,CHI,22,61,12,13,25
21,8479353,Brett Howden,C,VGK,26,67,12,13,25
21,8476469,Joel Armia,R,MTL,31,66,11,14,25
21,8476925,Colton Sissons,C,NSH,31,62,10,15,25
21,8479543,Michael Pezzetta,L,MTL,26,64,10,15,25
21,8475848,Brendan Gallagher,R,MTL,32,70,8,17,25
21,8481523,Kirby Dach,C,MTL,23,64,7,18,25
21,8481059,Scott Perunovich,D,STL,26,64,7,18,25
21,8475764,Cam Fowler,D,ANA,33,70,2,23,25
21,8477506,Ryan Pulock,D,NYI,30,78,2,23,25
21,8480043,Timothy Liljegren,D,TOR,25,70,1,24,25
21,8478020,Michael Amadio,R,OTT,28,76,14,10,24
21,8481535,Nils Hoglander,L,VAN,24,65,14,10,24
21,8482157,Will Cuylle,L,NYR,22,67,14,10,24
21,8477392,Hudson Fasching,R,NYI,29,71,13,11,24
21,8476934,Brock McGinn,L,ANA,30,54,13,11,24
21,8476981,Josh Anderson,R,MTL,30,77,11,13,24
21,8480021,Jack Studnicka,C,LAK,25,67,11,13,24
21,8480144,David Kampf,C,TOR,29,72,10,14,24
21,8481553,Bobby Brink,R,PHI,23,58,9,15,24
21,8477903,Garnet Hathaway,R,PHI,33,63,9,15,24
21,8475149,Marcus Johansson,L,MIN,34,67,8,16,24
21,8481580,Connor McMichael,C,WSH,23,67,8,16,24
21,8476422,Mike Reilly,D,NYI,31,72,8,16,24
21,8473533,Jordan Staal,C,CAR,36,61,7,17,24
21,8478911,Matt Roy,D,WSH,29,63,6,18,24
21,8474716,Jared Spurgeon,D,MIN,35,75,4,20,24
21,8482067,Connor Mackey,D,NYR,28,57,4,20,24
21,8479402,Jake Bean,D,CGY,26,65,2,22,24
21,8478840,Will Borgen,D,SEA,28,65,1,23,24
21,8479336,Carl Grundstrom,R,SJS,27,54,12,11,23
21,8479368,Max Jones,L,BOS,26,64,12,11,23
21,8470621,Corey Perry,R,EDM,39,73,10,13,23
21,8483565,Nick Blankenburg,D,NSH,26,58,7,16,23
21,8483490,Pavel Mintyukov,D,ANA,21,75,6,17,23
21,8477948,Travis Sanheim,D,PHI,28,66,5,18,23
21,8481014,Alexander Romanov,D,NYI,24,76,5,18,23
21,8480878,Nils Lundkvist,D,DAL,24,76,5,18,23
21,8480873,Rasmus Sandin,D,WSH,24,67,4,19,23
21,8478851,Alexandre Carrier,D,NSH,28,70,4,19,23
21,8480049,Dylan Samberg,D,WPG,25,68,3,20,23
21,8476892,Colton Parayko,D,STL,31,73,2,21,23
21,8476902,Esa Lindell,D,DAL,30,76,2,21,23
21,8480281,Alexey Toropchenko,R,STL,25,57,13,9,22
21,8477839,Conor Sheary,L,TBL,32,81,11,11,22
21,8476918,Jimmy Vesey,L,NYR,31,58,10,12,22
21,8483445,Cutter Gauthier,L,ANA,20,58,8,14,22
21,8482101,Danil Gushchin,L,SJS,22,62,6,16,22
21,8473563,Nicklas Backstrom,C,WSH,37,51,5,17,22
21,8478882,Vladislav Gavrikov,D,LAK,29,65,5,17,22
21,8481178,Egor Zamula,D,PHI,24,60,5,17,22
21,8476897,Oskar Sundqvist,C,STL,30,64,4,18,22
21,8482073,Braden Schneider,D,NYR,23,64,4,18,22
21,8477220,Nate Schmidt,D,FLA,33,61,4,18,22
21,8482142,Jamie Drysdale,D,PHI,22,69,3,19,22
21,8479324,Ryan Lindgren,D,NYR,26,71,3,19,22
21,8476891,Matthew Grzelcyk,D,PIT,30,74,2,20,22
21,8476331,Dylan DeMelo,D,WPG,31,66,2,20,22
21,8480289,Morgan Barron,C,WPG,26,59,13,8,21
21,8482125,Alexander Holtz,R,VGK,22,68,11,10,21
21,8480789,Oliver Wahlstrom,R,NYI,24,68,10,11,21
21,8480835,Jack Drury,C,CAR,24,56,10,11,21
21,8477508,Curtis Lazar,C,NJD,29,57,9,12,21
21,8479661,Tanner Jeannot,L,LAK,27,78,8,13,21
21,8476467,Jamie Oleksiak,D,SEA,32,63,5,16,21
21,8482624,Daniil Miromanov,D,CGY,27,66,5,16,21
21,8477435,Ryan Graves,D,PIT,29,74,5,16,21
21,8474151,Ryan McDonagh,D,TBL,35,77,4,17,21
21,8480860,Kevin Bahl,D,CGY,24,60,3,18,21
21,8478507,John Marino,D,UTA,27,63,2,19,21
21,8476278,Colin Blackwell,C,DAL,31,77,13,7,20
21,8476374,Sean Kuraly,C,CBJ,31,58,12,8,20
21,8476889,Radek Faksa,C,STL,30,61,12,8,20
21,8477952,Robby Fabbri,C,ANA,28,58,11,9,20
21,8480205,Emil Bemstrom,C,PIT,25,52,10,10,20
21,8481704,Juuso Parssinen,C,NSH,23,61,9,11,20
21,8482737,Zack Bolduc,C,STL,21,56,9,11,20
21,8476822,Luke Glendening,C,TBL,35,80,9,11,20
21,8476856,Mathew Dumba,D,DAL,30,65,8,12,20
21,8478133,Jake Evans,C,MTL,28,70,6,14,20
21,8479639,Dylan Coghlan,D,WPG,26,66,5,15,20
21,8479982,Conor Timmins,D,TOR,26,65,4,16,20
21,8479983,Mario Ferraro,D,SJS,26,71,3,17,20
21,8477845,Trevor van Riemsdyk,D,WSH,33,57,1,19,20
21,8479941,Justin Danforth,R,CBJ,31,55,12,7,19
21,8479619,Michael Carcone,L,UTA,28,57,12,7,19
21,8478043,Sam Lafferty,C,BUF,29,63,9,10,19
21,8474189,Lars Eller,C,PIT,35,55,8,11,19
21,8476873,Mark Jankowski,C,NSH,30,57,8,11,19
21,8481522,Peyton Krebs,C,BUF,23,63,7,12,19
21,8478432,Christian Fischer,R,DET,27,71,6,13,19
21,8480762,Eric Robinson,L,CAR,29,59,5,14,19
21,8480246,Nick Perbix,D,TBL,26,76,4,15,19
21,8480172,Jan Rutta,D,SJS,34,66,4,15,19
21,8476879,Cody Ceci,D,EDM,31,66,2,17,19
21,8478416,Erik Cernak,D,TBL,27,72,0,19,19
21,8482074,Connor Zary,C,CGY,23,61,14,4,18
21,8478109,Victor Olofsson,L,VGK,29,67,11,7,18
21,8479066,Ryan Lomberg,L,CGY,30,62,10,8,18
21,8479344,Jesse Puljujarvi,R,PIT,26,54,9,9,18
21,8479315,Joey Anderson,R,CHI,26,56,6,12,18
21,8477919,Frederick Gaudreau,C,MIN,31,63,6,12,18
21,8471709,Marc-Edouard Vlasic,D,SJS,37,65,6,12,18
21,8480192,Johnathan Kovacevic,D,NJD,27,60,6,12,18
21,8481019,David Gustafsson,C,WPG,24,47,6,12,18
21,8475790,Erik Gudbranson,D,CBJ,32,75,5,13,18
21,8476457,Adam Larsson,D,SEA,32,69,4,14,18
21,8475855,Jesper Fast,R,CAR,33,53,4,14,18
21,8480035,Henri Jokiharju,D,BUF,25,63,4,14,18
21,8477499,Rasmus Ristolainen,D,PHI,30,58,4,14,18
21,8475462,Radko Gudas,D,ANA,34,66,3,15,18
21,8478569,Noel Acciari,C,PIT,33,56,10,7,17
21,8477979,Nicolas Aube-Kubel,R,BUF,28,59,10,7,17
21,8484149,Gavin Brindley,C,CBJ,20,53,9,8,17
21,8477015,Connor Brown,R,EDM,30,67,8,9,17
21,8481537,Nikita Okhotiuk,D,CGY,24,62,7,10,17
21,8481093,Rafael Harvey-Pinard,L,MTL,25,66,6,11,17
21,8483482,Tristan Luneau,D,ANA,20,57,6,11,17
21,8483466,Kevin Korchinski,D,CHI,20,47,6,11,17
21,8480074,Alexandre Texier,C,STL,25,56,6,11,17
21,8481568,Alex Vlasic,D,CHI,23,54,4,13,17
21,8475188,Brayden McNabb,D,VGK,33,61,4,13,17
21,8482176,Wyatt Kaiser,D,CHI,22,55,4,13,17
21,8478452,Caleb Jones,D,LAK,27,60,3,14,17
21,8480727,Zach Whitecloud,D,VGK,28,56,3,14,17
21,8475181,Nick Leddy,D,STL,33,67,2,15,17
21,8474673,TJ Brodie,D,CHI,34,63,2,15,17
21,8482245,Artem Zub,D,OTT,29,69,2,15,17
21,8481518,Nolan Foote,L,NJD,24,41,12,4,16
21,8480855,Jack McBain,C,UTA,24,63,9,7,16
21,8476624,Barclay Goodrow,C,SJS,31,52,9,7,16
21,8478585,Derek Ryan,C,EDM,38,58,9,7,16
21,8473453,Trevor Lewis,C,LAK,37,77,7,9,16
21,8479439,Jacob MacDonald,D,COL,31,50,7,9,16
21,8475842,Sam Carrick,C,NYR,32,58,7,9,16
21,8482111,Justin Barron,D,MTL,23,64,5,11,16
21,8478211,Dryden Hunt,L,CGY,29,55,5,11,16
21,8482166,Shakir Mukhamadullin,D,SJS,22,60,5,11,16
21,8479976,Juuso Valimaki,D,UTA,26,71,3,13,16
21,8478399,Jonas Siegenthaler,D,NJD,27,58,3,13,16
21,8480796,Martin Fehervary,D,WSH,25,58,3,13,16
21,8470600,Ryan Suter,D,STL,39,63,3,13,16
21,8475208,Brian Dumoulin,D,ANA,33,65,2,14,16
21,8481032,Paul Cotter,C,NJD,25,61,12,3,15
21,8476329,Travis Boyd,C,MIN,31,65,7,8,15
21,8474034,Patrick Maroon,L,CHI,36,43,7,8,15
21,8482749,Joshua Roy,R,MTL,21,62,6,9,15
21,8475220,Marcus Foligno,L,MIN,33,65,6,9,15
21,8479972,Mason Shaw,C,WPG,26,39,6,9,15
21,8482809,Jackson Blake,R,CAR,21,44,5,10,15
21,8480073,Erik Brannstrom,D,COL,25,57,4,11,15
21,8478178,Darren Raddysh,D,TBL,28,71,3,12,15
21,8478136,Jake Middleton,D,MIN,28,77,2,13,15
21,8482859,Zack Ostapchuk,C,OTT,21,55,6,8,14
21,8477380,Jonny Brodzinski,C,NYR,31,51,5,9,14
21,8479994,Jaret Anderson-Dolan,C,WPG,25,40,5,9,14
21,8478468,Jeremy Lauzon,D,NSH,27,52,5,9,14
21,8479291,Kevin Rooney,C,CGY,31,52,4,10,14
21,8475279,Ben Chiarot,D,DET,33,66,4,10,14
21,8476874,Olli Maatta,D,DET,30,64,4,10,14
21,8480070,Ian Mitchell,D,BOS,25,48,3,11,14
21,8483460,David Jiricek,D,CBJ,21,56,3,11,14
21,8476967,Brett Kulak,D,EDM,30,56,2,12,14
21,8476988,Matt Benning,D,SJS,30,66,1,13,14
21,8478859,Niko Mikkola,D,FLA,28,60,1,13,14
21,8475179,Dmitry Kulikov,D,FLA,34,67,0,14,14
21,8480848,Ty Dellandrea,C,SJS,24,37,9,4,13
21,8479520,Brandon Duhaime,R,WSH,27,51,8,5,13
21,8483493,Frank Nazar,C,CHI,20,45,7,6,13
21,8482679,Matt Coronato,R,CGY,22,66,6,7,13
21,8478434,Keegan Kolesar,R,VGK,27,56,6,7,13
21,8480448,Parker Kelly,L,COL,25,71,6,7,13
21,8477931,Tomas Nosek,L,FLA,32,64,6,7,13
21,8482730,Brandt Clarke,D,LAK,21,54,6,7,13
21,8481609,Vladislav Kolyachonok,D,UTA,23,36,6,7,13
21,8479026,Philippe Myers,D,TOR,27,56,5,8,13
21,8482807,Ethan Del Mastro,D,CHI,21,45,5,8,13
21,8479370,Tyson Jost,C,CAR,26,57,5,8,13
21,8480879,Jacob Bernard-Docker,D,OTT,24,53,5,8,13
21,8481477,Nico Sturm,C,SJS,29,50,4,9,13
21,8476525,Colin Miller,D,WPG,32,63,3,10,13
21,8477018,Ben Hutton,D,VGK,31,46,3,10,13
21,8480891,Michael Kesselring,D,UTA,24,49,1,12,13
21,8477406,Mattias Janmark,C,EDM,32,68,1,12,13
21,8478443,Brandon Carlo,D,BOS,28,58,1,12,13
21,8482762,Simon Edvinsson,D,DET,21,60,8,4,12
21,8482062,Cole Smith,L,NSH,29,60,7,5,12
21,8479944,Zach Aston-Reese,C,VGK,30,56,7,5,12
21,8481517,Brett Leason,R,ANA,25,60,7,5,12
21,8477070,Liam O'Brien,C,UTA,30,57,7,5,12
21,8482634,Alex Steeves,C,TOR,25,51,6,6,12
21,8482659,Josh Doan,R,UTA,22,50,5,7,12
21,8479718,Alex Barré-Boulet,C,MTL,27,46,5,7,12
21,8479985,Cale Fleury,D,SEA,26,35,5,7,12
21,8482451,Mikael Pyyhtia,L,CBJ,23,46,4,8,12
21,8481013,Jonatan Berggren,R,DET,24,60,4,8,12
21,8476442,Matt Nieto,L,PIT,32,48,4,8,12
21,8480980,Connor Dewar,C,TOR,25,65,3,9,12
21,8482496,Nils Aman,C,VAN,24,38,3,9,12
21,8476429,Scott Mayfield,D,NYI,32,76,2,10,12
21,8474166,Alec Martinez,D,CHI,37,56,2,10,12
21,8471677,Jack Johnson,D,CBJ,37,73,2,10,12
21,8473446,Erik Johnson,D,PHI,36,48,2,10,12
21,8482192,Isaak Phillips,D,CHI,23,52,1,11,12
21,8475690,Chris Tanev,D,TOR,35,52,0,12,12
21,8477507,Nikita Zadorov,D,BOS,29,70,0,12,12
21,8482145,Mavrik Bourque,C,DAL,22,54,7,4,11
21,8479671,Mathieu Olivier,R,CBJ,27,36,7,4,11
21,8479414,Nathan Bastian,R,NJD,27,57,6,5,11
21,8481641,Joel Kiviranta,L,COL,28,70,6,5,11
21,8477573,Nathan Walker,L,STL,30,52,6,5,11
21,8482077,Dylan Holloway,L,EDM,23,55,6,5,11
21,8481716,Dmitri Voronkov,L,CBJ,24,45,6,5,11
21,8481028,Martin Pospisil,C,CGY,25,46,5,6,11
21,8478451,Ethan Bear,D,WSH,27,47,5,6,11
21,8471817,Ryan Reaves,R,TOR,37,62,5,6,11
21,8481521,Ronnie Attard,D,PHI,25,48,4,7,11
21,8477962,Brendan Lemieux,L,CAR,28,37,4,7,11
21,8482803,Olen Zellweger,D,ANA,21,61,3,8,11
21,8481550,Adam Beckman,L,NJD,23,39,3,8,11
21,8475233,David Savard,D,MTL,34,63,2,9,11
21,8479980,Nicolas Hague,D,VGK,26,55,2,9,11
21,8481751,Lukas Rousek,R,BUF,25,39,2,9,11
21,8480196,Jacob Bryson,D,BUF,27,42,2,9,11
21,8480222,Sebastian Aho,D,PIT,28,66,0,11,11
21,8482751,Ryan Winterton,C,SEA,21,36,7,3,10
21,8479638,Justin Brazeau,R,BOS,26,37,7,3,10
21,8481617,Vasily Podkolzin,R,VAN,23,47,6,4,10
21,8480292,Carson Meyer,R,ANA,27,36,6,4,10
21,8480355,Mark Kastelic,C,BOS,25,62,5,5,10
21,8481754,Nikita Nesterenko,C,ANA,23,35,5,5,10
21,8480845,Rasmus Kupari,C,WPG,24,32,4,6,10
21,8480995,Pontus Holmberg,R,TOR,25,54,4,6,10
21,8479442,Troy Stecher,D,EDM,30,55,4,6,10
21,8479328,Julien Gauthier,R,NYI,27,54,3,7,10
21,8481567,Henry Thrun,D,SJS,23,45,3,7,10
21,8476441,Joel Edmundson,D,LAK,31,42,3,7,10
21,8481708,Zac Jones,D,NYR,24,48,2,8,10
21,8480807,Mattias Samuelsson,D,BUF,24,53,2,8,10
21,8475750,Jon Merrill,D,MIN,32,54,2,8,10
21,8474612,Travis Hamonic,D,OTT,34,43,2,8,10
21,8477365,Connor Clifton,D,BUF,29,51,1,9,10
21,8479998,Mikey Anderson,D,LAK,25,61,1,9,10
21,8475324,Nick Jensen,D,OTT,34,66,1,9,10
21,8474568,Luke Schenn,D,NSH,35,48,1,9,10
21,8474574,Tyler Myers,D,VAN,34,66,0,10,10
21,8477887,Patrick Brown,C,BOS,32,44,7,2,9
21,8482148,Hendrix Lapierre,C,WSH,22,55,6,3,9
21,8478421,A.J. Greer,L,FLA,28,60,5,4,9
21,8482747,Brennan Othmann,L,NYR,21,41,5,4,9
21,8476867,Brendan Gaunce,C,MIN,30,38,5,4,9
21,8479536,Axel Jonsson-Fjallby,L,WPG,26,27,5,4,9
21,8477446,Michael McCarron,R,NSH,29,40,4,5,9
21,8481161,Jake Christiansen,D,CBJ,25,52,4,5,9
21,8480007,Jonas Rondbjerg,R,VGK,25,50,4,5,9
21,8481147,Reese Johnson,C,MIN,26,37,4,5,9
21,8475455,Brenden Dillon,D,NJD,34,61,3,6,9
21,8482155,Alex Laferriere,R,LAK,23,55,3,6,9
21,8480887,Jordan Harris,D,MTL,24,56,3,6,9
21,8483495,Simon Nemec,D,NJD,20,51,2,7,9
21,8479986,Kole Lind,R,DAL,26,46,2,7,9
21,8480011,Klim Kostin,C,SJS,25,54,2,7,9
21,8475718,Justin Holl,D,DET,32,61,1,8,9
21,8476372,Nick Seeler,D,PHI,31,39,1,8,9
21,8482861,Vincent Iorio,D,WSH,22,27,1,8,9
21,8476858,Phillip Di Giuseppe,L,VAN,31,40,7,1,8
21,8477938,Haydn Fleury,D,WPG,28,35,5,3,8
21,8479359,Beck Malenstyn,L,BUF,26,47,4,4,8
21,8482652,Walker Duehr,R,CGY,27,39,4,4,8
21,8481167,Brayden Pachal,D,CGY,25,45,4,4,8
21,8482153,Brendan Brisson,C,VGK,23,32,4,4,8
21,8483549,Lucas Condotta,L,MTL,27,29,3,5,8
21,8474567,Zach Bogosian,D,MIN,34,59,3,5,8
21,8480025,MacKenzie Entwistle,R,FLA,25,62,3,5,8
21,8480844,Grigori Denisenko,L,VGK,24,31,3,5,8
21,8480001,Urho Vaakanainen,D,ANA,25,61,2,6,8
21,8481527,Kaedan Korczak,D,VGK,23,41,2,6,8
21,8481599,Victor Soderstrom,D,UTA,23,48,2,6,8
21,8481605,Jackson LaCombe,D,ANA,23,37,2,6,8
21,8479369,Andrew Peeke,D,BOS,26,60,1,7,8
21,8479378,Logan Stanley,D,WPG,26,45,1,7,8
21,8480950,Ilya Lyubushkin,D,DAL,30,56,1,7,8
21,8474090,Brendan Smith,D,DAL,35,60,1,7,8
21,8479372,Joshua Mahura,D,SEA,26,55,0,8,8
21,8480441,Trey Fix-Wolansky,R,CBJ,25,42,0,8,8
21,8478831,Kevin Stenlund,C,UTA,28,55,5,2,7
21,8481789,Tye Kartye,L,SEA,23,40,5,2,7
21,8478502,Dennis Gilbert,D,BUF,28,23,5,2,7
21,8474013,Ian Cole,D,UTA,35,54,4,3,7
21,8481598,Philip Broberg,D,EDM,23,45,4,3,7
21,8477369,Carson Soucy,D,VAN,30,66,3,4,7
21,8480157,Calle Rosen,D,COL,30,44,3,4,7
21,8479968,Vinni Lettieri,C,BOS,29,40,3,4,7
21,8480890,Jan Jenik,C,OTT,24,34,3,4,7
21,8478146,Matthew Highmore,C,OTT,28,38,3,4,7
21,8478874,Adam Gaudette,R,OTT,28,31,3,4,7
21,8476952,Dominic Toninato,C,WPG,30,42,2,5,7
21,8481592,Jakob Pelletier,L,CGY,23,50,2,5,7
21,8478424,Jansen Harkins,C,ANA,27,40,2,5,7
21,8477335,Kyle Burroughs,D,LAK,29,45,2,5,7
21,8479348,Kale Clague,D,BUF,26,34,2,5,7
21,8482172,Landon Slaggert,L,CHI,22,30,2,5,7
21,8477851,Jordan Oesterle,D,BOS,32,37,1,6,7
21,8480058,Pierre-Olivier Joseph,D,STL,25,50,1,6,7
21,8480252,Cole Guttman,C,CHI,25,31,1,6,7
21,8479249,Andrew Poturalski,C,SJS,30,33,1,6,7
21,8477034,Jaycob Megna,D,FLA,32,44,1,6,7
21,8482744,James Malatesta,L,CBJ,21,37,1,6,7
21,8475762,Derek Forbort,D,VAN,32,44,0,7,7
21,8478409,Anthony Richard,C,PHI,28,26,5,1,6
21,8482147,Jean-Luc Foudy,C,COL,22,31,5,1,6
21,8477482,Zachary Sanford,L,CHI,30,28,4,2,6
21,8482070,Mitchell Chaffee,R,TBL,26,60,4,2,6
21,8482666,Scott Morrow,D,CAR,22,49,3,3,6
21,8482511,Mason Lohrei,D,BOS,23,37,3,3,6
21,8482784,Zach Dean,C,STL,21,39,3,3,6
21,8481679,Maxence Guenette,D,OTT,23,42,3,3,6
21,8475177,Calvin de Haan,D,COL,33,44,2,4,6
21,8482733,Logan Mailloux,D,MTL,31,34,2,4,6
21,8483630,Pavol Regenda,L,ANA,25,19,2,4,6
21,8483512,Matthew Savoie,C,EDM,20,20,2,4,6
21,8481532,Alex Turcotte,C,LAK,23,35,2,4,6
21,8483570,Ben Meyers,C,SEA,26,31,2,4,6
21,8476473,Connor Murphy,D,CHI,31,34,2,4,6
21,8480834,Ty Emberson,D,SJS,24,29,1,5,6
21,8484911,Collin Graf,R,SJS,22,38,3,2,5
21,8481122,Simon Benoit,D,TOR,26,35,3,2,5
21,8482713,Mackie Samoskevich,R,FLA,22,27,3,2,5
21,8481600,Tobias Bjornfot,D,FLA,23,40,2,3,5
21,8482964,Arber Xhekaj,D,MTL,23,45,2,3,5
21,8479379,Givani Smith,R,SJS,26,37,2,3,5
21,8482087,Kaiden Guhle,D,MTL,22,64,1,4,5
21,8479981,Jonah Gadjovich,L,FLA,26,41,1,4,5
21,8479576,Vincent Desharnais,D,VAN,28,34,1,4,5
21,8480990,Declan Chisholm,D,MIN,24,39,1,4,5
21,8482765,Isak Rosen,R,BUF,21,22,1,4,5
21,8482141,Lukas Cormier,D,VGK,22,27,1,4,5
21,8484258,Sam Malinski,D,COL,26,22,1,4,5
21,8484254,Akito Hirose,D,VAN,25,36,0,5,5
21,8482177,Marat Khusnutdinov,C,MIN,22,36,0,5,5
21,8483397,Marc McLaughlin,C,BOS,25,34,4,0,4
21,8479772,Zack MacEwen,R,OTT,28,47,4,0,4
21,8481237,Kyle MacLean,C,NYI,25,20,4,0,4
21,8481556,John Beecher,C,BOS,23,33,3,1,4
21,8482165,Yan Kuznetsov,D,CGY,22,13,3,1,4
21,8481585,Egor Afanasyev,L,SJS,23,15,3,1,4
21,8480245,Olle Lycksell,R,PHI,25,32,2,2,4
21,8480880,Jakub Lauko,C,MIN,24,35,2,2,4
21,8475958,Michael Sgarbossa,C,WSH,32,25,2,2,4
21,8483619,Filip Roos,D,OTT,25,37,2,2,4
21,8482929,Emil Lilleberg,D,TBL,23,17,2,2,4
21,8481743,Marc Del Gaizo,D,NSH,25,19,2,2,4
21,8481422,Jake Lucchini,C,NSH,29,22,2,2,4
21,8478450,Parker Wotherspoon,D,BOS,27,37,1,3,4
21,8481056,Spencer Stastney,D,NSH,24,33,1,3,4
21,8482095,Tyler Kleven,D,OTT,22,40,1,3,4
21,8483763,Maksymilian Szuber,D,UTA,22,24,1,3,4
21,8482470,Ilya Solovyov,D,CGY,24,20,1,3,4
21,8482144,Jack Thompson,D,SJS,22,22,1,3,4
21,8479320,Maxime Lajoie,D,SEA,27,24,1,3,4
21,8477527,Ross Johnston,L,ANA,30,29,1,3,4
21,8480851,Akil Thomas,C,LAK,24,22,1,3,4
21,8478021,William Lagesson,D,DET,28,24,0,4,4
21,8482061,Brandon Biro,L,SEA,26,13,3,0,3
21,8477401,John Hayden,C,SEA,29,26,2,1,3
21,8482516,Matthew Kessel,D,STL,24,22,2,1,3
21,8483395,Arshdeep Bains,L,VAN,23,14,2,1,3
21,8480306,Grant Hutton,D,NYI,29,6,2,1,3
21,8476913,Devin Shore,C,MIN,30,33,2,1,3
21,8478017,Mark Friedman,D,VAN,29,42,1,2,3
21,8483012,Logan Morrison,C,SEA,22,28,1,2,3
21,8481541,Samuel Bolduc,D,NYI,24,26,1,2,3
21,8480870,Bo Groulx,C,NYR,24,30,1,2,3
21,8477244,Chad Ruhwedel,D,NYR,34,36,1,2,3
21,8477073,Kurtis MacDermid,L,NJD,30,32,1,2,3
21,8481806,Louis Crevier,D,CHI,23,15,1,2,3
21,8477320,Anton Blidh,L,NYR,29,23,0,3,3
21,8475795,Dylan McIlrath,D,WSH,32,14,0,3,3
21,8484287,Cole McWard,D,VAN,23,21,0,3,3
21,8477149,Scott Sabourin,R,SJS,32,14,0,3,3
21,8481699,Aku Raty,R,UTA,23,10,0,3,3
21,8479419,Brett Murray,L,BUF,26,20,0,3,3
21,8477473,Justin Bailey,R,SJS,29,26,2,0,2
21,8478477,Mitchell Stephens,C,SEA,27,17,2,0,2
21,8479367,William Lockwood,R,FLA,26,26,2,0,2
21,8481564,Ryan Johnson,D,BUF,23,19,2,0,2
21,8478881,Brett Seney,L,CHI,28,8,2,0,2
21,8477384,Joshua Brown,D,EDM,30,39,1,1,2
21,8480075,Cameron Crotty,D,MIN,25,10,1,1,2
21,8480084,Nick DeSimone,D,NJD,30,16,1,1,2
21,8483471,Brad Lambert,C,WPG,31,10,1,1,2
21,8481024,Linus Karlsson,C,VAN,25,9,1,1,2
21,8482088,Justin Sourdif,R,FLA,22,24,1,1,2
21,8478011,Louie Belpedio,D,PHI,28,16,1,1,2
21,8483432,Luca Del Bel Belluz,C,CBJ,31,5,1,1,2
21,8483609,Adam Klapka,R,CGY,24,5,1,1,2
21,8481701,Santeri Hatakka,D,NJD,23,30,0,2,2
21,8475235,Nicolas Deslauriers,L,PHI,33,47,0,2,2
21,8478454,Noah Juulsen,D,VAN,27,33,0,2,2
21,8482094,Daemon Hunt,D,MIN,22,22,0,2,2
21,8481030,Jack St. Ivany,D,PIT,25,20,0,2,2
21,8482476,Emil Heineman,L,MTL,23,9,0,2,2
21,8481593,Jayden Struble,D,MTL,23,19,1,0,1
21,8479362,Riley Tufte,L,BOS,26,20,1,0,1
21,8478051,Max Willman,C,NJD,29,16,1,0,1
21,8481206,John Ludvig,D,PIT,24,11,1,0,1
21,8480032,Shane Bowers,C,NJD,25,14,1,0,1
21,8479330,Brandon Gignac,C,MTL,27,6,1,0,1
21,8483489,Fraser Minten,C,TOR,31,12,1,0,1
21,8482102,Vasily Ponomarev,C,PIT,22,19,1,0,1
21,8481043,Cole Koepke,L,BOS,26,21,1,0,1
21,8482162,Roby Jarventie,L,EDM,22,16,1,0,1
21,8480823,Alexander Alexeyev,D,WSH,25,14,1,0,1
21,8477993,Justin Kirkland,C,CGY,28,5,1,0,1
21,8479421,Jacob Moverare,D,LAK,26,6,1,0,1
21,8479991,Jake Leschyshyn,C,NYR,25,32,0,1,1
21,8480874,Adam Ginning,D,PHI,24,14,0,1,1
21,8482250,Callahan Burke,C,VGK,27,19,0,1,1
21,8477462,Robert Hagg,D,VGK,29,22,0,1,1
21,8482858,Ryker Evans,D,SEA,23,17,0,1,1
21,8480468,James Hamblin,L,EDM,25,15,0,1,1
21,8481726,Adam Edstrom,C,NYR,24,8,0,1,1
21,8477541,Dakota Mermis,D,TOR,30,5,0,1,1
21,8475413,Justin Dowling,C,NJD,34,14,0,1,1
21,8481006,Tyler Tucker,D,STL,24,8,0,1,1
21,8483567,Georgii Merkulov,C,BOS,24,7,0,1,1
21,8484304,Uvis Balinskis,D,FLA,28,11,0,1,1
21,8475780,Chris Wagner,R,COL,33,10,0,1,1
21,8474062,Riley Nash,C,NYR,35,17,0,1,1
21,8484255,Jason Polin,R,COL,25,3,0,1,1
21,8481655,Cole Schwindt,R,CGY,23,6,0,1,1
21,8477467,Gustav Olofsson,D,SEA,30,16,0,0,0
21,8481543,Nikita Alexandrov,C,STL,24,26,0,0,0
21,8477971,Andreas Englund,D,LAK,28,21,0,0,0
21,8482118,Sam Colangelo,R,ANA,23,19,0,0,0
21,8483597,Milos Kelemen,L,UTA,25,18,0,0,0
21,8481462,Mason Morelli,L,VGK,28,14,0,0,0
21,8478446,Glenn Gawdin,C,LAK,27,8,0,0,0
21,8484325,Waltteri Merela,C,TBL,26,16,0,0,0
21,8482201,Gage Goncalves,C,TBL,23,19,0,0,0
21,8478854,Ryan Shea,D,PIT,27,8,0,0,0
21,8475755,Alexander Petrovic,D,DAL,32,10,0,0,0
21,8479587,Rhett Gardner,C,PHI,28,20,0,0,0
21,8477810,Joel Hanley,D,CGY,33,21,0,0,0
21,8481719,Maxwell Crozier,D,TBL,24,15,0,0,0
21,8480267,Sammy Walker,C,MIN,25,16,0,0,0
21,8483398,Declan Carlile,D,TBL,31,8,0,0,0
21,8483407,Brandon Scanlin,D,NYR,25,6,0,0,0
21,8481065,Angus Crookshank,L,OTT,25,15,0,0,0
21,8482787,Nikita Chibrikov,R,WPG,31,2,0,0,0
21,8482460,Matt Rempe,C,NYR,22,9,0,0,0
21,8481578,Graeme Clarke,R,MIN,23,9,0,0,0
21,8484326,Patrik Koch,D,UTA,28,3,0,0,0
21,8484259,Ondrej Pavel,C,COL,31,3,0,0,0
21,8480274,Philip Kemp,D,EDM,25,3,0,0,0
21,8483546,Marshall Rifai,D,TOR,26,2,0,0,0
21,8483531,Brian Halonen,L,NJD,25,3,0,0,0
21,8483401,Marc Johnstone,R,PIT,28,1,0,0,0
21,8479522,Hardy Haman Aktell,D,WSH,26,4,0,0,0
21,8476323,Max McCormick,L,SEA,32,2,0,0,0
21,8483920,Pierrick Dube,R,WSH,23,5,0,0,0
21,8482197,Adam Raska,R,MIN,23,5,0,0,0
21,8484321,Nikolas Matinpalo,D,OTT,26,1,0,0,0
21,8478147,Bokondji Imama,L,PIT,28,1,0,0,0
21,8481534,Raphael Lavoie,C,EDM,24,2,0,0,0
21,8482126,Emil Andrae,D,PHI,31,4,0,0,0
21,8470794,Joe Pavelski,C,,40,0,0,0,0
21,8479321,Lucas Johansen,D,,27,0,0,0,0
21,8477950,Tony DeAngelo,D,,29,0,0,0,0
21,8471218,Blake Wheeler,R,,38,0,0,0,0
21,8475197,Tyson Barrie,D,,33,0,0,0,0
21,8474157,Max Pacioretty,L,,36,0,0,0,0
21,8475744,Evgeny Kuznetsov,C,,32,0,0,0,0
21,8474037,James van Riemsdyk,L,,35,0,0,0,0
21,8476907,Mackenzie MacEachern,L,,30,0,0,0,0
21,8480216,Jacob Peterson,C,,25,0,0,0,0
21,8474602,Justin Schultz,D,,34,0,0,0,0
21,8482222,Alexander Barabanov,L,,30,0,0,0,0
21,8474031,Kevin Shattenkirk,D,,35,0,0,0,0
21,8477330,Dominik Kubalik,L,,29,0,0,0,0
21,8480884,Calen Addison,D,,24,0,0,0,0
21,8475906,John Klingberg,D,,32,0,0,0,0
21,8480008,Adam Ruzicka,C,,25,0,0,0,0
21,8476884,Derrick Pouliot,D,,30,0,0,0,0
21,8476919,Chris Tierney,C,,30,0,0,0,0
21,8479415,Michael McLeod,C,,26,0,0,0,0
21,8474870,Tyler Johnson,C,,34,0,0,0,0
21,8470604,Jeff Carter,C,,39,0,0,0,0
21,8478104,Sammy Blais,L,,28,0,0,0,0
21,8474884,Mike Hoffman,C,,35,0,0,0,0
21,8481591,Sam Poulin,R,,23,0,0,0,0
21,8471274,Alex Goligoski,D,,39,0,0,0,0
21,8476871,Tanner Pearson,L,,32,0,0,0,0
21,8476393,Nick Cousins,C,,31,0,0,0,0
21,8479977,Kailer Yamamoto,R,,26,0,0,0,0
21,8479346,Dillon Dube,C,,26,0,0,0,0
21,8480184,Gustav Lindstrom,D,,26,0,0,0,0
21,8479376,Victor Mete,D,,26,0,0,0,0
21,8473449,Kyle Okposo,R,,36,0,0,0,0
21,8481058,Jesse Ylonen,R,,25,0,0,0,0
21,8475752,Tyler Pitlick,C,,33,0,0,0,0
21,8481239,Samuel Fagemo,L,,24,0,0,0,0
21,8480821,Filip Zadina,R,,25,0,0,0,0
21,8470966,Mark Giordano,D,,41,0,0,0,0
21,8478495,Denis Gurianov,R,,27,0,0,0,0
21,8477464,Nic Petan,C,,29,0,0,0,0
21,8478099,Kevin Labanc,R,,29,0,0,0,0
21,8482241,Radim Zohorna,L,,28,0,0,0,0
21,8474040,Sam Gagner,C,,35,0,0,0,0
21,8479514,Rem Pitlick,C,,27,0,0,0,0
21,8478430,Oliver Kylington,D,,27,0,0,0,0
21,8479533,Joona Koppanen,L,,26,0,0,0,0
21,8479984,Cal Foote,D,,26,0,0,0,0
21,8477126,Jayson Megna,C,,34,0,0,0,0
21,8475164,Jakob Silfverberg,R,,34,0,0,0,0
21,8474009,Nick Bonino,C,,36,0,0,0,0
21,8479458,Nikita Zaitsev,D,,33,0,0,0,0
21,8477944,Jakub Vrana,L,,28,0,0,0,0
21,8471699,Andrew Cogliano,C,,37,0,0,0,0
21,8478067,Oskar Lindblom,L,,28,0,0,0,0
21,8471686,Marc Staal,D,,37,0,0,0,0
21,8470610,Zach Parise,L,,40,0,0,0,0
21,8478904,Steven Lorentz,C,,28,0,0,0,0
21,8473473,Milan Lucic,L,,36,0,0,0,0
21,8480031,Maxime Comtois,L,,25,0,0,0,0
21,8478512,Austin Czarnik,C,,32,0,0,0,0
21,8473504,Cal Clutterbuck,R,,37,0,0,0,0
21,8477454,Adam Erne,L,,29,0,0,0,0
21,8479383,Boris Katchouk,L,,26,0,0,0,0
21,8475825,Jani Hakanpää,D,,32,0,0,0,0
21,8477846,Ryan Carpenter,C,,33,0,0,0,0
21,8477930,Pierre-Edouard Bellemare,L,,39,0,0,0,0
21,8478400,Colin White,C,,27,0,0,0,0
21,8480226,Marián Studenic,R,,26,0,0,0,0
21,8480853,Liam Foudy,C,,24,0,0,0,0
21,8475797,Jarred Tinordi,D,,32,0,0,0,0
21,8479423,Alex Nylander,L,,26,0,0,0,0
21,8474618,Marco Scandella,D,,34,0,0,0,0
21,8478028,Fredrik Olofsson,L,,28,0,0,0,0
21,8474709,Matt Martin,L,,35,0,0,0,0
21,8481070,Hugh McGing,L,,26,0,0,0,0
21,8479546,Oskar Steen,C,,26,0,0,0,0
21,8474145,Robert Bortuzzo,D,,35,0,0,0,0
21,8476915,Jujhar Khaira,L,,30,0,0,0,0
21,8475278,Byron Froese,C,,33,0,0,0,0
21,8481812,Nikolai Knyzhov,D,,27,0,0,0,0
21,8478408,Travis Dermott,D,,28,0,0,0,0
21,8481077,John Leonard,L,,26,0,0,0,0
21,8479547,Matthew Phillips,R,,26,0,0,0,0
21,8480836,Jonathan Gruden,C,,24,0,0,0,0
21,8481690,Tyler Angle,C,,24,0,0,0,0
21,8475766,Austin Watson,L,,32,0,0,0,0
21,8481016,Ruslan Iskhakov,C,,24,0,0,0,0
21,8478078,Rourke Chartier,C,,28,0,0,0,0
21,8480776,Sheldon Rempal,R,,29,0,0,0,0
21,8478956,Samuel Laberge,L,NJD,27,0,0,0,0
21,8483045,Cameron Butler,R,CBJ,31,2,0,0,0
21,8484314,Jiri Smejkal,L,,28,0,0,0,0
22,8477492,Nathan MacKinnon,C,COL,29,80,58,87,145
22,8478402,Connor McDavid,C,EDM,27,80,40,103,143
22,8476453,Nikita Kucherov,R,TBL,31,82,32,109,141
22,8477956,David Pastrnak,R,BOS,28,79,66,64,130
22,8477934,Leon Draisaitl,C,EDM,29,79,43,76,119
22,8477939,William Nylander,R,TOR,28,79,57,61,118
22,8479318,Auston Matthews,C,TOR,27,77,66,48,114
22,8478483,Mitch Marner,R,TOR,27,81,29,84,113
22,8478420,Mikko Rantanen,R,COL,28,81,54,58,112
22,8477493,Aleksander Barkov,C,FLA,29,80,34,77,111
22,8479314,Matthew Tkachuk,L,FLA,27,81,40,68,108
22,8478550,Artemi Panarin,L,NYR,33,78,38,70,108
22,8476468,J.T. Miller,C,VAN,31,78,35,70,105
22,8474564,Steven Stamkos,C,NSH,34,75,40,62,102
22,8477942,Kevin Fiala,L,LAK,28,81,39,61,100
22,8480012,Elias Pettersson,C,VAN,26,75,42,55,97
22,8478864,Kirill Kaprizov,L,MIN,27,76,44,52,96
22,8477404,Jake Guentzel,C,TBL,30,82,40,55,95
22,8480801,Brady Tkachuk,L,OTT,25,80,45,49,94
22,8480027,Jason Robertson,L,DAL,25,80,32,62,94
22,8475786,Zach Hyman,L,EDM,32,77,50,40,90
22,8477501,Valeri Nichushkin,R,COL,29,82,42,48,90
22,8475166,John Tavares,C,TOR,34,81,40,50,90
22,8481559,Jack Hughes,C,NJD,23,71,29,60,89
22,8480069,Cale Makar,D,COL,26,70,24,64,88
22,8476887,Filip Forsberg,L,NSH,30,74,45,42,87
22,8478010,Brayden Point,C,TBL,28,81,47,38,85
22,8471675,Sidney Crosby,C,PIT,37,78,40,45,85
22,8479407,Jesper Bratt,L,NJD,26,75,27,58,85
22,8480023,Robert Thomas,C,STL,25,74,25,60,85
22,8479542,Brandon Hagel,L,TBL,26,82,40,44,84
22,8476389,Vincent Trocheck,C,NYR,31,80,28,56,84
22,8477933,Sam Reinhart,C,FLA,29,77,40,43,83
22,8478493,Joel Eriksson Ek,C,MIN,27,75,30,53,83
22,8479420,Tage Thompson,C,BUF,27,74,41,41,82
22,8476454,Ryan Nugent-Hopkins,C,EDM,31,77,25,57,82
22,8478445,Mathew Barzal,C,NYI,27,81,23,59,82
22,8480800,Quinn Hughes,D,VAN,25,69,13,69,82
22,8477951,Nick Schmaltz,C,UTA,28,82,25,56,81
22,8477503,Max Domi,C,TOR,29,79,19,62,81
22,8480002,Nico Hischier,C,NJD,25,74,32,48,80
22,8475172,Nazem Kadri,C,CGY,34,78,23,57,80
22,8478414,Timo Meier,R,NJD,28,69,41,38,79
22,8478427,Sebastian Aho,C,CAR,27,74,35,44,79
22,8480830,Andrei Svechnikov,R,CAR,24,76,29,50,79
22,8479323,Adam Fox,D,NYR,26,72,16,63,79
22,8476853,Morgan Rielly,D,TOR,30,70,14,64,78
22,8480865,Noah Dobson,D,NYI,24,79,13,65,78
22,8477409,Carter Verhaeghe,C,FLA,29,76,36,41,77
22,8482116,Tim Stützle,C,OTT,22,77,19,58,77
22,8478403,Jack Eichel,C,VGK,28,73,39,37,76
22,8481557,Matt Boldy,L,MIN,23,72,31,45,76
22,8474141,Patrick Kane,R,DET,36,79,26,50,76
22,8477500,Bo Horvat,C,NYI,29,80,39,36,75
22,8478398,Kyle Connor,L,WPG,28,70,39,35,74
22,8477946,Dylan Larkin,C,DET,28,81,30,44,74
22,8484144,Connor Bedard,C,CHI,19,63,29,45,74
22,8478439,Travis Konecny,R,PHI,27,76,22,52,74
22,8475168,Matt Duchene,C,DAL,33,80,23,50,73
22,8480036,Miro Heiskanen,D,DAL,25,77,18,55,73
22,8481540,Cole Caufield,R,MTL,23,77,39,33,72
22,8477476,Artturi Lehkonen,L,COL,29,81,32,40,72
22,8480208,Drake Batherson,R,OTT,26,79,26,46,72
22,8474600,Roman Josi,D,NSH,34,73,13,59,72
22,8478449,Roope Hintz,C,DAL,28,81,36,35,71
22,8478444,Brock Boeser,R,VAN,27,76,31,40,71
22,8476459,Mika Zibanejad,C,NYR,31,75,29,42,71
22,8478460,Zach Werenski,D,CBJ,27,82,7,64,71
22,8477494,Jonathan Drouin,L,COL,29,82,24,46,70
22,8477960,Adrian Kempe,R,LAK,28,82,21,49,70
22,8476456,Jonathan Huberdeau,C,CGY,31,80,16,54,70
22,8479385,Jordan Kyrou,C,STL,26,74,34,35,69
22,8482740,Wyatt Johnston,C,DAL,21,82,37,31,68
22,8475784,Jeff Skinner,C,EDM,32,77,34,34,68
22,8475913,Mark Stone,R,VGK,32,74,26,42,68
22,8473419,Brad Marchand,L,BOS,36,79,31,36,67
22,8482093,Seth Jarvis,C,CAR,22,74,29,38,67
22,8476448,William Karlsson,C,VGK,31,77,28,39,67
22,8471685,Anze Kopitar,C,LAK,37,80,26,41,67
22,8477402,Pavel Buchnevich,L,STL,29,75,24,43,67
22,8473994,Jamie Benn,L,DAL,35,80,24,43,67
22,8480803,Evan Bouchard,D,EDM,25,79,16,51,67
22,8475151,Kyle Palmieri,C,NYI,33,78,29,37,66
22,8477496,Elias Lindholm,C,BOS,30,79,28,38,66
22,8476462,Dougie Hamilton,D,NJD,31,68,16,50,66
22,8475692,Mats Zuccarello,R,MIN,37,76,11,55,66
22,8477447,Shea Theodore,D,VGK,29,65,16,49,65
22,8482684,Luke Hughes,D,NJD,21,76,8,57,65
22,8479675,Trevor Moore,L,LAK,29,81,33,31,64
22,8476539,Jonathan Marchessault,R,NSH,34,74,32,32,64
22,8478440,Dylan Strome,C,WSH,27,73,24,40,64
22,8476881,Tomas Hertl,C,VGK,31,76,28,35,63
22,8477935,Sam Bennett,C,FLA,28,80,28,35,63
22,8479337,Alex DeBrincat,R,DET,27,81,25,38,63
22,8475170,Brayden Schenn,C,STL,33,76,25,38,63
22,8478975,Mason Marchment,L,DAL,29,81,24,39,63
22,8476346,Johnny Gaudreau,L,CBJ,31,66,16,47,63
22,8471214,Alex Ovechkin,L,WSH,39,75,32,30,62
22,8479343,Clayton Keller,R,UTA,26,80,30,32,62
22,8482665,Matty Beniers,C,SEA,22,69,27,35,62
22,8482110,Dawson Mercer,C,NJD,23,72,29,32,61
22,8483431,Logan Cooley,C,UTA,20,77,28,32,60
22,8476460,Mark Scheifele,C,WPG,31,72,25,35,60
22,8475158,Ryan O'Reilly,C,NSH,33,74,20,40,60
22,8473512,Claude Giroux,R,OTT,36,75,19,41,60
22,8474590,John Carlson,D,WSH,34,71,15,45,60
22,8480839,Rasmus Dahlin,D,BUF,24,69,13,47,60
22,8482109,Alexis Lafrenière,L,NYR,23,75,31,28,59
22,8475794,Tyler Seguin,C,DAL,32,82,28,31,59
22,8482113,Anton Lundell,C,FLA,23,77,23,36,59
22,8478401,Pavel Zacha,C,BOS,27,81,21,38,59
22,8479999,Casey Mittelstadt,C,COL,26,80,12,47,59
22,8477955,Jared McCann,L,SEA,28,70,27,31,58
22,8482699,Dylan Guenther,R,UTA,21,76,25,33,58
22,8480188,Fabian Zetterlund,L,SJS,25,68,21,37,58
22,8473986,Alex Killorn,L,ANA,35,74,17,41,58
22,8474578,Erik Karlsson,D,PIT,34,79,11,47,58
22,8475714,Calle Jarnkrok,C,TOR,33,78,26,31,57
22,8477949,Alex Tuch,R,BUF,28,73,21,36,57
22,8476905,Chandler Stephenson,C,SEA,30,71,13,44,57
22,8478407,Vince Dunn,D,SEA,28,73,13,44,57
22,8479325,Charlie McAvoy,D,BOS,27,70,9,48,57
22,8476906,Shayne Gostisbehere,D,CAR,31,79,8,49,57
22,8475799,Nino Niederreiter,R,WPG,32,70,33,23,56
22,8475810,Bryan Rust,R,PIT,32,74,21,35,56
22,8482159,Tyson Foerster,R,PHI,22,75,19,37,56
22,8479425,Filip Hronek,D,VAN,27,72,10,46,56
22,8478366,Frank Vatrano,R,ANA,30,74,31,24,55
22,8478873,Troy Terry,R,ANA,27,67,22,33,55
22,8478856,Conor Garland,R,VAN,28,71,21,34,55
22,8475754,Brock Nelson,C,NYI,33,79,20,35,55
22,8474679,Gustav Nyquist,C,NSH,35,74,19,36,55
22,8480039,Martin Necas,C,CAR,25,73,19,36,55
22,8475167,Victor Hedman,D,TBL,34,81,14,41,55
22,8477504,Josh Morrissey,D,WPG,29,74,7,48,55
22,8476432,Boone Jenner,C,CBJ,31,74,31,23,54
22,8481560,Arthur Kaliyev,R,LAK,23,79,29,25,54
22,8476399,Blake Coleman,C,CGY,33,78,27,27,54
22,8478047,Michael Bunting,L,PIT,29,73,22,32,54
22,8474150,Mikael Backlund,C,CGY,35,76,20,34,54
22,8478519,Anthony Cirelli,C,TBL,27,82,15,39,54
22,8477426,Nicholas Paul,L,TBL,29,82,32,21,53
22,8475726,Tyler Toffoli,C,SJS,32,73,27,26,53
22,8471215,Evgeni Malkin,C,PIT,38,70,25,28,53
22,8483515,Juraj Slafkovsky,L,MTL,20,69,24,29,53
22,8484153,Leo Carlsson,C,ANA,20,68,21,32,53
22,8477986,Brandon Montour,D,SEA,30,70,20,33,53
22,8476875,Mike Matheson,D,MTL,30,67,16,37,53
22,8481528,Dylan Cozens,C,BUF,23,77,15,38,53
22,8481068,Yegor Sharangovich,C,CGY,26,76,28,24,52
22,8477511,Anthony Mantha,R,CGY,30,75,26,26,52
22,8477932,Aaron Ekblad,D,FLA,28,66,17,35,52
22,8480014,Gabriel Vilardi,C,WPG,25,64,31,20,51
22,8480015,Owen Tippett,R,PHI,25,73,27,24,51
22,8477407,Anthony Duclair,L,NYI,29,75,26,25,51
22,8478542,Evan Rodrigues,C,FLA,31,77,23,28,51
22,8475765,Vladimir Tarasenko,R,DET,33,80,22,29,51
22,8475169,Evander Kane,L,EDM,33,74,26,24,50
22,8478498,Jake DeBrusk,L,VAN,28,75,25,25,50
22,8479525,Ross Colton,C,COL,28,82,25,25,50
22,8474149,Evgenii Dadonov,R,DAL,35,80,23,27,50
22,8482124,Quinton Byfield,R,LAK,22,81,14,36,50
22,8482078,Lucas Raymond,L,DET,22,81,13,37,50
22,8474565,Alex Pietrangelo,D,VGK,34,66,11,39,50
22,8479410,Mikhail Sergachev,D,UTA,26,72,8,42,50
22,8477998,Warren Foegele,L,LAK,28,80,27,22,49
22,8480064,Josh Norris,C,OTT,25,71,25,24,49
22,8474641,Adam Henrique,C,EDM,34,75,23,26,49
22,8477940,Nikolaj Ehlers,L,WPG,28,69,22,27,49
22,8474053,Logan Couture,C,SJS,35,61,19,30,49
22,8482745,Mason McTavish,C,ANA,21,70,18,31,49
22,8477444,Andre Burakovsky,L,SEA,29,70,18,31,49
22,8480018,Nick Suzuki,C,MTL,25,75,13,36,49
22,8475184,Chris Kreider,L,NYR,33,74,30,18,48
22,8482720,Matthew Knies,L,TOR,22,77,26,22,48
22,8475191,Reilly Smith,R,NYR,33,74,18,30,48
22,8475745,Charlie Coyle,C,BOS,32,77,18,30,48
22,8478462,Nicolas Roy,C,VGK,27,73,12,36,48
22,8475314,Anders Lee,L,NYI,34,73,26,21,47
22,8478438,Tommy Novak,C,NSH,27,72,22,25,47
22,8474102,David Perron,L,OTT,36,80,21,26,47
22,8475760,Nick Bjugstad,C,UTA,32,75,19,28,47
22,8477021,Alex Kerfoot,C,UTA,30,77,17,30,47
22,8481533,Trevor Zegras,C,ANA,23,69,15,32,47
22,8476792,Torey Krug,D,STL,33,74,12,35,47
22,8478397,Rasmus Andersson,D,CGY,28,68,12,35,47
22,8475753,Justin Faulk,D,STL,32,75,10,37,47
22,8474563,Drew Doughty,D,LAK,35,76,8,39,47
22,8477416,Oliver Bjorkstrand,R,SEA,29,78,23,23,46
22,8484166,Adam Fantilli,C,CBJ,20,72,22,24,46
22,8476882,Teuvo Teravainen,C,CHI,30,65,17,29,46
22,8476479,Phillip Danault,C,LAK,31,78,16,30,46
22,8477495,Seth Jones,D,CHI,30,70,7,39,46
22,8475793,Ryan Johansen,C,PHI,32,75,22,23,45
22,8482097,Jack Quinn,R,BUF,23,64,19,26,45
22,8477456,J.T. Compher,L,DET,29,81,19,26,45
22,8477964,Ivan Barbashev,C,VGK,29,79,15,30,45
22,8481596,Shane Pinto,C,OTT,24,78,15,30,45
22,8476869,Brady Skjei,D,NSH,30,72,9,36,45
22,8479345,Jakob Chychrun,D,WSH,26,63,8,37,45
22,8479987,Morgan Geekie,C,BOS,26,75,19,25,44
22,8479400,Pierre-Luc Dubois,L,WSH,26,73,18,26,44
22,8483808,Andrei Kuzmenko,L,CGY,28,74,14,30,44
22,8480871,Adam Boqvist,D,FLA,24,72,14,30,44
22,8480009,Eeli Tolvanen,R,SEA,25,71,21,22,43
22,8476483,Rickard Rakell,R,PIT,31,73,19,24,43
22,8476292,Ondrej Palat,L,NJD,33,73,19,24,43
22,8478115,Pierre Engvall,L,NYI,28,74,19,24,43
22,8481604,Pavel Dorofeyev,L,VGK,24,76,18,25,43
22,8481711,Matias Maccelli,L,UTA,24,74,16,27,43
22,8483505,Matthew Poitras,C,BOS,20,71,16,27,43
22,8481581,Thomas Harley,D,DAL,23,78,11,32,43
22,8474715,Cameron Atkinson,R,TBL,35,81,18,24,42
22,8480797,Joel Farabee,L,PHI,24,73,17,25,42
22,8478472,Mathieu Joseph,R,STL,27,72,17,25,42
22,8474586,Jordan Eberle,R,SEA,34,77,16,26,42
22,8475218,Mattias Ekholm,D,EDM,34,76,10,32,42
22,8478474,Lawson Crouse,L,UTA,27,73,21,20,41
22,8480078,Filip Chytil,C,NYR,25,67,17,24,41
22,8475763,Kevin Hayes,R,PIT,32,68,16,25,41
22,8477498,Darnell Nurse,D,EDM,29,74,15,26,41
22,8477451,Ryan Hartman,R,MIN,30,67,13,28,41
22,8475764,Cam Fowler,D,ANA,33,74,5,36,41
22,8470613,Brent Burns,D,CAR,39,73,19,21,40
22,8476392,Adam Lowry,C,WPG,31,70,18,22,40
22,8479339,Patrik Laine,L,CBJ,26,72,15,25,40
22,8476872,Scott Laughton,C,PHI,30,74,13,27,40
22,8480798,Philipp Kurashev,C,CHI,25,64,13,27,40
22,8478038,Devon Toews,D,COL,30,69,11,29,40
22,8480185,Eetu Luostarinen,C,FLA,26,71,11,29,40
22,8476826,Yanni Gourde,C,SEA,33,74,10,30,40
22,8482712,Oskar Olausson,R,COL,22,79,10,30,40
22,8481542,Moritz Seider,D,DET,23,78,8,32,40
22,8476474,Stefan Noesen,R,NJD,31,69,22,17,39
22,8482149,Cole Perfetti,C,WPG,22,67,18,21,39
22,8480028,Morgan Frost,C,PHI,25,70,16,23,39
22,8479393,Noah Gregor,L,OTT,26,72,15,24,39
22,8475798,Mikael Granlund,C,SJS,32,69,14,25,39
22,8476458,Ryan Strome,C,ANA,31,70,14,25,39
22,8478042,Viktor Arvidsson,L,EDM,31,75,12,27,39
22,8477346,MacKenzie Weegar,D,CGY,30,69,9,30,39
22,8478466,Daniel Sprong,R,VAN,27,74,19,19,38
22,8476927,Teddy Blueger,C,VAN,30,71,16,22,38
22,8475768,Jaden Schwartz,C,SEA,32,73,13,25,38
22,8471724,Kris Letang,D,PIT,37,81,8,30,38
22,8475722,Jason Zucker,L,BUF,32,69,18,19,37
22,8481618,Alex Newhook,C,MTL,23,70,18,19,37
22,8482092,Ridly Greig,C,OTT,22,79,18,19,37
22,8478458,John (Jack) Roslovic,C,CAR,27,67,15,22,37
22,8477429,Andrew Copp,C,DET,30,80,14,23,37
22,8476419,Jean-Gabriel Pageau,C,NYI,32,70,11,26,37
22,8476463,Jonas Brodin,D,MIN,31,77,8,29,37
22,8480817,K'Andre Miller,D,NYR,24,64,7,30,37
22,8478469,Thomas Chabot,D,OTT,27,73,6,31,37
22,8481606,Jordan Spence,D,LAK,23,72,4,33,37
22,8475149,Marcus Johansson,L,MIN,34,64,17,19,36
22,8475287,Erik Haula,L,NJD,33,71,16,20,36
22,8479351,Sam Steel,C,DAL,26,78,14,22,36
22,8478055,Gustav Forsling,D,FLA,28,76,12,24,36
22,8482667,William Eklund,L,SJS,22,66,12,24,36
22,8477839,Conor Sheary,L,TBL,32,81,12,24,36
22,8475200,Dmitry Orlov,D,CAR,33,75,11,25,36
22,8477488,Brett Pesce,D,NJD,30,75,9,27,36
22,8477948,Travis Sanheim,D,PHI,28,67,7,29,36
22,8480829,Jesperi Kotkaniemi,C,CAR,24,65,22,13,35
22,8476981,Josh Anderson,R,MTL,30,75,17,18,35
22,8480068,Ryan Poehling,C,PHI,25,70,14,21,35
22,8479365,Trent Frederic,C,BOS,26,78,13,22,35
22,8476880,Tom Wilson,R,WSH,30,70,12,23,35
22,8481523,Kirby Dach,C,MTL,23,64,12,23,35
22,8480434,Sean Durzi,D,UTA,26,66,6,29,35
22,8480336,Sean Walker,D,CAR,30,71,6,29,35
22,8482122,Brock Faber,D,MIN,22,79,5,30,35
22,8477479,Tyler Bertuzzi,L,CHI,29,61,20,14,34
22,8479992,Michael Rasmussen,C,DET,25,80,19,15,34
22,8481535,Nils Hoglander,L,VAN,24,61,18,16,34
22,8471698,T.J. Oshie,R,WSH,38,67,16,18,34
22,8482117,Lukas Reichel,L,CHI,22,60,16,18,34
22,8479661,Tanner Jeannot,L,LAK,27,81,16,18,34
22,8482660,Kent Johnson,C,CBJ,22,57,15,19,34
22,8482702,Logan Stankoven,C,DAL,21,81,14,20,34
22,8481577,Philip Tomasino,C,NSH,23,66,13,21,34
22,8477497,Sean Monahan,C,CBJ,30,66,10,24,34
22,8476854,Hampus Lindholm,D,BOS,30,74,8,26,34
22,8480043,Timothy Liljegren,D,TOR,25,67,4,30,34
22,8482146,Luke Evangelista,R,NSH,22,64,19,14,33
22,8481554,Kaapo Kakko,R,NYR,23,73,16,17,33
22,8476921,Jordan Martinook,L,CAR,32,63,15,18,33
22,8478891,Mason Appleton,C,WPG,28,67,9,24,33
22,8478396,Noah Hanifin,D,VGK,27,56,7,26,33
22,8476931,Jake McCabe,D,TOR,31,66,2,31,33
22,8477969,Marcus Pettersson,D,PIT,28,78,1,32,33
22,8479390,Taylor Raddysh,R,WSH,26,67,19,13,32
22,8480995,Pontus Holmberg,R,TOR,25,66,18,14,32
22,8477505,Alexander Wennberg,C,SJS,30,66,17,15,32
22,8478046,Danton Heinen,L,VAN,29,75,16,16,32
22,8480220,Noah Cates,L,PHI,25,71,13,19,32
22,8481524,Bowen Byram,D,BUF,23,72,12,20,32
22,8481186,Logan O'Connor,R,COL,28,80,12,20,32
22,8476480,Vladislav Namestnikov,C,WPG,32,69,9,23,32
22,8476923,Damon Severson,D,CBJ,30,82,5,27,32
22,8483490,Pavel Mintyukov,D,ANA,21,71,5,27,32
22,8484145,Zach Benson,L,BUF,19,67,15,16,31
22,8479591,Michael Eyssimont,C,TBL,28,80,15,16,31
22,8478434,Keegan Kolesar,R,VGK,27,65,14,17,31
22,8481546,Cam York,D,PHI,23,63,10,21,31
22,8475848,Brendan Gallagher,R,MTL,32,69,10,21,31
22,8480802,Ryan McLeod,C,BUF,25,59,9,22,31
22,8476469,Joel Armia,R,MTL,31,74,15,15,30
22,8480459,Pius Suter,C,VAN,28,65,12,18,30
22,8478413,Jordan Greenway,L,BUF,27,63,11,19,30
22,8477425,Miles Wood,L,COL,29,69,11,19,30
22,8474574,Tyler Myers,D,VAN,34,68,5,25,30
22,8480873,Rasmus Sandin,D,WSH,24,59,4,26,30
22,8480806,Isac Lundestrom,C,ANA,25,62,17,12,29
22,8470621,Corey Perry,R,EDM,39,71,17,12,29
22,8478109,Victor Olofsson,L,VGK,29,71,16,13,29
22,8478057,Dakota Joshua,C,VAN,28,65,15,14,29
22,8476461,Sean Couturier,C,PHI,32,66,14,15,29
22,8479316,Luke Kunin,C,SJS,27,59,14,15,29
22,8476278,Colin Blackwell,C,DAL,31,77,14,15,29
22,8484203,Bradly Nadeau,L,CAR,19,62,12,17,29
22,8473422,Nick Foligno,L,CHI,37,62,12,17,29
22,8476925,Colton Sissons,C,NSH,31,67,12,17,29
22,8476885,Jacob Trouba,D,NYR,30,72,11,18,29
22,8474716,Jared Spurgeon,D,MIN,35,75,11,18,29
22,8475193,Tomas Tatar,L,NJD,34,67,9,20,29
22,8480144,David Kampf,C,TOR,29,70,9,20,29
22,8478911,Matt Roy,D,WSH,29,69,9,20,29
22,8482111,Justin Barron,D,MTL,23,68,7,22,29
22,8478416,Erik Cernak,D,TBL,27,71,5,24,29
22,8476438,Brandon Saad,L,STL,32,68,17,11,28
22,8479293,Brandon Tanev,L,SEA,33,63,16,12,28
22,8478432,Christian Fischer,R,DET,27,73,13,15,28
22,8477919,Frederick Gaudreau,C,MIN,31,66,12,16,28
22,8482624,Daniil Miromanov,D,CGY,27,67,8,20,28
22,8481656,Aliaksei Protas,C,WSH,23,71,7,21,28
22,8481014,Alexander Romanov,D,NYI,24,79,7,21,28
22,8482133,Thomas Bordeleau,C,SJS,22,65,4,24,28
22,8479982,Conor Timmins,D,TOR,26,67,4,24,28
22,8482089,Jake Neighbours,L,STL,22,63,18,9,27
22,8481553,Bobby Brink,R,PHI,23,68,13,14,27
22,8482671,Owen Power,D,BUF,22,64,9,18,27
22,8477506,Ryan Pulock,D,NYI,30,78,2,25,27
22,8478840,Will Borgen,D,SEA,28,64,2,25,27
22,8482475,Yegor Chinakhov,R,CBJ,23,64,16,10,26
22,8483524,Shane Wright,C,SEA,20,63,14,12,26
22,8481582,Nicholas Robertson,L,TOR,23,69,14,12,26
22,8480855,Jack McBain,C,UTA,24,67,12,14,26
22,8482062,Cole Smith,L,NSH,29,55,10,16,26
22,8478013,Jake Walman,D,SJS,28,73,9,17,26
22,8478507,John Marino,D,UTA,27,67,5,21,26
22,8479976,Juuso Valimaki,D,UTA,26,69,5,21,26
22,8482087,Kaiden Guhle,D,MTL,22,61,5,21,26
22,8480145,Neal Pionk,D,WPG,29,71,3,23,26
22,8476958,Jaccob Slavin,D,CAR,30,75,2,24,26
22,8482055,Drew O'Connor,L,PIT,26,63,17,8,25
22,8482259,Bobby McMann,C,TOR,28,62,15,10,25
22,8482679,Matt Coronato,R,CGY,22,69,15,10,25
22,8477987,Ryan Donato,C,CHI,28,64,14,11,25
22,8480113,Alex Iafallo,L,WPG,31,70,13,12,25
22,8482079,Marco Rossi,C,MIN,23,58,13,12,25
22,8476374,Sean Kuraly,C,CBJ,31,59,12,13,25
22,8477947,Sonny Milano,L,WSH,28,67,10,15,25
22,8480748,Kiefer Sherwood,L,VAN,29,54,10,15,25
22,8476979,Erik Gustafsson,D,DET,32,76,8,17,25
22,8478133,Jake Evans,C,MTL,28,70,8,17,25
22,8477380,Jonny Brodzinski,C,NYR,31,45,8,17,25
22,8481019,David Gustafsson,C,WPG,24,48,7,18,25
22,8480074,Alexandre Texier,C,STL,25,59,7,18,25
22,8475324,Nick Jensen,D,OTT,34,73,7,18,25
22,8476467,Jamie Oleksiak,D,SEA,32,65,6,19,25
22,8481441,Joe Snively,C,DET,28,71,5,20,25
22,8480878,Nils Lundkvist,D,DAL,24,73,5,20,25
22,8479619,Michael Carcone,L,UTA,28,64,14,10,24
22,8476918,Jimmy Vesey,L,NYR,31,68,13,11,24
22,8482175,JJ Peterka,R,BUF,22,71,12,12,24
22,8476878,Zemgus Girgensons,C,TBL,30,80,10,14,24
22,8477953,Kasperi Kapanen,R,STL,28,72,10,14,24
22,8476422,Mike Reilly,D,NYI,31,73,10,14,24
22,8474189,Lars Eller,C,PIT,35,65,10,14,24
22,8480849,Barrett Hayton,C,UTA,24,69,8,16,24
22,8477508,Curtis Lazar,C,NJD,29,60,8,16,24
22,8482809,Jackson Blake,R,CAR,21,57,8,16,24
22,8481703,Valtteri Puustinen,R,PIT,25,59,7,17,24
22,8482105,Jake Sanderson,D,OTT,22,71,7,17,24
22,8482142,Jamie Drysdale,D,PHI,22,62,7,17,24
22,8479639,Dylan Coghlan,D,WPG,26,65,7,17,24
22,8479996,Cody Glass,C,NSH,25,59,4,20,24
22,8479402,Jake Bean,D,CGY,26,72,3,21,24
22,8476902,Esa Lindell,D,DAL,30,73,3,21,24
22,8474151,Ryan McDonagh,D,TBL,35,81,3,21,24
22,8480049,Dylan Samberg,D,WPG,25,68,2,22,24
22,8475233,David Savard,D,MTL,34,64,1,23,24
22,8480893,Kirill Marchenko,R,CBJ,24,59,14,9,23
22,8480281,Alexey Toropchenko,R,STL,25,51,12,11,23
22,8476822,Luke Glendening,C,TBL,35,81,12,11,23
22,8479941,Justin Danforth,R,CBJ,31,62,12,11,23
22,8477979,Nicolas Aube-Kubel,R,BUF,28,59,12,11,23
22,8480003,Jesper Boqvist,C,FLA,26,72,11,12,23
22,8478233,Andrew Mangiapane,L,WSH,28,64,10,13,23
22,8480205,Emil Bemstrom,C,PIT,25,61,10,13,23
22,8482705,Cole Sillinger,C,CBJ,21,60,9,14,23
22,8477989,Christian Dvorak,C,MTL,28,67,9,14,23
22,8481481,Blake Lizotte,C,PIT,27,62,9,14,23
22,8479368,Max Jones,L,BOS,26,63,8,15,23
22,8473563,Nicklas Backstrom,C,WSH,37,50,7,16,23
22,8476429,Scott Mayfield,D,NYI,32,76,7,16,23
22,8477446,Michael McCarron,R,NSH,29,53,7,16,23
22,8476457,Adam Larsson,D,SEA,32,69,5,18,23
22,8475231,Casey Cizikas,C,NYI,33,69,4,19,23
22,8481178,Egor Zamula,D,PHI,24,57,4,19,23
22,8477952,Robby Fabbri,C,ANA,28,54,12,10,22
22,8477015,Connor Brown,R,EDM,30,64,12,10,22
22,8475842,Sam Carrick,C,NYR,32,59,12,10,22
22,8478463,Anthony Beauvillier,L,PIT,27,61,11,11,22
22,8483499,Liam Ohgren,L,MIN,20,55,11,11,22
22,8483445,Cutter Gauthier,L,ANA,20,62,11,11,22
22,8482737,Zack Bolduc,C,STL,21,59,10,12,22
22,8481522,Peyton Krebs,C,BUF,23,60,9,13,22
22,8475855,Jesper Fast,R,CAR,33,58,9,13,22
22,8475791,Taylor Hall,L,CHI,33,59,8,14,22
22,8476856,Mathew Dumba,D,DAL,30,74,5,17,22
22,8478500,Ivan Provorov,D,CBJ,27,79,3,19,22
22,8480813,Joe Veleno,C,DET,24,79,12,9,21
22,8480980,Connor Dewar,C,TOR,25,66,12,9,21
22,8476858,Phillip Di Giuseppe,L,VAN,31,42,12,9,21
22,8483457,Lane Hutson,D,MTL,20,65,9,12,21
22,8482101,Danil Gushchin,L,SJS,22,58,9,12,21
22,8478970,Jalen Chatfield,D,CAR,28,73,8,13,21
22,8476917,Adam Pelech,D,NYI,30,80,7,14,21
22,8480835,Jack Drury,C,CAR,24,54,7,14,21
22,8480035,Henri Jokiharju,D,BUF,25,61,7,14,21
22,8475343,Nic Dowd,C,WSH,34,60,6,15,21
22,8478882,Vladislav Gavrikov,D,LAK,29,73,5,16,21
22,8473507,Jeff Petry,D,DET,37,70,4,17,21
22,8479324,Ryan Lindgren,D,NYR,26,64,4,17,21
22,8476879,Cody Ceci,D,EDM,31,70,4,17,21
22,8475171,Oliver Ekman-Larsson,D,TOR,33,64,3,18,21
22,8477435,Ryan Graves,D,PIT,29,78,2,19,21
22,8476892,Colton Parayko,D,STL,31,66,1,20,21
22,8479414,Nathan Bastian,R,NJD,27,57,12,8,20
22,8482125,Alexander Holtz,R,VGK,22,67,11,9,20
22,8481093,Rafael Harvey-Pinard,L,MTL,25,54,11,9,20
22,8481032,Paul Cotter,C,NJD,25,55,11,9,20
22,8481601,Simon Holmstrom,R,NYI,23,67,9,11,20
22,8476873,Mark Jankowski,C,NSH,30,55,9,11,20
22,8479315,Joey Anderson,R,CHI,26,54,9,11,20
22,8483482,Tristan Luneau,D,ANA,20,63,8,12,20
22,8482749,Joshua Roy,R,MTL,21,59,8,12,20
22,8482803,Olen Zellweger,D,ANA,21,61,8,12,20
22,8477353,Tyler Motte,C,DET,29,73,6,14,20
22,8477499,Rasmus Ristolainen,D,PHI,30,62,6,14,20
22,8480073,Erik Brannstrom,D,COL,25,67,5,15,20
22,8479371,Dante Fabbro,D,NSH,26,62,4,16,20
22,8483468,Jiri Kulich,C,BUF,20,56,4,16,20
22,8478443,Brandon Carlo,D,BOS,28,62,3,17,20
22,8474166,Alec Martinez,D,CHI,37,53,3,17,20
22,8479026,Philippe Myers,D,TOR,27,52,2,18,20
22,8474673,TJ Brodie,D,CHI,34,64,1,19,20
22,8477450,Jason Dickinson,C,CHI,29,48,11,8,19
22,8481580,Connor McMichael,C,WSH,23,60,11,8,19
22,8478508,Yakov Trenin,C,MIN,27,65,10,9,19
22,8482074,Connor Zary,C,CGY,23,65,10,9,19
22,8478020,Michael Amadio,R,OTT,28,75,9,10,19
22,8482730,Brandt Clarke,D,LAK,21,47,8,11,19
22,8482245,Artem Zub,D,OTT,29,70,6,13,19
22,8477931,Tomas Nosek,L,FLA,32,56,6,13,19
22,8475179,Dmitry Kulikov,D,FLA,34,65,4,15,19
22,8479370,Tyson Jost,C,CAR,26,54,4,15,19
22,8480289,Morgan Barron,C,WPG,26,50,3,16,19
22,8475462,Radko Gudas,D,ANA,34,62,3,16,19
22,8482655,Janis Moser,D,TBL,24,74,2,17,19
22,8479353,Brett Howden,C,VGK,26,66,9,9,18
22,8481624,Ilya Mikheyev,R,CHI,30,58,7,11,18
22,8480246,Nick Perbix,D,TBL,26,75,6,12,18
22,8481550,Adam Beckman,L,NJD,23,37,5,13,18
22,8482067,Connor Mackey,D,NYR,28,63,4,14,18
22,8478178,Darren Raddysh,D,TBL,28,72,4,14,18
22,8481708,Zac Jones,D,NYR,24,56,4,14,18
22,8480950,Ilya Lyubushkin,D,DAL,30,57,4,14,18
22,8480252,Cole Guttman,C,CHI,25,49,4,14,18
22,8479998,Mikey Anderson,D,LAK,25,58,3,15,18
22,8478399,Jonas Siegenthaler,D,NJD,27,58,2,16,18
22,8476331,Dylan DeMelo,D,WPG,31,67,1,17,18
22,8482192,Isaak Phillips,D,CHI,23,57,1,17,18
22,8481059,Scott Perunovich,D,STL,26,60,0,18,18
22,8483491,Ivan Miroshnichenko,L,WSH,20,44,11,6,17
22,8476897,Oskar Sundqvist,C,STL,30,57,9,8,17
22,8477478,William Carrier,L,CAR,30,59,8,9,17
22,8473533,Jordan Staal,C,CAR,36,56,8,9,17
22,8470600,Ryan Suter,D,STL,39,64,8,9,17
22,8476960,Andreas Athanasiou,C,CHI,30,51,7,10,17
22,8482157,Will Cuylle,L,NYR,22,62,7,10,17
22,8478851,Alexandre Carrier,D,NSH,28,71,7,10,17
22,8483565,Nick Blankenburg,D,NSH,26,64,5,12,17
22,8481527,Kaedan Korczak,D,VGK,23,52,5,12,17
22,8480727,Zach Whitecloud,D,VGK,28,52,4,13,17
22,8483495,Simon Nemec,D,NJD,20,51,4,13,17
22,8479983,Mario Ferraro,D,SJS,26,65,3,14,17
22,8479369,Andrew Peeke,D,BOS,26,64,3,14,17
22,8483493,Frank Nazar,C,CHI,20,52,10,6,16
22,8478569,Noel Acciari,C,PIT,33,55,9,7,16
22,8477406,Mattias Janmark,C,EDM,32,62,8,8,16
22,8479671,Mathieu Olivier,R,CBJ,27,51,8,8,16
22,8480245,Olle Lycksell,R,PHI,25,38,8,8,16
22,8480762,Eric Robinson,L,CAR,29,53,7,9,16
22,8480011,Klim Kostin,C,SJS,25,48,7,9,16
22,8481537,Nikita Okhotiuk,D,CGY,24,57,5,11,16
22,8480448,Parker Kelly,L,COL,25,76,5,11,16
22,8476891,Matthew Grzelcyk,D,PIT,30,73,4,12,16
22,8476988,Matt Benning,D,SJS,30,62,4,12,16
22,8479398,Samuel Girard,D,COL,26,65,3,13,16
22,8476525,Colin Miller,D,WPG,32,69,3,13,16
22,8480222,Sebastian Aho,D,PIT,28,75,3,13,16
22,8482073,Braden Schneider,D,NYR,23,66,2,14,16
22,8480891,Michael Kesselring,D,UTA,24,60,1,15,16
22,8477392,Hudson Fasching,R,NYI,29,70,10,5,15
22,8480789,Oliver Wahlstrom,R,NYI,24,71,10,5,15
22,8475225,Craig Smith,C,CHI,35,46,9,6,15
22,8479336,Carl Grundstrom,R,SJS,27,53,8,7,15
22,8480192,Johnathan Kovacevic,D,NJD,27,57,7,8,15
22,8482166,Shakir Mukhamadullin,D,SJS,22,62,7,8,15
22,8482859,Zack Ostapchuk,C,OTT,21,58,7,8,15
22,8482077,Dylan Holloway,L,EDM,23,52,7,8,15
22,8479543,Michael Pezzetta,L,MTL,26,54,6,9,15
22,8478585,Derek Ryan,C,EDM,38,60,6,9,15
22,8479291,Kevin Rooney,C,CGY,31,48,6,9,15
22,8476312,Josh Manson,D,COL,33,58,5,10,15
22,8475208,Brian Dumoulin,D,ANA,33,67,5,10,15
22,8478136,Jake Middleton,D,MIN,28,74,5,10,15
22,8477845,Trevor van Riemsdyk,D,WSH,33,56,4,11,15
22,8480807,Mattias Samuelsson,D,BUF,24,52,4,11,15
22,8480172,Jan Rutta,D,SJS,34,63,3,12,15
22,8480157,Calle Rosen,D,COL,30,52,3,12,15
22,8475690,Chris Tanev,D,TOR,35,57,2,13,15
22,8475181,Nick Leddy,D,STL,33,64,1,14,15
22,8482155,Alex Laferriere,R,LAK,23,58,12,2,14
22,8481518,Nolan Foote,L,NJD,24,46,9,5,14
22,8475220,Marcus Foligno,L,MIN,33,63,9,5,14
22,8482659,Josh Doan,R,UTA,22,54,9,5,14
22,8481477,Nico Sturm,C,SJS,29,54,8,6,14
22,8481704,Juuso Parssinen,C,NSH,23,56,6,8,14
22,8478043,Sam Lafferty,C,BUF,29,58,5,9,14
22,8474567,Zach Bogosian,D,MIN,34,61,5,9,14
22,8478452,Caleb Jones,D,LAK,27,55,3,11,14
22,8478859,Niko Mikkola,D,FLA,28,59,3,11,14
22,8477573,Nathan Walker,L,STL,30,56,3,11,14
22,8482964,Arber Xhekaj,D,MTL,23,46,3,11,14
22,8481701,Santeri Hatakka,D,NJD,23,38,3,11,14
22,8483460,David Jiricek,D,CBJ,21,59,2,12,14
22,8479520,Brandon Duhaime,R,WSH,27,55,9,4,13
22,8482176,Wyatt Kaiser,D,CHI,22,45,8,5,13
22,8482666,Scott Morrow,D,CAR,22,46,8,5,13
22,8477903,Garnet Hathaway,R,PHI,33,58,7,6,13
22,8476889,Radek Faksa,C,STL,30,54,7,6,13
22,8476442,Matt Nieto,L,PIT,32,45,7,6,13
22,8481641,Joel Kiviranta,L,COL,28,68,7,6,13
22,8481754,Nikita Nesterenko,C,ANA,23,46,7,6,13
22,8480441,Trey Fix-Wolansky,R,CBJ,25,35,7,6,13
22,8476934,Brock McGinn,L,ANA,30,54,6,7,13
22,8482807,Ethan Del Mastro,D,CHI,21,47,6,7,13
22,8474034,Patrick Maroon,L,CHI,36,55,5,8,13
22,8481161,Jake Christiansen,D,CBJ,25,51,5,8,13
22,8471709,Marc-Edouard Vlasic,D,SJS,37,54,4,9,13
22,8481517,Brett Leason,R,ANA,25,55,4,9,13
22,8477507,Nikita Zadorov,D,BOS,29,69,3,10,13
22,8481521,Ronnie Attard,D,PHI,25,60,3,10,13
22,8477365,Connor Clifton,D,BUF,29,58,3,10,13
22,8476624,Barclay Goodrow,C,SJS,31,53,2,11,13
22,8480070,Ian Mitchell,D,BOS,25,47,2,11,13
22,8479372,Joshua Mahura,D,SEA,26,51,1,12,13
22,8479249,Andrew Poturalski,C,SJS,30,42,1,12,13
22,8475188,Brayden McNabb,D,VGK,33,51,0,13,13
22,8479066,Ryan Lomberg,L,CGY,30,65,9,3,12
22,8481716,Dmitri Voronkov,L,CBJ,24,42,8,4,12
22,8480021,Jack Studnicka,C,LAK,25,61,7,5,12
22,8480880,Jakub Lauko,C,MIN,24,35,7,5,12
22,8483466,Kevin Korchinski,D,CHI,20,52,5,7,12
22,8482148,Hendrix Lapierre,C,WSH,22,51,5,7,12
22,8482652,Walker Duehr,R,CGY,27,39,5,7,12
22,8480025,MacKenzie Entwistle,R,FLA,25,63,5,7,12
22,8481568,Alex Vlasic,D,CHI,23,54,4,8,12
22,8476967,Brett Kulak,D,EDM,30,61,4,8,12
22,8479718,Alex Barré-Boulet,C,MTL,27,51,4,8,12
22,8480196,Jacob Bryson,D,BUF,27,48,4,8,12
22,8477220,Nate Schmidt,D,FLA,33,66,3,9,12
22,8481013,Jonatan Berggren,R,DET,24,45,3,9,12
22,8478451,Ethan Bear,D,WSH,27,59,3,9,12
22,8474568,Luke Schenn,D,NSH,35,53,3,9,12
22,8481147,Reese Johnson,C,MIN,26,29,3,9,12
22,8475790,Erik Gudbranson,D,CBJ,32,73,2,10,12
22,8479980,Nicolas Hague,D,VGK,26,52,1,11,12
22,8475718,Justin Holl,D,DET,32,63,1,11,12
22,8480860,Kevin Bahl,D,CGY,24,52,0,12,12
22,8480887,Jordan Harris,D,MTL,24,59,0,12,12
22,8480848,Ty Dellandrea,C,SJS,24,39,9,2,11
22,8471817,Ryan Reaves,R,TOR,37,52,8,3,11
22,8479536,Axel Jonsson-Fjallby,L,WPG,26,34,7,4,11
22,8477369,Carson Soucy,D,VAN,30,61,6,5,11
22,8484149,Gavin Brindley,C,CBJ,20,50,5,6,11
22,8478421,A.J. Greer,L,FLA,28,62,5,6,11
22,8479359,Beck Malenstyn,L,BUF,26,52,5,6,11
22,8481592,Jakob Pelletier,L,CGY,23,41,5,6,11
22,8479328,Julien Gauthier,R,NYI,27,64,4,7,11
22,8476867,Brendan Gaunce,C,MIN,30,32,4,7,11
22,8479986,Kole Lind,R,DAL,26,59,4,7,11
22,8474090,Brendan Smith,D,DAL,35,51,4,7,11
22,8482733,Logan Mailloux,D,MTL,31,41,4,7,11
22,8476994,Vinnie Hinostroza,C,NSH,30,48,3,8,11
22,8475279,Ben Chiarot,D,DET,33,62,3,8,11
22,8477018,Ben Hutton,D,VGK,31,48,2,9,11
22,8475750,Jon Merrill,D,MIN,32,67,2,9,11
22,8477335,Kyle Burroughs,D,LAK,29,46,2,9,11
22,8479348,Kale Clague,D,BUF,26,34,2,9,11
22,8477034,Jaycob Megna,D,FLA,32,45,2,9,11
22,8482451,Mikael Pyyhtia,L,CBJ,23,51,1,10,11
22,8481598,Philip Broberg,D,EDM,23,40,1,10,11
22,8482762,Simon Edvinsson,D,DET,21,60,8,2,10
22,8482496,Nils Aman,C,VAN,24,31,5,5,10
22,8481028,Martin Pospisil,C,CGY,25,51,5,5,10
22,8481617,Vasily Podkolzin,R,VAN,23,52,5,5,10
22,8479985,Cale Fleury,D,SEA,26,33,4,6,10
22,8479442,Troy Stecher,D,EDM,30,54,3,7,10
22,8476372,Nick Seeler,D,PHI,31,50,3,7,10
22,8483549,Lucas Condotta,L,MTL,27,34,3,7,10
22,8481599,Victor Soderstrom,D,UTA,23,38,3,7,10
22,8479972,Mason Shaw,C,WPG,26,41,2,8,10
22,8482634,Alex Steeves,C,TOR,25,40,2,8,10
22,8471677,Jack Johnson,D,CBJ,37,66,2,8,10
22,8475455,Brenden Dillon,D,NJD,34,55,2,8,10
22,8474013,Ian Cole,D,UTA,35,56,2,8,10
22,8476952,Dominic Toninato,C,WPG,30,34,2,8,10
22,8480058,Pierre-Olivier Joseph,D,STL,25,52,2,8,10
22,8477384,Joshua Brown,D,EDM,30,38,2,8,10
22,8473453,Trevor Lewis,C,LAK,37,65,5,4,9
22,8479439,Jacob MacDonald,D,COL,31,47,5,4,9
22,8478211,Dryden Hunt,L,CGY,29,55,5,4,9
22,8480844,Grigori Denisenko,L,VGK,24,38,4,5,9
22,8476329,Travis Boyd,C,MIN,31,53,2,7,9
22,8480845,Rasmus Kupari,C,WPG,24,45,2,7,9
22,8480001,Urho Vaakanainen,D,ANA,25,54,2,7,9
22,8477851,Jordan Oesterle,D,BOS,32,42,2,7,9
22,8484254,Akito Hirose,D,VAN,25,42,2,7,9
22,8476874,Olli Maatta,D,DET,30,57,1,8,9
22,8475177,Calvin de Haan,D,COL,33,48,1,8,9
22,8479638,Justin Brazeau,R,BOS,26,44,6,2,8
22,8482744,James Malatesta,L,CBJ,21,40,6,2,8
22,8479344,Jesse Puljujarvi,R,PIT,26,52,5,3,8
22,8478424,Jansen Harkins,C,ANA,27,35,5,3,8
22,8479944,Zach Aston-Reese,C,VGK,30,53,4,4,8
22,8481751,Lukas Rousek,R,BUF,25,36,3,5,8
22,8477887,Patrick Brown,C,BOS,32,49,3,5,8
22,8481167,Brayden Pachal,D,CGY,25,43,3,5,8
22,8482153,Brendan Brisson,C,VGK,23,28,3,5,8
22,8477482,Zachary Sanford,L,CHI,30,37,3,5,8
22,8478468,Jeremy Lauzon,D,NSH,27,45,2,6,8
22,8480292,Carson Meyer,R,ANA,27,40,1,7,8
22,8481600,Tobias Bjornfot,D,FLA,23,33,1,7,8
22,8479378,Logan Stanley,D,WPG,26,41,0,8,8
22,8477401,John Hayden,C,SEA,29,32,6,1,7
22,8478831,Kevin Stenlund,C,UTA,28,52,4,3,7
22,8482070,Mitchell Chaffee,R,TBL,26,45,4,3,7
22,8482784,Zach Dean,C,STL,21,44,4,3,7
22,8479994,Jaret Anderson-Dolan,C,WPG,25,32,3,4,7
22,8477070,Liam O'Brien,C,UTA,30,45,3,4,7
22,8477962,Brendan Lemieux,L,CAR,28,39,3,4,7
22,8475235,Nicolas Deslauriers,L,PHI,33,51,3,4,7
22,8481543,Nikita Alexandrov,C,STL,24,30,3,4,7
22,8480007,Jonas Rondbjerg,R,VGK,25,38,2,5,7
22,8480796,Martin Fehervary,D,WSH,25,54,1,6,7
22,8482861,Vincent Iorio,D,WSH,22,31,1,6,7
22,8475762,Derek Forbort,D,VAN,32,44,1,6,7
22,8481532,Alex Turcotte,C,LAK,23,42,1,6,7
22,8482713,Mackie Samoskevich,R,FLA,22,33,1,6,7
22,8477810,Joel Hanley,D,CGY,33,22,1,6,7
22,8483619,Filip Roos,D,OTT,25,41,0,7,7
22,8481789,Tye Kartye,L,SEA,23,44,5,1,6
22,8483570,Ben Meyers,C,SEA,26,29,5,1,6
22,8481541,Samuel Bolduc,D,NYI,24,25,5,1,6
22,8481679,Maxence Guenette,D,OTT,23,32,4,2,6
22,8480990,Declan Chisholm,D,MIN,24,34,4,2,6
22,8481556,John Beecher,C,BOS,23,31,4,2,6
22,8483012,Logan Morrison,C,SEA,22,37,4,2,6
22,8482751,Ryan Winterton,C,SEA,21,37,3,3,6
22,8480355,Mark Kastelic,C,BOS,25,52,3,3,6
22,8484911,Collin Graf,R,SJS,22,36,3,3,6
22,8482141,Lukas Cormier,D,VGK,22,29,3,3,6
22,8479320,Maxime Lajoie,D,SEA,27,22,3,3,6
22,8478874,Adam Gaudette,R,OTT,28,39,2,4,6
22,8478409,Anthony Richard,C,PHI,28,27,2,4,6
22,8482765,Isak Rosen,R,BUF,21,31,2,4,6
22,8479772,Zack MacEwen,R,OTT,28,55,2,4,6
22,8482144,Jack Thompson,D,SJS,22,30,2,4,6
22,8481567,Henry Thrun,D,SJS,23,50,1,5,6
22,8478502,Dennis Gilbert,D,BUF,28,15,1,5,6
22,8481122,Simon Benoit,D,TOR,26,36,1,5,6
22,8478017,Mark Friedman,D,VAN,29,35,1,5,6
22,8477473,Justin Bailey,R,SJS,29,22,1,5,6
22,8478450,Parker Wotherspoon,D,BOS,27,30,0,6,6
22,8480870,Bo Groulx,C,NYR,24,28,0,6,6
22,8479968,Vinni Lettieri,C,BOS,29,40,4,1,5
22,8479379,Givani Smith,R,SJS,26,27,4,1,5
22,8483397,Marc McLaughlin,C,BOS,25,42,4,1,5
22,8476441,Joel Edmundson,D,LAK,31,30,3,2,5
22,8478146,Matthew Highmore,C,OTT,28,27,3,2,5
22,8483630,Pavol Regenda,L,ANA,25,32,3,2,5
22,8475958,Michael Sgarbossa,C,WSH,32,31,3,2,5
22,8482929,Emil Lilleberg,D,TBL,23,17,3,2,5
22,8480879,Jacob Bernard-Docker,D,OTT,24,47,2,3,5
22,8480834,Ty Emberson,D,SJS,24,33,2,3,5
22,8477527,Ross Johnston,L,ANA,30,37,2,3,5
22,8476913,Devin Shore,C,MIN,30,34,2,3,5
22,8479367,William Lockwood,R,FLA,26,21,2,3,5
22,8482747,Brennan Othmann,L,NYR,21,37,1,4,5
22,8480890,Jan Jenik,C,OTT,24,21,1,4,5
22,8482095,Tyler Kleven,D,OTT,22,44,1,4,5
22,8476473,Connor Murphy,D,CHI,31,35,0,5,5
22,8479981,Jonah Gadjovich,L,FLA,26,40,0,5,5
22,8479576,Vincent Desharnais,D,VAN,28,41,0,5,5
22,8477320,Anton Blidh,L,NYR,29,24,3,1,4
22,8480874,Adam Ginning,D,PHI,24,14,3,1,4
22,8482145,Mavrik Bourque,C,DAL,22,43,1,3,4
22,8481237,Kyle MacLean,C,NYI,25,33,1,3,4
22,8478021,William Lagesson,D,DET,28,26,1,3,4
22,8478454,Noah Juulsen,D,VAN,27,35,1,3,4
22,8481006,Tyler Tucker,D,STL,24,16,1,3,4
22,8474612,Travis Hamonic,D,OTT,34,40,0,4,4
22,8482177,Marat Khusnutdinov,C,MIN,22,32,0,4,4
22,8482165,Yan Kuznetsov,D,CGY,22,19,0,4,4
22,8477462,Robert Hagg,D,VGK,29,21,0,4,4
22,8479587,Rhett Gardner,C,PHI,28,19,0,4,4
22,8481206,John Ludvig,D,PIT,24,13,2,1,3
22,8482858,Ryker Evans,D,SEA,23,28,2,1,3
22,8481605,Jackson LaCombe,D,ANA,23,40,1,2,3
22,8482172,Landon Slaggert,L,CHI,22,24,1,2,3
22,8482511,Mason Lohrei,D,BOS,23,34,1,2,3
22,8484258,Sam Malinski,D,COL,26,16,1,2,3
22,8481585,Egor Afanasyev,L,SJS,23,14,1,2,3
22,8481056,Spencer Stastney,D,NSH,24,30,1,2,3
22,8477073,Kurtis MacDermid,L,NJD,30,29,1,2,3
22,8478881,Brett Seney,L,CHI,28,12,1,2,3
22,8479362,Riley Tufte,L,BOS,26,20,1,2,3
22,8478051,Max Willman,C,NJD,29,25,1,2,3
22,8479991,Jake Leschyshyn,C,NYR,25,35,1,2,3
22,8482118,Sam Colangelo,R,ANA,23,15,1,2,3
22,8473446,Erik Johnson,D,PHI,36,43,0,3,3
22,8481699,Aku Raty,R,UTA,23,11,0,3,3
22,8481655,Cole Schwindt,R,CGY,23,4,0,3,3
22,8477971,Andreas Englund,D,LAK,28,26,0,3,3
22,8481462,Mason Morelli,L,VGK,28,13,2,0,2
22,8483398,Declan Carlile,D,TBL,31,9,2,0,2
22,8477938,Haydn Fleury,D,WPG,28,37,1,1,2
22,8482147,Jean-Luc Foudy,C,COL,22,23,1,1,2
22,8481743,Marc Del Gaizo,D,NSH,25,22,1,1,2
22,8481422,Jake Lucchini,C,NSH,29,18,1,1,2
22,8483763,Maksymilian Szuber,D,UTA,22,30,1,1,2
22,8484287,Cole McWard,D,VAN,23,25,1,1,2
22,8483489,Fraser Minten,C,TOR,31,7,1,1,2
22,8480823,Alexander Alexeyev,D,WSH,25,13,1,1,2
22,8482250,Callahan Burke,C,VGK,27,17,1,1,2
22,8480468,James Hamblin,L,EDM,25,22,1,1,2
22,8475413,Justin Dowling,C,NJD,34,16,1,1,2
22,8482201,Gage Goncalves,C,TBL,23,23,1,1,2
22,8481065,Angus Crookshank,L,OTT,25,18,1,1,2
22,8481609,Vladislav Kolyachonok,D,UTA,23,31,0,2,2
22,8483512,Matthew Savoie,C,EDM,20,22,0,2,2
22,8480851,Akil Thomas,C,LAK,24,24,0,2,2
22,8479419,Brett Murray,L,BUF,26,15,0,2,2
22,8480084,Nick DeSimone,D,NJD,30,14,0,2,2
22,8481024,Linus Karlsson,C,VAN,25,10,0,2,2
22,8482102,Vasily Ponomarev,C,PIT,22,20,0,2,2
22,8477467,Gustav Olofsson,D,SEA,30,17,0,2,2
22,8484325,Waltteri Merela,C,TBL,26,22,0,2,2
22,8483920,Pierrick Dube,R,WSH,23,6,0,2,2
22,8477244,Chad Ruhwedel,D,NYR,34,32,1,0,1
22,8483471,Brad Lambert,C,WPG,31,8,1,0,1
22,8482088,Justin Sourdif,R,FLA,22,18,1,0,1
22,8482094,Daemon Hunt,D,MIN,22,13,1,0,1
22,8480032,Shane Bowers,C,NJD,25,13,1,0,1
22,8479330,Brandon Gignac,C,MTL,27,10,1,0,1
22,8482162,Roby Jarventie,L,EDM,22,16,1,0,1
22,8477993,Justin Kirkland,C,CGY,28,7,1,0,1
22,8479421,Jacob Moverare,D,LAK,26,9,1,0,1
22,8475780,Chris Wagner,R,COL,33,9,1,0,1
22,8480267,Sammy Walker,C,MIN,25,14,1,0,1
22,8482460,Matt Rempe,C,NYR,22,7,1,0,1
22,8481578,Graeme Clarke,R,MIN,23,10,1,0,1
22,8482061,Brandon Biro,L,SEA,26,11,0,1,1
22,8482516,Matthew Kessel,D,STL,24,21,0,1,1
22,8475795,Dylan McIlrath,D,WSH,32,13,0,1,1
22,8481564,Ryan Johnson,D,BUF,23,19,0,1,1
22,8483432,Luca Del Bel Belluz,C,CBJ,31,3,0,1,1
22,8474062,Riley Nash,C,NYR,35,13,0,1,1
22,8484255,Jason Polin,R,COL,25,9,0,1,1
22,8483597,Milos Kelemen,L,UTA,25,8,0,1,1
22,8478446,Glenn Gawdin,C,LAK,27,11,0,1,1
22,8475755,Alexander Petrovic,D,DAL,32,9,0,1,1
22,8481719,Maxwell Crozier,D,TBL,24,12,0,1,1
22,8479522,Hardy Haman Aktell,D,WSH,26,4,0,1,1
22,8482197,Adam Raska,R,MIN,23,8,0,1,1
22,8482470,Ilya Solovyov,D,CGY,24,23,0,0,0
22,8483395,Arshdeep Bains,L,VAN,23,9,0,0,0
22,8480306,Grant Hutton,D,NYI,29,2,0,0,0
22,8481806,Louis Crevier,D,CHI,23,15,0,0,0
22,8477149,Scott Sabourin,R,SJS,32,11,0,0,0
22,8478477,Mitchell Stephens,C,SEA,27,12,0,0,0
22,8480075,Cameron Crotty,D,MIN,25,12,0,0,0
22,8478011,Louie Belpedio,D,PHI,28,11,0,0,0
22,8483609,Adam Klapka,R,CGY,24,3,0,0,0
22,8481030,Jack St. Ivany,D,PIT,25,10,0,0,0
22,8482476,Emil Heineman,L,MTL,23,12,0,0,0
22,8481593,Jayden Struble,D,MTL,23,21,0,0,0
22,8481043,Cole Koepke,L,BOS,26,19,0,0,0
22,8481726,Adam Edstrom,C,NYR,24,10,0,0,0
22,8477541,Dakota Mermis,D,TOR,30,12,0,0,0
22,8483567,Georgii Merkulov,C,BOS,24,5,0,0,0
22,8484304,Uvis Balinskis,D,FLA,28,10,0,0,0
22,8478854,Ryan Shea,D,PIT,27,5,0,0,0
22,8483407,Brandon Scanlin,D,NYR,25,3,0,0,0
22,8482787,Nikita Chibrikov,R,WPG,31,4,0,0,0
22,8484326,Patrik Koch,D,UTA,28,3,0,0,0
22,8484259,Ondrej Pavel,C,COL,31,3,0,0,0
22,8480274,Philip Kemp,D,EDM,25,0,0,0,0
22,8483546,Marshall Rifai,D,TOR,26,1,0,0,0
22,8483531,Brian Halonen,L,NJD,25,3,0,0,0
22,8483401,Marc Johnstone,R,PIT,28,0,0,0,0
22,8476323,Max McCormick,L,SEA,32,3,0,0,0
22,8484321,Nikolas Matinpalo,D,OTT,26,1,0,0,0
22,8478147,Bokondji Imama,L,PIT,28,5,0,0,0
22,8481534,Raphael Lavoie,C,EDM,24,1,0,0,0
22,8482126,Emil Andrae,D,PHI,31,3,0,0,0
22,8470794,Joe Pavelski,C,,40,0,0,0,0
22,8479321,Lucas Johansen,D,,27,0,0,0,0
22,8477950,Tony DeAngelo,D,,29,0,0,0,0
22,8471218,Blake Wheeler,R,,38,0,0,0,0
22,8475197,Tyson Barrie,D,,33,0,0,0,0
22,8474157,Max Pacioretty,L,,36,0,0,0,0
22,8475744,Evgeny Kuznetsov,C,,32,0,0,0,0
22,8474037,James van Riemsdyk,L,,35,0,0,0,0
22,8476907,Mackenzie MacEachern,L,,30,0,0,0,0
22,8480216,Jacob Peterson,C,,25,0,0,0,0
22,8474602,Justin Schultz,D,,34,0,0,0,0
22,8482222,Alexander Barabanov,L,,30,0,0,0,0
22,8474031,Kevin Shattenkirk,D,,35,0,0,0,0
22,8477330,Dominik Kubalik,L,,29,0,0,0,0
22,8480884,Calen Addison,D,,24,0,0,0,0
22,8475906,John Klingberg,D,,32,0,0,0,0
22,8480008,Adam Ruzicka,C,,25,0,0,0,0
22,8476884,Derrick Pouliot,D,,30,0,0,0,0
22,8476919,Chris Tierney,C,,30,0,0,0,0
22,8479415,Michael McLeod,C,,26,0,0,0,0
22,8474870,Tyler Johnson,C,,34,0,0,0,0
22,8470604,Jeff Carter,C,,39,0,0,0,0
22,8478104,Sammy Blais,L,,28,0,0,0,0
22,8474884,Mike Hoffman,C,,35,0,0,0,0
22,8481591,Sam Poulin,R,,23,0,0,0,0
22,8471274,Alex Goligoski,D,,39,0,0,0,0
22,8476871,Tanner Pearson,L,,32,0,0,0,0
22,8476393,Nick Cousins,C,,31,0,0,0,0
22,8479977,Kailer Yamamoto,R,,26,0,0,0,0
22,8479346,Dillon Dube,C,,26,0,0,0,0
22,8480184,Gustav Lindstrom,D,,26,0,0,0,0
22,8479376,Victor Mete,D,,26,0,0,0,0
22,8473449,Kyle Okposo,R,,36,0,0,0,0
22,8481058,Jesse Ylonen,R,,25,0,0,0,0
22,8475752,Tyler Pitlick,C,,33,0,0,0,0
22,8481239,Samuel Fagemo,L,,24,0,0,0,0
22,8480821,Filip Zadina,R,,25,0,0,0,0
22,8470966,Mark Giordano,D,,41,0,0,0,0
22,8478495,Denis Gurianov,R,,27,0,0,0,0
22,8477464,Nic Petan,C,,29,0,0,0,0
22,8478099,Kevin Labanc,R,,29,0,0,0,0
22,8482241,Radim Zohorna,L,,28,0,0,0,0
22,8474040,Sam Gagner,C,,35,0,0,0,0
22,8479514,Rem Pitlick,C,,27,0,0,0,0
22,8478430,Oliver Kylington,D,,27,0,0,0,0
22,8479533,Joona Koppanen,L,,26,0,0,0,0
22,8479984,Cal Foote,D,,26,0,0,0,0
22,8477126,Jayson Megna,C,,34,0,0,0,0
22,8475164,Jakob Silfverberg,R,,34,0,0,0,0
22,8474009,Nick Bonino,C,,36,0,0,0,0
22,8479458,Nikita Zaitsev,D,,33,0,0,0,0
22,8477944,Jakub Vrana,L,,28,0,0,0,0
22,8471699,Andrew Cogliano,C,,37,0,0,0,0
22,8478067,Oskar Lindblom,L,,28,0,0,0,0
22,8471686,Marc Staal,D,,37,0,0,0,0
22,8470610,Zach Parise,L,,40,0,0,0,0
22,8478904,Steven Lorentz,C,,28,0,0,0,0
22,8473473,Milan Lucic,L,,36,0,0,0,0
22,8480031,Maxime Comtois,L,,25,0,0,0,0
22,8478512,Austin Czarnik,C,,32,0,0,0,0
22,8473504,Cal Clutterbuck,R,,37,0,0,0,0
22,8477454,Adam Erne,L,,29,0,0,0,0
22,8479383,Boris Katchouk,L,,26,0,0,0,0
22,8475825,Jani Hakanpää,D,,32,0,0,0,0
22,8477846,Ryan Carpenter,C,,33,0,0,0,0
22,8477930,Pierre-Edouard Bellemare,L,,39,0,0,0,0
22,8478400,Colin White,C,,27,0,0,0,0
22,8480226,Marián Studenic,R,,26,0,0,0,0
22,8480853,Liam Foudy,C,,24,0,0,0,0
22,8475797,Jarred Tinordi,D,,32,0,0,0,0
22,8479423,Alex Nylander,L,,26,0,0,0,0
22,8474618,Marco Scandella,D,,34,0,0,0,0
22,8478028,Fredrik Olofsson,L,,28,0,0,0,0
22,8474709,Matt Martin,L,,35,0,0,0,0
22,8481070,Hugh McGing,L,,26,0,0,0,0
22,8479546,Oskar Steen,C,,26,0,0,0,0
22,8474145,Robert Bortuzzo,D,,35,0,0,0,0
22,8476915,Jujhar Khaira,L,,30,0,0,0,0
22,8475278,Byron Froese,C,,33,0,0,0,0
22,8481812,Nikolai Knyzhov,D,,27,0,0,0,0
22,8478408,Travis Dermott,D,,28,0,0,0,0
22,8481077,John Leonard,L,,26,0,0,0,0
22,8479547,Matthew Phillips,R,,26,0,0,0,0
22,8480836,Jonathan Gruden,C,,24,0,0,0,0
22,8481690,Tyler Angle,C,,24,0,0,0,0
22,8475766,Austin Watson,L,,32,0,0,0,0
22,8481016,Ruslan Iskhakov,C,,24,0,0,0,0
22,8478078,Rourke Chartier,C,,28,0,0,0,0
22,8480776,Sheldon Rempal,R,,29,0,0,0,0
22,8478956,Samuel Laberge,L,NJD,27,2,0,0,0
22,8483045,Cameron Butler,R,CBJ,31,1,0,0,0
22,8484314,Jiri Smejkal,L,,28,0,0,0,0
23,8477492,Nathan MacKinnon,C,COL,29,82,61,93,154
23,8477956,David Pastrnak,R,BOS,28,79,64,65,129
23,8478402,Connor McDavid,C,EDM,27,77,37,84,121
23,8479318,Auston Matthews,C,TOR,27,80,66,54,120
23,8478483,Mitch Marner,R,TOR,27,81,33,87,120
23,8478550,Artemi Panarin,L,NYR,33,77,34,81,115
23,8478420,Mikko Rantanen,R,COL,28,82,42,71,113
23,8476453,Nikita Kucherov,R,TBL,31,82,34,75,109
23,8481559,Jack Hughes,C,NJD,23,73,40,65,105
23,8477939,William Nylander,R,TOR,28,80,44,59,103
23,8479343,Clayton Keller,R,UTA,26,76,49,52,101
23,8478439,Travis Konecny,R,PHI,27,78,35,66,101
23,8480027,Jason Robertson,L,DAL,25,82,33,67,100
23,8477946,Dylan Larkin,C,DET,28,80,52,47,99
23,8476887,Filip Forsberg,L,NSH,30,75,44,55,99
23,8480069,Cale Makar,D,COL,26,73,27,71,98
23,8480012,Elias Pettersson,C,VAN,26,78,41,54,95
23,8477934,Leon Draisaitl,C,EDM,29,79,38,57,95
23,8476468,J.T. Miller,C,VAN,31,73,36,59,95
23,8471675,Sidney Crosby,C,PIT,37,75,35,59,94
23,8477493,Aleksander Barkov,C,FLA,29,75,30,63,93
23,8477501,Valeri Nichushkin,R,COL,29,80,47,44,91
23,8478864,Kirill Kaprizov,L,MIN,27,70,35,56,91
23,8477933,Sam Reinhart,C,FLA,29,80,42,48,90
23,8482116,Tim Stützle,C,OTT,22,80,36,54,90
23,8479314,Matthew Tkachuk,L,FLA,27,77,28,62,90
23,8477404,Jake Guentzel,C,TBL,30,82,35,54,89
23,8480023,Robert Thomas,C,STL,25,77,28,61,89
23,8479385,Jordan Kyrou,C,STL,26,70,34,54,88
23,8479407,Jesper Bratt,L,NJD,26,75,30,58,88
23,8481557,Matt Boldy,L,MIN,23,70,38,49,87
23,8477409,Carter Verhaeghe,C,FLA,29,77,48,38,86
23,8480801,Brady Tkachuk,L,OTT,25,79,39,47,86
23,8478493,Joel Eriksson Ek,C,MIN,27,77,35,51,86
23,8477942,Kevin Fiala,L,LAK,28,81,31,55,86
23,8480002,Nico Hischier,C,NJD,25,76,28,58,86
23,8473512,Claude Giroux,R,OTT,36,79,28,58,86
23,8478427,Sebastian Aho,C,CAR,27,73,39,46,85
23,8477949,Alex Tuch,R,BUF,28,69,36,47,83
23,8475166,John Tavares,C,TOR,34,75,35,48,83
23,8480830,Andrei Svechnikov,R,CAR,24,66,27,54,81
23,8479323,Adam Fox,D,NYR,26,75,17,64,81
23,8480036,Miro Heiskanen,D,DAL,25,75,14,67,81
23,8482093,Seth Jarvis,C,CAR,22,73,40,39,79
23,8478398,Kyle Connor,L,WPG,28,76,39,40,79
23,8474564,Steven Stamkos,C,NSH,34,70,33,46,79
23,8478414,Timo Meier,R,NJD,28,76,33,46,79
23,8480800,Quinn Hughes,D,VAN,25,76,9,70,79
23,8478449,Roope Hintz,C,DAL,28,81,35,43,78
23,8478010,Brayden Point,C,TBL,28,82,33,44,77
23,8479337,Alex DeBrincat,R,DET,27,80,24,53,77
23,8479542,Brandon Hagel,L,TBL,26,82,33,43,76
23,8475168,Matt Duchene,C,DAL,33,82,31,44,75
23,8478403,Jack Eichel,C,VGK,28,74,28,47,75
23,8480208,Drake Batherson,R,OTT,26,80,28,47,75
23,8475913,Mark Stone,R,VGK,32,76,20,54,74
23,8476389,Vincent Trocheck,C,NYR,31,75,31,42,73
23,8478445,Mathew Barzal,C,NYI,27,78,15,58,73
23,8474102,David Perron,L,OTT,36,77,27,45,72
23,8478873,Troy Terry,R,ANA,27,76,25,47,72
23,8473994,Jamie Benn,L,DAL,35,81,31,40,71
23,8476454,Ryan Nugent-Hopkins,C,EDM,31,74,19,52,71
23,8476346,Johnny Gaudreau,L,CBJ,31,76,18,53,71
23,8475692,Mats Zuccarello,R,MIN,37,75,17,54,71
23,8482740,Wyatt Johnston,C,DAL,21,82,36,34,70
23,8476539,Jonathan Marchessault,R,NSH,34,70,36,34,70
23,8479675,Trevor Moore,L,LAK,29,79,32,38,70
23,8484144,Connor Bedard,C,CHI,19,68,23,47,70
23,8478460,Zach Werenski,D,CBJ,27,77,20,50,70
23,8474600,Roman Josi,D,NSH,34,77,17,53,70
23,8476881,Tomas Hertl,C,VGK,31,73,32,37,69
23,8471214,Alex Ovechkin,L,WSH,39,75,30,39,69
23,8477500,Bo Horvat,C,NYI,29,81,29,39,68
23,8476459,Mika Zibanejad,C,NYR,31,77,26,42,68
23,8478401,Pavel Zacha,C,BOS,27,79,26,42,68
23,8475172,Nazem Kadri,C,CGY,34,79,24,44,68
23,8471215,Evgeni Malkin,C,PIT,38,75,24,44,68
23,8475810,Bryan Rust,R,PIT,32,74,31,36,67
23,8476448,William Karlsson,C,VGK,31,75,26,40,66
23,8471685,Anze Kopitar,C,LAK,37,78,18,48,66
23,8477504,Josh Morrissey,D,WPG,29,72,16,50,66
23,8478440,Dylan Strome,C,WSH,27,72,13,53,66
23,8478975,Mason Marchment,L,DAL,29,81,30,35,65
23,8475158,Ryan O'Reilly,C,NSH,33,63,27,38,65
23,8482078,Lucas Raymond,L,DET,22,81,26,39,65
23,8481528,Dylan Cozens,C,BUF,23,75,24,41,65
23,8476456,Jonathan Huberdeau,C,CGY,31,81,17,48,65
23,8480865,Noah Dobson,D,NYI,24,80,12,53,65
23,8477496,Elias Lindholm,C,BOS,30,80,29,35,64
23,8475786,Zach Hyman,L,EDM,32,80,33,30,63
23,8475754,Brock Nelson,C,NYI,33,79,32,31,63
23,8475184,Chris Kreider,L,NYR,33,75,31,32,63
23,8477960,Adrian Kempe,R,LAK,28,81,30,33,63
23,8480018,Nick Suzuki,C,MTL,25,77,28,35,63
23,8477951,Nick Schmaltz,C,UTA,28,80,26,37,63
23,8475765,Vladimir Tarasenko,R,DET,33,81,20,43,63
23,8474578,Erik Karlsson,D,PIT,34,80,17,46,63
23,8482159,Tyson Foerster,R,PHI,22,71,31,31,62
23,8476460,Mark Scheifele,C,WPG,31,74,30,32,62
23,8475794,Tyler Seguin,C,DAL,32,80,26,35,61
23,8473986,Alex Killorn,L,ANA,35,71,26,35,61
23,8477964,Ivan Barbashev,C,VGK,29,74,26,35,61
23,8482149,Cole Perfetti,C,WPG,22,68,26,35,61
23,8479420,Tage Thompson,C,BUF,27,72,28,32,60
23,8474141,Patrick Kane,R,DET,36,78,26,34,60
23,8477503,Max Domi,C,TOR,29,77,21,39,60
23,8481540,Cole Caufield,R,MTL,23,75,30,29,59
23,8477955,Jared McCann,L,SEA,28,68,29,30,59
23,8480839,Rasmus Dahlin,D,BUF,24,72,13,46,59
23,8483431,Logan Cooley,C,UTA,20,73,21,37,58
23,8475167,Victor Hedman,D,TBL,34,79,19,39,58
23,8473419,Brad Marchand,L,BOS,36,79,18,40,58
23,8477402,Pavel Buchnevich,L,STL,29,69,18,40,58
23,8477940,Nikolaj Ehlers,L,WPG,28,71,18,40,58
23,8482684,Luke Hughes,D,NJD,21,66,12,46,58
23,8476853,Morgan Rielly,D,TOR,30,74,10,48,58
23,8477476,Artturi Lehkonen,L,COL,29,79,35,22,57
23,8482745,Mason McTavish,C,ANA,21,76,27,30,57
23,8478458,John (Jack) Roslovic,C,CAR,27,65,18,39,57
23,8480803,Evan Bouchard,D,EDM,25,76,16,41,57
23,8475798,Mikael Granlund,C,SJS,32,67,14,43,57
23,8477935,Sam Bennett,C,FLA,28,77,34,22,56
23,8480039,Martin Necas,C,CAR,25,72,27,29,56
23,8475151,Kyle Palmieri,C,NYI,33,80,25,30,55
23,8475170,Brayden Schenn,C,STL,33,71,25,30,55
23,8477497,Sean Monahan,C,CBJ,30,70,24,31,55
23,8478438,Tommy Novak,C,NSH,27,71,22,33,55
23,8476479,Phillip Danault,C,LAK,31,81,20,35,55
23,8475793,Ryan Johansen,C,PHI,32,71,20,35,55
23,8477407,Anthony Duclair,L,NYI,29,80,30,24,54
23,8475726,Tyler Toffoli,C,SJS,32,68,29,25,54
23,8479325,Charlie McAvoy,D,BOS,27,74,12,42,54
23,8483515,Juraj Slafkovsky,L,MTL,20,71,26,27,53
23,8482665,Matty Beniers,C,SEA,22,78,25,28,53
23,8478047,Michael Bunting,L,PIT,29,68,23,30,53
23,8476399,Blake Coleman,C,CGY,33,74,21,32,53
23,8475745,Charlie Coyle,C,BOS,32,77,21,32,53
23,8479345,Jakob Chychrun,D,WSH,26,65,11,42,53
23,8477494,Jonathan Drouin,L,COL,29,81,22,30,52
23,8479425,Filip Hronek,D,VAN,27,70,10,42,52
23,8478397,Rasmus Andersson,D,CGY,28,75,9,43,52
23,8478407,Vince Dunn,D,SEA,28,73,7,45,52
23,8480064,Josh Norris,C,OTT,25,73,24,27,51
23,8479999,Casey Mittelstadt,C,COL,26,80,16,35,51
23,8476905,Chandler Stephenson,C,SEA,30,78,16,35,51
23,8478474,Lawson Crouse,L,UTA,27,76,30,20,50
23,8476432,Boone Jenner,C,CBJ,31,72,24,26,50
23,8474590,John Carlson,D,WSH,34,66,13,37,50
23,8481068,Yegor Sharangovich,C,CGY,26,80,23,26,49
23,8484153,Leo Carlsson,C,ANA,20,73,22,27,49
23,8477021,Alex Kerfoot,C,UTA,30,77,20,29,49
23,8475784,Jeff Skinner,C,EDM,32,76,18,31,49
23,8481533,Trevor Zegras,C,ANA,23,73,17,32,49
23,8474679,Gustav Nyquist,C,NSH,35,76,15,34,49
23,8475314,Anders Lee,L,NYI,34,79,28,20,48
23,8482109,Alexis Lafrenière,L,NYR,23,74,26,22,48
23,8480015,Owen Tippett,R,PHI,25,71,26,22,48
23,8478444,Brock Boeser,R,VAN,27,68,24,24,48
23,8474149,Evgenii Dadonov,R,DAL,35,80,24,24,48
23,8481596,Shane Pinto,C,OTT,24,79,21,27,48
23,8483808,Andrei Kuzmenko,L,CGY,28,79,21,27,48
23,8478042,Viktor Arvidsson,L,EDM,31,78,19,29,48
23,8476882,Teuvo Teravainen,C,CHI,30,64,18,30,48
23,8475287,Erik Haula,L,NJD,33,76,18,30,48
23,8482113,Anton Lundell,C,FLA,23,77,16,32,48
23,8478469,Thomas Chabot,D,OTT,27,74,9,39,48
23,8477451,Ryan Hartman,R,MIN,30,71,22,25,47
23,8480220,Noah Cates,L,PHI,25,73,20,27,47
23,8474586,Jordan Eberle,R,SEA,34,73,18,29,47
23,8477346,MacKenzie Weegar,D,CGY,30,77,16,31,47
23,8476854,Hampus Lindholm,D,BOS,30,73,7,40,47
23,8480014,Gabriel Vilardi,C,WPG,25,73,27,19,46
23,8475191,Reilly Smith,R,NYR,33,75,21,25,46
23,8477426,Nicholas Paul,L,TBL,29,82,20,26,46
23,8477416,Oliver Bjorkstrand,R,SEA,29,76,19,27,46
23,8480028,Morgan Frost,C,PHI,25,70,18,28,46
23,8477447,Shea Theodore,D,VGK,29,58,14,32,46
23,8481711,Matias Maccelli,L,UTA,24,73,14,32,46
23,8470613,Brent Burns,D,CAR,39,76,14,32,46
23,8476792,Torey Krug,D,STL,33,75,13,33,46
23,8478498,Jake DeBrusk,L,VAN,28,73,26,19,45
23,8479351,Sam Steel,C,DAL,26,79,20,25,45
23,8474641,Adam Henrique,C,EDM,34,79,19,26,45
23,8475763,Kevin Hayes,R,PIT,32,64,19,26,45
23,8478519,Anthony Cirelli,C,TBL,27,82,16,29,45
23,8476872,Scott Laughton,C,PHI,30,73,15,30,45
23,8477495,Seth Jones,D,CHI,30,68,14,31,45
23,8477429,Andrew Copp,C,DET,30,76,12,33,45
23,8477932,Aaron Ekblad,D,FLA,28,69,10,35,45
23,8478055,Gustav Forsling,D,FLA,28,74,10,35,45
23,8475169,Evander Kane,L,EDM,33,69,27,17,44
23,8471698,T.J. Oshie,R,WSH,38,68,26,18,44
23,8477998,Warren Foegele,L,LAK,28,81,24,20,44
23,8476880,Tom Wilson,R,WSH,30,74,24,20,44
23,8482110,Dawson Mercer,C,NJD,23,80,21,23,44
23,8482097,Jack Quinn,R,BUF,23,63,21,23,44
23,8478463,Anthony Beauvillier,L,PIT,27,69,21,23,44
23,8477505,Alexander Wennberg,C,SJS,30,71,19,25,44
23,8479992,Michael Rasmussen,C,DET,25,77,16,28,44
23,8474716,Jared Spurgeon,D,MIN,35,77,12,32,44
23,8481703,Valtteri Puustinen,R,PIT,25,64,10,34,44
23,8471724,Kris Letang,D,PIT,37,79,6,38,44
23,8478046,Danton Heinen,L,VAN,29,67,23,20,43
23,8482475,Yegor Chinakhov,R,CBJ,23,64,21,22,43
23,8477511,Anthony Mantha,R,CGY,30,78,20,23,43
23,8482092,Ridly Greig,C,OTT,22,75,20,23,43
23,8478115,Pierre Engvall,L,NYI,28,78,17,26,43
23,8481618,Alex Newhook,C,MTL,23,78,17,26,43
23,8481577,Philip Tomasino,C,NSH,23,71,16,27,43
23,8484145,Zach Benson,L,BUF,19,73,16,27,43
23,8477986,Brandon Montour,D,SEA,30,70,15,28,43
23,8478856,Conor Garland,R,VAN,28,69,14,29,43
23,8476906,Shayne Gostisbehere,D,CAR,31,77,11,32,43
23,8481604,Pavel Dorofeyev,L,VGK,24,70,19,23,42
23,8476461,Sean Couturier,C,PHI,32,72,18,24,42
23,8476462,Dougie Hamilton,D,NJD,31,75,17,25,42
23,8484166,Adam Fantilli,C,CBJ,20,70,17,25,42
23,8479987,Morgan Geekie,C,BOS,26,75,17,25,42
23,8479410,Mikhail Sergachev,D,UTA,26,76,14,28,42
23,8482124,Quinton Byfield,R,LAK,22,77,13,29,42
23,8480185,Eetu Luostarinen,C,FLA,26,74,12,30,42
23,8477948,Travis Sanheim,D,PHI,28,77,12,30,42
23,8478396,Noah Hanifin,D,VGK,27,64,11,31,42
23,8481542,Moritz Seider,D,DET,23,77,4,38,42
23,8475799,Nino Niederreiter,R,WPG,32,70,22,19,41
23,8475760,Nick Bjugstad,C,UTA,32,76,22,19,41
23,8479525,Ross Colton,C,COL,28,81,17,24,41
23,8478462,Nicolas Roy,C,VGK,27,79,17,24,41
23,8481535,Nils Hoglander,L,VAN,24,72,16,25,41
23,8480798,Philipp Kurashev,C,CHI,25,62,15,26,41
23,8478038,Devon Toews,D,COL,30,62,10,31,41
23,8476958,Jaccob Slavin,D,CAR,30,76,4,37,41
23,8477456,J.T. Compher,L,DET,29,78,27,13,40
23,8476925,Colton Sissons,C,NSH,31,65,17,23,40
23,8474150,Mikael Backlund,C,CGY,35,78,13,27,40
23,8482105,Jake Sanderson,D,OTT,22,77,12,28,40
23,8474053,Logan Couture,C,SJS,35,64,11,29,40
23,8476923,Damon Severson,D,CBJ,30,82,9,31,40
23,8475722,Jason Zucker,L,BUF,32,64,21,18,39
23,8478542,Evan Rodrigues,C,FLA,31,73,18,21,39
23,8482699,Dylan Guenther,R,UTA,21,71,17,22,39
23,8478472,Mathieu Joseph,R,STL,27,70,16,23,39
23,8482705,Cole Sillinger,C,CBJ,21,70,16,23,39
23,8481581,Thomas Harley,D,DAL,23,76,13,26,39
23,8480434,Sean Durzi,D,UTA,26,68,5,34,39
23,8476483,Rickard Rakell,R,PIT,31,69,21,17,38
23,8482667,William Eklund,L,SJS,22,69,18,20,38
23,8473533,Jordan Staal,C,CAR,36,67,13,25,38
23,8476826,Yanni Gourde,C,SEA,33,68,11,27,38
23,8474563,Drew Doughty,D,LAK,35,73,10,28,38
23,8474565,Alex Pietrangelo,D,VGK,34,55,9,29,38
23,8475764,Cam Fowler,D,ANA,33,74,4,34,38
23,8480797,Joel Farabee,L,PHI,24,76,15,22,37
23,8479400,Pierre-Luc Dubois,L,WSH,26,67,14,23,37
23,8479591,Michael Eyssimont,C,TBL,28,80,12,25,37
23,8475848,Brendan Gallagher,R,MTL,32,68,12,25,37
23,8476480,Vladislav Namestnikov,C,WPG,32,67,8,29,37
23,8482055,Drew O'Connor,L,PIT,26,61,18,18,36
23,8481560,Arthur Kaliyev,R,LAK,23,78,17,19,36
23,8481554,Kaapo Kakko,R,NYR,23,68,17,19,36
23,8480802,Ryan McLeod,C,BUF,25,67,14,22,36
23,8478413,Jordan Greenway,L,BUF,27,68,14,22,36
23,8476292,Ondrej Palat,L,NJD,33,67,13,23,36
23,8483505,Matthew Poitras,C,BOS,20,76,13,23,36
23,8479365,Trent Frederic,C,BOS,26,71,13,23,36
23,8482702,Logan Stankoven,C,DAL,21,79,13,23,36
23,8480849,Barrett Hayton,C,UTA,24,76,12,24,36
23,8476458,Ryan Strome,C,ANA,31,70,11,25,36
23,8480009,Eeli Tolvanen,R,SEA,25,75,9,27,36
23,8476902,Esa Lindell,D,DAL,30,73,8,28,36
23,8476875,Mike Matheson,D,MTL,30,68,7,29,36
23,8476392,Adam Lowry,C,WPG,31,65,16,19,35
23,8480188,Fabian Zetterlund,L,SJS,25,69,15,20,35
23,8480078,Filip Chytil,C,NYR,25,69,15,20,35
23,8481524,Bowen Byram,D,BUF,23,68,11,24,35
23,8475768,Jaden Schwartz,C,SEA,32,74,18,16,34
23,8480459,Pius Suter,C,VAN,28,70,16,18,34
23,8481624,Ilya Mikheyev,R,CHI,30,65,16,18,34
23,8478233,Andrew Mangiapane,L,WSH,28,73,15,19,34
23,8482720,Matthew Knies,L,TOR,22,73,14,20,34
23,8482660,Kent Johnson,C,CBJ,22,68,12,22,34
23,8481186,Logan O'Connor,R,COL,28,81,11,23,34
23,8476869,Brady Skjei,D,NSH,30,66,10,24,34
23,8480145,Neal Pionk,D,WPG,29,71,10,24,34
23,8477969,Marcus Pettersson,D,PIT,28,79,6,28,34
23,8476419,Jean-Gabriel Pageau,C,NYI,32,74,18,15,33
23,8482679,Matt Coronato,R,CGY,22,73,15,18,33
23,8480336,Sean Walker,D,CAR,30,77,12,21,33
23,8480817,K'Andre Miller,D,NYR,24,69,11,22,33
23,8480113,Alex Iafallo,L,WPG,31,65,11,22,33
23,8477444,Andre Burakovsky,L,SEA,29,67,10,23,33
23,8475753,Justin Faulk,D,STL,32,74,10,23,33
23,8480871,Adam Boqvist,D,FLA,24,67,10,23,33
23,8476885,Jacob Trouba,D,NYR,30,68,7,26,33
23,8477953,Kasperi Kapanen,R,STL,28,67,7,26,33
23,8482089,Jake Neighbours,L,STL,22,67,22,10,32
23,8476438,Brandon Saad,L,STL,32,71,19,13,32
23,8478366,Frank Vatrano,R,ANA,30,72,16,16,32
23,8479339,Patrik Laine,L,CBJ,26,62,12,20,32
23,8476927,Teddy Blueger,C,VAN,30,65,12,20,32
23,8478466,Daniel Sprong,R,VAN,27,71,11,21,32
23,8475218,Mattias Ekholm,D,EDM,34,72,10,22,32
23,8482067,Connor Mackey,D,NYR,28,62,10,22,32
23,8482712,Oskar Olausson,R,COL,22,80,0,32,32
23,8482175,JJ Peterka,R,BUF,22,67,16,15,31
23,8475714,Calle Jarnkrok,C,TOR,33,77,15,16,31
23,8481523,Kirby Dach,C,MTL,23,68,15,16,31
23,8477353,Tyler Motte,C,DET,29,78,15,16,31
23,8478133,Jake Evans,C,MTL,28,71,12,19,31
23,8473563,Nicklas Backstrom,C,WSH,37,58,9,22,31
23,8482122,Brock Faber,D,MIN,22,78,8,23,31
23,8476463,Jonas Brodin,D,MIN,31,75,7,24,31
23,8482671,Owen Power,D,BUF,22,68,7,24,31
23,8475171,Oliver Ekman-Larsson,D,TOR,33,68,7,24,31
23,8480073,Erik Brannstrom,D,COL,25,69,4,27,31
23,8477989,Christian Dvorak,C,MTL,28,70,14,16,30
23,8475149,Marcus Johansson,L,MIN,34,67,13,17,30
23,8477839,Conor Sheary,L,TBL,32,81,13,17,30
23,8482079,Marco Rossi,C,MIN,23,61,12,18,30
23,8482803,Olen Zellweger,D,ANA,21,68,12,18,30
23,8480448,Parker Kelly,L,COL,25,72,11,19,30
23,8478500,Ivan Provorov,D,CBJ,27,77,4,26,30
23,8477425,Miles Wood,L,COL,29,77,22,7,29
23,8479520,Brandon Duhaime,R,WSH,27,61,17,12,29
23,8479293,Brandon Tanev,L,SEA,33,64,16,13,29
23,8477479,Tyler Bertuzzi,L,CHI,29,60,14,15,29
23,8478109,Victor Olofsson,L,VGK,29,74,13,16,29
23,8481032,Paul Cotter,C,NJD,25,61,11,18,29
23,8476873,Mark Jankowski,C,NSH,30,53,11,18,29
23,8484203,Bradly Nadeau,L,CAR,19,69,10,19,29
23,8481656,Aliaksei Protas,C,WSH,23,66,10,19,29
23,8477498,Darnell Nurse,D,EDM,29,74,8,21,29
23,8475200,Dmitry Orlov,D,CAR,33,68,7,22,29
23,8482133,Thomas Bordeleau,C,SJS,22,71,4,25,29
23,8480878,Nils Lundkvist,D,DAL,24,73,3,26,29
23,8479398,Samuel Girard,D,COL,26,67,3,26,29
23,8479316,Luke Kunin,C,SJS,27,61,19,9,28
23,8481582,Nicholas Robertson,L,TOR,23,70,16,12,28
23,8476960,Andreas Athanasiou,C,CHI,30,50,15,13,28
23,8482146,Luke Evangelista,R,NSH,22,63,13,15,28
23,8483491,Ivan Miroshnichenko,L,WSH,20,55,11,17,28
23,8479976,Juuso Valimaki,D,UTA,26,66,6,22,28
23,8479639,Dylan Coghlan,D,WPG,26,59,6,22,28
23,8476892,Colton Parayko,D,STL,31,68,6,22,28
23,8482749,Joshua Roy,R,MTL,21,61,6,22,28
23,8483490,Pavel Mintyukov,D,ANA,21,71,4,24,28
23,8476331,Dylan DeMelo,D,WPG,31,72,4,24,28
23,8477845,Trevor van Riemsdyk,D,WSH,33,57,4,24,28
23,8477987,Ryan Donato,C,CHI,28,58,14,13,27
23,8479996,Cody Glass,C,NSH,25,59,13,14,27
23,8480068,Ryan Poehling,C,PHI,25,67,10,17,27
23,8478891,Mason Appleton,C,WPG,28,65,10,17,27
23,8478057,Dakota Joshua,C,VAN,28,65,9,18,27
23,8476525,Colin Miller,D,WPG,32,57,8,19,27
23,8476979,Erik Gustafsson,D,DET,32,77,4,23,27
23,8479941,Justin Danforth,R,CBJ,31,59,16,10,26
23,8482125,Alexander Holtz,R,VGK,22,67,16,10,26
23,8480806,Isac Lundestrom,C,ANA,25,58,14,12,26
23,8478020,Michael Amadio,R,OTT,28,73,14,12,26
23,8474715,Cameron Atkinson,R,TBL,35,80,13,13,26
23,8479390,Taylor Raddysh,R,WSH,26,58,12,14,26
23,8473422,Nick Foligno,L,CHI,37,66,12,14,26
23,8475193,Tomas Tatar,L,NJD,34,70,10,16,26
23,8479353,Brett Howden,C,VGK,26,68,10,16,26
23,8475791,Taylor Hall,L,CHI,33,56,9,17,26
23,8476917,Adam Pelech,D,NYI,30,80,7,19,26
23,8477435,Ryan Graves,D,PIT,29,74,7,19,26
23,8477506,Ryan Pulock,D,NYI,30,81,6,20,26
23,8481059,Scott Perunovich,D,STL,26,63,2,24,26
23,8477450,Jason Dickinson,C,CHI,29,56,15,10,25
23,8480829,Jesperi Kotkaniemi,C,CAR,24,65,14,11,25
23,8480835,Jack Drury,C,CAR,24,54,13,12,25
23,8477478,William Carrier,L,CAR,30,62,12,13,25
23,8474189,Lars Eller,C,PIT,35,60,10,15,25
23,8482117,Lukas Reichel,L,CHI,22,58,9,16,25
23,8477446,Michael McCarron,R,NSH,29,57,8,17,25
23,8481606,Jordan Spence,D,LAK,23,67,4,21,25
23,8477952,Robby Fabbri,C,ANA,28,65,16,8,24
23,8477508,Curtis Lazar,C,NJD,29,65,13,11,24
23,8480893,Kirill Marchenko,R,CBJ,24,58,13,11,24
23,8481580,Connor McMichael,C,WSH,23,66,10,14,24
23,8481517,Brett Leason,R,ANA,25,57,10,14,24
23,8482111,Justin Barron,D,MTL,23,58,9,15,24
23,8475231,Casey Cizikas,C,NYI,33,76,8,16,24
23,8476474,Stefan Noesen,R,NJD,31,61,7,17,24
23,8476921,Jordan Martinook,L,CAR,32,66,7,17,24
23,8478043,Sam Lafferty,C,BUF,29,53,7,17,24
23,8481546,Cam York,D,PHI,23,64,6,18,24
23,8479983,Mario Ferraro,D,SJS,26,68,6,18,24
23,8482148,Hendrix Lapierre,C,WSH,22,50,6,18,24
23,8481527,Kaedan Korczak,D,VGK,23,55,5,19,24
23,8473507,Jeff Petry,D,DET,37,74,3,21,24
23,8480035,Henri Jokiharju,D,BUF,25,59,2,22,24
23,8482074,Connor Zary,C,CGY,23,61,16,7,23
23,8482259,Bobby McMann,C,TOR,28,66,14,9,23
23,8481704,Juuso Parssinen,C,NSH,23,63,12,11,23
23,8479661,Tanner Jeannot,L,LAK,27,76,11,12,23
23,8476278,Colin Blackwell,C,DAL,31,72,11,12,23
23,8480748,Kiefer Sherwood,L,VAN,29,63,11,12,23
23,8477979,Nicolas Aube-Kubel,R,BUF,28,61,10,13,23
23,8477947,Sonny Milano,L,WSH,28,48,9,14,23
23,8480855,Jack McBain,C,UTA,24,68,7,16,23
23,8477488,Brett Pesce,D,NJD,30,66,5,18,23
23,8479982,Conor Timmins,D,TOR,26,50,5,18,23
23,8477499,Rasmus Ristolainen,D,PHI,30,67,5,18,23
23,8475233,David Savard,D,MTL,34,61,4,19,23
23,8478507,John Marino,D,UTA,27,61,3,20,23
23,8479066,Ryan Lomberg,L,CGY,30,68,14,8,22
23,8482157,Will Cuylle,L,NYR,22,66,13,9,22
23,8479393,Noah Gregor,L,OTT,26,71,12,10,22
23,8480813,Joe Veleno,C,DET,24,78,12,10,22
23,8479368,Max Jones,L,BOS,26,72,10,12,22
23,8476469,Joel Armia,R,MTL,31,66,9,13,22
23,8477015,Connor Brown,R,EDM,30,70,9,13,22
23,8482624,Daniil Miromanov,D,CGY,27,66,8,14,22
23,8476467,Jamie Oleksiak,D,SEA,32,73,7,15,22
23,8476891,Matthew Grzelcyk,D,PIT,30,77,4,18,22
23,8482087,Kaiden Guhle,D,MTL,22,73,3,19,22
23,8480172,Jan Rutta,D,SJS,34,65,3,19,22
23,8480049,Dylan Samberg,D,WPG,25,68,1,21,22
23,8476879,Cody Ceci,D,EDM,31,67,0,22,22
23,8476374,Sean Kuraly,C,CBJ,31,60,15,6,21
23,8479336,Carl Grundstrom,R,SJS,27,51,13,8,21
23,8480789,Oliver Wahlstrom,R,NYI,24,65,12,9,21
23,8479414,Nathan Bastian,R,NJD,27,49,10,11,21
23,8476897,Oskar Sundqvist,C,STL,30,57,10,11,21
23,8476329,Travis Boyd,C,MIN,31,58,10,11,21
23,8482062,Cole Smith,L,NSH,29,58,9,12,21
23,8482809,Jackson Blake,R,CAR,21,61,9,12,21
23,8476981,Josh Anderson,R,MTL,30,61,8,13,21
23,8481553,Bobby Brink,R,PHI,23,58,8,13,21
23,8478970,Jalen Chatfield,D,CAR,28,71,8,13,21
23,8478432,Christian Fischer,R,DET,27,73,7,14,21
23,8477507,Nikita Zadorov,D,BOS,29,65,7,14,21
23,8483468,Jiri Kulich,C,BUF,20,60,6,15,21
23,8475181,Nick Leddy,D,STL,33,70,6,15,21
23,8477365,Connor Clifton,D,BUF,29,53,5,16,21
23,8479324,Ryan Lindgren,D,NYR,26,65,4,17,21
23,8482655,Janis Moser,D,TBL,24,81,4,17,21
23,8474567,Zach Bogosian,D,MIN,34,60,3,18,21
23,8480043,Timothy Liljegren,D,TOR,25,69,2,19,21
23,8474673,TJ Brodie,D,CHI,34,63,2,19,21
23,8480281,Alexey Toropchenko,R,STL,25,61,14,6,20
23,8478911,Matt Roy,D,WSH,29,66,12,8,20
23,8478569,Noel Acciari,C,PIT,33,50,12,8,20
23,8480205,Emil Bemstrom,C,PIT,25,61,9,11,20
23,8482737,Zack Bolduc,C,STL,21,64,9,11,20
23,8477406,Mattias Janmark,C,EDM,32,69,8,12,20
23,8480762,Eric Robinson,L,CAR,29,50,8,12,20
23,8483482,Tristan Luneau,D,ANA,20,58,6,14,20
23,8482142,Jamie Drysdale,D,PHI,22,68,5,15,20
23,8480222,Sebastian Aho,D,PIT,28,73,5,15,20
23,8481521,Ronnie Attard,D,PHI,25,61,5,15,20
23,8476429,Scott Mayfield,D,NYI,32,75,3,17,20
23,8475462,Radko Gudas,D,ANA,34,68,3,17,20
23,8476878,Zemgus Girgensons,C,TBL,30,81,14,5,19
23,8479619,Michael Carcone,L,UTA,28,66,11,8,19
23,8470621,Corey Perry,R,EDM,39,77,10,9,19
23,8475343,Nic Dowd,C,WSH,34,60,10,9,19
23,8476889,Radek Faksa,C,STL,30,62,10,9,19
23,8478421,A.J. Greer,L,FLA,28,54,9,10,19
23,8480074,Alexandre Texier,C,STL,25,53,8,11,19
23,8477919,Frederick Gaudreau,C,MIN,31,58,7,12,19
23,8476918,Jimmy Vesey,L,NYR,31,66,7,12,19
23,8483457,Lane Hutson,D,MTL,20,69,7,12,19
23,8481481,Blake Lizotte,C,PIT,27,67,6,13,19
23,8480144,David Kampf,C,TOR,29,68,5,14,19
23,8478851,Alexandre Carrier,D,NSH,28,67,5,14,19
23,8479369,Andrew Peeke,D,BOS,26,60,5,14,19
23,8477903,Garnet Hathaway,R,PHI,33,64,5,14,19
23,8474151,Ryan McDonagh,D,TBL,35,71,4,15,19
23,8479402,Jake Bean,D,CGY,26,68,3,16,19
23,8477392,Hudson Fasching,R,NYI,29,67,3,16,19
23,8480873,Rasmus Sandin,D,WSH,24,71,1,18,19
23,8478508,Yakov Trenin,C,MIN,27,50,13,5,18
23,8480011,Klim Kostin,C,SJS,25,46,10,8,18
23,8475855,Jesper Fast,R,CAR,33,58,9,9,18
23,8482634,Alex Steeves,C,TOR,25,48,9,9,18
23,8475225,Craig Smith,C,CHI,35,55,8,10,18
23,8480021,Jack Studnicka,C,LAK,25,60,8,10,18
23,8481441,Joe Snively,C,DET,28,66,7,11,18
23,8481028,Martin Pospisil,C,CGY,25,50,7,11,18
23,8480995,Pontus Holmberg,R,TOR,25,59,6,12,18
23,8474574,Tyler Myers,D,VAN,34,71,6,12,18
23,8476457,Adam Larsson,D,SEA,32,65,6,12,18
23,8479543,Michael Pezzetta,L,MTL,26,56,6,12,18
23,8483445,Cutter Gauthier,L,ANA,20,67,5,13,18
23,8478882,Vladislav Gavrikov,D,LAK,29,64,5,13,18
23,8475188,Brayden McNabb,D,VGK,33,53,5,13,18
23,8480887,Jordan Harris,D,MTL,24,60,5,13,18
23,8475324,Nick Jensen,D,OTT,34,62,4,14,18
23,8477018,Ben Hutton,D,VGK,31,53,4,14,18
23,8476874,Olli Maatta,D,DET,30,65,3,15,18
23,8475455,Brenden Dillon,D,NJD,34,68,2,16,18
23,8479439,Jacob MacDonald,D,COL,31,56,8,9,17
23,8480289,Morgan Barron,C,WPG,26,55,7,10,17
23,8481537,Nikita Okhotiuk,D,CGY,24,54,7,10,17
23,8481601,Simon Holmstrom,R,NYI,23,70,6,11,17
23,8481522,Peyton Krebs,C,BUF,23,65,4,13,17
23,8476856,Mathew Dumba,D,DAL,30,73,4,13,17
23,8482101,Danil Gushchin,L,SJS,22,52,4,13,17
23,8480246,Nick Perbix,D,TBL,26,76,4,13,17
23,8478452,Caleb Jones,D,LAK,27,54,4,13,17
23,8480860,Kevin Bahl,D,CGY,24,48,4,13,17
23,8482245,Artem Zub,D,OTT,29,72,3,14,17
23,8475690,Chris Tanev,D,TOR,35,61,3,14,17
23,8476931,Jake McCabe,D,TOR,31,65,2,15,17
23,8481014,Alexander Romanov,D,NYI,24,75,1,16,17
23,8478840,Will Borgen,D,SEA,28,69,0,17,17
23,8480891,Michael Kesselring,D,UTA,24,60,0,17,17
23,8483524,Shane Wright,C,SEA,20,64,10,6,16
23,8481716,Dmitri Voronkov,L,CBJ,24,47,10,6,16
23,8483499,Liam Ohgren,L,MIN,20,52,9,7,16
23,8477573,Nathan Walker,L,STL,30,51,9,7,16
23,8479718,Alex Barré-Boulet,C,MTL,27,55,8,8,16
23,8481093,Rafael Harvey-Pinard,L,MTL,25,60,7,9,16
23,8482155,Alex Laferriere,R,LAK,23,56,7,9,16
23,8476442,Matt Nieto,L,PIT,32,53,6,10,16
23,8481161,Jake Christiansen,D,CBJ,25,56,5,11,16
23,8475279,Ben Chiarot,D,DET,33,63,5,11,16
23,8481708,Zac Jones,D,NYR,24,49,4,12,16
23,8483565,Nick Blankenburg,D,NSH,26,60,4,12,16
23,8476422,Mike Reilly,D,NYI,31,77,3,13,16
23,8480980,Connor Dewar,C,TOR,25,67,3,13,16
23,8471677,Jack Johnson,D,CBJ,37,68,3,13,16
23,8476967,Brett Kulak,D,EDM,30,67,2,14,16
23,8479371,Dante Fabbro,D,NSH,26,62,1,15,16
23,8479998,Mikey Anderson,D,LAK,25,63,1,15,16
23,8480058,Pierre-Olivier Joseph,D,STL,25,56,1,15,16
23,8480001,Urho Vaakanainen,D,ANA,25,62,1,15,16
23,8481568,Alex Vlasic,D,CHI,23,63,0,16,16
23,8479671,Mathieu Olivier,R,CBJ,27,46,10,5,15
23,8483493,Frank Nazar,C,CHI,20,52,8,7,15
23,8480003,Jesper Boqvist,C,FLA,26,71,6,9,15
23,8481013,Jonatan Berggren,R,DET,24,58,6,9,15
23,8480848,Ty Dellandrea,C,SJS,24,41,6,9,15
23,8476988,Matt Benning,D,SJS,30,63,5,10,15
23,8480157,Calle Rosen,D,COL,30,52,5,10,15
23,8480727,Zach Whitecloud,D,VGK,28,52,4,11,15
23,8475179,Dmitry Kulikov,D,FLA,34,64,3,12,15
23,8478178,Darren Raddysh,D,TBL,28,70,3,12,15
23,8482192,Isaak Phillips,D,CHI,23,56,3,12,15
23,8475750,Jon Merrill,D,MIN,32,60,3,12,15
23,8476624,Barclay Goodrow,C,SJS,31,54,2,13,15
23,8478831,Kevin Stenlund,C,UTA,28,55,8,6,14
23,8475842,Sam Carrick,C,NYR,32,66,7,7,14
23,8482077,Dylan Holloway,L,EDM,23,49,7,7,14
23,8478585,Derek Ryan,C,EDM,38,53,7,7,14
23,8484149,Gavin Brindley,C,CBJ,20,46,7,7,14
23,8480192,Johnathan Kovacevic,D,NJD,27,52,6,8,14
23,8482807,Ethan Del Mastro,D,CHI,21,48,6,8,14
23,8474034,Patrick Maroon,L,CHI,36,53,6,8,14
23,8479378,Logan Stanley,D,WPG,26,41,6,8,14
23,8482744,James Malatesta,L,CBJ,21,39,4,10,14
23,8471709,Marc-Edouard Vlasic,D,SJS,37,60,3,11,14
23,8480070,Ian Mitchell,D,BOS,25,48,3,11,14
23,8478136,Jake Middleton,D,MIN,28,75,2,12,14
23,8480807,Mattias Samuelsson,D,BUF,24,58,2,12,14
23,8474090,Brendan Smith,D,DAL,35,55,0,14,14
23,8481518,Nolan Foote,L,NJD,24,41,10,3,13
23,8479359,Beck Malenstyn,L,BUF,26,35,10,3,13
23,8479638,Justin Brazeau,R,BOS,26,43,10,3,13
23,8476867,Brendan Gaunce,C,MIN,30,35,6,7,13
23,8477380,Jonny Brodzinski,C,NYR,31,50,5,8,13
23,8483495,Simon Nemec,D,NJD,20,52,5,8,13
23,8475220,Marcus Foligno,L,MIN,33,62,5,8,13
23,8482095,Tyler Kleven,D,OTT,22,42,5,8,13
23,8482730,Brandt Clarke,D,LAK,21,53,4,9,13
23,8477220,Nate Schmidt,D,FLA,33,64,4,9,13
23,8477369,Carson Soucy,D,VAN,30,56,4,9,13
23,8481599,Victor Soderstrom,D,UTA,23,40,3,10,13
23,8480796,Martin Fehervary,D,WSH,25,52,3,10,13
23,8482859,Zack Ostapchuk,C,OTT,21,57,2,11,13
23,8474013,Ian Cole,D,UTA,35,52,1,12,13
23,8476473,Connor Murphy,D,CHI,31,43,0,13,13
23,8476858,Phillip Di Giuseppe,L,VAN,31,44,8,4,12
23,8480355,Mark Kastelic,C,BOS,25,60,7,5,12
23,8479968,Vinni Lettieri,C,BOS,29,49,7,5,12
23,8479370,Tyson Jost,C,CAR,26,47,6,6,12
23,8481477,Nico Sturm,C,SJS,29,49,6,6,12
23,8479344,Jesse Puljujarvi,R,PIT,26,49,6,6,12
23,8477931,Tomas Nosek,L,FLA,32,63,5,7,12
23,8482176,Wyatt Kaiser,D,CHI,22,48,5,7,12
23,8478211,Dryden Hunt,L,CGY,29,52,5,7,12
23,8482861,Vincent Iorio,D,WSH,22,40,5,7,12
23,8478013,Jake Walman,D,SJS,28,64,4,8,12
23,8481701,Santeri Hatakka,D,NJD,23,41,4,8,12
23,8477070,Liam O'Brien,C,UTA,30,51,4,8,12
23,8479981,Jonah Gadjovich,L,FLA,26,44,4,8,12
23,8479328,Julien Gauthier,R,NYI,27,60,3,9,12
23,8479972,Mason Shaw,C,WPG,26,35,3,9,12
23,8481751,Lukas Rousek,R,BUF,25,40,3,9,12
23,8478416,Erik Cernak,D,TBL,27,72,2,10,12
23,8482073,Braden Schneider,D,NYR,23,66,2,10,12
23,8482511,Mason Lohrei,D,BOS,23,36,2,10,12
23,8481178,Egor Zamula,D,PHI,24,52,1,11,12
23,8479026,Philippe Myers,D,TOR,27,52,1,11,12
23,8478399,Jonas Siegenthaler,D,NJD,27,58,1,11,12
23,8480196,Jacob Bryson,D,BUF,27,41,1,11,12
23,8475790,Erik Gudbranson,D,CBJ,32,74,1,11,12
23,8476822,Luke Glendening,C,TBL,35,74,7,4,11
23,8473453,Trevor Lewis,C,LAK,37,75,7,4,11
23,8481532,Alex Turcotte,C,LAK,23,57,6,5,11
23,8482652,Walker Duehr,R,CGY,27,42,5,6,11
23,8482762,Simon Edvinsson,D,DET,21,55,5,6,11
23,8478424,Jansen Harkins,C,ANA,27,46,5,6,11
23,8475235,Nicolas Deslauriers,L,PHI,33,45,5,6,11
23,8481019,David Gustafsson,C,WPG,24,46,4,7,11
23,8476952,Dominic Toninato,C,WPG,30,44,3,8,11
23,8475208,Brian Dumoulin,D,ANA,33,59,2,9,11
23,8478859,Niko Mikkola,D,FLA,28,52,2,9,11
23,8483460,David Jiricek,D,CBJ,21,58,2,9,11
23,8474166,Alec Martinez,D,CHI,37,41,1,10,11
23,8476994,Vinnie Hinostroza,C,NSH,30,52,1,10,11
23,8480845,Rasmus Kupari,C,WPG,24,36,7,3,10
23,8480990,Declan Chisholm,D,MIN,24,41,6,4,10
23,8477482,Zachary Sanford,L,CHI,30,38,5,5,10
23,8482166,Shakir Mukhamadullin,D,SJS,22,62,4,6,10
23,8480025,MacKenzie Entwistle,R,FLA,25,63,4,6,10
23,8479944,Zach Aston-Reese,C,VGK,30,46,4,6,10
23,8479315,Joey Anderson,R,CHI,26,53,3,7,10
23,8482666,Scott Morrow,D,CAR,22,47,3,7,10
23,8478451,Ethan Bear,D,WSH,27,51,3,7,10
23,8478874,Adam Gaudette,R,OTT,28,26,3,7,10
23,8481122,Simon Benoit,D,TOR,26,40,3,7,10
23,8483466,Kevin Korchinski,D,CHI,20,48,2,8,10
23,8474568,Luke Schenn,D,NSH,35,53,2,8,10
23,8482964,Arber Xhekaj,D,MTL,23,45,1,9,10
23,8480879,Jacob Bernard-Docker,D,OTT,24,47,1,9,10
23,8480950,Ilya Lyubushkin,D,DAL,30,56,0,10,10
23,8484254,Akito Hirose,D,VAN,25,42,0,10,10
23,8482659,Josh Doan,R,UTA,22,47,6,3,9
23,8479291,Kevin Rooney,C,CGY,31,44,5,4,9
23,8480441,Trey Fix-Wolansky,R,CBJ,25,36,5,4,9
23,8480880,Jakub Lauko,C,MIN,24,37,5,4,9
23,8471817,Ryan Reaves,R,TOR,37,52,5,4,9
23,8482747,Brennan Othmann,L,NYR,21,34,5,4,9
23,8480007,Jonas Rondbjerg,R,VGK,25,37,4,5,9
23,8483619,Filip Roos,D,OTT,25,35,4,5,9
23,8478409,Anthony Richard,C,PHI,28,40,4,5,9
23,8479986,Kole Lind,R,DAL,26,52,3,6,9
23,8477851,Jordan Oesterle,D,BOS,32,42,3,6,9
23,8482784,Zach Dean,C,STL,21,44,3,6,9
23,8478443,Brandon Carlo,D,BOS,28,58,2,7,9
23,8475718,Justin Holl,D,DET,32,53,2,7,9
23,8481567,Henry Thrun,D,SJS,23,54,2,7,9
23,8481609,Vladislav Kolyachonok,D,UTA,23,39,2,7,9
23,8479980,Nicolas Hague,D,VGK,26,59,1,8,9
23,8481167,Brayden Pachal,D,CGY,25,45,1,8,9
23,8482451,Mikael Pyyhtia,L,CBJ,23,37,0,9,9
23,8478434,Keegan Kolesar,R,VGK,27,64,6,2,8
23,8481617,Vasily Podkolzin,R,VAN,23,47,6,2,8
23,8481789,Tye Kartye,L,SEA,23,43,6,2,8
23,8479372,Joshua Mahura,D,SEA,26,55,4,4,8
23,8481592,Jakob Pelletier,L,CGY,23,34,4,4,8
23,8479348,Kale Clague,D,BUF,26,42,4,4,8
23,8482144,Jack Thompson,D,SJS,22,26,4,4,8
23,8482145,Mavrik Bourque,C,DAL,22,53,4,4,8
23,8480252,Cole Guttman,C,CHI,25,37,3,5,8
23,8470600,Ryan Suter,D,STL,39,55,3,5,8
23,8481641,Joel Kiviranta,L,COL,28,73,3,5,8
23,8479772,Zack MacEwen,R,OTT,28,58,3,5,8
23,8477938,Haydn Fleury,D,WPG,28,52,3,5,8
23,8481550,Adam Beckman,L,NJD,23,30,2,6,8
23,8477335,Kyle Burroughs,D,LAK,29,44,2,6,8
23,8475177,Calvin de Haan,D,COL,33,43,2,6,8
23,8475958,Michael Sgarbossa,C,WSH,32,28,2,6,8
23,8482177,Marat Khusnutdinov,C,MIN,22,40,2,6,8
23,8476312,Josh Manson,D,COL,33,55,1,7,8
23,8477034,Jaycob Megna,D,FLA,32,52,1,7,8
23,8479442,Troy Stecher,D,EDM,30,53,1,7,8
23,8483549,Lucas Condotta,L,MTL,27,33,1,7,8
23,8481600,Tobias Bjornfot,D,FLA,23,42,1,7,8
23,8482153,Brendan Brisson,C,VGK,23,31,5,2,7
23,8483397,Marc McLaughlin,C,BOS,25,39,5,2,7
23,8483012,Logan Morrison,C,SEA,22,38,4,3,7
23,8480245,Olle Lycksell,R,PHI,25,29,3,4,7
23,8481147,Reese Johnson,C,MIN,26,40,3,4,7
23,8478468,Jeremy Lauzon,D,NSH,27,48,2,5,7
23,8479994,Jaret Anderson-Dolan,C,WPG,25,29,2,5,7
23,8482102,Vasily Ponomarev,C,PIT,22,17,2,5,7
23,8478454,Noah Juulsen,D,VAN,27,32,1,6,7
23,8476372,Nick Seeler,D,PHI,31,39,0,7,7
23,8473446,Erik Johnson,D,PHI,36,43,0,7,7
23,8481598,Philip Broberg,D,EDM,23,41,5,1,6
23,8482765,Isak Rosen,R,BUF,21,36,4,2,6
23,8476934,Brock McGinn,L,ANA,30,48,3,3,6
23,8479320,Maxime Lajoie,D,SEA,27,24,3,3,6
23,8479367,William Lockwood,R,FLA,26,20,3,3,6
23,8483763,Maksymilian Szuber,D,UTA,22,26,3,3,6
23,8477962,Brendan Lemieux,L,CAR,28,36,2,4,6
23,8482713,Mackie Samoskevich,R,FLA,22,32,2,4,6
23,8482751,Ryan Winterton,C,SEA,21,34,2,4,6
23,8476913,Devin Shore,C,MIN,30,32,2,4,6
23,8474612,Travis Hamonic,D,OTT,34,49,2,4,6
23,8477462,Robert Hagg,D,VGK,29,28,2,4,6
23,8479536,Axel Jonsson-Fjallby,L,WPG,26,33,1,5,6
23,8480292,Carson Meyer,R,ANA,27,34,1,5,6
23,8477401,John Hayden,C,SEA,29,30,1,5,6
23,8482070,Mitchell Chaffee,R,TBL,26,44,1,5,6
23,8477244,Chad Ruhwedel,D,NYR,34,35,1,5,6
23,8481056,Spencer Stastney,D,NSH,24,31,0,6,6
23,8483570,Ben Meyers,C,SEA,26,21,3,2,5
23,8479379,Givani Smith,R,SJS,26,31,3,2,5
23,8478021,William Lagesson,D,DET,28,28,3,2,5
23,8480468,James Hamblin,L,EDM,25,19,3,2,5
23,8480844,Grigori Denisenko,L,VGK,24,37,2,3,5
23,8484911,Collin Graf,R,SJS,22,35,2,3,5
23,8481543,Nikita Alexandrov,C,STL,24,30,1,4,5
23,8478017,Mark Friedman,D,VAN,29,43,1,4,5
23,8478450,Parker Wotherspoon,D,BOS,27,36,1,4,5
23,8478051,Max Willman,C,NJD,29,17,1,4,5
23,8479985,Cale Fleury,D,SEA,26,24,0,5,5
23,8479587,Rhett Gardner,C,PHI,28,26,0,5,5
23,8481237,Kyle MacLean,C,NYI,25,17,3,1,4
23,8481754,Nikita Nesterenko,C,ANA,23,34,2,2,4
23,8481679,Maxence Guenette,D,OTT,23,34,2,2,4
23,8477473,Justin Bailey,R,SJS,29,30,2,2,4
23,8480870,Bo Groulx,C,NYR,24,33,2,2,4
23,8479991,Jake Leschyshyn,C,NYR,25,27,2,2,4
23,8482147,Jean-Luc Foudy,C,COL,22,27,2,2,4
23,8479249,Andrew Poturalski,C,SJS,30,29,1,3,4
23,8482496,Nils Aman,C,VAN,24,41,1,3,4
23,8477887,Patrick Brown,C,BOS,32,36,1,3,4
23,8482201,Gage Goncalves,C,TBL,23,32,1,3,4
23,8482516,Matthew Kessel,D,STL,24,17,1,3,4
23,8481719,Maxwell Crozier,D,TBL,24,13,1,3,4
23,8482733,Logan Mailloux,D,MTL,31,40,0,4,4
23,8477527,Ross Johnston,L,ANA,30,27,0,4,4
23,8484258,Sam Malinski,D,COL,26,15,2,1,3
23,8481422,Jake Lucchini,C,NSH,29,18,2,1,3
23,8482470,Ilya Solovyov,D,CGY,24,13,2,1,3
23,8478477,Mitchell Stephens,C,SEA,27,17,2,1,3
23,8477384,Joshua Brown,D,EDM,30,42,1,2,3
23,8475762,Derek Forbort,D,VAN,32,48,1,2,3
23,8478146,Matthew Highmore,C,OTT,28,39,1,2,3
23,8481605,Jackson LaCombe,D,ANA,23,32,1,2,3
23,8482172,Landon Slaggert,L,CHI,22,24,1,2,3
23,8477073,Kurtis MacDermid,L,NJD,30,32,1,2,3
23,8481065,Angus Crookshank,L,OTT,25,18,1,2,3
23,8482088,Justin Sourdif,R,FLA,22,27,1,2,3
23,8477810,Joel Hanley,D,CGY,33,29,0,3,3
23,8476441,Joel Edmundson,D,LAK,31,38,0,3,3
23,8482250,Callahan Burke,C,VGK,27,26,0,3,3
23,8481043,Cole Koepke,L,BOS,26,16,0,3,3
23,8478881,Brett Seney,L,CHI,28,9,2,0,2
23,8484287,Cole McWard,D,VAN,23,21,2,0,2
23,8484255,Jason Polin,R,COL,25,6,2,0,2
23,8483597,Milos Kelemen,L,UTA,25,7,2,0,2
23,8481556,John Beecher,C,BOS,23,32,1,1,2
23,8483630,Pavol Regenda,L,ANA,25,23,1,1,2
23,8480890,Jan Jenik,C,OTT,24,20,1,1,2
23,8477320,Anton Blidh,L,NYR,29,15,1,1,2
23,8481006,Tyler Tucker,D,STL,24,14,1,1,2
23,8477971,Andreas Englund,D,LAK,28,26,1,1,2
23,8483512,Matthew Savoie,C,EDM,20,17,1,1,2
23,8480851,Akil Thomas,C,LAK,24,14,1,1,2
23,8477467,Gustav Olofsson,D,SEA,30,14,1,1,2
23,8481564,Ryan Johnson,D,BUF,23,12,1,1,2
23,8483395,Arshdeep Bains,L,VAN,23,9,1,1,2
23,8478011,Louie Belpedio,D,PHI,28,9,1,1,2
23,8481030,Jack St. Ivany,D,PIT,25,14,1,1,2
23,8482929,Emil Lilleberg,D,TBL,23,26,0,2,2
23,8479576,Vincent Desharnais,D,VAN,28,33,0,2,2
23,8480874,Adam Ginning,D,PHI,24,12,0,2,2
23,8481585,Egor Afanasyev,L,SJS,23,11,0,2,2
23,8481743,Marc Del Gaizo,D,NSH,25,28,0,2,2
23,8479522,Hardy Haman Aktell,D,WSH,26,6,0,2,2
23,8481806,Louis Crevier,D,CHI,23,14,0,2,2
23,8477149,Scott Sabourin,R,SJS,32,15,0,2,2
23,8481593,Jayden Struble,D,MTL,23,18,0,2,2
23,8481726,Adam Edstrom,C,NYR,24,11,0,2,2
23,8482165,Yan Kuznetsov,D,CGY,22,17,1,0,1
23,8482118,Sam Colangelo,R,ANA,23,14,1,0,1
23,8480823,Alexander Alexeyev,D,WSH,25,10,1,0,1
23,8479419,Brett Murray,L,BUF,26,16,1,0,1
23,8483471,Brad Lambert,C,WPG,31,7,1,0,1
23,8480032,Shane Bowers,C,NJD,25,14,1,0,1
23,8482197,Adam Raska,R,MIN,23,5,1,0,1
23,8484304,Uvis Balinskis,D,FLA,28,8,1,0,1
23,8478854,Ryan Shea,D,PIT,27,7,1,0,1
23,8481541,Samuel Bolduc,D,NYI,24,19,0,1,1
23,8482141,Lukas Cormier,D,VGK,22,15,0,1,1
23,8478502,Dennis Gilbert,D,BUF,28,19,0,1,1
23,8480834,Ty Emberson,D,SJS,24,30,0,1,1
23,8482858,Ryker Evans,D,SEA,23,25,0,1,1
23,8479330,Brandon Gignac,C,MTL,27,11,0,1,1
23,8482162,Roby Jarventie,L,EDM,22,13,0,1,1
23,8477993,Justin Kirkland,C,CGY,28,3,0,1,1
23,8479421,Jacob Moverare,D,LAK,26,10,0,1,1
23,8481578,Graeme Clarke,R,MIN,23,5,0,1,1
23,8477541,Dakota Mermis,D,TOR,30,10,0,1,1
23,8483407,Brandon Scanlin,D,NYR,25,3,0,1,1
23,8483546,Marshall Rifai,D,TOR,26,3,0,1,1
23,8483531,Brian Halonen,L,NJD,25,3,0,1,1
23,8481206,John Ludvig,D,PIT,24,9,0,0,0
23,8479362,Riley Tufte,L,BOS,26,15,0,0,0
23,8481699,Aku Raty,R,UTA,23,12,0,0,0
23,8481655,Cole Schwindt,R,CGY,23,5,0,0,0
23,8481462,Mason Morelli,L,VGK,28,13,0,0,0
23,8483398,Declan Carlile,D,TBL,31,4,0,0,0
23,8483489,Fraser Minten,C,TOR,31,11,0,0,0
23,8475413,Justin Dowling,C,NJD,34,17,0,0,0
23,8480084,Nick DeSimone,D,NJD,30,14,0,0,0
23,8481024,Linus Karlsson,C,VAN,25,9,0,0,0
23,8484325,Waltteri Merela,C,TBL,26,20,0,0,0
23,8483920,Pierrick Dube,R,WSH,23,5,0,0,0
23,8482094,Daemon Hunt,D,MIN,22,17,0,0,0
23,8475780,Chris Wagner,R,COL,33,2,0,0,0
23,8480267,Sammy Walker,C,MIN,25,19,0,0,0
23,8482460,Matt Rempe,C,NYR,22,10,0,0,0
23,8482061,Brandon Biro,L,SEA,26,10,0,0,0
23,8475795,Dylan McIlrath,D,WSH,32,8,0,0,0
23,8483432,Luca Del Bel Belluz,C,CBJ,31,3,0,0,0
23,8474062,Riley Nash,C,NYR,35,16,0,0,0
23,8478446,Glenn Gawdin,C,LAK,27,10,0,0,0
23,8475755,Alexander Petrovic,D,DAL,32,11,0,0,0
23,8480306,Grant Hutton,D,NYI,29,5,0,0,0
23,8480075,Cameron Crotty,D,MIN,25,9,0,0,0
23,8483609,Adam Klapka,R,CGY,24,3,0,0,0
23,8482476,Emil Heineman,L,MTL,23,3,0,0,0
23,8483567,Georgii Merkulov,C,BOS,24,6,0,0,0
23,8482787,Nikita Chibrikov,R,WPG,31,5,0,0,0
23,8484326,Patrik Koch,D,UTA,28,4,0,0,0
23,8484259,Ondrej Pavel,C,COL,31,1,0,0,0
23,8480274,Philip Kemp,D,EDM,25,0,0,0,0
23,8483401,Marc Johnstone,R,PIT,28,2,0,0,0
23,8476323,Max McCormick,L,SEA,32,6,0,0,0
23,8484321,Nikolas Matinpalo,D,OTT,26,0,0,0,0
23,8478147,Bokondji Imama,L,PIT,28,6,0,0,0
23,8481534,Raphael Lavoie,C,EDM,24,5,0,0,0
23,8482126,Emil Andrae,D,PHI,31,0,0,0,0
23,8470794,Joe Pavelski,C,,40,0,0,0,0
23,8479321,Lucas Johansen,D,,27,0,0,0,0
23,8477950,Tony DeAngelo,D,,29,0,0,0,0
23,8471218,Blake Wheeler,R,,38,0,0,0,0
23,8475197,Tyson Barrie,D,,33,0,0,0,0
23,8474157,Max Pacioretty,L,,36,0,0,0,0
23,8475744,Evgeny Kuznetsov,C,,32,0,0,0,0
23,8474037,James van Riemsdyk,L,,35,0,0,0,0
23,8476907,Mackenzie MacEachern,L,,30,0,0,0,0
23,8480216,Jacob Peterson,C,,25,0,0,0,0
23,8474602,Justin Schultz,D,,34,0,0,0,0
23,8482222,Alexander Barabanov,L,,30,0,0,0,0
23,8474031,Kevin Shattenkirk,D,,35,0,0,0,0
23,8477330,Dominik Kubalik,L,,29,0,0,0,0
23,8480884,Calen Addison,D,,24,0,0,0,0
23,8475906,John Klingberg,D,,32,0,0,0,0
23,8480008,Adam Ruzicka,C,,25,0,0,0,0
23,8476884,Derrick Pouliot,D,,30,0,0,0,0
23,8476919,Chris Tierney,C,,30,0,0,0,0
23,8479415,Michael McLeod,C,,26,0,0,0,0
23,8474870,Tyler Johnson,C,,34,0,0,0,0
23,8470604,Jeff Carter,C,,39,0,0,0,0
23,8478104,Sammy Blais,L,,28,0,0,0,0
23,8474884,Mike Hoffman,C,,35,0,0,0,0
23,8481591,Sam Poulin,R,,23,0,0,0,0
23,8471274,Alex Goligoski,D,,39,0,0,0,0
23,8476871,Tanner Pearson,L,,32,0,0,0,0
23,8476393,Nick Cousins,C,,31,0,0,0,0
23,8479977,Kailer Yamamoto,R,,26,0,0,0,0
23,8479346,Dillon Dube,C,,26,0,0,0,0
23,8480184,Gustav Lindstrom,D,,26,0,0,0,0
23,8479376,Victor Mete,D,,26,0,0,0,0
23,8473449,Kyle Okposo,R,,36,0,0,0,0
23,8481058,Jesse Ylonen,R,,25,0,0,0,0
23,8475752,Tyler Pitlick,C,,33,0,0,0,0
23,8481239,Samuel Fagemo,L,,24,0,0,0,0
23,8480821,Filip Zadina,R,,25,0,0,0,0
23,8470966,Mark Giordano,D,,41,0,0,0,0
23,8478495,Denis Gurianov,R,,27,0,0,0,0
23,8477464,Nic Petan,C,,29,0,0,0,0
23,8478099,Kevin Labanc,R,,29,0,0,0,0
23,8482241,Radim Zohorna,L,,28,0,0,0,0
23,8474040,Sam Gagner,C,,35,0,0,0,0
23,8479514,Rem Pitlick,C,,27,0,0,0,0
23,8478430,Oliver Kylington,D,,27,0,0,0,0
23,8479533,Joona Koppanen,L,,26,0,0,0,0
23,8479984,Cal Foote,D,,26,0,0,0,0
23,8477126,Jayson Megna,C,,34,0,0,0,0
23,8475164,Jakob Silfverberg,R,,34,0,0,0,0
23,8474009,Nick Bonino,C,,36,0,0,0,0
23,8479458,Nikita Zaitsev,D,,33,0,0,0,0
23,8477944,Jakub Vrana,L,,28,0,0,0,0
23,8471699,Andrew Cogliano,C,,37,0,0,0,0
23,8478067,Oskar Lindblom,L,,28,0,0,0,0
23,8471686,Marc Staal,D,,37,0,0,0,0
23,8470610,Zach Parise,L,,40,0,0,0,0
23,8478904,Steven Lorentz,C,,28,0,0,0,0
23,8473473,Milan Lucic,L,,36,0,0,0,0
23,8480031,Maxime Comtois,L,,25,0,0,0,0
23,8478512,Austin Czarnik,C,,32,0,0,0,0
23,8473504,Cal Clutterbuck,R,,37,0,0,0,0
23,8477454,Adam Erne,L,,29,0,0,0,0
23,8479383,Boris Katchouk,L,,26,0,0,0,0
23,8475825,Jani Hakanpää,D,,32,0,0,0,0
23,8477846,Ryan Carpenter,C,,33,0,0,0,0
23,8477930,Pierre-Edouard Bellemare,L,,39,0,0,0,0
23,8478400,Colin White,C,,27,0,0,0,0
23,8480226,Marián Studenic,R,,26,0,0,0,0
23,8480853,Liam Foudy,C,,24,0,0,0,0
23,8475797,Jarred Tinordi,D,,32,0,0,0,0
23,8479423,Alex Nylander,L,,26,0,0,0,0
23,8474618,Marco Scandella,D,,34,0,0,0,0
23,8478028,Fredrik Olofsson,L,,28,0,0,0,0
23,8474709,Matt Martin,L,,35,0,0,0,0
23,8481070,Hugh McGing,L,,26,0,0,0,0
23,8479546,Oskar Steen,C,,26,0,0,0,0
23,8474145,Robert Bortuzzo,D,,35,0,0,0,0
23,8476915,Jujhar Khaira,L,,30,0,0,0,0
23,8475278,Byron Froese,C,,33,0,0,0,0
23,8481812,Nikolai Knyzhov,D,,27,0,0,0,0
23,8478408,Travis Dermott,D,,28,0,0,0,0
23,8481077,John Leonard,L,,26,0,0,0,0
23,8479547,Matthew Phillips,R,,26,0,0,0,0
23,8480836,Jonathan Gruden,C,,24,0,0,0,0
23,8481690,Tyler Angle,C,,24,0,0,0,0
23,8475766,Austin Watson,L,,32,0,0,0,0
23,8481016,Ruslan Iskhakov,C,,24,0,0,0,0
23,8478078,Rourke Chartier,C,,28,0,0,0,0
23,8480776,Sheldon Rempal,R,,29,0,0,0,0
23,8478956,Samuel Laberge,L,NJD,27,1,0,0,0
23,8483045,Cameron Butler,R,CBJ,31,1,0,0,0
23,8484314,Jiri Smejkal,L,,28,0,0,0,0
24,8476453,Nikita Kucherov,R,TBL,31,82,48,100,148
24,8478402,Connor McDavid,C,EDM,27,79,36,100,136
24,8478864,Kirill Kaprizov,L,MIN,27,75,61,72,133
24,8477956,David Pastrnak,R,BOS,28,78,62,70,132
24,8479318,Auston Matthews,C,TOR,27,79,74,53,127
24,8477492,Nathan MacKinnon,C,COL,29,80,45,82,127
24,8479314,Matthew Tkachuk,L,FLA,27,79,31,85,116
24,8478420,Mikko Rantanen,R,COL,28,81,48,63,111
24,8477404,Jake Guentzel,C,TBL,30,82,46,59,105
24,8477934,Leon Draisaitl,C,EDM,29,77,40,64,104
24,8478483,Mitch Marner,R,TOR,27,79,33,69,102
24,8471675,Sidney Crosby,C,PIT,37,68,43,57,100
24,8477939,William Nylander,R,TOR,28,73,39,59,98
24,8476389,Vincent Trocheck,C,NYR,31,75,27,70,97
24,8480023,Robert Thomas,C,STL,25,75,24,72,96
24,8476468,J.T. Miller,C,VAN,31,75,30,65,95
24,8478550,Artemi Panarin,L,NYR,33,78,26,68,94
24,8477933,Sam Reinhart,C,FLA,29,81,40,53,93
24,8481559,Jack Hughes,C,NJD,23,75,33,60,93
24,8477951,Nick Schmaltz,C,UTA,28,78,42,50,92
24,8481557,Matt Boldy,L,MIN,23,73,30,62,92
24,8476454,Ryan Nugent-Hopkins,C,EDM,31,79,32,59,91
24,8477493,Aleksander Barkov,C,FLA,29,79,27,62,89
24,8479407,Jesper Bratt,L,NJD,26,78,27,60,87
24,8478427,Sebastian Aho,C,CAR,27,75,40,46,86
24,8474564,Steven Stamkos,C,NSH,34,76,39,47,86
24,8477946,Dylan Larkin,C,DET,28,77,39,45,84
24,8477402,Pavel Buchnevich,L,STL,29,73,39,45,84
24,8478439,Travis Konecny,R,PHI,27,77,34,50,84
24,8480800,Quinn Hughes,D,VAN,25,74,11,73,84
24,8476887,Filip Forsberg,L,NSH,30,74,42,41,83
24,8478403,Jack Eichel,C,VGK,28,74,40,43,83
24,8477942,Kevin Fiala,L,LAK,28,78,29,54,83
24,8480069,Cale Makar,D,COL,26,72,18,65,83
24,8477409,Carter Verhaeghe,C,FLA,29,80,45,37,82
24,8478449,Roope Hintz,C,DAL,28,82,39,43,82
24,8478010,Brayden Point,C,TBL,28,81,31,51,82
24,8476346,Johnny Gaudreau,L,CBJ,31,78,20,61,81
24,8475913,Mark Stone,R,VGK,32,75,29,51,80
24,8479385,Jordan Kyrou,C,STL,26,79,27,53,80
24,8478440,Dylan Strome,C,WSH,27,72,27,53,80
24,8478398,Kyle Connor,L,WPG,28,74,39,40,79
24,8475166,John Tavares,C,TOR,34,80,33,46,79
24,8475692,Mats Zuccarello,R,MIN,37,72,23,56,79
24,8479542,Brandon Hagel,L,TBL,26,82,37,41,78
24,8479420,Tage Thompson,C,BUF,27,74,36,42,78
24,8476456,Jonathan Huberdeau,C,CGY,31,78,19,59,78
24,8479337,Alex DeBrincat,R,DET,27,81,36,41,77
24,8482699,Dylan Guenther,R,UTA,21,78,36,40,76
24,8480027,Jason Robertson,L,DAL,25,82,30,46,76
24,8480012,Elias Pettersson,C,VAN,26,75,30,45,75
24,8478445,Mathew Barzal,C,NYI,27,80,19,56,75
24,8475810,Bryan Rust,R,PIT,32,75,36,38,74
24,8480002,Nico Hischier,C,NJD,25,74,30,43,73
24,8482116,Tim Stützle,C,OTT,22,79,24,49,73
24,8474578,Erik Karlsson,D,PIT,34,77,14,59,73
24,8475167,Victor Hedman,D,TBL,34,80,12,61,73
24,8475786,Zach Hyman,L,EDM,32,78,43,29,72
24,8480208,Drake Batherson,R,OTT,26,79,31,41,72
24,8476539,Jonathan Marchessault,R,NSH,34,70,43,28,71
24,8482740,Wyatt Johnston,C,DAL,21,80,34,37,71
24,8475172,Nazem Kadri,C,CGY,34,75,29,42,71
24,8479343,Clayton Keller,R,UTA,26,77,27,44,71
24,8479323,Adam Fox,D,NYR,26,73,18,53,71
24,8478414,Timo Meier,R,NJD,28,72,31,39,70
24,8480018,Nick Suzuki,C,MTL,25,74,25,45,70
24,8475765,Vladimir Tarasenko,R,DET,33,79,24,46,70
24,8478460,Zach Werenski,D,CBJ,27,78,17,53,70
24,8474141,Patrick Kane,R,DET,36,81,29,40,69
24,8477960,Adrian Kempe,R,LAK,28,81,28,41,69
24,8477986,Brandon Montour,D,SEA,30,78,22,47,69
24,8474600,Roman Josi,D,NSH,34,68,21,48,69
24,8477955,Jared McCann,L,SEA,28,74,31,37,68
24,8471685,Anze Kopitar,C,LAK,37,81,25,43,68
24,8477940,Nikolaj Ehlers,L,WPG,28,72,24,44,68
24,8478493,Joel Eriksson Ek,C,MIN,27,73,31,36,67
24,8471215,Evgeni Malkin,C,PIT,38,71,30,36,66
24,8480830,Andrei Svechnikov,R,CAR,24,67,24,42,66
24,8480036,Miro Heiskanen,D,DAL,25,76,10,56,66
24,8475754,Brock Nelson,C,NYI,33,77,34,31,65
24,8479675,Trevor Moore,L,LAK,29,80,29,36,65
24,8478047,Michael Bunting,L,PIT,29,74,24,41,65
24,8477416,Oliver Bjorkstrand,R,SEA,29,75,24,41,65
24,8473419,Brad Marchand,L,BOS,36,78,21,44,65
24,8482684,Luke Hughes,D,NJD,21,71,12,53,65
24,8482745,Mason McTavish,C,ANA,21,77,32,32,64
24,8478519,Anthony Cirelli,C,TBL,27,82,29,35,64
24,8480803,Evan Bouchard,D,EDM,25,76,15,49,64
24,8481711,Matias Maccelli,L,UTA,24,73,26,37,63
24,8484153,Leo Carlsson,C,ANA,20,78,25,38,63
24,8479999,Casey Mittelstadt,C,COL,26,81,20,43,63
24,8477501,Valeri Nichushkin,R,COL,29,81,29,33,62
24,8480801,Brady Tkachuk,L,OTT,25,80,28,34,62
24,8476479,Phillip Danault,C,LAK,31,78,22,40,62
24,8482078,Lucas Raymond,L,DET,22,81,28,33,61
24,8476448,William Karlsson,C,VGK,31,76,25,36,61
24,8475184,Chris Kreider,L,NYR,33,75,35,25,60
24,8476483,Rickard Rakell,R,PIT,31,68,34,26,60
24,8482113,Anton Lundell,C,FLA,23,77,26,34,60
24,8478873,Troy Terry,R,ANA,27,75,16,44,60
24,8475798,Mikael Granlund,C,SJS,32,69,16,44,60
24,8474679,Gustav Nyquist,C,NSH,35,70,16,44,60
24,8477500,Bo Horvat,C,NYI,29,78,28,31,59
24,8476881,Tomas Hertl,C,VGK,31,75,27,32,59
24,8474586,Jordan Eberle,R,SEA,34,74,27,32,59
24,8484144,Connor Bedard,C,CHI,19,71,23,36,59
24,8475158,Ryan O'Reilly,C,NSH,33,71,20,39,59
24,8473512,Claude Giroux,R,OTT,36,80,19,40,59
24,8473994,Jamie Benn,L,DAL,35,81,18,41,59
24,8474150,Mikael Backlund,C,CGY,35,79,18,41,59
24,8475784,Jeff Skinner,C,EDM,32,76,32,26,58
24,8478401,Pavel Zacha,C,BOS,27,78,31,27,58
24,8475314,Anders Lee,L,NYI,34,79,29,29,58
24,8475168,Matt Duchene,C,DAL,33,80,23,35,58
24,8475170,Brayden Schenn,C,STL,33,74,22,36,58
24,8477949,Alex Tuch,R,BUF,28,71,19,39,58
24,8478042,Viktor Arvidsson,L,EDM,31,77,18,40,58
24,8477504,Josh Morrissey,D,WPG,29,71,12,46,58
24,8478407,Vince Dunn,D,SEA,28,74,6,52,58
24,8480039,Martin Necas,C,CAR,25,74,24,33,57
24,8474641,Adam Henrique,C,EDM,34,78,21,36,57
24,8476460,Mark Scheifele,C,WPG,31,68,19,38,57
24,8480839,Rasmus Dahlin,D,BUF,24,72,19,38,57
24,8480865,Noah Dobson,D,NYI,24,78,11,46,57
24,8481542,Moritz Seider,D,DET,23,73,10,47,57
24,8475191,Reilly Smith,R,NYR,33,73,27,29,56
24,8481540,Cole Caufield,R,MTL,23,71,22,34,56
24,8476459,Mika Zibanejad,C,NYR,31,73,21,35,56
24,8475745,Charlie Coyle,C,BOS,32,79,16,40,56
24,8476875,Mike Matheson,D,MTL,30,70,18,37,55
24,8476906,Shayne Gostisbehere,D,CAR,31,76,16,39,55
24,8476853,Morgan Rielly,D,TOR,30,67,8,47,55
24,8478366,Frank Vatrano,R,ANA,30,75,35,19,54
24,8475169,Evander Kane,L,EDM,33,76,34,20,54
24,8483431,Logan Cooley,C,UTA,20,77,28,26,54
24,8479400,Pierre-Luc Dubois,L,WSH,26,70,24,30,54
24,8476882,Teuvo Teravainen,C,CHI,30,68,23,31,54
24,8471214,Alex Ovechkin,L,WSH,39,74,30,23,53
24,8480015,Owen Tippett,R,PHI,25,77,29,24,53
24,8482109,Alexis Lafrenière,L,NYR,23,74,27,26,53
24,8478856,Conor Garland,R,VAN,28,75,25,28,53
24,8482665,Matty Beniers,C,SEA,22,73,15,38,53
24,8474563,Drew Doughty,D,LAK,35,69,14,39,53
24,8474590,John Carlson,D,WSH,34,68,6,47,53
24,8480014,Gabriel Vilardi,C,WPG,25,73,32,20,52
24,8482124,Quinton Byfield,R,LAK,22,80,24,28,52
24,8482093,Seth Jarvis,C,CAR,22,67,20,32,52
24,8477447,Shea Theodore,D,VGK,29,65,11,41,52
24,8478397,Rasmus Andersson,D,CGY,28,75,8,44,52
24,8478975,Mason Marchment,L,DAL,29,79,28,23,51
24,8482475,Yegor Chinakhov,R,CBJ,23,73,27,24,51
24,8478498,Jake DeBrusk,L,VAN,28,75,24,27,51
24,8482667,William Eklund,L,SJS,22,67,21,30,51
24,8481528,Dylan Cozens,C,BUF,23,76,18,33,51
24,8476905,Chandler Stephenson,C,SEA,30,70,17,34,51
24,8474102,David Perron,L,OTT,36,77,17,33,50
24,8477451,Ryan Hartman,R,MIN,30,75,27,22,49
24,8474149,Evgenii Dadonov,R,DAL,35,81,21,28,49
24,8477407,Anthony Duclair,L,NYI,29,81,20,29,49
24,8482110,Dawson Mercer,C,NJD,23,72,28,20,48
24,8482055,Drew O'Connor,L,PIT,26,69,25,23,48
24,8477476,Artturi Lehkonen,L,COL,29,79,23,25,48
24,8477456,J.T. Compher,L,DET,29,77,22,26,48
24,8478542,Evan Rodrigues,C,FLA,31,80,21,27,48
24,8480188,Fabian Zetterlund,L,SJS,25,70,21,27,48
24,8477496,Elias Lindholm,C,BOS,30,78,18,30,48
24,8482159,Tyson Foerster,R,PHI,22,76,17,31,48
24,8478438,Tommy Novak,C,NSH,27,68,15,33,48
24,8475794,Tyler Seguin,C,DAL,32,78,13,35,48
24,8478055,Gustav Forsling,D,FLA,28,71,12,36,48
24,8477498,Darnell Nurse,D,EDM,29,73,10,38,48
24,8478444,Brock Boeser,R,VAN,27,73,23,24,47
24,8479525,Ross Colton,C,COL,28,81,23,24,47
24,8481560,Arthur Kaliyev,R,LAK,23,78,21,26,47
24,8478233,Andrew Mangiapane,L,WSH,28,71,19,28,47
24,8475799,Nino Niederreiter,R,WPG,32,66,18,29,47
24,8482705,Cole Sillinger,C,CBJ,21,69,17,30,47
24,8476792,Torey Krug,D,STL,33,75,15,32,47
24,8477429,Andrew Copp,C,DET,30,80,15,32,47
24,8471724,Kris Letang,D,PIT,37,75,11,36,47
24,8481068,Yegor Sharangovich,C,CGY,26,77,20,26,46
24,8476292,Ondrej Palat,L,NJD,33,70,19,27,46
24,8480064,Josh Norris,C,OTT,25,73,17,29,46
24,8477479,Tyler Bertuzzi,L,CHI,29,61,14,32,46
24,8477494,Jonathan Drouin,L,COL,29,79,13,33,46
24,8476923,Damon Severson,D,CBJ,30,78,13,33,46
24,8479325,Charlie McAvoy,D,BOS,27,70,9,37,46
24,8476399,Blake Coleman,C,CGY,33,76,30,15,45
24,8477935,Sam Bennett,C,FLA,28,76,20,25,45
24,8475726,Tyler Toffoli,C,SJS,32,63,20,25,45
24,8477497,Sean Monahan,C,CBJ,30,67,17,28,45
24,8483515,Juraj Slafkovsky,L,MTL,20,76,17,28,45
24,8478474,Lawson Crouse,L,UTA,27,74,17,28,45
24,8473986,Alex Killorn,L,ANA,35,73,16,29,45
24,8477021,Alex Kerfoot,C,UTA,30,73,16,29,45
24,8482720,Matthew Knies,L,TOR,22,79,15,30,45
24,8477932,Aaron Ekblad,D,FLA,28,77,8,37,45
24,8480009,Eeli Tolvanen,R,SEA,25,73,19,25,44
24,8478462,Nicolas Roy,C,VGK,27,73,17,27,44
24,8481533,Trevor Zegras,C,ANA,23,73,12,32,44
24,8477346,MacKenzie Weegar,D,CGY,30,74,12,32,44
24,8477503,Max Domi,C,TOR,29,72,11,33,44
24,8475764,Cam Fowler,D,ANA,33,74,6,38,44
24,8476432,Boone Jenner,C,CBJ,31,64,27,16,43
24,8482149,Cole Perfetti,C,WPG,22,73,22,21,43
24,8482097,Jack Quinn,R,BUF,23,67,21,22,43
24,8477964,Ivan Barbashev,C,VGK,29,77,19,24,43
24,8484145,Zach Benson,L,BUF,19,75,19,24,43
24,8480797,Joel Farabee,L,PHI,24,66,17,26,43
24,8479345,Jakob Chychrun,D,WSH,26,67,15,28,43
24,8476474,Stefan Noesen,R,NJD,31,71,15,28,43
24,8477495,Seth Jones,D,CHI,30,66,6,37,43
24,8481604,Pavel Dorofeyev,L,VGK,24,66,24,18,42
24,8477511,Anthony Mantha,R,CGY,30,76,17,25,42
24,8476480,Vladislav Namestnikov,C,WPG,32,62,11,31,42
24,8480817,K'Andre Miller,D,NYR,24,76,10,32,42
24,8479410,Mikhail Sergachev,D,UTA,26,73,3,39,42
24,8477998,Warren Foegele,L,LAK,28,78,19,22,41
24,8475793,Ryan Johansen,C,PHI,32,73,18,23,41
24,8476880,Tom Wilson,R,WSH,30,65,18,23,41
24,8480028,Morgan Frost,C,PHI,25,72,13,28,41
24,8476458,Ryan Strome,C,ANA,31,66,8,33,41
24,8481596,Shane Pinto,C,OTT,24,76,15,25,40
24,8479987,Morgan Geekie,C,BOS,26,78,15,25,40
24,8476872,Scott Laughton,C,PHI,30,71,11,29,40
24,8481577,Philip Tomasino,C,NSH,23,70,11,29,40
24,8478396,Noah Hanifin,D,VGK,27,63,7,33,40
24,8476869,Brady Skjei,D,NSH,30,78,6,34,40
24,8481618,Alex Newhook,C,MTL,23,75,21,18,39
24,8484166,Adam Fantilli,C,CBJ,20,69,21,18,39
24,8482133,Thomas Bordeleau,C,SJS,22,61,18,21,39
24,8477426,Nicholas Paul,L,TBL,29,81,16,23,39
24,8480145,Neal Pionk,D,WPG,29,73,10,29,39
24,8478466,Daniel Sprong,R,VAN,27,73,10,29,39
24,8478020,Michael Amadio,R,OTT,28,69,21,17,38
24,8479339,Patrik Laine,L,CBJ,26,61,15,23,38
24,8474716,Jared Spurgeon,D,MIN,35,76,13,25,38
24,8482702,Logan Stankoven,C,DAL,21,81,13,25,38
24,8480220,Noah Cates,L,PHI,25,73,12,26,38
24,8482660,Kent Johnson,C,CBJ,22,69,11,27,38
24,8476917,Adam Pelech,D,NYI,30,78,6,32,38
24,8476958,Jaccob Slavin,D,CAR,30,75,5,33,38
24,8481186,Logan O'Connor,R,COL,28,80,18,19,37
24,8478115,Pierre Engvall,L,NYI,28,78,17,20,37
24,8482146,Luke Evangelista,R,NSH,22,68,17,20,37
24,8479365,Trent Frederic,C,BOS,26,79,13,24,37
24,8481524,Bowen Byram,D,BUF,23,68,10,27,37
24,8476463,Jonas Brodin,D,MIN,31,71,6,31,37
24,8475151,Kyle Palmieri,C,NYI,33,80,24,12,36
24,8476981,Josh Anderson,R,MTL,30,74,18,18,36
24,8478038,Devon Toews,D,COL,30,67,12,24,36
24,8481546,Cam York,D,PHI,23,65,9,27,36
24,8474565,Alex Pietrangelo,D,VGK,34,58,8,28,36
24,8479425,Filip Hronek,D,VAN,27,73,7,29,36
24,8482655,Janis Moser,D,TBL,24,80,6,30,36
24,8476854,Hampus Lindholm,D,BOS,30,67,5,31,36
24,8475768,Jaden Schwartz,C,SEA,32,66,20,15,35
24,8482092,Ridly Greig,C,OTT,22,77,19,16,35
24,8483808,Andrei Kuzmenko,L,CGY,28,70,17,18,35
24,8482175,JJ Peterka,R,BUF,22,66,17,18,35
24,8476462,Dougie Hamilton,D,NJD,31,67,15,20,35
24,8475791,Taylor Hall,L,CHI,33,65,15,20,35
24,8475287,Erik Haula,L,NJD,33,69,14,21,35
24,8474053,Logan Couture,C,SJS,35,55,12,23,35
24,8475193,Tomas Tatar,L,NJD,34,68,11,24,35
24,8480434,Sean Durzi,D,UTA,26,71,10,25,35
24,8481703,Valtteri Puustinen,R,PIT,25,63,7,28,35
24,8482122,Brock Faber,D,MIN,22,79,4,31,35
24,8474715,Cameron Atkinson,R,TBL,35,81,22,12,34
24,8479351,Sam Steel,C,DAL,26,81,21,13,34
24,8471698,T.J. Oshie,R,WSH,38,68,18,16,34
24,8481535,Nils Hoglander,L,VAN,24,71,18,16,34
24,8480068,Ryan Poehling,C,PHI,25,72,17,17,34
24,8479992,Michael Rasmussen,C,DET,25,79,14,20,34
24,8480829,Jesperi Kotkaniemi,C,CAR,24,68,13,21,34
24,8480798,Philipp Kurashev,C,CHI,25,66,11,23,34
24,8478469,Thomas Chabot,D,OTT,27,72,9,25,34
24,8480871,Adam Boqvist,D,FLA,24,70,7,27,34
24,8470613,Brent Burns,D,CAR,39,75,2,32,34
24,8480185,Eetu Luostarinen,C,FLA,26,71,18,15,33
24,8477947,Sonny Milano,L,WSH,28,63,16,17,33
24,8475763,Kevin Hayes,R,PIT,32,68,14,19,33
24,8477444,Andre Burakovsky,L,SEA,29,67,11,22,33
24,8475753,Justin Faulk,D,STL,32,71,7,26,33
24,8479591,Michael Eyssimont,C,TBL,28,80,18,14,32
24,8479293,Brandon Tanev,L,SEA,33,69,17,15,32
24,8474189,Lars Eller,C,PIT,35,66,17,15,32
24,8475714,Calle Jarnkrok,C,TOR,33,74,15,17,32
24,8476438,Brandon Saad,L,STL,32,71,14,18,32
24,8475760,Nick Bjugstad,C,UTA,32,69,11,21,32
24,8482105,Jake Sanderson,D,OTT,22,73,11,21,32
24,8475218,Mattias Ekholm,D,EDM,34,70,11,21,32
24,8477919,Frederick Gaudreau,C,MIN,31,67,8,24,32
24,8478840,Will Borgen,D,SEA,28,62,8,24,32
24,8476979,Erik Gustafsson,D,DET,32,74,4,28,32
24,8482079,Marco Rossi,C,MIN,23,59,20,11,31
24,8477505,Alexander Wennberg,C,SJS,30,61,11,20,31
24,8477953,Kasperi Kapanen,R,STL,28,69,11,20,31
24,8478891,Mason Appleton,C,WPG,28,60,11,20,31
24,8480336,Sean Walker,D,CAR,30,76,10,21,31
24,8475149,Marcus Johansson,L,MIN,34,65,10,21,31
24,8479398,Samuel Girard,D,COL,26,69,5,26,31
24,8475171,Oliver Ekman-Larsson,D,TOR,33,70,4,27,31
24,8476897,Oskar Sundqvist,C,STL,30,72,19,11,30
24,8476419,Jean-Gabriel Pageau,C,NYI,32,75,16,14,30
24,8479941,Justin Danforth,R,CBJ,31,60,16,14,30
24,8478046,Danton Heinen,L,VAN,29,69,15,15,30
24,8476392,Adam Lowry,C,WPG,31,60,14,16,30
24,8475848,Brendan Gallagher,R,MTL,32,67,13,17,30
24,8476826,Yanni Gourde,C,SEA,33,71,12,18,30
24,8483505,Matthew Poitras,C,BOS,20,76,12,18,30
24,8479353,Brett Howden,C,VGK,26,73,12,18,30
24,8476278,Colin Blackwell,C,DAL,31,78,12,18,30
24,8481624,Ilya Mikheyev,R,CHI,30,62,11,19,30
24,8477839,Conor Sheary,L,TBL,32,79,10,20,30
24,8480459,Pius Suter,C,VAN,28,69,19,10,29
24,8480855,Jack McBain,C,UTA,24,70,16,13,29
24,8475722,Jason Zucker,L,BUF,32,70,13,16,29
24,8478458,John (Jack) Roslovic,C,CAR,27,72,11,18,29
24,8476461,Sean Couturier,C,PHI,32,65,11,18,29
24,8480748,Kiefer Sherwood,L,VAN,29,62,11,18,29
24,8481704,Juuso Parssinen,C,NSH,23,54,9,20,29
24,8479336,Carl Grundstrom,R,SJS,27,61,16,12,28
24,8480448,Parker Kelly,L,COL,25,73,15,13,28
24,8478463,Anthony Beauvillier,L,PIT,27,67,14,14,28
24,8480144,David Kampf,C,TOR,29,65,14,14,28
24,8477425,Miles Wood,L,COL,29,73,12,16,28
24,8480003,Jesper Boqvist,C,FLA,26,68,12,16,28
24,8480849,Barrett Hayton,C,UTA,24,68,11,17,28
24,8484203,Bradly Nadeau,L,CAR,19,67,11,17,28
24,8481523,Kirby Dach,C,MTL,23,61,10,18,28
24,8483524,Shane Wright,C,SEA,20,63,10,18,28
24,8482737,Zack Bolduc,C,STL,21,58,9,19,28
24,8482712,Oskar Olausson,R,COL,22,77,8,20,28
24,8480802,Ryan McLeod,C,BUF,25,62,7,21,28
24,8477969,Marcus Pettersson,D,PIT,28,76,5,23,28
24,8473507,Jeff Petry,D,DET,37,69,5,23,28
24,8482259,Bobby McMann,C,TOR,28,65,18,9,27
24,8480813,Joe Veleno,C,DET,24,73,16,11,27
24,8476921,Jordan Martinook,L,CAR,32,57,14,13,27
24,8475343,Nic Dowd,C,WSH,34,61,12,15,27
24,8482111,Justin Barron,D,MTL,23,66,10,17,27
24,8481581,Thomas Harley,D,DAL,23,78,9,18,27
24,8473563,Nicklas Backstrom,C,WSH,37,66,7,20,27
24,8479639,Dylan Coghlan,D,WPG,26,61,6,21,27
24,8477506,Ryan Pulock,D,NYI,30,79,5,22,27
24,8476892,Colton Parayko,D,STL,31,70,2,25,27
24,8480043,Timothy Liljegren,D,TOR,25,65,2,25,27
24,8477952,Robby Fabbri,C,ANA,28,65,15,11,26
24,8477903,Garnet Hathaway,R,PHI,33,68,14,12,26
24,8476918,Jimmy Vesey,L,NYR,31,66,13,13,26
24,8481582,Nicholas Robertson,L,TOR,23,66,12,14,26
24,8483491,Ivan Miroshnichenko,L,WSH,20,57,12,14,26
24,8480113,Alex Iafallo,L,WPG,31,64,10,16,26
24,8476469,Joel Armia,R,MTL,31,70,10,16,26
24,8475220,Marcus Foligno,L,MIN,33,56,8,18,26
24,8480078,Filip Chytil,C,NYR,25,67,7,19,26
24,8483490,Pavel Mintyukov,D,ANA,21,70,7,19,26
24,8482624,Daniil Miromanov,D,CGY,27,63,6,20,26
24,8478882,Vladislav Gavrikov,D,LAK,29,68,4,22,26
24,8481554,Kaapo Kakko,R,NYR,23,69,18,7,25
24,8478109,Victor Olofsson,L,VGK,29,72,16,9,25
24,8483445,Cutter Gauthier,L,ANA,20,60,11,14,25
24,8475842,Sam Carrick,C,NYR,32,59,11,14,25
24,8480789,Oliver Wahlstrom,R,NYI,24,69,10,15,25
24,8478472,Mathieu Joseph,R,STL,27,69,8,17,25
24,8474151,Ryan McDonagh,D,TBL,35,73,8,17,25
24,8477948,Travis Sanheim,D,PHI,28,68,6,19,25
24,8478133,Jake Evans,C,MTL,28,72,6,19,25
24,8482671,Owen Power,D,BUF,22,68,6,19,25
24,8476856,Mathew Dumba,D,DAL,30,73,5,20,25
24,8481527,Kaedan Korczak,D,VGK,23,49,4,21,25
24,8480891,Michael Kesselring,D,UTA,24,60,3,22,25
24,8478507,John Marino,D,UTA,27,64,2,23,25
24,8480873,Rasmus Sandin,D,WSH,24,63,2,23,25
24,8480281,Alexey Toropchenko,R,STL,25,56,18,6,24
24,8477989,Christian Dvorak,C,MTL,28,68,16,8,24
24,8473533,Jordan Staal,C,CAR,36,65,14,10,24
24,8482074,Connor Zary,C,CGY,23,67,13,11,24
24,8477015,Connor Brown,R,EDM,30,59,13,11,24
24,8476925,Colton Sissons,C,NSH,31,66,11,13,24
24,8479316,Luke Kunin,C,SJS,27,66,11,13,24
24,8476329,Travis Boyd,C,MIN,31,61,11,13,24
24,8478508,Yakov Trenin,C,MIN,27,55,10,14,24
24,8477450,Jason Dickinson,C,CHI,29,58,9,15,24
24,8479393,Noah Gregor,L,OTT,26,74,9,15,24
24,8481093,Rafael Harvey-Pinard,L,MTL,25,59,9,15,24
24,8478434,Keegan Kolesar,R,VGK,27,68,8,16,24
24,8470621,Corey Perry,R,EDM,39,69,7,17,24
24,8482101,Danil Gushchin,L,SJS,22,52,7,17,24
24,8476467,Jamie Oleksiak,D,SEA,32,65,6,18,24
24,8477353,Tyler Motte,C,DET,29,71,5,19,24
24,8476331,Dylan DeMelo,D,WPG,31,70,5,19,24
24,8478136,Jake Middleton,D,MIN,28,76,4,20,24
24,8478500,Ivan Provorov,D,CBJ,27,79,3,21,24
24,8479661,Tanner Jeannot,L,LAK,27,77,13,10,23
24,8478413,Jordan Greenway,L,BUF,27,58,12,11,23
24,8477446,Michael McCarron,R,NSH,29,64,12,11,23
24,8478057,Dakota Joshua,C,VAN,28,67,11,12,23
24,8480893,Kirill Marchenko,R,CBJ,24,52,11,12,23
24,8475200,Dmitry Orlov,D,CAR,33,73,8,15,23
24,8480878,Nils Lundkvist,D,DAL,24,67,5,18,23
24,8482142,Jamie Drysdale,D,PHI,22,67,5,18,23
24,8481656,Aliaksei Protas,C,WSH,23,63,4,19,23
24,8479976,Juuso Valimaki,D,UTA,26,59,3,20,23
24,8483565,Nick Blankenburg,D,NSH,26,67,3,20,23
24,8477220,Nate Schmidt,D,FLA,33,60,3,20,23
24,8479998,Mikey Anderson,D,LAK,25,68,2,21,23
24,8479390,Taylor Raddysh,R,WSH,26,59,14,8,22
24,8476960,Andreas Athanasiou,C,CHI,30,48,12,10,22
24,8477478,William Carrier,L,CAR,30,58,12,10,22
24,8479315,Joey Anderson,R,CHI,26,51,11,11,22
24,8477406,Mattias Janmark,C,EDM,32,63,10,12,22
24,8480762,Eric Robinson,L,CAR,29,62,10,12,22
24,8476927,Teddy Blueger,C,VAN,30,70,9,13,22
24,8477987,Ryan Donato,C,CHI,28,62,9,13,22
24,8476525,Colin Miller,D,WPG,32,67,8,14,22
24,8481553,Bobby Brink,R,PHI,23,59,7,15,22
24,8473453,Trevor Lewis,C,LAK,37,72,7,15,22
24,8476885,Jacob Trouba,D,NYR,30,69,4,18,22
24,8482073,Braden Schneider,D,NYR,23,67,4,18,22
24,8480727,Zach Whitecloud,D,VGK,28,50,1,21,22
24,8479619,Michael Carcone,L,UTA,28,55,13,8,21
24,8480980,Connor Dewar,C,TOR,25,67,13,8,21
24,8482089,Jake Neighbours,L,STL,22,68,12,9,21
24,8482062,Cole Smith,L,NSH,29,56,12,9,21
24,8481580,Connor McMichael,C,WSH,23,60,11,10,21
24,8483482,Tristan Luneau,D,ANA,20,67,11,10,21
24,8480995,Pontus Holmberg,R,TOR,25,63,11,10,21
24,8480252,Cole Guttman,C,CHI,25,46,11,10,21
24,8478569,Noel Acciari,C,PIT,33,56,10,11,21
24,8482117,Lukas Reichel,L,CHI,22,52,9,12,21
24,8476878,Zemgus Girgensons,C,TBL,30,80,9,12,21
24,8481606,Jordan Spence,D,LAK,23,62,5,16,21
24,8477845,Trevor van Riemsdyk,D,WSH,33,60,3,18,21
24,8481178,Egor Zamula,D,PHI,24,54,3,18,21
24,8479982,Conor Timmins,D,TOR,26,52,2,19,21
24,8476931,Jake McCabe,D,TOR,31,62,2,19,21
24,8477365,Connor Clifton,D,BUF,29,56,0,21,21
24,8481032,Paul Cotter,C,NJD,25,64,14,6,20
24,8482155,Alex Laferriere,R,LAK,23,70,14,6,20
24,8482679,Matt Coronato,R,CGY,22,56,13,7,20
24,8482125,Alexander Holtz,R,VGK,22,73,13,7,20
24,8478432,Christian Fischer,R,DET,27,78,12,8,20
24,8475855,Jesper Fast,R,CAR,33,59,12,8,20
24,8481517,Brett Leason,R,ANA,25,58,11,9,20
24,8476374,Sean Kuraly,C,CBJ,31,53,10,10,20
24,8480011,Klim Kostin,C,SJS,25,49,10,10,20
24,8480835,Jack Drury,C,CAR,24,61,9,11,20
24,8479671,Mathieu Olivier,R,CBJ,27,50,9,11,20
24,8479370,Tyson Jost,C,CAR,26,46,7,13,20
24,8480073,Erik Brannstrom,D,COL,25,59,6,14,20
24,8477435,Ryan Graves,D,PIT,29,79,5,15,20
24,8481481,Blake Lizotte,C,PIT,27,58,5,15,20
24,8480222,Sebastian Aho,D,PIT,28,73,4,16,20
24,8478416,Erik Cernak,D,TBL,27,67,4,16,20
24,8481028,Martin Pospisil,C,CGY,25,64,11,8,19
24,8474034,Patrick Maroon,L,CHI,36,55,11,8,19
24,8482157,Will Cuylle,L,NYR,22,60,8,11,19
24,8483493,Frank Nazar,C,CHI,20,47,8,11,19
24,8476624,Barclay Goodrow,C,SJS,31,60,6,13,19
24,8478970,Jalen Chatfield,D,CAR,28,73,5,14,19
24,8479402,Jake Bean,D,CGY,26,68,4,15,19
24,8481441,Joe Snively,C,DET,28,70,4,15,19
24,8481522,Peyton Krebs,C,BUF,23,63,4,15,19
24,8475181,Nick Leddy,D,STL,33,66,3,16,19
24,8480049,Dylan Samberg,D,WPG,25,69,2,17,19
24,8476879,Cody Ceci,D,EDM,31,62,2,17,19
24,8482245,Artem Zub,D,OTT,29,74,2,17,19
24,8475790,Erik Gudbranson,D,CBJ,32,79,2,17,19
24,8476891,Matthew Grzelcyk,D,PIT,30,72,0,19,19
24,8481161,Jake Christiansen,D,CBJ,25,58,12,6,18
24,8478043,Sam Lafferty,C,BUF,29,61,9,9,18
24,8480289,Morgan Barron,C,WPG,26,58,9,9,18
24,8482807,Ethan Del Mastro,D,CHI,21,54,9,9,18
24,8476889,Radek Faksa,C,STL,30,56,8,10,18
24,8478013,Jake Walman,D,SJS,28,72,7,11,18
24,8477488,Brett Pesce,D,NJD,30,72,6,12,18
24,8476988,Matt Benning,D,SJS,30,66,6,12,18
24,8479996,Cody Glass,C,NSH,25,63,5,13,18
24,8479344,Jesse Puljujarvi,R,PIT,26,49,5,13,18
24,8478468,Jeremy Lauzon,D,NSH,27,55,4,14,18
24,8480205,Emil Bemstrom,C,PIT,25,55,3,15,18
24,8475455,Brenden Dillon,D,NJD,34,65,3,15,18
24,8475690,Chris Tanev,D,TOR,35,68,3,15,18
24,8475188,Brayden McNabb,D,VGK,33,58,2,16,18
24,8481014,Alexander Romanov,D,NYI,24,78,1,17,18
24,8477508,Curtis Lazar,C,NJD,29,64,9,8,17
24,8481601,Simon Holmstrom,R,NYI,23,70,8,9,17
24,8476312,Josh Manson,D,COL,33,58,8,9,17
24,8480806,Isac Lundestrom,C,ANA,25,56,7,10,17
24,8480025,MacKenzie Entwistle,R,FLA,25,66,7,10,17
24,8479066,Ryan Lomberg,L,CGY,30,64,6,11,17
24,8480021,Jack Studnicka,C,LAK,25,66,6,11,17
24,8477979,Nicolas Aube-Kubel,R,BUF,28,59,5,12,17
24,8478399,Jonas Siegenthaler,D,NJD,27,64,5,12,17
24,8478911,Matt Roy,D,WSH,29,63,4,13,17
24,8480157,Calle Rosen,D,COL,30,54,4,13,17
24,8480035,Henri Jokiharju,D,BUF,25,62,3,14,17
24,8480001,Urho Vaakanainen,D,ANA,25,59,3,14,17
24,8475208,Brian Dumoulin,D,ANA,33,64,3,14,17
24,8480172,Jan Rutta,D,SJS,34,62,2,15,17
24,8475462,Radko Gudas,D,ANA,34,65,2,15,17
24,8478452,Caleb Jones,D,LAK,27,52,2,15,17
24,8482451,Mikael Pyyhtia,L,CBJ,23,51,2,15,17
24,8475225,Craig Smith,C,CHI,35,49,10,6,16
24,8476442,Matt Nieto,L,PIT,32,56,10,6,16
24,8473422,Nick Foligno,L,CHI,37,52,9,7,16
24,8481521,Ronnie Attard,D,PHI,25,57,8,8,16
24,8478421,A.J. Greer,L,FLA,28,56,8,8,16
24,8477392,Hudson Fasching,R,NYI,29,63,8,8,16
24,8481641,Joel Kiviranta,L,COL,28,70,8,8,16
24,8483468,Jiri Kulich,C,BUF,20,59,7,9,16
24,8483499,Liam Ohgren,L,MIN,20,62,6,10,16
24,8482730,Brandt Clarke,D,LAK,21,53,6,10,16
24,8482634,Alex Steeves,C,TOR,25,48,5,11,16
24,8474574,Tyler Myers,D,VAN,34,70,4,12,16
24,8475279,Ben Chiarot,D,DET,33,70,4,12,16
24,8471709,Marc-Edouard Vlasic,D,SJS,37,61,4,12,16
24,8481019,David Gustafsson,C,WPG,24,49,4,12,16
24,8476902,Esa Lindell,D,DAL,30,75,3,13,16
24,8482067,Connor Mackey,D,NYR,28,56,2,14,16
24,8474673,TJ Brodie,D,CHI,34,65,2,14,16
24,8475233,David Savard,D,MTL,34,63,1,15,16
24,8478851,Alexandre Carrier,D,NSH,28,68,1,15,16
24,8476457,Adam Larsson,D,SEA,32,63,1,15,16
24,8480860,Kevin Bahl,D,CGY,24,55,1,15,16
24,8476822,Luke Glendening,C,TBL,35,78,9,6,15
24,8479414,Nathan Bastian,R,NJD,27,52,8,7,15
24,8479026,Philippe Myers,D,TOR,27,55,7,8,15
24,8479291,Kevin Rooney,C,CGY,31,48,7,8,15
24,8478211,Dryden Hunt,L,CGY,29,58,6,9,15
24,8482803,Olen Zellweger,D,ANA,21,58,5,10,15
24,8476873,Mark Jankowski,C,NSH,30,56,5,10,15
24,8471677,Jack Johnson,D,CBJ,37,63,5,10,15
24,8477931,Tomas Nosek,L,FLA,32,58,5,10,15
24,8476874,Olli Maatta,D,DET,30,66,4,11,15
24,8475179,Dmitry Kulikov,D,FLA,34,58,4,11,15
24,8482176,Wyatt Kaiser,D,CHI,22,50,4,11,15
24,8479983,Mario Ferraro,D,SJS,26,63,3,12,15
24,8475324,Nick Jensen,D,OTT,34,66,3,12,15
24,8480246,Nick Perbix,D,TBL,26,76,2,13,15
24,8481568,Alex Vlasic,D,CHI,23,48,2,13,15
24,8479249,Andrew Poturalski,C,SJS,30,36,2,13,15
24,8481059,Scott Perunovich,D,STL,26,60,1,14,15
24,8476429,Scott Mayfield,D,NYI,32,71,0,15,15
24,8477482,Zachary Sanford,L,CHI,30,36,8,6,14
24,8481477,Nico Sturm,C,SJS,29,52,7,7,14
24,8482749,Joshua Roy,R,MTL,21,65,6,8,14
24,8480074,Alexandre Texier,C,STL,25,51,5,9,14
24,8482744,James Malatesta,L,CBJ,21,44,5,9,14
24,8474166,Alec Martinez,D,CHI,37,52,5,9,14
24,8479369,Andrew Peeke,D,BOS,26,69,4,10,14
24,8480058,Pierre-Olivier Joseph,D,STL,25,51,4,10,14
24,8480355,Mark Kastelic,C,BOS,25,62,4,10,14
24,8482192,Isaak Phillips,D,CHI,23,53,3,11,14
24,8483460,David Jiricek,D,CBJ,21,57,3,11,14
24,8478178,Darren Raddysh,D,TBL,28,66,1,13,14
24,8483466,Kevin Korchinski,D,CHI,20,54,1,13,14
24,8477573,Nathan Walker,L,STL,30,41,8,5,13
24,8477380,Jonny Brodzinski,C,NYR,31,58,8,5,13
24,8481751,Lukas Rousek,R,BUF,25,32,8,5,13
24,8482859,Zack Ostapchuk,C,OTT,21,49,7,6,13
24,8482762,Simon Edvinsson,D,DET,21,62,6,7,13
24,8482166,Shakir Mukhamadullin,D,SJS,22,54,5,8,13
24,8481609,Vladislav Kolyachonok,D,UTA,23,32,5,8,13
24,8482809,Jackson Blake,R,CAR,21,51,4,9,13
24,8480807,Mattias Samuelsson,D,BUF,24,53,4,9,13
24,8477499,Rasmus Ristolainen,D,PHI,30,56,3,10,13
24,8478451,Ethan Bear,D,WSH,27,48,3,10,13
24,8481617,Vasily Podkolzin,R,VAN,23,50,3,10,13
24,8482087,Kaiden Guhle,D,MTL,22,67,2,11,13
24,8479324,Ryan Lindgren,D,NYR,26,67,2,11,13
24,8478859,Niko Mikkola,D,FLA,28,51,2,11,13
24,8475718,Justin Holl,D,DET,32,49,2,11,13
24,8479994,Jaret Anderson-Dolan,C,WPG,25,46,11,1,12
24,8477369,Carson Soucy,D,VAN,30,65,7,5,12
24,8479328,Julien Gauthier,R,NYI,27,56,7,5,12
24,8479368,Max Jones,L,BOS,26,66,5,7,12
24,8479378,Logan Stanley,D,WPG,26,39,5,7,12
24,8479944,Zach Aston-Reese,C,VGK,30,48,5,7,12
24,8475231,Casey Cizikas,C,NYI,33,73,4,8,12
24,8482666,Scott Morrow,D,CAR,22,44,4,8,12
24,8481147,Reese Johnson,C,MIN,26,40,4,8,12
24,8481567,Henry Thrun,D,SJS,23,52,3,9,12
24,8477507,Nikita Zadorov,D,BOS,29,66,2,10,12
24,8476422,Mike Reilly,D,NYI,31,74,2,10,12
24,8479359,Beck Malenstyn,L,BUF,26,42,2,10,12
24,8476967,Brett Kulak,D,EDM,30,60,1,11,12
24,8481789,Tye Kartye,L,SEA,23,40,9,2,11
24,8481716,Dmitri Voronkov,L,CBJ,24,39,7,4,11
24,8482652,Walker Duehr,R,CGY,27,44,7,4,11
24,8482077,Dylan Holloway,L,EDM,23,60,6,5,11
24,8476867,Brendan Gaunce,C,MIN,30,26,6,5,11
24,8481592,Jakob Pelletier,L,CGY,23,39,6,5,11
24,8476934,Brock McGinn,L,ANA,30,47,6,5,11
24,8479536,Axel Jonsson-Fjallby,L,WPG,26,39,6,5,11
24,8483570,Ben Meyers,C,SEA,26,36,6,5,11
24,8476994,Vinnie Hinostroza,C,NSH,30,41,5,6,11
24,8481600,Tobias Bjornfot,D,FLA,23,45,4,7,11
24,8479439,Jacob MacDonald,D,COL,31,55,3,8,11
24,8479372,Joshua Mahura,D,SEA,26,56,3,8,11
24,8477034,Jaycob Megna,D,FLA,32,49,3,8,11
24,8477887,Patrick Brown,C,BOS,32,44,3,8,11
24,8483495,Simon Nemec,D,NJD,20,49,2,9,11
24,8481167,Brayden Pachal,D,CGY,25,43,2,9,11
24,8470600,Ryan Suter,D,STL,39,58,2,9,11
24,8477938,Haydn Fleury,D,WPG,28,42,2,9,11
24,8478443,Brandon Carlo,D,BOS,28,60,1,10,11
24,8481598,Philip Broberg,D,EDM,23,49,1,10,11
24,8479968,Vinni Lettieri,C,BOS,29,47,7,3,10
24,8481679,Maxence Guenette,D,OTT,23,35,7,3,10
24,8479520,Brandon Duhaime,R,WSH,27,55,6,4,10
24,8482148,Hendrix Lapierre,C,WSH,22,47,5,5,10
24,8483457,Lane Hutson,D,MTL,20,61,5,5,10
24,8479718,Alex Barré-Boulet,C,MTL,27,55,5,5,10
24,8478585,Derek Ryan,C,EDM,38,57,5,5,10
24,8480880,Jakub Lauko,C,MIN,24,32,5,5,10
24,8484149,Gavin Brindley,C,CBJ,20,45,4,6,10
24,8480192,Johnathan Kovacevic,D,NJD,27,54,4,6,10
24,8473446,Erik Johnson,D,PHI,36,45,4,6,10
24,8474612,Travis Hamonic,D,OTT,34,49,4,6,10
24,8477070,Liam O'Brien,C,UTA,30,51,3,7,10
24,8481532,Alex Turcotte,C,LAK,23,41,3,7,10
24,8475177,Calvin de Haan,D,COL,33,38,3,7,10
24,8475958,Michael Sgarbossa,C,WSH,32,29,3,7,10
24,8474567,Zach Bogosian,D,MIN,34,69,2,8,10
24,8480887,Jordan Harris,D,MTL,24,50,2,8,10
24,8475750,Jon Merrill,D,MIN,32,61,1,9,10
24,8476952,Dominic Toninato,C,WPG,30,44,1,9,10
24,8479980,Nicolas Hague,D,VGK,26,52,0,10,10
24,8482070,Mitchell Chaffee,R,TBL,26,55,8,1,9
24,8480845,Rasmus Kupari,C,WPG,24,34,6,3,9
24,8471817,Ryan Reaves,R,TOR,37,58,6,3,9
24,8476441,Joel Edmundson,D,LAK,31,43,5,4,9
24,8481708,Zac Jones,D,NYR,24,51,4,5,9
24,8480070,Ian Mitchell,D,BOS,25,50,4,5,9
24,8479442,Troy Stecher,D,EDM,30,54,4,5,9
24,8484911,Collin Graf,R,SJS,22,41,4,5,9
24,8481754,Nikita Nesterenko,C,ANA,23,29,4,5,9
24,8482141,Lukas Cormier,D,VGK,22,32,4,5,9
24,8481537,Nikita Okhotiuk,D,CGY,24,51,3,6,9
24,8481013,Jonatan Berggren,R,DET,24,57,3,6,9
24,8481599,Victor Soderstrom,D,UTA,23,46,3,6,9
24,8479348,Kale Clague,D,BUF,26,41,3,6,9
24,8477335,Kyle Burroughs,D,LAK,29,44,2,7,9
24,8477018,Ben Hutton,D,VGK,31,43,1,8,9
24,8474090,Brendan Smith,D,DAL,35,57,1,8,9
24,8480796,Martin Fehervary,D,WSH,25,60,1,8,9
24,8484254,Akito Hirose,D,VAN,25,38,0,9,9
24,8476858,Phillip Di Giuseppe,L,VAN,31,33,8,0,8
24,8475235,Nicolas Deslauriers,L,PHI,33,51,6,2,8
24,8479638,Justin Brazeau,R,BOS,26,44,5,3,8
24,8482659,Josh Doan,R,UTA,22,53,5,3,8
24,8477962,Brendan Lemieux,L,CAR,28,35,4,4,8
24,8482747,Brennan Othmann,L,NYR,21,42,3,5,8
24,8483619,Filip Roos,D,OTT,25,24,3,5,8
24,8479772,Zack MacEwen,R,OTT,28,50,3,5,8
24,8476372,Nick Seeler,D,PHI,31,48,3,5,8
24,8480848,Ty Dellandrea,C,SJS,24,48,2,6,8
24,8479972,Mason Shaw,C,WPG,26,28,2,6,8
24,8478409,Anthony Richard,C,PHI,28,27,2,6,8
24,8479371,Dante Fabbro,D,NSH,26,60,1,7,8
24,8478831,Kevin Stenlund,C,UTA,28,46,1,7,8
24,8482861,Vincent Iorio,D,WSH,22,34,1,7,8
24,8474568,Luke Schenn,D,NSH,35,48,1,7,8
24,8478424,Jansen Harkins,C,ANA,27,38,5,2,7
24,8483012,Logan Morrison,C,SEA,22,33,5,2,7
24,8479981,Jonah Gadjovich,L,FLA,26,38,4,3,7
24,8480007,Jonas Rondbjerg,R,VGK,25,41,4,3,7
24,8481543,Nikita Alexandrov,C,STL,24,30,4,3,7
24,8482145,Mavrik Bourque,C,DAL,22,51,3,4,7
24,8483763,Maksymilian Szuber,D,UTA,22,31,3,4,7
24,8480292,Carson Meyer,R,ANA,27,32,3,4,7
24,8478450,Parker Wotherspoon,D,BOS,27,36,3,4,7
24,8481699,Aku Raty,R,UTA,23,21,3,4,7
24,8474013,Ian Cole,D,UTA,35,55,1,6,7
24,8476473,Connor Murphy,D,CHI,31,40,1,6,7
24,8480879,Jacob Bernard-Docker,D,OTT,24,56,1,6,7
24,8481550,Adam Beckman,L,NJD,23,39,1,6,7
24,8477384,Joshua Brown,D,EDM,30,46,1,6,7
24,8479986,Kole Lind,R,DAL,26,50,0,7,7
24,8480245,Olle Lycksell,R,PHI,25,31,4,2,6
24,8482751,Ryan Winterton,C,SEA,21,38,4,2,6
24,8477473,Justin Bailey,R,SJS,29,26,4,2,6
24,8482516,Matthew Kessel,D,STL,24,23,4,2,6
24,8478454,Noah Juulsen,D,VAN,27,38,3,3,6
24,8478017,Mark Friedman,D,VAN,29,32,3,3,6
24,8481518,Nolan Foote,L,NJD,24,39,2,4,6
24,8480950,Ilya Lyubushkin,D,DAL,30,58,2,4,6
24,8480441,Trey Fix-Wolansky,R,CBJ,25,33,2,4,6
24,8477851,Jordan Oesterle,D,BOS,32,44,2,4,6
24,8482144,Jack Thompson,D,SJS,22,29,2,4,6
24,8477401,John Hayden,C,SEA,29,30,2,4,6
24,8475762,Derek Forbort,D,VAN,32,47,2,4,6
24,8481122,Simon Benoit,D,TOR,26,36,1,5,6
24,8477527,Ross Johnston,L,ANA,30,31,1,5,6
24,8481006,Tyler Tucker,D,STL,24,18,0,6,6
24,8480834,Ty Emberson,D,SJS,24,33,0,6,6
24,8480844,Grigori Denisenko,L,VGK,24,29,3,2,5
24,8480870,Bo Groulx,C,NYR,24,32,3,2,5
24,8481556,John Beecher,C,BOS,23,38,3,2,5
24,8480196,Jacob Bryson,D,BUF,27,45,2,3,5
24,8482177,Marat Khusnutdinov,C,MIN,22,30,2,3,5
24,8483630,Pavol Regenda,L,ANA,25,37,2,3,5
24,8482153,Brendan Brisson,C,VGK,23,29,1,4,5
24,8479587,Rhett Gardner,C,PHI,28,26,1,4,5
24,8481237,Kyle MacLean,C,NYI,25,25,1,4,5
24,8478146,Matthew Highmore,C,OTT,28,33,1,4,5
24,8477073,Kurtis MacDermid,L,NJD,30,27,1,4,5
24,8484287,Cole McWard,D,VAN,23,30,1,4,5
24,8482929,Emil Lilleberg,D,TBL,23,23,1,4,5
24,8481701,Santeri Hatakka,D,NJD,23,39,0,5,5
24,8482964,Arber Xhekaj,D,MTL,23,55,0,5,5
24,8482784,Zach Dean,C,STL,21,42,3,1,4
24,8482765,Isak Rosen,R,BUF,21,26,3,1,4
24,8482733,Logan Mailloux,D,MTL,31,34,3,1,4
24,8477971,Andreas Englund,D,LAK,28,25,3,1,4
24,8477467,Gustav Olofsson,D,SEA,30,22,3,1,4
24,8479419,Brett Murray,L,BUF,26,23,3,1,4
24,8482470,Ilya Solovyov,D,CGY,24,22,2,2,4
24,8480084,Nick DeSimone,D,NJD,30,11,2,2,4
24,8483549,Lucas Condotta,L,MTL,27,34,1,3,4
24,8480468,James Hamblin,L,EDM,25,17,1,3,4
24,8479991,Jake Leschyshyn,C,NYR,25,28,1,3,4
24,8481605,Jackson LaCombe,D,ANA,23,35,1,3,4
24,8478011,Louie Belpedio,D,PHI,28,19,1,3,4
24,8481585,Egor Afanasyev,L,SJS,23,13,1,3,4
24,8479362,Riley Tufte,L,BOS,26,16,1,3,4
24,8474062,Riley Nash,C,NYR,35,20,1,3,4
24,8479543,Michael Pezzetta,L,MTL,26,48,0,4,4
24,8482095,Tyler Kleven,D,OTT,22,41,0,4,4
24,8479320,Maxime Lajoie,D,SEA,27,19,0,4,4
24,8478051,Max Willman,C,NJD,29,19,0,4,4
24,8482858,Ryker Evans,D,SEA,23,29,0,4,4
24,8480823,Alexander Alexeyev,D,WSH,25,12,3,0,3
24,8480990,Declan Chisholm,D,MIN,24,31,2,1,3
24,8477244,Chad Ruhwedel,D,NYR,34,23,2,1,3
24,8479379,Givani Smith,R,SJS,26,24,2,1,3
24,8481422,Jake Lucchini,C,NSH,29,17,2,1,3
24,8482172,Landon Slaggert,L,CHI,22,22,2,1,3
24,8480890,Jan Jenik,C,OTT,24,28,2,1,3
24,8475413,Justin Dowling,C,NJD,34,13,2,1,3
24,8475780,Chris Wagner,R,COL,33,12,2,1,3
24,8480267,Sammy Walker,C,MIN,25,23,2,1,3
24,8482713,Mackie Samoskevich,R,FLA,22,36,1,2,3
24,8476913,Devin Shore,C,MIN,30,32,1,2,3
24,8478477,Mitchell Stephens,C,SEA,27,21,1,2,3
24,8481065,Angus Crookshank,L,OTT,25,30,1,2,3
24,8482088,Justin Sourdif,R,FLA,22,17,1,2,3
24,8479576,Vincent Desharnais,D,VAN,28,25,1,2,3
24,8482165,Yan Kuznetsov,D,CGY,22,20,1,2,3
24,8482118,Sam Colangelo,R,ANA,23,14,1,2,3
24,8478502,Dennis Gilbert,D,BUF,28,21,1,2,3
24,8483489,Fraser Minten,C,TOR,31,16,1,2,3
24,8481056,Spencer Stastney,D,NSH,24,31,0,3,3
24,8482496,Nils Aman,C,VAN,24,33,0,3,3
24,8481593,Jayden Struble,D,MTL,23,26,0,3,3
24,8478021,William Lagesson,D,DET,28,29,2,0,2
24,8483597,Milos Kelemen,L,UTA,25,21,2,0,2
24,8481462,Mason Morelli,L,VGK,28,15,2,0,2
24,8482511,Mason Lohrei,D,BOS,23,30,1,1,2
24,8483397,Marc McLaughlin,C,BOS,25,29,1,1,2
24,8477462,Robert Hagg,D,VGK,29,22,1,1,2
24,8479985,Cale Fleury,D,SEA,26,24,1,1,2
24,8482201,Gage Goncalves,C,TBL,23,19,1,1,2
24,8481743,Marc Del Gaizo,D,NSH,25,17,1,1,2
24,8481541,Samuel Bolduc,D,NYI,24,27,1,1,2
24,8477541,Dakota Mermis,D,TOR,30,11,1,1,2
24,8481206,John Ludvig,D,PIT,24,7,1,1,2
24,8484325,Waltteri Merela,C,TBL,26,22,1,1,2
24,8482102,Vasily Ponomarev,C,PIT,22,14,0,2,2
24,8482147,Jean-Luc Foudy,C,COL,22,30,0,2,2
24,8477320,Anton Blidh,L,NYR,29,15,0,2,2
24,8480851,Akil Thomas,C,LAK,24,17,0,2,2
24,8481030,Jack St. Ivany,D,PIT,25,21,0,2,2
24,8477149,Scott Sabourin,R,SJS,32,10,0,2,2
24,8478854,Ryan Shea,D,PIT,27,12,0,2,2
24,8479421,Jacob Moverare,D,LAK,26,8,0,2,2
24,8481578,Graeme Clarke,R,MIN,23,5,0,2,2
24,8479367,William Lockwood,R,FLA,26,22,1,0,1
24,8481719,Maxwell Crozier,D,TBL,24,19,1,0,1
24,8477810,Joel Hanley,D,CGY,33,21,1,0,1
24,8481043,Cole Koepke,L,BOS,26,9,1,0,1
24,8483512,Matthew Savoie,C,EDM,20,17,1,0,1
24,8477993,Justin Kirkland,C,CGY,28,4,1,0,1
24,8481024,Linus Karlsson,C,VAN,25,7,1,0,1
24,8483432,Luca Del Bel Belluz,C,CBJ,31,7,1,0,1
24,8475755,Alexander Petrovic,D,DAL,32,8,1,0,1
24,8480075,Cameron Crotty,D,MIN,25,17,1,0,1
24,8483609,Adam Klapka,R,CGY,24,7,1,0,1
24,8483567,Georgii Merkulov,C,BOS,24,5,1,0,1
24,8481564,Ryan Johnson,D,BUF,23,6,0,1,1
24,8480874,Adam Ginning,D,PHI,24,9,0,1,1
24,8479522,Hardy Haman Aktell,D,WSH,26,2,0,1,1
24,8483471,Brad Lambert,C,WPG,31,12,0,1,1
24,8482197,Adam Raska,R,MIN,23,3,0,1,1
24,8483531,Brian Halonen,L,NJD,25,4,0,1,1
24,8482094,Daemon Hunt,D,MIN,22,12,0,1,1
24,8482061,Brandon Biro,L,SEA,26,8,0,1,1
24,8478446,Glenn Gawdin,C,LAK,27,7,0,1,1
24,8480306,Grant Hutton,D,NYI,29,7,0,1,1
24,8478874,Adam Gaudette,R,OTT,28,30,0,0,0
24,8484258,Sam Malinski,D,COL,26,20,0,0,0
24,8482250,Callahan Burke,C,VGK,27,20,0,0,0
24,8478881,Brett Seney,L,CHI,28,13,0,0,0
24,8484255,Jason Polin,R,COL,25,5,0,0,0
24,8483395,Arshdeep Bains,L,VAN,23,7,0,0,0
24,8481806,Louis Crevier,D,CHI,23,10,0,0,0
24,8481726,Adam Edstrom,C,NYR,24,8,0,0,0
24,8480032,Shane Bowers,C,NJD,25,12,0,0,0
24,8484304,Uvis Balinskis,D,FLA,28,11,0,0,0
24,8479330,Brandon Gignac,C,MTL,27,10,0,0,0
24,8482162,Roby Jarventie,L,EDM,22,19,0,0,0
24,8483407,Brandon Scanlin,D,NYR,25,10,0,0,0
24,8483546,Marshall Rifai,D,TOR,26,6,0,0,0
24,8481655,Cole Schwindt,R,CGY,23,2,0,0,0
24,8483398,Declan Carlile,D,TBL,31,8,0,0,0
24,8483920,Pierrick Dube,R,WSH,23,4,0,0,0
24,8482460,Matt Rempe,C,NYR,22,12,0,0,0
24,8475795,Dylan McIlrath,D,WSH,32,15,0,0,0
24,8482476,Emil Heineman,L,MTL,23,5,0,0,0
24,8482787,Nikita Chibrikov,R,WPG,31,2,0,0,0
24,8484326,Patrik Koch,D,UTA,28,1,0,0,0
24,8484259,Ondrej Pavel,C,COL,31,2,0,0,0
24,8480274,Philip Kemp,D,EDM,25,2,0,0,0
24,8483401,Marc Johnstone,R,PIT,28,2,0,0,0
24,8476323,Max McCormick,L,SEA,32,3,0,0,0
24,8484321,Nikolas Matinpalo,D,OTT,26,2,0,0,0
24,8478147,Bokondji Imama,L,PIT,28,5,0,0,0
24,8481534,Raphael Lavoie,C,EDM,24,3,0,0,0
24,8482126,Emil Andrae,D,PHI,31,4,0,0,0
24,8470794,Joe Pavelski,C,,40,0,0,0,0
24,8479321,Lucas Johansen,D,,27,0,0,0,0
24,8477950,Tony DeAngelo,D,,29,0,0,0,0
24,8471218,Blake Wheeler,R,,38,0,0,0,0
24,8475197,Tyson Barrie,D,,33,0,0,0,0
24,8474157,Max Pacioretty,L,,36,0,0,0,0
24,8475744,Evgeny Kuznetsov,C,,32,0,0,0,0
24,8474037,James van Riemsdyk,L,,35,0,0,0,0
24,8476907,Mackenzie MacEachern,L,,30,0,0,0,0
24,8480216,Jacob Peterson,C,,25,0,0,0,0
24,8474602,Justin Schultz,D,,34,0,0,0,0
24,8482222,Alexander Barabanov,L,,30,0,0,0,0
24,8474031,Kevin Shattenkirk,D,,35,0,0,0,0
24,8477330,Dominik Kubalik,L,,29,0,0,0,0
24,8480884,Calen Addison,D,,24,0,0,0,0
24,8475906,John Klingberg,D,,32,0,0,0,0
24,8480008,Adam Ruzicka,C,,25,0,0,0,0
24,8476884,Derrick Pouliot,D,,30,0,0,0,0
24,8476919,Chris Tierney,C,,30,0,0,0,0
24,8479415,Michael McLeod,C,,26,0,0,0,0
24,8474870,Tyler Johnson,C,,34,0,0,0,0
24,8470604,Jeff Carter,C,,39,0,0,0,0
24,8478104,Sammy Blais,L,,28,0,0,0,0
24,8474884,Mike Hoffman,C,,35,0,0,0,0
24,8481591,Sam Poulin,R,,23,0,0,0,0
24,8471274,Alex Goligoski,D,,39,0,0,0,0
24,8476871,Tanner Pearson,L,,32,0,0,0,0
24,8476393,Nick Cousins,C,,31,0,0,0,0
24,8479977,Kailer Yamamoto,R,,26,0,0,0,0
24,8479346,Dillon Dube,C,,26,0,0,0,0
24,8480184,Gustav Lindstrom,D,,26,0,0,0,0
24,8479376,Victor Mete,D,,26,0,0,0,0
24,8473449,Kyle Okposo,R,,36,0,0,0,0
24,8481058,Jesse Ylonen,R,,25,0,0,0,0
24,8475752,Tyler Pitlick,C,,33,0,0,0,0
24,8481239,Samuel Fagemo,L,,24,0,0,0,0
24,8480821,Filip Zadina,R,,25,0,0,0,0
24,8470966,Mark Giordano,D,,41,0,0,0,0
24,8478495,Denis Gurianov,R,,27,0,0,0,0
24,8477464,Nic Petan,C,,29,0,0,0,0
24,8478099,Kevin Labanc,R,,29,0,0,0,0
24,8482241,Radim Zohorna,L,,28,0,0,0,0
24,8474040,Sam Gagner,C,,35,0,0,0,0
24,8479514,Rem Pitlick,C,,27,0,0,0,0
24,8478430,Oliver Kylington,D,,27,0,0,0,0
24,8479533,Joona Koppanen,L,,26,0,0,0,0
24,8479984,Cal Foote,D,,26,0,0,0,0
24,8477126,Jayson Megna,C,,34,0,0,0,0
24,8475164,Jakob Silfverberg,R,,34,0,0,0,0
24,8474009,Nick Bonino,C,,36,0,0,0,0
24,8479458,Nikita Zaitsev,D,,33,0,0,0,0
24,8477944,Jakub Vrana,L,,28,0,0,0,0
24,8471699,Andrew Cogliano,C,,37,0,0,0,0
24,8478067,Oskar Lindblom,L,,28,0,0,0,0
24,8471686,Marc Staal,D,,37,0,0,0,0
24,8470610,Zach Parise,L,,40,0,0,0,0
24,8478904,Steven Lorentz,C,,28,0,0,0,0
24,8473473,Milan Lucic,L,,36,0,0,0,0
24,8480031,Maxime Comtois,L,,25,0,0,0,0
24,8478512,Austin Czarnik,C,,32,0,0,0,0
24,8473504,Cal Clutterbuck,R,,37,0,0,0,0
24,8477454,Adam Erne,L,,29,0,0,0,0
24,8479383,Boris Katchouk,L,,26,0,0,0,0
24,8475825,Jani Hakanpää,D,,32,0,0,0,0
24,8477846,Ryan Carpenter,C,,33,0,0,0,0
24,8477930,Pierre-Edouard Bellemare,L,,39,0,0,0,0
24,8478400,Colin White,C,,27,0,0,0,0
24,8480226,Marián Studenic,R,,26,0,0,0,0
24,8480853,Liam Foudy,C,,24,0,0,0,0
24,8475797,Jarred Tinordi,D,,32,0,0,0,0
24,8479423,Alex Nylander,L,,26,0,0,0,0
24,8474618,Marco Scandella,D,,34,0,0,0,0
24,8478028,Fredrik Olofsson,L,,28,0,0,0,0
24,8474709,Matt Martin,L,,35,0,0,0,0
24,8481070,Hugh McGing,L,,26,0,0,0,0
24,8479546,Oskar Steen,C,,26,0,0,0,0
24,8474145,Robert Bortuzzo,D,,35,0,0,0,0
24,8476915,Jujhar Khaira,L,,30,0,0,0,0
24,8475278,Byron Froese,C,,33,0,0,0,0
24,8481812,Nikolai Knyzhov,D,,27,0,0,0,0
24,8478408,Travis Dermott,D,,28,0,0,0,0
24,8481077,John Leonard,L,,26,0,0,0,0
24,8479547,Matthew Phillips,R,,26,0,0,0,0
24,8480836,Jonathan Gruden,C,,24,0,0,0,0
24,8481690,Tyler Angle,C,,24,0,0,0,0
24,8475766,Austin Watson,L,,32,0,0,0,0
24,8481016,Ruslan Iskhakov,C,,24,0,0,0,0
24,8478078,Rourke Chartier,C,,28,0,0,0,0
24,8480776,Sheldon Rempal,R,,29,0,0,0,0
24,8478956,Samuel Laberge,L,NJD,27,2,0,0,0
24,8483045,Cameron Butler,R,CBJ,31,0,0,0,0
24,8484314,Jiri Smejkal,L,,28,0,0,0,0
25,8476453,Nikita Kucherov,R,TBL,31,81,50,95,145
25,8477492,Nathan MacKinnon,C,COL,29,82,51,86,137
25,8477956,David Pastrnak,R,BOS,28,79,58,77,135
25,8479407,Jesper Bratt,L,NJD,26,74,45,67,112
25,8478402,Connor McDavid,C,EDM,27,78,33,78,111
25,8478483,Mitch Marner,R,TOR,27,80,32,79,111
25,8477404,Jake Guentzel,C,TBL,30,82,43,67,110
25,8479318,Auston Matthews,C,TOR,27,80,59,49,108
25,8478010,Brayden Point,C,TBL,28,82,56,51,107
25,8477493,Aleksander Barkov,C,FLA,29,79,32,74,106
25,8478420,Mikko Rantanen,R,COL,28,82,41,64,105
25,8481559,Jack Hughes,C,NJD,23,75,44,57,101
25,8471675,Sidney Crosby,C,PIT,37,73,42,59,101
25,8480027,Jason Robertson,L,DAL,25,81,37,59,96
25,8478439,Travis Konecny,R,PHI,27,80,35,61,96
25,8478864,Kirill Kaprizov,L,MIN,27,70,40,55,95
25,8478449,Roope Hintz,C,DAL,28,82,39,54,93
25,8482116,Tim Stützle,C,OTT,22,80,32,61,93
25,8479314,Matthew Tkachuk,L,FLA,27,81,30,61,91
25,8479385,Jordan Kyrou,C,STL,26,75,43,47,90
25,8480023,Robert Thomas,C,STL,25,73,29,60,89
25,8477939,William Nylander,R,TOR,28,80,40,48,88
25,8478403,Jack Eichel,C,VGK,28,78,35,53,88
25,8476468,J.T. Miller,C,VAN,31,78,29,57,86
25,8479343,Clayton Keller,R,UTA,26,76,38,47,85
25,8478445,Mathew Barzal,C,NYI,27,80,31,52,83
25,8478550,Artemi Panarin,L,NYR,33,75,29,54,83
25,8480002,Nico Hischier,C,NJD,25,74,35,47,82
25,8477934,Leon Draisaitl,C,EDM,29,77,31,51,82
25,8480801,Brady Tkachuk,L,OTT,25,80,43,38,81
25,8476887,Filip Forsberg,L,NSH,30,75,42,39,81
25,8480012,Elias Pettersson,C,VAN,26,73,37,44,81
25,8480069,Cale Makar,D,COL,26,73,21,60,81
25,8474578,Erik Karlsson,D,PIT,34,77,19,62,81
25,8479323,Adam Fox,D,NYR,26,69,11,70,81
25,8478414,Timo Meier,R,NJD,28,77,34,46,80
25,8481557,Matt Boldy,L,MIN,23,74,30,50,80
25,8480865,Noah Dobson,D,NYI,24,80,14,66,80
25,8478427,Sebastian Aho,C,CAR,27,70,31,48,79
25,8478398,Kyle Connor,L,WPG,28,72,40,38,78
25,8484144,Connor Bedard,C,CHI,19,70,23,55,78
25,8477500,Bo Horvat,C,NYI,29,79,38,39,77
25,8475692,Mats Zuccarello,R,MIN,37,73,21,56,77
25,8474600,Roman Josi,D,NSH,34,77,17,60,77
25,8477501,Valeri Nichushkin,R,COL,29,78,34,42,76
25,8481540,Cole Caufield,R,MTL,23,73,41,34,75
25,8477933,Sam Reinhart,C,FLA,29,79,32,43,75
25,8477940,Nikolaj Ehlers,L,WPG,28,69,32,43,75
25,8477409,Carter Verhaeghe,C,FLA,29,80,44,30,74
25,8474564,Steven Stamkos,C,NSH,34,76,25,49,74
25,8471685,Anze Kopitar,C,LAK,37,81,22,52,74
25,8471215,Evgeni Malkin,C,PIT,38,73,22,52,74
25,8476389,Vincent Trocheck,C,NYR,31,76,36,37,73
25,8474141,Patrick Kane,R,DET,36,82,30,43,73
25,8480208,Drake Batherson,R,OTT,26,80,24,49,73
25,8471214,Alex Ovechkin,L,WSH,39,69,43,29,72
25,8482740,Wyatt Johnston,C,DAL,21,82,33,39,72
25,8478047,Michael Bunting,L,PIT,29,76,28,44,72
25,8476459,Mika Zibanejad,C,NYR,31,78,26,46,72
25,8480800,Quinn Hughes,D,VAN,25,77,10,62,72
25,8476881,Tomas Hertl,C,VGK,31,76,41,30,71
25,8479337,Alex DeBrincat,R,DET,27,82,32,39,71
25,8475913,Mark Stone,R,VGK,32,76,29,42,71
25,8477402,Pavel Buchnevich,L,STL,29,77,24,47,71
25,8475166,John Tavares,C,TOR,34,75,34,36,70
25,8477949,Alex Tuch,R,BUF,28,68,34,36,70
25,8479542,Brandon Hagel,L,TBL,26,81,32,38,70
25,8476905,Chandler Stephenson,C,SEA,30,77,21,49,70
25,8477942,Kevin Fiala,L,LAK,28,82,19,51,70
25,8475765,Vladimir Tarasenko,R,DET,33,79,24,45,69
25,8475167,Victor Hedman,D,TBL,34,82,12,57,69
25,8475810,Bryan Rust,R,PIT,32,72,27,41,68
25,8480839,Rasmus Dahlin,D,BUF,24,72,18,50,68
25,8476456,Jonathan Huberdeau,C,CGY,31,76,17,51,68
25,8478407,Vince Dunn,D,SEA,28,77,17,51,68
25,8480036,Miro Heiskanen,D,DAL,25,76,16,52,68
25,8477476,Artturi Lehkonen,L,COL,29,80,34,33,67
25,8476448,William Karlsson,C,VGK,31,78,33,34,67
25,8478493,Joel Eriksson Ek,C,MIN,27,75,29,38,67
25,8477955,Jared McCann,L,SEA,28,76,36,30,66
25,8478873,Troy Terry,R,ANA,27,76,23,43,66
25,8478440,Dylan Strome,C,WSH,27,69,21,45,66
25,8477946,Dylan Larkin,C,DET,28,78,36,29,65
25,8475786,Zach Hyman,L,EDM,32,80,34,31,65
25,8477416,Oliver Bjorkstrand,R,SEA,29,71,22,43,65
25,8473419,Brad Marchand,L,BOS,36,81,22,43,65
25,8475172,Nazem Kadri,C,CGY,34,75,24,40,64
25,8480830,Andrei Svechnikov,R,CAR,24,74,18,46,64
25,8476454,Ryan Nugent-Hopkins,C,EDM,31,80,11,53,64
25,8478366,Frank Vatrano,R,ANA,30,71,27,36,63
25,8482124,Quinton Byfield,R,LAK,22,79,26,37,63
25,8481528,Dylan Cozens,C,BUF,23,77,19,44,63
25,8475168,Matt Duchene,C,DAL,33,80,28,34,62
25,8474586,Jordan Eberle,R,SEA,34,75,27,35,62
25,8479325,Charlie McAvoy,D,BOS,27,76,11,51,62
25,8477407,Anthony Duclair,L,NYI,29,80,34,27,61
25,8475754,Brock Nelson,C,NYI,33,78,30,31,61
25,8477451,Ryan Hartman,R,MIN,30,73,26,35,61
25,8476346,Johnny Gaudreau,L,CBJ,31,72,18,43,61
25,8477447,Shea Theodore,D,VGK,29,63,11,50,61
25,8476460,Mark Scheifele,C,WPG,31,72,27,33,60
25,8477496,Elias Lindholm,C,BOS,30,79,19,41,60
25,8480018,Nick Suzuki,C,MTL,25,76,13,47,60
25,8476853,Morgan Rielly,D,TOR,30,75,9,51,60
25,8478975,Mason Marchment,L,DAL,29,80,31,28,59
25,8473986,Alex Killorn,L,ANA,35,73,28,31,59
25,8475794,Tyler Seguin,C,DAL,32,81,25,34,59
25,8482093,Seth Jarvis,C,CAR,22,67,25,33,58
25,8479420,Tage Thompson,C,BUF,27,72,21,37,58
25,8476539,Jonathan Marchessault,R,NSH,34,78,28,29,57
25,8480039,Martin Necas,C,CAR,25,66,23,34,57
25,8477960,Adrian Kempe,R,LAK,28,81,22,35,57
25,8482665,Matty Beniers,C,SEA,22,74,21,36,57
25,8479999,Casey Mittelstadt,C,COL,26,82,17,40,57
25,8482745,Mason McTavish,C,ANA,21,72,26,30,56
25,8477444,Andre Burakovsky,L,SEA,29,66,26,30,56
25,8479675,Trevor Moore,L,LAK,29,81,23,33,56
25,8478856,Conor Garland,R,VAN,28,76,22,34,56
25,8478460,Zach Werenski,D,CBJ,27,81,15,41,56
25,8477504,Josh Morrissey,D,WPG,29,75,11,45,56
25,8475184,Chris Kreider,L,NYR,33,78,36,19,55
25,8480797,Joel Farabee,L,PHI,24,76,26,29,55
25,8482667,William Eklund,L,SJS,22,70,25,30,55
25,8473512,Claude Giroux,R,OTT,36,77,22,33,55
25,8478401,Pavel Zacha,C,BOS,27,80,21,34,55
25,8477494,Jonathan Drouin,L,COL,29,80,18,37,55
25,8480803,Evan Bouchard,D,EDM,25,73,14,41,55
25,8475784,Jeff Skinner,C,EDM,32,80,28,26,54
25,8476880,Tom Wilson,R,WSH,30,70,27,27,54
25,8482702,Logan Stankoven,C,DAL,21,81,20,34,54
25,8478519,Anthony Cirelli,C,TBL,27,82,25,28,53
25,8484153,Leo Carlsson,C,ANA,20,73,22,31,53
25,8482110,Dawson Mercer,C,NJD,23,77,22,31,53
25,8477986,Brandon Montour,D,SEA,30,68,19,34,53
25,8482109,Alexis Lafrenière,L,NYR,23,78,30,22,52
25,8475768,Jaden Schwartz,C,SEA,32,66,25,27,52
25,8479400,Pierre-Luc Dubois,L,WSH,26,70,22,30,52
25,8475191,Reilly Smith,R,NYR,33,74,18,34,52
25,8478462,Nicolas Roy,C,VGK,27,75,16,36,52
25,8480015,Owen Tippett,R,PHI,25,72,28,23,51
25,8477951,Nick Schmaltz,C,UTA,28,76,24,27,51
25,8477935,Sam Bennett,C,FLA,28,78,24,27,51
25,8473994,Jamie Benn,L,DAL,35,80,23,28,51
25,8475287,Erik Haula,L,NJD,33,73,21,30,51
25,8482113,Anton Lundell,C,FLA,23,80,19,32,51
25,8475798,Mikael Granlund,C,SJS,32,68,19,32,51
25,8478498,Jake DeBrusk,L,VAN,28,73,19,32,51
25,8476875,Mike Matheson,D,MTL,30,74,16,35,51
25,8478458,John (Jack) Roslovic,C,CAR,27,70,23,27,50
25,8479525,Ross Colton,C,COL,28,81,18,32,50
25,8482684,Luke Hughes,D,NJD,21,76,10,40,50
25,8474102,David Perron,L,OTT,36,77,24,25,49
25,8478233,Andrew Mangiapane,L,WSH,28,74,15,34,49
25,8476826,Yanni Gourde,C,SEA,33,70,13,36,49
25,8481068,Yegor Sharangovich,C,CGY,26,79,26,22,48
25,8477998,Warren Foegele,L,LAK,28,80,23,25,48
25,8481560,Arthur Kaliyev,R,LAK,23,78,19,29,48
25,8481711,Matias Maccelli,L,UTA,24,75,14,34,48
25,8477503,Max Domi,C,TOR,29,76,13,35,48
25,8476479,Phillip Danault,C,LAK,31,80,26,21,47
25,8476399,Blake Coleman,C,CGY,33,77,24,23,47
25,8478115,Pierre Engvall,L,NYI,28,79,20,27,47
25,8474150,Mikael Backlund,C,CGY,35,78,18,29,47
25,8479351,Sam Steel,C,DAL,26,80,16,31,47
25,8482078,Lucas Raymond,L,DET,22,82,15,32,47
25,8482720,Matthew Knies,L,TOR,22,76,13,34,47
25,8477479,Tyler Bertuzzi,L,CHI,29,62,24,22,46
25,8482699,Dylan Guenther,R,UTA,21,73,21,25,46
25,8475170,Brayden Schenn,C,STL,33,71,21,25,46
25,8471724,Kris Letang,D,PIT,37,81,16,30,46
25,8481581,Thomas Harley,D,DAL,23,75,6,40,46
25,8478891,Mason Appleton,C,WPG,28,68,19,26,45
25,8478463,Anthony Beauvillier,L,PIT,27,69,18,27,45
25,8482159,Tyson Foerster,R,PHI,22,76,17,28,45
25,8477021,Alex Kerfoot,C,UTA,30,73,14,31,45
25,8478466,Daniel Sprong,R,VAN,27,77,12,33,45
25,8475753,Justin Faulk,D,STL,32,76,12,33,45
25,8478396,Noah Hanifin,D,VGK,27,58,11,34,45
25,8476869,Brady Skjei,D,NSH,30,74,11,34,45
25,8477346,MacKenzie Weegar,D,CGY,30,74,8,37,45
25,8474590,John Carlson,D,WSH,34,68,7,38,45
25,8470613,Brent Burns,D,CAR,39,75,7,38,45
25,8475169,Evander Kane,L,EDM,33,79,27,17,44
25,8475151,Kyle Palmieri,C,NYI,33,80,22,22,44
25,8475745,Charlie Coyle,C,BOS,32,80,17,27,44
25,8476882,Teuvo Teravainen,C,CHI,30,65,14,30,44
25,8479425,Filip Hronek,D,VAN,27,76,6,38,44
25,8476483,Rickard Rakell,R,PIT,31,74,26,17,43
25,8479987,Morgan Geekie,C,BOS,26,75,24,19,43
25,8475314,Anders Lee,L,NYI,34,79,21,22,43
25,8481596,Shane Pinto,C,OTT,24,76,21,22,43
25,8477456,J.T. Compher,L,DET,29,78,16,27,43
25,8478542,Evan Rodrigues,C,FLA,31,77,16,27,43
25,8480145,Neal Pionk,D,WPG,29,75,9,34,43
25,8476432,Boone Jenner,C,CBJ,31,70,21,21,42
25,8478444,Brock Boeser,R,VAN,27,74,20,22,42
25,8477964,Ivan Barbashev,C,VGK,29,80,20,22,42
25,8483808,Andrei Kuzmenko,L,CGY,28,79,20,22,42
25,8484145,Zach Benson,L,BUF,19,69,16,26,42
25,8475793,Ryan Johansen,C,PHI,32,67,16,26,42
25,8475763,Kevin Hayes,R,PIT,32,65,15,27,42
25,8483505,Matthew Poitras,C,BOS,20,79,14,28,42
25,8474679,Gustav Nyquist,C,NSH,35,68,9,33,42
25,8475218,Mattias Ekholm,D,EDM,34,72,9,33,42
25,8477932,Aaron Ekblad,D,FLA,28,72,7,35,42
25,8480064,Josh Norris,C,OTT,25,74,21,20,41
25,8477497,Sean Monahan,C,CBJ,30,67,21,20,41
25,8481604,Pavel Dorofeyev,L,VGK,24,66,19,22,41
25,8474641,Adam Henrique,C,EDM,34,74,15,26,41
25,8480220,Noah Cates,L,PHI,25,72,15,26,41
25,8476792,Torey Krug,D,STL,33,72,13,28,41
25,8476458,Ryan Strome,C,ANA,31,70,13,28,41
25,8478038,Devon Toews,D,COL,30,73,11,30,41
25,8477429,Andrew Copp,C,DET,30,79,10,31,41
25,8478397,Rasmus Andersson,D,CGY,28,73,5,36,41
25,8479992,Michael Rasmussen,C,DET,25,74,16,24,40
25,8478042,Viktor Arvidsson,L,EDM,31,76,14,26,40
25,8481533,Trevor Zegras,C,ANA,23,70,14,26,40
25,8476392,Adam Lowry,C,WPG,31,65,14,26,40
25,8476480,Vladislav Namestnikov,C,WPG,32,71,11,29,40
25,8476958,Jaccob Slavin,D,CAR,30,72,8,32,40
25,8482079,Marco Rossi,C,MIN,23,64,20,19,39
25,8482705,Cole Sillinger,C,CBJ,21,65,18,21,39
25,8477426,Nicholas Paul,L,TBL,29,82,17,22,39
25,8483431,Logan Cooley,C,UTA,20,79,16,23,39
25,8471698,T.J. Oshie,R,WSH,38,67,14,25,39
25,8480028,Morgan Frost,C,PHI,25,70,13,26,39
25,8483515,Juraj Slafkovsky,L,MTL,20,75,10,29,39
25,8482122,Brock Faber,D,MIN,22,80,8,31,39
25,8475799,Nino Niederreiter,R,WPG,32,64,23,15,38
25,8482175,JJ Peterka,R,BUF,22,72,22,16,38
25,8475158,Ryan O'Reilly,C,NSH,33,73,17,21,38
25,8474149,Evgenii Dadonov,R,DAL,35,78,16,22,38
25,8479339,Patrik Laine,L,CBJ,26,61,16,22,38
25,8475714,Calle Jarnkrok,C,TOR,33,71,14,24,38
25,8478057,Dakota Joshua,C,VAN,28,69,14,24,38
25,8478438,Tommy Novak,C,NSH,27,65,13,25,38
25,8474565,Alex Pietrangelo,D,VGK,34,64,8,30,38
25,8478469,Thomas Chabot,D,OTT,27,73,6,32,38
25,8476923,Damon Severson,D,CBJ,30,80,5,33,38
25,8480068,Ryan Poehling,C,PHI,25,71,16,21,37
25,8476419,Jean-Gabriel Pageau,C,NYI,32,77,16,21,37
25,8474151,Ryan McDonagh,D,TBL,35,75,6,31,37
25,8477495,Seth Jones,D,CHI,30,64,5,32,37
25,8480434,Sean Durzi,D,UTA,26,68,5,32,37
25,8481542,Moritz Seider,D,DET,23,71,3,34,37
25,8476872,Scott Laughton,C,PHI,30,72,17,19,36
25,8480185,Eetu Luostarinen,C,FLA,26,73,17,19,36
25,8480893,Kirill Marchenko,R,CBJ,24,62,17,19,36
25,8476927,Teddy Blueger,C,VAN,30,68,16,20,36
25,8480009,Eeli Tolvanen,R,SEA,25,65,15,21,36
25,8477511,Anthony Mantha,R,CGY,30,80,15,21,36
25,8474716,Jared Spurgeon,D,MIN,35,77,12,24,36
25,8481524,Bowen Byram,D,BUF,23,71,12,24,36
25,8476906,Shayne Gostisbehere,D,CAR,31,76,8,28,36
25,8476854,Hampus Lindholm,D,BOS,30,75,8,28,36
25,8478046,Danton Heinen,L,VAN,29,73,21,14,35
25,8482089,Jake Neighbours,L,STL,22,66,20,15,35
25,8481186,Logan O'Connor,R,COL,28,77,19,16,35
25,8481618,Alex Newhook,C,MTL,23,75,17,18,35
25,8478472,Mathieu Joseph,R,STL,27,69,13,22,35
25,8483490,Pavel Mintyukov,D,ANA,21,75,11,24,35
25,8482803,Olen Zellweger,D,ANA,21,72,11,24,35
25,8479345,Jakob Chychrun,D,WSH,26,68,7,28,35
25,8475764,Cam Fowler,D,ANA,33,73,1,34,35
25,8482259,Bobby McMann,C,TOR,28,69,23,11,34
25,8480014,Gabriel Vilardi,C,WPG,25,69,21,13,34
25,8480849,Barrett Hayton,C,UTA,24,74,20,14,34
25,8476438,Brandon Saad,L,STL,32,70,19,15,34
25,8475726,Tyler Toffoli,C,SJS,32,67,17,17,34
25,8476981,Josh Anderson,R,MTL,30,70,17,17,34
25,8482092,Ridly Greig,C,OTT,22,76,15,19,34
25,8481656,Aliaksei Protas,C,WSH,23,70,14,20,34
25,8478413,Jordan Greenway,L,BUF,27,63,13,21,34
25,8474563,Drew Doughty,D,LAK,35,72,11,23,34
25,8477505,Alexander Wennberg,C,SJS,30,67,9,25,34
25,8477948,Travis Sanheim,D,PHI,28,72,9,25,34
25,8477498,Darnell Nurse,D,EDM,29,73,7,27,34
25,8480817,K'Andre Miller,D,NYR,24,69,5,29,34
25,8477952,Robby Fabbri,C,ANA,28,67,19,14,33
25,8473422,Nick Foligno,L,CHI,37,55,18,15,33
25,8479365,Trent Frederic,C,BOS,26,73,17,16,33
25,8480835,Jack Drury,C,CAR,24,57,16,17,33
25,8480188,Fabian Zetterlund,L,SJS,25,62,14,19,33
25,8481624,Ilya Mikheyev,R,CHI,30,52,14,19,33
25,8482149,Cole Perfetti,C,WPG,22,63,12,21,33
25,8474053,Logan Couture,C,SJS,35,60,12,21,33
25,8480078,Filip Chytil,C,NYR,25,70,12,21,33
25,8480336,Sean Walker,D,CAR,30,70,11,22,33
25,8478055,Gustav Forsling,D,FLA,28,71,9,24,33
25,8482671,Owen Power,D,BUF,22,71,7,26,33
25,8477989,Christian Dvorak,C,MTL,28,68,16,16,32
25,8480798,Philipp Kurashev,C,CHI,25,70,14,18,32
25,8481577,Philip Tomasino,C,NSH,23,68,13,19,32
25,8475722,Jason Zucker,L,BUF,32,67,10,22,32
25,8476902,Esa Lindell,D,DAL,30,78,10,22,32
25,8475171,Oliver Ekman-Larsson,D,TOR,33,70,9,23,32
25,8482105,Jake Sanderson,D,OTT,22,76,7,25,32
25,8480205,Emil Bemstrom,C,PIT,25,52,15,16,31
25,8476292,Ondrej Palat,L,NJD,33,67,12,19,31
25,8479591,Michael Eyssimont,C,TBL,28,77,9,22,31
25,8481521,Ronnie Attard,D,PHI,25,56,7,24,31
25,8482055,Drew O'Connor,L,PIT,26,61,18,12,30
25,8482475,Yegor Chinakhov,R,CBJ,23,59,17,13,30
25,8476278,Colin Blackwell,C,DAL,31,80,16,14,30
25,8484166,Adam Fantilli,C,CBJ,20,66,14,16,30
25,8477839,Conor Sheary,L,TBL,32,82,14,16,30
25,8475220,Marcus Foligno,L,MIN,33,57,13,17,30
25,8477947,Sonny Milano,L,WSH,28,56,11,19,30
25,8476461,Sean Couturier,C,PHI,32,69,11,19,30
25,8476462,Dougie Hamilton,D,NJD,31,69,10,20,30
25,8482624,Daniil Miromanov,D,CGY,27,67,9,21,30
25,8481014,Alexander Romanov,D,NYI,24,75,5,25,30
25,8479410,Mikhail Sergachev,D,UTA,26,75,4,26,30
25,8474673,TJ Brodie,D,CHI,34,65,3,27,30
25,8478507,John Marino,D,UTA,27,69,2,28,30
25,8481582,Nicholas Robertson,L,TOR,23,75,17,12,29
25,8481535,Nils Hoglander,L,VAN,24,60,16,13,29
25,8475760,Nick Bjugstad,C,UTA,32,72,16,13,29
25,8481032,Paul Cotter,C,NJD,25,63,14,15,29
25,8474189,Lars Eller,C,PIT,35,67,12,17,29
25,8481553,Bobby Brink,R,PHI,23,63,11,18,29
25,8481704,Juuso Parssinen,C,NSH,23,58,10,19,29
25,8479390,Taylor Raddysh,R,WSH,26,67,10,19,29
25,8476331,Dylan DeMelo,D,WPG,31,70,8,21,29
25,8475848,Brendan Gallagher,R,MTL,32,77,7,22,29
25,8477506,Ryan Pulock,D,NYI,30,75,5,24,29
25,8482655,Janis Moser,D,TBL,24,80,3,26,29
25,8478109,Victor Olofsson,L,VGK,29,68,16,12,28
25,8476878,Zemgus Girgensons,C,TBL,30,80,16,12,28
25,8480802,Ryan McLeod,C,BUF,25,66,15,13,28
25,8479661,Tanner Jeannot,L,LAK,27,73,15,13,28
25,8482097,Jack Quinn,R,BUF,23,58,13,15,28
25,8480829,Jesperi Kotkaniemi,C,CAR,24,64,12,16,28
25,8480789,Oliver Wahlstrom,R,NYI,24,72,12,16,28
25,8482133,Thomas Bordeleau,C,SJS,22,56,10,18,28
25,8480855,Jack McBain,C,UTA,24,63,10,18,28
25,8484203,Bradly Nadeau,L,CAR,19,62,10,18,28
25,8482142,Jamie Drysdale,D,PHI,22,67,9,19,28
25,8480113,Alex Iafallo,L,WPG,31,70,8,20,28
25,8481546,Cam York,D,PHI,23,61,6,22,28
25,8476463,Jonas Brodin,D,MIN,31,77,5,23,28
25,8475193,Tomas Tatar,L,NJD,34,67,5,23,28
25,8480878,Nils Lundkvist,D,DAL,24,68,5,23,28
25,8476885,Jacob Trouba,D,NYR,30,75,5,23,28
25,8479293,Brandon Tanev,L,SEA,33,63,15,12,27
25,8480459,Pius Suter,C,VAN,28,61,15,12,27
25,8476925,Colton Sissons,C,NSH,31,67,13,14,27
25,8482737,Zack Bolduc,C,STL,21,65,11,16,27
25,8482101,Danil Gushchin,L,SJS,22,60,11,16,27
25,8478911,Matt Roy,D,WSH,29,65,9,18,27
25,8476891,Matthew Grzelcyk,D,PIT,30,75,4,23,27
25,8478500,Ivan Provorov,D,CBJ,27,77,3,24,27
25,8475791,Taylor Hall,L,CHI,33,60,11,15,26
25,8477953,Kasperi Kapanen,R,STL,28,70,11,15,26
25,8478474,Lawson Crouse,L,UTA,27,77,9,17,26
25,8477435,Ryan Graves,D,PIT,29,76,9,17,26
25,8482067,Connor Mackey,D,NYR,28,58,9,17,26
25,8477507,Nikita Zadorov,D,BOS,29,66,8,18,26
25,8476422,Mike Reilly,D,NYI,31,77,6,20,26
25,8483445,Cutter Gauthier,L,ANA,20,66,5,21,26
25,8480043,Timothy Liljegren,D,TOR,25,64,3,23,26
25,8479982,Conor Timmins,D,TOR,26,56,2,24,26
25,8476474,Stefan Noesen,R,NJD,31,69,18,7,25
25,8481580,Connor McMichael,C,WSH,23,59,13,12,25
25,8477015,Connor Brown,R,EDM,30,66,11,14,25
25,8477919,Frederick Gaudreau,C,MIN,31,65,9,16,25
25,8481093,Rafael Harvey-Pinard,L,MTL,25,58,9,16,25
25,8476892,Colton Parayko,D,STL,31,65,6,19,25
25,8482712,Oskar Olausson,R,COL,22,75,5,20,25
25,8473563,Nicklas Backstrom,C,WSH,37,59,5,20,25
25,8478136,Jake Middleton,D,MIN,28,76,5,20,25
25,8476889,Radek Faksa,C,STL,30,65,5,20,25
25,8481703,Valtteri Puustinen,R,PIT,25,55,4,21,25
25,8476525,Colin Miller,D,WPG,32,67,4,21,25
25,8481606,Jordan Spence,D,LAK,23,71,3,22,25
25,8482749,Joshua Roy,R,MTL,21,70,17,7,24
25,8482146,Luke Evangelista,R,NSH,22,69,14,10,24
25,8474715,Cameron Atkinson,R,TBL,35,81,14,10,24
25,8477425,Miles Wood,L,COL,29,77,14,10,24
25,8480025,MacKenzie Entwistle,R,FLA,25,65,12,12,24
25,8476467,Jamie Oleksiak,D,SEA,32,68,9,15,24
25,8482679,Matt Coronato,R,CGY,22,65,9,15,24
25,8480073,Erik Brannstrom,D,COL,25,61,9,15,24
25,8483468,Jiri Kulich,C,BUF,20,65,9,15,24
25,8479393,Noah Gregor,L,OTT,26,74,8,16,24
25,8478970,Jalen Chatfield,D,CAR,28,75,8,16,24
25,8479639,Dylan Coghlan,D,WPG,26,58,7,17,24
25,8482660,Kent Johnson,C,CBJ,22,69,6,18,24
25,8476917,Adam Pelech,D,NYI,30,78,5,19,24
25,8483491,Ivan Miroshnichenko,L,WSH,20,59,15,8,23
25,8480813,Joe Veleno,C,DET,24,77,14,9,23
25,8479353,Brett Howden,C,VGK,26,69,12,11,23
25,8477987,Ryan Donato,C,CHI,28,61,12,11,23
25,8479368,Max Jones,L,BOS,26,61,12,11,23
25,8476897,Oskar Sundqvist,C,STL,30,55,11,12,23
25,8479941,Justin Danforth,R,CBJ,31,58,11,12,23
25,8480762,Eric Robinson,L,CAR,29,62,11,12,23
25,8481523,Kirby Dach,C,MTL,23,66,8,15,23
25,8482809,Jackson Blake,R,CAR,21,59,8,15,23
25,8480246,Nick Perbix,D,TBL,26,75,3,20,23
25,8477488,Brett Pesce,D,NJD,30,68,2,21,23
25,8479980,Nicolas Hague,D,VGK,26,60,2,21,23
25,8482074,Connor Zary,C,CGY,23,58,15,7,22
25,8482125,Alexander Holtz,R,VGK,22,72,11,11,22
25,8483524,Shane Wright,C,SEA,20,57,9,13,22
25,8481751,Lukas Rousek,R,BUF,25,50,9,13,22
25,8477499,Rasmus Ristolainen,D,PHI,30,57,6,16,22
25,8478013,Jake Walman,D,SJS,28,70,5,17,22
25,8476988,Matt Benning,D,SJS,30,64,4,18,22
25,8479402,Jake Bean,D,CGY,26,69,2,20,22
25,8470621,Corey Perry,R,EDM,39,71,17,4,21
25,8480281,Alexey Toropchenko,R,STL,25,60,15,6,21
25,8479316,Luke Kunin,C,SJS,27,60,11,10,21
25,8477450,Jason Dickinson,C,CHI,29,55,11,10,21
25,8481517,Brett Leason,R,ANA,25,55,11,10,21
25,8482117,Lukas Reichel,L,CHI,22,52,10,11,21
25,8479359,Beck Malenstyn,L,BUF,26,44,10,11,21
25,8475149,Marcus Johansson,L,MIN,34,67,9,12,21
25,8479315,Joey Anderson,R,CHI,26,47,6,15,21
25,8482451,Mikael Pyyhtia,L,CBJ,23,48,5,16,21
25,8477969,Marcus Pettersson,D,PIT,28,75,4,17,21
25,8475200,Dmitry Orlov,D,CAR,33,72,4,17,21
25,8478851,Alexandre Carrier,D,NSH,28,69,4,17,21
25,8476457,Adam Larsson,D,SEA,32,62,2,19,21
25,8479336,Carl Grundstrom,R,SJS,27,58,14,6,20
25,8477353,Tyler Motte,C,DET,29,73,12,8,20
25,8476921,Jordan Martinook,L,CAR,32,61,11,9,20
25,8481554,Kaapo Kakko,R,NYR,23,71,11,9,20
25,8481028,Martin Pospisil,C,CGY,25,60,10,10,20
25,8479344,Jesse Puljujarvi,R,PIT,26,52,10,10,20
25,8479619,Michael Carcone,L,UTA,28,60,9,11,20
25,8483457,Lane Hutson,D,MTL,20,72,9,11,20
25,8484149,Gavin Brindley,C,CBJ,20,52,9,11,20
25,8480871,Adam Boqvist,D,FLA,24,72,4,16,20
25,8478840,Will Borgen,D,SEA,28,63,4,16,20
25,8480049,Dylan Samberg,D,WPG,25,67,3,17,20
25,8478133,Jake Evans,C,MTL,28,72,2,18,20
25,8475790,Erik Gudbranson,D,CBJ,32,73,2,18,20
25,8475233,David Savard,D,MTL,34,61,2,18,20
25,8480222,Sebastian Aho,D,PIT,28,71,0,20,20
25,8477446,Michael McCarron,R,NSH,29,58,11,8,19
25,8478585,Derek Ryan,C,EDM,38,56,10,9,19
25,8477406,Mattias Janmark,C,EDM,32,64,9,10,19
25,8475343,Nic Dowd,C,WSH,34,57,8,11,19
25,8479996,Cody Glass,C,NSH,25,65,8,11,19
25,8477979,Nicolas Aube-Kubel,R,BUF,28,58,8,11,19
25,8476329,Travis Boyd,C,MIN,31,53,7,12,19
25,8479983,Mario Ferraro,D,SJS,26,70,6,13,19
25,8478882,Vladislav Gavrikov,D,LAK,29,66,5,14,19
25,8476856,Mathew Dumba,D,DAL,30,70,5,14,19
25,8478416,Erik Cernak,D,TBL,27,73,5,14,19
25,8475188,Brayden McNabb,D,VGK,33,54,5,14,19
25,8482111,Justin Barron,D,MTL,23,63,4,15,19
25,8473533,Jordan Staal,C,CAR,36,58,4,15,19
25,8481527,Kaedan Korczak,D,VGK,23,54,3,16,19
25,8476979,Erik Gustafsson,D,DET,32,76,2,17,19
25,8482245,Artem Zub,D,OTT,29,76,2,17,19
25,8475324,Nick Jensen,D,OTT,34,69,2,17,19
25,8475855,Jesper Fast,R,CAR,33,63,14,4,18
25,8478020,Michael Amadio,R,OTT,28,72,11,7,18
25,8481013,Jonatan Berggren,R,DET,24,63,11,7,18
25,8476374,Sean Kuraly,C,CBJ,31,58,9,9,18
25,8480806,Isac Lundestrom,C,ANA,25,56,9,9,18
25,8480748,Kiefer Sherwood,L,VAN,29,58,8,10,18
25,8481601,Simon Holmstrom,R,NYI,23,65,8,10,18
25,8476469,Joel Armia,R,MTL,31,63,7,11,18
25,8482634,Alex Steeves,C,TOR,25,50,6,12,18
25,8477573,Nathan Walker,L,STL,30,53,6,12,18
25,8483495,Simon Nemec,D,NJD,20,52,6,12,18
25,8481708,Zac Jones,D,NYR,24,52,5,13,18
25,8480172,Jan Rutta,D,SJS,34,62,4,14,18
25,8479986,Kole Lind,R,DAL,26,54,4,14,18
25,8479976,Juuso Valimaki,D,UTA,26,57,2,16,18
25,8477220,Nate Schmidt,D,FLA,33,66,2,16,18
25,8479998,Mikey Anderson,D,LAK,25,65,2,16,18
25,8480252,Cole Guttman,C,CHI,25,39,12,5,17
25,8478421,A.J. Greer,L,FLA,28,55,12,5,17
25,8479066,Ryan Lomberg,L,CGY,30,62,11,6,17
25,8477478,William Carrier,L,CAR,30,57,9,8,17
25,8478508,Yakov Trenin,C,MIN,27,62,7,10,17
25,8476960,Andreas Athanasiou,C,CHI,30,54,7,10,17
25,8478043,Sam Lafferty,C,BUF,29,58,7,10,17
25,8477903,Garnet Hathaway,R,PHI,33,68,6,11,17
25,8483493,Frank Nazar,C,CHI,20,59,6,11,17
25,8477508,Curtis Lazar,C,NJD,29,58,6,11,17
25,8483482,Tristan Luneau,D,ANA,20,63,4,13,17
25,8478452,Caleb Jones,D,LAK,27,52,3,14,17
25,8478399,Jonas Siegenthaler,D,NJD,27,60,2,15,17
25,8475455,Brenden Dillon,D,NJD,34,59,1,16,17
25,8480727,Zach Whitecloud,D,VGK,28,55,0,17,17
25,8480995,Pontus Holmberg,R,TOR,25,53,10,6,16
25,8477369,Carson Soucy,D,VAN,30,61,8,8,16
25,8481481,Blake Lizotte,C,PIT,27,57,7,9,16
25,8480289,Morgan Barron,C,WPG,26,51,7,9,16
25,8475225,Craig Smith,C,CHI,35,54,7,9,16
25,8476918,Jimmy Vesey,L,NYR,31,67,6,10,16
25,8481522,Peyton Krebs,C,BUF,23,55,6,10,16
25,8477931,Tomas Nosek,L,FLA,32,54,6,10,16
25,8475231,Casey Cizikas,C,NYI,33,72,6,10,16
25,8479398,Samuel Girard,D,COL,26,63,5,11,16
25,8473507,Jeff Petry,D,DET,37,74,4,12,16
25,8482073,Braden Schneider,D,NYR,23,69,4,12,16
25,8480891,Michael Kesselring,D,UTA,24,59,3,13,16
25,8480873,Rasmus Sandin,D,WSH,24,66,3,13,16
25,8475181,Nick Leddy,D,STL,33,69,3,13,16
25,8481059,Scott Perunovich,D,STL,26,57,2,14,16
25,8478831,Kevin Stenlund,C,UTA,28,51,12,3,15
25,8473453,Trevor Lewis,C,LAK,37,73,8,7,15
25,8476822,Luke Glendening,C,TBL,35,78,8,7,15
25,8480074,Alexandre Texier,C,STL,25,56,8,7,15
25,8478432,Christian Fischer,R,DET,27,77,7,8,15
25,8479414,Nathan Bastian,R,NJD,27,60,7,8,15
25,8477938,Haydn Fleury,D,WPG,28,49,7,8,15
25,8474034,Patrick Maroon,L,CHI,36,57,6,9,15
25,8480003,Jesper Boqvist,C,FLA,26,66,5,10,15
25,8483499,Liam Ohgren,L,MIN,20,53,5,10,15
25,8479026,Philippe Myers,D,TOR,27,48,5,10,15
25,8482148,Hendrix Lapierre,C,WSH,22,50,5,10,15
25,8479442,Troy Stecher,D,EDM,30,50,4,11,15
25,8480796,Martin Fehervary,D,WSH,25,54,4,11,15
25,8483565,Nick Blankenburg,D,NSH,26,64,3,12,15
25,8477365,Connor Clifton,D,BUF,29,59,3,12,15
25,8476624,Barclay Goodrow,C,SJS,31,51,3,12,15
25,8480035,Henri Jokiharju,D,BUF,25,57,3,12,15
25,8480807,Mattias Samuelsson,D,BUF,24,54,3,12,15
25,8479372,Joshua Mahura,D,SEA,26,62,3,12,15
25,8480011,Klim Kostin,C,SJS,25,50,2,13,15
25,8474574,Tyler Myers,D,VAN,34,65,1,14,15
25,8476429,Scott Mayfield,D,NYI,32,71,1,14,15
25,8478178,Darren Raddysh,D,TBL,28,66,1,14,15
25,8482807,Ethan Del Mastro,D,CHI,21,51,11,3,14
25,8479718,Alex Barré-Boulet,C,MTL,27,46,10,4,14
25,8475842,Sam Carrick,C,NYR,32,62,9,5,14
25,8481617,Vasily Podkolzin,R,VAN,23,44,9,5,14
25,8480144,David Kampf,C,TOR,29,65,8,6,14
25,8480021,Jack Studnicka,C,LAK,25,58,8,6,14
25,8482166,Shakir Mukhamadullin,D,SJS,22,52,8,6,14
25,8480980,Connor Dewar,C,TOR,25,66,6,8,14
25,8478569,Noel Acciari,C,PIT,33,57,6,8,14
25,8479968,Vinni Lettieri,C,BOS,29,39,6,8,14
25,8477070,Liam O'Brien,C,UTA,30,57,6,8,14
25,8483466,Kevin Korchinski,D,CHI,20,46,5,9,14
25,8474090,Brendan Smith,D,DAL,35,56,5,9,14
25,8476312,Josh Manson,D,COL,33,57,4,10,14
25,8480860,Kevin Bahl,D,CGY,24,62,4,10,14
25,8481477,Nico Sturm,C,SJS,29,53,4,10,14
25,8480355,Mark Kastelic,C,BOS,25,58,4,10,14
25,8478859,Niko Mikkola,D,FLA,28,52,4,10,14
25,8480845,Rasmus Kupari,C,WPG,24,38,3,11,14
25,8475179,Dmitry Kulikov,D,FLA,34,58,2,12,14
25,8482087,Kaiden Guhle,D,MTL,22,62,2,12,14
25,8475750,Jon Merrill,D,MIN,32,59,2,12,14
25,8476931,Jake McCabe,D,TOR,31,62,1,13,14
25,8476874,Olli Maatta,D,DET,30,58,1,13,14
25,8481568,Alex Vlasic,D,CHI,23,56,1,13,14
25,8482077,Dylan Holloway,L,EDM,23,58,9,4,13
25,8482157,Will Cuylle,L,NYR,22,60,8,5,13
25,8479671,Mathieu Olivier,R,CBJ,27,54,5,8,13
25,8477018,Ben Hutton,D,VGK,31,44,5,8,13
25,8481701,Santeri Hatakka,D,NJD,23,42,5,8,13
25,8478434,Keegan Kolesar,R,VGK,27,61,4,9,13
25,8475690,Chris Tanev,D,TOR,35,59,4,9,13
25,8480157,Calle Rosen,D,COL,30,46,4,9,13
25,8482176,Wyatt Kaiser,D,CHI,22,56,3,10,13
25,8482192,Isaak Phillips,D,CHI,23,54,3,10,13
25,8477034,Jaycob Megna,D,FLA,32,47,3,10,13
25,8480887,Jordan Harris,D,MTL,24,58,3,10,13
25,8476873,Mark Jankowski,C,NSH,30,43,2,11,13
25,8476967,Brett Kulak,D,EDM,30,65,2,11,13
25,8480001,Urho Vaakanainen,D,ANA,25,65,1,12,13
25,8479324,Ryan Lindgren,D,NYR,26,62,1,12,13
25,8475208,Brian Dumoulin,D,ANA,33,57,0,13,13
25,8476934,Brock McGinn,L,ANA,30,55,9,3,12
25,8480448,Parker Kelly,L,COL,25,72,8,4,12
25,8481641,Joel Kiviranta,L,COL,28,74,7,5,12
25,8478211,Dryden Hunt,L,CGY,29,44,5,7,12
25,8481537,Nikita Okhotiuk,D,CGY,24,49,5,7,12
25,8476372,Nick Seeler,D,PHI,31,44,5,7,12
25,8476994,Vinnie Hinostroza,C,NSH,30,49,4,8,12
25,8478468,Jeremy Lauzon,D,NSH,27,46,3,9,12
25,8471709,Marc-Edouard Vlasic,D,SJS,37,69,3,9,12
25,8479291,Kevin Rooney,C,CGY,31,55,3,9,12
25,8477392,Hudson Fasching,R,NYI,29,58,2,10,12
25,8470600,Ryan Suter,D,STL,39,62,2,10,12
25,8474612,Travis Hamonic,D,OTT,34,42,1,11,12
25,8480070,Ian Mitchell,D,BOS,25,47,1,11,12
25,8479371,Dante Fabbro,D,NSH,26,64,1,11,12
25,8476442,Matt Nieto,L,PIT,32,45,7,4,11
25,8481716,Dmitri Voronkov,L,CBJ,24,36,7,4,11
25,8479520,Brandon Duhaime,R,WSH,27,54,7,4,11
25,8481441,Joe Snively,C,DET,28,60,6,5,11
25,8477380,Jonny Brodzinski,C,NYR,31,51,6,5,11
25,8481592,Jakob Pelletier,L,CGY,23,44,6,5,11
25,8482062,Cole Smith,L,NSH,29,57,5,6,11
25,8476879,Cody Ceci,D,EDM,31,69,5,6,11
25,8471677,Jack Johnson,D,CBJ,37,66,4,7,11
25,8479439,Jacob MacDonald,D,COL,31,49,4,7,11
25,8480058,Pierre-Olivier Joseph,D,STL,25,54,3,8,11
25,8474567,Zach Bogosian,D,MIN,34,57,3,8,11
25,8480848,Ty Dellandrea,C,SJS,24,47,3,8,11
25,8477845,Trevor van Riemsdyk,D,WSH,33,49,2,9,11
25,8474166,Alec Martinez,D,CHI,37,52,2,9,11
25,8481567,Henry Thrun,D,SJS,23,45,1,10,11
25,8474013,Ian Cole,D,UTA,35,58,1,10,11
25,8482155,Alex Laferriere,R,LAK,23,63,6,4,10
25,8477962,Brendan Lemieux,L,CAR,28,40,6,4,10
25,8479772,Zack MacEwen,R,OTT,28,49,6,4,10
25,8481019,David Gustafsson,C,WPG,24,43,5,5,10
25,8482762,Simon Edvinsson,D,DET,21,58,5,5,10
25,8479370,Tyson Jost,C,CAR,26,54,4,6,10
25,8479328,Julien Gauthier,R,NYI,27,60,4,6,10
25,8480441,Trey Fix-Wolansky,R,CBJ,25,39,4,6,10
25,8482784,Zach Dean,C,STL,21,33,4,6,10
25,8477482,Zachary Sanford,L,CHI,30,36,3,7,10
25,8476952,Dominic Toninato,C,WPG,30,36,3,7,10
25,8480245,Olle Lycksell,R,PHI,25,32,3,7,10
25,8482964,Arber Xhekaj,D,MTL,23,52,3,7,10
25,8479369,Andrew Peeke,D,BOS,26,59,2,8,10
25,8480192,Johnathan Kovacevic,D,NJD,27,50,2,8,10
25,8477335,Kyle Burroughs,D,LAK,29,46,2,8,10
25,8481550,Adam Beckman,L,NJD,23,37,2,8,10
25,8480950,Ilya Lyubushkin,D,DAL,30,59,2,8,10
25,8481178,Egor Zamula,D,PHI,24,54,1,9,10
25,8478451,Ethan Bear,D,WSH,27,56,1,9,10
25,8475718,Justin Holl,D,DET,32,59,1,9,10
25,8477851,Jordan Oesterle,D,BOS,32,43,1,9,10
25,8479543,Michael Pezzetta,L,MTL,26,52,1,9,10
25,8479972,Mason Shaw,C,WPG,26,48,0,10,10
25,8482070,Mitchell Chaffee,R,TBL,26,55,7,2,9
25,8479944,Zach Aston-Reese,C,VGK,30,55,5,4,9
25,8481789,Tye Kartye,L,SEA,23,44,5,4,9
25,8480007,Jonas Rondbjerg,R,VGK,25,40,4,5,9
25,8482730,Brandt Clarke,D,LAK,21,42,3,6,9
25,8478443,Brandon Carlo,D,BOS,28,61,3,6,9
25,8482733,Logan Mailloux,D,MTL,31,32,3,6,9
25,8482744,James Malatesta,L,CBJ,21,44,2,7,9
25,8481679,Maxence Guenette,D,OTT,23,36,2,7,9
25,8483460,David Jiricek,D,CBJ,21,59,1,8,9
25,8482153,Brendan Brisson,C,VGK,23,32,1,8,9
25,8476858,Phillip Di Giuseppe,L,VAN,31,39,7,1,8
25,8479536,Axel Jonsson-Fjallby,L,WPG,26,31,6,2,8
25,8481754,Nikita Nesterenko,C,ANA,23,37,6,2,8
25,8482666,Scott Morrow,D,CAR,22,52,5,3,8
25,8483570,Ben Meyers,C,SEA,26,35,5,3,8
25,8481518,Nolan Foote,L,NJD,24,39,5,3,8
25,8481147,Reese Johnson,C,MIN,26,44,3,5,8
25,8476867,Brendan Gaunce,C,MIN,30,34,3,5,8
25,8477887,Patrick Brown,C,BOS,32,44,3,5,8
25,8475177,Calvin de Haan,D,COL,33,44,2,6,8
25,8477384,Joshua Brown,D,EDM,30,46,2,6,8
25,8478146,Matthew Highmore,C,OTT,28,38,2,6,8
25,8481056,Spencer Stastney,D,NSH,24,33,2,6,8
25,8475279,Ben Chiarot,D,DET,33,68,1,7,8
25,8480990,Declan Chisholm,D,MIN,24,44,1,7,8
25,8479249,Andrew Poturalski,C,SJS,30,35,0,8,8
25,8480880,Jakub Lauko,C,MIN,24,27,5,2,7
25,8479638,Justin Brazeau,R,BOS,26,37,5,2,7
25,8481161,Jake Christiansen,D,CBJ,25,56,4,3,7
25,8482859,Zack Ostapchuk,C,OTT,21,60,4,3,7
25,8484911,Collin Graf,R,SJS,22,31,4,3,7
25,8482747,Brennan Othmann,L,NYR,21,37,3,4,7
25,8474568,Luke Schenn,D,NSH,35,52,3,4,7
25,8478424,Jansen Harkins,C,ANA,27,38,3,4,7
25,8479576,Vincent Desharnais,D,VAN,28,38,3,4,7
25,8482165,Yan Kuznetsov,D,CGY,22,20,3,4,7
25,8479378,Logan Stanley,D,WPG,26,31,2,5,7
25,8483619,Filip Roos,D,OTT,25,33,2,5,7
25,8481543,Nikita Alexandrov,C,STL,24,26,2,5,7
25,8477401,John Hayden,C,SEA,29,35,2,5,7
25,8475762,Derek Forbort,D,VAN,32,48,2,5,7
25,8478874,Adam Gaudette,R,OTT,28,38,2,5,7
25,8475462,Radko Gudas,D,ANA,34,56,1,6,7
25,8481600,Tobias Bjornfot,D,FLA,23,47,1,6,7
25,8478450,Parker Wotherspoon,D,BOS,27,35,1,6,7
25,8482751,Ryan Winterton,C,SEA,21,37,5,1,6
25,8479994,Jaret Anderson-Dolan,C,WPG,25,37,4,2,6
25,8482659,Josh Doan,R,UTA,22,50,4,2,6
25,8479981,Jonah Gadjovich,L,FLA,26,39,4,2,6
25,8481556,John Beecher,C,BOS,23,42,4,2,6
25,8481237,Kyle MacLean,C,NYI,25,25,3,3,6
25,8484287,Cole McWard,D,VAN,23,25,3,3,6
25,8479348,Kale Clague,D,BUF,26,38,2,4,6
25,8484254,Akito Hirose,D,VAN,25,30,2,4,6
25,8482861,Vincent Iorio,D,WSH,22,36,2,4,6
25,8483630,Pavol Regenda,L,ANA,25,34,2,4,6
25,8479419,Brett Murray,L,BUF,26,22,2,4,6
25,8476913,Devin Shore,C,MIN,30,29,2,4,6
25,8475795,Dylan McIlrath,D,WSH,32,15,2,4,6
25,8484258,Sam Malinski,D,COL,26,26,1,5,6
25,8481609,Vladislav Kolyachonok,D,UTA,23,29,3,2,5
25,8473446,Erik Johnson,D,PHI,36,51,3,2,5
25,8480834,Ty Emberson,D,SJS,24,34,3,2,5
25,8478051,Max Willman,C,NJD,29,21,3,2,5
25,8479985,Cale Fleury,D,SEA,26,27,3,2,5
25,8481167,Brayden Pachal,D,CGY,25,42,2,3,5
25,8481532,Alex Turcotte,C,LAK,23,44,2,3,5
25,8476441,Joel Edmundson,D,LAK,31,34,2,3,5
25,8481006,Tyler Tucker,D,STL,24,20,2,3,5
25,8481605,Jackson LaCombe,D,ANA,23,31,2,3,5
25,8475413,Justin Dowling,C,NJD,34,16,2,3,5
25,8482496,Nils Aman,C,VAN,24,42,2,3,5
25,8482201,Gage Goncalves,C,TBL,23,26,2,3,5
25,8482141,Lukas Cormier,D,VGK,22,18,1,4,5
25,8478409,Anthony Richard,C,PHI,28,30,1,4,5
25,8483549,Lucas Condotta,L,MTL,27,27,1,4,5
25,8478017,Mark Friedman,D,VAN,29,36,0,5,5
25,8480196,Jacob Bryson,D,BUF,27,42,0,5,5
25,8479587,Rhett Gardner,C,PHI,28,18,0,5,5
25,8471817,Ryan Reaves,R,TOR,37,56,3,1,4
25,8476473,Connor Murphy,D,CHI,31,35,3,1,4
25,8480468,James Hamblin,L,EDM,25,13,3,1,4
25,8482145,Mavrik Bourque,C,DAL,22,45,2,2,4
25,8480879,Jacob Bernard-Docker,D,OTT,24,48,2,2,4
25,8479362,Riley Tufte,L,BOS,26,16,2,2,4
25,8482858,Ryker Evans,D,SEA,23,23,2,2,4
25,8482713,Mackie Samoskevich,R,FLA,22,43,2,2,4
25,8478021,William Lagesson,D,DET,28,28,2,2,4
25,8481598,Philip Broberg,D,EDM,23,42,1,3,4
25,8481599,Victor Soderstrom,D,UTA,23,33,1,3,4
25,8477473,Justin Bailey,R,SJS,29,25,1,3,4
25,8478454,Noah Juulsen,D,VAN,27,36,1,3,4
25,8481122,Simon Benoit,D,TOR,26,42,1,3,4
25,8482929,Emil Lilleberg,D,TBL,23,18,1,3,4
25,8477971,Andreas Englund,D,LAK,28,38,1,3,4
25,8482095,Tyler Kleven,D,OTT,22,37,1,3,4
25,8478477,Mitchell Stephens,C,SEA,27,29,1,3,4
25,8483012,Logan Morrison,C,SEA,22,29,0,4,4
25,8477462,Robert Hagg,D,VGK,29,22,0,4,4
25,8481806,Louis Crevier,D,CHI,23,13,0,4,4
25,8483397,Marc McLaughlin,C,BOS,25,32,3,0,3
25,8475235,Nicolas Deslauriers,L,PHI,33,48,2,1,3
25,8478446,Glenn Gawdin,C,LAK,27,12,2,1,3
25,8482250,Callahan Burke,C,VGK,27,25,2,1,3
25,8483401,Marc Johnstone,R,PIT,28,4,2,1,3
25,8482652,Walker Duehr,R,CGY,27,39,1,2,3
25,8480292,Carson Meyer,R,ANA,27,30,1,2,3
25,8477527,Ross Johnston,L,ANA,30,30,1,2,3
25,8480844,Grigori Denisenko,L,VGK,24,26,1,2,3
25,8477467,Gustav Olofsson,D,SEA,30,17,1,2,3
25,8480084,Nick DeSimone,D,NJD,30,16,1,2,3
25,8474062,Riley Nash,C,NYR,35,13,1,2,3
25,8477244,Chad Ruhwedel,D,NYR,34,29,1,2,3
25,8482511,Mason Lohrei,D,BOS,23,30,1,2,3
25,8482147,Jean-Luc Foudy,C,COL,22,24,1,2,3
25,8477810,Joel Hanley,D,CGY,33,19,1,2,3
25,8483567,Georgii Merkulov,C,BOS,24,12,1,2,3
25,8482094,Daemon Hunt,D,MIN,22,16,1,2,3
25,8478502,Dennis Gilbert,D,BUF,28,17,0,3,3
25,8482177,Marat Khusnutdinov,C,MIN,22,27,2,0,2
25,8481585,Egor Afanasyev,L,SJS,23,15,2,0,2
25,8481065,Angus Crookshank,L,OTT,25,12,2,0,2
25,8481743,Marc Del Gaizo,D,NSH,25,13,2,0,2
25,8475958,Michael Sgarbossa,C,WSH,32,29,1,1,2
25,8482144,Jack Thompson,D,SJS,22,26,1,1,2
25,8480870,Bo Groulx,C,NYR,24,27,1,1,2
25,8477073,Kurtis MacDermid,L,NJD,30,23,1,1,2
25,8482765,Isak Rosen,R,BUF,21,20,1,1,2
25,8482470,Ilya Solovyov,D,CGY,24,17,1,1,2
25,8482172,Landon Slaggert,L,CHI,22,25,1,1,2
25,8480890,Jan Jenik,C,OTT,24,21,1,1,2
25,8475780,Chris Wagner,R,COL,33,13,1,1,2
25,8480267,Sammy Walker,C,MIN,25,21,1,1,2
25,8482102,Vasily Ponomarev,C,PIT,22,26,1,1,2
25,8479421,Jacob Moverare,D,LAK,26,6,1,1,2
25,8481578,Graeme Clarke,R,MIN,23,9,1,1,2
25,8478881,Brett Seney,L,CHI,28,11,1,1,2
25,8483395,Arshdeep Bains,L,VAN,23,9,1,1,2
25,8483763,Maksymilian Szuber,D,UTA,22,40,0,2,2
25,8478011,Louie Belpedio,D,PHI,28,16,0,2,2
25,8481541,Samuel Bolduc,D,NYI,24,29,0,2,2
25,8477149,Scott Sabourin,R,SJS,32,17,0,2,2
25,8481719,Maxwell Crozier,D,TBL,24,20,0,2,2
25,8481726,Adam Edstrom,C,NYR,24,6,0,2,2
25,8482162,Roby Jarventie,L,EDM,22,15,0,2,2
25,8481422,Jake Lucchini,C,NSH,29,15,1,0,1
25,8482118,Sam Colangelo,R,ANA,23,11,1,0,1
25,8483489,Fraser Minten,C,TOR,31,12,1,0,1
25,8481593,Jayden Struble,D,MTL,23,18,1,0,1
25,8483597,Milos Kelemen,L,UTA,25,15,1,0,1
25,8481030,Jack St. Ivany,D,PIT,25,19,1,0,1
25,8478854,Ryan Shea,D,PIT,27,6,1,0,1
25,8479367,William Lockwood,R,FLA,26,20,1,0,1
25,8481043,Cole Koepke,L,BOS,26,17,1,0,1
25,8477993,Justin Kirkland,C,CGY,28,5,1,0,1
25,8480075,Cameron Crotty,D,MIN,25,6,1,0,1
25,8482476,Emil Heineman,L,MTL,23,5,1,0,1
25,8482787,Nikita Chibrikov,R,WPG,31,8,1,0,1
25,8481699,Aku Raty,R,UTA,23,13,0,1,1
25,8482516,Matthew Kessel,D,STL,24,17,0,1,1
25,8479991,Jake Leschyshyn,C,NYR,25,31,0,1,1
25,8479320,Maxime Lajoie,D,SEA,27,25,0,1,1
25,8477541,Dakota Mermis,D,TOR,30,15,0,1,1
25,8481206,John Ludvig,D,PIT,24,12,0,1,1
25,8477320,Anton Blidh,L,NYR,29,21,0,1,1
25,8480851,Akil Thomas,C,LAK,24,19,0,1,1
25,8483512,Matthew Savoie,C,EDM,20,17,0,1,1
25,8482197,Adam Raska,R,MIN,23,7,0,1,1
25,8482061,Brandon Biro,L,SEA,26,14,0,1,1
25,8480032,Shane Bowers,C,NJD,25,12,0,1,1
25,8484304,Uvis Balinskis,D,FLA,28,7,0,1,1
25,8484326,Patrik Koch,D,UTA,28,4,0,1,1
25,8476323,Max McCormick,L,SEA,32,1,0,1,1
25,8480823,Alexander Alexeyev,D,WSH,25,12,0,0,0
25,8479379,Givani Smith,R,SJS,26,32,0,0,0
25,8482088,Justin Sourdif,R,FLA,22,15,0,0,0
25,8481462,Mason Morelli,L,VGK,28,7,0,0,0
25,8484325,Waltteri Merela,C,TBL,26,15,0,0,0
25,8481024,Linus Karlsson,C,VAN,25,10,0,0,0
25,8483432,Luca Del Bel Belluz,C,CBJ,31,4,0,0,0
25,8475755,Alexander Petrovic,D,DAL,32,10,0,0,0
25,8483609,Adam Klapka,R,CGY,24,2,0,0,0
25,8481564,Ryan Johnson,D,BUF,23,11,0,0,0
25,8480874,Adam Ginning,D,PHI,24,10,0,0,0
25,8479522,Hardy Haman Aktell,D,WSH,26,3,0,0,0
25,8483471,Brad Lambert,C,WPG,31,9,0,0,0
25,8483531,Brian Halonen,L,NJD,25,2,0,0,0
25,8480306,Grant Hutton,D,NYI,29,7,0,0,0
25,8484255,Jason Polin,R,COL,25,4,0,0,0
25,8479330,Brandon Gignac,C,MTL,27,11,0,0,0
25,8483407,Brandon Scanlin,D,NYR,25,9,0,0,0
25,8483546,Marshall Rifai,D,TOR,26,1,0,0,0
25,8481655,Cole Schwindt,R,CGY,23,6,0,0,0
25,8483398,Declan Carlile,D,TBL,31,3,0,0,0
25,8483920,Pierrick Dube,R,WSH,23,5,0,0,0
25,8482460,Matt Rempe,C,NYR,22,9,0,0,0
25,8484259,Ondrej Pavel,C,COL,31,3,0,0,0
25,8480274,Philip Kemp,D,EDM,25,2,0,0,0
25,8484321,Nikolas Matinpalo,D,OTT,26,2,0,0,0
25,8478147,Bokondji Imama,L,PIT,28,6,0,0,0
25,8481534,Raphael Lavoie,C,EDM,24,0,0,0,0
25,8482126,Emil Andrae,D,PHI,31,4,0,0,0
25,8470794,Joe Pavelski,C,,40,0,0,0,0
25,8479321,Lucas Johansen,D,,27,0,0,0,0
25,8477950,Tony DeAngelo,D,,29,0,0,0,0
25,8471218,Blake Wheeler,R,,38,0,0,0,0
25,8475197,Tyson Barrie,D,,33,0,0,0,0
25,8474157,Max Pacioretty,L,,36,0,0,0,0
25,8475744,Evgeny Kuznetsov,C,,32,0,0,0,0
25,8474037,James van Riemsdyk,L,,35,0,0,0,0
25,8476907,Mackenzie MacEachern,L,,30,0,0,0,0
25,8480216,Jacob Peterson,C,,25,0,0,0,0
25,8474602,Justin Schultz,D,,34,0,0,0,0
25,8482222,Alexander Barabanov,L,,30,0,0,0,0
25,8474031,Kevin Shattenkirk,D,,35,0,0,0,0
25,8477330,Dominik Kubalik,L,,29,0,0,0,0
25,8480884,Calen Addison,D,,24,0,0,0,0
25,8475906,John Klingberg,D,,32,0,0,0,0
25,8480008,Adam Ruzicka,C,,25,0,0,0,0
25,8476884,Derrick Pouliot,D,,30,0,0,0,0
25,8476919,Chris Tierney,C,,30,0,0,0,0
25,8479415,Michael McLeod,C,,26,0,0,0,0
25,8474870,Tyler Johnson,C,,34,0,0,0,0
25,8470604,Jeff Carter,C,,39,0,0,0,0
25,8478104,Sammy Blais,L,,28,0,0,0,0
25,8474884,Mike Hoffman,C,,35,0,0,0,0
25,8481591,Sam Poulin,R,,23,0,0,0,0
25,8471274,Alex Goligoski,D,,39,0,0,0,0
25,8476871,Tanner Pearson,L,,32,0,0,0,0
25,8476393,Nick Cousins,C,,31,0,0,0,0
25,8479977,Kailer Yamamoto,R,,26,0,0,0,0
25,8479346,Dillon Dube,C,,26,0,0,0,0
25,8480184,Gustav Lindstrom,D,,26,0,0,0,0
25,8479376,Victor Mete,D,,26,0,0,0,0
25,8473449,Kyle Okposo,R,,36,0,0,0,0
25,8481058,Jesse Ylonen,R,,25,0,0,0,0
25,8475752,Tyler Pitlick,C,,33,0,0,0,0
25,8481239,Samuel Fagemo,L,,24,0,0,0,0
25,8480821,Filip Zadina,R,,25,0,0,0,0
25,8470966,Mark Giordano,D,,41,0,0,0,0
25,8478495,Denis Gurianov,R,,27,0,0,0,0
25,8477464,Nic Petan,C,,29,0,0,0,0
25,8478099,Kevin Labanc,R,,29,0,0,0,0
25,8482241,Radim Zohorna,L,,28,0,0,0,0
25,8474040,Sam Gagner,C,,35,0,0,0,0
25,8479514,Rem Pitlick,C,,27,0,0,0,0
25,8478430,Oliver Kylington,D,,27,0,0,0,0
25,8479533,Joona Koppanen,L,,26,0,0,0,0
25,8479984,Cal Foote,D,,26,0,0,0,0
25,8477126,Jayson Megna,C,,34,0,0,0,0
25,8475164,Jakob Silfverberg,R,,34,0,0,0,0
25,8474009,Nick Bonino,C,,36,0,0,0,0
25,8479458,Nikita Zaitsev,D,,33,0,0,0,0
25,8477944,Jakub Vrana,L,,28,0,0,0,0
25,8471699,Andrew Cogliano,C,,37,0,0,0,0
25,8478067,Oskar Lindblom,L,,28,0,0,0,0
25,8471686,Marc Staal,D,,37,0,0,0,0
25,8470610,Zach Parise,L,,40,0,0,0,0
25,8478904,Steven Lorentz,C,,28,0,0,0,0
25,8473473,Milan Lucic,L,,36,0,0,0,0
25,8480031,Maxime Comtois,L,,25,0,0,0,0
25,8478512,Austin Czarnik,C,,32,0,0,0,0
25,8473504,Cal Clutterbuck,R,,37,0,0,0,0
25,8477454,Adam Erne,L,,29,0,0,0,0
25,8479383,Boris Katchouk,L,,26,0,0,0,0
25,8475825,Jani Hakanpää,D,,32,0,0,0,0
25,8477846,Ryan Carpenter,C,,33,0,0,0,0
25,8477930,Pierre-Edouard Bellemare,L,,39,0,0,0,0
25,8478400,Colin White,C,,27,0,0,0,0
25,8480226,Marián Studenic,R,,26,0,0,0,0
25,8480853,Liam Foudy,C,,24,0,0,0,0
25,8475797,Jarred Tinordi,D,,32,0,0,0,0
25,8479423,Alex Nylander,L,,26,0,0,0,0
25,8474618,Marco Scandella,D,,34,0,0,0,0
25,8478028,Fredrik Olofsson,L,,28,0,0,0,0
25,8474709,Matt Martin,L,,35,0,0,0,0
25,8481070,Hugh McGing,L,,26,0,0,0,0
25,8479546,Oskar Steen,C,,26,0,0,0,0
25,8474145,Robert Bortuzzo,D,,35,0,0,0,0
25,8476915,Jujhar Khaira,L,,30,0,0,0,0
25,8475278,Byron Froese,C,,33,0,0,0,0
25,8481812,Nikolai Knyzhov,D,,27,0,0,0,0
25,8478408,Travis Dermott,D,,28,0,0,0,0
25,8481077,John Leonard,L,,26,0,0,0,0
25,8479547,Matthew Phillips,R,,26,0,0,0,0
25,8480836,Jonathan Gruden,C,,24,0,0,0,0
25,8481690,Tyler Angle,C,,24,0,0,0,0
25,8475766,Austin Watson,L,,32,0,0,0,0
25,8481016,Ruslan Iskhakov,C,,24,0,0,0,0
25,8478078,Rourke Chartier,C,,28,0,0,0,0
25,8480776,Sheldon Rempal,R,,29,0,0,0,0
25,8478956,Samuel Laberge,L,NJD,27,0,0,0,0
25,8483045,Cameron Butler,R,CBJ,31,0,0,0,0
25,8484314,Jiri Smejkal,L,,28,0,0,0,0
26,8478402,Connor McDavid,C,EDM,27,81,38,103,141
26,8476453,Nikita Kucherov,R,TBL,31,82,48,84,132
26,8478550,Artemi Panarin,L,NYR,33,77,39,77,116
26,8477492,Nathan MacKinnon,C,COL,29,82,48,67,115
26,8477956,David Pastrnak,R,BOS,28,80,53,59,112
26,8481559,Jack Hughes,C,NJD,23,74,41,66,107
26,8479314,Matthew Tkachuk,L,FLA,27,78,32,74,106
26,8479318,Auston Matthews,C,TOR,27,79,67,38,105
26,8477933,Sam Reinhart,C,FLA,29,78,44,55,99
26,8476468,J.T. Miller,C,VAN,31,76,32,67,99
26,8477493,Aleksander Barkov,C,FLA,29,80,30,67,97
26,8477934,Leon Draisaitl,C,EDM,29,80,29,68,97
26,8474600,Roman Josi,D,NSH,34,77,28,69,97
26,8478403,Jack Eichel,C,VGK,28,77,42,54,96
26,8477404,Jake Guentzel,C,TBL,30,82,36,59,95
26,8479323,Adam Fox,D,NYR,26,74,24,71,95
26,8477939,William Nylander,R,TOR,28,80,42,52,94
26,8482116,Tim Stützle,C,OTT,22,80,32,62,94
26,8478483,Mitch Marner,R,TOR,27,79,25,69,94
26,8477501,Valeri Nichushkin,R,COL,29,80,52,41,93
26,8475166,John Tavares,C,TOR,34,81,41,51,92
26,8478864,Kirill Kaprizov,L,MIN,27,72,38,53,91
26,8479343,Clayton Keller,R,UTA,26,75,39,51,90
26,8480023,Robert Thomas,C,STL,25,74,27,63,90
26,8478420,Mikko Rantanen,R,COL,28,80,44,45,89
26,8475913,Mark Stone,R,VGK,32,76,31,58,89
26,8477942,Kevin Fiala,L,LAK,28,81,28,61,89
26,8476454,Ryan Nugent-Hopkins,C,EDM,31,79,27,62,89
26,8478460,Zach Werenski,D,CBJ,27,80,22,67,89
26,8477940,Nikolaj Ehlers,L,WPG,28,75,38,50,88
26,8478445,Mathew Barzal,C,NYI,27,78,23,65,88
26,8474564,Steven Stamkos,C,NSH,34,73,39,48,87
26,8480002,Nico Hischier,C,NJD,25,75,36,50,86
26,8480012,Elias Pettersson,C,VAN,26,78,34,52,86
26,8479407,Jesper Bratt,L,NJD,26,79,25,60,85
26,8476887,Filip Forsberg,L,NSH,30,69,37,47,84
26,8481557,Matt Boldy,L,MIN,23,67,35,49,84
26,8471675,Sidney Crosby,C,PIT,37,79,34,50,84
26,8478427,Sebastian Aho,C,CAR,27,75,29,52,81
26,8476881,Tomas Hertl,C,VGK,31,78,35,45,80
26,8480801,Brady Tkachuk,L,OTT,25,79,32,48,80
26,8471685,Anze Kopitar,C,LAK,37,82,27,53,80
26,8480027,Jason Robertson,L,DAL,25,82,33,46,79
26,8477949,Alex Tuch,R,BUF,28,75,31,48,79
26,8475786,Zach Hyman,L,EDM,32,79,44,34,78
26,8477951,Nick Schmaltz,C,UTA,28,75,33,45,78
26,8474141,Patrick Kane,R,DET,36,81,30,47,77
26,8480865,Noah Dobson,D,NYI,24,80,17,60,77
26,8479385,Jordan Kyrou,C,STL,26,79,29,46,75
26,8477402,Pavel Buchnevich,L,STL,29,75,39,35,74
26,8476389,Vincent Trocheck,C,NYR,31,74,22,52,74
26,8475754,Brock Nelson,C,NYI,33,80,32,41,73
26,8480803,Evan Bouchard,D,EDM,25,79,19,54,73
26,8478401,Pavel Zacha,C,BOS,27,80,32,40,72
26,8475168,Matt Duchene,C,DAL,33,82,27,45,72
26,8479542,Brandon Hagel,L,TBL,26,82,25,47,72
26,8473419,Brad Marchand,L,BOS,36,80,24,48,72
26,8476459,Mika Zibanejad,C,NYR,31,74,23,49,72
26,8475184,Chris Kreider,L,NYR,33,72,49,22,71
26,8477946,Dylan Larkin,C,DET,28,81,37,34,71
26,8478398,Kyle Connor,L,WPG,28,75,32,39,71
26,8478439,Travis Konecny,R,PHI,27,75,30,41,71
26,8482078,Lucas Raymond,L,DET,22,80,23,48,71
26,8480069,Cale Makar,D,COL,26,70,17,54,71
26,8477409,Carter Verhaeghe,C,FLA,29,76,37,33,70
26,8477960,Adrian Kempe,R,LAK,28,81,34,36,70
26,8475765,Vladimir Tarasenko,R,DET,33,80,25,45,70
26,8481540,Cole Caufield,R,MTL,23,78,40,28,68
26,8475794,Tyler Seguin,C,DAL,32,82,40,28,68
26,8479420,Tage Thompson,C,BUF,27,73,35,33,68
26,8478010,Brayden Point,C,TBL,28,82,33,35,68
26,8477496,Elias Lindholm,C,BOS,30,79,31,37,68
26,8476448,William Karlsson,C,VGK,31,78,27,41,68
26,8480018,Nick Suzuki,C,MTL,25,77,27,41,68
26,8482740,Wyatt Johnston,C,DAL,21,81,35,32,67
26,8478449,Roope Hintz,C,DAL,28,81,26,41,67
26,8475172,Nazem Kadri,C,CGY,34,78,25,42,67
26,8482665,Matty Beniers,C,SEA,22,72,24,43,67
26,8473994,Jamie Benn,L,DAL,35,80,22,45,67
26,8474578,Erik Karlsson,D,PIT,34,79,15,52,67
26,8477447,Shea Theodore,D,VGK,29,64,13,54,67
26,8482684,Luke Hughes,D,NJD,21,75,13,54,67
26,8480800,Quinn Hughes,D,VAN,25,70,7,60,67
26,8484144,Connor Bedard,C,CHI,19,67,28,38,66
26,8478444,Brock Boeser,R,VAN,27,75,28,38,66
26,8476346,Johnny Gaudreau,L,CBJ,31,72,19,47,66
26,8479325,Charlie McAvoy,D,BOS,27,76,16,50,66
26,8475692,Mats Zuccarello,R,MIN,37,74,10,56,66
26,8480208,Drake Batherson,R,OTT,26,79,27,38,65
26,8474679,Gustav Nyquist,C,NSH,35,75,18,47,65
26,8478873,Troy Terry,R,ANA,27,76,30,34,64
26,8476539,Jonathan Marchessault,R,NSH,34,75,30,34,64
26,8482667,William Eklund,L,SJS,22,70,28,36,64
26,8473512,Claude Giroux,R,OTT,36,80,22,42,64
26,8471724,Kris Letang,D,PIT,37,79,18,46,64
26,8479337,Alex DeBrincat,R,DET,27,81,34,29,63
26,8471215,Evgeni Malkin,C,PIT,38,76,30,33,63
26,8476460,Mark Scheifele,C,WPG,31,70,26,37,63
26,8476882,Teuvo Teravainen,C,CHI,30,71,23,40,63
26,8477503,Max Domi,C,TOR,29,79,20,43,63
26,8480830,Andrei Svechnikov,R,CAR,24,70,30,32,62
26,8478414,Timo Meier,R,NJD,28,70,25,37,62
26,8482124,Quinton Byfield,R,LAK,22,78,24,38,62
26,8482699,Dylan Guenther,R,UTA,21,76,29,32,61
26,8474590,John Carlson,D,WSH,34,71,13,48,61
26,8477504,Josh Morrissey,D,WPG,29,76,9,52,61
26,8478498,Jake DeBrusk,L,VAN,28,74,30,30,60
26,8480078,Filip Chytil,C,NYR,25,74,21,39,60
26,8481711,Matias Maccelli,L,UTA,24,70,20,40,60
26,8475167,Victor Hedman,D,TBL,34,80,17,43,60
26,8475726,Tyler Toffoli,C,SJS,32,65,28,31,59
26,8483808,Andrei Kuzmenko,L,CGY,28,78,27,32,59
26,8478975,Mason Marchment,L,DAL,29,81,22,37,59
26,8479999,Casey Mittelstadt,C,COL,26,80,15,43,58
26,8471214,Alex Ovechkin,L,WSH,39,69,24,33,57
26,8481533,Trevor Zegras,C,ANA,23,73,23,34,57
26,8480839,Rasmus Dahlin,D,BUF,24,71,22,35,57
26,8479410,Mikhail Sergachev,D,UTA,26,72,13,44,57
26,8480036,Miro Heiskanen,D,DAL,25,77,11,46,57
26,8475169,Evander Kane,L,EDM,33,73,28,28,56
26,8477935,Sam Bennett,C,FLA,28,80,23,33,56
26,8478493,Joel Eriksson Ek,C,MIN,27,71,21,35,56
26,8475810,Bryan Rust,R,PIT,32,73,30,25,55
26,8476906,Shayne Gostisbehere,D,CAR,31,78,18,37,55
26,8474150,Mikael Backlund,C,CGY,35,80,24,30,54
26,8483431,Logan Cooley,C,UTA,20,78,24,30,54
26,8482149,Cole Perfetti,C,WPG,22,69,24,30,54
26,8475745,Charlie Coyle,C,BOS,32,76,20,34,54
26,8476875,Mike Matheson,D,MTL,30,75,12,42,54
26,8479425,Filip Hronek,D,VAN,27,73,10,44,54
26,8480015,Owen Tippett,R,PHI,25,75,22,31,53
26,8482745,Mason McTavish,C,ANA,21,70,20,33,53
26,8478462,Nicolas Roy,C,VGK,27,73,14,39,53
26,8482109,Alexis Lafrenière,L,NYR,23,78,31,21,52
26,8477500,Bo Horvat,C,NYI,29,81,21,31,52
26,8484166,Adam Fantilli,C,CBJ,20,67,18,34,52
26,8476923,Damon Severson,D,CBJ,30,80,15,37,52
26,8478440,Dylan Strome,C,WSH,27,69,14,38,52
26,8475798,Mikael Granlund,C,SJS,32,71,14,38,52
26,8476456,Jonathan Huberdeau,C,CGY,31,74,10,42,52
26,8475799,Nino Niederreiter,R,WPG,32,61,32,19,51
26,8480014,Gabriel Vilardi,C,WPG,25,66,25,26,51
26,8475784,Jeff Skinner,C,EDM,32,80,23,28,51
26,8475158,Ryan O'Reilly,C,NSH,33,74,21,30,51
26,8478047,Michael Bunting,L,PIT,29,69,20,31,51
26,8476479,Phillip Danault,C,LAK,31,81,20,31,51
26,8481528,Dylan Cozens,C,BUF,23,73,17,34,51
26,8474102,David Perron,L,OTT,36,78,17,34,51
26,8483515,Juraj Slafkovsky,L,MTL,20,73,17,34,51
26,8475170,Brayden Schenn,C,STL,33,74,16,35,51
26,8476905,Chandler Stephenson,C,SEA,30,74,15,36,51
26,8478397,Rasmus Andersson,D,CGY,28,75,11,40,51
26,8477407,Anthony Duclair,L,NYI,29,75,21,29,50
26,8480849,Barrett Hayton,C,UTA,24,63,21,29,50
26,8479675,Trevor Moore,L,LAK,29,80,19,31,50
26,8478438,Tommy Novak,C,NSH,27,68,16,34,50
26,8474563,Drew Doughty,D,LAK,35,74,12,38,50
26,8476853,Morgan Rielly,D,TOR,30,74,5,45,50
26,8481542,Moritz Seider,D,DET,23,79,5,45,50
26,8477476,Artturi Lehkonen,L,COL,29,81,27,22,49
26,8477451,Ryan Hartman,R,MIN,30,70,26,23,49
26,8476432,Boone Jenner,C,CBJ,31,70,26,23,49
26,8476880,Tom Wilson,R,WSH,30,76,19,30,49
26,8482702,Logan Stankoven,C,DAL,21,80,19,30,49
26,8478042,Viktor Arvidsson,L,EDM,31,75,18,31,49
26,8478469,Thomas Chabot,D,OTT,27,76,16,33,49
26,8477494,Jonathan Drouin,L,COL,29,81,12,37,49
26,8475753,Justin Faulk,D,STL,32,73,10,39,49
26,8477955,Jared McCann,L,SEA,28,74,29,19,48
26,8476483,Rickard Rakell,R,PIT,31,75,28,20,48
26,8478519,Anthony Cirelli,C,TBL,27,82,26,22,48
26,8481068,Yegor Sharangovich,C,CGY,26,77,26,22,48
26,8475191,Reilly Smith,R,NYR,33,74,25,23,48
26,8478057,Dakota Joshua,C,VAN,28,68,24,24,48
26,8482705,Cole Sillinger,C,CBJ,21,68,18,30,48
26,8477964,Ivan Barbashev,C,VGK,29,74,17,31,48
26,8478038,Devon Toews,D,COL,30,70,4,44,48
26,8476826,Yanni Gourde,C,SEA,33,65,16,31,47
26,8477479,Tyler Bertuzzi,L,CHI,29,67,16,31,47
26,8477416,Oliver Bjorkstrand,R,SEA,29,74,12,35,47
26,8478366,Frank Vatrano,R,ANA,30,68,23,23,46
26,8481186,Logan O'Connor,R,COL,28,80,22,24,46
26,8482093,Seth Jarvis,C,CAR,22,72,20,26,46
26,8476462,Dougie Hamilton,D,NJD,31,68,17,29,46
26,8482133,Thomas Bordeleau,C,SJS,22,66,12,34,46
26,8475760,Nick Bjugstad,C,UTA,32,74,25,20,45
26,8476872,Scott Laughton,C,PHI,30,78,22,23,45
26,8477456,J.T. Compher,L,DET,29,79,21,24,45
26,8477497,Sean Monahan,C,CBJ,30,70,18,27,45
26,8477444,Andre Burakovsky,L,SEA,29,73,17,28,45
26,8481577,Philip Tomasino,C,NSH,23,69,16,29,45
26,8479987,Morgan Geekie,C,BOS,26,77,14,31,45
26,8484153,Leo Carlsson,C,ANA,20,72,12,33,45
26,8478407,Vince Dunn,D,SEA,28,72,10,35,45
26,8482110,Dawson Mercer,C,NJD,23,74,22,22,44
26,8476927,Teddy Blueger,C,VAN,30,66,21,23,44
26,8479339,Patrik Laine,L,CBJ,26,61,19,25,44
26,8479525,Ross Colton,C,COL,28,80,18,26,44
26,8475793,Ryan Johansen,C,PHI,32,72,16,28,44
26,8478472,Mathieu Joseph,R,STL,27,71,13,31,44
26,8477021,Alex Kerfoot,C,UTA,30,77,12,32,44
26,8473986,Alex Killorn,L,ANA,35,76,16,27,43
26,8480220,Noah Cates,L,PHI,25,70,15,28,43
26,8480028,Morgan Frost,C,PHI,25,75,15,28,43
26,8480798,Philipp Kurashev,C,CHI,25,68,14,29,43
26,8479345,Jakob Chychrun,D,WSH,26,71,10,33,43
26,8475151,Kyle Palmieri,C,NYI,33,79,26,16,42
26,8480064,Josh Norris,C,OTT,25,73,22,20,42
26,8474586,Jordan Eberle,R,SEA,34,73,21,21,42
26,8477426,Nicholas Paul,L,TBL,29,82,20,22,42
26,8479400,Pierre-Luc Dubois,L,WSH,26,72,19,23,42
26,8480459,Pius Suter,C,VAN,28,69,19,23,42
26,8476399,Blake Coleman,C,CGY,33,74,17,25,42
26,8478233,Andrew Mangiapane,L,WSH,28,69,16,26,42
26,8477429,Andrew Copp,C,DET,30,79,16,26,42
26,8477505,Alexander Wennberg,C,SJS,30,63,16,26,42
26,8480039,Martin Necas,C,CAR,25,71,12,30,42
26,8475171,Oliver Ekman-Larsson,D,TOR,33,62,9,33,42
26,8475314,Anders Lee,L,NYI,34,77,24,17,41
26,8478474,Lawson Crouse,L,UTA,27,78,23,18,41
26,8481604,Pavel Dorofeyev,L,VGK,24,72,22,19,41
26,8480185,Eetu Luostarinen,C,FLA,26,74,16,25,41
26,8482097,Jack Quinn,R,BUF,23,70,15,26,41
26,8484145,Zach Benson,L,BUF,19,72,17,23,40
26,8480797,Joel Farabee,L,PHI,24,76,15,25,40
26,8482113,Anton Lundell,C,FLA,23,79,15,25,40
26,8477986,Brandon Montour,D,SEA,30,75,11,29,40
26,8478396,Noah Hanifin,D,VGK,27,59,10,30,40
26,8482712,Oskar Olausson,R,COL,22,77,7,33,40
26,8470613,Brent Burns,D,CAR,39,73,5,35,40
26,8482055,Drew O'Connor,L,PIT,26,67,23,16,39
26,8480188,Fabian Zetterlund,L,SJS,25,60,15,24,39
26,8476292,Ondrej Palat,L,NJD,33,74,15,24,39
26,8476792,Torey Krug,D,STL,33,67,11,28,39
26,8480145,Neal Pionk,D,WPG,29,69,10,29,39
26,8477495,Seth Jones,D,CHI,30,67,10,29,39
26,8476869,Brady Skjei,D,NSH,30,72,9,30,39
26,8478055,Gustav Forsling,D,FLA,28,76,9,30,39
26,8482092,Ridly Greig,C,OTT,22,76,20,18,38
26,8477952,Robby Fabbri,C,ANA,28,69,19,19,38
26,8477511,Anthony Mantha,R,CGY,30,77,18,20,38
26,8475714,Calle Jarnkrok,C,TOR,33,77,17,21,38
26,8480835,Jack Drury,C,CAR,24,62,17,21,38
26,8475768,Jaden Schwartz,C,SEA,32,69,16,22,38
26,8474565,Alex Pietrangelo,D,VGK,34,62,15,23,38
26,8474149,Evgenii Dadonov,R,DAL,35,77,14,24,38
26,8475848,Brendan Gallagher,R,MTL,32,73,12,26,38
26,8481703,Valtteri Puustinen,R,PIT,25,66,9,29,38
26,8477346,MacKenzie Weegar,D,CGY,30,73,7,31,38
26,8471698,T.J. Oshie,R,WSH,38,60,19,18,37
26,8476419,Jean-Gabriel Pageau,C,NYI,32,75,15,22,37
26,8478891,Mason Appleton,C,WPG,28,66,14,23,37
26,8481618,Alex Newhook,C,MTL,23,72,14,23,37
26,8477932,Aaron Ekblad,D,FLA,28,70,10,27,37
26,8481581,Thomas Harley,D,DAL,23,75,6,31,37
26,8479992,Michael Rasmussen,C,DET,25,75,17,19,36
26,8481524,Bowen Byram,D,BUF,23,65,15,21,36
26,8478458,John (Jack) Roslovic,C,CAR,27,66,14,22,36
26,8476885,Jacob Trouba,D,NYR,30,71,14,22,36
26,8480434,Sean Durzi,D,UTA,26,66,8,28,36
26,8481535,Nils Hoglander,L,VAN,24,68,21,14,35
26,8474053,Logan Couture,C,SJS,35,61,16,19,35
26,8480113,Alex Iafallo,L,WPG,31,68,15,20,35
26,8479365,Trent Frederic,C,BOS,26,76,14,21,35
26,8482720,Matthew Knies,L,TOR,22,74,13,22,35
26,8483445,Cutter Gauthier,L,ANA,20,57,13,22,35
26,8478046,Danton Heinen,L,VAN,29,70,12,23,35
26,8474189,Lars Eller,C,PIT,35,68,11,24,35
26,8482671,Owen Power,D,BUF,22,65,10,25,35
26,8482089,Jake Neighbours,L,STL,22,65,19,15,34
26,8474641,Adam Henrique,C,EDM,34,75,18,16,34
26,8476438,Brandon Saad,L,STL,32,66,18,16,34
26,8478542,Evan Rodrigues,C,FLA,31,80,16,18,34
26,8480829,Jesperi Kotkaniemi,C,CAR,24,64,15,19,34
26,8482146,Luke Evangelista,R,NSH,22,67,15,19,34
26,8478856,Conor Garland,R,VAN,28,68,14,20,34
26,8478466,Daniel Sprong,R,VAN,27,66,14,20,34
26,8478434,Keegan Kolesar,R,VGK,27,68,13,21,34
26,8475200,Dmitry Orlov,D,CAR,33,68,9,25,34
26,8480817,K'Andre Miller,D,NYR,24,70,4,30,34
26,8482122,Brock Faber,D,MIN,22,76,2,32,34
26,8478115,Pierre Engvall,L,NYI,28,77,16,17,33
26,8482175,JJ Peterka,R,BUF,22,66,16,17,33
26,8477998,Warren Foegele,L,LAK,28,77,15,18,33
26,8482475,Yegor Chinakhov,R,CBJ,23,58,14,19,33
26,8482624,Daniil Miromanov,D,CGY,27,69,9,24,33
26,8476854,Hampus Lindholm,D,BOS,30,70,3,30,33
26,8477969,Marcus Pettersson,D,PIT,28,79,0,33,33
26,8481560,Arthur Kaliyev,R,LAK,23,79,12,20,32
26,8481032,Paul Cotter,C,NJD,25,65,12,20,32
26,8482660,Kent Johnson,C,CBJ,22,63,12,20,32
26,8475791,Taylor Hall,L,CHI,33,61,10,22,32
26,8476958,Jaccob Slavin,D,CAR,30,75,8,24,32
26,8481656,Aliaksei Protas,C,WSH,23,64,8,24,32
26,8478500,Ivan Provorov,D,CBJ,27,79,4,28,32
26,8479402,Jake Bean,D,CGY,26,74,2,30,32
26,8480893,Kirill Marchenko,R,CBJ,24,69,18,13,31
26,8478109,Victor Olofsson,L,VGK,29,71,18,13,31
26,8480068,Ryan Poehling,C,PHI,25,71,16,15,31
26,8482159,Tyson Foerster,R,PHI,22,73,14,17,31
26,8481554,Kaapo Kakko,R,NYR,23,64,13,18,31
26,8480855,Jack McBain,C,UTA,24,66,7,24,31
26,8480873,Rasmus Sandin,D,WSH,24,62,6,25,31
26,8478463,Anthony Beauvillier,L,PIT,27,59,15,15,30
26,8479390,Taylor Raddysh,R,WSH,26,57,14,16,30
26,8477953,Kasperi Kapanen,R,STL,28,71,12,18,30
26,8482101,Danil Gushchin,L,SJS,22,61,10,20,30
26,8479661,Tanner Jeannot,L,LAK,27,74,9,21,30
26,8475764,Cam Fowler,D,ANA,33,72,5,25,30
26,8477947,Sonny Milano,L,WSH,28,64,15,14,29
26,8476921,Jordan Martinook,L,CAR,32,63,15,14,29
26,8480009,Eeli Tolvanen,R,SEA,25,73,14,15,29
26,8480748,Kiefer Sherwood,L,VAN,29,64,13,16,29
26,8484203,Bradly Nadeau,L,CAR,19,68,10,19,29
26,8479315,Joey Anderson,R,CHI,26,50,9,20,29
26,8481580,Connor McMichael,C,WSH,23,65,17,11,28
26,8475287,Erik Haula,L,NJD,33,68,16,12,28
26,8476474,Stefan Noesen,R,NJD,31,66,14,14,28
26,8482074,Connor Zary,C,CGY,23,64,13,15,28
26,8479351,Sam Steel,C,DAL,26,79,12,16,28
26,8476458,Ryan Strome,C,ANA,31,69,12,16,28
26,8477498,Darnell Nurse,D,EDM,29,76,12,16,28
26,8480802,Ryan McLeod,C,BUF,25,65,12,16,28
26,8473533,Jordan Staal,C,CAR,36,61,12,16,28
26,8479353,Brett Howden,C,VGK,26,71,11,17,28
26,8478413,Jordan Greenway,L,BUF,27,62,10,18,28
26,8478020,Michael Amadio,R,OTT,28,75,10,18,28
26,8476463,Jonas Brodin,D,MIN,31,79,9,19,28
26,8478013,Jake Walman,D,SJS,28,76,9,19,28
26,8481596,Shane Pinto,C,OTT,24,76,7,21,28
26,8477948,Travis Sanheim,D,PHI,28,70,7,21,28
26,8476917,Adam Pelech,D,NYI,30,79,5,23,28
26,8475763,Kevin Hayes,R,PIT,32,68,15,12,27
26,8482125,Alexander Holtz,R,VGK,22,67,14,13,27
26,8481582,Nicholas Robertson,L,TOR,23,71,13,14,27
26,8476960,Andreas Athanasiou,C,CHI,30,54,13,14,27
26,8477903,Garnet Hathaway,R,PHI,33,70,12,15,27
26,8474715,Cameron Atkinson,R,TBL,35,80,10,17,27
26,8478133,Jake Evans,C,MTL,28,74,9,18,27
26,8482067,Connor Mackey,D,NYR,28,66,6,21,27
26,8474716,Jared Spurgeon,D,MIN,35,75,4,23,27
26,8482655,Janis Moser,D,TBL,24,79,3,24,27
26,8476981,Josh Anderson,R,MTL,30,72,17,9,26
26,8477450,Jason Dickinson,C,CHI,29,53,17,9,26
26,8477353,Tyler Motte,C,DET,29,76,12,14,26
26,8476392,Adam Lowry,C,WPG,31,62,11,15,26
26,8482259,Bobby McMann,C,TOR,28,67,11,15,26
26,8479591,Michael Eyssimont,C,TBL,28,80,10,16,26
26,8470621,Corey Perry,R,EDM,39,74,10,16,26
26,8479393,Noah Gregor,L,OTT,26,74,9,17,26
26,8477989,Christian Dvorak,C,MTL,28,61,7,19,26
26,8480878,Nils Lundkvist,D,DAL,24,71,7,19,26
26,8479293,Brandon Tanev,L,SEA,33,60,7,19,26
26,8480336,Sean Walker,D,CAR,30,76,6,20,26
26,8481523,Kirby Dach,C,MTL,23,68,6,20,26
26,8476979,Erik Gustafsson,D,DET,32,77,6,20,26
26,8480035,Henri Jokiharju,D,BUF,25,63,4,22,26
26,8479398,Samuel Girard,D,COL,26,67,3,23,26
26,8476879,Cody Ceci,D,EDM,31,67,3,23,26
26,8483491,Ivan Miroshnichenko,L,WSH,20,53,19,6,25
26,8479619,Michael Carcone,L,UTA,28,66,15,10,25
26,8476897,Oskar Sundqvist,C,STL,30,66,14,11,25
26,8475220,Marcus Foligno,L,MIN,33,64,13,12,25
26,8475193,Tomas Tatar,L,NJD,34,64,13,12,25
26,8480289,Morgan Barron,C,WPG,26,59,13,12,25
26,8483493,Frank Nazar,C,CHI,20,55,11,14,25
26,8478451,Ethan Bear,D,WSH,27,52,9,16,25
26,8475218,Mattias Ekholm,D,EDM,34,75,8,17,25
26,8477987,Ryan Donato,C,CHI,28,65,8,17,25
26,8483505,Matthew Poitras,C,BOS,20,74,7,18,25
26,8482117,Lukas Reichel,L,CHI,22,57,7,18,25
26,8476457,Adam Larsson,D,SEA,32,74,7,18,25
26,8477506,Ryan Pulock,D,NYI,30,75,4,21,25
26,8481606,Jordan Spence,D,LAK,23,67,4,21,25
26,8483490,Pavel Mintyukov,D,ANA,21,74,3,22,25
26,8481014,Alexander Romanov,D,NYI,24,79,2,23,25
26,8483524,Shane Wright,C,SEA,20,62,14,10,24
26,8480789,Oliver Wahlstrom,R,NYI,24,75,13,11,24
26,8475149,Marcus Johansson,L,MIN,34,60,13,11,24
26,8477392,Hudson Fasching,R,NYI,29,64,13,11,24
26,8475855,Jesper Fast,R,CAR,33,59,12,12,24
26,8477425,Miles Wood,L,COL,29,78,11,13,24
26,8480074,Alexandre Texier,C,STL,25,56,10,14,24
26,8477839,Conor Sheary,L,TBL,32,82,8,16,24
26,8476480,Vladislav Namestnikov,C,WPG,32,69,5,19,24
26,8476902,Esa Lindell,D,DAL,30,76,5,19,24
26,8474574,Tyler Myers,D,VAN,34,61,3,21,24
26,8479639,Dylan Coghlan,D,WPG,26,67,2,22,24
26,8475181,Nick Leddy,D,STL,33,69,2,22,24
26,8477446,Michael McCarron,R,NSH,29,57,16,7,23
26,8475722,Jason Zucker,L,BUF,32,62,13,10,23
26,8477015,Connor Brown,R,EDM,30,74,12,11,23
26,8480995,Pontus Holmberg,R,TOR,25,62,12,11,23
26,8479941,Justin Danforth,R,CBJ,31,55,11,12,23
26,8481624,Ilya Mikheyev,R,CHI,30,51,10,13,23
26,8476278,Colin Blackwell,C,DAL,31,79,9,14,23
26,8473563,Nicklas Backstrom,C,WSH,37,61,8,15,23
26,8482749,Joshua Roy,R,MTL,21,68,7,16,23
26,8482087,Kaiden Guhle,D,MTL,22,65,6,17,23
26,8480871,Adam Boqvist,D,FLA,24,63,5,18,23
26,8478911,Matt Roy,D,WSH,29,58,4,19,23
26,8478507,John Marino,D,UTA,27,68,3,20,23
26,8478970,Jalen Chatfield,D,CAR,28,74,11,11,22
26,8483457,Lane Hutson,D,MTL,20,68,10,12,22
26,8479996,Cody Glass,C,NSH,25,61,10,12,22
26,8473422,Nick Foligno,L,CHI,37,51,9,13,22
26,8474151,Ryan McDonagh,D,TBL,35,77,6,16,22
26,8480762,Eric Robinson,L,CAR,29,57,6,16,22
26,8481521,Ronnie Attard,D,PHI,25,54,5,17,22
26,8481568,Alex Vlasic,D,CHI,23,58,4,18,22
26,8482105,Jake Sanderson,D,OTT,22,71,3,19,22
26,8476331,Dylan DeMelo,D,WPG,31,71,3,19,22
26,8479982,Conor Timmins,D,TOR,26,56,2,20,22
26,8478136,Jake Middleton,D,MIN,28,76,2,20,22
26,8476931,Jake McCabe,D,TOR,31,63,1,21,22
26,8479371,Dante Fabbro,D,NSH,26,61,1,21,22
26,8476891,Matthew Grzelcyk,D,PIT,30,78,0,22,22
26,8479368,Max Jones,L,BOS,26,70,13,8,21
26,8477919,Frederick Gaudreau,C,MIN,31,67,11,10,21
26,8481093,Rafael Harvey-Pinard,L,MTL,25,56,11,10,21
26,8483482,Tristan Luneau,D,ANA,20,65,11,10,21
26,8480003,Jesper Boqvist,C,FLA,26,64,9,12,21
26,8477507,Nikita Zadorov,D,BOS,29,67,8,13,21
26,8480043,Timothy Liljegren,D,TOR,25,72,8,13,21
26,8480813,Joe Veleno,C,DET,24,72,8,13,21
26,8482142,Jamie Drysdale,D,PHI,22,63,7,14,21
26,8483468,Jiri Kulich,C,BUF,20,53,7,14,21
26,8481546,Cam York,D,PHI,23,66,5,16,21
26,8479976,Juuso Valimaki,D,UTA,26,56,4,17,21
26,8480049,Dylan Samberg,D,WPG,25,61,3,18,21
26,8480073,Erik Brannstrom,D,COL,25,60,2,19,21
26,8480281,Alexey Toropchenko,R,STL,25,63,15,5,20
26,8480011,Klim Kostin,C,SJS,25,51,14,6,20
26,8481601,Simon Holmstrom,R,NYI,23,68,13,7,20
26,8479414,Nathan Bastian,R,NJD,27,57,13,7,20
26,8476461,Sean Couturier,C,PHI,32,66,11,9,20
26,8480252,Cole Guttman,C,CHI,25,44,11,9,20
26,8476878,Zemgus Girgensons,C,TBL,30,80,10,10,20
26,8479336,Carl Grundstrom,R,SJS,27,48,10,10,20
26,8475343,Nic Dowd,C,WSH,34,56,10,10,20
26,8476918,Jimmy Vesey,L,NYR,31,68,10,10,20
26,8482062,Cole Smith,L,NSH,29,54,10,10,20
26,8478432,Christian Fischer,R,DET,27,79,7,13,20
26,8476422,Mike Reilly,D,NYI,31,75,6,14,20
26,8475324,Nick Jensen,D,OTT,34,74,6,14,20
26,8478882,Vladislav Gavrikov,D,LAK,29,66,5,15,20
26,8479316,Luke Kunin,C,SJS,27,54,4,16,20
26,8479328,Julien Gauthier,R,NYI,27,55,4,16,20
26,8477435,Ryan Graves,D,PIT,29,77,3,17,20
26,8478851,Alexandre Carrier,D,NSH,28,67,3,17,20
26,8478416,Erik Cernak,D,TBL,27,74,3,17,20
26,8474673,TJ Brodie,D,CHI,34,66,2,18,20
26,8476429,Scott Mayfield,D,NYI,32,74,2,18,20
26,8475718,Justin Holl,D,DET,32,63,2,18,20
26,8482073,Braden Schneider,D,NYR,23,68,1,19,20
26,8482679,Matt Coronato,R,CGY,22,68,14,5,19
26,8475231,Casey Cizikas,C,NYI,33,73,12,7,19
26,8481704,Juuso Parssinen,C,NSH,23,59,11,8,19
26,8482155,Alex Laferriere,R,LAK,23,61,11,8,19
26,8481441,Joe Snively,C,DET,28,61,10,9,19
26,8476889,Radek Faksa,C,STL,30,62,9,10,19
26,8476329,Travis Boyd,C,MIN,31,49,9,10,19
26,8473453,Trevor Lewis,C,LAK,37,70,9,10,19
26,8476312,Josh Manson,D,COL,33,62,7,12,19
26,8479998,Mikey Anderson,D,LAK,25,65,6,13,19
26,8481019,David Gustafsson,C,WPG,24,48,6,13,19
26,8477488,Brett Pesce,D,NJD,30,70,5,14,19
26,8481178,Egor Zamula,D,PHI,24,56,4,15,19
26,8480205,Emil Bemstrom,C,PIT,25,53,3,16,19
26,8471709,Marc-Edouard Vlasic,D,SJS,37,68,3,16,19
26,8477845,Trevor van Riemsdyk,D,WSH,33,66,2,17,19
26,8481059,Scott Perunovich,D,STL,26,60,1,18,19
26,8482809,Jackson Blake,R,CAR,21,54,10,8,18
26,8480848,Ty Dellandrea,C,SJS,24,54,10,8,18
26,8476374,Sean Kuraly,C,CBJ,31,63,9,9,18
26,8481481,Blake Lizotte,C,PIT,27,62,9,9,18
26,8477220,Nate Schmidt,D,FLA,33,69,8,10,18
26,8481553,Bobby Brink,R,PHI,23,58,7,11,18
26,8476525,Colin Miller,D,WPG,32,66,7,11,18
26,8480891,Michael Kesselring,D,UTA,24,58,5,13,18
26,8476925,Colton Sissons,C,NSH,31,63,4,14,18
26,8482111,Justin Barron,D,MTL,23,67,3,15,18
26,8481522,Peyton Krebs,C,BUF,23,55,3,15,18
26,8478840,Will Borgen,D,SEA,28,65,2,16,18
26,8477499,Rasmus Ristolainen,D,PHI,30,55,0,18,18
26,8482077,Dylan Holloway,L,EDM,23,44,12,5,17
26,8482737,Zack Bolduc,C,STL,21,56,10,7,17
26,8479066,Ryan Lomberg,L,CGY,30,64,10,7,17
26,8474034,Patrick Maroon,L,CHI,36,48,8,9,17
26,8477979,Nicolas Aube-Kubel,R,BUF,28,56,7,10,17
26,8482148,Hendrix Lapierre,C,WSH,22,50,7,10,17
26,8476873,Mark Jankowski,C,NSH,30,50,7,10,17
26,8481517,Brett Leason,R,ANA,25,59,6,11,17
26,8484149,Gavin Brindley,C,CBJ,20,55,6,11,17
26,8477369,Carson Soucy,D,VAN,30,65,5,12,17
26,8480144,David Kampf,C,TOR,29,64,5,12,17
26,8480950,Ilya Lyubushkin,D,DAL,30,64,4,13,17
26,8475790,Erik Gudbranson,D,CBJ,32,76,3,14,17
26,8478399,Jonas Siegenthaler,D,NJD,27,66,3,14,17
26,8479324,Ryan Lindgren,D,NYR,26,65,3,14,17
26,8480807,Mattias Samuelsson,D,BUF,24,61,2,15,17
26,8483460,David Jiricek,D,CBJ,21,65,2,15,17
26,8476892,Colton Parayko,D,STL,31,68,0,17,17
26,8475225,Craig Smith,C,CHI,35,49,11,5,16
26,8482079,Marco Rossi,C,MIN,23,54,10,6,16
26,8479370,Tyson Jost,C,CAR,26,52,10,6,16
26,8479439,Jacob MacDonald,D,COL,31,54,9,7,16
26,8482730,Brandt Clarke,D,LAK,21,44,9,7,16
26,8477573,Nathan Walker,L,STL,30,41,8,8,16
26,8481617,Vasily Podkolzin,R,VAN,23,47,8,8,16
26,8479543,Michael Pezzetta,L,MTL,26,52,8,8,16
26,8477406,Mattias Janmark,C,EDM,32,67,7,9,16
26,8480806,Isac Lundestrom,C,ANA,25,51,6,10,16
26,8477478,William Carrier,L,CAR,30,54,6,10,16
26,8482157,Will Cuylle,L,NYR,22,59,6,10,16
26,8479291,Kevin Rooney,C,CGY,31,52,6,10,16
26,8479983,Mario Ferraro,D,SJS,26,69,5,11,16
26,8480727,Zach Whitecloud,D,VGK,28,42,5,11,16
26,8483499,Liam Ohgren,L,MIN,20,57,5,11,16
26,8479026,Philippe Myers,D,TOR,27,57,5,11,16
26,8476624,Barclay Goodrow,C,SJS,31,46,5,11,16
26,8475462,Radko Gudas,D,ANA,34,67,4,12,16
26,8479980,Nicolas Hague,D,VGK,26,50,3,13,16
26,8476988,Matt Benning,D,SJS,30,55,3,13,16
26,8482451,Mikael Pyyhtia,L,CBJ,23,38,3,13,16
26,8478178,Darren Raddysh,D,TBL,28,70,3,13,16
26,8475179,Dmitry Kulikov,D,FLA,34,55,2,14,16
26,8475208,Brian Dumoulin,D,ANA,33,67,2,14,16
26,8475279,Ben Chiarot,D,DET,33,66,2,14,16
26,8478421,A.J. Greer,L,FLA,28,64,8,7,15
26,8480980,Connor Dewar,C,TOR,25,62,8,7,15
26,8481641,Joel Kiviranta,L,COL,28,70,8,7,15
26,8478585,Derek Ryan,C,EDM,38,59,7,8,15
26,8476822,Luke Glendening,C,TBL,35,78,7,8,15
26,8478859,Niko Mikkola,D,FLA,28,58,6,9,15
26,8482176,Wyatt Kaiser,D,CHI,22,52,6,9,15
26,8480448,Parker Kelly,L,COL,25,74,6,9,15
26,8479520,Brandon Duhaime,R,WSH,27,63,6,9,15
26,8480021,Jack Studnicka,C,LAK,25,58,5,10,15
26,8481477,Nico Sturm,C,SJS,29,57,5,10,15
26,8481567,Henry Thrun,D,SJS,23,56,5,10,15
26,8475233,David Savard,D,MTL,34,63,4,11,15
26,8477380,Jonny Brodzinski,C,NYR,31,49,4,11,15
26,8479372,Joshua Mahura,D,SEA,26,65,2,13,15
26,8476874,Olli Maatta,D,DET,30,62,2,13,15
26,8480887,Jordan Harris,D,MTL,24,58,2,13,15
26,8479369,Andrew Peeke,D,BOS,26,62,1,14,15
26,8481716,Dmitri Voronkov,L,CBJ,24,40,11,3,14
26,8480441,Trey Fix-Wolansky,R,CBJ,25,40,10,4,14
26,8479671,Mathieu Olivier,R,CBJ,27,49,8,6,14
26,8482166,Shakir Mukhamadullin,D,SJS,22,54,7,7,14
26,8481537,Nikita Okhotiuk,D,CGY,24,54,7,7,14
26,8478831,Kevin Stenlund,C,UTA,28,55,6,8,14
26,8482803,Olen Zellweger,D,ANA,21,64,5,9,14
26,8476994,Vinnie Hinostroza,C,NSH,30,51,5,9,14
26,8476856,Mathew Dumba,D,DAL,30,70,4,10,14
26,8478043,Sam Lafferty,C,BUF,29,61,4,10,14
26,8478211,Dryden Hunt,L,CGY,29,50,4,10,14
26,8481527,Kaedan Korczak,D,VGK,23,49,2,12,14
26,8473507,Jeff Petry,D,DET,37,65,1,13,14
26,8480001,Urho Vaakanainen,D,ANA,25,52,1,13,14
26,8479249,Andrew Poturalski,C,SJS,30,39,1,13,14
26,8481789,Tye Kartye,L,SEA,23,42,11,2,13
26,8477018,Ben Hutton,D,VGK,31,54,8,5,13
26,8483565,Nick Blankenburg,D,NSH,26,65,6,7,13
26,8477508,Curtis Lazar,C,NJD,29,57,4,9,13
26,8475455,Brenden Dillon,D,NJD,34,60,4,9,13
26,8478569,Noel Acciari,C,PIT,33,59,4,9,13
26,8477070,Liam O'Brien,C,UTA,30,59,4,9,13
26,8480860,Kevin Bahl,D,CGY,24,51,4,9,13
26,8484254,Akito Hirose,D,VAN,25,41,4,9,13
26,8481599,Victor Soderstrom,D,UTA,23,43,3,10,13
26,8480172,Jan Rutta,D,SJS,34,61,2,11,13
26,8475842,Sam Carrick,C,NYR,32,57,8,4,12
26,8482762,Simon Edvinsson,D,DET,21,53,8,4,12
26,8478508,Yakov Trenin,C,MIN,27,61,7,5,12
26,8481028,Martin Pospisil,C,CGY,25,55,6,6,12
26,8481592,Jakob Pelletier,L,CGY,23,44,6,6,12
26,8482744,James Malatesta,L,CBJ,21,42,6,6,12
26,8476867,Brendan Gaunce,C,MIN,30,35,6,6,12
26,8477931,Tomas Nosek,L,FLA,32,55,4,8,12
26,8482177,Marat Khusnutdinov,C,MIN,22,48,4,8,12
26,8475188,Brayden McNabb,D,VGK,33,56,3,9,12
26,8481013,Jonatan Berggren,R,DET,24,60,3,9,12
26,8482634,Alex Steeves,C,TOR,25,46,3,9,12
26,8481708,Zac Jones,D,NYR,24,48,3,9,12
26,8475690,Chris Tanev,D,TOR,35,54,3,9,12
26,8477034,Jaycob Megna,D,FLA,32,51,3,9,12
26,8477335,Kyle Burroughs,D,LAK,29,47,3,9,12
26,8474568,Luke Schenn,D,NSH,35,51,3,9,12
26,8479348,Kale Clague,D,BUF,26,41,3,9,12
26,8476467,Jamie Oleksiak,D,SEA,32,59,2,10,12
26,8470600,Ryan Suter,D,STL,39,60,2,10,12
26,8480222,Sebastian Aho,D,PIT,28,71,1,11,12
26,8482192,Isaak Phillips,D,CHI,23,56,1,11,12
26,8480058,Pierre-Olivier Joseph,D,STL,25,58,1,11,12
26,8476934,Brock McGinn,L,ANA,30,54,6,5,11
26,8482659,Josh Doan,R,UTA,22,48,6,5,11
26,8476469,Joel Armia,R,MTL,31,66,5,6,11
26,8478452,Caleb Jones,D,LAK,27,60,4,7,11
26,8480157,Calle Rosen,D,COL,30,52,4,7,11
26,8482666,Scott Morrow,D,CAR,22,48,4,7,11
26,8479718,Alex Barré-Boulet,C,MTL,27,51,3,8,11
26,8483466,Kevin Korchinski,D,CHI,20,49,3,8,11
26,8481600,Tobias Bjornfot,D,FLA,23,38,3,8,11
26,8480025,MacKenzie Entwistle,R,FLA,25,68,2,9,11
26,8474090,Brendan Smith,D,DAL,35,52,2,9,11
26,8475177,Calvin de Haan,D,COL,33,45,2,9,11
26,8481598,Philip Broberg,D,EDM,23,47,2,9,11
26,8480192,Johnathan Kovacevic,D,NJD,27,47,1,10,11
26,8474013,Ian Cole,D,UTA,35,59,0,11,11
26,8479344,Jesse Puljujarvi,R,PIT,26,49,6,4,10
26,8476967,Brett Kulak,D,EDM,30,61,5,5,10
26,8482095,Tyler Kleven,D,OTT,22,47,5,5,10
26,8483495,Simon Nemec,D,NJD,20,55,4,6,10
26,8480796,Martin Fehervary,D,WSH,25,49,4,6,10
26,8481550,Adam Beckman,L,NJD,23,35,4,6,10
26,8480246,Nick Perbix,D,TBL,26,76,3,7,10
26,8477887,Patrick Brown,C,BOS,32,46,3,7,10
26,8473446,Erik Johnson,D,PHI,36,47,3,7,10
26,8478017,Mark Friedman,D,VAN,29,36,3,7,10
26,8480879,Jacob Bernard-Docker,D,OTT,24,48,3,7,10
26,8481518,Nolan Foote,L,NJD,24,45,2,8,10
26,8478454,Noah Juulsen,D,VAN,27,38,2,8,10
26,8479359,Beck Malenstyn,L,BUF,26,54,6,3,9
26,8477482,Zachary Sanford,L,CHI,30,45,4,5,9
26,8481751,Lukas Rousek,R,BUF,25,32,3,6,9
26,8481701,Santeri Hatakka,D,NJD,23,39,3,6,9
26,8476952,Dominic Toninato,C,WPG,30,39,3,6,9
26,8478443,Brandon Carlo,D,BOS,28,66,3,6,9
26,8480834,Ty Emberson,D,SJS,24,28,3,6,9
26,8482858,Ryker Evans,D,SEA,23,18,3,6,9
26,8474612,Travis Hamonic,D,OTT,34,46,2,7,9
26,8482964,Arber Xhekaj,D,MTL,23,45,2,7,9
26,8482496,Nils Aman,C,VAN,24,45,2,7,9
26,8477365,Connor Clifton,D,BUF,29,59,1,8,9
26,8474567,Zach Bogosian,D,MIN,34,64,1,8,9
26,8482141,Lukas Cormier,D,VGK,22,39,1,8,9
26,8480196,Jacob Bryson,D,BUF,27,48,1,8,9
26,8480070,Ian Mitchell,D,BOS,25,48,0,9,9
26,8481167,Brayden Pachal,D,CGY,25,42,0,9,9
26,8479944,Zach Aston-Reese,C,VGK,30,53,6,2,8
26,8482070,Mitchell Chaffee,R,TBL,26,49,5,3,8
26,8476858,Phillip Di Giuseppe,L,VAN,31,38,5,3,8
26,8480880,Jakub Lauko,C,MIN,24,31,5,3,8
26,8482784,Zach Dean,C,STL,21,35,4,4,8
26,8482807,Ethan Del Mastro,D,CHI,21,53,3,5,8
26,8476442,Matt Nieto,L,PIT,32,37,3,5,8
26,8480245,Olle Lycksell,R,PHI,25,30,3,5,8
26,8479536,Axel Jonsson-Fjallby,L,WPG,26,35,3,5,8
26,8481056,Spencer Stastney,D,NSH,24,30,3,5,8
26,8482859,Zack Ostapchuk,C,OTT,21,50,3,5,8
26,8471817,Ryan Reaves,R,TOR,37,58,3,5,8
26,8482511,Mason Lohrei,D,BOS,23,32,3,5,8
26,8479378,Logan Stanley,D,WPG,26,47,2,6,8
26,8478450,Parker Wotherspoon,D,BOS,27,32,1,7,8
26,8479981,Jonah Gadjovich,L,FLA,26,31,6,1,7
26,8482652,Walker Duehr,R,CGY,27,37,6,1,7
26,8478424,Jansen Harkins,C,ANA,27,39,5,2,7
26,8481532,Alex Turcotte,C,LAK,23,54,5,2,7
26,8481556,John Beecher,C,BOS,23,33,4,3,7
26,8479985,Cale Fleury,D,SEA,26,25,4,3,7
26,8479320,Maxime Lajoie,D,SEA,27,26,4,3,7
26,8482733,Logan Mailloux,D,MTL,31,29,3,4,7
26,8482751,Ryan Winterton,C,SEA,21,41,3,4,7
26,8483630,Pavol Regenda,L,ANA,25,33,3,4,7
26,8482765,Isak Rosen,R,BUF,21,28,3,4,7
26,8477527,Ross Johnston,L,ANA,30,38,2,5,7
26,8480844,Grigori Denisenko,L,VGK,24,28,2,5,7
26,8471677,Jack Johnson,D,CBJ,37,64,1,6,7
26,8481122,Simon Benoit,D,TOR,26,37,1,6,7
26,8475235,Nicolas Deslauriers,L,PHI,33,44,1,6,7
26,8478468,Jeremy Lauzon,D,NSH,27,53,0,7,7
26,8480292,Carson Meyer,R,ANA,27,39,0,7,7
26,8484911,Collin Graf,R,SJS,22,39,4,2,6
26,8480355,Mark Kastelic,C,BOS,25,58,3,3,6
26,8476372,Nick Seeler,D,PHI,31,51,3,3,6
26,8480990,Declan Chisholm,D,MIN,24,37,3,3,6
26,8481543,Nikita Alexandrov,C,STL,24,30,3,3,6
26,8478874,Adam Gaudette,R,OTT,28,30,3,3,6
26,8482172,Landon Slaggert,L,CHI,22,21,3,3,6
26,8481541,Samuel Bolduc,D,NYI,24,27,3,3,6
26,8481161,Jake Christiansen,D,CBJ,25,48,2,4,6
26,8475762,Derek Forbort,D,VAN,32,47,2,4,6
26,8479419,Brett Murray,L,BUF,26,27,2,4,6
26,8476441,Joel Edmundson,D,LAK,31,33,2,4,6
26,8481585,Egor Afanasyev,L,SJS,23,21,2,4,6
26,8479379,Givani Smith,R,SJS,26,30,2,4,6
26,8482245,Artem Zub,D,OTT,29,69,1,5,6
26,8479772,Zack MacEwen,R,OTT,28,49,1,5,6
26,8478146,Matthew Highmore,C,OTT,28,48,1,5,6
26,8478409,Anthony Richard,C,PHI,28,32,1,5,6
26,8476473,Connor Murphy,D,CHI,31,30,1,5,6
26,8482144,Jack Thompson,D,SJS,22,25,1,5,6
26,8481605,Jackson LaCombe,D,ANA,23,31,0,6,6
26,8481679,Maxence Guenette,D,OTT,23,30,5,0,5
26,8483570,Ben Meyers,C,SEA,26,33,5,0,5
26,8477938,Haydn Fleury,D,WPG,28,35,3,2,5
26,8481147,Reese Johnson,C,MIN,26,40,3,2,5
26,8477401,John Hayden,C,SEA,29,27,3,2,5
26,8483012,Logan Morrison,C,SEA,22,38,3,2,5
26,8480890,Jan Jenik,C,OTT,24,24,3,2,5
26,8474166,Alec Martinez,D,CHI,37,48,2,3,5
26,8482165,Yan Kuznetsov,D,CGY,22,25,2,3,5
26,8475958,Michael Sgarbossa,C,WSH,32,33,2,3,5
26,8480845,Rasmus Kupari,C,WPG,24,38,1,4,5
26,8475750,Jon Merrill,D,MIN,32,58,1,4,5
26,8479972,Mason Shaw,C,WPG,26,35,1,4,5
26,8480007,Jonas Rondbjerg,R,VGK,25,35,1,4,5
26,8482747,Brennan Othmann,L,NYR,21,39,1,4,5
26,8483549,Lucas Condotta,L,MTL,27,28,1,4,5
26,8480870,Bo Groulx,C,NYR,24,27,1,4,5
26,8483763,Maksymilian Szuber,D,UTA,22,35,1,4,5
26,8479442,Troy Stecher,D,EDM,30,48,0,5,5
26,8482861,Vincent Iorio,D,WSH,22,35,0,5,5
26,8479968,Vinni Lettieri,C,BOS,29,41,3,1,4
26,8477962,Brendan Lemieux,L,CAR,28,36,3,1,4
26,8479986,Kole Lind,R,DAL,26,50,2,2,4
26,8477851,Jordan Oesterle,D,BOS,32,39,2,2,4
26,8484287,Cole McWard,D,VAN,23,22,2,2,4
26,8476913,Devin Shore,C,MIN,30,32,2,2,4
26,8484258,Sam Malinski,D,COL,26,12,2,2,4
26,8481609,Vladislav Kolyachonok,D,UTA,23,34,2,2,4
26,8482145,Mavrik Bourque,C,DAL,22,50,2,2,4
26,8478011,Louie Belpedio,D,PHI,28,17,2,2,4
26,8481593,Jayden Struble,D,MTL,23,22,2,2,4
26,8479362,Riley Tufte,L,BOS,26,23,1,3,4
26,8481743,Marc Del Gaizo,D,NSH,25,16,1,3,4
26,8477244,Chad Ruhwedel,D,NYR,34,24,0,4,4
26,8481754,Nikita Nesterenko,C,ANA,23,25,3,0,3
26,8479638,Justin Brazeau,R,BOS,26,33,3,0,3
26,8482118,Sam Colangelo,R,ANA,23,16,3,0,3
26,8481699,Aku Raty,R,UTA,23,15,3,0,3
26,8482088,Justin Sourdif,R,FLA,22,22,3,0,3
26,8482929,Emil Lilleberg,D,TBL,23,20,2,1,3
26,8474062,Riley Nash,C,NYR,35,19,2,1,3
26,8481578,Graeme Clarke,R,MIN,23,10,2,1,3
26,8483489,Fraser Minten,C,TOR,31,5,2,1,3
26,8480851,Akil Thomas,C,LAK,24,18,2,1,3
26,8477384,Joshua Brown,D,EDM,30,38,1,2,3
26,8483619,Filip Roos,D,OTT,25,29,1,2,3
26,8479994,Jaret Anderson-Dolan,C,WPG,25,28,1,2,3
26,8481237,Kyle MacLean,C,NYI,25,27,1,2,3
26,8475413,Justin Dowling,C,NJD,34,18,1,2,3
26,8480084,Nick DeSimone,D,NJD,30,12,1,2,3
26,8478502,Dennis Gilbert,D,BUF,28,11,1,2,3
26,8480267,Sammy Walker,C,MIN,25,18,1,2,3
26,8479367,William Lockwood,R,FLA,26,20,1,2,3
26,8477320,Anton Blidh,L,NYR,29,29,1,2,3
26,8479991,Jake Leschyshyn,C,NYR,25,29,0,3,3
26,8482153,Brendan Brisson,C,VGK,23,28,2,0,2
26,8481030,Jack St. Ivany,D,PIT,25,12,2,0,2
26,8479576,Vincent Desharnais,D,VAN,28,39,1,1,2
26,8478477,Mitchell Stephens,C,SEA,27,20,1,1,2
26,8477462,Robert Hagg,D,VGK,29,17,1,1,2
26,8477467,Gustav Olofsson,D,SEA,30,13,1,1,2
26,8482102,Vasily Ponomarev,C,PIT,22,15,1,1,2
26,8483395,Arshdeep Bains,L,VAN,23,7,1,1,2
26,8483597,Milos Kelemen,L,UTA,25,9,1,1,2
26,8482476,Emil Heineman,L,MTL,23,8,1,1,2
26,8483512,Matthew Savoie,C,EDM,20,17,1,1,2
26,8480823,Alexander Alexeyev,D,WSH,25,12,1,1,2
26,8475795,Dylan McIlrath,D,WSH,32,13,0,2,2
26,8482201,Gage Goncalves,C,TBL,23,19,0,2,2
26,8479587,Rhett Gardner,C,PHI,28,19,0,2,2
26,8478021,William Lagesson,D,DET,28,27,0,2,2
26,8477971,Andreas Englund,D,LAK,28,27,0,2,2
26,8482250,Callahan Burke,C,VGK,27,23,0,2,2
26,8481043,Cole Koepke,L,BOS,26,19,0,2,2
26,8480874,Adam Ginning,D,PHI,24,9,0,2,2
26,8478051,Max Willman,C,NJD,29,19,1,0,1
26,8483397,Marc McLaughlin,C,BOS,25,31,1,0,1
26,8482147,Jean-Luc Foudy,C,COL,22,27,1,0,1
26,8481726,Adam Edstrom,C,NYR,24,8,1,0,1
26,8481024,Linus Karlsson,C,VAN,25,5,1,0,1
26,8483471,Brad Lambert,C,WPG,31,12,1,0,1
26,8483920,Pierrick Dube,R,WSH,23,3,1,0,1
26,8481006,Tyler Tucker,D,STL,24,17,0,1,1
26,8480468,James Hamblin,L,EDM,25,17,0,1,1
26,8482713,Mackie Samoskevich,R,FLA,22,35,0,1,1
26,8477473,Justin Bailey,R,SJS,29,18,0,1,1
26,8481806,Louis Crevier,D,CHI,23,13,0,1,1
26,8478446,Glenn Gawdin,C,LAK,27,10,0,1,1
26,8477810,Joel Hanley,D,CGY,33,16,0,1,1
26,8477073,Kurtis MacDermid,L,NJD,30,25,0,1,1
26,8482470,Ilya Solovyov,D,CGY,24,13,0,1,1
26,8479421,Jacob Moverare,D,LAK,26,9,0,1,1
26,8477149,Scott Sabourin,R,SJS,32,10,0,1,1
26,8482516,Matthew Kessel,D,STL,24,20,0,1,1
26,8480032,Shane Bowers,C,NJD,25,15,0,1,1
26,8484304,Uvis Balinskis,D,FLA,28,12,0,1,1
26,8481462,Mason Morelli,L,VGK,28,12,0,1,1
26,8483432,Luca Del Bel Belluz,C,CBJ,31,4,0,1,1
26,8483398,Declan Carlile,D,TBL,31,5,0,1,1
26,8482460,Matt Rempe,C,NYR,22,13,0,1,1
26,8483401,Marc Johnstone,R,PIT,28,4,0,0,0
26,8483567,Georgii Merkulov,C,BOS,24,8,0,0,0
26,8482094,Daemon Hunt,D,MIN,22,18,0,0,0
26,8481065,Angus Crookshank,L,OTT,25,13,0,0,0
26,8475780,Chris Wagner,R,COL,33,9,0,0,0
26,8478881,Brett Seney,L,CHI,28,7,0,0,0
26,8481719,Maxwell Crozier,D,TBL,24,11,0,0,0
26,8482162,Roby Jarventie,L,EDM,22,8,0,0,0
26,8481422,Jake Lucchini,C,NSH,29,19,0,0,0
26,8478854,Ryan Shea,D,PIT,27,8,0,0,0
26,8477993,Justin Kirkland,C,CGY,28,7,0,0,0
26,8480075,Cameron Crotty,D,MIN,25,9,0,0,0
26,8482787,Nikita Chibrikov,R,WPG,31,9,0,0,0
26,8477541,Dakota Mermis,D,TOR,30,9,0,0,0
26,8481206,John Ludvig,D,PIT,24,9,0,0,0
26,8482197,Adam Raska,R,MIN,23,4,0,0,0
26,8482061,Brandon Biro,L,SEA,26,8,0,0,0
26,8484326,Patrik Koch,D,UTA,28,1,0,0,0
26,8476323,Max McCormick,L,SEA,32,6,0,0,0
26,8484325,Waltteri Merela,C,TBL,26,24,0,0,0
26,8475755,Alexander Petrovic,D,DAL,32,7,0,0,0
26,8483609,Adam Klapka,R,CGY,24,1,0,0,0
26,8481564,Ryan Johnson,D,BUF,23,8,0,0,0
26,8479522,Hardy Haman Aktell,D,WSH,26,3,0,0,0
26,8483531,Brian Halonen,L,NJD,25,3,0,0,0
26,8480306,Grant Hutton,D,NYI,29,3,0,0,0
26,8484255,Jason Polin,R,COL,25,5,0,0,0
26,8479330,Brandon Gignac,C,MTL,27,7,0,0,0
26,8483407,Brandon Scanlin,D,NYR,25,6,0,0,0
26,8483546,Marshall Rifai,D,TOR,26,8,0,0,0
26,8481655,Cole Schwindt,R,CGY,23,4,0,0,0
26,8484259,Ondrej Pavel,C,COL,31,0,0,0,0
26,8480274,Philip Kemp,D,EDM,25,1,0,0,0
26,8484321,Nikolas Matinpalo,D,OTT,26,2,0,0,0
26,8478147,Bokondji Imama,L,PIT,28,5,0,0,0
26,8481534,Raphael Lavoie,C,EDM,24,2,0,0,0
26,8482126,Emil Andrae,D,PHI,31,4,0,0,0
26,8470794,Joe Pavelski,C,,40,0,0,0,0
26,8479321,Lucas Johansen,D,,27,0,0,0,0
26,8477950,Tony DeAngelo,D,,29,0,0,0,0
26,8471218,Blake Wheeler,R,,38,0,0,0,0
26,8475197,Tyson Barrie,D,,33,0,0,0,0
26,8474157,Max Pacioretty,L,,36,0,0,0,0
26,8475744,Evgeny Kuznetsov,C,,32,0,0,0,0
26,8474037,James van Riemsdyk,L,,35,0,0,0,0
26,8476907,Mackenzie MacEachern,L,,30,0,0,0,0
26,8480216,Jacob Peterson,C,,25,0,0,0,0
26,8474602,Justin Schultz,D,,34,0,0,0,0
26,8482222,Alexander Barabanov,L,,30,0,0,0,0
26,8474031,Kevin Shattenkirk,D,,35,0,0,0,0
26,8477330,Dominik Kubalik,L,,29,0,0,0,0
26,8480884,Calen Addison,D,,24,0,0,0,0
26,8475906,John Klingberg,D,,32,0,0,0,0
26,8480008,Adam Ruzicka,C,,25,0,0,0,0
26,8476884,Derrick Pouliot,D,,30,0,0,0,0
26,8476919,Chris Tierney,C,,30,0,0,0,0
26,8479415,Michael McLeod,C,,26,0,0,0,0
26,8474870,Tyler Johnson,C,,34,0,0,0,0
26,8470604,Jeff Carter,C,,39,0,0,0,0
26,8478104,Sammy Blais,L,,28,0,0,0,0
26,8474884,Mike Hoffman,C,,35,0,0,0,0
26,8481591,Sam Poulin,R,,23,0,0,0,0
26,8471274,Alex Goligoski,D,,39,0,0,0,0
26,8476871,Tanner Pearson,L,,32,0,0,0,0
26,8476393,Nick Cousins,C,,31,0,0,0,0
26,8479977,Kailer Yamamoto,R,,26,0,0,0,0
26,8479346,Dillon Dube,C,,26,0,0,0,0
26,8480184,Gustav Lindstrom,D,,26,0,0,0,0
26,8479376,Victor Mete,D,,26,0,0,0,0
26,8473449,Kyle Okposo,R,,36,0,0,0,0
26,8481058,Jesse Ylonen,R,,25,0,0,0,0
26,8475752,Tyler Pitlick,C,,33,0,0,0,0
26,8481239,Samuel Fagemo,L,,24,0,0,0,0
26,8480821,Filip Zadina,R,,25,0,0,0,0
26,8470966,Mark Giordano,D,,41,0,0,0,0
26,8478495,Denis Gurianov,R,,27,0,0,0,0
26,8477464,Nic Petan,C,,29,0,0,0,0
26,8478099,Kevin Labanc,R,,29,0,0,0,0
26,8482241,Radim Zohorna,L,,28,0,0,0,0
26,8474040,Sam Gagner,C,,35,0,0,0,0
26,8479514,Rem Pitlick,C,,27,0,0,0,0
26,8478430,Oliver Kylington,D,,27,0,0,0,0
26,8479533,Joona Koppanen,L,,26,0,0,0,0
26,8479984,Cal Foote,D,,26,0,0,0,0
26,8477126,Jayson Megna,C,,34,0,0,0,0
26,8475164,Jakob Silfverberg,R,,34,0,0,0,0
26,8474009,Nick Bonino,C,,36,0,0,0,0
26,8479458,Nikita Zaitsev,D,,33,0,0,0,0
26,8477944,Jakub Vrana,L,,28,0,0,0,0
26,8471699,Andrew Cogliano,C,,37,0,0,0,0
26,8478067,Oskar Lindblom,L,,28,0,0,0,0
26,8471686,Marc Staal,D,,37,0,0,0,0
26,8470610,Zach Parise,L,,40,0,0,0,0
26,8478904,Steven Lorentz,C,,28,0,0,0,0
26,8473473,Milan Lucic,L,,36,0,0,0,0
26,8480031,Maxime Comtois,L,,25,0,0,0,0
26,8478512,Austin Czarnik,C,,32,0,0,0,0
26,8473504,Cal Clutterbuck,R,,37,0,0,0,0
26,8477454,Adam Erne,L,,29,0,0,0,0
26,8479383,Boris Katchouk,L,,26,0,0,0,0
26,8475825,Jani Hakanpää,D,,32,0,0,0,0
26,8477846,Ryan Carpenter,C,,33,0,0,0,0
26,8477930,Pierre-Edouard Bellemare,L,,39,0,0,0,0
26,8478400,Colin White,C,,27,0,0,0,0
26,8480226,Marián Studenic,R,,26,0,0,0,0
26,8480853,Liam Foudy,C,,24,0,0,0,0
26,8475797,Jarred Tinordi,D,,32,0,0,0,0
26,8479423,Alex Nylander,L,,26,0,0,0,0
26,8474618,Marco Scandella,D,,34,0,0,0,0
26,8478028,Fredrik Olofsson,L,,28,0,0,0,0
26,8474709,Matt Martin,L,,35,0,0,0,0
26,8481070,Hugh McGing,L,,26,0,0,0,0
26,8479546,Oskar Steen,C,,26,0,0,0,0
26,8474145,Robert Bortuzzo,D,,35,0,0,0,0
26,8476915,Jujhar Khaira,L,,30,0,0,0,0
26,8475278,Byron Froese,C,,33,0,0,0,0
26,8481812,Nikolai Knyzhov,D,,27,0,0,0,0
26,8478408,Travis Dermott,D,,28,0,0,0,0
26,8481077,John Leonard,L,,26,0,0,0,0
26,8479547,Matthew Phillips,R,,26,0,0,0,0
26,8480836,Jonathan Gruden,C,,24,0,0,0,0
26,8481690,Tyler Angle,C,,24,0,0,0,0
26,8475766,Austin Watson,L,,32,0,0,0,0
26,8481016,Ruslan Iskhakov,C,,24,0,0,0,0
26,8478078,Rourke Chartier,C,,28,0,0,0,0
26,8480776,Sheldon Rempal,R,,29,0,0,0,0
26,8478956,Samuel Laberge,L,NJD,27,1,0,0,0
26,8483045,Cameron Butler,R,CBJ,31,0,0,0,0
26,8484314,Jiri Smejkal,L,,28,0,0,0,0
27,8478402,Connor McDavid,C,EDM,27,79,38,105,143
27,8476453,Nikita Kucherov,R,TBL,31,82,41,95,136
27,8477492,Nathan MacKinnon,C,COL,29,82,50,85,135
27,8477956,David Pastrnak,R,BOS,28,80,48,67,115
27,8477934,Leon Draisaitl,C,EDM,29,78,53,61,114
27,8476468,J.T. Miller,C,VAN,31,77,32,79,111
27,8480012,Elias Pettersson,C,VAN,26,77,41,69,110
27,8478483,Mitch Marner,R,TOR,27,81,31,79,110
27,8476887,Filip Forsberg,L,NSH,30,77,51,57,108
27,8479314,Matthew Tkachuk,L,FLA,27,80,33,75,108
27,8478550,Artemi Panarin,L,NYR,33,76,43,62,105
27,8474600,Roman Josi,D,NSH,34,75,23,81,104
27,8478420,Mikko Rantanen,R,COL,28,80,47,55,102
27,8481559,Jack Hughes,C,NJD,23,76,35,67,102
27,8477939,William Nylander,R,TOR,28,77,53,48,101
27,8471675,Sidney Crosby,C,PIT,37,75,35,66,101
27,8480027,Jason Robertson,L,DAL,25,82,36,63,99
27,8480002,Nico Hischier,C,NJD,25,76,35,64,99
27,8477404,Jake Guentzel,C,TBL,30,81,36,61,97
27,8480801,Brady Tkachuk,L,OTT,25,82,42,54,96
27,8479323,Adam Fox,D,NYR,26,75,22,73,95
27,8477946,Dylan Larkin,C,DET,28,82,49,43,92
27,8475172,Nazem Kadri,C,CGY,34,80,41,51,92
27,8479318,Auston Matthews,C,TOR,27,79,46,44,90
27,8476389,Vincent Trocheck,C,NYR,31,77,36,54,90
27,8480023,Robert Thomas,C,STL,25,76,28,62,90
27,8478864,Kirill Kaprizov,L,MIN,27,70,40,49,89
27,8476459,Mika Zibanejad,C,NYR,31,78,25,64,89
27,8477493,Aleksander Barkov,C,FLA,29,79,34,54,88
27,8478398,Kyle Connor,L,WPG,28,79,32,56,88
27,8480800,Quinn Hughes,D,VAN,25,75,16,72,88
27,8478427,Sebastian Aho,C,CAR,27,79,37,50,87
27,8480036,Miro Heiskanen,D,DAL,25,79,18,69,87
27,8479542,Brandon Hagel,L,TBL,26,82,36,50,86
27,8477942,Kevin Fiala,L,LAK,28,81,29,57,86
27,8476456,Jonathan Huberdeau,C,CGY,31,79,22,63,85
27,8471214,Alex Ovechkin,L,WSH,39,75,42,42,84
27,8477960,Adrian Kempe,R,LAK,28,81,33,51,84
27,8479407,Jesper Bratt,L,NJD,26,74,27,56,83
27,8478414,Timo Meier,R,NJD,28,74,38,44,82
27,8475754,Brock Nelson,C,NYI,33,79,35,47,82
27,8474141,Patrick Kane,R,DET,36,80,28,54,82
27,8477501,Valeri Nichushkin,R,COL,29,78,41,40,81
27,8478010,Brayden Point,C,TBL,28,82,37,44,81
27,8480208,Drake Batherson,R,OTT,26,79,33,48,81
27,8479337,Alex DeBrincat,R,DET,27,81,37,43,80
27,8478403,Jack Eichel,C,VGK,28,77,28,52,80
27,8480865,Noah Dobson,D,NYI,24,80,17,63,80
27,8479420,Tage Thompson,C,BUF,27,74,42,37,79
27,8479343,Clayton Keller,R,UTA,26,76,31,48,79
27,8478440,Dylan Strome,C,WSH,27,72,34,44,78
27,8474578,Erik Karlsson,D,PIT,34,81,27,51,78
27,8475184,Chris Kreider,L,NYR,33,79,42,35,77
27,8480018,Nick Suzuki,C,MTL,25,74,32,45,77
27,8475166,John Tavares,C,TOR,34,77,29,48,77
27,8482116,Tim Stützle,C,OTT,22,77,28,49,77
27,8478439,Travis Konecny,R,PHI,27,76,34,42,76
27,8475913,Mark Stone,R,VGK,32,71,28,48,76
27,8478460,Zach Werenski,D,CBJ,27,80,19,57,76
27,8475167,Victor Hedman,D,TBL,34,80,18,58,76
27,8477933,Sam Reinhart,C,FLA,29,78,35,40,75
27,8478445,Mathew Barzal,C,NYI,27,79,22,53,75
27,8475784,Jeff Skinner,C,EDM,32,77,22,53,75
27,8477500,Bo Horvat,C,NYI,29,76,40,34,74
27,8477402,Pavel Buchnevich,L,STL,29,70,27,46,73
27,8476346,Johnny Gaudreau,L,CBJ,31,72,19,54,73
27,8481557,Matt Boldy,L,MIN,23,76,37,35,72
27,8478493,Joel Eriksson Ek,C,MIN,27,73,32,40,72
27,8477940,Nikolaj Ehlers,L,WPG,28,72,31,41,72
27,8480069,Cale Makar,D,COL,26,73,18,54,72
27,8478449,Roope Hintz,C,DAL,28,81,34,37,71
27,8480830,Andrei Svechnikov,R,CAR,24,60,30,41,71
27,8480839,Rasmus Dahlin,D,BUF,24,74,22,49,71
27,8475692,Mats Zuccarello,R,MIN,37,67,17,54,71
27,8476454,Ryan Nugent-Hopkins,C,EDM,31,76,21,49,70
27,8475786,Zach Hyman,L,EDM,32,78,45,24,69
27,8475726,Tyler Toffoli,C,SJS,32,71,40,29,69
27,8476539,Jonathan Marchessault,R,NSH,34,75,34,35,69
27,8478047,Michael Bunting,L,PIT,29,74,32,37,69
27,8475169,Evander Kane,L,EDM,33,78,38,30,68
27,8475810,Bryan Rust,R,PIT,32,73,35,33,68
27,8476875,Mike Matheson,D,MTL,30,74,15,53,68
27,8474564,Steven Stamkos,C,NSH,34,75,36,31,67
27,8482699,Dylan Guenther,R,UTA,21,78,31,36,67
27,8476460,Mark Scheifele,C,WPG,31,71,26,41,67
27,8477949,Alex Tuch,R,BUF,28,77,19,48,67
27,8475168,Matt Duchene,C,DAL,33,80,22,43,65
27,8476448,William Karlsson,C,VGK,31,75,20,45,65
27,8475765,Vladimir Tarasenko,R,DET,33,80,27,37,64
27,8475170,Brayden Schenn,C,STL,33,74,27,37,64
27,8473419,Brad Marchand,L,BOS,36,79,24,40,64
27,8471215,Evgeni Malkin,C,PIT,38,79,24,40,64
27,8480803,Evan Bouchard,D,EDM,25,71,7,57,64
27,8476881,Tomas Hertl,C,VGK,31,81,28,35,63
27,8477496,Elias Lindholm,C,BOS,30,81,24,39,63
27,8482684,Luke Hughes,D,NJD,21,73,9,54,63
27,8478856,Conor Garland,R,VAN,28,71,27,35,62
27,8475745,Charlie Coyle,C,BOS,32,79,26,36,62
27,8477951,Nick Schmaltz,C,UTA,28,76,22,40,62
27,8484144,Connor Bedard,C,CHI,19,65,19,43,62
27,8482093,Seth Jarvis,C,CAR,22,72,28,33,61
27,8480039,Martin Necas,C,CAR,25,72,28,32,60
27,8479999,Casey Mittelstadt,C,COL,26,82,26,34,60
27,8471685,Anze Kopitar,C,LAK,37,79,24,36,60
27,8482078,Lucas Raymond,L,DET,22,80,23,37,60
27,8473512,Claude Giroux,R,OTT,36,78,22,38,60
27,8478401,Pavel Zacha,C,BOS,27,76,21,39,60
27,8477504,Josh Morrissey,D,WPG,29,73,11,49,60
27,8478366,Frank Vatrano,R,ANA,30,71,33,26,59
27,8482109,Alexis Lafrenière,L,NYR,23,71,28,31,59
27,8481540,Cole Caufield,R,MTL,23,72,26,33,59
27,8478975,Mason Marchment,L,DAL,29,82,25,34,59
27,8481596,Shane Pinto,C,OTT,24,75,24,35,59
27,8477456,J.T. Compher,L,DET,29,81,22,37,59
27,8473994,Jamie Benn,L,DAL,35,80,21,38,59
27,8482113,Anton Lundell,C,FLA,23,74,21,38,59
27,8474590,John Carlson,D,WSH,34,67,7,52,59
27,8477409,Carter Verhaeghe,C,FLA,29,76,25,33,58
27,8481528,Dylan Cozens,C,BUF,23,72,24,34,58
27,8474102,David Perron,L,OTT,36,78,23,35,58
27,8481711,Matias Maccelli,L,UTA,24,78,17,41,58
27,8474679,Gustav Nyquist,C,NSH,35,70,16,42,58
27,8471724,Kris Letang,D,PIT,37,81,9,49,58
27,8475798,Mikael Granlund,C,SJS,32,65,17,40,57
27,8475151,Kyle Palmieri,C,NYI,33,79,29,27,56
27,8478462,Nicolas Roy,C,VGK,27,74,24,32,56
27,8479400,Pierre-Luc Dubois,L,WSH,26,70,19,37,56
27,8483515,Juraj Slafkovsky,L,MTL,20,79,25,30,55
27,8483808,Andrei Kuzmenko,L,CGY,28,73,23,32,55
27,8475158,Ryan O'Reilly,C,NSH,33,70,23,32,55
27,8482159,Tyson Foerster,R,PHI,22,74,21,34,55
27,8479410,Mikhail Sergachev,D,UTA,26,72,7,48,55
27,8479385,Jordan Kyrou,C,STL,26,73,23,31,54
27,8478873,Troy Terry,R,ANA,27,74,23,31,54
27,8475191,Reilly Smith,R,NYR,33,75,23,31,54
27,8478444,Brock Boeser,R,VAN,27,71,28,25,53
27,8482740,Wyatt Johnston,C,DAL,21,82,23,30,53
27,8477494,Jonathan Drouin,L,COL,29,79,22,31,53
27,8480798,Philipp Kurashev,C,CHI,25,65,22,31,53
27,8482665,Matty Beniers,C,SEA,22,77,18,35,53
27,8480797,Joel Farabee,L,PHI,24,70,17,36,53
27,8477429,Andrew Copp,C,DET,30,78,15,38,53
27,8478397,Rasmus Andersson,D,CGY,28,76,13,40,53
27,8478407,Vince Dunn,D,SEA,28,71,13,40,53
27,8476792,Torey Krug,D,STL,33,74,11,42,53
27,8482097,Jack Quinn,R,BUF,23,69,25,27,52
27,8481533,Trevor Zegras,C,ANA,23,76,19,33,52
27,8479345,Jakob Chychrun,D,WSH,26,65,19,33,52
27,8476905,Chandler Stephenson,C,SEA,30,73,18,34,52
27,8477346,MacKenzie Weegar,D,CGY,30,75,8,44,52
27,8476432,Boone Jenner,C,CBJ,31,65,36,15,51
27,8474641,Adam Henrique,C,EDM,34,74,22,29,51
27,8478233,Andrew Mangiapane,L,WSH,28,67,20,31,51
27,8481560,Arthur Kaliyev,R,LAK,23,80,20,31,51
27,8479325,Charlie McAvoy,D,BOS,27,76,14,37,51
27,8480014,Gabriel Vilardi,C,WPG,25,71,29,21,50
27,8481068,Yegor Sharangovich,C,CGY,26,81,24,26,50
27,8476880,Tom Wilson,R,WSH,30,65,23,27,50
27,8477497,Sean Monahan,C,CBJ,30,74,21,29,50
27,8482124,Quinton Byfield,R,LAK,22,81,20,30,50
27,8476479,Phillip Danault,C,LAK,31,81,20,30,50
27,8480188,Fabian Zetterlund,L,SJS,25,64,20,30,50
27,8476882,Teuvo Teravainen,C,CHI,30,70,15,35,50
27,8482667,William Eklund,L,SJS,22,65,14,36,50
27,8479425,Filip Hronek,D,VAN,27,77,12,38,50
27,8476853,Morgan Rielly,D,TOR,30,68,10,40,50
27,8477416,Oliver Bjorkstrand,R,SEA,29,67,24,25,49
27,8476399,Blake Coleman,C,CGY,33,78,21,28,49
27,8479675,Trevor Moore,L,LAK,29,79,19,30,49
27,8477503,Max Domi,C,TOR,29,78,13,36,49
27,8475794,Tyler Seguin,C,DAL,32,82,26,22,48
27,8479987,Morgan Geekie,C,BOS,26,76,21,27,48
27,8477451,Ryan Hartman,R,MIN,30,73,20,28,48
27,8476826,Yanni Gourde,C,SEA,33,69,15,33,48
27,8476462,Dougie Hamilton,D,NJD,31,72,12,36,48
27,8477447,Shea Theodore,D,VGK,29,64,10,38,48
27,8478498,Jake DeBrusk,L,VAN,28,69,24,23,47
27,8477955,Jared McCann,L,SEA,28,73,24,23,47
27,8477511,Anthony Mantha,R,CGY,30,76,23,24,47
27,8480064,Josh Norris,C,OTT,25,71,22,25,47
27,8477407,Anthony Duclair,L,NYI,29,75,20,27,47
27,8482720,Matthew Knies,L,TOR,22,76,16,31,47
27,8478469,Thomas Chabot,D,OTT,27,75,9,38,47
27,8484145,Zach Benson,L,BUF,19,65,28,18,46
27,8478519,Anthony Cirelli,C,TBL,27,82,23,23,46
27,8476483,Rickard Rakell,R,PIT,31,71,20,26,46
27,8477935,Sam Bennett,C,FLA,28,77,19,27,46
27,8477021,Alex Kerfoot,C,UTA,30,76,18,28,46
27,8474565,Alex Pietrangelo,D,VGK,34,56,15,31,46
27,8474150,Mikael Backlund,C,CGY,35,74,14,32,46
27,8476419,Jean-Gabriel Pageau,C,NYI,32,81,14,32,46
27,8481542,Moritz Seider,D,DET,23,77,5,41,46
27,8482110,Dawson Mercer,C,NJD,23,72,24,21,45
27,8477426,Nicholas Paul,L,TBL,29,81,24,21,45
27,8477998,Warren Foegele,L,LAK,28,80,24,21,45
27,8478474,Lawson Crouse,L,UTA,27,73,23,22,45
27,8477479,Tyler Bertuzzi,L,CHI,29,63,21,24,45
27,8477498,Darnell Nurse,D,EDM,29,75,17,28,45
27,8480459,Pius Suter,C,VAN,28,71,25,19,44
27,8481554,Kaapo Kakko,R,NYR,23,72,19,25,44
27,8476461,Sean Couturier,C,PHI,32,73,18,26,44
27,8483431,Logan Cooley,C,UTA,20,75,17,27,44
27,8482745,Mason McTavish,C,ANA,21,73,17,27,44
27,8481618,Alex Newhook,C,MTL,23,73,13,31,44
27,8470613,Brent Burns,D,CAR,39,73,9,35,44
27,8476854,Hampus Lindholm,D,BOS,30,74,7,37,44
27,8479525,Ross Colton,C,COL,28,81,26,17,43
27,8475714,Calle Jarnkrok,C,TOR,33,74,25,18,43
27,8480220,Noah Cates,L,PHI,25,73,19,24,43
27,8473986,Alex Killorn,L,ANA,35,71,18,25,43
27,8478413,Jordan Greenway,L,BUF,27,67,18,25,43
27,8484153,Leo Carlsson,C,ANA,20,72,17,26,43
27,8477476,Artturi Lehkonen,L,COL,29,80,14,29,43
27,8476906,Shayne Gostisbehere,D,CAR,31,72,10,33,43
27,8475314,Anders Lee,L,NYI,34,78,21,21,42
27,8480015,Owen Tippett,R,PHI,25,72,18,24,42
27,8482133,Thomas Bordeleau,C,SJS,22,66,13,29,42
27,8474563,Drew Doughty,D,LAK,35,78,12,30,42
27,8478500,Ivan Provorov,D,CBJ,27,81,4,38,42
27,8479339,Patrik Laine,L,CBJ,26,64,21,20,41
27,8478438,Tommy Novak,C,NSH,27,71,19,22,41
27,8477964,Ivan Barbashev,C,VGK,29,76,17,24,41
27,8475753,Justin Faulk,D,STL,32,72,14,27,41
27,8478055,Gustav Forsling,D,FLA,28,77,13,28,41
27,8478891,Mason Appleton,C,WPG,28,61,16,24,40
27,8482149,Cole Perfetti,C,WPG,22,70,15,25,40
27,8484166,Adam Fantilli,C,CBJ,20,67,14,26,40
27,8478396,Noah Hanifin,D,VGK,27,64,14,26,40
27,8475218,Mattias Ekholm,D,EDM,34,72,14,26,40
27,8480145,Neal Pionk,D,WPG,29,75,11,29,40
27,8476869,Brady Skjei,D,NSH,30,75,11,29,40
27,8481577,Philip Tomasino,C,NSH,23,67,10,30,40
27,8482712,Oskar Olausson,R,COL,22,79,6,34,40
27,8480028,Morgan Frost,C,PHI,25,75,21,18,39
27,8480078,Filip Chytil,C,NYR,25,66,18,21,39
27,8476474,Stefan Noesen,R,NJD,31,67,18,21,39
27,8482175,JJ Peterka,R,BUF,22,72,17,22,39
27,8480009,Eeli Tolvanen,R,SEA,25,74,17,22,39
27,8481093,Rafael Harvey-Pinard,L,MTL,25,63,16,23,39
27,8481524,Bowen Byram,D,BUF,23,62,15,24,39
27,8475764,Cam Fowler,D,ANA,33,72,9,30,39
27,8478038,Devon Toews,D,COL,30,67,3,36,39
27,8479992,Michael Rasmussen,C,DET,25,77,19,19,38
27,8475760,Nick Bjugstad,C,UTA,32,67,17,21,38
27,8476917,Adam Pelech,D,NYI,30,77,8,30,38
27,8481604,Pavel Dorofeyev,L,VGK,24,70,20,17,37
27,8480802,Ryan McLeod,C,BUF,25,63,13,24,37
27,8482117,Lukas Reichel,L,CHI,22,61,13,24,37
27,8482105,Jake Sanderson,D,OTT,22,76,10,27,37
27,8476923,Damon Severson,D,CBJ,30,79,8,29,37
27,8477506,Ryan Pulock,D,NYI,30,80,5,32,37
27,8479365,Trent Frederic,C,BOS,26,76,20,16,36
27,8476921,Jordan Martinook,L,CAR,32,62,18,18,36
27,8482705,Cole Sillinger,C,CBJ,21,65,17,19,36
27,8480813,Joe Veleno,C,DET,24,74,15,21,36
27,8470621,Corey Perry,R,EDM,39,75,21,14,35
27,8478472,Mathieu Joseph,R,STL,27,73,13,22,35
27,8476458,Ryan Strome,C,ANA,31,69,13,22,35
27,8477839,Conor Sheary,L,TBL,32,81,9,26,35
27,8477986,Brandon Montour,D,SEA,30,72,7,28,35
27,8476892,Colton Parayko,D,STL,31,71,7,28,35
27,8471698,T.J. Oshie,R,WSH,38,64,18,16,34
27,8481582,Nicholas Robertson,L,TOR,23,69,16,18,34
27,8478042,Viktor Arvidsson,L,EDM,31,68,13,21,34
27,8474586,Jordan Eberle,R,SEA,34,73,13,21,34
27,8479353,Brett Howden,C,VGK,26,71,13,21,34
27,8473563,Nicklas Backstrom,C,WSH,37,60,11,23,34
27,8477505,Alexander Wennberg,C,SJS,30,58,9,25,34
27,8483505,Matthew Poitras,C,BOS,20,75,9,25,34
27,8481656,Aliaksei Protas,C,WSH,23,69,8,26,34
27,8479351,Sam Steel,C,DAL,26,79,8,26,34
27,8477948,Travis Sanheim,D,PHI,28,70,8,26,34
27,8481606,Jordan Spence,D,LAK,23,67,8,26,34
27,8476902,Esa Lindell,D,DAL,30,76,4,30,34
27,8478507,John Marino,D,UTA,27,70,4,30,34
27,8480849,Barrett Hayton,C,UTA,24,68,19,14,33
27,8480835,Jack Drury,C,CAR,24,59,16,17,33
27,8474149,Evgenii Dadonov,R,DAL,35,82,16,17,33
27,8478109,Victor Olofsson,L,VGK,29,72,16,17,33
27,8476872,Scott Laughton,C,PHI,30,68,15,18,33
27,8478463,Anthony Beauvillier,L,PIT,27,64,15,18,33
27,8479591,Michael Eyssimont,C,TBL,28,81,15,18,33
27,8475793,Ryan Johansen,C,PHI,32,71,11,22,33
27,8476292,Ondrej Palat,L,NJD,33,72,11,22,33
27,8481581,Thomas Harley,D,DAL,23,78,9,24,33
27,8474053,Logan Couture,C,SJS,35,62,8,25,33
27,8481014,Alexander Romanov,D,NYI,24,80,8,25,33
27,8482122,Brock Faber,D,MIN,22,77,5,28,33
27,8482089,Jake Neighbours,L,STL,22,61,21,11,32
27,8475799,Nino Niederreiter,R,WPG,32,70,19,13,32
27,8482475,Yegor Chinakhov,R,CBJ,23,66,18,14,32
27,8480855,Jack McBain,C,UTA,24,74,18,14,32
27,8476960,Andreas Athanasiou,C,CHI,30,57,16,16,32
27,8477987,Ryan Donato,C,CHI,28,67,14,18,32
27,8475287,Erik Haula,L,NJD,33,69,13,19,32
27,8482660,Kent Johnson,C,CBJ,22,66,12,20,32
27,8477015,Connor Brown,R,EDM,30,67,11,21,32
27,8483445,Cutter Gauthier,L,ANA,20,65,10,22,32
27,8482671,Owen Power,D,BUF,22,67,6,26,32
27,8478046,Danton Heinen,L,VAN,29,73,17,14,31
27,8480448,Parker Kelly,L,COL,25,76,16,15,31
27,8478466,Daniel Sprong,R,VAN,27,71,15,16,31
27,8475768,Jaden Schwartz,C,SEA,32,73,13,18,31
27,8480434,Sean Durzi,D,UTA,26,65,13,18,31
27,8480185,Eetu Luostarinen,C,FLA,26,71,12,19,31
27,8481535,Nils Hoglander,L,VAN,24,67,12,19,31
27,8480829,Jesperi Kotkaniemi,C,CAR,24,69,12,19,31
27,8482146,Luke Evangelista,R,NSH,22,58,12,19,31
27,8478542,Evan Rodrigues,C,FLA,31,73,11,20,31
27,8476885,Jacob Trouba,D,NYR,30,72,7,24,31
27,8475171,Oliver Ekman-Larsson,D,TOR,33,72,4,27,31
27,8476278,Colin Blackwell,C,DAL,31,79,17,13,30
27,8481580,Connor McMichael,C,WSH,23,60,16,14,30
27,8481553,Bobby Brink,R,PHI,23,70,16,14,30
27,8482079,Marco Rossi,C,MIN,23,59,15,15,30
27,8475848,Brendan Gallagher,R,MTL,32,65,13,17,30
27,8475149,Marcus Johansson,L,MIN,34,59,12,18,30
27,8484203,Bradly Nadeau,L,CAR,19,62,8,22,30
27,8480817,K'Andre Miller,D,NYR,24,71,6,24,30
27,8474716,Jared Spurgeon,D,MIN,35,76,5,25,30
27,8483490,Pavel Mintyukov,D,ANA,21,76,5,25,30
27,8476958,Jaccob Slavin,D,CAR,30,71,4,26,30
27,8477969,Marcus Pettersson,D,PIT,28,77,3,27,30
27,8476438,Brandon Saad,L,STL,32,74,17,12,29
27,8480893,Kirill Marchenko,R,CBJ,24,66,17,12,29
27,8481186,Logan O'Connor,R,COL,28,77,16,13,29
27,8483524,Shane Wright,C,SEA,20,61,13,16,29
27,8476480,Vladislav Namestnikov,C,WPG,32,63,12,17,29
27,8477952,Robby Fabbri,C,ANA,28,66,10,19,29
27,8477932,Aaron Ekblad,D,FLA,28,74,8,21,29
27,8480871,Adam Boqvist,D,FLA,24,67,8,21,29
27,8482245,Artem Zub,D,OTT,29,72,8,21,29
27,8477495,Seth Jones,D,CHI,30,67,6,23,29
27,8480336,Sean Walker,D,CAR,30,75,6,23,29
27,8474715,Cameron Atkinson,R,TBL,35,81,17,11,28
27,8476392,Adam Lowry,C,WPG,31,70,17,11,28
27,8480113,Alex Iafallo,L,WPG,31,61,14,14,28
27,8476918,Jimmy Vesey,L,NYR,31,70,13,15,28
27,8477953,Kasperi Kapanen,R,STL,28,69,12,16,28
27,8475722,Jason Zucker,L,BUF,32,66,12,16,28
27,8475193,Tomas Tatar,L,NJD,34,68,11,17,28
27,8480068,Ryan Poehling,C,PHI,25,62,9,19,28
27,8476927,Teddy Blueger,C,VAN,30,67,7,21,28
27,8474673,TJ Brodie,D,CHI,34,67,5,23,28
27,8475181,Nick Leddy,D,STL,33,66,4,24,28
27,8482702,Logan Stankoven,C,DAL,21,80,19,8,27
27,8482125,Alexander Holtz,R,VGK,22,62,17,10,27
27,8477989,Christian Dvorak,C,MTL,28,67,17,10,27
27,8479390,Taylor Raddysh,R,WSH,26,66,15,12,27
27,8473422,Nick Foligno,L,CHI,37,60,13,14,27
27,8478911,Matt Roy,D,WSH,29,66,11,16,27
27,8481522,Peyton Krebs,C,BUF,23,60,11,16,27
27,8481527,Kaedan Korczak,D,VGK,23,47,9,18,27
27,8480878,Nils Lundkvist,D,DAL,24,75,8,19,27
27,8475855,Jesper Fast,R,CAR,33,59,8,19,27
27,8481703,Valtteri Puustinen,R,PIT,25,60,5,22,27
27,8473507,Jeff Petry,D,DET,37,72,5,22,27
27,8476931,Jake McCabe,D,TOR,31,70,4,23,27
27,8480043,Timothy Liljegren,D,TOR,25,67,3,24,27
27,8478882,Vladislav Gavrikov,D,LAK,29,70,2,25,27
27,8482055,Drew O'Connor,L,PIT,26,59,16,10,26
27,8478057,Dakota Joshua,C,VAN,28,67,15,11,26
27,8479996,Cody Glass,C,NSH,25,58,15,11,26
27,8476925,Colton Sissons,C,NSH,31,70,11,15,26
27,8481028,Martin Pospisil,C,CGY,25,55,11,15,26
27,8478115,Pierre Engvall,L,NYI,28,79,10,16,26
27,8477947,Sonny Milano,L,WSH,28,64,10,16,26
27,8478133,Jake Evans,C,MTL,28,64,9,17,26
27,8476981,Josh Anderson,R,MTL,30,62,9,17,26
27,8481523,Kirby Dach,C,MTL,23,63,8,18,26
27,8477499,Rasmus Ristolainen,D,PHI,30,62,8,18,26
27,8476463,Jonas Brodin,D,MIN,31,77,7,19,26
27,8479976,Juuso Valimaki,D,UTA,26,63,7,19,26
27,8480073,Erik Brannstrom,D,COL,25,64,4,22,26
27,8480035,Henri Jokiharju,D,BUF,25,58,2,24,26
27,8481477,Nico Sturm,C,SJS,29,53,16,9,25
27,8473533,Jordan Staal,C,CAR,36,59,14,11,25
27,8475791,Taylor Hall,L,CHI,33,54,8,17,25
27,8478178,Darren Raddysh,D,TBL,28,73,7,18,25
27,8479639,Dylan Coghlan,D,WPG,26,61,6,19,25
27,8476891,Matthew Grzelcyk,D,PIT,30,75,4,21,25
27,8476422,Mike Reilly,D,NYI,31,69,4,21,25
27,8476429,Scott Mayfield,D,NYI,32,71,3,22,25
27,8475790,Erik Gudbranson,D,CBJ,32,75,1,24,25
27,8477392,Hudson Fasching,R,NYI,29,59,14,10,24
27,8479393,Noah Gregor,L,OTT,26,69,13,11,24
27,8479941,Justin Danforth,R,CBJ,31,55,13,11,24
27,8481601,Simon Holmstrom,R,NYI,23,69,13,11,24
27,8479315,Joey Anderson,R,CHI,26,48,12,12,24
27,8480074,Alexandre Texier,C,STL,25,49,12,12,24
27,8475763,Kevin Hayes,R,PIT,32,62,10,14,24
27,8477444,Andre Burakovsky,L,SEA,29,70,9,15,24
27,8475220,Marcus Foligno,L,MIN,33,60,9,15,24
27,8484149,Gavin Brindley,C,CBJ,20,53,9,15,24
27,8477406,Mattias Janmark,C,EDM,32,67,7,17,24
27,8476457,Adam Larsson,D,SEA,32,72,3,21,24
27,8479980,Nicolas Hague,D,VGK,26,54,3,21,24
27,8482655,Janis Moser,D,TBL,24,71,1,23,24
27,8482259,Bobby McMann,C,TOR,28,65,16,7,23
27,8481624,Ilya Mikheyev,R,CHI,30,50,15,8,23
27,8481032,Paul Cotter,C,NJD,25,64,14,9,23
27,8482679,Matt Coronato,R,CGY,22,70,13,10,23
27,8477425,Miles Wood,L,COL,29,77,12,11,23
27,8480789,Oliver Wahlstrom,R,NYI,24,70,11,12,23
27,8478013,Jake Walman,D,SJS,28,72,9,14,23
27,8482749,Joshua Roy,R,MTL,21,66,8,15,23
27,8476374,Sean Kuraly,C,CBJ,31,57,8,15,23
27,8479982,Conor Timmins,D,TOR,26,67,7,16,23
27,8483499,Liam Ohgren,L,MIN,20,57,7,16,23
27,8478970,Jalen Chatfield,D,CAR,28,73,6,17,23
27,8481546,Cam York,D,PHI,23,69,6,17,23
27,8482111,Justin Barron,D,MTL,23,69,6,17,23
27,8482624,Daniil Miromanov,D,CGY,27,65,5,18,23
27,8476331,Dylan DeMelo,D,WPG,31,71,5,18,23
27,8478136,Jake Middleton,D,MIN,28,74,5,18,23
27,8477450,Jason Dickinson,C,CHI,29,58,15,7,22
27,8482092,Ridly Greig,C,OTT,22,72,12,10,22
27,8479661,Tanner Jeannot,L,LAK,27,79,11,11,22
27,8480003,Jesper Boqvist,C,FLA,26,68,11,11,22
27,8481517,Brett Leason,R,ANA,25,50,11,11,22
27,8479983,Mario Ferraro,D,SJS,26,67,11,11,22
27,8478458,John (Jack) Roslovic,C,CAR,27,71,10,12,22
27,8477435,Ryan Graves,D,PIT,29,74,10,12,22
27,8475200,Dmitry Orlov,D,CAR,33,76,8,14,22
27,8483466,Kevin Korchinski,D,CHI,20,62,5,17,22
27,8479336,Carl Grundstrom,R,SJS,27,52,12,9,21
27,8476873,Mark Jankowski,C,NSH,30,53,12,9,21
27,8477446,Michael McCarron,R,NSH,29,55,11,10,21
27,8479316,Luke Kunin,C,SJS,27,59,11,10,21
27,8478020,Michael Amadio,R,OTT,28,74,8,13,21
27,8477919,Frederick Gaudreau,C,MIN,31,65,8,13,21
27,8482142,Jamie Drysdale,D,PHI,22,65,6,15,21
27,8482062,Cole Smith,L,NSH,29,59,6,15,21
27,8479402,Jake Bean,D,CGY,26,62,5,16,21
27,8481441,Joe Snively,C,DET,28,65,5,16,21
27,8480873,Rasmus Sandin,D,WSH,24,66,4,17,21
27,8479371,Dante Fabbro,D,NSH,26,64,3,18,21
27,8474151,Ryan McDonagh,D,TBL,35,76,2,19,21
27,8480049,Dylan Samberg,D,WPG,25,61,2,19,21
27,8479998,Mikey Anderson,D,LAK,25,65,2,19,21
27,8479324,Ryan Lindgren,D,NYR,26,66,2,19,21
27,8479293,Brandon Tanev,L,SEA,33,70,12,8,20
27,8483491,Ivan Miroshnichenko,L,WSH,20,51,10,10,20
27,8481013,Jonatan Berggren,R,DET,24,66,9,11,20
27,8476469,Joel Armia,R,MTL,31,72,9,11,20
27,8483457,Lane Hutson,D,MTL,20,69,8,12,20
27,8480205,Emil Bemstrom,C,PIT,25,60,8,12,20
27,8481481,Blake Lizotte,C,PIT,27,61,8,12,20
27,8482451,Mikael Pyyhtia,L,CBJ,23,46,8,12,20
27,8478508,Yakov Trenin,C,MIN,27,53,8,12,20
27,8477488,Brett Pesce,D,NJD,30,62,7,13,20
27,8480807,Mattias Samuelsson,D,BUF,24,61,5,15,20
27,8476979,Erik Gustafsson,D,DET,32,71,1,19,20
27,8475324,Nick Jensen,D,OTT,34,65,1,19,20
27,8480281,Alexey Toropchenko,R,STL,25,63,13,6,19
27,8482155,Alex Laferriere,R,LAK,23,58,12,7,19
27,8480289,Morgan Barron,C,WPG,26,52,8,11,19
27,8476889,Radek Faksa,C,STL,30,62,8,11,19
27,8482077,Dylan Holloway,L,EDM,23,53,8,11,19
27,8477979,Nicolas Aube-Kubel,R,BUF,28,61,8,11,19
27,8475842,Sam Carrick,C,NYR,32,63,8,11,19
27,8480762,Eric Robinson,L,CAR,29,53,7,12,19
27,8480806,Isac Lundestrom,C,ANA,25,58,7,12,19
27,8477380,Jonny Brodzinski,C,NYR,31,50,7,12,19
27,8482101,Danil Gushchin,L,SJS,22,55,6,13,19
27,8478840,Will Borgen,D,SEA,28,61,5,14,19
27,8476467,Jamie Oleksiak,D,SEA,32,67,5,14,19
27,8474574,Tyler Myers,D,VAN,34,66,3,16,19
27,8482073,Braden Schneider,D,NYR,23,65,3,16,19
27,8476525,Colin Miller,D,WPG,32,58,2,17,19
27,8479619,Michael Carcone,L,UTA,28,58,11,7,18
27,8476897,Oskar Sundqvist,C,STL,30,63,11,7,18
27,8479414,Nathan Bastian,R,NJD,27,59,11,7,18
27,8477931,Tomas Nosek,L,FLA,32,62,10,8,18
27,8475279,Ben Chiarot,D,DET,33,67,8,10,18
27,8477903,Garnet Hathaway,R,PHI,33,70,7,11,18
27,8477573,Nathan Walker,L,STL,30,44,7,11,18
27,8477478,William Carrier,L,CAR,30,60,7,11,18
27,8479671,Mathieu Olivier,R,CBJ,27,55,7,11,18
27,8474034,Patrick Maroon,L,CHI,36,46,5,13,18
27,8475188,Brayden McNabb,D,VGK,33,50,5,13,18
27,8476329,Travis Boyd,C,MIN,31,58,4,14,18
27,8477507,Nikita Zadorov,D,BOS,29,68,3,15,18
27,8478851,Alexandre Carrier,D,NSH,28,73,3,15,18
27,8480891,Michael Kesselring,D,UTA,24,55,3,15,18
27,8476879,Cody Ceci,D,EDM,31,64,1,17,18
27,8481059,Scott Perunovich,D,STL,26,62,1,17,18
27,8476878,Zemgus Girgensons,C,TBL,30,82,9,8,17
27,8479718,Alex Barré-Boulet,C,MTL,27,53,9,8,17
27,8482807,Ethan Del Mastro,D,CHI,21,48,9,8,17
27,8478432,Christian Fischer,R,DET,27,69,8,9,17
27,8473453,Trevor Lewis,C,LAK,37,75,8,9,17
27,8482809,Jackson Blake,R,CAR,21,55,8,9,17
27,8482166,Shakir Mukhamadullin,D,SJS,22,54,8,9,17
27,8476856,Mathew Dumba,D,DAL,30,69,8,9,17
27,8480025,MacKenzie Entwistle,R,FLA,25,62,8,9,17
27,8479066,Ryan Lomberg,L,CGY,30,66,7,10,17
27,8478043,Sam Lafferty,C,BUF,29,53,5,12,17
27,8478443,Brandon Carlo,D,BOS,28,58,4,13,17
27,8474166,Alec Martinez,D,CHI,37,46,4,13,17
27,8483493,Frank Nazar,C,CHI,20,57,3,14,17
27,8478416,Erik Cernak,D,TBL,27,74,2,15,17
27,8479344,Jesse Puljujarvi,R,PIT,26,52,10,6,16
27,8477018,Ben Hutton,D,VGK,31,50,9,7,16
27,8479368,Max Jones,L,BOS,26,61,8,8,16
27,8474189,Lars Eller,C,PIT,35,67,7,9,16
27,8480748,Kiefer Sherwood,L,VAN,29,53,7,9,16
27,8482803,Olen Zellweger,D,ANA,21,67,7,9,16
27,8477962,Brendan Lemieux,L,CAR,28,39,7,9,16
27,8478569,Noel Acciari,C,PIT,33,61,6,10,16
27,8475343,Nic Dowd,C,WSH,34,58,5,11,16
27,8476312,Josh Manson,D,COL,33,64,5,11,16
27,8483468,Jiri Kulich,C,BUF,20,53,4,12,16
27,8479543,Michael Pezzetta,L,MTL,26,57,4,12,16
27,8478434,Keegan Kolesar,R,VGK,27,67,3,13,16
27,8470600,Ryan Suter,D,STL,39,58,3,13,16
27,8477845,Trevor van Riemsdyk,D,WSH,33,65,2,14,16
27,8480172,Jan Rutta,D,SJS,34,66,0,16,16
27,8480021,Jack Studnicka,C,LAK,25,59,9,6,15
27,8480995,Pontus Holmberg,R,TOR,25,58,8,7,15
27,8482157,Will Cuylle,L,NYR,22,65,8,7,15
27,8475231,Casey Cizikas,C,NYI,33,69,7,8,15
27,8483482,Tristan Luneau,D,ANA,20,55,6,9,15
27,8480144,David Kampf,C,TOR,29,67,6,9,15
27,8475225,Craig Smith,C,CHI,35,46,6,9,15
27,8478421,A.J. Greer,L,FLA,28,53,6,9,15
27,8480980,Connor Dewar,C,TOR,25,67,6,9,15
27,8477508,Curtis Lazar,C,NJD,29,59,6,9,15
27,8481599,Victor Soderstrom,D,UTA,23,46,6,9,15
27,8480011,Klim Kostin,C,SJS,25,47,5,10,15
27,8477887,Patrick Brown,C,BOS,32,46,5,10,15
27,8482744,James Malatesta,L,CBJ,21,38,4,11,15
27,8477365,Connor Clifton,D,BUF,29,48,4,11,15
27,8474567,Zach Bogosian,D,MIN,34,61,4,11,15
27,8475462,Radko Gudas,D,ANA,34,66,3,12,15
27,8482176,Wyatt Kaiser,D,CHI,22,52,3,12,15
27,8476994,Vinnie Hinostroza,C,NSH,30,50,3,12,15
27,8482192,Isaak Phillips,D,CHI,23,49,3,12,15
27,8479026,Philippe Myers,D,TOR,27,46,2,13,15
27,8476988,Matt Benning,D,SJS,30,61,2,13,15
27,8475690,Chris Tanev,D,TOR,35,52,2,13,15
27,8480222,Sebastian Aho,D,PIT,28,72,2,13,15
27,8478452,Caleb Jones,D,LAK,27,51,2,13,15
27,8482074,Connor Zary,C,CGY,23,63,8,6,14
27,8480192,Johnathan Kovacevic,D,NJD,27,57,7,7,14
27,8480252,Cole Guttman,C,CHI,25,44,5,9,14
27,8481617,Vasily Podkolzin,R,VAN,23,56,5,9,14
27,8477369,Carson Soucy,D,VAN,30,71,4,10,14
27,8479369,Andrew Peeke,D,BOS,26,62,4,10,14
27,8484254,Akito Hirose,D,VAN,25,38,3,11,14
27,8479442,Troy Stecher,D,EDM,30,56,3,11,14
27,8479398,Samuel Girard,D,COL,26,66,2,12,14
27,8476874,Olli Maatta,D,DET,30,59,2,12,14
27,8481708,Zac Jones,D,NYR,24,51,2,12,14
27,8480796,Martin Fehervary,D,WSH,25,53,2,12,14
27,8471709,Marc-Edouard Vlasic,D,SJS,37,66,1,13,14
27,8475208,Brian Dumoulin,D,ANA,33,64,1,13,14
27,8480058,Pierre-Olivier Joseph,D,STL,25,58,0,14,14
27,8482737,Zack Bolduc,C,STL,21,61,8,5,13
27,8478831,Kevin Stenlund,C,UTA,28,56,8,5,13
27,8479520,Brandon Duhaime,R,WSH,27,57,7,6,13
27,8482659,Josh Doan,R,UTA,22,55,5,8,13
27,8481019,David Gustafsson,C,WPG,24,44,4,9,13
27,8477220,Nate Schmidt,D,FLA,33,62,4,9,13
27,8476624,Barclay Goodrow,C,SJS,31,52,4,9,13
27,8483495,Simon Nemec,D,NJD,20,54,4,9,13
27,8478399,Jonas Siegenthaler,D,NJD,27,58,3,10,13
27,8479981,Jonah Gadjovich,L,FLA,26,46,3,10,13
27,8482087,Kaiden Guhle,D,MTL,22,63,2,11,13
27,8471677,Jack Johnson,D,CBJ,37,70,2,11,13
27,8475179,Dmitry Kulikov,D,FLA,34,62,1,12,13
27,8476967,Brett Kulak,D,EDM,30,65,0,13,13
27,8477353,Tyler Motte,C,DET,29,71,7,5,12
27,8479328,Julien Gauthier,R,NYI,27,60,6,6,12
27,8478211,Dryden Hunt,L,CGY,29,66,6,6,12
27,8474612,Travis Hamonic,D,OTT,34,47,4,8,12
27,8482859,Zack Ostapchuk,C,OTT,21,58,4,8,12
27,8475718,Justin Holl,D,DET,32,63,3,9,12
27,8482634,Alex Steeves,C,TOR,25,50,3,9,12
27,8479972,Mason Shaw,C,WPG,26,39,3,9,12
27,8482067,Connor Mackey,D,NYR,28,59,2,10,12
27,8478859,Niko Mikkola,D,FLA,28,60,2,10,12
27,8480246,Nick Perbix,D,TBL,26,73,1,11,12
27,8481521,Ronnie Attard,D,PHI,25,55,0,12,12
27,8482762,Simon Edvinsson,D,DET,21,56,9,2,11
27,8481592,Jakob Pelletier,L,CGY,23,40,8,3,11
27,8479439,Jacob MacDonald,D,COL,31,46,6,5,11
27,8481122,Simon Benoit,D,TOR,26,40,6,5,11
27,8483565,Nick Blankenburg,D,NSH,26,52,4,7,11
27,8477070,Liam O'Brien,C,UTA,30,49,4,7,11
27,8479968,Vinni Lettieri,C,BOS,29,54,4,7,11
27,8481704,Juuso Parssinen,C,NSH,23,56,3,8,11
27,8482730,Brandt Clarke,D,LAK,21,46,3,8,11
27,8474568,Luke Schenn,D,NSH,35,49,3,8,11
27,8482964,Arber Xhekaj,D,MTL,23,51,3,8,11
27,8479536,Axel Jonsson-Fjallby,L,WPG,26,29,3,8,11
27,8479378,Logan Stanley,D,WPG,26,49,3,8,11
27,8481167,Brayden Pachal,D,CGY,25,45,2,9,11
27,8479249,Andrew Poturalski,C,SJS,30,37,1,10,11
27,8480157,Calle Rosen,D,COL,30,38,1,10,11
27,8482095,Tyler Kleven,D,OTT,22,48,1,10,11
27,8479359,Beck Malenstyn,L,BUF,26,46,1,10,11
27,8478468,Jeremy Lauzon,D,NSH,27,54,1,10,11
27,8480950,Ilya Lyubushkin,D,DAL,30,57,0,11,11
27,8481641,Joel Kiviranta,L,COL,28,71,7,3,10
27,8476822,Luke Glendening,C,TBL,35,78,6,4,10
27,8471817,Ryan Reaves,R,TOR,37,57,6,4,10
27,8482652,Walker Duehr,R,CGY,27,38,6,4,10
27,8481716,Dmitri Voronkov,L,CBJ,24,37,5,5,10
27,8480441,Trey Fix-Wolansky,R,CBJ,25,31,5,5,10
27,8482511,Mason Lohrei,D,BOS,23,30,5,5,10
27,8481543,Nikita Alexandrov,C,STL,24,28,4,6,10
27,8480727,Zach Whitecloud,D,VGK,28,49,3,7,10
27,8476442,Matt Nieto,L,PIT,32,39,3,7,10
27,8481056,Spencer Stastney,D,NSH,24,35,3,7,10
27,8477473,Justin Bailey,R,SJS,29,23,3,7,10
27,8478451,Ethan Bear,D,WSH,27,43,2,8,10
27,8481567,Henry Thrun,D,SJS,23,50,2,8,10
27,8480001,Urho Vaakanainen,D,ANA,25,59,2,8,10
27,8480196,Jacob Bryson,D,BUF,27,50,2,8,10
27,8477938,Haydn Fleury,D,WPG,28,44,2,8,10
27,8480845,Rasmus Kupari,C,WPG,24,38,2,8,10
27,8481178,Egor Zamula,D,PHI,24,50,1,9,10
27,8475455,Brenden Dillon,D,NJD,34,57,1,9,10
27,8475177,Calvin de Haan,D,COL,33,53,1,9,10
27,8480070,Ian Mitchell,D,BOS,25,45,1,9,10
27,8475233,David Savard,D,MTL,34,57,0,10,10
27,8479348,Kale Clague,D,BUF,26,42,0,10,10
27,8474013,Ian Cole,D,UTA,35,63,0,10,10
27,8478454,Noah Juulsen,D,VAN,27,36,0,10,10
27,8481556,John Beecher,C,BOS,23,39,8,1,9
27,8480355,Mark Kastelic,C,BOS,25,63,7,2,9
27,8482747,Brennan Othmann,L,NYR,21,36,6,3,9
27,8478585,Derek Ryan,C,EDM,38,62,5,4,9
27,8481537,Nikita Okhotiuk,D,CGY,24,55,5,4,9
27,8482070,Mitchell Chaffee,R,TBL,26,56,5,4,9
27,8482784,Zach Dean,C,STL,21,44,5,4,9
27,8475235,Nicolas Deslauriers,L,PHI,33,45,5,4,9
27,8481751,Lukas Rousek,R,BUF,25,36,4,5,9
27,8481532,Alex Turcotte,C,LAK,23,46,4,5,9
27,8479379,Givani Smith,R,SJS,26,39,4,5,9
27,8479994,Jaret Anderson-Dolan,C,WPG,25,47,4,5,9
27,8482177,Marat Khusnutdinov,C,MIN,22,31,3,6,9
27,8475750,Jon Merrill,D,MIN,32,60,3,6,9
27,8478450,Parker Wotherspoon,D,BOS,27,34,2,7,9
27,8483460,David Jiricek,D,CBJ,21,53,1,8,9
27,8480860,Kevin Bahl,D,CGY,24,59,1,8,9
27,8479372,Joshua Mahura,D,SEA,26,52,0,9,9
27,8476441,Joel Edmundson,D,LAK,31,36,0,9,9
27,8482765,Isak Rosen,R,BUF,21,33,7,1,8
27,8481518,Nolan Foote,L,NJD,24,40,6,2,8
27,8476858,Phillip Di Giuseppe,L,VAN,31,38,5,3,8
27,8480844,Grigori Denisenko,L,VGK,24,33,5,3,8
27,8480245,Olle Lycksell,R,PHI,25,28,4,4,8
27,8482148,Hendrix Lapierre,C,WSH,22,53,3,5,8
27,8479370,Tyson Jost,C,CAR,26,53,3,5,8
27,8480834,Ty Emberson,D,SJS,24,29,3,5,8
27,8482496,Nils Aman,C,VAN,24,39,3,5,8
27,8481161,Jake Christiansen,D,CBJ,25,54,3,5,8
27,8479986,Kole Lind,R,DAL,26,43,3,5,8
27,8481550,Adam Beckman,L,NJD,23,39,2,6,8
27,8478017,Mark Friedman,D,VAN,29,36,2,6,8
27,8480887,Jordan Harris,D,MTL,24,52,1,7,8
27,8476372,Nick Seeler,D,PHI,31,51,1,7,8
27,8480879,Jacob Bernard-Docker,D,OTT,24,48,0,8,8
27,8476952,Dominic Toninato,C,WPG,30,35,0,8,8
27,8481679,Maxence Guenette,D,OTT,23,33,7,0,7
27,8476867,Brendan Gaunce,C,MIN,30,35,5,2,7
27,8481754,Nikita Nesterenko,C,ANA,23,32,5,2,7
27,8481237,Kyle MacLean,C,NYI,25,31,5,2,7
27,8479291,Kevin Rooney,C,CGY,31,38,4,3,7
27,8483012,Logan Morrison,C,SEA,22,43,4,3,7
27,8480267,Sammy Walker,C,MIN,25,20,4,3,7
27,8480848,Ty Dellandrea,C,SJS,24,39,3,4,7
27,8475762,Derek Forbort,D,VAN,32,43,3,4,7
27,8477401,John Hayden,C,SEA,29,28,3,4,7
27,8479576,Vincent Desharnais,D,VAN,28,30,3,4,7
27,8483397,Marc McLaughlin,C,BOS,25,23,3,4,7
27,8481598,Philip Broberg,D,EDM,23,44,2,5,7
27,8477482,Zachary Sanford,L,CHI,30,37,2,5,7
27,8480292,Carson Meyer,R,ANA,27,31,2,5,7
27,8483619,Filip Roos,D,OTT,25,28,2,5,7
27,8482250,Callahan Burke,C,VGK,27,26,2,5,7
27,8481568,Alex Vlasic,D,CHI,23,51,1,6,7
27,8476473,Connor Murphy,D,CHI,31,35,1,6,7
27,8482102,Vasily Ponomarev,C,PIT,22,20,0,7,7
27,8478021,William Lagesson,D,DET,28,27,0,7,7
27,8479772,Zack MacEwen,R,OTT,28,52,5,1,6
27,8478424,Jansen Harkins,C,ANA,27,45,4,2,6
27,8477527,Ross Johnston,L,ANA,30,35,4,2,6
27,8484911,Collin Graf,R,SJS,22,37,3,3,6
27,8480990,Declan Chisholm,D,MIN,24,39,3,3,6
27,8476913,Devin Shore,C,MIN,30,38,3,3,6
27,8477384,Joshua Brown,D,EDM,30,43,3,3,6
27,8476934,Brock McGinn,L,ANA,30,51,2,4,6
27,8474090,Brendan Smith,D,DAL,35,49,2,4,6
27,8481701,Santeri Hatakka,D,NJD,23,41,2,4,6
27,8477851,Jordan Oesterle,D,BOS,32,45,2,4,6
27,8481609,Vladislav Kolyachonok,D,UTA,23,26,2,4,6
27,8482666,Scott Morrow,D,CAR,22,52,1,5,6
27,8473446,Erik Johnson,D,PHI,36,43,1,5,6
27,8478146,Matthew Highmore,C,OTT,28,35,1,5,6
27,8482144,Jack Thompson,D,SJS,22,27,1,5,6
27,8475958,Michael Sgarbossa,C,WSH,32,24,1,5,6
27,8477335,Kyle Burroughs,D,LAK,29,43,0,6,6
27,8479944,Zach Aston-Reese,C,VGK,30,50,4,1,5
27,8482145,Mavrik Bourque,C,DAL,22,52,4,1,5
27,8483763,Maksymilian Szuber,D,UTA,22,30,3,2,5
27,8478477,Mitchell Stephens,C,SEA,27,15,3,2,5
27,8477462,Robert Hagg,D,VGK,29,30,3,2,5
27,8480880,Jakub Lauko,C,MIN,24,32,2,3,5
27,8480890,Jan Jenik,C,OTT,24,34,2,3,5
27,8482470,Ilya Solovyov,D,CGY,24,19,2,3,5
27,8480007,Jonas Rondbjerg,R,VGK,25,35,1,4,5
27,8483549,Lucas Condotta,L,MTL,27,35,1,4,5
27,8479638,Justin Brazeau,R,BOS,26,34,1,4,5
27,8475780,Chris Wagner,R,COL,33,14,1,4,5
27,8477034,Jaycob Megna,D,FLA,32,39,0,5,5
27,8479587,Rhett Gardner,C,PHI,28,27,0,5,5
27,8481600,Tobias Bjornfot,D,FLA,23,37,4,0,4
27,8481789,Tye Kartye,L,SEA,23,46,3,1,4
27,8484325,Waltteri Merela,C,TBL,26,21,3,1,4
27,8479320,Maxime Lajoie,D,SEA,27,35,2,2,4
27,8483630,Pavol Regenda,L,ANA,25,25,2,2,4
27,8480870,Bo Groulx,C,NYR,24,25,2,2,4
27,8483395,Arshdeep Bains,L,VAN,23,7,2,2,4
27,8481043,Cole Koepke,L,BOS,26,9,2,2,4
27,8477810,Joel Hanley,D,CGY,33,25,2,2,4
27,8479985,Cale Fleury,D,SEA,26,32,1,3,4
27,8478874,Adam Gaudette,R,OTT,28,36,1,3,4
27,8481541,Samuel Bolduc,D,NYI,24,26,1,3,4
27,8481147,Reese Johnson,C,MIN,26,40,1,3,4
27,8482153,Brendan Brisson,C,VGK,23,24,1,3,4
27,8477971,Andreas Englund,D,LAK,28,29,1,3,4
27,8482861,Vincent Iorio,D,WSH,22,32,0,4,4
27,8481743,Marc Del Gaizo,D,NSH,25,15,0,4,4
27,8477244,Chad Ruhwedel,D,NYR,34,27,0,4,4
27,8480851,Akil Thomas,C,LAK,24,17,0,4,4
27,8483570,Ben Meyers,C,SEA,26,19,3,0,3
27,8482733,Logan Mailloux,D,MTL,31,34,2,1,3
27,8482751,Ryan Winterton,C,SEA,21,36,2,1,3
27,8484258,Sam Malinski,D,COL,26,21,2,1,3
27,8483489,Fraser Minten,C,TOR,31,9,2,1,3
27,8478502,Dennis Gilbert,D,BUF,28,13,2,1,3
27,8478051,Max Willman,C,NJD,29,16,2,1,3
27,8481006,Tyler Tucker,D,STL,24,17,2,1,3
27,8482141,Lukas Cormier,D,VGK,22,28,1,2,3
27,8481605,Jackson LaCombe,D,ANA,23,33,1,2,3
27,8482147,Jean-Luc Foudy,C,COL,22,22,1,2,3
27,8482713,Mackie Samoskevich,R,FLA,22,40,1,2,3
27,8481462,Mason Morelli,L,VGK,28,20,1,2,3
27,8481593,Jayden Struble,D,MTL,23,23,0,3,3
27,8482929,Emil Lilleberg,D,TBL,23,26,2,0,2
27,8482476,Emil Heineman,L,MTL,23,9,2,0,2
27,8481024,Linus Karlsson,C,VAN,25,10,2,0,2
27,8480468,James Hamblin,L,EDM,25,20,2,0,2
27,8482172,Landon Slaggert,L,CHI,22,26,1,1,2
27,8478409,Anthony Richard,C,PHI,28,30,1,1,2
27,8484287,Cole McWard,D,VAN,23,20,1,1,2
27,8482088,Justin Sourdif,R,FLA,22,17,1,1,2
27,8483512,Matthew Savoie,C,EDM,20,17,1,1,2
27,8478446,Glenn Gawdin,C,LAK,27,8,1,1,2
27,8478881,Brett Seney,L,CHI,28,10,1,1,2
27,8477541,Dakota Mermis,D,TOR,30,9,1,1,2
27,8482197,Adam Raska,R,MIN,23,10,1,1,2
27,8478147,Bokondji Imama,L,PIT,28,5,1,1,2
27,8482858,Ryker Evans,D,SEA,23,15,0,2,2
27,8479367,William Lockwood,R,FLA,26,28,0,2,2
27,8481030,Jack St. Ivany,D,PIT,25,14,0,2,2
27,8480823,Alexander Alexeyev,D,WSH,25,13,0,2,2
27,8480874,Adam Ginning,D,PHI,24,14,0,2,2
27,8479522,Hardy Haman Aktell,D,WSH,26,3,0,2,2
27,8481699,Aku Raty,R,UTA,23,17,1,0,1
27,8479991,Jake Leschyshyn,C,NYR,25,26,1,0,1
27,8482201,Gage Goncalves,C,TBL,23,14,1,0,1
27,8483920,Pierrick Dube,R,WSH,23,9,1,0,1
27,8481806,Louis Crevier,D,CHI,23,15,1,0,1
27,8482516,Matthew Kessel,D,STL,24,14,1,0,1
27,8481065,Angus Crookshank,L,OTT,25,14,1,0,1
27,8481719,Maxwell Crozier,D,TBL,24,12,1,0,1
27,8477993,Justin Kirkland,C,CGY,28,3,1,0,1
27,8482787,Nikita Chibrikov,R,WPG,31,5,1,0,1
27,8475755,Alexander Petrovic,D,DAL,32,9,1,0,1
27,8479362,Riley Tufte,L,BOS,26,25,0,1,1
27,8474062,Riley Nash,C,NYR,35,21,0,1,1
27,8480084,Nick DeSimone,D,NJD,30,18,0,1,1
27,8477320,Anton Blidh,L,NYR,29,15,0,1,1
27,8477467,Gustav Olofsson,D,SEA,30,15,0,1,1
27,8475795,Dylan McIlrath,D,WSH,32,19,0,1,1
27,8483471,Brad Lambert,C,WPG,31,7,0,1,1
27,8477073,Kurtis MacDermid,L,NJD,30,30,0,1,1
27,8479421,Jacob Moverare,D,LAK,26,7,0,1,1
27,8477149,Scott Sabourin,R,SJS,32,23,0,1,1
27,8483432,Luca Del Bel Belluz,C,CBJ,31,7,0,1,1
27,8483398,Declan Carlile,D,TBL,31,7,0,1,1
27,8482460,Matt Rempe,C,NYR,22,14,0,1,1
27,8481206,John Ludvig,D,PIT,24,8,0,1,1
27,8482061,Brandon Biro,L,SEA,26,9,0,1,1
27,8476323,Max McCormick,L,SEA,32,8,0,1,1
27,8481564,Ryan Johnson,D,BUF,23,17,0,1,1
27,8482126,Emil Andrae,D,PHI,31,3,0,1,1
27,8479419,Brett Murray,L,BUF,26,17,0,0,0
27,8481585,Egor Afanasyev,L,SJS,23,17,0,0,0
27,8482165,Yan Kuznetsov,D,CGY,22,11,0,0,0
27,8478011,Louie Belpedio,D,PHI,28,10,0,0,0
27,8482118,Sam Colangelo,R,ANA,23,20,0,0,0
27,8481578,Graeme Clarke,R,MIN,23,8,0,0,0
27,8475413,Justin Dowling,C,NJD,34,8,0,0,0
27,8483597,Milos Kelemen,L,UTA,25,8,0,0,0
27,8481726,Adam Edstrom,C,NYR,24,5,0,0,0
27,8480032,Shane Bowers,C,NJD,25,13,0,0,0
27,8484304,Uvis Balinskis,D,FLA,28,14,0,0,0
27,8483401,Marc Johnstone,R,PIT,28,2,0,0,0
27,8483567,Georgii Merkulov,C,BOS,24,8,0,0,0
27,8482094,Daemon Hunt,D,MIN,22,18,0,0,0
27,8482162,Roby Jarventie,L,EDM,22,14,0,0,0
27,8481422,Jake Lucchini,C,NSH,29,20,0,0,0
27,8478854,Ryan Shea,D,PIT,27,10,0,0,0
27,8480075,Cameron Crotty,D,MIN,25,10,0,0,0
27,8484326,Patrik Koch,D,UTA,28,2,0,0,0
27,8483609,Adam Klapka,R,CGY,24,2,0,0,0
27,8483531,Brian Halonen,L,NJD,25,6,0,0,0
27,8480306,Grant Hutton,D,NYI,29,9,0,0,0
27,8484255,Jason Polin,R,COL,25,6,0,0,0
27,8479330,Brandon Gignac,C,MTL,27,10,0,0,0
27,8483407,Brandon Scanlin,D,NYR,25,6,0,0,0
27,8483546,Marshall Rifai,D,TOR,26,1,0,0,0
27,8481655,Cole Schwindt,R,CGY,23,2,0,0,0
27,8484259,Ondrej Pavel,C,COL,31,0,0,0,0
27,8480274,Philip Kemp,D,EDM,25,2,0,0,0
27,8484321,Nikolas Matinpalo,D,OTT,26,0,0,0,0
27,8481534,Raphael Lavoie,C,EDM,24,1,0,0,0
27,8470794,Joe Pavelski,C,,40,0,0,0,0
27,8479321,Lucas Johansen,D,,27,0,0,0,0
27,8477950,Tony DeAngelo,D,,29,0,0,0,0
27,8471218,Blake Wheeler,R,,38,0,0,0,0
27,8475197,Tyson Barrie,D,,33,0,0,0,0
27,8474157,Max Pacioretty,L,,36,0,0,0,0
27,8475744,Evgeny Kuznetsov,C,,32,0,0,0,0
27,8474037,James van Riemsdyk,L,,35,0,0,0,0
27,8476907,Mackenzie MacEachern,L,,30,0,0,0,0
27,8480216,Jacob Peterson,C,,25,0,0,0,0
27,8474602,Justin Schultz,D,,34,0,0,0,0
27,8482222,Alexander Barabanov,L,,30,0,0,0,0
27,8474031,Kevin Shattenkirk,D,,35,0,0,0,0
27,8477330,Dominik Kubalik,L,,29,0,0,0,0
27,8480884,Calen Addison,D,,24,0,0,0,0
27,8475906,John Klingberg,D,,32,0,0,0,0
27,8480008,Adam Ruzicka,C,,25,0,0,0,0
27,8476884,Derrick Pouliot,D,,30,0,0,0,0
27,8476919,Chris Tierney,C,,30,0,0,0,0
27,8479415,Michael McLeod,C,,26,0,0,0,0
27,8474870,Tyler Johnson,C,,34,0,0,0,0
27,8470604,Jeff Carter,C,,39,0,0,0,0
27,8478104,Sammy Blais,L,,28,0,0,0,0
27,8474884,Mike Hoffman,C,,35,0,0,0,0
27,8481591,Sam Poulin,R,,23,0,0,0,0
27,8471274,Alex Goligoski,D,,39,0,0,0,0
27,8476871,Tanner Pearson,L,,32,0,0,0,0
27,8476393,Nick Cousins,C,,31,0,0,0,0
27,8479977,Kailer Yamamoto,R,,26,0,0,0,0
27,8479346,Dillon Dube,C,,26,0,0,0,0
27,8480184,Gustav Lindstrom,D,,26,0,0,0,0
27,8479376,Victor Mete,D,,26,0,0,0,0
27,8473449,Kyle Okposo,R,,36,0,0,0,0
27,8481058,Jesse Ylonen,R,,25,0,0,0,0
27,8475752,Tyler Pitlick,C,,33,0,0,0,0
27,8481239,Samuel Fagemo,L,,24,0,0,0,0
27,8480821,Filip Zadina,R,,25,0,0,0,0
27,8470966,Mark Giordano,D,,41,0,0,0,0
27,8478495,Denis Gurianov,R,,27,0,0,0,0
27,8477464,Nic Petan,C,,29,0,0,0,0
27,8478099,Kevin Labanc,R,,29,0,0,0,0
27,8482241,Radim Zohorna,L,,28,0,0,0,0
27,8474040,Sam Gagner,C,,35,0,0,0,0
27,8479514,Rem Pitlick,C,,27,0,0,0,0
27,8478430,Oliver Kylington,D,,27,0,0,0,0
27,8479533,Joona Koppanen,L,,26,0,0,0,0
27,8479984,Cal Foote,D,,26,0,0,0,0
27,8477126,Jayson Megna,C,,34,0,0,0,0
27,8475164,Jakob Silfverberg,R,,34,0,0,0,0
27,8474009,Nick Bonino,C,,36,0,0,0,0
27,8479458,Nikita Zaitsev,D,,33,0,0,0,0
27,8477944,Jakub Vrana,L,,28,0,0,0,0
27,8471699,Andrew Cogliano,C,,37,0,0,0,0
27,8478067,Oskar Lindblom,L,,28,0,0,0,0
27,8471686,Marc Staal,D,,37,0,0,0,0
27,8470610,Zach Parise,L,,40,0,0,0,0
27,8478904,Steven Lorentz,C,,28,0,0,0,0
27,8473473,Milan Lucic,L,,36,0,0,0,0
27,8480031,Maxime Comtois,L,,25,0,0,0,0
27,8478512,Austin Czarnik,C,,32,0,0,0,0
27,8473504,Cal Clutterbuck,R,,37,0,0,0,0
27,8477454,Adam Erne,L,,29,0,0,0,0
27,8479383,Boris Katchouk,L,,26,0,0,0,0
27,8475825,Jani Hakanpää,D,,32,0,0,0,0
27,8477846,Ryan Carpenter,C,,33,0,0,0,0
27,8477930,Pierre-Edouard Bellemare,L,,39,0,0,0,0
27,8478400,Colin White,C,,27,0,0,0,0
27,8480226,Marián Studenic,R,,26,0,0,0,0
27,8480853,Liam Foudy,C,,24,0,0,0,0
27,8475797,Jarred Tinordi,D,,32,0,0,0,0
27,8479423,Alex Nylander,L,,26,0,0,0,0
27,8474618,Marco Scandella,D,,34,0,0,0,0
27,8478028,Fredrik Olofsson,L,,28,0,0,0,0
27,8474709,Matt Martin,L,,35,0,0,0,0
27,8481070,Hugh McGing,L,,26,0,0,0,0
27,8479546,Oskar Steen,C,,26,0,0,0,0
27,8474145,Robert Bortuzzo,D,,35,0,0,0,0
27,8476915,Jujhar Khaira,L,,30,0,0,0,0
27,8475278,Byron Froese,C,,33,0,0,0,0
27,8481812,Nikolai Knyzhov,D,,27,0,0,0,0
27,8478408,Travis Dermott,D,,28,0,0,0,0
27,8481077,John Leonard,L,,26,0,0,0,0
27,8479547,Matthew Phillips,R,,26,0,0,0,0
27,8480836,Jonathan Gruden,C,,24,0,0,0,0
27,8481690,Tyler Angle,C,,24,0,0,0,0
27,8475766,Austin Watson,L,,32,0,0,0,0
27,8481016,Ruslan Iskhakov,C,,24,0,0,0,0
27,8478078,Rourke Chartier,C,,28,0,0,0,0
27,8480776,Sheldon Rempal,R,,29,0,0,0,0
27,8478956,Samuel Laberge,L,NJD,27,2,0,0,0
27,8483045,Cameron Butler,R,CBJ,31,0,0,0,0
27,8484314,Jiri Smejkal,L,,28,0,0,0,0
28,8480027,Jason Robertson,L,DAL,25,82,49,72,121
28,8481559,Jack Hughes,C,NJD,23,77,42,77,119
28,8478402,Connor McDavid,C,EDM,27,80,36,83,119
28,8477492,Nathan MacKinnon,C,COL,29,81,49,68,117
28,8477934,Leon Draisaitl,C,EDM,29,79,43,73,116
28,8476453,Nikita Kucherov,R,TBL,31,82,29,87,116
28,8479318,Auston Matthews,C,TOR,27,80,59,54,113
28,8478483,Mitch Marner,R,TOR,27,79,28,85,113
28,8479314,Matthew Tkachuk,L,FLA,27,78,31,81,112
28,8478420,Mikko Rantanen,R,COL,28,82,52,58,110
28,8476468,J.T. Miller,C,VAN,31,77,31,78,109
28,8478550,Artemi Panarin,L,NYR,33,79,34,74,108
28,8477956,David Pastrnak,R,BOS,28,79,51,55,106
28,8477493,Aleksander Barkov,C,FLA,29,80,29,69,98
28,8480002,Nico Hischier,C,NJD,25,77,41,56,97
28,8477404,Jake Guentzel,C,TBL,30,82,39,57,96
28,8480800,Quinn Hughes,D,VAN,25,76,14,80,94
28,8482116,Tim Stützle,C,OTT,22,79,33,60,93
28,8478398,Kyle Connor,L,WPG,28,72,46,46,92
28,8479407,Jesper Bratt,L,NJD,26,78,31,60,91
28,8478864,Kirill Kaprizov,L,MIN,27,77,38,52,90
28,8480012,Elias Pettersson,C,VAN,26,75,37,53,90
28,8478445,Mathew Barzal,C,NYI,27,82,20,70,90
28,8477939,William Nylander,R,TOR,28,77,40,49,89
28,8476887,Filip Forsberg,L,NSH,30,71,38,51,89
28,8479323,Adam Fox,D,NYR,26,76,23,66,89
28,8480069,Cale Makar,D,COL,26,71,22,67,89
28,8471214,Alex Ovechkin,L,WSH,39,70,45,42,87
28,8482740,Wyatt Johnston,C,DAL,21,82,43,43,86
28,8477946,Dylan Larkin,C,DET,28,81,41,44,85
28,8475172,Nazem Kadri,C,CGY,34,75,25,60,85
28,8478403,Jack Eichel,C,VGK,28,75,38,46,84
28,8479675,Trevor Moore,L,LAK,29,80,48,35,83
28,8478414,Timo Meier,R,NJD,28,75,39,44,83
28,8480036,Miro Heiskanen,D,DAL,25,78,21,62,83
28,8481557,Matt Boldy,L,MIN,23,69,35,47,82
28,8475167,Victor Hedman,D,TBL,34,79,17,64,81
28,8475184,Chris Kreider,L,NYR,33,79,46,34,80
28,8479420,Tage Thompson,C,BUF,27,77,40,39,79
28,8476389,Vincent Trocheck,C,NYR,31,76,27,52,79
28,8478439,Travis Konecny,R,PHI,27,79,27,52,79
28,8475913,Mark Stone,R,VGK,32,78,29,49,78
28,8478460,Zach Werenski,D,CBJ,27,81,22,56,78
28,8476346,Johnny Gaudreau,L,CBJ,31,74,13,65,78
28,8484144,Connor Bedard,C,CHI,19,69,29,48,77
28,8480801,Brady Tkachuk,L,OTT,25,77,37,39,76
28,8480830,Andrei Svechnikov,R,CAR,24,75,31,45,76
28,8477942,Kevin Fiala,L,LAK,28,80,27,49,76
28,8476456,Jonathan Huberdeau,C,CGY,31,77,19,57,76
28,8477949,Alex Tuch,R,BUF,28,71,22,53,75
28,8478427,Sebastian Aho,C,CAR,27,70,31,43,74
28,8476459,Mika Zibanejad,C,NYR,31,79,27,47,74
28,8477501,Valeri Nichushkin,R,COL,29,81,33,40,73
28,8478975,Mason Marchment,L,DAL,29,80,25,48,73
28,8478440,Dylan Strome,C,WSH,27,72,24,49,73
28,8476454,Ryan Nugent-Hopkins,C,EDM,31,78,22,51,73
28,8480023,Robert Thomas,C,STL,25,72,17,56,73
28,8478010,Brayden Point,C,TBL,28,82,34,38,72
28,8480208,Drake Batherson,R,OTT,26,82,22,50,72
28,8477496,Elias Lindholm,C,BOS,30,81,27,44,71
28,8473994,Jamie Benn,L,DAL,35,81,22,49,71
28,8479385,Jordan Kyrou,C,STL,26,78,34,36,70
28,8475166,John Tavares,C,TOR,34,78,29,41,70
28,8480018,Nick Suzuki,C,MTL,25,74,25,45,70
28,8475692,Mats Zuccarello,R,MIN,37,70,22,48,70
28,8477504,Josh Morrissey,D,WPG,29,76,17,53,70
28,8475810,Bryan Rust,R,PIT,32,77,39,30,69
28,8474564,Steven Stamkos,C,NSH,34,71,31,38,69
28,8479343,Clayton Keller,R,UTA,26,78,28,41,69
28,8477955,Jared McCann,L,SEA,28,76,27,42,69
28,8476881,Tomas Hertl,C,VGK,31,74,36,32,68
28,8477500,Bo Horvat,C,NYI,29,81,33,35,68
28,8478047,Michael Bunting,L,PIT,29,79,31,37,68
28,8475754,Brock Nelson,C,NYI,33,76,30,38,68
28,8471675,Sidney Crosby,C,PIT,37,74,28,40,68
28,8478449,Roope Hintz,C,DAL,28,82,28,40,68
28,8477416,Oliver Bjorkstrand,R,SEA,29,80,26,42,68
28,8478444,Brock Boeser,R,VAN,27,75,29,38,67
28,8477402,Pavel Buchnevich,L,STL,29,77,23,44,67
28,8477951,Nick Schmaltz,C,UTA,28,78,19,48,67
28,8475784,Jeff Skinner,C,EDM,32,75,29,37,66
28,8475168,Matt Duchene,C,DAL,33,82,28,38,66
28,8482078,Lucas Raymond,L,DET,22,82,25,41,66
28,8476905,Chandler Stephenson,C,SEA,30,79,17,49,66
28,8474600,Roman Josi,D,NSH,34,78,19,46,65
28,8479325,Charlie McAvoy,D,BOS,27,73,19,46,65
28,8477933,Sam Reinhart,C,FLA,29,76,33,31,64
28,8477960,Adrian Kempe,R,LAK,28,80,27,37,64
28,8479542,Brandon Hagel,L,TBL,26,82,26,38,64
28,8473419,Brad Marchand,L,BOS,36,81,20,44,64
28,8477409,Carter Verhaeghe,C,FLA,29,73,35,28,63
28,8479999,Casey Mittelstadt,C,COL,26,79,18,45,63
28,8476539,Jonathan Marchessault,R,NSH,34,75,30,32,62
28,8481540,Cole Caufield,R,MTL,23,72,25,37,62
28,8477940,Nikolaj Ehlers,L,WPG,28,70,19,43,62
28,8476875,Mike Matheson,D,MTL,30,74,12,50,62
28,8482665,Matty Beniers,C,SEA,22,70,29,32,61
28,8474150,Mikael Backlund,C,CGY,35,75,26,35,61
28,8478401,Pavel Zacha,C,BOS,27,79,12,49,61
28,8474590,John Carlson,D,WSH,34,70,11,50,61
28,8479337,Alex DeBrincat,R,DET,27,80,34,26,60
28,8474102,David Perron,L,OTT,36,79,24,36,60
28,8480839,Rasmus Dahlin,D,BUF,24,67,20,40,60
28,8478493,Joel Eriksson Ek,C,MIN,27,69,28,31,59
28,8476882,Teuvo Teravainen,C,CHI,30,63,25,34,59
28,8482699,Dylan Guenther,R,UTA,21,77,24,35,59
28,8477986,Brandon Montour,D,SEA,30,75,20,39,59
28,8477444,Andre Burakovsky,L,SEA,29,72,20,39,59
28,8480865,Noah Dobson,D,NYI,24,78,12,47,59
28,8475191,Reilly Smith,R,NYR,33,73,27,31,58
28,8476448,William Karlsson,C,VGK,31,77,24,34,58
28,8482093,Seth Jarvis,C,CAR,22,66,24,34,58
28,8471215,Evgeni Malkin,C,PIT,38,72,23,35,58
28,8474141,Patrick Kane,R,DET,36,79,17,41,58
28,8478366,Frank Vatrano,R,ANA,30,77,30,27,57
28,8483808,Andrei Kuzmenko,L,CGY,28,72,25,32,57
28,8475158,Ryan O'Reilly,C,NSH,33,75,24,33,57
28,8478873,Troy Terry,R,ANA,27,75,23,34,57
28,8477494,Jonathan Drouin,L,COL,29,81,21,36,57
28,8474578,Erik Karlsson,D,PIT,34,80,12,45,57
28,8478498,Jake DeBrusk,L,VAN,28,75,36,20,56
28,8477456,J.T. Compher,L,DET,29,78,27,29,56
28,8474641,Adam Henrique,C,EDM,34,75,25,31,56
28,8481068,Yegor Sharangovich,C,CGY,26,80,29,26,55
28,8475786,Zach Hyman,L,EDM,32,79,28,27,55
28,8476460,Mark Scheifele,C,WPG,31,70,23,32,55
28,8480798,Philipp Kurashev,C,CHI,25,67,13,42,55
28,8482684,Luke Hughes,D,NJD,21,69,9,46,55
28,8483515,Juraj Slafkovsky,L,MTL,20,77,25,29,54
28,8482745,Mason McTavish,C,ANA,21,71,24,30,54
28,8477479,Tyler Bertuzzi,L,CHI,29,66,23,31,54
28,8475798,Mikael Granlund,C,SJS,32,70,14,40,54
28,8476462,Dougie Hamilton,D,NJD,31,67,18,35,53
28,8484203,Bradly Nadeau,L,CAR,19,69,16,37,53
28,8478397,Rasmus Andersson,D,CGY,28,72,12,41,53
28,8475794,Tyler Seguin,C,DAL,32,80,26,26,52
28,8480039,Martin Necas,C,CAR,25,68,19,33,52
28,8477511,Anthony Mantha,R,CGY,30,74,19,33,52
28,8471685,Anze Kopitar,C,LAK,37,80,14,38,52
28,8484166,Adam Fantilli,C,CBJ,20,72,25,26,51
28,8476479,Phillip Danault,C,LAK,31,80,23,28,51
28,8474586,Jordan Eberle,R,SEA,34,76,22,29,51
28,8480797,Joel Farabee,L,PHI,24,72,21,30,51
28,8477935,Sam Bennett,C,FLA,28,76,21,30,51
28,8475170,Brayden Schenn,C,STL,33,67,20,31,51
28,8473512,Claude Giroux,R,OTT,36,79,16,35,51
28,8482124,Quinton Byfield,R,LAK,22,78,15,36,51
28,8478469,Thomas Chabot,D,OTT,27,76,15,36,51
28,8471724,Kris Letang,D,PIT,37,80,7,44,51
28,8478407,Vince Dunn,D,SEA,28,78,13,37,50
28,8476483,Rickard Rakell,R,PIT,31,73,28,21,49
28,8475768,Jaden Schwartz,C,SEA,32,72,24,25,49
28,8475745,Charlie Coyle,C,BOS,32,79,21,28,49
28,8479339,Patrik Laine,L,CBJ,26,70,19,30,49
28,8478438,Tommy Novak,C,NSH,27,67,19,30,49
28,8474679,Gustav Nyquist,C,NSH,35,71,12,37,49
28,8477503,Max Domi,C,TOR,29,79,10,39,49
28,8477447,Shea Theodore,D,VGK,29,53,10,39,49
28,8482109,Alexis Lafrenière,L,NYR,23,68,24,24,48
28,8475765,Vladimir Tarasenko,R,DET,33,76,23,25,48
28,8478519,Anthony Cirelli,C,TBL,27,80,23,25,48
28,8477476,Artturi Lehkonen,L,COL,29,79,22,26,48
28,8480803,Evan Bouchard,D,EDM,25,74,13,35,48
28,8477429,Andrew Copp,C,DET,30,79,11,37,48
28,8482110,Dawson Mercer,C,NJD,23,73,23,24,47
28,8481618,Alex Newhook,C,MTL,23,71,20,27,47
28,8477497,Sean Monahan,C,CBJ,30,68,18,29,47
28,8477407,Anthony Duclair,L,NYI,29,80,22,24,46
28,8478466,Daniel Sprong,R,VAN,27,75,22,24,46
28,8480028,Morgan Frost,C,PHI,25,74,21,25,46
28,8481711,Matias Maccelli,L,UTA,24,74,19,27,46
28,8481596,Shane Pinto,C,OTT,24,72,17,29,46
28,8479525,Ross Colton,C,COL,28,81,23,22,45
28,8479365,Trent Frederic,C,BOS,26,77,22,23,45
28,8482720,Matthew Knies,L,TOR,22,77,20,25,45
28,8483431,Logan Cooley,C,UTA,20,74,18,27,45
28,8482475,Yegor Chinakhov,R,CBJ,23,62,18,27,45
28,8478046,Danton Heinen,L,VAN,29,69,17,28,45
28,8476872,Scott Laughton,C,PHI,30,79,15,30,45
28,8475753,Justin Faulk,D,STL,32,72,11,34,45
28,8475151,Kyle Palmieri,C,NYI,33,80,26,18,44
28,8480188,Fabian Zetterlund,L,SJS,25,67,24,20,44
28,8480459,Pius Suter,C,VAN,28,70,19,25,44
28,8481577,Philip Tomasino,C,NSH,23,65,19,25,44
28,8475287,Erik Haula,L,NJD,33,74,18,26,44
28,8478856,Conor Garland,R,VAN,28,71,17,27,44
28,8481528,Dylan Cozens,C,BUF,23,72,17,27,44
28,8476927,Teddy Blueger,C,VAN,30,64,17,27,44
28,8479400,Pierre-Luc Dubois,L,WSH,26,70,16,28,44
28,8475169,Evander Kane,L,EDM,33,76,25,18,43
28,8480009,Eeli Tolvanen,R,SEA,25,70,21,22,43
28,8480185,Eetu Luostarinen,C,FLA,26,76,21,22,43
28,8481560,Arthur Kaliyev,R,LAK,23,77,17,26,43
28,8477451,Ryan Hartman,R,MIN,30,72,17,26,43
28,8476906,Shayne Gostisbehere,D,CAR,31,78,15,28,43
28,8478462,Nicolas Roy,C,VGK,27,76,13,30,43
28,8476880,Tom Wilson,R,WSH,30,71,23,19,42
28,8476399,Blake Coleman,C,CGY,33,80,22,20,42
28,8480015,Owen Tippett,R,PHI,25,77,20,22,42
28,8480835,Jack Drury,C,CAR,24,66,19,23,42
28,8477964,Ivan Barbashev,C,VGK,29,79,17,25,42
28,8476958,Jaccob Slavin,D,CAR,30,71,14,28,42
28,8477346,MacKenzie Weegar,D,CGY,30,70,12,30,42
28,8478396,Noah Hanifin,D,VGK,27,61,6,36,42
28,8482712,Oskar Olausson,R,COL,22,76,5,37,42
28,8475726,Tyler Toffoli,C,SJS,32,68,22,19,41
28,8478542,Evan Rodrigues,C,FLA,31,78,20,21,41
28,8482097,Jack Quinn,R,BUF,23,65,16,25,41
28,8476474,Stefan Noesen,R,NJD,31,72,16,25,41
28,8479992,Michael Rasmussen,C,DET,25,79,15,26,41
28,8474565,Alex Pietrangelo,D,VGK,34,66,11,30,41
28,8474563,Drew Doughty,D,LAK,35,69,9,32,41
28,8476853,Morgan Rielly,D,TOR,30,68,8,33,41
28,8476869,Brady Skjei,D,NSH,30,72,7,34,41
28,8477495,Seth Jones,D,CHI,30,67,6,35,41
28,8475764,Cam Fowler,D,ANA,33,70,5,36,41
28,8480078,Filip Chytil,C,NYR,25,64,15,25,40
28,8477021,Alex Kerfoot,C,UTA,30,77,13,27,40
28,8477998,Warren Foegele,L,LAK,28,77,13,27,40
28,8476292,Ondrej Palat,L,NJD,33,67,13,27,40
28,8476419,Jean-Gabriel Pageau,C,NYI,32,77,12,28,40
28,8481533,Trevor Zegras,C,ANA,23,71,9,31,40
28,8479425,Filip Hronek,D,VAN,27,77,9,31,40
28,8478038,Devon Toews,D,COL,30,67,9,31,40
28,8475314,Anders Lee,L,NYI,34,80,25,14,39
28,8480220,Noah Cates,L,PHI,25,78,17,22,39
28,8479987,Morgan Geekie,C,BOS,26,75,16,23,39
28,8481581,Thomas Harley,D,DAL,23,79,14,25,39
28,8481542,Moritz Seider,D,DET,23,76,2,37,39
28,8482667,William Eklund,L,SJS,22,69,21,17,38
28,8480014,Gabriel Vilardi,C,WPG,25,69,19,19,38
28,8476826,Yanni Gourde,C,SEA,33,68,18,20,38
28,8478042,Viktor Arvidsson,L,EDM,31,73,15,23,38
28,8475763,Kevin Hayes,R,PIT,32,71,15,23,38
28,8482092,Ridly Greig,C,OTT,22,75,14,24,38
28,8470613,Brent Burns,D,CAR,39,75,10,28,38
28,8478055,Gustav Forsling,D,FLA,28,69,10,28,38
28,8480434,Sean Durzi,D,UTA,26,65,9,29,38
28,8483490,Pavel Mintyukov,D,ANA,21,71,7,31,38
28,8481604,Pavel Dorofeyev,L,VGK,24,71,21,16,37
28,8479390,Taylor Raddysh,R,WSH,26,59,18,19,37
28,8482702,Logan Stankoven,C,DAL,21,82,17,20,37
28,8471698,T.J. Oshie,R,WSH,38,70,15,22,37
28,8477948,Travis Sanheim,D,PHI,28,73,7,30,37
28,8475722,Jason Zucker,L,BUF,32,70,24,12,36
28,8477426,Nicholas Paul,L,TBL,29,81,21,15,36
28,8482159,Tyson Foerster,R,PHI,22,76,19,17,36
28,8480064,Josh Norris,C,OTT,25,75,19,17,36
28,8475799,Nino Niederreiter,R,WPG,32,65,18,18,36
28,8476432,Boone Jenner,C,CBJ,31,69,17,19,36
28,8481535,Nils Hoglander,L,VAN,24,66,17,19,36
28,8479591,Michael Eyssimont,C,TBL,28,81,14,22,36
28,8475793,Ryan Johansen,C,PHI,32,76,14,22,36
28,8475848,Brendan Gallagher,R,MTL,32,72,13,23,36
28,8482671,Owen Power,D,BUF,22,66,8,28,36
28,8479410,Mikhail Sergachev,D,UTA,26,67,5,31,36
28,8478057,Dakota Joshua,C,VAN,28,63,20,15,35
28,8473422,Nick Foligno,L,CHI,37,57,18,17,35
28,8482113,Anton Lundell,C,FLA,23,75,17,18,35
28,8475714,Calle Jarnkrok,C,TOR,33,79,16,19,35
28,8480849,Barrett Hayton,C,UTA,24,71,15,20,35
28,8481524,Bowen Byram,D,BUF,23,67,12,23,35
28,8483505,Matthew Poitras,C,BOS,20,79,12,23,35
28,8482149,Cole Perfetti,C,WPG,22,63,10,25,35
28,8478472,Mathieu Joseph,R,STL,27,69,10,25,35
28,8482105,Jake Sanderson,D,OTT,22,74,9,26,35
28,8479351,Sam Steel,C,DAL,26,78,9,26,35
28,8477969,Marcus Pettersson,D,PIT,28,80,9,26,35
28,8478133,Jake Evans,C,MTL,28,73,8,27,35
28,8477353,Tyler Motte,C,DET,29,73,18,16,34
28,8484145,Zach Benson,L,BUF,19,69,17,17,34
28,8477425,Miles Wood,L,COL,29,78,17,17,34
28,8474053,Logan Couture,C,SJS,35,68,14,20,34
28,8474149,Evgenii Dadonov,R,DAL,35,79,13,21,34
28,8475218,Mattias Ekholm,D,EDM,34,76,12,22,34
28,8476923,Damon Severson,D,CBJ,30,78,10,24,34
28,8475171,Oliver Ekman-Larsson,D,TOR,33,67,7,27,34
28,8481703,Valtteri Puustinen,R,PIT,25,63,7,27,34
28,8476979,Erik Gustafsson,D,DET,32,74,5,29,34
28,8473986,Alex Killorn,L,ANA,35,68,19,14,33
28,8476438,Brandon Saad,L,STL,32,70,19,14,33
28,8480748,Kiefer Sherwood,L,VAN,29,65,16,17,33
28,8479345,Jakob Chychrun,D,WSH,26,61,12,21,33
28,8476854,Hampus Lindholm,D,BOS,30,76,10,23,33
28,8480145,Neal Pionk,D,WPG,29,67,9,24,33
28,8478020,Michael Amadio,R,OTT,28,78,24,8,32
28,8481032,Paul Cotter,C,NJD,25,61,23,9,32
28,8475760,Nick Bjugstad,C,UTA,32,70,19,13,32
28,8470621,Corey Perry,R,EDM,39,74,18,14,32
28,8481624,Ilya Mikheyev,R,CHI,30,60,16,16,32
28,8484153,Leo Carlsson,C,ANA,20,68,15,17,32
28,8481186,Logan O'Connor,R,COL,28,79,14,18,32
28,8478463,Anthony Beauvillier,L,PIT,27,67,10,22,32
28,8482655,Janis Moser,D,TBL,24,77,8,24,32
28,8482055,Drew O'Connor,L,PIT,26,58,20,11,31
28,8478891,Mason Appleton,C,WPG,28,62,18,13,31
28,8478233,Andrew Mangiapane,L,WSH,28,70,16,15,31
28,8474716,Jared Spurgeon,D,MIN,35,78,14,17,31
28,8476480,Vladislav Namestnikov,C,WPG,32,63,12,19,31
28,8477953,Kasperi Kapanen,R,STL,28,61,10,21,31
28,8477932,Aaron Ekblad,D,FLA,28,73,9,22,31
28,8477947,Sonny Milano,L,WSH,28,66,9,22,31
28,8480336,Sean Walker,D,CAR,30,73,8,23,31
28,8476463,Jonas Brodin,D,MIN,31,76,7,24,31
28,8481546,Cam York,D,PHI,23,69,7,24,31
28,8482122,Brock Faber,D,MIN,22,77,5,26,31
28,8478474,Lawson Crouse,L,UTA,27,75,15,15,30
28,8475193,Tomas Tatar,L,NJD,34,64,14,16,30
28,8479661,Tanner Jeannot,L,LAK,27,79,14,16,30
28,8476469,Joel Armia,R,MTL,31,58,14,16,30
28,8478432,Christian Fischer,R,DET,27,74,14,16,30
28,8476461,Sean Couturier,C,PHI,32,70,13,17,30
28,8476458,Ryan Strome,C,ANA,31,68,13,17,30
28,8480893,Kirill Marchenko,R,CBJ,24,66,13,17,30
28,8481523,Kirby Dach,C,MTL,23,69,12,18,30
28,8480802,Ryan McLeod,C,BUF,25,66,11,19,30
28,8478109,Victor Olofsson,L,VGK,29,74,11,19,30
28,8474574,Tyler Myers,D,VAN,34,67,4,26,30
28,8482125,Alexander Holtz,R,VGK,22,70,16,13,29
28,8477987,Ryan Donato,C,CHI,28,55,15,14,29
28,8477952,Robby Fabbri,C,ANA,28,67,14,15,29
28,8481554,Kaapo Kakko,R,NYR,23,64,13,16,29
28,8482146,Luke Evangelista,R,NSH,22,71,13,16,29
28,8474189,Lars Eller,C,PIT,35,64,13,16,29
28,8481522,Peyton Krebs,C,BUF,23,56,11,18,29
28,8481553,Bobby Brink,R,PHI,23,62,10,19,29
28,8479414,Nathan Bastian,R,NJD,27,59,9,20,29
28,8476925,Colton Sissons,C,NSH,31,66,8,21,29
28,8480817,K'Andre Miller,D,NYR,24,71,7,22,29
28,8476902,Esa Lindell,D,DAL,30,75,5,24,29
28,8478851,Alexandre Carrier,D,NSH,28,65,1,28,29
28,8482079,Marco Rossi,C,MIN,23,57,16,12,28
28,8482259,Bobby McMann,C,TOR,28,63,15,13,28
28,8476921,Jordan Martinook,L,CAR,32,63,14,14,28
28,8480813,Joe Veleno,C,DET,24,77,13,15,28
28,8477220,Nate Schmidt,D,FLA,33,68,7,21,28
28,8476917,Adam Pelech,D,NYI,30,79,6,22,28
28,8476792,Torey Krug,D,STL,33,71,5,23,28
28,8478911,Matt Roy,D,WSH,29,64,5,23,28
28,8474151,Ryan McDonagh,D,TBL,35,78,3,25,28
28,8474715,Cameron Atkinson,R,TBL,35,79,16,11,27
28,8482117,Lukas Reichel,L,CHI,22,60,14,13,27
28,8479368,Max Jones,L,BOS,26,65,12,15,27
28,8482101,Danil Gushchin,L,SJS,22,54,11,16,27
28,8481656,Aliaksei Protas,C,WSH,23,64,10,17,27
28,8480829,Jesperi Kotkaniemi,C,CAR,24,72,9,18,27
28,8476429,Scott Mayfield,D,NYI,32,72,8,19,27
28,8477498,Darnell Nurse,D,EDM,29,76,7,20,27
28,8479639,Dylan Coghlan,D,WPG,26,65,4,23,27
28,8480043,Timothy Liljegren,D,TOR,25,67,3,24,27
28,8476981,Josh Anderson,R,MTL,30,71,15,11,26
28,8483445,Cutter Gauthier,L,ANA,20,67,13,13,26
28,8477450,Jason Dickinson,C,CHI,29,58,12,14,26
28,8477508,Curtis Lazar,C,NJD,29,61,12,14,26
28,8481582,Nicholas Robertson,L,TOR,23,70,11,15,26
28,8479996,Cody Glass,C,NSH,25,64,11,15,26
28,8476467,Jamie Oleksiak,D,SEA,32,68,10,16,26
28,8478413,Jordan Greenway,L,BUF,27,65,9,17,26
28,8473563,Nicklas Backstrom,C,WSH,37,46,9,17,26
28,8476885,Jacob Trouba,D,NYR,30,74,8,18,26
28,8475200,Dmitry Orlov,D,CAR,33,72,8,18,26
28,8480871,Adam Boqvist,D,FLA,24,69,7,19,26
28,8482705,Cole Sillinger,C,CBJ,21,68,15,10,25
28,8478115,Pierre Engvall,L,NYI,28,77,12,13,25
28,8477839,Conor Sheary,L,TBL,32,80,11,14,25
28,8481580,Connor McMichael,C,WSH,23,66,10,15,25
28,8483524,Shane Wright,C,SEA,20,56,10,15,25
28,8476392,Adam Lowry,C,WPG,31,70,9,16,25
28,8480860,Kevin Bahl,D,CGY,24,62,7,18,25
28,8479983,Mario Ferraro,D,SJS,26,67,6,19,25
28,8483565,Nick Blankenburg,D,NSH,26,57,6,19,25
28,8476892,Colton Parayko,D,STL,31,70,3,22,25
28,8476457,Adam Larsson,D,SEA,32,67,3,22,25
28,8476878,Zemgus Girgensons,C,TBL,30,79,15,9,24
28,8482074,Connor Zary,C,CGY,23,64,14,10,24
28,8479336,Carl Grundstrom,R,SJS,27,53,13,11,24
28,8482175,JJ Peterka,R,BUF,22,69,10,14,24
28,8480113,Alex Iafallo,L,WPG,31,64,10,14,24
28,8478882,Vladislav Gavrikov,D,LAK,29,70,9,15,24
28,8478434,Keegan Kolesar,R,VGK,27,59,9,15,24
28,8482133,Thomas Bordeleau,C,SJS,22,64,8,16,24
28,8478458,John (Jack) Roslovic,C,CAR,27,68,8,16,24
28,8483493,Frank Nazar,C,CHI,20,56,8,16,24
28,8477505,Alexander Wennberg,C,SJS,30,61,7,17,24
28,8482087,Kaiden Guhle,D,MTL,22,65,7,17,24
28,8475231,Casey Cizikas,C,NYI,33,69,6,18,24
28,8479398,Samuel Girard,D,COL,26,73,6,18,24
28,8478136,Jake Middleton,D,MIN,28,72,5,19,24
28,8480873,Rasmus Sandin,D,WSH,24,66,5,19,24
28,8477488,Brett Pesce,D,NJD,30,72,5,19,24
28,8478840,Will Borgen,D,SEA,28,64,5,19,24
28,8475790,Erik Gudbranson,D,CBJ,32,77,3,21,24
28,8478500,Ivan Provorov,D,CBJ,27,77,2,22,24
28,8481059,Scott Perunovich,D,STL,26,65,2,22,24
28,8479941,Justin Danforth,R,CBJ,31,53,20,3,23
28,8482660,Kent Johnson,C,CBJ,22,64,16,7,23
28,8479066,Ryan Lomberg,L,CGY,30,65,12,11,23
28,8480068,Ryan Poehling,C,PHI,25,62,10,13,23
28,8478970,Jalen Chatfield,D,CAR,28,76,10,13,23
28,8477989,Christian Dvorak,C,MTL,28,61,8,15,23
28,8477931,Tomas Nosek,L,FLA,32,60,8,15,23
28,8482809,Jackson Blake,R,CAR,21,56,7,16,23
28,8479316,Luke Kunin,C,SJS,27,60,6,17,23
28,8476331,Dylan DeMelo,D,WPG,31,70,4,19,23
28,8473507,Jeff Petry,D,DET,37,67,2,21,23
28,8483457,Lane Hutson,D,MTL,20,72,14,8,22
28,8480252,Cole Guttman,C,CHI,25,40,13,9,22
28,8482089,Jake Neighbours,L,STL,22,70,12,10,22
28,8481093,Rafael Harvey-Pinard,L,MTL,25,62,10,12,22
28,8482624,Daniil Miromanov,D,CGY,27,62,10,12,22
28,8478508,Yakov Trenin,C,MIN,27,62,10,12,22
28,8482142,Jamie Drysdale,D,PHI,22,63,9,13,22
28,8478569,Noel Acciari,C,PIT,33,50,9,13,22
28,8473533,Jordan Staal,C,CAR,36,64,8,14,22
28,8475149,Marcus Johansson,L,MIN,34,67,7,15,22
28,8480878,Nils Lundkvist,D,DAL,24,66,7,15,22
28,8479315,Joey Anderson,R,CHI,26,55,7,15,22
28,8481704,Juuso Parssinen,C,NSH,23,57,7,15,22
28,8482111,Justin Barron,D,MTL,23,60,5,17,22
28,8483491,Ivan Miroshnichenko,L,WSH,20,54,5,17,22
28,8481606,Jordan Spence,D,LAK,23,60,4,18,22
28,8474673,TJ Brodie,D,CHI,34,70,2,20,22
28,8476873,Mark Jankowski,C,NSH,30,50,17,4,21
28,8475343,Nic Dowd,C,WSH,34,57,13,8,21
28,8479520,Brandon Duhaime,R,WSH,27,57,13,8,21
28,8480995,Pontus Holmberg,R,TOR,25,56,12,9,21
28,8482737,Zack Bolduc,C,STL,21,62,12,9,21
28,8480144,David Kampf,C,TOR,29,73,11,10,21
28,8475220,Marcus Foligno,L,MIN,33,59,10,11,21
28,8477446,Michael McCarron,R,NSH,29,60,10,11,21
28,8481441,Joe Snively,C,DET,28,61,10,11,21
28,8480205,Emil Bemstrom,C,PIT,25,57,10,11,21
28,8480789,Oliver Wahlstrom,R,NYI,24,71,9,12,21
28,8477507,Nikita Zadorov,D,BOS,29,69,9,12,21
28,8480011,Klim Kostin,C,SJS,25,48,9,12,21
28,8483468,Jiri Kulich,C,BUF,20,57,8,13,21
28,8480855,Jack McBain,C,UTA,24,60,7,14,21
28,8477919,Frederick Gaudreau,C,MIN,31,56,7,14,21
28,8481014,Alexander Romanov,D,NYI,24,77,3,18,21
28,8480281,Alexey Toropchenko,R,STL,25,60,14,6,20
28,8479293,Brandon Tanev,L,SEA,33,58,11,9,20
28,8477903,Garnet Hathaway,R,PHI,33,60,11,9,20
28,8479353,Brett Howden,C,VGK,26,70,10,10,20
28,8476278,Colin Blackwell,C,DAL,31,77,10,10,20
28,8479393,Noah Gregor,L,OTT,26,72,10,10,20
28,8483499,Liam Ohgren,L,MIN,20,48,10,10,20
28,8482157,Will Cuylle,L,NYR,22,62,9,11,20
28,8478211,Dryden Hunt,L,CGY,29,55,8,12,20
28,8476918,Jimmy Vesey,L,NYR,31,66,7,13,20
28,8482749,Joshua Roy,R,MTL,21,64,7,13,20
28,8476994,Vinnie Hinostroza,C,NSH,30,48,7,13,20
28,8475455,Brenden Dillon,D,NJD,34,60,6,14,20
28,8476422,Mike Reilly,D,NYI,31,74,5,15,20
28,8475279,Ben Chiarot,D,DET,33,66,5,15,20
28,8476931,Jake McCabe,D,TOR,31,56,4,16,20
28,8479980,Nicolas Hague,D,VGK,26,49,4,16,20
28,8479402,Jake Bean,D,CGY,26,70,4,16,20
28,8476856,Mathew Dumba,D,DAL,30,73,4,16,20
28,8482245,Artem Zub,D,OTT,29,66,2,18,20
28,8471709,Marc-Edouard Vlasic,D,SJS,37,68,2,18,20
28,8479998,Mikey Anderson,D,LAK,25,64,1,19,20
28,8476967,Brett Kulak,D,EDM,30,67,0,20,20
28,8481477,Nico Sturm,C,SJS,29,53,12,7,19
28,8480074,Alexandre Texier,C,STL,25,56,11,8,19
28,8483495,Simon Nemec,D,NJD,20,61,8,11,19
28,8482679,Matt Coronato,R,CGY,22,62,7,12,19
28,8480762,Eric Robinson,L,CAR,29,49,6,13,19
28,8482067,Connor Mackey,D,NYR,28,58,6,13,19
28,8483482,Tristan Luneau,D,ANA,20,65,5,14,19
28,8476988,Matt Benning,D,SJS,30,68,5,14,19
28,8480950,Ilya Lyubushkin,D,DAL,30,60,5,14,19
28,8475179,Dmitry Kulikov,D,FLA,34,63,4,15,19
28,8477506,Ryan Pulock,D,NYI,30,76,2,17,19
28,8476891,Matthew Grzelcyk,D,PIT,30,78,1,18,19
28,8480049,Dylan Samberg,D,WPG,25,67,1,18,19
28,8476525,Colin Miller,D,WPG,32,66,1,18,19
28,8480003,Jesper Boqvist,C,FLA,26,70,9,9,18
28,8476960,Andreas Athanasiou,C,CHI,30,53,8,10,18
28,8477478,William Carrier,L,CAR,30,57,8,10,18
28,8477406,Mattias Janmark,C,EDM,32,66,7,11,18
28,8476897,Oskar Sundqvist,C,STL,30,64,7,11,18
28,8475855,Jesper Fast,R,CAR,33,59,6,12,18
28,8477979,Nicolas Aube-Kubel,R,BUF,28,56,6,12,18
28,8477369,Carson Soucy,D,VAN,30,64,6,12,18
28,8477015,Connor Brown,R,EDM,30,67,5,13,18
28,8480806,Isac Lundestrom,C,ANA,25,62,4,14,18
28,8480073,Erik Brannstrom,D,COL,25,64,3,15,18
28,8476312,Josh Manson,D,COL,33,57,2,16,18
28,8475462,Radko Gudas,D,ANA,34,71,2,16,18
28,8481716,Dmitri Voronkov,L,CBJ,24,42,10,7,17
28,8481019,David Gustafsson,C,WPG,24,46,9,8,17
28,8475181,Nick Leddy,D,STL,33,70,8,9,17
28,8475791,Taylor Hall,L,CHI,33,51,8,9,17
28,8478043,Sam Lafferty,C,BUF,29,60,8,9,17
28,8481527,Kaedan Korczak,D,VGK,23,53,6,11,17
28,8481481,Blake Lizotte,C,PIT,27,61,5,12,17
28,8476879,Cody Ceci,D,EDM,31,69,5,12,17
28,8482192,Isaak Phillips,D,CHI,23,53,5,12,17
28,8481161,Jake Christiansen,D,CBJ,25,62,5,12,17
28,8480246,Nick Perbix,D,TBL,26,79,4,13,17
28,8482095,Tyler Kleven,D,OTT,22,43,4,13,17
28,8481568,Alex Vlasic,D,CHI,23,48,4,13,17
28,8479976,Juuso Valimaki,D,UTA,26,62,3,14,17
28,8480172,Jan Rutta,D,SJS,34,65,3,14,17
28,8477365,Connor Clifton,D,BUF,29,55,3,14,17
28,8475233,David Savard,D,MTL,34,68,1,16,17
28,8481601,Simon Holmstrom,R,NYI,23,66,10,6,16
28,8482166,Shakir Mukhamadullin,D,SJS,22,56,10,6,16
28,8480448,Parker Kelly,L,COL,25,76,9,7,16
28,8480289,Morgan Barron,C,WPG,26,57,8,8,16
28,8476374,Sean Kuraly,C,CBJ,31,59,6,10,16
28,8478416,Erik Cernak,D,TBL,27,75,6,10,16
28,8477392,Hudson Fasching,R,NYI,29,68,5,11,16
28,8482073,Braden Schneider,D,NYR,23,63,4,12,16
28,8480222,Sebastian Aho,D,PIT,28,69,3,13,16
28,8480001,Urho Vaakanainen,D,ANA,25,53,3,13,16
28,8478443,Brandon Carlo,D,BOS,28,58,2,14,16
28,8481178,Egor Zamula,D,PHI,24,55,2,14,16
28,8475188,Brayden McNabb,D,VGK,33,57,1,15,16
28,8475690,Chris Tanev,D,TOR,35,63,1,15,16
28,8475324,Nick Jensen,D,OTT,34,65,0,16,16
28,8479619,Michael Carcone,L,UTA,28,56,11,4,15
28,8475225,Craig Smith,C,CHI,35,44,10,5,15
28,8481617,Vasily Podkolzin,R,VAN,23,54,9,6,15
28,8476889,Radek Faksa,C,STL,30,58,8,7,15
28,8479026,Philippe Myers,D,TOR,27,58,8,7,15
28,8482148,Hendrix Lapierre,C,WSH,22,52,8,7,15
28,8479439,Jacob MacDonald,D,COL,31,54,7,8,15
28,8476329,Travis Boyd,C,MIN,31,55,6,9,15
28,8473453,Trevor Lewis,C,LAK,37,71,6,9,15
28,8479348,Kale Clague,D,BUF,26,42,6,9,15
28,8479370,Tyson Jost,C,CAR,26,46,6,9,15
28,8479944,Zach Aston-Reese,C,VGK,30,57,6,9,15
28,8477573,Nathan Walker,L,STL,30,57,5,10,15
28,8480058,Pierre-Olivier Joseph,D,STL,25,56,5,10,15
28,8480035,Henri Jokiharju,D,BUF,25,61,4,11,15
28,8480891,Michael Kesselring,D,UTA,24,57,4,11,15
28,8478452,Caleb Jones,D,LAK,27,57,4,11,15
28,8482176,Wyatt Kaiser,D,CHI,22,48,2,13,15
28,8478507,John Marino,D,UTA,27,67,1,14,15
28,8479718,Alex Barré-Boulet,C,MTL,27,45,7,7,14
28,8482807,Ethan Del Mastro,D,CHI,21,49,6,8,14
28,8479344,Jesse Puljujarvi,R,PIT,26,56,6,8,14
28,8478421,A.J. Greer,L,FLA,28,58,6,8,14
28,8477938,Haydn Fleury,D,WPG,28,44,5,9,14
28,8481550,Adam Beckman,L,NJD,23,36,5,9,14
28,8482803,Olen Zellweger,D,ANA,21,66,4,10,14
28,8474567,Zach Bogosian,D,MIN,34,63,4,10,14
28,8475208,Brian Dumoulin,D,ANA,33,63,3,11,14
28,8482496,Nils Aman,C,VAN,24,34,3,11,14
28,8476874,Olli Maatta,D,DET,30,65,2,12,14
28,8481708,Zac Jones,D,NYR,24,54,2,12,14
28,8479291,Kevin Rooney,C,CGY,31,56,2,12,14
28,8482155,Alex Laferriere,R,LAK,23,56,8,5,13
28,8481517,Brett Leason,R,ANA,25,49,7,6,13
28,8481013,Jonatan Berggren,R,DET,24,65,7,6,13
28,8481518,Nolan Foote,L,NJD,24,46,6,7,13
28,8477499,Rasmus Ristolainen,D,PHI,30,58,5,8,13
28,8477380,Jonny Brodzinski,C,NYR,31,59,5,8,13
28,8474034,Patrick Maroon,L,CHI,36,54,5,8,13
28,8477018,Ben Hutton,D,VGK,31,49,3,10,13
28,8479986,Kole Lind,R,DAL,26,53,3,10,13
28,8479982,Conor Timmins,D,TOR,26,55,2,11,13
28,8479371,Dante Fabbro,D,NSH,26,61,1,12,13
28,8478399,Jonas Siegenthaler,D,NJD,27,59,0,13,13
28,8480021,Jack Studnicka,C,LAK,25,61,7,5,12
28,8480980,Connor Dewar,C,TOR,25,68,5,7,12
28,8480025,MacKenzie Entwistle,R,FLA,25,59,4,8,12
28,8481567,Henry Thrun,D,SJS,23,48,4,8,12
28,8479576,Vincent Desharnais,D,VAN,28,32,4,8,12
28,8480192,Johnathan Kovacevic,D,NJD,27,51,3,9,12
28,8479972,Mason Shaw,C,WPG,26,43,3,9,12
28,8474568,Luke Schenn,D,NSH,35,44,3,9,12
28,8480157,Calle Rosen,D,COL,30,48,3,9,12
28,8481751,Lukas Rousek,R,BUF,25,39,2,10,12
28,8478178,Darren Raddysh,D,TBL,28,71,1,11,12
28,8477845,Trevor van Riemsdyk,D,WSH,33,56,1,11,12
28,8475718,Justin Holl,D,DET,32,62,1,11,12
28,8480070,Ian Mitchell,D,BOS,25,43,1,11,12
28,8479378,Logan Stanley,D,WPG,26,37,0,12,12
28,8476822,Luke Glendening,C,TBL,35,76,9,2,11
28,8481641,Joel Kiviranta,L,COL,28,69,7,4,11
28,8479772,Zack MacEwen,R,OTT,28,58,6,5,11
28,8478013,Jake Walman,D,SJS,28,70,5,6,11
28,8482077,Dylan Holloway,L,EDM,23,50,5,6,11
28,8482762,Simon Edvinsson,D,DET,21,51,5,6,11
28,8481789,Tye Kartye,L,SEA,23,40,5,6,11
28,8481592,Jakob Pelletier,L,CGY,23,51,4,7,11
28,8479536,Axel Jonsson-Fjallby,L,WPG,26,34,4,7,11
28,8482751,Ryan Winterton,C,SEA,21,34,4,7,11
28,8480807,Mattias Samuelsson,D,BUF,24,53,3,8,11
28,8482859,Zack Ostapchuk,C,OTT,21,51,3,8,11
28,8481521,Ronnie Attard,D,PHI,25,49,3,8,11
28,8478450,Parker Wotherspoon,D,BOS,27,37,3,8,11
28,8481598,Philip Broberg,D,EDM,23,46,3,8,11
28,8473446,Erik Johnson,D,PHI,36,50,3,8,11
28,8478874,Adam Gaudette,R,OTT,28,31,3,8,11
28,8479369,Andrew Peeke,D,BOS,26,63,2,9,11
28,8476624,Barclay Goodrow,C,SJS,31,53,2,9,11
28,8478451,Ethan Bear,D,WSH,27,44,2,9,11
28,8477851,Jordan Oesterle,D,BOS,32,39,2,9,11
28,8481028,Martin Pospisil,C,CGY,25,42,9,1,10
28,8475842,Sam Carrick,C,NYR,32,60,8,2,10
28,8479328,Julien Gauthier,R,NYI,27,53,8,2,10
28,8482666,Scott Morrow,D,CAR,22,47,7,3,10
28,8479442,Troy Stecher,D,EDM,30,48,6,4,10
28,8476442,Matt Nieto,L,PIT,32,41,6,4,10
28,8480845,Rasmus Kupari,C,WPG,24,44,6,4,10
28,8482062,Cole Smith,L,NSH,29,51,5,5,10
28,8482730,Brandt Clarke,D,LAK,21,37,5,5,10
28,8481537,Nikita Okhotiuk,D,CGY,24,51,5,5,10
28,8477435,Ryan Graves,D,PIT,29,78,4,6,10
28,8479671,Mathieu Olivier,R,CBJ,27,46,4,6,10
28,8478831,Kevin Stenlund,C,UTA,28,55,4,6,10
28,8474612,Travis Hamonic,D,OTT,34,52,3,7,10
28,8482634,Alex Steeves,C,TOR,25,43,3,7,10
28,8481147,Reese Johnson,C,MIN,26,46,3,7,10
28,8470600,Ryan Suter,D,STL,39,59,2,8,10
28,8482861,Vincent Iorio,D,WSH,22,34,2,8,10
28,8474166,Alec Martinez,D,CHI,37,48,1,9,10
28,8478585,Derek Ryan,C,EDM,38,60,1,9,10
28,8474090,Brendan Smith,D,DAL,35,48,1,9,10
28,8479249,Andrew Poturalski,C,SJS,30,39,0,10,10
28,8479372,Joshua Mahura,D,SEA,26,52,0,10,10
28,8477070,Liam O'Brien,C,UTA,30,52,5,4,9
28,8476858,Phillip Di Giuseppe,L,VAN,31,38,5,4,9
28,8483630,Pavol Regenda,L,ANA,25,33,5,4,9
28,8478859,Niko Mikkola,D,FLA,28,52,4,5,9
28,8482784,Zach Dean,C,STL,21,38,4,5,9
28,8477482,Zachary Sanford,L,CHI,30,43,4,5,9
28,8483549,Lucas Condotta,L,MTL,27,39,4,5,9
28,8477962,Brendan Lemieux,L,CAR,28,36,3,6,9
28,8475958,Michael Sgarbossa,C,WSH,32,36,3,6,9
28,8481167,Brayden Pachal,D,CGY,25,51,1,8,9
28,8478468,Jeremy Lauzon,D,NSH,27,57,1,8,9
28,8475750,Jon Merrill,D,MIN,32,59,1,8,9
28,8480887,Jordan Harris,D,MTL,24,51,1,8,9
28,8484149,Gavin Brindley,C,CBJ,20,43,5,3,8
28,8481679,Maxence Guenette,D,OTT,23,38,5,3,8
28,8482511,Mason Lohrei,D,BOS,23,34,4,4,8
28,8482652,Walker Duehr,R,CGY,27,35,3,5,8
28,8480355,Mark Kastelic,C,BOS,25,61,3,5,8
28,8481754,Nikita Nesterenko,C,ANA,23,38,3,5,8
28,8479543,Michael Pezzetta,L,MTL,26,62,2,6,8
28,8476473,Connor Murphy,D,CHI,31,45,2,6,8
28,8479985,Cale Fleury,D,SEA,26,26,2,6,8
28,8475762,Derek Forbort,D,VAN,32,41,1,7,8
28,8477384,Joshua Brown,D,EDM,30,35,1,7,8
28,8476441,Joel Edmundson,D,LAK,31,48,0,8,8
28,8476372,Nick Seeler,D,PHI,31,41,0,8,8
28,8482659,Josh Doan,R,UTA,22,57,5,2,7
28,8481543,Nikita Alexandrov,C,STL,24,25,5,2,7
28,8483619,Filip Roos,D,OTT,25,32,5,2,7
28,8479981,Jonah Gadjovich,L,FLA,26,43,4,3,7
28,8474013,Ian Cole,D,UTA,35,50,4,3,7
28,8476952,Dominic Toninato,C,WPG,30,41,4,3,7
28,8476934,Brock McGinn,L,ANA,30,55,4,3,7
28,8481609,Vladislav Kolyachonok,D,UTA,23,34,4,3,7
28,8482744,James Malatesta,L,CBJ,21,46,3,4,7
28,8471677,Jack Johnson,D,CBJ,37,61,3,4,7
28,8475235,Nicolas Deslauriers,L,PHI,33,44,3,4,7
28,8480879,Jacob Bernard-Docker,D,OTT,24,46,3,4,7
28,8480848,Ty Dellandrea,C,SJS,24,44,3,4,7
28,8478424,Jansen Harkins,C,ANA,27,40,3,4,7
28,8482733,Logan Mailloux,D,MTL,31,34,3,4,7
28,8481122,Simon Benoit,D,TOR,26,46,2,5,7
28,8482747,Brennan Othmann,L,NYR,21,39,2,5,7
28,8480292,Carson Meyer,R,ANA,27,31,2,5,7
28,8481701,Santeri Hatakka,D,NJD,23,35,2,5,7
28,8481065,Angus Crookshank,L,OTT,25,19,2,5,7
28,8479324,Ryan Lindgren,D,NYR,26,54,1,6,7
28,8479359,Beck Malenstyn,L,BUF,26,49,1,6,7
28,8478454,Noah Juulsen,D,VAN,27,44,1,6,7
28,8477462,Robert Hagg,D,VGK,29,24,1,6,7
28,8475177,Calvin de Haan,D,COL,33,39,0,7,7
28,8479638,Justin Brazeau,R,BOS,26,38,6,0,6
28,8478146,Matthew Highmore,C,OTT,28,36,4,2,6
28,8483570,Ben Meyers,C,SEA,26,29,4,2,6
28,8482451,Mikael Pyyhtia,L,CBJ,23,40,3,3,6
28,8479968,Vinni Lettieri,C,BOS,29,46,3,3,6
28,8483763,Maksymilian Szuber,D,UTA,22,35,3,3,6
28,8481743,Marc Del Gaizo,D,NSH,25,25,3,3,6
28,8477320,Anton Blidh,L,NYR,29,20,3,3,6
28,8483466,Kevin Korchinski,D,CHI,20,54,2,4,6
28,8480727,Zach Whitecloud,D,VGK,28,47,2,4,6
28,8476867,Brendan Gaunce,C,MIN,30,35,2,4,6
28,8484911,Collin Graf,R,SJS,22,34,2,4,6
28,8480880,Jakub Lauko,C,MIN,24,33,2,4,6
28,8477244,Chad Ruhwedel,D,NYR,34,35,2,4,6
28,8481605,Jackson LaCombe,D,ANA,23,33,2,4,6
28,8480084,Nick DeSimone,D,NJD,30,18,2,4,6
28,8484254,Akito Hirose,D,VAN,25,35,1,5,6
28,8480796,Martin Fehervary,D,WSH,25,54,1,5,6
28,8482070,Mitchell Chaffee,R,TBL,26,41,1,5,6
28,8483012,Logan Morrison,C,SEA,22,37,1,5,6
28,8477401,John Hayden,C,SEA,29,31,1,5,6
28,8480196,Jacob Bryson,D,BUF,27,44,0,6,6
28,8483460,David Jiricek,D,CBJ,21,56,0,6,6
28,8481556,John Beecher,C,BOS,23,30,4,1,5
28,8481532,Alex Turcotte,C,LAK,23,43,4,1,5
28,8482145,Mavrik Bourque,C,DAL,22,46,4,1,5
28,8471817,Ryan Reaves,R,TOR,37,53,3,2,5
28,8482177,Marat Khusnutdinov,C,MIN,22,32,3,2,5
28,8477527,Ross Johnston,L,ANA,30,33,3,2,5
28,8482964,Arber Xhekaj,D,MTL,23,47,2,3,5
28,8482765,Isak Rosen,R,BUF,21,25,2,3,5
28,8480990,Declan Chisholm,D,MIN,24,41,2,3,5
28,8480441,Trey Fix-Wolansky,R,CBJ,25,38,1,4,5
28,8479994,Jaret Anderson-Dolan,C,WPG,25,37,1,4,5
28,8478021,William Lagesson,D,DET,28,31,1,4,5
28,8480834,Ty Emberson,D,SJS,24,33,0,5,5
28,8478477,Mitchell Stephens,C,SEA,27,21,0,5,5
28,8477034,Jaycob Megna,D,FLA,32,45,0,5,5
28,8481599,Victor Soderstrom,D,UTA,23,52,3,1,4
28,8480851,Akil Thomas,C,LAK,24,29,3,1,4
28,8482141,Lukas Cormier,D,VGK,22,33,3,1,4
28,8482713,Mackie Samoskevich,R,FLA,22,39,3,1,4
28,8480468,James Hamblin,L,EDM,25,20,3,1,4
28,8481237,Kyle MacLean,C,NYI,25,24,2,2,4
28,8483397,Marc McLaughlin,C,BOS,25,25,2,2,4
28,8476913,Devin Shore,C,MIN,30,39,2,2,4
28,8480007,Jonas Rondbjerg,R,VGK,25,45,2,2,4
28,8478502,Dennis Gilbert,D,BUF,28,19,2,2,4
28,8484304,Uvis Balinskis,D,FLA,28,10,2,2,4
28,8477887,Patrick Brown,C,BOS,32,46,1,3,4
28,8478017,Mark Friedman,D,VAN,29,34,1,3,4
28,8480890,Jan Jenik,C,OTT,24,21,1,3,4
28,8475795,Dylan McIlrath,D,WSH,32,24,1,3,4
28,8481056,Spencer Stastney,D,NSH,24,33,0,4,4
28,8479379,Givani Smith,R,SJS,26,30,0,4,4
28,8477335,Kyle Burroughs,D,LAK,29,50,0,4,4
28,8481593,Jayden Struble,D,MTL,23,21,0,4,4
28,8482172,Landon Slaggert,L,CHI,22,23,0,4,4
28,8475780,Chris Wagner,R,COL,33,9,2,1,3
28,8481043,Cole Koepke,L,BOS,26,18,2,1,3
28,8478409,Anthony Richard,C,PHI,28,28,2,1,3
28,8479367,William Lockwood,R,FLA,26,24,2,1,3
28,8482201,Gage Goncalves,C,TBL,23,34,2,1,3
28,8482787,Nikita Chibrikov,R,WPG,31,8,2,1,3
28,8480032,Shane Bowers,C,NJD,25,14,2,1,3
28,8480245,Olle Lycksell,R,PHI,25,30,1,2,3
28,8480267,Sammy Walker,C,MIN,25,15,1,2,3
28,8479320,Maxime Lajoie,D,SEA,27,20,1,2,3
28,8481541,Samuel Bolduc,D,NYI,24,27,1,2,3
28,8479991,Jake Leschyshyn,C,NYR,25,26,1,2,3
28,8482165,Yan Kuznetsov,D,CGY,22,19,1,2,3
28,8482118,Sam Colangelo,R,ANA,23,11,1,2,3
28,8481422,Jake Lucchini,C,NSH,29,22,1,2,3
28,8481655,Cole Schwindt,R,CGY,23,6,1,2,3
28,8482144,Jack Thompson,D,SJS,22,17,0,3,3
28,8480870,Bo Groulx,C,NYR,24,28,0,3,3
28,8482088,Justin Sourdif,R,FLA,22,19,0,3,3
28,8481699,Aku Raty,R,UTA,23,18,0,3,3
28,8477993,Justin Kirkland,C,CGY,28,12,0,3,3
28,8474062,Riley Nash,C,NYR,35,21,0,3,3
28,8477467,Gustav Olofsson,D,SEA,30,22,0,3,3
28,8482094,Daemon Hunt,D,MIN,22,21,0,3,3
28,8484325,Waltteri Merela,C,TBL,26,25,2,0,2
28,8480844,Grigori Denisenko,L,VGK,24,23,1,1,2
28,8482102,Vasily Ponomarev,C,PIT,22,18,1,1,2
28,8482470,Ilya Solovyov,D,CGY,24,16,1,1,2
28,8477810,Joel Hanley,D,CGY,33,19,1,1,2
28,8482929,Emil Lilleberg,D,TBL,23,18,1,1,2
28,8479419,Brett Murray,L,BUF,26,18,1,1,2
28,8481578,Graeme Clarke,R,MIN,23,13,1,1,2
28,8483567,Georgii Merkulov,C,BOS,24,13,1,1,2
28,8477473,Justin Bailey,R,SJS,29,26,0,2,2
28,8482250,Callahan Burke,C,VGK,27,18,0,2,2
28,8479587,Rhett Gardner,C,PHI,28,17,0,2,2
28,8477971,Andreas Englund,D,LAK,28,32,0,2,2
28,8482147,Jean-Luc Foudy,C,COL,22,26,0,2,2
28,8484287,Cole McWard,D,VAN,23,22,0,2,2
28,8478881,Brett Seney,L,CHI,28,10,0,2,2
28,8481030,Jack St. Ivany,D,PIT,25,14,0,2,2
28,8480823,Alexander Alexeyev,D,WSH,25,15,0,2,2
28,8480874,Adam Ginning,D,PHI,24,10,0,2,2
28,8477149,Scott Sabourin,R,SJS,32,12,0,2,2
28,8482061,Brandon Biro,L,SEA,26,12,0,2,2
28,8478011,Louie Belpedio,D,PHI,28,21,0,2,2
28,8475413,Justin Dowling,C,NJD,34,12,0,2,2
28,8484258,Sam Malinski,D,COL,26,19,1,0,1
28,8481006,Tyler Tucker,D,STL,24,14,1,0,1
28,8481462,Mason Morelli,L,VGK,28,14,1,0,1
28,8482197,Adam Raska,R,MIN,23,10,1,0,1
28,8475755,Alexander Petrovic,D,DAL,32,13,1,0,1
28,8479362,Riley Tufte,L,BOS,26,12,1,0,1
28,8483471,Brad Lambert,C,WPG,31,6,1,0,1
28,8483398,Declan Carlile,D,TBL,31,8,1,0,1
28,8481585,Egor Afanasyev,L,SJS,23,11,1,0,1
28,8481600,Tobias Bjornfot,D,FLA,23,43,0,1,1
28,8482153,Brendan Brisson,C,VGK,23,24,0,1,1
28,8478051,Max Willman,C,NJD,29,9,0,1,1
28,8478446,Glenn Gawdin,C,LAK,27,13,0,1,1
28,8477541,Dakota Mermis,D,TOR,30,9,0,1,1
28,8482858,Ryker Evans,D,SEA,23,20,0,1,1
28,8481806,Louis Crevier,D,CHI,23,10,0,1,1
28,8482516,Matthew Kessel,D,STL,24,15,0,1,1
28,8481719,Maxwell Crozier,D,TBL,24,7,0,1,1
28,8477073,Kurtis MacDermid,L,NJD,30,25,0,1,1
28,8481206,John Ludvig,D,PIT,24,7,0,1,1
28,8481564,Ryan Johnson,D,BUF,23,18,0,1,1
28,8483407,Brandon Scanlin,D,NYR,25,7,0,1,1
28,8483395,Arshdeep Bains,L,VAN,23,6,0,0,0
28,8483489,Fraser Minten,C,TOR,31,9,0,0,0
28,8482476,Emil Heineman,L,MTL,23,4,0,0,0
28,8481024,Linus Karlsson,C,VAN,25,7,0,0,0
28,8483512,Matthew Savoie,C,EDM,20,20,0,0,0
28,8478147,Bokondji Imama,L,PIT,28,2,0,0,0
28,8479522,Hardy Haman Aktell,D,WSH,26,4,0,0,0
28,8483920,Pierrick Dube,R,WSH,23,4,0,0,0
28,8479421,Jacob Moverare,D,LAK,26,5,0,0,0
28,8483432,Luca Del Bel Belluz,C,CBJ,31,4,0,0,0
28,8482460,Matt Rempe,C,NYR,22,13,0,0,0
28,8476323,Max McCormick,L,SEA,32,3,0,0,0
28,8482126,Emil Andrae,D,PHI,31,3,0,0,0
28,8483597,Milos Kelemen,L,UTA,25,12,0,0,0
28,8481726,Adam Edstrom,C,NYR,24,8,0,0,0
28,8483401,Marc Johnstone,R,PIT,28,1,0,0,0
28,8482162,Roby Jarventie,L,EDM,22,11,0,0,0
28,8478854,Ryan Shea,D,PIT,27,6,0,0,0
28,8480075,Cameron Crotty,D,MIN,25,5,0,0,0
28,8484326,Patrik Koch,D,UTA,28,3,0,0,0
28,8483609,Adam Klapka,R,CGY,24,3,0,0,0
28,8483531,Brian Halonen,L,NJD,25,2,0,0,0
28,8480306,Grant Hutton,D,NYI,29,9,0,0,0
28,8484255,Jason Polin,R,COL,25,4,0,0,0
28,8479330,Brandon Gignac,C,MTL,27,10,0,0,0
28,8483546,Marshall Rifai,D,TOR,26,3,0,0,0
28,8484259,Ondrej Pavel,C,COL,31,3,0,0,0
28,8480274,Philip Kemp,D,EDM,25,1,0,0,0
28,8484321,Nikolas Matinpalo,D,OTT,26,0,0,0,0
28,8481534,Raphael Lavoie,C,EDM,24,1,0,0,0
28,8470794,Joe Pavelski,C,,40,0,0,0,0
28,8479321,Lucas Johansen,D,,27,0,0,0,0
28,8477950,Tony DeAngelo,D,,29,0,0,0,0
28,8471218,Blake Wheeler,R,,38,0,0,0,0
28,8475197,Tyson Barrie,D,,33,0,0,0,0
28,8474157,Max Pacioretty,L,,36,0,0,0,0
28,8475744,Evgeny Kuznetsov,C,,32,0,0,0,0
28,8474037,James van Riemsdyk,L,,35,0,0,0,0
28,8476907,Mackenzie MacEachern,L,,30,0,0,0,0
28,8480216,Jacob Peterson,C,,25,0,0,0,0
28,8474602,Justin Schultz,D,,34,0,0,0,0
28,8482222,Alexander Barabanov,L,,30,0,0,0,0
28,8474031,Kevin Shattenkirk,D,,35,0,0,0,0
28,8477330,Dominik Kubalik,L,,29,0,0,0,0
28,8480884,Calen Addison,D,,24,0,0,0,0
28,8475906,John Klingberg,D,,32,0,0,0,0
28,8480008,Adam Ruzicka,C,,25,0,0,0,0
28,8476884,Derrick Pouliot,D,,30,0,0,0,0
28,8476919,Chris Tierney,C,,30,0,0,0,0
28,8479415,Michael McLeod,C,,26,0,0,0,0
28,8474870,Tyler Johnson,C,,34,0,0,0,0
28,8470604,Jeff Carter,C,,39,0,0,0,0
28,8478104,Sammy Blais,L,,28,0,0,0,0
28,8474884,Mike Hoffman,C,,35,0,0,0,0
28,8481591,Sam Poulin,R,,23,0,0,0,0
28,8471274,Alex Goligoski,D,,39,0,0,0,0
28,8476871,Tanner Pearson,L,,32,0,0,0,0
28,8476393,Nick Cousins,C,,31,0,0,0,0
28,8479977,Kailer Yamamoto,R,,26,0,0,0,0
28,8479346,Dillon Dube,C,,26,0,0,0,0
28,8480184,Gustav Lindstrom,D,,26,0,0,0,0
28,8479376,Victor Mete,D,,26,0,0,0,0
28,8473449,Kyle Okposo,R,,36,0,0,0,0
28,8481058,Jesse Ylonen,R,,25,0,0,0,0
28,8475752,Tyler Pitlick,C,,33,0,0,0,0
28,8481239,Samuel Fagemo,L,,24,0,0,0,0
28,8480821,Filip Zadina,R,,25,0,0,0,0
28,8470966,Mark Giordano,D,,41,0,0,0,0
28,8478495,Denis Gurianov,R,,27,0,0,0,0
28,8477464,Nic Petan,C,,29,0,0,0,0
28,8478099,Kevin Labanc,R,,29,0,0,0,0
28,8482241,Radim Zohorna,L,,28,0,0,0,0
28,8474040,Sam Gagner,C,,35,0,0,0,0
28,8479514,Rem Pitlick,C,,27,0,0,0,0
28,8478430,Oliver Kylington,D,,27,0,0,0,0
28,8479533,Joona Koppanen,L,,26,0,0,0,0
28,8479984,Cal Foote,D,,26,0,0,0,0
28,8477126,Jayson Megna,C,,34,0,0,0,0
28,8475164,Jakob Silfverberg,R,,34,0,0,0,0
28,8474009,Nick Bonino,C,,36,0,0,0,0
28,8479458,Nikita Zaitsev,D,,33,0,0,0,0
28,8477944,Jakub Vrana,L,,28,0,0,0,0
28,8471699,Andrew Cogliano,C,,37,0,0,0,0
28,8478067,Oskar Lindblom,L,,28,0,0,0,0
28,8471686,Marc Staal,D,,37,0,0,0,0
28,8470610,Zach Parise,L,,40,0,0,0,0
28,8478904,Steven Lorentz,C,,28,0,0,0,0
28,8473473,Milan Lucic,L,,36,0,0,0,0
28,8480031,Maxime Comtois,L,,25,0,0,0,0
28,8478512,Austin Czarnik,C,,32,0,0,0,0
28,8473504,Cal Clutterbuck,R,,37,0,0,0,0
28,8477454,Adam Erne,L,,29,0,0,0,0
28,8479383,Boris Katchouk,L,,26,0,0,0,0
28,8475825,Jani Hakanpää,D,,32,0,0,0,0
28,8477846,Ryan Carpenter,C,,33,0,0,0,0
28,8477930,Pierre-Edouard Bellemare,L,,39,0,0,0,0
28,8478400,Colin White,C,,27,0,0,0,0
28,8480226,Marián Studenic,R,,26,0,0,0,0
28,8480853,Liam Foudy,C,,24,0,0,0,0
28,8475797,Jarred Tinordi,D,,32,0,0,0,0
28,8479423,Alex Nylander,L,,26,0,0,0,0
28,8474618,Marco Scandella,D,,34,0,0,0,0
28,8478028,Fredrik Olofsson,L,,28,0,0,0,0
28,8474709,Matt Martin,L,,35,0,0,0,0
28,8481070,Hugh McGing,L,,26,0,0,0,0
28,8479546,Oskar Steen,C,,26,0,0,0,0
28,8474145,Robert Bortuzzo,D,,35,0,0,0,0
28,8476915,Jujhar Khaira,L,,30,0,0,0,0
28,8475278,Byron Froese,C,,33,0,0,0,0
28,8481812,Nikolai Knyzhov,D,,27,0,0,0,0
28,8478408,Travis Dermott,D,,28,0,0,0,0
28,8481077,John Leonard,L,,26,0,0,0,0
28,8479547,Matthew Phillips,R,,26,0,0,0,0
28,8480836,Jonathan Gruden,C,,24,0,0,0,0
28,8481690,Tyler Angle,C,,24,0,0,0,0
28,8475766,Austin Watson,L,,32,0,0,0,0
28,8481016,Ruslan Iskhakov,C,,24,0,0,0,0
28,8478078,Rourke Chartier,C,,28,0,0,0,0
28,8480776,Sheldon Rempal,R,,29,0,0,0,0
28,8478956,Samuel Laberge,L,NJD,27,2,0,0,0
28,8483045,Cameron Butler,R,CBJ,31,0,0,0,0
28,8484314,Jiri Smejkal,L,,28,0,0,0,0
29,8476453,Nikita Kucherov,R,TBL,31,82,39,98,137
29,8477492,Nathan MacKinnon,C,COL,29,81,48,83,131
29,8478402,Connor McDavid,C,EDM,27,78,27,102,129
29,8477956,David Pastrnak,R,BOS,28,82,58,66,124
29,8479318,Auston Matthews,C,TOR,27,78,66,51,117
29,8478483,Mitch Marner,R,TOR,27,74,40,72,112
29,8477939,William Nylander,R,TOR,28,79,44,64,108
29,8480027,Jason Robertson,L,DAL,25,81,34,73,107
29,8478420,Mikko Rantanen,R,COL,28,82,49,57,106
29,8481559,Jack Hughes,C,NJD,23,73,42,64,106
29,8477934,Leon Draisaitl,C,EDM,29,74,38,68,106
29,8480023,Robert Thomas,C,STL,25,77,28,77,105
29,8477933,Sam Reinhart,C,FLA,29,81,55,47,102
29,8477946,Dylan Larkin,C,DET,28,82,47,52,99
29,8478403,Jack Eichel,C,VGK,28,79,42,57,99
29,8479314,Matthew Tkachuk,L,FLA,27,76,39,60,99
29,8478445,Mathew Barzal,C,NYI,27,82,26,73,99
29,8478550,Artemi Panarin,L,NYR,33,76,39,58,97
29,8477942,Kevin Fiala,L,LAK,28,82,37,59,96
29,8477493,Aleksander Barkov,C,FLA,29,81,25,69,94
29,8480069,Cale Makar,D,COL,26,69,24,70,94
29,8480012,Elias Pettersson,C,VAN,26,74,37,56,93
29,8478427,Sebastian Aho,C,CAR,27,74,47,44,91
29,8478010,Brayden Point,C,TBL,28,82,41,48,89
29,8477409,Carter Verhaeghe,C,FLA,29,76,40,49,89
29,8476389,Vincent Trocheck,C,NYR,31,79,31,58,89
29,8480002,Nico Hischier,C,NJD,25,76,44,44,88
29,8477404,Jake Guentzel,C,TBL,30,81,42,46,88
29,8477960,Adrian Kempe,R,LAK,28,81,39,49,88
29,8476468,J.T. Miller,C,VAN,31,73,33,55,88
29,8482116,Tim Stützle,C,OTT,22,79,38,49,87
29,8477951,Nick Schmaltz,C,UTA,28,80,29,58,87
29,8474600,Roman Josi,D,NSH,34,74,24,63,87
29,8474564,Steven Stamkos,C,NSH,34,74,33,53,86
29,8479385,Jordan Kyrou,C,STL,26,79,35,50,85
29,8471214,Alex Ovechkin,L,WSH,39,76,43,41,84
29,8480800,Quinn Hughes,D,VAN,25,71,10,74,84
29,8478864,Kirill Kaprizov,L,MIN,27,75,32,50,82
29,8476887,Filip Forsberg,L,NSH,30,72,36,45,81
29,8479343,Clayton Keller,R,UTA,26,76,39,41,80
29,8474141,Patrick Kane,R,DET,36,80,27,53,80
29,8473419,Brad Marchand,L,BOS,36,76,26,54,80
29,8480865,Noah Dobson,D,NYI,24,81,15,65,80
29,8475810,Bryan Rust,R,PIT,32,72,40,39,79
29,8475166,John Tavares,C,TOR,34,77,31,48,79
29,8478398,Kyle Connor,L,WPG,28,77,38,40,78
29,8475172,Nazem Kadri,C,CGY,34,77,31,47,78
29,8476454,Ryan Nugent-Hopkins,C,EDM,31,77,26,52,78
29,8476346,Johnny Gaudreau,L,CBJ,31,68,22,56,78
29,8479407,Jesper Bratt,L,NJD,26,74,21,57,78
29,8474578,Erik Karlsson,D,PIT,34,79,16,62,78
29,8475184,Chris Kreider,L,NYR,33,78,37,40,77
29,8480208,Drake Batherson,R,OTT,26,80,32,45,77
29,8476459,Mika Zibanejad,C,NYR,31,78,29,48,77
29,8475167,Victor Hedman,D,TBL,34,81,18,58,76
29,8479420,Tage Thompson,C,BUF,27,75,43,32,75
29,8479542,Brandon Hagel,L,TBL,26,82,35,40,75
29,8477402,Pavel Buchnevich,L,STL,29,76,28,47,75
29,8481540,Cole Caufield,R,MTL,23,73,41,33,74
29,8479337,Alex DeBrincat,R,DET,27,80,25,49,74
29,8480018,Nick Suzuki,C,MTL,25,77,19,55,74
29,8477500,Bo Horvat,C,NYI,29,79,43,30,73
29,8478439,Travis Konecny,R,PHI,27,76,33,40,73
29,8478449,Roope Hintz,C,DAL,28,81,36,36,72
29,8473512,Claude Giroux,R,OTT,36,77,22,50,72
29,8479323,Adam Fox,D,NYR,26,74,17,55,72
29,8480036,Miro Heiskanen,D,DAL,25,77,15,57,72
29,8471675,Sidney Crosby,C,PIT,37,71,33,38,71
29,8482665,Matty Beniers,C,SEA,22,77,27,43,70
29,8482740,Wyatt Johnston,C,DAL,21,80,30,38,68
29,8477416,Oliver Bjorkstrand,R,SEA,29,74,30,38,68
29,8477496,Elias Lindholm,C,BOS,30,78,27,41,68
29,8481533,Trevor Zegras,C,ANA,23,73,24,44,68
29,8477949,Alex Tuch,R,BUF,28,75,16,52,68
29,8475754,Brock Nelson,C,NYI,33,80,37,30,67
29,8481557,Matt Boldy,L,MIN,23,70,29,38,67
29,8471685,Anze Kopitar,C,LAK,37,81,27,40,67
29,8477940,Nikolaj Ehlers,L,WPG,28,76,21,46,67
29,8482093,Seth Jarvis,C,CAR,22,74,36,30,66
29,8478366,Frank Vatrano,R,ANA,30,74,34,32,66
29,8475913,Mark Stone,R,VGK,32,78,28,38,66
29,8480830,Andrei Svechnikov,R,CAR,24,71,27,39,66
29,8476456,Jonathan Huberdeau,C,CGY,31,79,18,48,66
29,8476539,Jonathan Marchessault,R,NSH,34,78,33,32,65
29,8478444,Brock Boeser,R,VAN,27,78,26,39,65
29,8482745,Mason McTavish,C,ANA,21,75,25,40,65
29,8478440,Dylan Strome,C,WSH,27,70,22,43,65
29,8477501,Valeri Nichushkin,R,COL,29,79,36,28,64
29,8475158,Ryan O'Reilly,C,NSH,33,73,25,39,64
29,8478460,Zach Werenski,D,CBJ,27,80,16,48,64
29,8484153,Leo Carlsson,C,ANA,20,72,27,36,63
29,8484144,Connor Bedard,C,CHI,19,71,23,40,63
29,8474679,Gustav Nyquist,C,NSH,35,79,19,44,63
29,8476399,Blake Coleman,C,CGY,33,77,27,35,62
29,8478038,Devon Toews,D,COL,30,66,14,48,62
29,8475151,Kyle Palmieri,C,NYI,33,74,35,26,61
29,8480801,Brady Tkachuk,L,OTT,25,79,27,34,61
29,8475692,Mats Zuccarello,R,MIN,37,74,19,42,61
29,8480839,Rasmus Dahlin,D,BUF,24,76,18,43,61
29,8475726,Tyler Toffoli,C,SJS,32,74,37,23,60
29,8480039,Martin Necas,C,CAR,25,72,24,36,60
29,8478873,Troy Terry,R,ANA,27,72,19,41,60
29,8481528,Dylan Cozens,C,BUF,23,74,16,44,60
29,8476853,Morgan Rielly,D,TOR,30,67,5,55,60
29,8477955,Jared McCann,L,SEA,28,74,31,28,59
29,8475784,Jeff Skinner,C,EDM,32,74,30,29,59
29,8482124,Quinton Byfield,R,LAK,22,79,24,35,59
29,8473994,Jamie Benn,L,DAL,35,80,21,38,59
29,8477503,Max Domi,C,TOR,29,78,17,42,59
29,8476905,Chandler Stephenson,C,SEA,30,73,16,43,59
29,8476882,Teuvo Teravainen,C,CHI,30,69,23,35,58
29,8478519,Anthony Cirelli,C,TBL,27,82,21,37,58
29,8478975,Mason Marchment,L,DAL,29,81,20,38,58
29,8478047,Michael Bunting,L,PIT,29,73,19,39,58
29,8476792,Torey Krug,D,STL,33,75,16,42,58
29,8475168,Matt Duchene,C,DAL,33,82,31,26,57
29,8478493,Joel Eriksson Ek,C,MIN,27,64,30,27,57
29,8476460,Mark Scheifele,C,WPG,31,73,20,37,57
29,8475765,Vladimir Tarasenko,R,DET,33,79,16,41,57
29,8475798,Mikael Granlund,C,SJS,32,69,14,43,57
29,8481068,Yegor Sharangovich,C,CGY,26,78,30,26,56
29,8480014,Gabriel Vilardi,C,WPG,25,67,30,26,56
29,8478856,Conor Garland,R,VAN,28,72,29,27,56
29,8474102,David Perron,L,OTT,36,80,27,29,56
29,8481596,Shane Pinto,C,OTT,24,74,20,36,56
29,8475745,Charlie Coyle,C,BOS,32,77,17,39,56
29,8474590,John Carlson,D,WSH,34,70,8,48,56
29,8478414,Timo Meier,R,NJD,28,76,31,24,55
29,8478401,Pavel Zacha,C,BOS,27,80,23,32,55
29,8477964,Ivan Barbashev,C,VGK,29,76,23,32,55
29,8478042,Viktor Arvidsson,L,EDM,31,74,21,34,55
29,8476479,Phillip Danault,C,LAK,31,80,19,36,55
29,8478469,Thomas Chabot,D,OTT,27,78,11,44,55
29,8477476,Artturi Lehkonen,L,COL,29,80,22,32,54
29,8480803,Evan Bouchard,D,EDM,25,75,12,42,54
29,8483808,Andrei Kuzmenko,L,CGY,28,74,27,26,53
29,8475794,Tyler Seguin,C,DAL,32,82,24,29,53
29,8482720,Matthew Knies,L,TOR,22,79,23,30,53
29,8473986,Alex Killorn,L,ANA,35,67,22,31,53
29,8475191,Reilly Smith,R,NYR,33,72,19,34,53
29,8477511,Anthony Mantha,R,CGY,30,78,18,35,53
29,8475170,Brayden Schenn,C,STL,33,74,15,38,53
29,8476906,Shayne Gostisbehere,D,CAR,31,78,9,44,53
29,8480015,Owen Tippett,R,PHI,25,75,21,31,52
29,8477497,Sean Monahan,C,CBJ,30,69,20,32,52
29,8479987,Morgan Geekie,C,BOS,26,78,18,34,52
29,8479999,Casey Mittelstadt,C,COL,26,81,17,35,52
29,8478407,Vince Dunn,D,SEA,28,70,13,39,52
29,8479425,Filip Hronek,D,VAN,27,72,13,39,52
29,8476875,Mike Matheson,D,MTL,30,75,7,45,52
29,8482684,Luke Hughes,D,NJD,21,78,5,47,52
29,8476880,Tom Wilson,R,WSH,30,73,26,25,51
29,8476881,Tomas Hertl,C,VGK,31,77,23,28,51
29,8479675,Trevor Moore,L,LAK,29,82,19,32,51
29,8477451,Ryan Hartman,R,MIN,30,71,19,32,51
29,8478466,Daniel Sprong,R,VAN,27,71,18,33,51
29,8477494,Jonathan Drouin,L,COL,29,79,13,38,51
29,8478397,Rasmus Andersson,D,CGY,28,74,10,41,51
29,8470613,Brent Burns,D,CAR,39,76,8,43,51
29,8484166,Adam Fantilli,C,CBJ,20,67,24,26,50
29,8480009,Eeli Tolvanen,R,SEA,25,67,22,28,50
29,8477407,Anthony Duclair,L,NYI,29,78,21,29,50
29,8481577,Philip Tomasino,C,NSH,23,68,19,31,50
29,8476458,Ryan Strome,C,ANA,31,72,15,35,50
29,8482109,Alexis Lafrenière,L,NYR,23,71,30,19,49
29,8482078,Lucas Raymond,L,DET,22,81,24,25,49
29,8483431,Logan Cooley,C,UTA,20,70,23,26,49
29,8471215,Evgeni Malkin,C,PIT,38,73,22,27,49
29,8482699,Dylan Guenther,R,UTA,21,74,20,29,49
29,8477021,Alex Kerfoot,C,UTA,30,71,20,29,49
29,8477504,Josh Morrissey,D,WPG,29,69,11,38,49
29,8475786,Zach Hyman,L,EDM,32,73,26,22,48
29,8480064,Josh Norris,C,OTT,25,76,25,23,48
29,8481560,Arthur Kaliyev,R,LAK,23,77,21,27,48
29,8480028,Morgan Frost,C,PHI,25,69,19,29,48
29,8482055,Drew O'Connor,L,PIT,26,65,28,19,47
29,8484145,Zach Benson,L,BUF,19,62,25,22,47
29,8476483,Rickard Rakell,R,PIT,31,72,24,23,47
29,8474150,Mikael Backlund,C,CGY,35,76,18,29,47
29,8483515,Juraj Slafkovsky,L,MTL,20,70,18,29,47
29,8482159,Tyson Foerster,R,PHI,22,77,18,29,47
29,8474565,Alex Pietrangelo,D,VGK,34,65,9,38,47
29,8481554,Kaapo Kakko,R,NYR,23,67,22,24,46
29,8477456,J.T. Compher,L,DET,29,76,21,25,46
29,8476448,William Karlsson,C,VGK,31,76,19,27,46
29,8477986,Brandon Montour,D,SEA,30,71,16,30,46
29,8481711,Matias Maccelli,L,UTA,24,73,11,35,46
29,8471724,Kris Letang,D,PIT,37,81,7,39,46
29,8480220,Noah Cates,L,PHI,25,69,18,27,45
29,8482113,Anton Lundell,C,FLA,23,72,16,29,45
29,8476872,Scott Laughton,C,PHI,30,70,12,33,45
29,8474563,Drew Doughty,D,LAK,35,77,8,37,45
29,8478542,Evan Rodrigues,C,FLA,31,76,23,21,44
29,8475799,Nino Niederreiter,R,WPG,32,66,19,25,44
29,8477444,Andre Burakovsky,L,SEA,29,73,16,28,44
29,8482660,Kent Johnson,C,CBJ,22,61,15,29,44
29,8480185,Eetu Luostarinen,C,FLA,26,74,14,30,44
29,8478458,John (Jack) Roslovic,C,CAR,27,70,12,32,44
29,8479325,Charlie McAvoy,D,BOS,27,74,11,33,44
29,8479992,Michael Rasmussen,C,DET,25,79,24,19,43
29,8482089,Jake Neighbours,L,STL,22,68,24,19,43
29,8476438,Brandon Saad,L,STL,32,68,23,20,43
29,8477429,Andrew Copp,C,DET,30,75,22,21,43
29,8474641,Adam Henrique,C,EDM,34,78,21,22,43
29,8481604,Pavel Dorofeyev,L,VGK,24,75,20,23,43
29,8479525,Ross Colton,C,COL,28,80,19,24,43
29,8482097,Jack Quinn,R,BUF,23,65,18,25,43
29,8475768,Jaden Schwartz,C,SEA,32,76,17,26,43
29,8480078,Filip Chytil,C,NYR,25,63,16,27,43
29,8481656,Aliaksei Protas,C,WSH,23,70,16,27,43
29,8482149,Cole Perfetti,C,WPG,22,57,14,29,43
29,8477935,Sam Bennett,C,FLA,28,78,13,30,43
29,8482667,William Eklund,L,SJS,22,66,13,30,43
29,8475764,Cam Fowler,D,ANA,33,70,9,34,43
29,8479365,Trent Frederic,C,BOS,26,78,22,20,42
29,8475314,Anders Lee,L,NYI,34,78,21,21,42
29,8478474,Lawson Crouse,L,UTA,27,73,21,21,42
29,8476925,Colton Sissons,C,NSH,31,70,21,21,42
29,8479400,Pierre-Luc Dubois,L,WSH,26,68,20,22,42
29,8482110,Dawson Mercer,C,NJD,23,68,19,23,42
29,8481524,Bowen Byram,D,BUF,23,71,17,25,42
29,8478233,Andrew Mangiapane,L,WSH,28,67,17,25,42
29,8477495,Seth Jones,D,CHI,30,72,11,31,42
29,8474586,Jordan Eberle,R,SEA,34,72,21,20,41
29,8475722,Jason Zucker,L,BUF,32,64,18,23,41
29,8476826,Yanni Gourde,C,SEA,33,76,14,27,41
29,8475763,Kevin Hayes,R,PIT,32,72,14,27,41
29,8478115,Pierre Engvall,L,NYI,28,76,14,27,41
29,8478396,Noah Hanifin,D,VGK,27,61,11,30,41
29,8479410,Mikhail Sergachev,D,UTA,26,71,7,34,41
29,8475793,Ryan Johansen,C,PHI,32,72,24,16,40
29,8480188,Fabian Zetterlund,L,SJS,25,65,19,21,40
29,8478462,Nicolas Roy,C,VGK,27,73,19,21,40
29,8481186,Logan O'Connor,R,COL,28,76,19,21,40
29,8477932,Aaron Ekblad,D,FLA,28,69,12,28,40
29,8478438,Tommy Novak,C,NSH,27,69,10,30,40
29,8481546,Cam York,D,PHI,23,67,10,30,40
29,8482105,Jake Sanderson,D,OTT,22,75,8,32,40
29,8471698,T.J. Oshie,R,WSH,38,68,22,17,39
29,8478498,Jake DeBrusk,L,VAN,28,70,21,18,39
29,8477426,Nicholas Paul,L,TBL,29,81,21,18,39
29,8479591,Michael Eyssimont,C,TBL,28,82,17,22,39
29,8476419,Jean-Gabriel Pageau,C,NYI,32,74,16,23,39
29,8480459,Pius Suter,C,VAN,28,68,13,26,39
29,8480798,Philipp Kurashev,C,CHI,25,69,9,30,39
29,8480145,Neal Pionk,D,WPG,29,72,7,32,39
29,8478500,Ivan Provorov,D,CBJ,27,82,7,32,39
29,8477447,Shea Theodore,D,VGK,29,54,5,34,39
29,8482175,JJ Peterka,R,BUF,22,70,20,18,38
29,8480434,Sean Durzi,D,UTA,26,71,17,21,38
29,8481618,Alex Newhook,C,MTL,23,78,16,22,38
29,8476292,Ondrej Palat,L,NJD,33,68,16,22,38
29,8476480,Vladislav Namestnikov,C,WPG,32,70,16,22,38
29,8475287,Erik Haula,L,NJD,33,72,11,27,38
29,8475218,Mattias Ekholm,D,EDM,34,80,11,27,38
29,8477346,MacKenzie Weegar,D,CGY,30,76,10,28,38
29,8480336,Sean Walker,D,CAR,30,69,10,28,38
29,8476432,Boone Jenner,C,CBJ,31,66,23,14,37
29,8475169,Evander Kane,L,EDM,33,75,21,16,37
29,8479345,Jakob Chychrun,D,WSH,26,64,13,24,37
29,8481542,Moritz Seider,D,DET,23,73,7,30,37
29,8480893,Kirill Marchenko,R,CBJ,24,68,22,14,36
29,8473533,Jordan Staal,C,CAR,36,70,22,14,36
29,8478109,Victor Olofsson,L,VGK,29,72,21,15,36
29,8480797,Joel Farabee,L,PHI,24,77,16,20,36
29,8480849,Barrett Hayton,C,UTA,24,74,16,20,36
29,8483445,Cutter Gauthier,L,ANA,20,65,14,22,36
29,8477505,Alexander Wennberg,C,SJS,30,67,14,22,36
29,8477948,Travis Sanheim,D,PHI,28,72,3,33,36
29,8480817,K'Andre Miller,D,NYR,24,73,3,33,36
29,8479339,Patrik Laine,L,CBJ,26,66,16,19,35
29,8482702,Logan Stankoven,C,DAL,21,81,15,20,35
29,8476958,Jaccob Slavin,D,CAR,30,77,12,23,35
29,8477953,Kasperi Kapanen,R,STL,28,64,12,23,35
29,8482101,Danil Gushchin,L,SJS,22,62,12,23,35
29,8482133,Thomas Bordeleau,C,SJS,22,65,12,23,35
29,8478046,Danton Heinen,L,VAN,29,68,10,25,35
29,8478133,Jake Evans,C,MTL,28,66,10,25,35
29,8476462,Dougie Hamilton,D,NJD,31,66,8,27,35
29,8481703,Valtteri Puustinen,R,PIT,25,64,5,30,35
29,8476979,Erik Gustafsson,D,DET,32,79,2,33,35
29,8476474,Stefan Noesen,R,NJD,31,66,17,17,34
29,8477998,Warren Foegele,L,LAK,28,78,15,19,34
29,8477952,Robby Fabbri,C,ANA,28,61,15,19,34
29,8480813,Joe Veleno,C,DET,24,78,15,19,34
29,8483505,Matthew Poitras,C,BOS,20,74,14,20,34
29,8480068,Ryan Poehling,C,PHI,25,66,14,20,34
29,8478055,Gustav Forsling,D,FLA,28,73,12,22,34
29,8474149,Evgenii Dadonov,R,DAL,35,80,12,22,34
29,8474716,Jared Spurgeon,D,MIN,35,78,12,22,34
29,8482705,Cole Sillinger,C,CBJ,21,65,12,22,34
29,8475753,Justin Faulk,D,STL,32,72,11,23,34
29,8476927,Teddy Blueger,C,VAN,30,68,6,28,34
29,8476885,Jacob Trouba,D,NYR,30,69,5,29,34
29,8477406,Mattias Janmark,C,EDM,32,70,18,15,33
29,8479393,Noah Gregor,L,OTT,26,75,10,23,33
29,8477488,Brett Pesce,D,NJD,30,67,9,24,33
29,8481606,Jordan Spence,D,LAK,23,66,8,25,33
29,8479998,Mikey Anderson,D,LAK,25,59,6,27,33
29,8476469,Joel Armia,R,MTL,31,64,17,15,32
29,8475714,Calle Jarnkrok,C,TOR,33,75,15,17,32
29,8477989,Christian Dvorak,C,MTL,28,66,15,17,32
29,8476897,Oskar Sundqvist,C,STL,30,64,15,17,32
29,8479996,Cody Glass,C,NSH,25,60,13,19,32
29,8480835,Jack Drury,C,CAR,24,61,12,20,32
29,8476981,Josh Anderson,R,MTL,30,68,12,20,32
29,8475171,Oliver Ekman-Larsson,D,TOR,33,72,8,24,32
29,8478057,Dakota Joshua,C,VAN,28,71,17,14,31
29,8478020,Michael Amadio,R,OTT,28,72,15,16,31
29,8482475,Yegor Chinakhov,R,CBJ,23,59,14,17,31
29,8478463,Anthony Beauvillier,L,PIT,27,68,14,17,31
29,8475760,Nick Bjugstad,C,UTA,32,75,13,18,31
29,8475231,Casey Cizikas,C,NYI,33,74,11,20,31
29,8482671,Owen Power,D,BUF,22,67,10,21,31
29,8479293,Brandon Tanev,L,SEA,33,63,8,23,31
29,8480829,Jesperi Kotkaniemi,C,CAR,24,64,15,15,30
29,8477479,Tyler Bertuzzi,L,CHI,29,59,13,17,30
29,8482092,Ridly Greig,C,OTT,22,77,10,20,30
29,8476869,Brady Skjei,D,NSH,30,72,8,22,30
29,8476923,Damon Severson,D,CBJ,30,79,8,22,30
29,8477498,Darnell Nurse,D,EDM,29,67,8,22,30
29,8476892,Colton Parayko,D,STL,31,75,5,25,30
29,8482122,Brock Faber,D,MIN,22,79,3,27,30
29,8479316,Luke Kunin,C,SJS,27,58,16,13,29
29,8481523,Kirby Dach,C,MTL,23,71,13,16,29
29,8475848,Brendan Gallagher,R,MTL,32,66,11,18,29
29,8473422,Nick Foligno,L,CHI,37,58,8,21,29
29,8478970,Jalen Chatfield,D,CAR,28,75,7,22,29
29,8483490,Pavel Mintyukov,D,ANA,21,69,5,24,29
29,8478882,Vladislav Gavrikov,D,LAK,29,70,5,24,29
29,8477506,Ryan Pulock,D,NYI,30,75,3,26,29
29,8478507,John Marino,D,UTA,27,67,3,26,29
29,8478472,Mathieu Joseph,R,STL,27,74,16,12,28
29,8481553,Bobby Brink,R,PHI,23,65,15,13,28
29,8480113,Alex Iafallo,L,WPG,31,66,15,13,28
29,8475791,Taylor Hall,L,CHI,33,53,14,14,28
29,8482117,Lukas Reichel,L,CHI,22,56,9,19,28
29,8475200,Dmitry Orlov,D,CAR,33,72,8,20,28
29,8483565,Nick Blankenburg,D,NSH,26,61,8,20,28
29,8475149,Marcus Johansson,L,MIN,34,69,8,20,28
29,8477839,Conor Sheary,L,TBL,32,82,7,21,28
29,8477919,Frederick Gaudreau,C,MIN,31,63,7,21,28
29,8478851,Alexandre Carrier,D,NSH,28,64,6,22,28
29,8481535,Nils Hoglander,L,VAN,24,68,18,9,27
29,8482259,Bobby McMann,C,TOR,28,65,15,12,27
29,8478891,Mason Appleton,C,WPG,28,67,13,14,27
29,8482062,Cole Smith,L,NSH,29,56,13,14,27
29,8479941,Justin Danforth,R,CBJ,31,64,12,15,27
29,8476374,Sean Kuraly,C,CBJ,31,64,12,15,27
29,8474715,Cameron Atkinson,R,TBL,35,79,11,16,27
29,8477478,William Carrier,L,CAR,30,60,11,16,27
29,8479026,Philippe Myers,D,TOR,27,62,10,17,27
29,8480871,Adam Boqvist,D,FLA,24,71,8,19,27
29,8474151,Ryan McDonagh,D,TBL,35,72,6,21,27
29,8479639,Dylan Coghlan,D,WPG,26,66,6,21,27
29,8478013,Jake Walman,D,SJS,28,67,6,21,27
29,8480802,Ryan McLeod,C,BUF,25,65,4,23,27
29,8482245,Artem Zub,D,OTT,29,74,3,24,27
29,8480448,Parker Kelly,L,COL,25,76,12,14,26
29,8481032,Paul Cotter,C,NJD,25,65,11,15,26
29,8475193,Tomas Tatar,L,NJD,34,64,11,15,26
29,8481581,Thomas Harley,D,DAL,23,75,10,16,26
29,8477015,Connor Brown,R,EDM,30,63,10,16,26
29,8475181,Nick Leddy,D,STL,33,70,9,17,26
29,8477220,Nate Schmidt,D,FLA,33,73,6,20,26
29,8482067,Connor Mackey,D,NYR,28,71,5,21,26
29,8481178,Egor Zamula,D,PHI,24,59,4,22,26
29,8480035,Henri Jokiharju,D,BUF,25,62,4,22,26
29,8476917,Adam Pelech,D,NYI,30,79,3,23,26
29,8480246,Nick Perbix,D,TBL,26,74,2,24,26
29,8477450,Jason Dickinson,C,CHI,29,55,15,10,25
29,8479390,Taylor Raddysh,R,WSH,26,65,14,11,25
29,8480748,Kiefer Sherwood,L,VAN,29,60,13,12,25
29,8479439,Jacob MacDonald,D,COL,31,51,13,12,25
29,8477508,Curtis Lazar,C,NJD,29,65,12,13,25
29,8480281,Alexey Toropchenko,R,STL,25,51,12,13,25
29,8484203,Bradly Nadeau,L,CAR,19,61,9,16,25
29,8477947,Sonny Milano,L,WSH,28,58,8,17,25
29,8476461,Sean Couturier,C,PHI,32,67,8,17,25
29,8476902,Esa Lindell,D,DAL,30,73,3,22,25
29,8480873,Rasmus Sandin,D,WSH,24,66,3,22,25
29,8470621,Corey Perry,R,EDM,39,71,10,14,24
29,8477987,Ryan Donato,C,CHI,28,60,10,14,24
29,8476960,Andreas Athanasiou,C,CHI,30,54,9,15,24
29,8479351,Sam Steel,C,DAL,26,75,8,16,24
29,8478413,Jordan Greenway,L,BUF,27,61,8,16,24
29,8481441,Joe Snively,C,DET,28,66,8,16,24
29,8473563,Nicklas Backstrom,C,WSH,37,58,7,17,24
29,8477507,Nikita Zadorov,D,BOS,29,71,7,17,24
29,8476854,Hampus Lindholm,D,BOS,30,69,5,19,24
29,8481527,Kaedan Korczak,D,VGK,23,49,5,19,24
29,8479983,Mario Ferraro,D,SJS,26,68,3,21,24
29,8479398,Samuel Girard,D,COL,26,55,3,21,24
29,8475790,Erik Gudbranson,D,CBJ,32,76,3,21,24
29,8482712,Oskar Olausson,R,COL,22,80,2,22,24
29,8475188,Brayden McNabb,D,VGK,33,59,2,22,24
29,8477969,Marcus Pettersson,D,PIT,28,79,1,23,24
29,8479661,Tanner Jeannot,L,LAK,27,77,12,11,23
29,8480074,Alexandre Texier,C,STL,25,54,12,11,23
29,8479414,Nathan Bastian,R,NJD,27,63,10,13,23
29,8480003,Jesper Boqvist,C,FLA,26,72,10,13,23
29,8475855,Jesper Fast,R,CAR,33,61,10,13,23
29,8484149,Gavin Brindley,C,CBJ,20,47,9,14,23
29,8482809,Jackson Blake,R,CAR,21,50,8,15,23
29,8475343,Nic Dowd,C,WSH,34,65,6,17,23
29,8476525,Colin Miller,D,WPG,32,61,5,18,23
29,8476878,Zemgus Girgensons,C,TBL,30,82,15,7,22
29,8478043,Sam Lafferty,C,BUF,29,60,14,8,22
29,8482125,Alexander Holtz,R,VGK,22,68,13,9,22
29,8480762,Eric Robinson,L,CAR,29,57,11,11,22
29,8477979,Nicolas Aube-Kubel,R,BUF,28,60,11,11,22
29,8479619,Michael Carcone,L,UTA,28,60,11,11,22
29,8481013,Jonatan Berggren,R,DET,24,65,8,14,22
29,8476921,Jordan Martinook,L,CAR,32,53,7,15,22
29,8479353,Brett Howden,C,VGK,26,71,5,17,22
29,8479976,Juuso Valimaki,D,UTA,26,59,5,17,22
29,8482074,Connor Zary,C,CGY,23,60,13,8,21
29,8476918,Jimmy Vesey,L,NYR,31,67,13,8,21
29,8481582,Nicholas Robertson,L,TOR,23,68,12,9,21
29,8482146,Luke Evangelista,R,NSH,22,63,11,10,21
29,8483482,Tristan Luneau,D,ANA,20,62,11,10,21
29,8477425,Miles Wood,L,COL,29,77,9,12,21
29,8481580,Connor McMichael,C,WSH,23,58,9,12,21
29,8482737,Zack Bolduc,C,STL,21,50,9,12,21
29,8480806,Isac Lundestrom,C,ANA,25,63,9,12,21
29,8481093,Rafael Harvey-Pinard,L,MTL,25,57,8,13,21
29,8482749,Joshua Roy,R,MTL,21,62,7,14,21
29,8482655,Janis Moser,D,TBL,24,78,6,15,21
29,8480878,Nils Lundkvist,D,DAL,24,69,5,16,21
29,8480043,Timothy Liljegren,D,TOR,25,65,3,18,21
29,8476931,Jake McCabe,D,TOR,31,65,3,18,21
29,8482077,Dylan Holloway,L,EDM,23,55,13,7,20
29,8479368,Max Jones,L,BOS,26,68,10,10,20
29,8480995,Pontus Holmberg,R,TOR,25,60,10,10,20
29,8480855,Jack McBain,C,UTA,24,66,10,10,20
29,8482111,Justin Barron,D,MTL,23,65,9,11,20
29,8476392,Adam Lowry,C,WPG,31,67,8,12,20
29,8477070,Liam O'Brien,C,UTA,30,51,8,12,20
29,8475220,Marcus Foligno,L,MIN,33,56,7,13,20
29,8480860,Kevin Bahl,D,CGY,24,53,5,15,20
29,8483457,Lane Hutson,D,MTL,20,66,5,15,20
29,8476422,Mike Reilly,D,NYI,31,77,5,15,20
29,8482142,Jamie Drysdale,D,PHI,22,69,3,17,20
29,8479370,Tyson Jost,C,CAR,26,45,3,17,20
29,8476331,Dylan DeMelo,D,WPG,31,74,2,18,20
29,8476312,Josh Manson,D,COL,33,56,2,18,20
29,8481624,Ilya Mikheyev,R,CHI,30,53,14,5,19
29,8474189,Lars Eller,C,PIT,35,63,11,8,19
29,8476934,Brock McGinn,L,ANA,30,56,11,8,19
29,8481028,Martin Pospisil,C,CGY,25,52,10,9,19
29,8479359,Beck Malenstyn,L,BUF,26,57,10,9,19
29,8474053,Logan Couture,C,SJS,35,52,9,10,19
29,8481522,Peyton Krebs,C,BUF,23,58,7,12,19
29,8482624,Daniil Miromanov,D,CGY,27,65,7,12,19
29,8477353,Tyler Motte,C,DET,29,68,6,13,19
29,8479315,Joey Anderson,R,CHI,26,48,6,13,19
29,8480144,David Kampf,C,TOR,29,66,6,13,19
29,8477369,Carson Soucy,D,VAN,30,63,6,13,19
29,8482073,Braden Schneider,D,NYR,23,66,6,13,19
29,8473507,Jeff Petry,D,DET,37,71,5,14,19
29,8477392,Hudson Fasching,R,NYI,29,62,4,15,19
29,8482803,Olen Zellweger,D,ANA,21,64,4,15,19
29,8476467,Jamie Oleksiak,D,SEA,32,68,3,16,19
29,8478451,Ethan Bear,D,WSH,27,53,2,17,19
29,8478840,Will Borgen,D,SEA,28,63,1,18,19
29,8476429,Scott Mayfield,D,NYI,32,71,0,19,19
29,8482157,Will Cuylle,L,NYR,22,59,12,6,18
29,8480289,Morgan Barron,C,WPG,26,53,11,7,18
29,8483499,Liam Ohgren,L,MIN,20,62,10,8,18
29,8481641,Joel Kiviranta,L,COL,28,68,10,8,18
29,8482155,Alex Laferriere,R,LAK,23,56,9,9,18
29,8480355,Mark Kastelic,C,BOS,25,62,8,10,18
29,8483493,Frank Nazar,C,CHI,20,52,7,11,18
29,8477446,Michael McCarron,R,NSH,29,60,6,12,18
29,8476463,Jonas Brodin,D,MIN,31,77,5,13,18
29,8483495,Simon Nemec,D,NJD,20,62,5,13,18
29,8474574,Tyler Myers,D,VAN,34,67,3,15,18
29,8480222,Sebastian Aho,D,PIT,28,71,3,15,18
29,8479324,Ryan Lindgren,D,NYR,26,56,3,15,18
29,8476457,Adam Larsson,D,SEA,32,66,2,16,18
29,8476891,Matthew Grzelcyk,D,PIT,30,79,2,16,18
29,8481059,Scott Perunovich,D,STL,26,55,0,18,18
29,8482079,Marco Rossi,C,MIN,23,62,11,6,17
29,8477903,Garnet Hathaway,R,PHI,33,67,10,7,17
29,8476624,Barclay Goodrow,C,SJS,31,55,9,8,17
29,8478569,Noel Acciari,C,PIT,33,52,8,9,17
29,8476278,Colin Blackwell,C,DAL,31,79,8,9,17
29,8479066,Ryan Lomberg,L,CGY,30,55,7,10,17
29,8481517,Brett Leason,R,ANA,25,57,7,10,17
29,8475842,Sam Carrick,C,NYR,32,61,7,10,17
29,8480789,Oliver Wahlstrom,R,NYI,24,71,6,11,17
29,8482148,Hendrix Lapierre,C,WSH,22,50,6,11,17
29,8483491,Ivan Miroshnichenko,L,WSH,20,58,5,12,17
29,8482859,Zack Ostapchuk,C,OTT,21,54,5,12,17
29,8475462,Radko Gudas,D,ANA,34,66,4,13,17
29,8482192,Isaak Phillips,D,CHI,23,59,4,13,17
29,8475233,David Savard,D,MTL,34,65,4,13,17
29,8477365,Connor Clifton,D,BUF,29,58,3,14,17
29,8480049,Dylan Samberg,D,WPG,25,62,2,15,17
29,8479402,Jake Bean,D,CGY,26,69,1,16,17
29,8478508,Yakov Trenin,C,MIN,27,56,10,6,16
29,8473453,Trevor Lewis,C,LAK,37,70,10,6,16
29,8478585,Derek Ryan,C,EDM,38,60,10,6,16
29,8479328,Julien Gauthier,R,NYI,27,60,9,7,16
29,8479372,Joshua Mahura,D,SEA,26,53,8,8,16
29,8478432,Christian Fischer,R,DET,27,75,7,9,16
29,8475225,Craig Smith,C,CHI,35,55,7,9,16
29,8476856,Mathew Dumba,D,DAL,30,73,6,10,16
29,8482744,James Malatesta,L,CBJ,21,41,6,10,16
29,8479994,Jaret Anderson-Dolan,C,WPG,25,41,6,10,16
29,8480073,Erik Brannstrom,D,COL,25,62,5,11,16
29,8479291,Kevin Rooney,C,CGY,31,58,5,11,16
29,8471709,Marc-Edouard Vlasic,D,SJS,37,64,4,12,16
29,8477845,Trevor van Riemsdyk,D,WSH,33,54,4,12,16
29,8478136,Jake Middleton,D,MIN,28,75,3,13,16
29,8478416,Erik Cernak,D,TBL,27,71,3,13,16
29,8478178,Darren Raddysh,D,TBL,28,69,2,14,16
29,8479336,Carl Grundstrom,R,SJS,27,51,10,5,15
29,8479344,Jesse Puljujarvi,R,PIT,26,43,9,6,15
29,8478421,A.J. Greer,L,FLA,28,55,9,6,15
29,8480252,Cole Guttman,C,CHI,25,37,8,7,15
29,8480205,Emil Bemstrom,C,PIT,25,58,8,7,15
29,8475324,Nick Jensen,D,OTT,34,71,7,8,15
29,8483524,Shane Wright,C,SEA,20,63,6,9,15
29,8478434,Keegan Kolesar,R,VGK,27,59,6,9,15
29,8483466,Kevin Korchinski,D,CHI,20,53,6,9,15
29,8480007,Jonas Rondbjerg,R,VGK,25,37,6,9,15
29,8481019,David Gustafsson,C,WPG,24,49,5,10,15
29,8481521,Ronnie Attard,D,PHI,25,56,5,10,15
29,8481599,Victor Soderstrom,D,UTA,23,47,5,10,15
29,8475279,Ben Chiarot,D,DET,33,66,2,13,15
29,8482666,Scott Morrow,D,CAR,22,45,10,4,14
29,8477931,Tomas Nosek,L,FLA,32,61,9,5,14
29,8478831,Kevin Stenlund,C,UTA,28,55,9,5,14
29,8477573,Nathan Walker,L,STL,30,54,8,6,14
29,8482762,Simon Edvinsson,D,DET,21,57,8,6,14
29,8480011,Klim Kostin,C,SJS,25,48,7,7,14
29,8476994,Vinnie Hinostroza,C,NSH,30,43,7,7,14
29,8482166,Shakir Mukhamadullin,D,SJS,22,54,6,8,14
29,8481704,Juuso Parssinen,C,NSH,23,56,5,9,14
29,8476873,Mark Jankowski,C,NSH,30,41,5,9,14
29,8482095,Tyler Kleven,D,OTT,22,40,5,9,14
29,8479986,Kole Lind,R,DAL,26,55,5,9,14
29,8480980,Connor Dewar,C,TOR,25,68,5,9,14
29,8480172,Jan Rutta,D,SJS,34,67,4,10,14
29,8479348,Kale Clague,D,BUF,26,39,4,10,14
29,8480157,Calle Rosen,D,COL,30,59,4,10,14
29,8477435,Ryan Graves,D,PIT,29,74,4,10,14
29,8470600,Ryan Suter,D,STL,39,60,4,10,14
29,8480848,Ty Dellandrea,C,SJS,24,43,4,10,14
29,8475179,Dmitry Kulikov,D,FLA,34,59,3,11,14
29,8476967,Brett Kulak,D,EDM,30,60,2,12,14
29,8481568,Alex Vlasic,D,CHI,23,59,2,12,14
29,8478443,Brandon Carlo,D,BOS,28,60,2,12,14
29,8480192,Johnathan Kovacevic,D,NJD,27,44,2,12,14
29,8474166,Alec Martinez,D,CHI,37,48,2,12,14
29,8480807,Mattias Samuelsson,D,BUF,24,61,0,14,14
29,8481477,Nico Sturm,C,SJS,29,52,9,4,13
29,8476329,Travis Boyd,C,MIN,31,53,7,6,13
29,8477380,Jonny Brodzinski,C,NYR,31,54,7,6,13
29,8479520,Brandon Duhaime,R,WSH,27,50,6,7,13
29,8478211,Dryden Hunt,L,CGY,29,58,6,7,13
29,8481716,Dmitri Voronkov,L,CBJ,24,44,6,7,13
29,8481601,Simon Holmstrom,R,NYI,23,68,6,7,13
29,8482176,Wyatt Kaiser,D,CHI,22,50,5,8,13
29,8482730,Brandt Clarke,D,LAK,21,50,5,8,13
29,8479543,Michael Pezzetta,L,MTL,26,56,5,8,13
29,8476879,Cody Ceci,D,EDM,31,71,4,9,13
29,8481617,Vasily Podkolzin,R,VAN,23,51,4,9,13
29,8477018,Ben Hutton,D,VGK,31,55,4,9,13
29,8482451,Mikael Pyyhtia,L,CBJ,23,43,4,9,13
29,8471677,Jack Johnson,D,CBJ,37,62,3,10,13
29,8478911,Matt Roy,D,WSH,29,63,2,11,13
29,8475750,Jon Merrill,D,MIN,32,64,2,11,13
29,8476988,Matt Benning,D,SJS,30,61,1,12,13
29,8482807,Ethan Del Mastro,D,CHI,21,46,6,6,12
29,8474034,Patrick Maroon,L,CHI,36,51,6,6,12
29,8481592,Jakob Pelletier,L,CGY,23,36,6,6,12
29,8475718,Justin Holl,D,DET,32,61,4,8,12
29,8479442,Troy Stecher,D,EDM,30,56,4,8,12
29,8482087,Kaiden Guhle,D,MTL,22,63,3,9,12
29,8482679,Matt Coronato,R,CGY,22,65,3,9,12
29,8478399,Jonas Siegenthaler,D,NJD,27,58,3,9,12
29,8481751,Lukas Rousek,R,BUF,25,36,3,9,12
29,8481014,Alexander Romanov,D,NYI,24,76,2,10,12
29,8480001,Urho Vaakanainen,D,ANA,25,61,2,10,12
29,8480887,Jordan Harris,D,MTL,24,52,2,10,12
29,8483763,Maksymilian Szuber,D,UTA,22,39,2,10,12
29,8480796,Martin Fehervary,D,WSH,25,55,2,10,12
29,8479371,Dante Fabbro,D,NSH,26,60,1,11,12
29,8481537,Nikita Okhotiuk,D,CGY,24,52,1,11,12
29,8481701,Santeri Hatakka,D,NJD,23,34,1,11,12
29,8476874,Olli Maatta,D,DET,30,62,0,12,12
29,8478859,Niko Mikkola,D,FLA,28,54,0,12,12
29,8482659,Josh Doan,R,UTA,22,57,8,3,11
29,8481789,Tye Kartye,L,SEA,23,35,7,4,11
29,8483468,Jiri Kulich,C,BUF,20,49,6,5,11
29,8482784,Zach Dean,C,STL,21,43,6,5,11
29,8476822,Luke Glendening,C,TBL,35,73,5,6,11
29,8480292,Carson Meyer,R,ANA,27,29,4,7,11
29,8475455,Brenden Dillon,D,NJD,34,65,3,8,11
29,8481481,Blake Lizotte,C,PIT,27,66,2,9,11
29,8474013,Ian Cole,D,UTA,35,53,2,9,11
29,8474673,TJ Brodie,D,CHI,34,55,1,10,11
29,8480891,Michael Kesselring,D,UTA,24,52,1,10,11
29,8474567,Zach Bogosian,D,MIN,34,60,1,10,11
29,8480021,Jack Studnicka,C,LAK,25,64,7,3,10
29,8476858,Phillip Di Giuseppe,L,VAN,31,37,6,4,10
29,8481550,Adam Beckman,L,NJD,23,38,5,5,10
29,8475235,Nicolas Deslauriers,L,PHI,33,52,4,6,10
29,8479980,Nicolas Hague,D,VGK,26,53,3,7,10
29,8480070,Ian Mitchell,D,BOS,25,53,3,7,10
29,8475177,Calvin de Haan,D,COL,33,49,3,7,10
29,8477401,John Hayden,C,SEA,29,33,3,7,10
29,8474568,Luke Schenn,D,NSH,35,45,2,8,10
29,8480727,Zach Whitecloud,D,VGK,28,57,2,8,10
29,8483460,David Jiricek,D,CBJ,21,63,2,8,10
29,8480950,Ilya Lyubushkin,D,DAL,30,64,1,9,10
29,8478452,Caleb Jones,D,LAK,27,54,1,9,10
29,8475208,Brian Dumoulin,D,ANA,33,61,1,9,10
29,8475690,Chris Tanev,D,TOR,35,61,0,10,10
29,8479249,Andrew Poturalski,C,SJS,30,36,0,10,10
29,8482652,Walker Duehr,R,CGY,27,45,7,2,9
29,8476442,Matt Nieto,L,PIT,32,49,6,3,9
29,8481518,Nolan Foote,L,NJD,24,46,5,4,9
29,8480025,MacKenzie Entwistle,R,FLA,25,53,5,4,9
29,8479772,Zack MacEwen,R,OTT,28,54,5,4,9
29,8481532,Alex Turcotte,C,LAK,23,49,5,4,9
29,8477851,Jordan Oesterle,D,BOS,32,51,4,5,9
29,8482634,Alex Steeves,C,TOR,25,52,4,5,9
29,8478424,Jansen Harkins,C,ANA,27,44,4,5,9
29,8480870,Bo Groulx,C,NYR,24,32,4,5,9
29,8481567,Henry Thrun,D,SJS,23,51,3,6,9
29,8479378,Logan Stanley,D,WPG,26,43,3,6,9
29,8479638,Justin Brazeau,R,BOS,26,40,3,6,9
29,8482964,Arber Xhekaj,D,MTL,23,48,2,7,9
29,8481600,Tobias Bjornfot,D,FLA,23,39,2,7,9
29,8479536,Axel Jonsson-Fjallby,L,WPG,26,33,1,8,9
29,8479369,Andrew Peeke,D,BOS,26,57,1,8,9
29,8481605,Jackson LaCombe,D,ANA,23,39,0,9,9
29,8482496,Nils Aman,C,VAN,24,40,5,3,8
29,8480441,Trey Fix-Wolansky,R,CBJ,25,40,5,3,8
29,8479671,Mathieu Olivier,R,CBJ,27,49,4,4,8
29,8483549,Lucas Condotta,L,MTL,27,37,4,4,8
29,8481167,Brayden Pachal,D,CGY,25,39,4,4,8
29,8482861,Vincent Iorio,D,WSH,22,35,3,5,8
29,8481754,Nikita Nesterenko,C,ANA,23,37,3,5,8
29,8483397,Marc McLaughlin,C,BOS,25,29,3,5,8
29,8479944,Zach Aston-Reese,C,VGK,30,45,2,6,8
29,8476952,Dominic Toninato,C,WPG,30,40,2,6,8
29,8483570,Ben Meyers,C,SEA,26,30,2,6,8
29,8479968,Vinni Lettieri,C,BOS,29,50,2,6,8
29,8484911,Collin Graf,R,SJS,22,37,2,6,8
29,8480196,Jacob Bryson,D,BUF,27,34,2,6,8
29,8474090,Brendan Smith,D,DAL,35,53,1,7,8
29,8484254,Akito Hirose,D,VAN,25,36,1,7,8
29,8480058,Pierre-Olivier Joseph,D,STL,25,50,0,8,8
29,8476372,Nick Seeler,D,PHI,31,46,0,8,8
29,8480879,Jacob Bernard-Docker,D,OTT,24,43,0,8,8
29,8479718,Alex Barré-Boulet,C,MTL,27,46,4,3,7
29,8481679,Maxence Guenette,D,OTT,23,39,4,3,7
29,8471817,Ryan Reaves,R,TOR,37,57,4,3,7
29,8481161,Jake Christiansen,D,CBJ,25,50,3,4,7
29,8476441,Joel Edmundson,D,LAK,31,36,3,4,7
29,8480990,Declan Chisholm,D,MIN,24,35,3,4,7
29,8478017,Mark Friedman,D,VAN,29,39,3,4,7
29,8482172,Landon Slaggert,L,CHI,22,31,3,4,7
29,8480245,Olle Lycksell,R,PHI,25,32,3,4,7
29,8479972,Mason Shaw,C,WPG,26,28,2,5,7
29,8482751,Ryan Winterton,C,SEA,21,36,2,5,7
29,8481598,Philip Broberg,D,EDM,23,48,2,5,7
29,8477962,Brendan Lemieux,L,CAR,28,41,2,5,7
29,8475762,Derek Forbort,D,VAN,32,55,2,5,7
29,8477384,Joshua Brown,D,EDM,30,35,2,5,7
29,8482070,Mitchell Chaffee,R,TBL,26,44,2,5,7
29,8481237,Kyle MacLean,C,NYI,25,28,2,5,7
29,8482201,Gage Goncalves,C,TBL,23,32,2,5,7
29,8481708,Zac Jones,D,NYR,24,47,1,6,7
29,8473446,Erik Johnson,D,PHI,36,40,1,6,7
29,8478874,Adam Gaudette,R,OTT,28,41,1,6,7
29,8482165,Yan Kuznetsov,D,CGY,22,21,1,6,7
29,8482144,Jack Thompson,D,SJS,22,29,1,6,7
29,8479982,Conor Timmins,D,TOR,26,52,0,7,7
29,8482747,Brennan Othmann,L,NYR,21,40,5,1,6
29,8484258,Sam Malinski,D,COL,26,25,5,1,6
29,8477938,Haydn Fleury,D,WPG,28,45,4,2,6
29,8481147,Reese Johnson,C,MIN,26,47,4,2,6
29,8482141,Lukas Cormier,D,VGK,22,19,4,2,6
29,8478409,Anthony Richard,C,PHI,28,29,4,2,6
29,8484287,Cole McWard,D,VAN,23,22,4,2,6
29,8476889,Radek Faksa,C,STL,30,62,3,3,6
29,8481543,Nikita Alexandrov,C,STL,24,26,3,3,6
29,8481609,Vladislav Kolyachonok,D,UTA,23,29,3,3,6
29,8478021,William Lagesson,D,DET,28,23,3,3,6
29,8478468,Jeremy Lauzon,D,NSH,27,53,1,5,6
29,8477244,Chad Ruhwedel,D,NYR,34,32,1,5,6
29,8477034,Jaycob Megna,D,FLA,32,47,1,5,6
29,8481056,Spencer Stastney,D,NSH,24,35,1,5,6
29,8477335,Kyle Burroughs,D,LAK,29,42,1,5,6
29,8479576,Vincent Desharnais,D,VAN,28,37,0,6,6
29,8476913,Devin Shore,C,MIN,30,32,0,6,6
29,8479985,Cale Fleury,D,SEA,26,34,4,1,5
29,8480845,Rasmus Kupari,C,WPG,24,40,3,2,5
29,8483630,Pavol Regenda,L,ANA,25,26,3,2,5
29,8481743,Marc Del Gaizo,D,NSH,25,28,3,2,5
29,8483012,Logan Morrison,C,SEA,22,33,3,2,5
29,8477527,Ross Johnston,L,ANA,30,29,3,2,5
29,8482713,Mackie Samoskevich,R,FLA,22,43,3,2,5
29,8479379,Givani Smith,R,SJS,26,32,3,2,5
29,8481585,Egor Afanasyev,L,SJS,23,22,3,2,5
29,8474612,Travis Hamonic,D,OTT,34,51,2,3,5
29,8482733,Logan Mailloux,D,MTL,31,34,2,3,5
29,8481541,Samuel Bolduc,D,NYI,24,27,2,3,5
29,8477971,Andreas Englund,D,LAK,28,33,2,3,5
29,8481462,Mason Morelli,L,VGK,28,14,2,3,5
29,8476473,Connor Murphy,D,CHI,31,38,1,4,5
29,8481122,Simon Benoit,D,TOR,26,32,1,4,5
29,8478450,Parker Wotherspoon,D,BOS,27,29,0,5,5
29,8477320,Anton Blidh,L,NYR,29,29,3,1,4
29,8477499,Rasmus Ristolainen,D,PHI,30,56,2,2,4
29,8482145,Mavrik Bourque,C,DAL,22,47,2,2,4
29,8480468,James Hamblin,L,EDM,25,25,2,2,4
29,8479367,William Lockwood,R,FLA,26,23,2,2,4
29,8482470,Ilya Solovyov,D,CGY,24,22,2,2,4
29,8482516,Matthew Kessel,D,STL,24,14,2,2,4
29,8478454,Noah Juulsen,D,VAN,27,30,1,3,4
29,8480880,Jakub Lauko,C,MIN,24,40,1,3,4
29,8480834,Ty Emberson,D,SJS,24,31,1,3,4
29,8481699,Aku Raty,R,UTA,23,15,1,3,4
29,8482250,Callahan Burke,C,VGK,27,31,1,3,4
29,8481006,Tyler Tucker,D,STL,24,21,1,3,4
29,8479981,Jonah Gadjovich,L,FLA,26,45,0,4,4
29,8482765,Isak Rosen,R,BUF,21,27,0,4,4
29,8478881,Brett Seney,L,CHI,28,20,3,0,3
29,8482147,Jean-Luc Foudy,C,COL,22,23,2,1,3
29,8483512,Matthew Savoie,C,EDM,20,18,2,1,3
29,8475958,Michael Sgarbossa,C,WSH,32,25,1,2,3
29,8480267,Sammy Walker,C,MIN,25,12,1,2,3
29,8482118,Sam Colangelo,R,ANA,23,12,1,2,3
29,8478011,Louie Belpedio,D,PHI,28,14,1,2,3
29,8483471,Brad Lambert,C,WPG,31,11,1,2,3
29,8477073,Kurtis MacDermid,L,NJD,30,26,1,2,3
29,8484326,Patrik Koch,D,UTA,28,4,1,2,3
29,8480084,Nick DeSimone,D,NJD,30,18,0,3,3
29,8479991,Jake Leschyshyn,C,NYR,25,29,0,3,3
29,8481030,Jack St. Ivany,D,PIT,25,12,0,3,3
29,8482153,Brendan Brisson,C,VGK,23,28,0,3,3
29,8482088,Justin Sourdif,R,FLA,22,18,2,0,2
29,8477467,Gustav Olofsson,D,SEA,30,23,2,0,2
29,8482061,Brandon Biro,L,SEA,26,8,2,0,2
29,8478446,Glenn Gawdin,C,LAK,27,13,2,0,2
29,8482511,Mason Lohrei,D,BOS,23,28,1,1,2
29,8476867,Brendan Gaunce,C,MIN,30,28,1,1,2
29,8481556,John Beecher,C,BOS,23,33,1,1,2
29,8478477,Mitchell Stephens,C,SEA,27,15,1,1,2
29,8477887,Patrick Brown,C,BOS,32,40,1,1,2
29,8480890,Jan Jenik,C,OTT,24,23,1,1,2
29,8481593,Jayden Struble,D,MTL,23,24,1,1,2
29,8481655,Cole Schwindt,R,CGY,23,8,1,1,2
29,8474062,Riley Nash,C,NYR,35,18,1,1,2
29,8480844,Grigori Denisenko,L,VGK,24,25,1,1,2
29,8479419,Brett Murray,L,BUF,26,26,1,1,2
29,8475413,Justin Dowling,C,NJD,34,16,1,1,2
29,8479362,Riley Tufte,L,BOS,26,18,1,1,2
29,8481806,Louis Crevier,D,CHI,23,12,1,1,2
29,8481719,Maxwell Crozier,D,TBL,24,13,1,1,2
29,8481564,Ryan Johnson,D,BUF,23,7,1,1,2
29,8477462,Robert Hagg,D,VGK,29,20,0,2,2
29,8478502,Dennis Gilbert,D,BUF,28,17,0,2,2
29,8479320,Maxime Lajoie,D,SEA,27,20,0,2,2
29,8481422,Jake Lucchini,C,NSH,29,22,0,2,2
29,8482094,Daemon Hunt,D,MIN,22,16,0,2,2
29,8482929,Emil Lilleberg,D,TBL,23,27,0,2,2
29,8477473,Justin Bailey,R,SJS,29,20,0,2,2
29,8480823,Alexander Alexeyev,D,WSH,25,12,0,2,2
29,8477149,Scott Sabourin,R,SJS,32,10,0,2,2
29,8482858,Ryker Evans,D,SEA,23,24,0,2,2
29,8483407,Brandon Scanlin,D,NYR,25,4,0,2,2
29,8483597,Milos Kelemen,L,UTA,25,14,0,2,2
29,8483531,Brian Halonen,L,NJD,25,4,0,2,2
29,8483546,Marshall Rifai,D,TOR,26,4,0,2,2
29,8478146,Matthew Highmore,C,OTT,28,31,1,0,1
29,8482177,Marat Khusnutdinov,C,MIN,22,33,1,0,1
29,8480851,Akil Thomas,C,LAK,24,15,1,0,1
29,8481043,Cole Koepke,L,BOS,26,15,1,0,1
29,8480032,Shane Bowers,C,NJD,25,11,1,0,1
29,8484325,Waltteri Merela,C,TBL,26,20,1,0,1
29,8482102,Vasily Ponomarev,C,PIT,22,16,1,0,1
29,8481578,Graeme Clarke,R,MIN,23,12,1,0,1
29,8483567,Georgii Merkulov,C,BOS,24,6,1,0,1
29,8475755,Alexander Petrovic,D,DAL,32,8,1,0,1
29,8483395,Arshdeep Bains,L,VAN,23,7,1,0,1
29,8483489,Fraser Minten,C,TOR,31,8,1,0,1
29,8482476,Emil Heineman,L,MTL,23,6,1,0,1
29,8479522,Hardy Haman Aktell,D,WSH,26,2,1,0,1
29,8476323,Max McCormick,L,SEA,32,6,1,0,1
29,8484255,Jason Polin,R,COL,25,7,1,0,1
29,8479330,Brandon Gignac,C,MTL,27,21,1,0,1
29,8477482,Zachary Sanford,L,CHI,30,33,0,1,1
29,8483619,Filip Roos,D,OTT,25,21,0,1,1
29,8484304,Uvis Balinskis,D,FLA,28,7,0,1,1
29,8475795,Dylan McIlrath,D,WSH,32,18,0,1,1
29,8482197,Adam Raska,R,MIN,23,5,0,1,1
29,8483398,Declan Carlile,D,TBL,31,7,0,1,1
29,8477541,Dakota Mermis,D,TOR,30,12,0,1,1
29,8481024,Linus Karlsson,C,VAN,25,8,0,1,1
29,8479421,Jacob Moverare,D,LAK,26,5,0,1,1
29,8482126,Emil Andrae,D,PHI,31,2,0,1,1
29,8482162,Roby Jarventie,L,EDM,22,18,0,1,1
29,8480306,Grant Hutton,D,NYI,29,6,0,1,1
29,8481065,Angus Crookshank,L,OTT,25,12,0,0,0
29,8475780,Chris Wagner,R,COL,33,11,0,0,0
29,8482787,Nikita Chibrikov,R,WPG,31,3,0,0,0
29,8477993,Justin Kirkland,C,CGY,28,6,0,0,0
29,8477810,Joel Hanley,D,CGY,33,21,0,0,0
29,8479587,Rhett Gardner,C,PHI,28,21,0,0,0
29,8480874,Adam Ginning,D,PHI,24,11,0,0,0
29,8478051,Max Willman,C,NJD,29,13,0,0,0
29,8481206,John Ludvig,D,PIT,24,10,0,0,0
29,8478147,Bokondji Imama,L,PIT,28,6,0,0,0
29,8483920,Pierrick Dube,R,WSH,23,5,0,0,0
29,8483432,Luca Del Bel Belluz,C,CBJ,31,3,0,0,0
29,8482460,Matt Rempe,C,NYR,22,10,0,0,0
29,8481726,Adam Edstrom,C,NYR,24,1,0,0,0
29,8483401,Marc Johnstone,R,PIT,28,1,0,0,0
29,8478854,Ryan Shea,D,PIT,27,7,0,0,0
29,8480075,Cameron Crotty,D,MIN,25,8,0,0,0
29,8483609,Adam Klapka,R,CGY,24,2,0,0,0
29,8484259,Ondrej Pavel,C,COL,31,4,0,0,0
29,8480274,Philip Kemp,D,EDM,25,0,0,0,0
29,8484321,Nikolas Matinpalo,D,OTT,26,0,0,0,0
29,8481534,Raphael Lavoie,C,EDM,24,1,0,0,0
29,8470794,Joe Pavelski,C,,40,0,0,0,0
29,8479321,Lucas Johansen,D,,27,0,0,0,0
29,8477950,Tony DeAngelo,D,,29,0,0,0,0
29,8471218,Blake Wheeler,R,,38,0,0,0,0
29,8475197,Tyson Barrie,D,,33,0,0,0,0
29,8474157,Max Pacioretty,L,,36,0,0,0,0
29,8475744,Evgeny Kuznetsov,C,,32,0,0,0,0
29,8474037,James van Riemsdyk,L,,35,0,0,0,0
29,8476907,Mackenzie MacEachern,L,,30,0,0,0,0
29,8480216,Jacob Peterson,C,,25,0,0,0,0
29,8474602,Justin Schultz,D,,34,0,0,0,0
29,8482222,Alexander Barabanov,L,,30,0,0,0,0
29,8474031,Kevin Shattenkirk,D,,35,0,0,0,0
29,8477330,Dominik Kubalik,L,,29,0,0,0,0
29,8480884,Calen Addison,D,,24,0,0,0,0
29,8475906,John Klingberg,D,,32,0,0,0,0
29,8480008,Adam Ruzicka,C,,25,0,0,0,0
29,8476884,Derrick Pouliot,D,,30,0,0,0,0
29,8476919,Chris Tierney,C,,30,0,0,0,0
29,8479415,Michael McLeod,C,,26,0,0,0,0
29,8474870,Tyler Johnson,C,,34,0,0,0,0
29,8470604,Jeff Carter,C,,39,0,0,0,0
29,8478104,Sammy Blais,L,,28,0,0,0,0
29,8474884,Mike Hoffman,C,,35,0,0,0,0
29,8481591,Sam Poulin,R,,23,0,0,0,0
29,8471274,Alex Goligoski,D,,39,0,0,0,0
29,8476871,Tanner Pearson,L,,32,0,0,0,0
29,8476393,Nick Cousins,C,,31,0,0,0,0
29,8479977,Kailer Yamamoto,R,,26,0,0,0,0
29,8479346,Dillon Dube,C,,26,0,0,0,0
29,8480184,Gustav Lindstrom,D,,26,0,0,0,0
29,8479376,Victor Mete,D,,26,0,0,0,0
29,8473449,Kyle Okposo,R,,36,0,0,0,0
29,8481058,Jesse Ylonen,R,,25,0,0,0,0
29,8475752,Tyler Pitlick,C,,33,0,0,0,0
29,8481239,Samuel Fagemo,L,,24,0,0,0,0
29,8480821,Filip Zadina,R,,25,0,0,0,0
29,8470966,Mark Giordano,D,,41,0,0,0,0
29,8478495,Denis Gurianov,R,,27,0,0,0,0
29,8477464,Nic Petan,C,,29,0,0,0,0
29,8478099,Kevin Labanc,R,,29,0,0,0,0
29,8482241,Radim Zohorna,L,,28,0,0,0,0
29,8474040,Sam Gagner,C,,35,0,0,0,0
29,8479514,Rem Pitlick,C,,27,0,0,0,0
29,8478430,Oliver Kylington,D,,27,0,0,0,0
29,8479533,Joona Koppanen,L,,26,0,0,0,0
29,8479984,Cal Foote,D,,26,0,0,0,0
29,8477126,Jayson Megna,C,,34,0,0,0,0
29,8475164,Jakob Silfverberg,R,,34,0,0,0,0
29,8474009,Nick Bonino,C,,36,0,0,0,0
29,8479458,Nikita Zaitsev,D,,33,0,0,0,0
29,8477944,Jakub Vrana,L,,28,0,0,0,0
29,8471699,Andrew Cogliano,C,,37,0,0,0,0
29,8478067,Oskar Lindblom,L,,28,0,0,0,0
29,8471686,Marc Staal,D,,37,0,0,0,0
29,8470610,Zach Parise,L,,40,0,0,0,0
29,8478904,Steven Lorentz,C,,28,0,0,0,0
29,8473473,Milan Lucic,L,,36,0,0,0,0
29,8480031,Maxime Comtois,L,,25,0,0,0,0
29,8478512,Austin Czarnik,C,,32,0,0,0,0
29,8473504,Cal Clutterbuck,R,,37,0,0,0,0
29,8477454,Adam Erne,L,,29,0,0,0,0
29,8479383,Boris Katchouk,L,,26,0,0,0,0
29,8475825,Jani Hakanpää,D,,32,0,0,0,0
29,8477846,Ryan Carpenter,C,,33,0,0,0,0
29,8477930,Pierre-Edouard Bellemare,L,,39,0,0,0,0
29,8478400,Colin White,C,,27,0,0,0,0
29,8480226,Marián Studenic,R,,26,0,0,0,0
29,8480853,Liam Foudy,C,,24,0,0,0,0
29,8475797,Jarred Tinordi,D,,32,0,0,0,0
29,8479423,Alex Nylander,L,,26,0,0,0,0
29,8474618,Marco Scandella,D,,34,0,0,0,0
29,8478028,Fredrik Olofsson,L,,28,0,0,0,0
29,8474709,Matt Martin,L,,35,0,0,0,0
29,8481070,Hugh McGing,L,,26,0,0,0,0
29,8479546,Oskar Steen,C,,26,0,0,0,0
29,8474145,Robert Bortuzzo,D,,35,0,0,0,0
29,8476915,Jujhar Khaira,L,,30,0,0,0,0
29,8475278,Byron Froese,C,,33,0,0,0,0
29,8481812,Nikolai Knyzhov,D,,27,0,0,0,0
29,8478408,Travis Dermott,D,,28,0,0,0,0
29,8481077,John Leonard,L,,26,0,0,0,0
29,8479547,Matthew Phillips,R,,26,0,0,0,0
29,8480836,Jonathan Gruden,C,,24,0,0,0,0
29,8481690,Tyler Angle,C,,24,0,0,0,0
29,8475766,Austin Watson,L,,32,0,0,0,0
29,8481016,Ruslan Iskhakov,C,,24,0,0,0,0
29,8478078,Rourke Chartier,C,,28,0,0,0,0
29,8480776,Sheldon Rempal,R,,29,0,0,0,0
29,8478956,Samuel Laberge,L,NJD,27,0,0,0,0
29,8483045,Cameron Butler,R,CBJ,31,0,0,0,0
29,8484314,Jiri Smejkal,L,,28,0,0,0,0
30,8478402,Connor McDavid,C,EDM,27,77,40,95,135
30,8477956,David Pastrnak,R,BOS,28,79,60,74,134
30,8477492,Nathan MacKinnon,C,COL,29,81,44,90,134
30,8480027,Jason Robertson,L,DAL,25,82,54,72,126
30,8477934,Leon Draisaitl,C,EDM,29,74,45,81,126
30,8479318,Auston Matthews,C,TOR,27,80,73,46,119
30,8476453,Nikita Kucherov,R,TBL,31,81,34,78,112
30,8478864,Kirill Kaprizov,L,MIN,27,73,51,60,111
30,8478445,Mathew Barzal,C,NYI,27,81,16,92,108
30,8476389,Vincent Trocheck,C,NYR,31,79,43,60,103
30,8478420,Mikko Rantanen,R,COL,28,80,52,50,102
30,8479314,Matthew Tkachuk,L,FLA,27,78,29,72,101
30,8477942,Kevin Fiala,L,LAK,28,82,35,65,100
30,8481559,Jack Hughes,C,NJD,23,72,37,61,98
30,8478483,Mitch Marner,R,TOR,27,80,27,70,97
30,8480801,Brady Tkachuk,L,OTT,25,81,47,49,96
30,8479343,Clayton Keller,R,UTA,26,80,44,50,94
30,8478439,Travis Konecny,R,PHI,27,79,33,61,94
30,8480012,Elias Pettersson,C,VAN,26,73,32,62,94
30,8479385,Jordan Kyrou,C,STL,26,80,40,52,92
30,8477946,Dylan Larkin,C,DET,28,81,45,46,91
30,8478550,Artemi Panarin,L,NYR,33,77,26,65,91
30,8474564,Steven Stamkos,C,NSH,34,77,41,49,90
30,8471675,Sidney Crosby,C,PIT,37,72,35,54,89
30,8471214,Alex Ovechkin,L,WSH,39,74,41,46,87
30,8479337,Alex DeBrincat,R,DET,27,82,35,52,87
30,8476468,J.T. Miller,C,VAN,31,77,22,65,87
30,8480023,Robert Thomas,C,STL,25,77,26,60,86
30,8476456,Jonathan Huberdeau,C,CGY,31,76,22,64,86
30,8475786,Zach Hyman,L,EDM,32,79,47,38,85
30,8476459,Mika Zibanejad,C,NYR,31,74,39,46,85
30,8476454,Ryan Nugent-Hopkins,C,EDM,31,80,19,66,85
30,8479323,Adam Fox,D,NYR,26,75,19,66,85
30,8477939,William Nylander,R,TOR,28,80,38,46,84
30,8480018,Nick Suzuki,C,MTL,25,79,25,59,84
30,8474600,Roman Josi,D,NSH,34,72,21,63,84
30,8477409,Carter Verhaeghe,C,FLA,29,78,40,43,83
30,8478010,Brayden Point,C,TBL,28,81,43,39,82
30,8482116,Tim Stützle,C,OTT,22,78,30,52,82
30,8480208,Drake Batherson,R,OTT,26,82,37,44,81
30,8478398,Kyle Connor,L,WPG,28,72,39,41,80
30,8477493,Aleksander Barkov,C,FLA,29,78,25,55,80
30,8480800,Quinn Hughes,D,VAN,25,75,13,67,80
30,8477933,Sam Reinhart,C,FLA,29,76,43,36,79
30,8475184,Chris Kreider,L,NYR,33,80,43,36,79
30,8476539,Jonathan Marchessault,R,NSH,34,78,43,35,78
30,8477404,Jake Guentzel,C,TBL,30,82,36,42,78
30,8479407,Jesper Bratt,L,NJD,26,79,27,51,78
30,8480830,Andrei Svechnikov,R,CAR,24,74,20,58,78
30,8477504,Josh Morrissey,D,WPG,29,76,17,61,78
30,8482078,Lucas Raymond,L,DET,22,82,28,49,77
30,8475166,John Tavares,C,TOR,34,80,28,47,75
30,8477500,Bo Horvat,C,NYI,29,79,37,37,74
30,8478449,Roope Hintz,C,DAL,28,81,32,42,74
30,8475168,Matt Duchene,C,DAL,33,81,29,45,74
30,8478427,Sebastian Aho,C,CAR,27,75,22,52,74
30,8476881,Tomas Hertl,C,VGK,31,79,23,50,73
30,8477951,Nick Schmaltz,C,UTA,28,79,20,53,73
30,8480069,Cale Makar,D,COL,26,71,18,55,73
30,8475172,Nazem Kadri,C,CGY,34,76,34,38,72
30,8478403,Jack Eichel,C,VGK,28,76,33,39,72
30,8480002,Nico Hischier,C,NJD,25,77,24,48,72
30,8479420,Tage Thompson,C,BUF,27,74,33,38,71
30,8475754,Brock Nelson,C,NYI,33,80,33,38,71
30,8476887,Filip Forsberg,L,NSH,30,72,30,41,71
30,8476460,Mark Scheifele,C,WPG,31,73,29,42,71
30,8481557,Matt Boldy,L,MIN,23,70,28,43,71
30,8480036,Miro Heiskanen,D,DAL,25,78,9,62,71
30,8473419,Brad Marchand,L,BOS,36,81,22,48,70
30,8473512,Claude Giroux,R,OTT,36,79,18,52,70
30,8475167,Victor Hedman,D,TBL,34,82,17,53,70
30,8480865,Noah Dobson,D,NYI,24,81,16,54,70
30,8473994,Jamie Benn,L,DAL,35,82,32,37,69
30,8477940,Nikolaj Ehlers,L,WPG,28,69,24,45,69
30,8480014,Gabriel Vilardi,C,WPG,25,72,41,27,68
30,8481068,Yegor Sharangovich,C,CGY,26,79,36,32,68
30,8477501,Valeri Nichushkin,R,COL,29,80,32,36,68
30,8482699,Dylan Guenther,R,UTA,21,77,28,40,68
30,8478975,Mason Marchment,L,DAL,29,81,23,45,68
30,8477496,Elias Lindholm,C,BOS,30,79,32,35,67
30,8477402,Pavel Buchnevich,L,STL,29,68,25,42,67
30,8482665,Matty Beniers,C,SEA,22,75,20,47,67
30,8477935,Sam Bennett,C,FLA,28,80,30,36,66
30,8476346,Johnny Gaudreau,L,CBJ,31,75,21,45,66
30,8474578,Erik Karlsson,D,PIT,34,78,19,47,66
30,8475798,Mikael Granlund,C,SJS,32,70,17,49,66
30,8471724,Kris Letang,D,PIT,37,80,15,50,65
30,8479542,Brandon Hagel,L,TBL,26,81,32,32,64
30,8474641,Adam Henrique,C,EDM,34,79,32,32,64
30,8475191,Reilly Smith,R,NYR,33,76,26,38,64
30,8475765,Vladimir Tarasenko,R,DET,33,80,20,44,64
30,8474102,David Perron,L,OTT,36,76,19,45,64
30,8482702,Logan Stankoven,C,DAL,21,80,28,35,63
30,8478440,Dylan Strome,C,WSH,27,71,20,43,63
30,8475692,Mats Zuccarello,R,MIN,37,71,14,49,63
30,8475810,Bryan Rust,R,PIT,32,69,28,34,62
30,8478047,Michael Bunting,L,PIT,29,71,22,40,62
30,8480839,Rasmus Dahlin,D,BUF,24,75,16,46,62
30,8482684,Luke Hughes,D,NJD,21,69,8,54,62
30,8482093,Seth Jarvis,C,CAR,22,66,32,29,61
30,8478414,Timo Meier,R,NJD,28,75,32,29,61
30,8471215,Evgeni Malkin,C,PIT,38,72,30,31,61
30,8477960,Adrian Kempe,R,LAK,28,80,24,37,61
30,8475170,Brayden Schenn,C,STL,33,73,23,38,61
30,8480803,Evan Bouchard,D,EDM,25,75,15,46,61
30,8476853,Morgan Rielly,D,TOR,30,69,6,55,61
30,8481540,Cole Caufield,R,MTL,23,74,34,26,60
30,8484144,Connor Bedard,C,CHI,19,63,30,30,60
30,8477407,Anthony Duclair,L,NYI,29,77,27,33,60
30,8475794,Tyler Seguin,C,DAL,32,82,26,34,60
30,8478407,Vince Dunn,D,SEA,28,71,18,42,60
30,8478460,Zach Werenski,D,CBJ,27,80,13,47,60
30,8481542,Moritz Seider,D,DET,23,78,10,50,60
30,8478444,Brock Boeser,R,VAN,27,74,33,26,59
30,8482740,Wyatt Johnston,C,DAL,21,81,32,27,59
30,8477494,Jonathan Drouin,L,COL,29,81,21,38,59
30,8482110,Dawson Mercer,C,NJD,23,76,28,30,58
30,8478366,Frank Vatrano,R,ANA,30,77,25,33,58
30,8476448,William Karlsson,C,VGK,31,81,24,34,58
30,8481711,Matias Maccelli,L,UTA,24,77,22,36,58
30,8475745,Charlie Coyle,C,BOS,32,79,17,41,58
30,8478055,Gustav Forsling,D,FLA,28,73,10,48,58
30,8475158,Ryan O'Reilly,C,NSH,33,73,23,34,57
30,8478401,Pavel Zacha,C,BOS,27,80,22,35,57
30,8475753,Justin Faulk,D,STL,32,75,12,45,57
30,8476399,Blake Coleman,C,CGY,33,73,32,24,56
30,8477497,Sean Monahan,C,CBJ,30,74,29,27,56
30,8482109,Alexis Lafrenière,L,NYR,23,75,27,29,56
30,8477416,Oliver Bjorkstrand,R,SEA,29,72,26,30,56
30,8480039,Martin Necas,C,CAR,25,69,24,32,56
30,8477986,Brandon Montour,D,SEA,30,74,20,36,56
30,8479400,Pierre-Luc Dubois,L,WSH,26,70,18,38,56
30,8479999,Casey Mittelstadt,C,COL,26,81,11,45,56
30,8479675,Trevor Moore,L,LAK,29,79,28,27,55
30,8480028,Morgan Frost,C,PHI,25,75,20,35,55
30,8477021,Alex Kerfoot,C,UTA,30,74,18,37,55
30,8471685,Anze Kopitar,C,LAK,37,80,14,41,55
30,8477955,Jared McCann,L,SEA,28,70,31,23,54
30,8476483,Rickard Rakell,R,PIT,31,70,26,28,54
30,8482159,Tyson Foerster,R,PHI,22,69,24,30,54
30,8482124,Quinton Byfield,R,LAK,22,79,23,31,54
30,8474141,Patrick Kane,R,DET,36,76,22,32,54
30,8475913,Mark Stone,R,VGK,32,69,21,33,54
30,8477503,Max Domi,C,TOR,29,78,16,38,54
30,8476905,Chandler Stephenson,C,SEA,30,78,13,41,54
30,8475169,Evander Kane,L,EDM,33,76,26,27,53
30,8475784,Jeff Skinner,C,EDM,32,74,25,28,53
30,8481528,Dylan Cozens,C,BUF,23,73,20,33,53
30,8483515,Juraj Slafkovsky,L,MTL,20,75,18,35,53
30,8484166,Adam Fantilli,C,CBJ,20,61,14,39,53
30,8476792,Torey Krug,D,STL,33,76,12,41,53
30,8474679,Gustav Nyquist,C,NSH,35,75,10,43,53
30,8478038,Devon Toews,D,COL,30,70,10,43,53
30,8476432,Boone Jenner,C,CBJ,31,70,38,14,52
30,8482113,Anton Lundell,C,FLA,23,81,25,27,52
30,8483431,Logan Cooley,C,UTA,20,75,24,28,52
30,8475726,Tyler Toffoli,C,SJS,32,68,23,29,52
30,8478873,Troy Terry,R,ANA,27,69,23,29,52
30,8477456,J.T. Compher,L,DET,29,78,23,29,52
30,8482149,Cole Perfetti,C,WPG,22,74,22,30,52
30,8476438,Brandon Saad,L,STL,32,76,29,22,51
30,8480015,Owen Tippett,R,PHI,25,79,24,27,51
30,8480797,Joel Farabee,L,PHI,24,75,19,32,51
30,8478397,Rasmus Andersson,D,CGY,28,77,9,42,51
30,8478493,Joel Eriksson Ek,C,MIN,27,71,24,26,50
30,8476462,Dougie Hamilton,D,NJD,31,72,20,30,50
30,8476875,Mike Matheson,D,MTL,30,70,16,34,50
30,8477447,Shea Theodore,D,VGK,29,64,13,37,50
30,8476958,Jaccob Slavin,D,CAR,30,71,8,42,50
30,8474586,Jordan Eberle,R,SEA,34,73,21,28,49
30,8479339,Patrik Laine,L,CBJ,26,66,20,29,49
30,8476479,Phillip Danault,C,LAK,31,80,17,32,49
30,8479325,Charlie McAvoy,D,BOS,27,76,10,39,49
30,8480064,Josh Norris,C,OTT,25,69,28,20,48
30,8475314,Anders Lee,L,NYI,34,80,26,22,48
30,8475151,Kyle Palmieri,C,NYI,33,79,21,27,48
30,8478519,Anthony Cirelli,C,TBL,27,82,21,27,48
30,8482745,Mason McTavish,C,ANA,21,74,17,31,48
30,8476906,Shayne Gostisbehere,D,CAR,31,76,14,34,48
30,8481581,Thomas Harley,D,DAL,23,77,9,39,48
30,8475714,Calle Jarnkrok,C,TOR,33,73,23,24,47
30,8477451,Ryan Hartman,R,MIN,30,76,21,26,47
30,8477949,Alex Tuch,R,BUF,28,65,16,31,47
30,8474150,Mikael Backlund,C,CGY,35,77,16,31,47
30,8477932,Aaron Ekblad,D,FLA,28,70,14,33,47
30,8474590,John Carlson,D,WSH,34,68,11,36,47
30,8476923,Damon Severson,D,CBJ,30,80,9,38,47
30,8477476,Artturi Lehkonen,L,COL,29,81,21,25,46
30,8473986,Alex Killorn,L,ANA,35,72,20,26,46
30,8478542,Evan Rodrigues,C,FLA,31,75,18,28,46
30,8477429,Andrew Copp,C,DET,30,81,18,28,46
30,8478438,Tommy Novak,C,NSH,27,72,16,30,46
30,8474563,Drew Doughty,D,LAK,35,71,12,34,46
30,8475722,Jason Zucker,L,BUF,32,68,24,21,45
30,8479425,Filip Hronek,D,VAN,27,75,13,32,45
30,8480145,Neal Pionk,D,WPG,29,77,11,34,45
30,8477998,Warren Foegele,L,LAK,28,80,33,11,44
30,8476882,Teuvo Teravainen,C,CHI,30,65,14,30,44
30,8476872,Scott Laughton,C,PHI,30,72,13,31,44
30,8476419,Jean-Gabriel Pageau,C,NYI,32,76,11,33,44
30,8479992,Michael Rasmussen,C,DET,25,81,23,20,43
30,8484203,Bradly Nadeau,L,CAR,19,62,20,23,43
30,8478115,Pierre Engvall,L,NYI,28,76,19,24,43
30,8484153,Leo Carlsson,C,ANA,20,71,18,25,43
30,8481560,Arthur Kaliyev,R,LAK,23,79,14,29,43
30,8474565,Alex Pietrangelo,D,VGK,34,67,10,33,43
30,8481546,Cam York,D,PHI,23,70,8,35,43
30,8479410,Mikhail Sergachev,D,UTA,26,72,5,38,43
30,8474149,Evgenii Dadonov,R,DAL,35,80,19,23,42
30,8482092,Ridly Greig,C,OTT,22,74,19,23,42
30,8483808,Andrei Kuzmenko,L,CGY,28,77,18,24,42
30,8475287,Erik Haula,L,NJD,33,70,17,25,42
30,8478469,Thomas Chabot,D,OTT,27,71,15,27,42
30,8482122,Brock Faber,D,MIN,22,78,12,30,42
30,8470613,Brent Burns,D,CAR,39,78,9,33,42
30,8478396,Noah Hanifin,D,VGK,27,61,8,34,42
30,8479345,Jakob Chychrun,D,WSH,26,70,8,34,42
30,8475848,Brendan Gallagher,R,MTL,32,75,26,15,41
30,8480829,Jesperi Kotkaniemi,C,CAR,24,64,24,17,41
30,8480009,Eeli Tolvanen,R,SEA,25,70,22,19,41
30,8478498,Jake DeBrusk,L,VAN,28,75,18,23,41
30,8479591,Michael Eyssimont,C,TBL,28,82,18,23,41
30,8478466,Daniel Sprong,R,VAN,27,71,16,25,41
30,8483505,Matthew Poitras,C,BOS,20,75,15,26,41
30,8481524,Bowen Byram,D,BUF,23,67,13,28,41
30,8482475,Yegor Chinakhov,R,CBJ,23,66,17,23,40
30,8477444,Andre Burakovsky,L,SEA,29,70,16,24,40
30,8481533,Trevor Zegras,C,ANA,23,70,15,25,40
30,8475768,Jaden Schwartz,C,SEA,32,75,15,25,40
30,8478856,Conor Garland,R,VAN,28,69,12,28,40
30,8476480,Vladislav Namestnikov,C,WPG,32,64,12,28,40
30,8480434,Sean Durzi,D,UTA,26,72,10,30,40
30,8482720,Matthew Knies,L,TOR,22,77,9,31,40
30,8477346,MacKenzie Weegar,D,CGY,30,73,8,32,40
30,8475200,Dmitry Orlov,D,CAR,33,75,8,32,40
30,8477964,Ivan Barbashev,C,VGK,29,75,23,16,39
30,8478474,Lawson Crouse,L,UTA,27,79,21,18,39
30,8476925,Colton Sissons,C,NSH,31,62,18,21,39
30,8477505,Alexander Wennberg,C,SJS,30,71,13,26,39
30,8474716,Jared Spurgeon,D,MIN,35,78,9,30,39
30,8475764,Cam Fowler,D,ANA,33,74,6,33,39
30,8476979,Erik Gustafsson,D,DET,32,71,6,33,39
30,8476880,Tom Wilson,R,WSH,30,67,19,19,38
30,8482146,Luke Evangelista,R,NSH,22,71,18,20,38
30,8481596,Shane Pinto,C,OTT,24,80,16,22,38
30,8479365,Trent Frederic,C,BOS,26,80,12,26,38
30,8482097,Jack Quinn,R,BUF,23,64,11,27,38
30,8482705,Cole Sillinger,C,CBJ,21,64,11,27,38
30,8481703,Valtteri Puustinen,R,PIT,25,56,10,28,38
30,8477498,Darnell Nurse,D,EDM,29,72,10,28,38
30,8482712,Oskar Olausson,R,COL,22,80,9,29,38
30,8475218,Mattias Ekholm,D,EDM,34,72,8,30,38
30,8480893,Kirill Marchenko,R,CBJ,24,70,19,18,37
30,8478463,Anthony Beauvillier,L,PIT,27,59,19,18,37
30,8478042,Viktor Arvidsson,L,EDM,31,75,18,19,37
30,8482055,Drew O'Connor,L,PIT,26,77,18,19,37
30,8482175,JJ Peterka,R,BUF,22,71,18,19,37
30,8480188,Fabian Zetterlund,L,SJS,25,66,17,20,37
30,8477479,Tyler Bertuzzi,L,CHI,29,64,17,20,37
30,8478891,Mason Appleton,C,WPG,28,59,17,20,37
30,8479987,Morgan Geekie,C,BOS,26,76,15,22,37
30,8480849,Barrett Hayton,C,UTA,24,69,15,22,37
30,8476461,Sean Couturier,C,PHI,32,57,15,22,37
30,8482667,William Eklund,L,SJS,22,67,14,23,37
30,8480185,Eetu Luostarinen,C,FLA,26,73,13,24,37
30,8482105,Jake Sanderson,D,OTT,22,68,13,24,37
30,8480113,Alex Iafallo,L,WPG,31,66,13,24,37
30,8476927,Teddy Blueger,C,VAN,30,68,12,25,37
30,8476292,Ondrej Palat,L,NJD,33,73,10,27,37
30,8482624,Daniil Miromanov,D,CGY,27,68,9,28,37
30,8478057,Dakota Joshua,C,VAN,28,66,21,15,36
30,8480220,Noah Cates,L,PHI,25,74,14,22,36
30,8475760,Nick Bjugstad,C,UTA,32,73,14,22,36
30,8482660,Kent Johnson,C,CBJ,22,65,13,23,36
30,8479393,Noah Gregor,L,OTT,26,77,13,23,36
30,8481624,Ilya Mikheyev,R,CHI,30,58,13,23,36
30,8474715,Cameron Atkinson,R,TBL,35,81,11,25,36
30,8476885,Jacob Trouba,D,NYR,30,71,6,30,36
30,8474151,Ryan McDonagh,D,TBL,35,78,5,31,36
30,8482125,Alexander Holtz,R,VGK,22,73,22,13,35
30,8478413,Jordan Greenway,L,BUF,27,67,17,18,35
30,8484145,Zach Benson,L,BUF,19,73,15,20,35
30,8474053,Logan Couture,C,SJS,35,61,10,25,35
30,8482079,Marco Rossi,C,MIN,23,66,20,14,34
30,8479525,Ross Colton,C,COL,28,79,18,16,34
30,8477952,Robby Fabbri,C,ANA,28,71,18,16,34
30,8475193,Tomas Tatar,L,NJD,34,72,18,16,34
30,8477511,Anthony Mantha,R,CGY,30,72,14,20,34
30,8476392,Adam Lowry,C,WPG,31,66,14,20,34
30,8475763,Kevin Hayes,R,PIT,32,68,13,21,34
30,8476826,Yanni Gourde,C,SEA,33,73,11,23,34
30,8476854,Hampus Lindholm,D,BOS,30,69,8,26,34
30,8478500,Ivan Provorov,D,CBJ,27,78,6,28,34
30,8478458,John (Jack) Roslovic,C,CAR,27,71,5,29,34
30,8475181,Nick Leddy,D,STL,33,67,4,30,34
30,8482089,Jake Neighbours,L,STL,22,71,19,14,33
30,8477426,Nicholas Paul,L,TBL,29,82,16,17,33
30,8478046,Danton Heinen,L,VAN,29,70,16,17,33
30,8478472,Mathieu Joseph,R,STL,27,70,16,17,33
30,8481582,Nicholas Robertson,L,TOR,23,67,16,17,33
30,8481604,Pavel Dorofeyev,L,VGK,24,69,15,18,33
30,8481618,Alex Newhook,C,MTL,23,74,15,18,33
30,8475793,Ryan Johansen,C,PHI,32,67,14,19,33
30,8481186,Logan O'Connor,R,COL,28,80,14,19,33
30,8476921,Jordan Martinook,L,CAR,32,61,14,19,33
30,8480798,Philipp Kurashev,C,CHI,25,69,13,20,33
30,8474189,Lars Eller,C,PIT,35,62,13,20,33
30,8481606,Jordan Spence,D,LAK,23,67,5,28,33
30,8477987,Ryan Donato,C,CHI,28,72,15,17,32
30,8479661,Tanner Jeannot,L,LAK,27,74,15,17,32
30,8480789,Oliver Wahlstrom,R,NYI,24,73,14,18,32
30,8470621,Corey Perry,R,EDM,39,75,13,19,32
30,8478462,Nicolas Roy,C,VGK,27,74,11,21,32
30,8477989,Christian Dvorak,C,MTL,28,65,8,24,32
30,8471698,T.J. Oshie,R,WSH,38,70,19,12,31
30,8477953,Kasperi Kapanen,R,STL,28,65,15,16,31
30,8476897,Oskar Sundqvist,C,STL,30,66,15,16,31
30,8479390,Taylor Raddysh,R,WSH,26,64,15,16,31
30,8478020,Michael Amadio,R,OTT,28,77,14,17,31
30,8477947,Sonny Milano,L,WSH,28,62,14,17,31
30,8476422,Mike Reilly,D,NYI,31,76,12,19,31
30,8476869,Brady Skjei,D,NSH,30,72,9,22,31
30,8475791,Taylor Hall,L,CHI,33,57,6,25,31
30,8477969,Marcus Pettersson,D,PIT,28,76,5,26,31
30,8479328,Julien Gauthier,R,NYI,27,65,20,10,30
30,8480459,Pius Suter,C,VAN,28,70,19,11,30
30,8478233,Andrew Mangiapane,L,WSH,28,70,14,16,30
30,8475149,Marcus Johansson,L,MIN,34,65,12,18,30
30,8481522,Peyton Krebs,C,BUF,23,60,12,18,30
30,8480813,Joe Veleno,C,DET,24,77,11,19,30
30,8476469,Joel Armia,R,MTL,31,59,9,21,30
30,8483490,Pavel Mintyukov,D,ANA,21,74,8,22,30
30,8478133,Jake Evans,C,MTL,28,71,6,24,30
30,8476467,Jamie Oleksiak,D,SEA,32,74,6,24,30
30,8480873,Rasmus Sandin,D,WSH,24,68,3,27,30
30,8475324,Nick Jensen,D,OTT,34,72,2,28,30
30,8481059,Scott Perunovich,D,STL,26,66,1,29,30
30,8480068,Ryan Poehling,C,PHI,25,74,15,14,29
30,8480205,Emil Bemstrom,C,PIT,25,59,15,14,29
30,8473533,Jordan Staal,C,CAR,36,62,12,17,29
30,8482749,Joshua Roy,R,MTL,21,64,12,17,29
30,8480835,Jack Drury,C,CAR,24,59,11,18,29
30,8480871,Adam Boqvist,D,FLA,24,69,11,18,29
30,8479351,Sam Steel,C,DAL,26,79,11,18,29
30,8479976,Juuso Valimaki,D,UTA,26,71,10,19,29
30,8480855,Jack McBain,C,UTA,24,60,10,19,29
30,8480078,Filip Chytil,C,NYR,25,60,8,21,29
30,8480817,K'Andre Miller,D,NYR,24,77,7,22,29
30,8482142,Jamie Drysdale,D,PHI,22,67,6,23,29
30,8482259,Bobby McMann,C,TOR,28,62,18,10,28
30,8476458,Ryan Strome,C,ANA,31,70,14,14,28
30,8477948,Travis Sanheim,D,PHI,28,69,8,20,28
30,8481441,Joe Snively,C,DET,28,67,8,20,28
30,8476917,Adam Pelech,D,NYI,30,74,6,22,28
30,8477506,Ryan Pulock,D,NYI,30,79,5,23,28
30,8479371,Dante Fabbro,D,NSH,26,68,5,23,28
30,8477495,Seth Jones,D,CHI,30,67,4,24,28
30,8476891,Matthew Grzelcyk,D,PIT,30,75,3,25,28
30,8481014,Alexander Romanov,D,NYI,24,74,3,25,28
30,8478109,Victor Olofsson,L,VGK,29,76,14,13,27
30,8475799,Nino Niederreiter,R,WPG,32,69,12,15,27
30,8479996,Cody Glass,C,NSH,25,50,11,16,27
30,8476918,Jimmy Vesey,L,NYR,31,68,11,16,27
30,8481523,Kirby Dach,C,MTL,23,62,10,17,27
30,8483565,Nick Blankenburg,D,NSH,26,61,4,23,27
30,8483499,Liam Ohgren,L,MIN,20,57,14,12,26
30,8480748,Kiefer Sherwood,L,VAN,29,52,13,13,26
30,8481554,Kaapo Kakko,R,NYR,23,70,11,15,26
30,8477353,Tyler Motte,C,DET,29,72,11,15,26
30,8483445,Cutter Gauthier,L,ANA,20,63,10,16,26
30,8480074,Alexandre Texier,C,STL,25,54,9,17,26
30,8482809,Jackson Blake,R,CAR,21,60,9,17,26
30,8482679,Matt Coronato,R,CGY,22,72,9,17,26
30,8481577,Philip Tomasino,C,NSH,23,70,7,19,26
30,8480802,Ryan McLeod,C,BUF,25,59,7,19,26
30,8476463,Jonas Brodin,D,MIN,31,76,5,21,26
30,8477435,Ryan Graves,D,PIT,29,76,3,23,26
30,8476892,Colton Parayko,D,STL,31,66,2,24,26
30,8476981,Josh Anderson,R,MTL,30,77,15,10,25
30,8479316,Luke Kunin,C,SJS,27,61,14,11,25
30,8477425,Miles Wood,L,COL,29,78,14,11,25
30,8481601,Simon Holmstrom,R,NYI,23,69,14,11,25
30,8478970,Jalen Chatfield,D,CAR,28,74,13,12,25
30,8478911,Matt Roy,D,WSH,29,64,11,14,25
30,8476474,Stefan Noesen,R,NJD,31,66,9,16,25
30,8479369,Andrew Peeke,D,BOS,26,63,7,18,25
30,8482671,Owen Power,D,BUF,22,66,5,20,25
30,8479983,Mario Ferraro,D,SJS,26,74,4,21,25
30,8479324,Ryan Lindgren,D,NYR,26,66,2,23,25
30,8480281,Alexey Toropchenko,R,STL,25,57,16,8,24
30,8481580,Connor McMichael,C,WSH,23,61,15,9,24
30,8478432,Christian Fischer,R,DET,27,74,13,11,24
30,8473422,Nick Foligno,L,CHI,37,58,10,14,24
30,8477919,Frederick Gaudreau,C,MIN,31,60,10,14,24
30,8479293,Brandon Tanev,L,SEA,33,61,9,15,24
30,8479941,Justin Danforth,R,CBJ,31,60,9,15,24
30,8476525,Colin Miller,D,WPG,32,63,9,15,24
30,8483482,Tristan Luneau,D,ANA,20,62,8,16,24
30,8481656,Aliaksei Protas,C,WSH,23,59,7,17,24
30,8478851,Alexandre Carrier,D,NSH,28,68,4,20,24
30,8479639,Dylan Coghlan,D,WPG,26,62,4,20,24
30,8479982,Conor Timmins,D,TOR,26,55,2,22,24
30,8481481,Blake Lizotte,C,PIT,27,60,13,10,23
30,8480289,Morgan Barron,C,WPG,26,55,12,11,23
30,8483491,Ivan Miroshnichenko,L,WSH,20,55,11,12,23
30,8481535,Nils Hoglander,L,VAN,24,70,9,14,23
30,8475343,Nic Dowd,C,WSH,34,69,9,14,23
30,8477392,Hudson Fasching,R,NYI,29,60,9,14,23
30,8477015,Connor Brown,R,EDM,30,60,8,15,23
30,8476960,Andreas Athanasiou,C,CHI,30,57,8,15,23
30,8480144,David Kampf,C,TOR,29,71,8,15,23
30,8480336,Sean Walker,D,CAR,30,70,7,16,23
30,8482245,Artem Zub,D,OTT,29,73,6,17,23
30,8475171,Oliver Ekman-Larsson,D,TOR,33,63,5,18,23
30,8475790,Erik Gudbranson,D,CBJ,32,80,4,19,23
30,8482655,Janis Moser,D,TBL,24,75,2,21,23
30,8479402,Jake Bean,D,CGY,26,73,2,21,23
30,8476278,Colin Blackwell,C,DAL,31,76,16,6,22
30,8477446,Michael McCarron,R,NSH,29,58,15,7,22
30,8476889,Radek Faksa,C,STL,30,57,12,10,22
30,8475231,Casey Cizikas,C,NYI,33,68,10,12,22
30,8482101,Danil Gushchin,L,SJS,22,59,8,14,22
30,8481178,Egor Zamula,D,PHI,24,56,6,16,22
30,8477979,Nicolas Aube-Kubel,R,BUF,28,54,6,16,22
30,8480021,Jack Studnicka,C,LAK,25,68,6,16,22
30,8477220,Nate Schmidt,D,FLA,33,72,5,17,22
30,8473507,Jeff Petry,D,DET,37,72,4,18,22
30,8480049,Dylan Samberg,D,WPG,25,64,0,22,22
30,8482117,Lukas Reichel,L,CHI,22,57,10,11,21
30,8479344,Jesse Puljujarvi,R,PIT,26,52,9,12,21
30,8479368,Max Jones,L,BOS,26,62,8,13,21
30,8482111,Justin Barron,D,MTL,23,63,7,14,21
30,8475220,Marcus Foligno,L,MIN,33,60,7,14,21
30,8476312,Josh Manson,D,COL,33,54,7,14,21
30,8481521,Ronnie Attard,D,PHI,25,54,7,14,21
30,8480878,Nils Lundkvist,D,DAL,24,68,5,16,21
30,8479980,Nicolas Hague,D,VGK,26,51,5,16,21
30,8477839,Conor Sheary,L,TBL,32,82,3,18,21
30,8476856,Mathew Dumba,D,DAL,30,69,3,18,21
30,8480043,Timothy Liljegren,D,TOR,25,64,2,19,21
30,8480222,Sebastian Aho,D,PIT,28,74,2,19,21
30,8475462,Radko Gudas,D,ANA,34,63,0,21,21
30,8482155,Alex Laferriere,R,LAK,23,66,15,5,20
30,8480762,Eric Robinson,L,CAR,29,58,14,6,20
30,8480995,Pontus Holmberg,R,TOR,25,64,9,11,20
30,8481517,Brett Leason,R,ANA,25,56,9,11,20
30,8478508,Yakov Trenin,C,MIN,27,59,9,11,20
30,8480980,Connor Dewar,C,TOR,25,70,8,12,20
30,8482074,Connor Zary,C,CGY,23,59,7,13,20
30,8478882,Vladislav Gavrikov,D,LAK,29,71,6,14,20
30,8473563,Nicklas Backstrom,C,WSH,37,55,6,14,20
30,8476931,Jake McCabe,D,TOR,31,65,6,14,20
30,8479998,Mikey Anderson,D,LAK,25,58,4,16,20
30,8477488,Brett Pesce,D,NJD,30,68,3,17,20
30,8482087,Kaiden Guhle,D,MTL,22,62,1,19,20
30,8476878,Zemgus Girgensons,C,TBL,30,77,15,4,19
30,8479619,Michael Carcone,L,UTA,28,60,14,5,19
30,8480448,Parker Kelly,L,COL,25,74,12,7,19
30,8478211,Dryden Hunt,L,CGY,29,54,11,8,19
30,8478013,Jake Walman,D,SJS,28,74,8,11,19
30,8475855,Jesper Fast,R,CAR,33,58,8,11,19
30,8479353,Brett Howden,C,VGK,26,65,8,11,19
30,8482157,Will Cuylle,L,NYR,22,60,8,11,19
30,8481032,Paul Cotter,C,NJD,25,58,7,12,19
30,8478434,Keegan Kolesar,R,VGK,27,68,7,12,19
30,8478416,Erik Cernak,D,TBL,27,76,6,13,19
30,8480058,Pierre-Olivier Joseph,D,STL,25,55,6,13,19
30,8480192,Johnathan Kovacevic,D,NJD,27,55,5,14,19
30,8480891,Michael Kesselring,D,UTA,24,53,5,14,19
30,8480950,Ilya Lyubushkin,D,DAL,30,70,2,17,19
30,8482077,Dylan Holloway,L,EDM,23,53,13,5,18
30,8479336,Carl Grundstrom,R,SJS,27,46,13,5,18
30,8482133,Thomas Bordeleau,C,SJS,22,60,11,7,18
30,8481553,Bobby Brink,R,PHI,23,64,11,7,18
30,8478421,A.J. Greer,L,FLA,28,59,9,9,18
30,8481592,Jakob Pelletier,L,CGY,23,45,9,9,18
30,8479026,Philippe Myers,D,TOR,27,61,8,10,18
30,8480003,Jesper Boqvist,C,FLA,26,70,7,11,18
30,8482176,Wyatt Kaiser,D,CHI,22,58,7,11,18
30,8475233,David Savard,D,MTL,34,69,5,13,18
30,8478136,Jake Middleton,D,MIN,28,72,5,13,18
30,8481537,Nikita Okhotiuk,D,CGY,24,58,5,13,18
30,8481161,Jake Christiansen,D,CBJ,25,56,5,13,18
30,8476902,Esa Lindell,D,DAL,30,71,4,14,18
30,8480073,Erik Brannstrom,D,COL,25,62,4,14,18
30,8477845,Trevor van Riemsdyk,D,WSH,33,59,3,15,18
30,8475718,Justin Holl,D,DET,32,69,3,15,18
30,8476331,Dylan DeMelo,D,WPG,31,73,2,16,18
30,8481568,Alex Vlasic,D,CHI,23,58,2,16,18
30,8480001,Urho Vaakanainen,D,ANA,25,54,2,16,18
30,8474673,TJ Brodie,D,CHI,34,57,2,16,18
30,8478507,John Marino,D,UTA,27,66,0,18,18
30,8480246,Nick Perbix,D,TBL,26,73,0,18,18
30,8479315,Joey Anderson,R,CHI,26,55,11,6,17
30,8483468,Jiri Kulich,C,BUF,20,59,9,8,17
30,8476822,Luke Glendening,C,TBL,35,80,9,8,17
30,8481093,Rafael Harvey-Pinard,L,MTL,25,55,7,10,17
30,8481704,Juuso Parssinen,C,NSH,23,58,7,10,17
30,8477369,Carson Soucy,D,VAN,30,63,6,11,17
30,8476874,Olli Maatta,D,DET,30,60,6,11,17
30,8483457,Lane Hutson,D,MTL,20,61,5,12,17
30,8482859,Zack Ostapchuk,C,OTT,21,60,5,12,17
30,8476988,Matt Benning,D,SJS,30,66,5,12,17
30,8477499,Rasmus Ristolainen,D,PHI,30,63,5,12,17
30,8479986,Kole Lind,R,DAL,26,50,3,14,17
30,8481167,Brayden Pachal,D,CGY,25,41,3,14,17
30,8476879,Cody Ceci,D,EDM,31,73,2,15,17
30,8474574,Tyler Myers,D,VAN,34,64,1,16,17
30,8481716,Dmitri Voronkov,L,CBJ,24,41,14,2,16
30,8477573,Nathan Walker,L,STL,30,48,12,4,16
30,8477903,Garnet Hathaway,R,PHI,33,65,10,6,16
30,8477508,Curtis Lazar,C,NJD,29,52,9,7,16
30,8476934,Brock McGinn,L,ANA,30,50,9,7,16
30,8478569,Noel Acciari,C,PIT,33,49,9,7,16
30,8479671,Mathieu Olivier,R,CBJ,27,49,8,8,16
30,8482803,Olen Zellweger,D,ANA,21,59,7,9,16
30,8482148,Hendrix Lapierre,C,WSH,22,45,7,9,16
30,8479291,Kevin Rooney,C,CGY,31,50,7,9,16
30,8477931,Tomas Nosek,L,FLA,32,60,7,9,16
30,8482737,Zack Bolduc,C,STL,21,55,6,10,16
30,8478443,Brandon Carlo,D,BOS,28,58,4,12,16
30,8480860,Kevin Bahl,D,CGY,24,52,3,13,16
30,8482073,Braden Schneider,D,NYR,23,60,3,13,16
30,8476457,Adam Larsson,D,SEA,32,65,3,13,16
30,8480172,Jan Rutta,D,SJS,34,69,3,13,16
30,8482067,Connor Mackey,D,NYR,28,57,2,14,16
30,8482192,Isaak Phillips,D,CHI,23,57,1,15,16
30,8478831,Kevin Stenlund,C,UTA,28,59,11,4,15
30,8478585,Derek Ryan,C,EDM,38,65,9,6,15
30,8477380,Jonny Brodzinski,C,NYR,31,54,7,8,15
30,8479520,Brandon Duhaime,R,WSH,27,57,7,8,15
30,8482062,Cole Smith,L,NSH,29,55,6,9,15
30,8479439,Jacob MacDonald,D,COL,31,50,6,9,15
30,8481527,Kaedan Korczak,D,VGK,23,53,6,9,15
30,8480806,Isac Lundestrom,C,ANA,25,58,6,9,15
30,8477507,Nikita Zadorov,D,BOS,29,75,5,10,15
30,8483524,Shane Wright,C,SEA,20,51,5,10,15
30,8477406,Mattias Janmark,C,EDM,32,64,4,11,15
30,8484254,Akito Hirose,D,VAN,25,44,4,11,15
30,8475177,Calvin de Haan,D,COL,33,54,3,12,15
30,8475208,Brian Dumoulin,D,ANA,33,70,2,13,15
30,8475690,Chris Tanev,D,TOR,35,57,2,13,15
30,8479414,Nathan Bastian,R,NJD,27,54,10,4,14
30,8475842,Sam Carrick,C,NYR,32,62,9,5,14
30,8476994,Vinnie Hinostroza,C,NSH,30,49,8,6,14
30,8481477,Nico Sturm,C,SJS,29,53,7,7,14
30,8476329,Travis Boyd,C,MIN,31,55,7,7,14
30,8479066,Ryan Lomberg,L,CGY,30,56,6,8,14
30,8481599,Victor Soderstrom,D,UTA,23,45,5,9,14
30,8478451,Ethan Bear,D,WSH,27,46,4,10,14
30,8475188,Brayden McNabb,D,VGK,33,51,3,11,14
30,8479372,Joshua Mahura,D,SEA,26,52,3,11,14
30,8480796,Martin Fehervary,D,WSH,25,54,3,11,14
30,8481701,Santeri Hatakka,D,NJD,23,46,3,11,14
30,8479398,Samuel Girard,D,COL,26,65,2,12,14
30,8475455,Brenden Dillon,D,NJD,34,57,2,12,14
30,8480727,Zach Whitecloud,D,VGK,28,47,2,12,14
30,8476429,Scott Mayfield,D,NYI,32,68,1,13,14
30,8478840,Will Borgen,D,SEA,28,60,0,14,14
30,8482762,Simon Edvinsson,D,DET,21,53,8,5,13
30,8476374,Sean Kuraly,C,CBJ,31,51,7,6,13
30,8477478,William Carrier,L,CAR,30,54,7,6,13
30,8478043,Sam Lafferty,C,BUF,29,57,7,6,13
30,8482666,Scott Morrow,D,CAR,22,48,7,6,13
30,8482166,Shakir Mukhamadullin,D,SJS,22,56,5,8,13
30,8480011,Klim Kostin,C,SJS,25,46,4,9,13
30,8474567,Zach Bogosian,D,MIN,34,67,4,9,13
30,8476442,Matt Nieto,L,PIT,32,56,4,9,13
30,8483495,Simon Nemec,D,NJD,20,50,3,10,13
30,8480887,Jordan Harris,D,MTL,24,48,3,10,13
30,8482451,Mikael Pyyhtia,L,CBJ,23,37,2,11,13
30,8479536,Axel Jonsson-Fjallby,L,WPG,26,32,11,1,12
30,8481013,Jonatan Berggren,R,DET,24,53,8,4,12
30,8480252,Cole Guttman,C,CHI,25,37,8,4,12
30,8477070,Liam O'Brien,C,UTA,30,48,7,5,12
30,8481028,Martin Pospisil,C,CGY,25,58,7,5,12
30,8480025,MacKenzie Entwistle,R,FLA,25,63,6,6,12
30,8481641,Joel Kiviranta,L,COL,28,73,5,7,12
30,8480848,Ty Dellandrea,C,SJS,24,43,5,7,12
30,8482744,James Malatesta,L,CBJ,21,42,4,8,12
30,8474166,Alec Martinez,D,CHI,37,49,4,8,12
30,8478017,Mark Friedman,D,VAN,29,37,4,8,12
30,8475279,Ben Chiarot,D,DET,33,63,3,9,12
30,8478399,Jonas Siegenthaler,D,NJD,27,59,2,10,12
30,8478452,Caleb Jones,D,LAK,27,51,2,10,12
30,8480845,Rasmus Kupari,C,WPG,24,41,2,10,12
30,8470600,Ryan Suter,D,STL,39,60,1,11,12
30,8476913,Devin Shore,C,MIN,30,32,0,12,12
30,8479994,Jaret Anderson-Dolan,C,WPG,25,43,7,4,11
30,8475225,Craig Smith,C,CHI,35,49,6,5,11
30,8480157,Calle Rosen,D,COL,30,42,6,5,11
30,8474034,Patrick Maroon,L,CHI,36,51,5,6,11
30,8482659,Josh Doan,R,UTA,22,58,5,6,11
30,8482784,Zach Dean,C,STL,21,45,5,6,11
30,8480441,Trey Fix-Wolansky,R,CBJ,25,38,5,6,11
30,8483493,Frank Nazar,C,CHI,20,53,4,7,11
30,8482730,Brandt Clarke,D,LAK,21,41,4,7,11
30,8476441,Joel Edmundson,D,LAK,31,42,4,7,11
30,8477450,Jason Dickinson,C,CHI,29,46,3,8,11
30,8477365,Connor Clifton,D,BUF,29,58,3,8,11
30,8474090,Brendan Smith,D,DAL,35,51,3,8,11
30,8479378,Logan Stanley,D,WPG,26,35,2,9,11
30,8475762,Derek Forbort,D,VAN,32,52,2,9,11
30,8478468,Jeremy Lauzon,D,NSH,27,51,2,9,11
30,8475750,Jon Merrill,D,MIN,32,53,1,10,11
30,8479718,Alex Barré-Boulet,C,MTL,27,50,1,10,11
30,8480879,Jacob Bernard-Docker,D,OTT,24,47,0,11,11
30,8479968,Vinni Lettieri,C,BOS,29,45,8,2,10
30,8479944,Zach Aston-Reese,C,VGK,30,44,7,3,10
30,8479359,Beck Malenstyn,L,BUF,26,44,6,4,10
30,8477482,Zachary Sanford,L,CHI,30,32,6,4,10
30,8473453,Trevor Lewis,C,LAK,37,72,5,5,10
30,8476873,Mark Jankowski,C,NSH,30,50,5,5,10
30,8479543,Michael Pezzetta,L,MTL,26,59,5,5,10
30,8482634,Alex Steeves,C,TOR,25,39,5,5,10
30,8478859,Niko Mikkola,D,FLA,28,55,4,6,10
30,8484911,Collin Graf,R,SJS,22,45,4,6,10
30,8471709,Marc-Edouard Vlasic,D,SJS,37,56,3,7,10
30,8475179,Dmitry Kulikov,D,FLA,34,55,3,7,10
30,8481567,Henry Thrun,D,SJS,23,38,3,7,10
30,8476372,Nick Seeler,D,PHI,31,40,3,7,10
30,8480844,Grigori Denisenko,L,VGK,24,39,3,7,10
30,8481019,David Gustafsson,C,WPG,24,47,2,8,10
30,8480807,Mattias Samuelsson,D,BUF,24,50,2,8,10
30,8484149,Gavin Brindley,C,CBJ,20,51,5,4,9
30,8481789,Tye Kartye,L,SEA,23,41,5,4,9
30,8476967,Brett Kulak,D,EDM,30,56,3,6,9
30,8481751,Lukas Rousek,R,BUF,25,40,2,7,9
30,8481600,Tobias Bjornfot,D,FLA,23,38,2,7,9
30,8481598,Philip Broberg,D,EDM,23,46,2,7,9
30,8473446,Erik Johnson,D,PHI,36,44,2,7,9
30,8477335,Kyle Burroughs,D,LAK,29,49,2,7,9
30,8482145,Mavrik Bourque,C,DAL,22,49,2,7,9
30,8477462,Robert Hagg,D,VGK,29,28,2,7,9
30,8480070,Ian Mitchell,D,BOS,25,43,1,8,9
30,8476473,Connor Murphy,D,CHI,31,30,1,8,9
30,8480035,Henri Jokiharju,D,BUF,25,63,0,9,9
30,8480990,Declan Chisholm,D,MIN,24,46,0,9,9
30,8482496,Nils Aman,C,VAN,24,34,6,2,8
30,8482751,Ryan Winterton,C,SEA,21,43,5,3,8
30,8479370,Tyson Jost,C,CAR,26,48,3,5,8
30,8480355,Mark Kastelic,C,BOS,25,58,3,5,8
30,8479442,Troy Stecher,D,EDM,30,61,3,5,8
30,8471817,Ryan Reaves,R,TOR,37,56,3,5,8
30,8477938,Haydn Fleury,D,WPG,28,42,3,5,8
30,8481147,Reese Johnson,C,MIN,26,38,3,5,8
30,8480880,Jakub Lauko,C,MIN,24,36,3,5,8
30,8477810,Joel Hanley,D,CGY,33,22,3,5,8
30,8482095,Tyler Kleven,D,OTT,22,54,2,6,8
30,8476858,Phillip Di Giuseppe,L,VAN,31,40,2,6,8
30,8483460,David Jiricek,D,CBJ,21,54,2,6,8
30,8478874,Adam Gaudette,R,OTT,28,40,2,6,8
30,8478146,Matthew Highmore,C,OTT,28,32,2,6,8
30,8483619,Filip Roos,D,OTT,25,35,2,6,8
30,8482861,Vincent Iorio,D,WSH,22,35,1,7,8
30,8471677,Jack Johnson,D,CBJ,37,64,0,8,8
30,8476624,Barclay Goodrow,C,SJS,31,50,5,2,7
30,8482747,Brennan Othmann,L,NYR,21,35,5,2,7
30,8479981,Jonah Gadjovich,L,FLA,26,39,5,2,7
30,8482652,Walker Duehr,R,CGY,27,43,4,3,7
30,8481518,Nolan Foote,L,NJD,24,43,4,3,7
30,8477851,Jordan Oesterle,D,BOS,32,42,4,3,7
30,8482070,Mitchell Chaffee,R,TBL,26,52,4,3,7
30,8482733,Logan Mailloux,D,MTL,31,36,4,3,7
30,8480007,Jonas Rondbjerg,R,VGK,25,39,3,4,7
30,8478409,Anthony Richard,C,PHI,28,26,3,4,7
30,8479379,Givani Smith,R,SJS,26,35,3,4,7
30,8479348,Kale Clague,D,BUF,26,34,2,5,7
30,8477018,Ben Hutton,D,VGK,31,51,2,5,7
30,8476867,Brendan Gaunce,C,MIN,30,29,2,5,7
30,8478178,Darren Raddysh,D,TBL,28,65,1,6,7
30,8474568,Luke Schenn,D,NSH,35,48,1,6,7
30,8479772,Zack MacEwen,R,OTT,28,47,1,6,7
30,8477887,Patrick Brown,C,BOS,32,51,1,6,7
30,8474013,Ian Cole,D,UTA,35,50,0,7,7
30,8477244,Chad Ruhwedel,D,NYR,34,34,0,7,7
30,8480870,Bo Groulx,C,NYR,24,33,4,2,6
30,8479638,Justin Brazeau,R,BOS,26,41,4,2,6
30,8482144,Jack Thompson,D,SJS,22,26,4,2,6
30,8481541,Samuel Bolduc,D,NYI,24,31,4,2,6
30,8482511,Mason Lohrei,D,BOS,23,34,4,2,6
30,8481556,John Beecher,C,BOS,23,31,4,2,6
30,8482964,Arber Xhekaj,D,MTL,23,50,3,3,6
30,8482172,Landon Slaggert,L,CHI,22,28,3,3,6
30,8481609,Vladislav Kolyachonok,D,UTA,23,35,3,3,6
30,8479985,Cale Fleury,D,SEA,26,24,3,3,6
30,8481708,Zac Jones,D,NYR,24,48,2,4,6
30,8479972,Mason Shaw,C,WPG,26,34,1,5,6
30,8477034,Jaycob Megna,D,FLA,32,48,1,5,6
30,8482713,Mackie Samoskevich,R,FLA,22,39,1,5,6
30,8478450,Parker Wotherspoon,D,BOS,27,32,1,5,6
30,8482153,Brendan Brisson,C,VGK,23,25,0,6,6
30,8482858,Ryker Evans,D,SEA,23,30,0,6,6
30,8483012,Logan Morrison,C,SEA,22,41,5,0,5
30,8481754,Nikita Nesterenko,C,ANA,23,44,4,1,5
30,8483466,Kevin Korchinski,D,CHI,20,53,3,2,5
30,8477527,Ross Johnston,L,ANA,30,26,3,2,5
30,8481532,Alex Turcotte,C,LAK,23,38,2,3,5
30,8478424,Jansen Harkins,C,ANA,27,41,2,3,5
30,8477962,Brendan Lemieux,L,CAR,28,43,2,3,5
30,8482201,Gage Goncalves,C,TBL,23,23,2,3,5
30,8481056,Spencer Stastney,D,NSH,24,32,2,3,5
30,8482765,Isak Rosen,R,BUF,21,33,2,3,5
30,8483763,Maksymilian Szuber,D,UTA,22,26,1,4,5
30,8477401,John Hayden,C,SEA,29,32,1,4,5
30,8479249,Andrew Poturalski,C,SJS,30,30,1,4,5
30,8476952,Dominic Toninato,C,WPG,30,35,1,4,5
30,8484258,Sam Malinski,D,COL,26,24,1,4,5
30,8478021,William Lagesson,D,DET,28,26,1,4,5
30,8478454,Noah Juulsen,D,VAN,27,34,0,5,5
30,8480834,Ty Emberson,D,SJS,24,33,0,5,5
30,8482061,Brandon Biro,L,SEA,26,11,4,0,4
30,8481617,Vasily Podkolzin,R,VAN,23,52,3,1,4
30,8480292,Carson Meyer,R,ANA,27,30,3,1,4
30,8483570,Ben Meyers,C,SEA,26,26,3,1,4
30,8474062,Riley Nash,C,NYR,35,16,3,1,4
30,8474612,Travis Hamonic,D,OTT,34,42,2,2,4
30,8477320,Anton Blidh,L,NYR,29,21,2,2,4
30,8477467,Gustav Olofsson,D,SEA,30,17,2,2,4
30,8482177,Marat Khusnutdinov,C,MIN,22,34,2,2,4
30,8483549,Lucas Condotta,L,MTL,27,29,1,3,4
30,8477384,Joshua Brown,D,EDM,30,36,1,3,4
30,8479576,Vincent Desharnais,D,VAN,28,28,1,3,4
30,8481122,Simon Benoit,D,TOR,26,44,1,3,4
30,8482118,Sam Colangelo,R,ANA,23,15,1,3,4
30,8479419,Brett Murray,L,BUF,26,23,0,4,4
30,8481543,Nikita Alexandrov,C,STL,24,22,3,0,3
30,8483630,Pavol Regenda,L,ANA,25,27,3,0,3
30,8475235,Nicolas Deslauriers,L,PHI,33,51,2,1,3
30,8481679,Maxence Guenette,D,OTT,23,28,2,1,3
30,8481462,Mason Morelli,L,VGK,28,12,2,1,3
30,8480890,Jan Jenik,C,OTT,24,19,2,1,3
30,8482807,Ethan Del Mastro,D,CHI,21,44,1,2,3
30,8481550,Adam Beckman,L,NJD,23,35,1,2,3
30,8480196,Jacob Bryson,D,BUF,27,40,1,2,3
30,8482141,Lukas Cormier,D,VGK,22,19,1,2,3
30,8479991,Jake Leschyshyn,C,NYR,25,26,1,2,3
30,8481030,Jack St. Ivany,D,PIT,25,12,1,2,3
30,8478477,Mitchell Stephens,C,SEA,27,16,1,2,3
30,8482929,Emil Lilleberg,D,TBL,23,22,1,2,3
30,8481065,Angus Crookshank,L,OTT,25,13,1,2,3
30,8482250,Callahan Burke,C,VGK,27,20,0,3,3
30,8478011,Louie Belpedio,D,PHI,28,16,0,3,3
30,8481206,John Ludvig,D,PIT,24,11,0,3,3
30,8483397,Marc McLaughlin,C,BOS,25,30,2,0,2
30,8484287,Cole McWard,D,VAN,23,20,2,0,2
30,8481585,Egor Afanasyev,L,SJS,23,13,2,0,2
30,8479320,Maxime Lajoie,D,SEA,27,25,2,0,2
30,8482094,Daemon Hunt,D,MIN,22,11,2,0,2
30,8477473,Justin Bailey,R,SJS,29,19,2,0,2
30,8480851,Akil Thomas,C,LAK,24,17,2,0,2
30,8480032,Shane Bowers,C,NJD,25,19,2,0,2
30,8481605,Jackson LaCombe,D,ANA,23,36,1,1,2
30,8480245,Olle Lycksell,R,PHI,25,34,1,1,2
30,8482165,Yan Kuznetsov,D,CGY,22,13,1,1,2
30,8481699,Aku Raty,R,UTA,23,10,1,1,2
30,8475958,Michael Sgarbossa,C,WSH,32,31,1,1,2
30,8477073,Kurtis MacDermid,L,NJD,30,30,1,1,2
30,8481593,Jayden Struble,D,MTL,23,33,1,1,2
30,8479362,Riley Tufte,L,BOS,26,12,1,1,2
30,8480823,Alexander Alexeyev,D,WSH,25,11,1,1,2
30,8484325,Waltteri Merela,C,TBL,26,18,1,1,2
30,8482102,Vasily Ponomarev,C,PIT,22,21,1,1,2
30,8483567,Georgii Merkulov,C,BOS,24,9,1,1,2
30,8484304,Uvis Balinskis,D,FLA,28,12,1,1,2
30,8482197,Adam Raska,R,MIN,23,8,1,1,2
30,8480874,Adam Ginning,D,PHI,24,11,1,1,2
30,8481743,Marc Del Gaizo,D,NSH,25,20,0,2,2
30,8477971,Andreas Englund,D,LAK,28,33,0,2,2
30,8482470,Ilya Solovyov,D,CGY,24,15,0,2,2
30,8478502,Dennis Gilbert,D,BUF,28,23,0,2,2
30,8476323,Max McCormick,L,SEA,32,6,0,2,2
30,8480075,Cameron Crotty,D,MIN,25,11,0,2,2
30,8481006,Tyler Tucker,D,STL,24,10,1,0,1
30,8482147,Jean-Luc Foudy,C,COL,22,22,1,0,1
30,8480267,Sammy Walker,C,MIN,25,16,1,0,1
30,8484326,Patrik Koch,D,UTA,28,2,1,0,1
30,8481719,Maxwell Crozier,D,TBL,24,17,1,0,1
30,8483395,Arshdeep Bains,L,VAN,23,12,1,0,1
30,8483489,Fraser Minten,C,TOR,31,7,1,0,1
30,8481024,Linus Karlsson,C,VAN,25,11,1,0,1
30,8475780,Chris Wagner,R,COL,33,6,1,0,1
30,8478051,Max Willman,C,NJD,29,16,1,0,1
30,8478854,Ryan Shea,D,PIT,27,10,1,0,1
30,8481237,Kyle MacLean,C,NYI,25,21,0,1,1
30,8480468,James Hamblin,L,EDM,25,22,0,1,1
30,8483471,Brad Lambert,C,WPG,31,9,0,1,1
30,8480084,Nick DeSimone,D,NJD,30,16,0,1,1
30,8482088,Justin Sourdif,R,FLA,22,16,0,1,1
30,8481422,Jake Lucchini,C,NSH,29,14,0,1,1
30,8477149,Scott Sabourin,R,SJS,32,21,0,1,1
30,8483546,Marshall Rifai,D,TOR,26,6,0,1,1
30,8479330,Brandon Gignac,C,MTL,27,9,0,1,1
30,8479421,Jacob Moverare,D,LAK,26,9,0,1,1
30,8482126,Emil Andrae,D,PHI,31,2,0,1,1
30,8479587,Rhett Gardner,C,PHI,28,23,0,1,1
30,8482460,Matt Rempe,C,NYR,22,12,0,1,1
30,8481726,Adam Edstrom,C,NYR,24,6,0,1,1
30,8479367,William Lockwood,R,FLA,26,19,0,0,0
30,8482516,Matthew Kessel,D,STL,24,17,0,0,0
30,8478881,Brett Seney,L,CHI,28,13,0,0,0
30,8483512,Matthew Savoie,C,EDM,20,16,0,0,0
30,8478446,Glenn Gawdin,C,LAK,27,10,0,0,0
30,8481655,Cole Schwindt,R,CGY,23,6,0,0,0
30,8475413,Justin Dowling,C,NJD,34,13,0,0,0
30,8481806,Louis Crevier,D,CHI,23,19,0,0,0
30,8481564,Ryan Johnson,D,BUF,23,16,0,0,0
30,8483407,Brandon Scanlin,D,NYR,25,4,0,0,0
30,8483597,Milos Kelemen,L,UTA,25,6,0,0,0
30,8483531,Brian Halonen,L,NJD,25,3,0,0,0
30,8481043,Cole Koepke,L,BOS,26,16,0,0,0
30,8481578,Graeme Clarke,R,MIN,23,8,0,0,0
30,8475755,Alexander Petrovic,D,DAL,32,8,0,0,0
30,8482476,Emil Heineman,L,MTL,23,7,0,0,0
30,8479522,Hardy Haman Aktell,D,WSH,26,5,0,0,0
30,8484255,Jason Polin,R,COL,25,7,0,0,0
30,8475795,Dylan McIlrath,D,WSH,32,12,0,0,0
30,8483398,Declan Carlile,D,TBL,31,4,0,0,0
30,8477541,Dakota Mermis,D,TOR,30,8,0,0,0
30,8482162,Roby Jarventie,L,EDM,22,14,0,0,0
30,8480306,Grant Hutton,D,NYI,29,9,0,0,0
30,8482787,Nikita Chibrikov,R,WPG,31,4,0,0,0
30,8477993,Justin Kirkland,C,CGY,28,8,0,0,0
30,8478147,Bokondji Imama,L,PIT,28,7,0,0,0
30,8483920,Pierrick Dube,R,WSH,23,4,0,0,0
30,8483432,Luca Del Bel Belluz,C,CBJ,31,3,0,0,0
30,8483401,Marc Johnstone,R,PIT,28,4,0,0,0
30,8483609,Adam Klapka,R,CGY,24,3,0,0,0
30,8484259,Ondrej Pavel,C,COL,31,1,0,0,0
30,8480274,Philip Kemp,D,EDM,25,1,0,0,0
30,8484321,Nikolas Matinpalo,D,OTT,26,2,0,0,0
30,8481534,Raphael Lavoie,C,EDM,24,1,0,0,0
30,8470794,Joe Pavelski,C,,40,0,0,0,0
30,8479321,Lucas Johansen,D,,27,0,0,0,0
30,8477950,Tony DeAngelo,D,,29,0,0,0,0
30,8471218,Blake Wheeler,R,,38,0,0,0,0
30,8475197,Tyson Barrie,D,,33,0,0,0,0
30,8474157,Max Pacioretty,L,,36,0,0,0,0
30,8475744,Evgeny Kuznetsov,C,,32,0,0,0,0
30,8474037,James van Riemsdyk,L,,35,0,0,0,0
30,8476907,Mackenzie MacEachern,L,,30,0,0,0,0
30,8480216,Jacob Peterson,C,,25,0,0,0,0
30,8474602,Justin Schultz,D,,34,0,0,0,0
30,8482222,Alexander Barabanov,L,,30,0,0,0,0
30,8474031,Kevin Shattenkirk,D,,35,0,0,0,0
30,8477330,Dominik Kubalik,L,,29,0,0,0,0
30,8480884,Calen Addison,D,,24,0,0,0,0
30,8475906,John Klingberg,D,,32,0,0,0,0
30,8480008,Adam Ruzicka,C,,25,0,0,0,0
30,8476884,Derrick Pouliot,D,,30,0,0,0,0
30,8476919,Chris Tierney,C,,30,0,0,0,0
30,8479415,Michael McLeod,C,,26,0,0,0,0
30,8474870,Tyler Johnson,C,,34,0,0,0,0
30,8470604,Jeff Carter,C,,39,0,0,0,0
30,8478104,Sammy Blais,L,,28,0,0,0,0
30,8474884,Mike Hoffman,C,,35,0,0,0,0
30,8481591,Sam Poulin,R,,23,0,0,0,0
30,8471274,Alex Goligoski,D,,39,0,0,0,0
30,8476871,Tanner Pearson,L,,32,0,0,0,0
30,8476393,Nick Cousins,C,,31,0,0,0,0
30,8479977,Kailer Yamamoto,R,,26,0,0,0,0
30,8479346,Dillon Dube,C,,26,0,0,0,0
30,8480184,Gustav Lindstrom,D,,26,0,0,0,0
30,8479376,Victor Mete,D,,26,0,0,0,0
30,8473449,Kyle Okposo,R,,36,0,0,0,0
30,8481058,Jesse Ylonen,R,,25,0,0,0,0
30,8475752,Tyler Pitlick,C,,33,0,0,0,0
30,8481239,Samuel Fagemo,L,,24,0,0,0,0
30,8480821,Filip Zadina,R,,25,0,0,0,0
30,8470966,Mark Giordano,D,,41,0,0,0,0
30,8478495,Denis Gurianov,R,,27,0,0,0,0
30,8477464,Nic Petan,C,,29,0,0,0,0
30,8478099,Kevin Labanc,R,,29,0,0,0,0
30,8482241,Radim Zohorna,L,,28,0,0,0,0
30,8474040,Sam Gagner,C,,35,0,0,0,0
30,8479514,Rem Pitlick,C,,27,0,0,0,0
30,8478430,Oliver Kylington,D,,27,0,0,0,0
30,8479533,Joona Koppanen,L,,26,0,0,0,0
30,8479984,Cal Foote,D,,26,0,0,0,0
30,8477126,Jayson Megna,C,,34,0,0,0,0
30,8475164,Jakob Silfverberg,R,,34,0,0,0,0
30,8474009,Nick Bonino,C,,36,0,0,0,0
30,8479458,Nikita Zaitsev,D,,33,0,0,0,0
30,8477944,Jakub Vrana,L,,28,0,0,0,0
30,8471699,Andrew Cogliano,C,,37,0,0,0,0
30,8478067,Oskar Lindblom,L,,28,0,0,0,0
30,8471686,Marc Staal,D,,37,0,0,0,0
30,8470610,Zach Parise,L,,40,0,0,0,0
30,8478904,Steven Lorentz,C,,28,0,0,0,0
30,8473473,Milan Lucic,L,,36,0,0,0,0
30,8480031,Maxime Comtois,L,,25,0,0,0,0
30,8478512,Austin Czarnik,C,,32,0,0,0,0
30,8473504,Cal Clutterbuck,R,,37,0,0,0,0
30,8477454,Adam Erne,L,,29,0,0,0,0
30,8479383,Boris Katchouk,L,,26,0,0,0,0
30,8475825,Jani Hakanpää,D,,32,0,0,0,0
30,8477846,Ryan Carpenter,C,,33,0,0,0,0
30,8477930,Pierre-Edouard Bellemare,L,,39,0,0,0,0
30,8478400,Colin White,C,,27,0,0,0,0
30,8480226,Marián Studenic,R,,26,0,0,0,0
30,8480853,Liam Foudy,C,,24,0,0,0,0
30,8475797,Jarred Tinordi,D,,32,0,0,0,0
30,8479423,Alex Nylander,L,,26,0,0,0,0
30,8474618,Marco Scandella,D,,34,0,0,0,0
30,8478028,Fredrik Olofsson,L,,28,0,0,0,0
30,8474709,Matt Martin,L,,35,0,0,0,0
30,8481070,Hugh McGing,L,,26,0,0,0,0
30,8479546,Oskar Steen,C,,26,0,0,0,0
30,8474145,Robert Bortuzzo,D,,35,0,0,0,0
30,8476915,Jujhar Khaira,L,,30,0,0,0,0
30,8475278,Byron Froese,C,,33,0,0,0,0
30,8481812,Nikolai Knyzhov,D,,27,0,0,0,0
30,8478408,Travis Dermott,D,,28,0,0,0,0
30,8481077,John Leonard,L,,26,0,0,0,0
30,8479547,Matthew Phillips,R,,26,0,0,0,0
30,8480836,Jonathan Gruden,C,,24,0,0,0,0
30,8481690,Tyler Angle,C,,24,0,0,0,0
30,8475766,Austin Watson,L,,32,0,0,0,0
30,8481016,Ruslan Iskhakov,C,,24,0,0,0,0
30,8478078,Rourke Chartier,C,,28,0,0,0,0
30,8480776,Sheldon Rempal,R,,29,0,0,0,0
30,8478956,Samuel Laberge,L,NJD,27,1,0,0,0
30,8483045,Cameron Butler,R,CBJ,31,1,0,0,0
30,8484314,Jiri Smejkal,L,,28,0,0,0,0
31,8477492,Nathan MacKinnon,C,COL,29,82,52,76,128
31,8478402,Connor McDavid,C,EDM,27,79,39,89,128
31,8481559,Jack Hughes,C,NJD,23,77,49,77,126
31,8476453,Nikita Kucherov,R,TBL,31,82,44,82,126
31,8479318,Auston Matthews,C,TOR,27,75,65,57,122
31,8477939,William Nylander,R,TOR,28,80,56,63,119
31,8477956,David Pastrnak,R,BOS,28,80,46,72,118
31,8478420,Mikko Rantanen,R,COL,28,81,43,67,110
31,8477946,Dylan Larkin,C,DET,28,82,49,57,106
31,8478864,Kirill Kaprizov,L,MIN,27,73,47,58,105
31,8476468,J.T. Miller,C,VAN,31,77,40,64,104
31,8478550,Artemi Panarin,L,NYR,33,79,35,67,102
31,8479314,Matthew Tkachuk,L,FLA,27,79,36,65,101
31,8477493,Aleksander Barkov,C,FLA,29,74,26,74,100
31,8477934,Leon Draisaitl,C,EDM,29,79,33,66,99
31,8478010,Brayden Point,C,TBL,28,82,50,48,98
31,8477942,Kevin Fiala,L,LAK,28,79,39,57,96
31,8477409,Carter Verhaeghe,C,FLA,29,80,47,48,95
31,8474564,Steven Stamkos,C,NSH,34,77,39,55,94
31,8477933,Sam Reinhart,C,FLA,29,79,50,43,93
31,8478427,Sebastian Aho,C,CAR,27,73,43,50,93
31,8480069,Cale Makar,D,COL,26,70,19,73,92
31,8480830,Andrei Svechnikov,R,CAR,24,75,34,57,91
31,8480002,Nico Hischier,C,NJD,25,80,32,58,90
31,8476887,Filip Forsberg,L,NSH,30,74,42,45,87
31,8478483,Mitch Marner,R,TOR,27,78,24,63,87
31,8480012,Elias Pettersson,C,VAN,26,70,30,56,86
31,8475166,John Tavares,C,TOR,34,78,35,50,85
31,8478445,Mathew Barzal,C,NYI,27,79,23,60,83
31,8476454,Ryan Nugent-Hopkins,C,EDM,31,78,27,55,82
31,8480801,Brady Tkachuk,L,OTT,25,82,38,43,81
31,8480023,Robert Thomas,C,STL,25,76,19,62,81
31,8473419,Brad Marchand,L,BOS,36,80,24,56,80
31,8479343,Clayton Keller,R,UTA,26,77,39,40,79
31,8471675,Sidney Crosby,C,PIT,37,72,36,43,79
31,8475172,Nazem Kadri,C,CGY,34,78,33,46,79
31,8476459,Mika Zibanejad,C,NYR,31,76,30,49,79
31,8476389,Vincent Trocheck,C,NYR,31,73,33,45,78
31,8477404,Jake Guentzel,C,TBL,30,82,32,46,78
31,8478401,Pavel Zacha,C,BOS,27,82,32,46,78
31,8484144,Connor Bedard,C,CHI,19,67,31,47,78
31,8478439,Travis Konecny,R,PHI,27,75,35,42,77
31,8477955,Jared McCann,L,SEA,28,76,40,36,76
31,8478444,Brock Boeser,R,VAN,27,77,32,44,76
31,8478873,Troy Terry,R,ANA,27,78,26,50,76
31,8475913,Mark Stone,R,VGK,32,77,25,51,76
31,8480027,Jason Robertson,L,DAL,25,81,22,54,76
31,8476346,Johnny Gaudreau,L,CBJ,31,68,17,59,76
31,8477501,Valeri Nichushkin,R,COL,29,81,39,36,75
31,8471215,Evgeni Malkin,C,PIT,38,71,20,55,75
31,8480036,Miro Heiskanen,D,DAL,25,79,13,62,75
31,8476456,Jonathan Huberdeau,C,CGY,31,78,11,64,75
31,8479420,Tage Thompson,C,BUF,27,73,46,28,74
31,8471214,Alex Ovechkin,L,WSH,39,69,32,42,74
31,8479337,Alex DeBrincat,R,DET,27,77,31,43,74
31,8482109,Alexis Lafrenière,L,NYR,23,72,30,44,74
31,8476853,Morgan Rielly,D,TOR,30,73,16,58,74
31,8477476,Artturi Lehkonen,L,COL,29,82,32,41,73
31,8477402,Pavel Buchnevich,L,STL,29,77,31,42,73
31,8478414,Timo Meier,R,NJD,28,78,29,44,73
31,8474600,Roman Josi,D,NSH,34,73,14,59,73
31,8478460,Zach Werenski,D,CBJ,27,79,12,61,73
31,8479407,Jesper Bratt,L,NJD,26,72,29,43,72
31,8482745,Mason McTavish,C,ANA,21,71,26,46,72
31,8475692,Mats Zuccarello,R,MIN,37,76,20,52,72
31,8476539,Jonathan Marchessault,R,NSH,34,76,39,32,71
31,8478403,Jack Eichel,C,VGK,28,78,29,42,71
31,8479385,Jordan Kyrou,C,STL,26,78,27,44,71
31,8479323,Adam Fox,D,NYR,26,76,9,62,71
31,8475184,Chris Kreider,L,NYR,33,78,41,29,70
31,8478449,Roope Hintz,C,DAL,28,81,31,39,70
31,8473994,Jamie Benn,L,DAL,35,81,25,45,70
31,8475786,Zach Hyman,L,EDM,32,76,44,25,69
31,8475810,Bryan Rust,R,PIT,32,70,38,31,69
31,8482093,Seth Jarvis,C,CAR,22,73,29,40,69
31,8473512,Claude Giroux,R,OTT,36,79,20,49,69
31,8482078,Lucas Raymond,L,DET,22,81,30,38,68
31,8477951,Nick Schmaltz,C,UTA,28,77,29,39,68
31,8477496,Elias Lindholm,C,BOS,30,77,26,42,68
31,8476460,Mark Scheifele,C,WPG,31,73,18,50,68
31,8478407,Vince Dunn,D,SEA,28,75,12,56,68
31,8474578,Erik Karlsson,D,PIT,34,82,19,48,67
31,8470613,Brent Burns,D,CAR,39,73,12,55,67
31,8476881,Tomas Hertl,C,VGK,31,78,33,33,66
31,8481557,Matt Boldy,L,MIN,23,72,21,45,66
31,8478398,Kyle Connor,L,WPG,28,80,31,34,65
31,8477960,Adrian Kempe,R,LAK,28,80,30,35,65
31,8475168,Matt Duchene,C,DAL,33,81,27,38,65
31,8475765,Vladimir Tarasenko,R,DET,33,80,19,46,65
31,8475167,Victor Hedman,D,TBL,34,80,17,48,65
31,8477503,Max Domi,C,TOR,29,77,16,48,64
31,8477500,Bo Horvat,C,NYI,29,81,39,24,63
31,8482116,Tim Stützle,C,OTT,22,77,24,39,63
31,8477940,Nikolaj Ehlers,L,WPG,28,75,24,39,63
31,8480208,Drake Batherson,R,OTT,26,80,28,34,62
31,8481068,Yegor Sharangovich,C,CGY,26,79,27,35,62
31,8471685,Anze Kopitar,C,LAK,37,80,23,39,62
31,8475726,Tyler Toffoli,C,SJS,32,69,34,26,60
31,8481540,Cole Caufield,R,MTL,23,76,29,31,60
31,8482699,Dylan Guenther,R,UTA,21,75,23,37,60
31,8478440,Dylan Strome,C,WSH,27,76,21,39,60
31,8478047,Michael Bunting,L,PIT,29,70,21,39,60
31,8477949,Alex Tuch,R,BUF,28,63,16,44,60
31,8480839,Rasmus Dahlin,D,BUF,24,76,14,46,60
31,8477456,J.T. Compher,L,DET,29,82,28,31,59
31,8480018,Nick Suzuki,C,MTL,25,75,25,34,59
31,8474679,Gustav Nyquist,C,NSH,35,74,21,38,59
31,8480800,Quinn Hughes,D,VAN,25,69,5,54,59
31,8477935,Sam Bennett,C,FLA,28,76,25,33,58
31,8475794,Tyler Seguin,C,DAL,32,82,28,29,57
31,8475745,Charlie Coyle,C,BOS,32,80,23,34,57
31,8480803,Evan Bouchard,D,EDM,25,80,12,45,57
31,8476826,Yanni Gourde,C,SEA,33,75,27,29,56
31,8477426,Nicholas Paul,L,TBL,29,82,27,29,56
31,8481528,Dylan Cozens,C,BUF,23,76,26,30,56
31,8476906,Shayne Gostisbehere,D,CAR,31,77,13,43,56
31,8483808,Andrei Kuzmenko,L,CGY,28,72,34,21,55
31,8480015,Owen Tippett,R,PHI,25,79,32,23,55
31,8482740,Wyatt Johnston,C,DAL,21,82,28,27,55
31,8478856,Conor Garland,R,VAN,28,75,23,32,55
31,8481533,Trevor Zegras,C,ANA,23,73,21,34,55
31,8478438,Tommy Novak,C,NSH,27,69,19,36,55
31,8480039,Martin Necas,C,CAR,25,68,15,40,55
31,8476905,Chandler Stephenson,C,SEA,30,74,14,41,55
31,8471724,Kris Letang,D,PIT,37,80,11,44,55
31,8479325,Charlie McAvoy,D,BOS,27,74,10,45,55
31,8479675,Trevor Moore,L,LAK,29,80,29,25,54
31,8478366,Frank Vatrano,R,ANA,30,72,26,28,54
31,8476399,Blake Coleman,C,CGY,33,78,25,29,54
31,8478493,Joel Eriksson Ek,C,MIN,27,67,25,29,54
31,8482124,Quinton Byfield,R,LAK,22,81,20,34,54
31,8474141,Patrick Kane,R,DET,36,82,16,38,54
31,8475754,Brock Nelson,C,NYI,33,78,28,25,53
31,8477444,Andre Burakovsky,L,SEA,29,67,24,29,53
31,8479542,Brandon Hagel,L,TBL,26,82,22,31,53
31,8478519,Anthony Cirelli,C,TBL,27,82,22,31,53
31,8473986,Alex Killorn,L,ANA,35,73,21,32,53
31,8478055,Gustav Forsling,D,FLA,28,73,17,36,53
31,8475158,Ryan O'Reilly,C,NSH,33,68,24,28,52
31,8476875,Mike Matheson,D,MTL,30,73,17,35,52
31,8483431,Logan Cooley,C,UTA,20,76,27,24,51
31,8477416,Oliver Bjorkstrand,R,SEA,29,80,25,26,51
31,8476448,William Karlsson,C,VGK,31,77,24,27,51
31,8474590,John Carlson,D,WSH,34,67,11,40,51
31,8482684,Luke Hughes,D,NJD,21,75,6,45,51
31,8475784,Jeff Skinner,C,EDM,32,76,32,18,50
31,8482097,Jack Quinn,R,BUF,23,72,25,25,50
31,8475169,Evander Kane,L,EDM,33,77,24,26,50
31,8482146,Luke Evangelista,R,NSH,22,68,23,27,50
31,8479999,Casey Mittelstadt,C,COL,26,78,20,30,50
31,8482665,Matty Beniers,C,SEA,22,70,19,31,50
31,8481711,Matias Maccelli,L,UTA,24,77,17,33,50
31,8478469,Thomas Chabot,D,OTT,27,72,15,35,50
31,8478038,Devon Toews,D,COL,30,69,10,40,50
31,8481703,Valtteri Puustinen,R,PIT,25,68,10,40,50
31,8480865,Noah Dobson,D,NYI,24,79,8,42,50
31,8476432,Boone Jenner,C,CBJ,31,70,27,22,49
31,8478046,Danton Heinen,L,VAN,29,72,26,23,49
31,8484153,Leo Carlsson,C,ANA,20,78,25,24,49
31,8482110,Dawson Mercer,C,NJD,23,71,24,25,49
31,8478975,Mason Marchment,L,DAL,29,82,20,29,49
31,8475170,Brayden Schenn,C,STL,33,62,19,30,49
31,8474150,Mikael Backlund,C,CGY,35,74,18,31,49
31,8478542,Evan Rodrigues,C,FLA,31,79,18,31,49
31,8477932,Aaron Ekblad,D,FLA,28,75,12,37,49
31,8474586,Jordan Eberle,R,SEA,34,71,22,26,48
31,8482159,Tyson Foerster,R,PHI,22,77,20,28,48
31,8480797,Joel Farabee,L,PHI,24,71,20,28,48
31,8483515,Juraj Slafkovsky,L,MTL,20,75,17,31,48
31,8477504,Josh Morrissey,D,WPG,29,73,13,35,48
31,8474565,Alex Pietrangelo,D,VGK,34,66,12,36,48
31,8477451,Ryan Hartman,R,MIN,30,64,23,24,47
31,8475287,Erik Haula,L,NJD,33,72,21,26,47
31,8476880,Tom Wilson,R,WSH,30,69,21,26,47
31,8474102,David Perron,L,OTT,36,77,18,29,47
31,8478397,Rasmus Andersson,D,CGY,28,67,13,34,47
31,8474563,Drew Doughty,D,LAK,35,72,9,38,47
31,8477964,Ivan Barbashev,C,VGK,29,78,22,24,46
31,8474641,Adam Henrique,C,EDM,34,75,20,26,46
31,8484166,Adam Fantilli,C,CBJ,20,68,18,28,46
31,8477494,Jonathan Drouin,L,COL,29,80,17,29,46
31,8481596,Shane Pinto,C,OTT,24,79,17,29,46
31,8478458,John (Jack) Roslovic,C,CAR,27,70,13,33,46
31,8476923,Damon Severson,D,CBJ,30,78,11,35,46
31,8477495,Seth Jones,D,CHI,30,71,4,42,46
31,8477479,Tyler Bertuzzi,L,CHI,29,62,26,19,45
31,8475151,Kyle Palmieri,C,NYI,33,81,23,22,45
31,8479339,Patrik Laine,L,CBJ,26,69,20,25,45
31,8476882,Teuvo Teravainen,C,CHI,30,69,20,25,45
31,8479525,Ross Colton,C,COL,28,81,17,28,45
31,8477021,Alex Kerfoot,C,UTA,30,78,12,33,45
31,8479410,Mikhail Sergachev,D,UTA,26,69,7,38,45
31,8478474,Lawson Crouse,L,UTA,27,77,22,22,44
31,8477497,Sean Monahan,C,CBJ,30,69,17,27,44
31,8474716,Jared Spurgeon,D,MIN,35,77,17,27,44
31,8476792,Torey Krug,D,STL,33,72,10,34,44
31,8475793,Ryan Johansen,C,PHI,32,78,23,20,43
31,8482667,William Eklund,L,SJS,22,68,21,22,43
31,8477998,Warren Foegele,L,LAK,28,81,17,26,43
31,8480798,Philipp Kurashev,C,CHI,25,70,17,26,43
31,8477407,Anthony Duclair,L,NYI,29,79,16,27,43
31,8482720,Matthew Knies,L,TOR,22,76,16,27,43
31,8478057,Dakota Joshua,C,VAN,28,70,17,25,42
31,8481186,Logan O'Connor,R,COL,28,75,17,25,42
31,8477989,Christian Dvorak,C,MTL,28,72,14,28,42
31,8482113,Anton Lundell,C,FLA,23,76,12,30,42
31,8475768,Jaden Schwartz,C,SEA,32,68,12,30,42
31,8476292,Ondrej Palat,L,NJD,33,69,12,30,42
31,8480434,Sean Durzi,D,UTA,26,68,11,31,42
31,8481581,Thomas Harley,D,DAL,23,76,8,34,42
31,8477498,Darnell Nurse,D,EDM,29,71,8,34,42
31,8476483,Rickard Rakell,R,PIT,31,66,21,20,41
31,8475753,Justin Faulk,D,STL,32,71,17,24,41
31,8478042,Viktor Arvidsson,L,EDM,31,77,17,24,41
31,8480028,Morgan Frost,C,PHI,25,75,15,26,41
31,8477447,Shea Theodore,D,VGK,29,68,11,30,41
31,8479425,Filip Hronek,D,VAN,27,77,10,31,41
31,8476869,Brady Skjei,D,NSH,30,72,10,31,41
31,8478472,Mathieu Joseph,R,STL,27,65,9,32,41
31,8475799,Nino Niederreiter,R,WPG,32,69,24,16,40
31,8479400,Pierre-Luc Dubois,L,WSH,26,66,19,21,40
31,8478498,Jake DeBrusk,L,VAN,28,73,19,21,40
31,8478233,Andrew Mangiapane,L,WSH,28,65,18,22,40
31,8476278,Colin Blackwell,C,DAL,31,76,18,22,40
31,8484203,Bradly Nadeau,L,CAR,19,71,17,23,40
31,8476458,Ryan Strome,C,ANA,31,68,17,23,40
31,8478462,Nicolas Roy,C,VGK,27,78,14,26,40
31,8483505,Matthew Poitras,C,BOS,20,69,13,27,40
31,8482660,Kent Johnson,C,CBJ,22,66,9,31,40
31,8478466,Daniel Sprong,R,VAN,27,69,24,15,39
31,8479987,Morgan Geekie,C,BOS,26,74,16,23,39
31,8477429,Andrew Copp,C,DET,30,81,15,24,39
31,8481618,Alex Newhook,C,MTL,23,65,15,24,39
31,8480871,Adam Boqvist,D,FLA,24,73,15,24,39
31,8476479,Phillip Danault,C,LAK,31,78,12,27,39
31,8482624,Daniil Miromanov,D,CGY,27,65,12,27,39
31,8476462,Dougie Hamilton,D,NJD,31,63,11,28,39
31,8475798,Mikael Granlund,C,SJS,32,70,8,31,39
31,8476854,Hampus Lindholm,D,BOS,30,73,8,31,39
31,8480829,Jesperi Kotkaniemi,C,CAR,24,66,18,20,38
31,8481554,Kaapo Kakko,R,NYR,23,68,18,20,38
31,8475191,Reilly Smith,R,NYR,33,73,15,23,38
31,8477511,Anthony Mantha,R,CGY,30,79,11,27,38
31,8477986,Brandon Montour,D,SEA,30,70,6,32,38
31,8480813,Joe Veleno,C,DET,24,78,16,21,37
31,8474053,Logan Couture,C,SJS,35,68,14,23,37
31,8476872,Scott Laughton,C,PHI,30,71,13,24,37
31,8478396,Noah Hanifin,D,VGK,27,63,12,25,37
31,8479591,Michael Eyssimont,C,TBL,28,81,17,19,36
31,8475149,Marcus Johansson,L,MIN,34,62,14,22,36
31,8481523,Kirby Dach,C,MTL,23,73,13,23,36
31,8475218,Mattias Ekholm,D,EDM,34,76,9,27,36
31,8480220,Noah Cates,L,PHI,25,68,7,29,36
31,8476958,Jaccob Slavin,D,CAR,30,78,6,30,36
31,8482122,Brock Faber,D,MIN,22,79,3,33,36
31,8482089,Jake Neighbours,L,STL,22,74,21,14,35
31,8482055,Drew O'Connor,L,PIT,26,66,19,16,35
31,8482175,JJ Peterka,R,BUF,22,75,18,17,35
31,8475760,Nick Bjugstad,C,UTA,32,72,18,17,35
31,8475714,Calle Jarnkrok,C,TOR,33,75,17,18,35
31,8473533,Jordan Staal,C,CAR,36,64,17,18,35
31,8477987,Ryan Donato,C,CHI,28,65,16,19,35
31,8471698,T.J. Oshie,R,WSH,38,66,16,19,35
31,8476921,Jordan Martinook,L,CAR,32,62,14,21,35
31,8479992,Michael Rasmussen,C,DET,25,73,12,23,35
31,8479345,Jakob Chychrun,D,WSH,26,69,12,23,35
31,8481656,Aliaksei Protas,C,WSH,23,69,10,25,35
31,8481606,Jordan Spence,D,LAK,23,66,9,26,35
31,8475764,Cam Fowler,D,ANA,33,77,2,33,35
31,8478020,Michael Amadio,R,OTT,28,74,21,13,34
31,8482475,Yegor Chinakhov,R,CBJ,23,62,19,15,34
31,8481535,Nils Hoglander,L,VAN,24,68,19,15,34
31,8482702,Logan Stankoven,C,DAL,21,82,16,18,34
31,8476925,Colton Sissons,C,NSH,31,64,15,19,34
31,8481582,Nicholas Robertson,L,TOR,23,69,14,20,34
31,8480185,Eetu Luostarinen,C,FLA,26,72,12,22,34
31,8476419,Jean-Gabriel Pageau,C,NYI,32,78,11,23,34
31,8483565,Nick Blankenburg,D,NSH,26,65,11,23,34
31,8483445,Cutter Gauthier,L,ANA,20,65,10,24,34
31,8476438,Brandon Saad,L,STL,32,70,20,13,33
31,8475314,Anders Lee,L,NYI,34,79,19,14,33
31,8475848,Brendan Gallagher,R,MTL,32,68,15,18,33
31,8480849,Barrett Hayton,C,UTA,24,71,15,18,33
31,8480459,Pius Suter,C,VAN,28,69,12,21,33
31,8482092,Ridly Greig,C,OTT,22,77,11,22,33
31,8481524,Bowen Byram,D,BUF,23,71,11,22,33
31,8480817,K'Andre Miller,D,NYR,24,71,10,23,33
31,8481577,Philip Tomasino,C,NSH,23,60,9,24,33
31,8482671,Owen Power,D,BUF,22,68,9,24,33
31,8481546,Cam York,D,PHI,23,72,8,25,33
31,8483490,Pavel Mintyukov,D,ANA,21,70,7,26,33
31,8477948,Travis Sanheim,D,PHI,28,71,6,27,33
31,8475193,Tomas Tatar,L,NJD,34,71,18,14,32
31,8481560,Arthur Kaliyev,R,LAK,23,79,15,17,32
31,8480188,Fabian Zetterlund,L,SJS,25,66,13,19,32
31,8474149,Evgenii Dadonov,R,DAL,35,80,11,21,32
31,8480009,Eeli Tolvanen,R,SEA,25,69,10,22,32
31,8480336,Sean Walker,D,CAR,30,71,10,22,32
31,8480893,Kirill Marchenko,R,CBJ,24,59,23,8,31
31,8481604,Pavel Dorofeyev,L,VGK,24,70,18,13,31
31,8482149,Cole Perfetti,C,WPG,22,60,12,19,31
31,8476461,Sean Couturier,C,PHI,32,66,12,19,31
31,8473422,Nick Foligno,L,CHI,37,52,12,19,31
31,8481542,Moritz Seider,D,DET,23,71,9,22,31
31,8477346,MacKenzie Weegar,D,CGY,30,73,5,26,31
31,8479983,Mario Ferraro,D,SJS,26,74,5,26,31
31,8479402,Jake Bean,D,CGY,26,69,3,28,31
31,8476931,Jake McCabe,D,TOR,31,65,1,30,31
31,8482079,Marco Rossi,C,MIN,23,59,18,12,30
31,8479941,Justin Danforth,R,CBJ,31,63,16,14,30
31,8480064,Josh Norris,C,OTT,25,77,15,15,30
31,8474715,Cameron Atkinson,R,TBL,35,82,14,16,30
31,8476981,Josh Anderson,R,MTL,30,70,14,16,30
31,8478115,Pierre Engvall,L,NYI,28,77,12,18,30
31,8477953,Kasperi Kapanen,R,STL,28,70,10,20,30
31,8475200,Dmitry Orlov,D,CAR,33,78,8,22,30
31,8482712,Oskar Olausson,R,COL,22,79,3,27,30
31,8478507,John Marino,D,UTA,27,67,3,27,30
31,8475722,Jason Zucker,L,BUF,32,66,16,13,29
31,8477380,Jonny Brodzinski,C,NYR,31,55,15,14,29
31,8479661,Tanner Jeannot,L,LAK,27,71,14,15,29
31,8470621,Corey Perry,R,EDM,39,71,14,15,29
31,8476927,Teddy Blueger,C,VAN,30,61,10,19,29
31,8478413,Jordan Greenway,L,BUF,27,67,9,20,29
31,8476422,Mike Reilly,D,NYI,31,78,9,20,29
31,8477969,Marcus Pettersson,D,PIT,28,74,6,23,29
31,8476885,Jacob Trouba,D,NYR,30,68,3,26,29
31,8479365,Trent Frederic,C,BOS,26,75,20,8,28
31,8477505,Alexander Wennberg,C,SJS,30,67,15,13,28
31,8482705,Cole Sillinger,C,CBJ,21,67,15,13,28
31,8477952,Robby Fabbri,C,ANA,28,64,14,14,28
31,8480003,Jesper Boqvist,C,FLA,26,70,14,14,28
31,8478109,Victor Olofsson,L,VGK,29,71,13,15,28
31,8482105,Jake Sanderson,D,OTT,22,71,12,16,28
31,8479393,Noah Gregor,L,OTT,26,73,12,16,28
31,8480078,Filip Chytil,C,NYR,25,69,12,16,28
31,8479718,Alex Barré-Boulet,C,MTL,27,55,12,16,28
31,8479351,Sam Steel,C,DAL,26,81,10,18,28
31,8482067,Connor Mackey,D,NYR,28,67,10,18,28
31,8475791,Taylor Hall,L,CHI,33,54,8,20,28
31,8476873,Mark Jankowski,C,NSH,30,60,8,20,28
31,8478133,Jake Evans,C,MTL,28,67,6,22,28
31,8480145,Neal Pionk,D,WPG,29,71,4,24,28
31,8476463,Jonas Brodin,D,MIN,31,74,2,26,28
31,8483524,Shane Wright,C,SEA,20,61,16,11,27
31,8482125,Alexander Holtz,R,VGK,22,67,15,12,27
31,8480014,Gabriel Vilardi,C,WPG,25,70,14,13,27
31,8476480,Vladislav Namestnikov,C,WPG,32,65,13,14,27
31,8480113,Alex Iafallo,L,WPG,31,64,12,15,27
31,8480068,Ryan Poehling,C,PHI,25,73,12,15,27
31,8478432,Christian Fischer,R,DET,27,74,12,15,27
31,8480762,Eric Robinson,L,CAR,29,51,11,16,27
31,8475220,Marcus Foligno,L,MIN,33,64,10,17,27
31,8480802,Ryan McLeod,C,BUF,25,64,8,19,27
31,8477435,Ryan Graves,D,PIT,29,76,6,21,27
31,8481527,Kaedan Korczak,D,VGK,23,49,6,21,27
31,8476329,Travis Boyd,C,MIN,31,65,5,22,27
31,8476979,Erik Gustafsson,D,DET,32,75,4,23,27
31,8477488,Brett Pesce,D,NJD,30,70,4,23,27
31,8473507,Jeff Petry,D,DET,37,70,3,24,27
31,8480043,Timothy Liljegren,D,TOR,25,66,3,24,27
31,8475233,David Savard,D,MTL,34,64,3,24,27
31,8476879,Cody Ceci,D,EDM,31,69,3,24,27
31,8476392,Adam Lowry,C,WPG,31,61,14,12,26
31,8482259,Bobby McMann,C,TOR,28,69,14,12,26
31,8478891,Mason Appleton,C,WPG,28,68,13,13,26
31,8481704,Juuso Parssinen,C,NSH,23,57,13,13,26
31,8477478,William Carrier,L,CAR,30,58,13,13,26
31,8475763,Kevin Hayes,R,PIT,32,70,12,14,26
31,8481553,Bobby Brink,R,PHI,23,59,12,14,26
31,8481537,Nikita Okhotiuk,D,CGY,24,56,12,14,26
31,8476897,Oskar Sundqvist,C,STL,30,64,11,15,26
31,8476918,Jimmy Vesey,L,NYR,31,67,11,15,26
31,8478463,Anthony Beauvillier,L,PIT,27,58,10,16,26
31,8479390,Taylor Raddysh,R,WSH,26,70,10,16,26
31,8481481,Blake Lizotte,C,PIT,27,61,10,16,26
31,8482101,Danil Gushchin,L,SJS,22,59,10,16,26
31,8482655,Janis Moser,D,TBL,24,80,9,17,26
31,8477979,Nicolas Aube-Kubel,R,BUF,28,58,9,17,26
31,8479353,Brett Howden,C,VGK,26,64,9,17,26
31,8479315,Joey Anderson,R,CHI,26,48,9,17,26
31,8479324,Ryan Lindgren,D,NYR,26,70,7,19,26
31,8480855,Jack McBain,C,UTA,24,68,6,20,26
31,8478882,Vladislav Gavrikov,D,LAK,29,71,5,21,26
31,8480246,Nick Perbix,D,TBL,26,75,4,22,26
31,8481032,Paul Cotter,C,NJD,25,69,16,9,25
31,8479344,Jesse Puljujarvi,R,PIT,26,53,14,11,25
31,8479368,Max Jones,L,BOS,26,68,14,11,25
31,8477406,Mattias Janmark,C,EDM,32,72,12,13,25
31,8481624,Ilya Mikheyev,R,CHI,30,57,11,14,25
31,8483482,Tristan Luneau,D,ANA,20,66,10,15,25
31,8482117,Lukas Reichel,L,CHI,22,58,10,15,25
31,8473563,Nicklas Backstrom,C,WSH,37,55,7,18,25
31,8475171,Oliver Ekman-Larsson,D,TOR,33,71,4,21,25
31,8475181,Nick Leddy,D,STL,33,68,3,22,25
31,8478851,Alexandre Carrier,D,NSH,28,68,3,22,25
31,8477220,Nate Schmidt,D,FLA,33,61,3,22,25
31,8476457,Adam Larsson,D,SEA,32,65,3,22,25
31,8478569,Noel Acciari,C,PIT,33,64,16,8,24
31,8479996,Cody Glass,C,NSH,25,53,14,10,24
31,8474189,Lars Eller,C,PIT,35,62,13,11,24
31,8484145,Zach Benson,L,BUF,19,69,12,12,24
31,8483468,Jiri Kulich,C,BUF,20,55,11,13,24
31,8482133,Thomas Bordeleau,C,SJS,22,60,7,17,24
31,8480873,Rasmus Sandin,D,WSH,24,63,5,19,24
31,8482245,Artem Zub,D,OTT,29,70,3,21,24
31,8476917,Adam Pelech,D,NYI,30,77,2,22,24
31,8474574,Tyler Myers,D,VAN,34,64,2,22,24
31,8482679,Matt Coronato,R,CGY,22,66,11,12,23
31,8478970,Jalen Chatfield,D,CAR,28,69,9,14,23
31,8476474,Stefan Noesen,R,NJD,31,63,9,14,23
31,8482749,Joshua Roy,R,MTL,21,62,8,15,23
31,8480074,Alexandre Texier,C,STL,25,57,8,15,23
31,8479980,Nicolas Hague,D,VGK,26,54,5,18,23
31,8482087,Kaiden Guhle,D,MTL,22,65,5,18,23
31,8476892,Colton Parayko,D,STL,31,73,4,19,23
31,8479398,Samuel Girard,D,COL,26,63,3,20,23
31,8479371,Dante Fabbro,D,NSH,26,59,2,21,23
31,8481059,Scott Perunovich,D,STL,26,62,1,22,23
31,8474673,TJ Brodie,D,CHI,34,66,1,22,23
31,8482737,Zack Bolduc,C,STL,21,51,16,6,22
31,8481580,Connor McMichael,C,WSH,23,66,13,9,22
31,8482809,Jackson Blake,R,CAR,21,58,9,13,22
31,8480980,Connor Dewar,C,TOR,25,71,9,13,22
31,8481522,Peyton Krebs,C,BUF,23,58,7,15,22
31,8476312,Josh Manson,D,COL,33,60,7,15,22
31,8478911,Matt Roy,D,WSH,29,64,6,16,22
31,8482111,Justin Barron,D,MTL,23,61,6,16,22
31,8480073,Erik Brannstrom,D,COL,25,70,5,17,22
31,8478043,Sam Lafferty,C,BUF,29,56,5,17,22
31,8478840,Will Borgen,D,SEA,28,70,2,20,22
31,8474151,Ryan McDonagh,D,TBL,35,79,1,21,22
31,8478178,Darren Raddysh,D,TBL,28,65,1,21,22
31,8480281,Alexey Toropchenko,R,STL,25,64,16,5,21
31,8481093,Rafael Harvey-Pinard,L,MTL,25,55,9,12,21
31,8477508,Curtis Lazar,C,NJD,29,60,9,12,21
31,8480748,Kiefer Sherwood,L,VAN,29,59,8,13,21
31,8477919,Frederick Gaudreau,C,MIN,31,58,8,13,21
31,8476467,Jamie Oleksiak,D,SEA,32,72,7,14,21
31,8481441,Joe Snively,C,DET,28,71,7,14,21
31,8480789,Oliver Wahlstrom,R,NYI,24,70,5,16,21
31,8480001,Urho Vaakanainen,D,ANA,25,66,5,16,21
31,8478500,Ivan Provorov,D,CBJ,27,77,4,17,21
31,8481178,Egor Zamula,D,PHI,24,50,3,18,21
31,8480049,Dylan Samberg,D,WPG,25,65,2,19,21
31,8479293,Brandon Tanev,L,SEA,33,65,13,7,20
31,8482634,Alex Steeves,C,TOR,25,49,13,7,20
31,8480835,Jack Drury,C,CAR,24,54,11,9,20
31,8477425,Miles Wood,L,COL,29,78,10,10,20
31,8481601,Simon Holmstrom,R,NYI,23,62,10,10,20
31,8475855,Jesper Fast,R,CAR,33,56,10,10,20
31,8479066,Ryan Lomberg,L,CGY,30,66,10,10,20
31,8483499,Liam Ohgren,L,MIN,20,53,9,11,20
31,8477353,Tyler Motte,C,DET,29,70,9,11,20
31,8478434,Keegan Kolesar,R,VGK,27,63,9,11,20
31,8476902,Esa Lindell,D,DAL,30,73,8,12,20
31,8483457,Lane Hutson,D,MTL,20,65,8,12,20
31,8477450,Jason Dickinson,C,CHI,29,56,8,12,20
31,8477369,Carson Soucy,D,VAN,30,64,7,13,20
31,8479639,Dylan Coghlan,D,WPG,26,64,6,14,20
31,8480891,Michael Kesselring,D,UTA,24,56,5,15,20
31,8479976,Juuso Valimaki,D,UTA,26,66,4,16,20
31,8479316,Luke Kunin,C,SJS,27,56,4,16,20
31,8477839,Conor Sheary,L,TBL,32,80,4,16,20
31,8480058,Pierre-Olivier Joseph,D,STL,25,56,4,16,20
31,8474034,Patrick Maroon,L,CHI,36,56,4,16,20
31,8479369,Andrew Peeke,D,BOS,26,63,3,17,20
31,8478508,Yakov Trenin,C,MIN,27,62,14,5,19
31,8480205,Emil Bemstrom,C,PIT,25,56,11,8,19
31,8480448,Parker Kelly,L,COL,25,76,10,9,19
31,8482148,Hendrix Lapierre,C,WSH,22,52,10,9,19
31,8475231,Casey Cizikas,C,NYI,33,74,9,10,19
31,8476878,Zemgus Girgensons,C,TBL,30,81,9,10,19
31,8478013,Jake Walman,D,SJS,28,69,9,10,19
31,8477931,Tomas Nosek,L,FLA,32,62,9,10,19
31,8479772,Zack MacEwen,R,OTT,28,54,9,10,19
31,8477499,Rasmus Ristolainen,D,PHI,30,65,8,11,19
31,8481477,Nico Sturm,C,SJS,29,59,7,12,19
31,8477507,Nikita Zadorov,D,BOS,29,70,6,13,19
31,8480848,Ty Dellandrea,C,SJS,24,46,6,13,19
31,8481014,Alexander Romanov,D,NYI,24,76,5,14,19
31,8476856,Mathew Dumba,D,DAL,30,72,5,14,19
31,8476331,Dylan DeMelo,D,WPG,31,73,3,16,19
31,8476891,Matthew Grzelcyk,D,PIT,30,71,2,17,19
31,8479328,Julien Gauthier,R,NYI,27,61,12,6,18
31,8476469,Joel Armia,R,MTL,31,66,12,6,18
31,8479520,Brandon Duhaime,R,WSH,27,52,10,8,18
31,8475343,Nic Dowd,C,WSH,34,60,8,10,18
31,8483491,Ivan Miroshnichenko,L,WSH,20,50,6,12,18
31,8480144,David Kampf,C,TOR,29,70,6,12,18
31,8479982,Conor Timmins,D,TOR,26,59,4,14,18
31,8476429,Scott Mayfield,D,NYI,32,73,3,15,18
31,8481517,Brett Leason,R,ANA,25,52,9,8,17
31,8482074,Connor Zary,C,CGY,23,61,9,8,17
31,8480806,Isac Lundestrom,C,ANA,25,62,9,8,17
31,8477947,Sonny Milano,L,WSH,28,64,8,9,17
31,8482155,Alex Laferriere,R,LAK,23,66,8,9,17
31,8479619,Michael Carcone,L,UTA,28,63,8,9,17
31,8482157,Will Cuylle,L,NYR,22,66,7,10,17
31,8482192,Isaak Phillips,D,CHI,23,54,7,10,17
31,8473453,Trevor Lewis,C,LAK,37,72,7,10,17
31,8479359,Beck Malenstyn,L,BUF,26,50,6,11,17
31,8482176,Wyatt Kaiser,D,CHI,22,56,4,13,17
31,8477903,Garnet Hathaway,R,PHI,33,59,4,13,17
31,8475279,Ben Chiarot,D,DET,33,67,4,13,17
31,8480172,Jan Rutta,D,SJS,34,61,2,15,17
31,8478452,Caleb Jones,D,LAK,27,60,2,15,17
31,8481641,Joel Kiviranta,L,COL,28,69,12,4,16
31,8479414,Nathan Bastian,R,NJD,27,63,10,6,16
31,8479336,Carl Grundstrom,R,SJS,27,50,9,7,16
31,8480252,Cole Guttman,C,CHI,25,46,9,7,16
31,8482062,Cole Smith,L,NSH,29,48,8,8,16
31,8481013,Jonatan Berggren,R,DET,24,53,7,9,16
31,8479026,Philippe Myers,D,TOR,27,61,6,10,16
31,8480995,Pontus Holmberg,R,TOR,25,56,5,11,16
31,8479370,Tyson Jost,C,CAR,26,49,5,11,16
31,8481521,Ronnie Attard,D,PHI,25,57,4,12,16
31,8481708,Zac Jones,D,NYR,24,49,2,14,16
31,8478399,Jonas Siegenthaler,D,NJD,27,62,1,15,16
31,8477392,Hudson Fasching,R,NYI,29,64,9,6,15
31,8476960,Andreas Athanasiou,C,CHI,30,49,9,6,15
31,8480289,Morgan Barron,C,WPG,26,57,7,8,15
31,8477015,Connor Brown,R,EDM,30,58,7,8,15
31,8476822,Luke Glendening,C,TBL,35,79,6,9,15
31,8476374,Sean Kuraly,C,CBJ,31,59,6,9,15
31,8480355,Mark Kastelic,C,BOS,25,60,6,9,15
31,8479998,Mikey Anderson,D,LAK,25,61,3,12,15
31,8477845,Trevor van Riemsdyk,D,WSH,33,62,2,13,15
31,8475188,Brayden McNabb,D,VGK,33,48,2,13,15
31,8477365,Connor Clifton,D,BUF,29,56,2,13,15
31,8475462,Radko Gudas,D,ANA,34,63,1,14,15
31,8476889,Radek Faksa,C,STL,30,63,7,7,14
31,8483493,Frank Nazar,C,CHI,20,49,7,7,14
31,8482730,Brandt Clarke,D,LAK,21,52,7,7,14
31,8476624,Barclay Goodrow,C,SJS,31,54,7,7,14
31,8480025,MacKenzie Entwistle,R,FLA,25,67,6,8,14
31,8480021,Jack Studnicka,C,LAK,25,52,5,9,14
31,8476442,Matt Nieto,L,PIT,32,56,5,9,14
31,8481161,Jake Christiansen,D,CBJ,25,58,4,10,14
31,8480070,Ian Mitchell,D,BOS,25,44,4,10,14
31,8475208,Brian Dumoulin,D,ANA,33,62,3,11,14
31,8476994,Vinnie Hinostroza,C,NSH,30,54,3,11,14
31,8481028,Martin Pospisil,C,CGY,25,53,3,11,14
31,8475750,Jon Merrill,D,MIN,32,68,3,11,14
31,8480035,Henri Jokiharju,D,BUF,25,61,3,11,14
31,8476525,Colin Miller,D,WPG,32,63,2,12,14
31,8478416,Erik Cernak,D,TBL,27,74,2,12,14
31,8479372,Joshua Mahura,D,SEA,26,47,2,12,14
31,8475179,Dmitry Kulikov,D,FLA,34,57,2,12,14
31,8475324,Nick Jensen,D,OTT,34,68,1,13,14
31,8480222,Sebastian Aho,D,PIT,28,69,1,13,14
31,8478421,A.J. Greer,L,FLA,28,56,9,4,13
31,8481716,Dmitri Voronkov,L,CBJ,24,47,8,5,13
31,8482077,Dylan Holloway,L,EDM,23,54,7,6,13
31,8479291,Kevin Rooney,C,CGY,31,51,7,6,13
31,8475842,Sam Carrick,C,NYR,32,58,7,6,13
31,8477573,Nathan Walker,L,STL,30,51,6,7,13
31,8478443,Brandon Carlo,D,BOS,28,58,6,7,13
31,8478211,Dryden Hunt,L,CGY,29,55,5,8,13
31,8480950,Ilya Lyubushkin,D,DAL,30,54,4,9,13
31,8474568,Luke Schenn,D,NSH,35,52,4,9,13
31,8471709,Marc-Edouard Vlasic,D,SJS,37,58,3,10,13
31,8476967,Brett Kulak,D,EDM,30,60,3,10,13
31,8482803,Olen Zellweger,D,ANA,21,58,2,11,13
31,8481600,Tobias Bjornfot,D,FLA,23,40,2,11,13
31,8482095,Tyler Kleven,D,OTT,22,41,2,11,13
31,8480245,Olle Lycksell,R,PHI,25,37,1,12,13
31,8480727,Zach Whitecloud,D,VGK,28,46,0,13,13
31,8479968,Vinni Lettieri,C,BOS,29,56,7,5,12
31,8483012,Logan Morrison,C,SEA,22,44,5,7,12
31,8483549,Lucas Condotta,L,MTL,27,32,5,7,12
31,8483495,Simon Nemec,D,NJD,20,55,4,8,12
31,8482142,Jamie Drysdale,D,PHI,22,61,3,9,12
31,8478859,Niko Mikkola,D,FLA,28,57,3,9,12
31,8482073,Braden Schneider,D,NYR,23,58,2,10,12
31,8481701,Santeri Hatakka,D,NJD,23,43,2,10,12
31,8470600,Ryan Suter,D,STL,39,64,2,10,12
31,8480007,Jonas Rondbjerg,R,VGK,25,45,2,10,12
31,8477506,Ryan Pulock,D,NYI,30,77,1,11,12
31,8474567,Zach Bogosian,D,MIN,34,54,1,11,12
31,8480807,Mattias Samuelsson,D,BUF,24,55,0,12,12
31,8478831,Kevin Stenlund,C,UTA,28,53,7,4,11
31,8476934,Brock McGinn,L,ANA,30,48,6,5,11
31,8479439,Jacob MacDonald,D,COL,31,49,6,5,11
31,8477070,Liam O'Brien,C,UTA,30,51,6,5,11
31,8476988,Matt Benning,D,SJS,30,61,4,7,11
31,8481167,Brayden Pachal,D,CGY,25,43,4,7,11
31,8480860,Kevin Bahl,D,CGY,24,60,4,7,11
31,8475718,Justin Holl,D,DET,32,63,2,9,11
31,8475790,Erik Gudbranson,D,CBJ,32,75,1,10,11
31,8477034,Jaycob Megna,D,FLA,32,49,1,10,11
31,8482166,Shakir Mukhamadullin,D,SJS,22,56,6,4,10
31,8482659,Josh Doan,R,UTA,22,46,6,4,10
31,8482762,Simon Edvinsson,D,DET,21,50,5,5,10
31,8482652,Walker Duehr,R,CGY,27,43,5,5,10
31,8475235,Nicolas Deslauriers,L,PHI,33,49,5,5,10
31,8482807,Ethan Del Mastro,D,CHI,21,52,5,5,10
31,8479994,Jaret Anderson-Dolan,C,WPG,25,38,4,6,10
31,8481019,David Gustafsson,C,WPG,24,48,4,6,10
31,8482964,Arber Xhekaj,D,MTL,23,50,3,7,10
31,8481532,Alex Turcotte,C,LAK,23,49,3,7,10
31,8481617,Vasily Podkolzin,R,VAN,23,51,3,7,10
31,8475177,Calvin de Haan,D,COL,33,39,2,8,10
31,8478468,Jeremy Lauzon,D,NSH,27,54,2,8,10
31,8479576,Vincent Desharnais,D,VAN,28,35,2,8,10
31,8481568,Alex Vlasic,D,CHI,23,51,1,9,10
31,8480887,Jordan Harris,D,MTL,24,53,1,9,10
31,8474013,Ian Cole,D,UTA,35,56,1,9,10
31,8481518,Nolan Foote,L,NJD,24,34,6,3,9
31,8477446,Michael McCarron,R,NSH,29,61,5,4,9
31,8475225,Craig Smith,C,CHI,35,48,4,5,9
31,8479442,Troy Stecher,D,EDM,30,52,4,5,9
31,8476858,Phillip Di Giuseppe,L,VAN,31,42,4,5,9
31,8476867,Brendan Gaunce,C,MIN,30,40,4,5,9
31,8481679,Maxence Guenette,D,OTT,23,38,4,5,9
31,8480878,Nils Lundkvist,D,DAL,24,73,3,6,9
31,8481599,Victor Soderstrom,D,UTA,23,40,3,6,9
31,8477335,Kyle Burroughs,D,LAK,29,44,3,6,9
31,8482666,Scott Morrow,D,CAR,22,46,2,7,9
31,8473446,Erik Johnson,D,PHI,36,48,2,7,9
31,8478136,Jake Middleton,D,MIN,28,75,1,8,9
31,8478585,Derek Ryan,C,EDM,38,59,1,8,9
31,8480796,Martin Fehervary,D,WSH,25,51,1,8,9
31,8480157,Calle Rosen,D,COL,30,50,1,8,9
31,8481598,Philip Broberg,D,EDM,23,40,1,8,9
31,8483460,David Jiricek,D,CBJ,21,52,1,8,9
31,8481609,Vladislav Kolyachonok,D,UTA,23,35,1,8,9
31,8478454,Noah Juulsen,D,VAN,27,36,1,8,9
31,8476874,Olli Maatta,D,DET,30,64,0,9,9
31,8481567,Henry Thrun,D,SJS,23,48,0,9,9
31,8480441,Trey Fix-Wolansky,R,CBJ,25,44,5,3,8
31,8484149,Gavin Brindley,C,CBJ,20,47,4,4,8
31,8482747,Brennan Othmann,L,NYR,21,41,4,4,8
31,8476952,Dominic Toninato,C,WPG,30,32,4,4,8
31,8477482,Zachary Sanford,L,CHI,30,34,3,5,8
31,8484911,Collin Graf,R,SJS,22,33,3,5,8
31,8483466,Kevin Korchinski,D,CHI,20,42,3,5,8
31,8480890,Jan Jenik,C,OTT,24,27,3,5,8
31,8480196,Jacob Bryson,D,BUF,27,42,3,5,8
31,8475690,Chris Tanev,D,TOR,35,50,2,6,8
31,8479543,Michael Pezzetta,L,MTL,26,54,2,6,8
31,8480192,Johnathan Kovacevic,D,NJD,27,51,1,7,8
31,8484254,Akito Hirose,D,VAN,25,46,1,7,8
31,8482861,Vincent Iorio,D,WSH,22,35,1,7,8
31,8482859,Zack Ostapchuk,C,OTT,21,49,0,8,8
31,8481754,Nikita Nesterenko,C,ANA,23,34,6,1,7
31,8481592,Jakob Pelletier,L,CGY,23,36,4,3,7
31,8479671,Mathieu Olivier,R,CBJ,27,46,4,3,7
31,8480011,Klim Kostin,C,SJS,25,50,4,3,7
31,8477887,Patrick Brown,C,BOS,32,37,4,3,7
31,8480292,Carson Meyer,R,ANA,27,28,4,3,7
31,8483570,Ben Meyers,C,SEA,26,30,4,3,7
31,8481147,Reese Johnson,C,MIN,26,39,3,4,7
31,8482733,Logan Mailloux,D,MTL,31,36,3,4,7
31,8478424,Jansen Harkins,C,ANA,27,34,3,4,7
31,8484287,Cole McWard,D,VAN,23,21,3,4,7
31,8477462,Robert Hagg,D,VGK,29,23,2,5,7
31,8477018,Ben Hutton,D,VGK,31,47,2,5,7
31,8481550,Adam Beckman,L,NJD,23,39,2,5,7
31,8482451,Mikael Pyyhtia,L,CBJ,23,36,1,6,7
31,8481751,Lukas Rousek,R,BUF,25,32,1,6,7
31,8475958,Michael Sgarbossa,C,WSH,32,29,1,6,7
31,8478450,Parker Wotherspoon,D,BOS,27,31,0,7,7
31,8480845,Rasmus Kupari,C,WPG,24,42,5,1,6
31,8482145,Mavrik Bourque,C,DAL,22,53,5,1,6
31,8477962,Brendan Lemieux,L,CAR,28,36,4,2,6
31,8475455,Brenden Dillon,D,NJD,34,56,2,4,6
31,8479536,Axel Jonsson-Fjallby,L,WPG,26,35,2,4,6
31,8476913,Devin Shore,C,MIN,30,38,2,4,6
31,8471817,Ryan Reaves,R,TOR,37,50,2,4,6
31,8480880,Jakub Lauko,C,MIN,24,28,2,4,6
31,8482144,Jack Thompson,D,SJS,22,28,2,4,6
31,8474062,Riley Nash,C,NYR,35,18,2,4,6
31,8474612,Travis Hamonic,D,OTT,34,51,2,4,6
31,8481122,Simon Benoit,D,TOR,26,36,2,4,6
31,8481543,Nikita Alexandrov,C,STL,24,29,2,4,6
31,8483630,Pavol Regenda,L,ANA,25,29,2,4,6
31,8476473,Connor Murphy,D,CHI,31,36,1,5,6
31,8478874,Adam Gaudette,R,OTT,28,34,1,5,6
31,8483619,Filip Roos,D,OTT,25,34,1,5,6
31,8477851,Jordan Oesterle,D,BOS,32,47,1,5,6
31,8480834,Ty Emberson,D,SJS,24,37,1,5,6
31,8476441,Joel Edmundson,D,LAK,31,41,0,6,6
31,8474090,Brendan Smith,D,DAL,35,55,0,6,6
31,8475762,Derek Forbort,D,VAN,32,47,0,6,6
31,8480879,Jacob Bernard-Docker,D,OTT,24,44,0,6,6
31,8482751,Ryan Winterton,C,SEA,21,35,0,6,6
31,8471677,Jack Johnson,D,CBJ,37,73,3,2,5
31,8482070,Mitchell Chaffee,R,TBL,26,55,3,2,5
31,8482713,Mackie Samoskevich,R,FLA,22,27,3,2,5
31,8482153,Brendan Brisson,C,VGK,23,30,3,2,5
31,8482147,Jean-Luc Foudy,C,COL,22,29,3,2,5
31,8479367,William Lockwood,R,FLA,26,27,3,2,5
31,8478451,Ethan Bear,D,WSH,27,46,2,3,5
31,8479348,Kale Clague,D,BUF,26,37,2,3,5
31,8481556,John Beecher,C,BOS,23,29,2,3,5
31,8483763,Maksymilian Szuber,D,UTA,22,34,2,3,5
31,8482141,Lukas Cormier,D,VGK,22,28,2,3,5
31,8478409,Anthony Richard,C,PHI,28,29,1,4,5
31,8479986,Kole Lind,R,DAL,26,42,0,5,5
31,8479249,Andrew Poturalski,C,SJS,30,36,0,5,5
31,8477971,Andreas Englund,D,LAK,28,20,0,5,5
31,8477993,Justin Kirkland,C,CGY,28,8,4,0,4
31,8482511,Mason Lohrei,D,BOS,23,32,3,1,4
31,8482094,Daemon Hunt,D,MIN,22,18,3,1,4
31,8482744,James Malatesta,L,CBJ,21,37,2,2,4
31,8482784,Zach Dean,C,STL,21,33,2,2,4
31,8477938,Haydn Fleury,D,WPG,28,42,2,2,4
31,8479638,Justin Brazeau,R,BOS,26,30,2,2,4
31,8482765,Isak Rosen,R,BUF,21,31,2,2,4
31,8481743,Marc Del Gaizo,D,NSH,25,22,2,2,4
31,8483489,Fraser Minten,C,TOR,31,11,2,2,4
31,8481237,Kyle MacLean,C,NYI,25,21,2,2,4
31,8479587,Rhett Gardner,C,PHI,28,18,2,2,4
31,8474166,Alec Martinez,D,CHI,37,49,1,3,4
31,8479378,Logan Stanley,D,WPG,26,41,1,3,4
31,8480990,Declan Chisholm,D,MIN,24,41,1,3,4
31,8481541,Samuel Bolduc,D,NYI,24,29,1,3,4
31,8477527,Ross Johnston,L,ANA,30,37,1,3,4
31,8477401,John Hayden,C,SEA,29,26,1,3,4
31,8482118,Sam Colangelo,R,ANA,23,18,1,3,4
31,8483397,Marc McLaughlin,C,BOS,25,37,1,3,4
31,8481605,Jackson LaCombe,D,ANA,23,30,1,3,4
31,8476372,Nick Seeler,D,PHI,31,42,0,4,4
31,8482496,Nils Aman,C,VAN,24,35,0,4,4
31,8480870,Bo Groulx,C,NYR,24,28,0,4,4
31,8481056,Spencer Stastney,D,NSH,24,27,0,4,4
31,8477320,Anton Blidh,L,NYR,29,19,0,4,4
31,8477384,Joshua Brown,D,EDM,30,44,0,4,4
31,8477149,Scott Sabourin,R,SJS,32,16,0,4,4
31,8479379,Givani Smith,R,SJS,26,27,3,0,3
31,8481006,Tyler Tucker,D,STL,24,12,3,0,3
31,8481789,Tye Kartye,L,SEA,23,42,2,1,3
31,8482858,Ryker Evans,D,SEA,23,23,2,1,3
31,8482165,Yan Kuznetsov,D,CGY,22,16,2,1,3
31,8480267,Sammy Walker,C,MIN,25,21,2,1,3
31,8482516,Matthew Kessel,D,STL,24,14,2,1,3
31,8483407,Brandon Scanlin,D,NYR,25,8,2,1,3
31,8479944,Zach Aston-Reese,C,VGK,30,39,1,2,3
31,8479981,Jonah Gadjovich,L,FLA,26,37,1,2,3
31,8482172,Landon Slaggert,L,CHI,22,27,1,2,3
31,8484258,Sam Malinski,D,COL,26,22,1,2,3
31,8482929,Emil Lilleberg,D,TBL,23,22,1,2,3
31,8478881,Brett Seney,L,CHI,28,17,1,2,3
31,8477810,Joel Hanley,D,CGY,33,27,0,3,3
31,8477244,Chad Ruhwedel,D,NYR,34,25,0,3,3
31,8480823,Alexander Alexeyev,D,WSH,25,15,0,3,3
31,8478502,Dennis Gilbert,D,BUF,28,15,0,3,3
31,8481806,Louis Crevier,D,CHI,23,15,0,3,3
31,8481030,Jack St. Ivany,D,PIT,25,17,2,0,2
31,8477473,Justin Bailey,R,SJS,29,22,2,0,2
31,8477073,Kurtis MacDermid,L,NJD,30,26,2,0,2
31,8482470,Ilya Solovyov,D,CGY,24,16,2,0,2
31,8478051,Max Willman,C,NJD,29,16,2,0,2
31,8482460,Matt Rempe,C,NYR,22,18,2,0,2
31,8481578,Graeme Clarke,R,MIN,23,5,2,0,2
31,8478017,Mark Friedman,D,VAN,29,33,1,1,2
31,8480844,Grigori Denisenko,L,VGK,24,32,1,1,2
31,8478146,Matthew Highmore,C,OTT,28,32,1,1,2
31,8481206,John Ludvig,D,PIT,24,13,1,1,2
31,8481585,Egor Afanasyev,L,SJS,23,8,1,1,2
31,8479320,Maxime Lajoie,D,SEA,27,21,1,1,2
31,8480851,Akil Thomas,C,LAK,24,19,1,1,2
31,8480032,Shane Bowers,C,NJD,25,9,1,1,2
31,8479362,Riley Tufte,L,BOS,26,26,1,1,2
31,8480084,Nick DeSimone,D,NJD,30,17,1,1,2
31,8481422,Jake Lucchini,C,NSH,29,21,1,1,2
31,8479985,Cale Fleury,D,SEA,26,34,0,2,2
31,8479972,Mason Shaw,C,WPG,26,32,0,2,2
31,8479419,Brett Murray,L,BUF,26,19,0,2,2
31,8482250,Callahan Burke,C,VGK,27,29,0,2,2
31,8481719,Maxwell Crozier,D,TBL,24,16,0,2,2
31,8481564,Ryan Johnson,D,BUF,23,11,0,2,2
31,8475795,Dylan McIlrath,D,WSH,32,16,0,2,2
31,8477467,Gustav Olofsson,D,SEA,30,15,1,0,1
31,8479991,Jake Leschyshyn,C,NYR,25,20,1,0,1
31,8481065,Angus Crookshank,L,OTT,25,13,1,0,1
31,8481699,Aku Raty,R,UTA,23,11,1,0,1
31,8484304,Uvis Balinskis,D,FLA,28,7,1,0,1
31,8480468,James Hamblin,L,EDM,25,16,1,0,1
31,8482088,Justin Sourdif,R,FLA,22,23,1,0,1
31,8478446,Glenn Gawdin,C,LAK,27,17,1,0,1
31,8475413,Justin Dowling,C,NJD,34,14,1,0,1
31,8483597,Milos Kelemen,L,UTA,25,12,1,0,1
31,8481043,Cole Koepke,L,BOS,26,16,1,0,1
31,8482476,Emil Heineman,L,MTL,23,7,1,0,1
31,8482162,Roby Jarventie,L,EDM,22,15,1,0,1
31,8482201,Gage Goncalves,C,TBL,23,19,0,1,1
31,8478021,William Lagesson,D,DET,28,32,0,1,1
31,8482177,Marat Khusnutdinov,C,MIN,22,30,0,1,1
31,8478011,Louie Belpedio,D,PHI,28,13,0,1,1
31,8481593,Jayden Struble,D,MTL,23,25,0,1,1
31,8480874,Adam Ginning,D,PHI,24,11,0,1,1
31,8480075,Cameron Crotty,D,MIN,25,6,0,1,1
31,8481024,Linus Karlsson,C,VAN,25,7,0,1,1
31,8479330,Brandon Gignac,C,MTL,27,12,0,1,1
31,8483512,Matthew Savoie,C,EDM,20,14,0,1,1
31,8475755,Alexander Petrovic,D,DAL,32,10,0,1,1
31,8480306,Grant Hutton,D,NYI,29,3,0,1,1
31,8482061,Brandon Biro,L,SEA,26,12,0,0,0
31,8481462,Mason Morelli,L,VGK,28,8,0,0,0
31,8478477,Mitchell Stephens,C,SEA,27,17,0,0,0
31,8484325,Waltteri Merela,C,TBL,26,15,0,0,0
31,8482102,Vasily Ponomarev,C,PIT,22,19,0,0,0
31,8483567,Georgii Merkulov,C,BOS,24,8,0,0,0
31,8482197,Adam Raska,R,MIN,23,8,0,0,0
31,8476323,Max McCormick,L,SEA,32,2,0,0,0
31,8484326,Patrik Koch,D,UTA,28,1,0,0,0
31,8483395,Arshdeep Bains,L,VAN,23,9,0,0,0
31,8475780,Chris Wagner,R,COL,33,8,0,0,0
31,8478854,Ryan Shea,D,PIT,27,10,0,0,0
31,8483471,Brad Lambert,C,WPG,31,10,0,0,0
31,8483546,Marshall Rifai,D,TOR,26,4,0,0,0
31,8479421,Jacob Moverare,D,LAK,26,5,0,0,0
31,8482126,Emil Andrae,D,PHI,31,2,0,0,0
31,8481726,Adam Edstrom,C,NYR,24,6,0,0,0
31,8481655,Cole Schwindt,R,CGY,23,5,0,0,0
31,8483531,Brian Halonen,L,NJD,25,0,0,0,0
31,8479522,Hardy Haman Aktell,D,WSH,26,4,0,0,0
31,8484255,Jason Polin,R,COL,25,4,0,0,0
31,8483398,Declan Carlile,D,TBL,31,1,0,0,0
31,8477541,Dakota Mermis,D,TOR,30,7,0,0,0
31,8482787,Nikita Chibrikov,R,WPG,31,5,0,0,0
31,8478147,Bokondji Imama,L,PIT,28,2,0,0,0
31,8483920,Pierrick Dube,R,WSH,23,6,0,0,0
31,8483432,Luca Del Bel Belluz,C,CBJ,31,6,0,0,0
31,8483401,Marc Johnstone,R,PIT,28,0,0,0,0
31,8483609,Adam Klapka,R,CGY,24,2,0,0,0
31,8484259,Ondrej Pavel,C,COL,31,1,0,0,0
31,8480274,Philip Kemp,D,EDM,25,0,0,0,0
31,8484321,Nikolas Matinpalo,D,OTT,26,3,0,0,0
31,8481534,Raphael Lavoie,C,EDM,24,8,0,0,0
31,8470794,Joe Pavelski,C,,40,0,0,0,0
31,8479321,Lucas Johansen,D,,27,0,0,0,0
31,8477950,Tony DeAngelo,D,,29,0,0,0,0
31,8471218,Blake Wheeler,R,,38,0,0,0,0
31,8475197,Tyson Barrie,D,,33,0,0,0,0
31,8474157,Max Pacioretty,L,,36,0,0,0,0
31,8475744,Evgeny Kuznetsov,C,,32,0,0,0,0
31,8474037,James van Riemsdyk,L,,35,0,0,0,0
31,8476907,Mackenzie MacEachern,L,,30,0,0,0,0
31,8480216,Jacob Peterson,C,,25,0,0,0,0
31,8474602,Justin Schultz,D,,34,0,0,0,0
31,8482222,Alexander Barabanov,L,,30,0,0,0,0
31,8474031,Kevin Shattenkirk,D,,35,0,0,0,0
31,8477330,Dominik Kubalik,L,,29,0,0,0,0
31,8480884,Calen Addison,D,,24,0,0,0,0
31,8475906,John Klingberg,D,,32,0,0,0,0
31,8480008,Adam Ruzicka,C,,25,0,0,0,0
31,8476884,Derrick Pouliot,D,,30,0,0,0,0
31,8476919,Chris Tierney,C,,30,0,0,0,0
31,8479415,Michael McLeod,C,,26,0,0,0,0
31,8474870,Tyler Johnson,C,,34,0,0,0,0
31,8470604,Jeff Carter,C,,39,0,0,0,0
31,8478104,Sammy Blais,L,,28,0,0,0,0
31,8474884,Mike Hoffman,C,,35,0,0,0,0
31,8481591,Sam Poulin,R,,23,0,0,0,0
31,8471274,Alex Goligoski,D,,39,0,0,0,0
31,8476871,Tanner Pearson,L,,32,0,0,0,0
31,8476393,Nick Cousins,C,,31,0,0,0,0
31,8479977,Kailer Yamamoto,R,,26,0,0,0,0
31,8479346,Dillon Dube,C,,26,0,0,0,0
31,8480184,Gustav Lindstrom,D,,26,0,0,0,0
31,8479376,Victor Mete,D,,26,0,0,0,0
31,8473449,Kyle Okposo,R,,36,0,0,0,0
31,8481058,Jesse Ylonen,R,,25,0,0,0,0
31,8475752,Tyler Pitlick,C,,33,0,0,0,0
31,8481239,Samuel Fagemo,L,,24,0,0,0,0
31,8480821,Filip Zadina,R,,25,0,0,0,0
31,8470966,Mark Giordano,D,,41,0,0,0,0
31,8478495,Denis Gurianov,R,,27,0,0,0,0
31,8477464,Nic Petan,C,,29,0,0,0,0
31,8478099,Kevin Labanc,R,,29,0,0,0,0
31,8482241,Radim Zohorna,L,,28,0,0,0,0
31,8474040,Sam Gagner,C,,35,0,0,0,0
31,8479514,Rem Pitlick,C,,27,0,0,0,0
31,8478430,Oliver Kylington,D,,27,0,0,0,0
31,8479533,Joona Koppanen,L,,26,0,0,0,0
31,8479984,Cal Foote,D,,26,0,0,0,0
31,8477126,Jayson Megna,C,,34,0,0,0,0
31,8475164,Jakob Silfverberg,R,,34,0,0,0,0
31,8474009,Nick Bonino,C,,36,0,0,0,0
31,8479458,Nikita Zaitsev,D,,33,0,0,0,0
31,8477944,Jakub Vrana,L,,28,0,0,0,0
31,8471699,Andrew Cogliano,C,,37,0,0,0,0
31,8478067,Oskar Lindblom,L,,28,0,0,0,0
31,8471686,Marc Staal,D,,37,0,0,0,0
31,8470610,Zach Parise,L,,40,0,0,0,0
31,8478904,Steven Lorentz,C,,28,0,0,0,0
31,8473473,Milan Lucic,L,,36,0,0,0,0
31,8480031,Maxime Comtois,L,,25,0,0,0,0
31,8478512,Austin Czarnik,C,,32,0,0,0,0
31,8473504,Cal Clutterbuck,R,,37,0,0,0,0
31,8477454,Adam Erne,L,,29,0,0,0,0
31,8479383,Boris Katchouk,L,,26,0,0,0,0
31,8475825,Jani Hakanpää,D,,32,0,0,0,0
31,8477846,Ryan Carpenter,C,,33,0,0,0,0
31,8477930,Pierre-Edouard Bellemare,L,,39,0,0,0,0
31,8478400,Colin White,C,,27,0,0,0,0
31,8480226,Marián Studenic,R,,26,0,0,0,0
31,8480853,Liam Foudy,C,,24,0,0,0,0
31,8475797,Jarred Tinordi,D,,32,0,0,0,0
31,8479423,Alex Nylander,L,,26,0,0,0,0
31,8474618,Marco Scandella,D,,34,0,0,0,0
31,8478028,Fredrik Olofsson,L,,28,0,0,0,0
31,8474709,Matt Martin,L,,35,0,0,0,0
31,8481070,Hugh McGing,L,,26,0,0,0,0
31,8479546,Oskar Steen,C,,26,0,0,0,0
31,8474145,Robert Bortuzzo,D,,35,0,0,0,0
31,8476915,Jujhar Khaira,L,,30,0,0,0,0
31,8475278,Byron Froese,C,,33,0,0,0,0
31,8481812,Nikolai Knyzhov,D,,27,0,0,0,0
31,8478408,Travis Dermott,D,,28,0,0,0,0
31,8481077,John Leonard,L,,26,0,0,0,0
31,8479547,Matthew Phillips,R,,26,0,0,0,0
31,8480836,Jonathan Gruden,C,,24,0,0,0,0
31,8481690,Tyler Angle,C,,24,0,0,0,0
31,8475766,Austin Watson,L,,32,0,0,0,0
31,8481016,Ruslan Iskhakov,C,,24,0,0,0,0
31,8478078,Rourke Chartier,C,,28,0,0,0,0
31,8480776,Sheldon Rempal,R,,29,0,0,0,0
31,8478956,Samuel Laberge,L,NJD,27,1,0,0,0
31,8483045,Cameron Butler,R,CBJ,31,1,0,0,0
31,8484314,Jiri Smejkal,L,,28,0,0,0,0
32,8478402,Connor McDavid,C,EDM,27,76,44,111,155
32,8477492,Nathan MacKinnon,C,COL,29,82,56,77,133
32,8479318,Auston Matthews,C,TOR,27,81,65,58,123
32,8477939,William Nylander,R,TOR,28,77,62,61,123
32,8478420,Mikko Rantanen,R,COL,28,81,52,70,122
32,8479314,Matthew Tkachuk,L,FLA,27,80,36,78,114
32,8476453,Nikita Kucherov,R,TBL,31,82,39,74,113
32,8477934,Leon Draisaitl,C,EDM,29,80,45,65,110
32,8477409,Carter Verhaeghe,C,FLA,29,79,51,57,108
32,8478483,Mitch Marner,R,TOR,27,79,29,79,108
32,8480800,Quinn Hughes,D,VAN,25,73,9,94,103
32,8475166,John Tavares,C,TOR,34,78,41,61,102
32,8480012,Elias Pettersson,C,VAN,26,75,39,61,100
32,8478550,Artemi Panarin,L,NYR,33,76,26,74,100
32,8477956,David Pastrnak,R,BOS,28,78,48,51,99
32,8477946,Dylan Larkin,C,DET,28,82,41,58,99
32,8476887,Filip Forsberg,L,NSH,30,76,37,62,99
32,8477942,Kevin Fiala,L,LAK,28,80,42,55,97
32,8478010,Brayden Point,C,TBL,28,82,47,49,96
32,8478445,Mathew Barzal,C,NYI,27,81,30,66,96
32,8476454,Ryan Nugent-Hopkins,C,EDM,31,78,29,67,96
32,8480801,Brady Tkachuk,L,OTT,25,78,43,50,93
32,8481559,Jack Hughes,C,NJD,23,72,36,55,91
32,8476468,J.T. Miller,C,VAN,31,75,36,54,90
32,8475784,Jeff Skinner,C,EDM,32,81,46,42,88
32,8480023,Robert Thomas,C,STL,25,74,28,60,88
32,8480002,Nico Hischier,C,NJD,25,79,34,52,86
32,8477501,Valeri Nichushkin,R,COL,29,80,39,46,85
32,8480027,Jason Robertson,L,DAL,25,81,31,54,85
32,8479385,Jordan Kyrou,C,STL,26,68,35,49,84
32,8477493,Aleksander Barkov,C,FLA,29,80,30,53,83
32,8474564,Steven Stamkos,C,NSH,34,73,39,43,82
32,8471675,Sidney Crosby,C,PIT,37,73,37,45,82
32,8477940,Nikolaj Ehlers,L,WPG,28,75,36,46,82
32,8477402,Pavel Buchnevich,L,STL,29,73,28,54,82
32,8479407,Jesper Bratt,L,NJD,26,75,22,60,82
32,8478427,Sebastian Aho,C,CAR,27,76,37,44,81
32,8482116,Tim Stützle,C,OTT,22,79,33,48,81
32,8475184,Chris Kreider,L,NYR,33,73,41,39,80
32,8476389,Vincent Trocheck,C,NYR,31,76,37,43,80
32,8478403,Jack Eichel,C,VGK,28,77,33,47,80
32,8480069,Cale Makar,D,COL,26,64,24,56,80
32,8480036,Miro Heiskanen,D,DAL,25,78,14,65,79
32,8475726,Tyler Toffoli,C,SJS,32,70,36,42,78
32,8478444,Brock Boeser,R,VAN,27,75,35,43,78
32,8479675,Trevor Moore,L,LAK,29,79,34,44,78
32,8477933,Sam Reinhart,C,FLA,29,79,38,39,77
32,8478864,Kirill Kaprizov,L,MIN,27,74,36,41,77
32,8478439,Travis Konecny,R,PHI,27,74,34,42,76
32,8476460,Mark Scheifele,C,WPG,31,72,31,45,76
32,8479337,Alex DeBrincat,R,DET,27,82,30,46,76
32,8477494,Jonathan Drouin,L,COL,29,82,23,53,76
32,8476346,Johnny Gaudreau,L,CBJ,31,72,18,58,76
32,8477960,Adrian Kempe,R,LAK,28,81,33,42,75
32,8481557,Matt Boldy,L,MIN,23,72,32,43,75
32,8478449,Roope Hintz,C,DAL,28,82,28,47,75
32,8476853,Morgan Rielly,D,TOR,30,71,11,64,75
32,8475692,Mats Zuccarello,R,MIN,37,69,23,51,74
32,8475786,Zach Hyman,L,EDM,32,78,41,32,73
32,8477500,Bo Horvat,C,NYI,29,80,36,36,72
32,8479323,Adam Fox,D,NYR,26,75,14,58,72
32,8478398,Kyle Connor,L,WPG,28,73,38,33,71
32,8479420,Tage Thompson,C,BUF,27,74,35,36,71
32,8480865,Noah Dobson,D,NYI,24,81,16,55,71
32,8471215,Evgeni Malkin,C,PIT,38,70,26,44,70
32,8480208,Drake Batherson,R,OTT,26,79,22,48,70
32,8479542,Brandon Hagel,L,TBL,26,82,35,34,69
32,8476479,Phillip Danault,C,LAK,31,81,24,45,69
32,8474578,Erik Karlsson,D,PIT,34,79,15,54,69
32,8473419,Brad Marchand,L,BOS,36,77,36,32,68
32,8471214,Alex Ovechkin,L,WSH,39,70,34,34,68
32,8484144,Connor Bedard,C,CHI,19,73,32,36,68
32,8478440,Dylan Strome,C,WSH,27,77,30,38,68
32,8482078,Lucas Raymond,L,DET,22,79,26,42,68
32,8471685,Anze Kopitar,C,LAK,37,79,25,43,68
32,8478460,Zach Werenski,D,CBJ,27,81,19,49,68
32,8476459,Mika Zibanejad,C,NYR,31,77,30,37,67
32,8476456,Jonathan Huberdeau,C,CGY,31,77,20,47,67
32,8477476,Artturi Lehkonen,L,COL,29,81,23,43,66
32,8477404,Jake Guentzel,C,TBL,30,82,21,45,66
32,8482665,Matty Beniers,C,SEA,22,73,19,47,66
32,8482740,Wyatt Johnston,C,DAL,21,79,40,25,65
32,8476539,Jonathan Marchessault,R,NSH,34,73,39,26,65
32,8477951,Nick Schmaltz,C,UTA,28,80,26,39,65
32,8480830,Andrei Svechnikov,R,CAR,24,69,23,42,65
32,8475172,Nazem Kadri,C,CGY,34,79,22,43,65
32,8477955,Jared McCann,L,SEA,28,79,32,32,64
32,8480803,Evan Bouchard,D,EDM,25,77,17,47,64
32,8475754,Brock Nelson,C,NYI,33,79,31,32,63
32,8477949,Alex Tuch,R,BUF,28,75,25,38,63
32,8475913,Mark Stone,R,VGK,32,73,21,42,63
32,8476875,Mike Matheson,D,MTL,30,78,17,46,63
32,8480839,Rasmus Dahlin,D,BUF,24,67,14,49,63
32,8479343,Clayton Keller,R,UTA,26,77,32,30,62
32,8480014,Gabriel Vilardi,C,WPG,25,72,32,30,62
32,8478856,Conor Garland,R,VAN,28,70,27,35,62
32,8482159,Tyson Foerster,R,PHI,22,79,27,35,62
32,8477496,Elias Lindholm,C,BOS,30,78,26,36,62
32,8481068,Yegor Sharangovich,C,CGY,26,79,25,37,62
32,8479425,Filip Hronek,D,VAN,27,73,21,41,62
32,8479325,Charlie McAvoy,D,BOS,27,75,19,43,62
32,8481528,Dylan Cozens,C,BUF,23,75,27,34,61
32,8474141,Patrick Kane,R,DET,36,81,24,37,61
32,8476448,William Karlsson,C,VGK,31,75,20,41,61
32,8478038,Devon Toews,D,COL,30,73,11,50,61
32,8475810,Bryan Rust,R,PIT,32,73,35,25,60
32,8475798,Mikael Granlund,C,SJS,32,67,18,42,60
32,8474600,Roman Josi,D,NSH,34,73,15,45,60
32,8478047,Michael Bunting,L,PIT,29,73,26,33,59
32,8477497,Sean Monahan,C,CBJ,30,71,25,34,59
32,8478873,Troy Terry,R,ANA,27,74,22,37,59
32,8479339,Patrik Laine,L,CBJ,26,66,21,38,59
32,8475191,Reilly Smith,R,NYR,33,72,28,30,58
32,8478401,Pavel Zacha,C,BOS,27,80,25,33,58
32,8479999,Casey Mittelstadt,C,COL,26,81,19,39,58
32,8477503,Max Domi,C,TOR,29,75,18,40,58
32,8478414,Timo Meier,R,NJD,28,71,31,26,57
32,8482093,Seth Jarvis,C,CAR,22,70,25,32,57
32,8480797,Joel Farabee,L,PHI,24,75,23,34,57
32,8476826,Yanni Gourde,C,SEA,33,76,22,35,57
32,8477456,J.T. Compher,L,DET,29,81,21,36,57
32,8482124,Quinton Byfield,R,LAK,22,78,20,37,57
32,8473512,Claude Giroux,R,OTT,36,76,19,38,57
32,8478469,Thomas Chabot,D,OTT,27,74,14,43,57
32,8477504,Josh Morrissey,D,WPG,29,71,12,45,57
32,8480064,Josh Norris,C,OTT,25,77,29,27,56
32,8477935,Sam Bennett,C,FLA,28,78,27,29,56
32,8480188,Fabian Zetterlund,L,SJS,25,70,24,32,56
32,8474102,David Perron,L,OTT,36,78,15,41,56
32,8471724,Kris Letang,D,PIT,37,77,14,42,56
32,8475794,Tyler Seguin,C,DAL,32,82,30,25,55
32,8482745,Mason McTavish,C,ANA,21,73,29,26,55
32,8475745,Charlie Coyle,C,BOS,32,81,25,30,55
32,8474586,Jordan Eberle,R,SEA,34,72,22,33,55
32,8482684,Luke Hughes,D,NJD,21,77,9,46,55
32,8478498,Jake DeBrusk,L,VAN,28,74,32,22,54
32,8476881,Tomas Hertl,C,VGK,31,75,29,25,54
32,8475765,Vladimir Tarasenko,R,DET,33,80,23,31,54
32,8482699,Dylan Guenther,R,UTA,21,74,23,31,54
32,8475158,Ryan O'Reilly,C,NSH,33,75,23,31,54
32,8477479,Tyler Bertuzzi,L,CHI,29,65,22,32,54
32,8482702,Logan Stankoven,C,DAL,21,82,21,33,54
32,8480009,Eeli Tolvanen,R,SEA,25,71,29,24,53
32,8481540,Cole Caufield,R,MTL,23,76,28,25,53
32,8478975,Mason Marchment,L,DAL,29,79,22,31,53
32,8484153,Leo Carlsson,C,ANA,20,74,21,32,53
32,8476905,Chandler Stephenson,C,SEA,30,71,14,39,53
32,8480220,Noah Cates,L,PHI,25,68,18,34,52
32,8478407,Vince Dunn,D,SEA,28,73,11,41,52
32,8476432,Boone Jenner,C,CBJ,31,71,34,17,51
32,8482667,William Eklund,L,SJS,22,67,27,24,51
32,8478493,Joel Eriksson Ek,C,MIN,27,69,22,29,51
32,8484145,Zach Benson,L,BUF,19,63,19,32,51
32,8477444,Andre Burakovsky,L,SEA,29,68,15,36,51
32,8475167,Victor Hedman,D,TBL,34,80,10,41,51
32,8482109,Alexis Lafrenière,L,NYR,23,74,26,24,50
32,8480018,Nick Suzuki,C,MTL,25,75,25,25,50
32,8477407,Anthony Duclair,L,NYI,29,78,23,27,50
32,8483515,Juraj Slafkovsky,L,MTL,20,73,19,31,50
32,8474679,Gustav Nyquist,C,NSH,35,75,18,32,50
32,8480028,Morgan Frost,C,PHI,25,73,18,32,50
32,8476880,Tom Wilson,R,WSH,30,69,17,33,50
32,8480039,Martin Necas,C,CAR,25,67,15,35,50
32,8477986,Brandon Montour,D,SEA,30,75,14,36,50
32,8483808,Andrei Kuzmenko,L,CGY,28,74,13,37,50
32,8470613,Brent Burns,D,CAR,39,77,12,38,50
32,8480015,Owen Tippett,R,PHI,25,77,25,24,49
32,8475169,Evander Kane,L,EDM,33,74,22,27,49
32,8484166,Adam Fantilli,C,CBJ,20,68,21,28,49
32,8478519,Anthony Cirelli,C,TBL,27,82,20,29,49
32,8478042,Viktor Arvidsson,L,EDM,31,72,20,29,49
32,8475168,Matt Duchene,C,DAL,33,81,19,30,49
32,8476419,Jean-Gabriel Pageau,C,NYI,32,72,19,30,49
32,8475170,Brayden Schenn,C,STL,33,75,24,24,48
32,8481596,Shane Pinto,C,OTT,24,76,18,30,48
32,8474150,Mikael Backlund,C,CGY,35,75,23,24,47
32,8483431,Logan Cooley,C,UTA,20,73,22,25,47
32,8475768,Jaden Schwartz,C,SEA,32,73,21,26,47
32,8476792,Torey Krug,D,STL,33,73,14,33,47
32,8475763,Kevin Hayes,R,PIT,32,69,14,33,47
32,8478397,Rasmus Andersson,D,CGY,28,77,11,36,47
32,8476854,Hampus Lindholm,D,BOS,30,73,7,40,47
32,8481542,Moritz Seider,D,DET,23,78,7,40,47
32,8477416,Oliver Bjorkstrand,R,SEA,29,74,24,22,46
32,8474641,Adam Henrique,C,EDM,34,75,23,23,46
32,8473986,Alex Killorn,L,ANA,35,75,19,27,46
32,8475287,Erik Haula,L,NJD,33,76,19,27,46
32,8479365,Trent Frederic,C,BOS,26,74,18,28,46
32,8477998,Warren Foegele,L,LAK,28,80,15,31,46
32,8476462,Dougie Hamilton,D,NJD,31,70,13,33,46
32,8473994,Jamie Benn,L,DAL,35,82,12,34,46
32,8481711,Matias Maccelli,L,UTA,24,73,11,35,46
32,8475753,Justin Faulk,D,STL,32,72,9,37,46
32,8476483,Rickard Rakell,R,PIT,31,72,21,24,45
32,8479400,Pierre-Luc Dubois,L,WSH,26,72,21,24,45
32,8478542,Evan Rodrigues,C,FLA,31,76,19,26,45
32,8478466,Daniel Sprong,R,VAN,27,71,19,26,45
32,8479410,Mikhail Sergachev,D,UTA,26,69,8,37,45
32,8477426,Nicholas Paul,L,TBL,29,82,23,21,44
32,8479992,Michael Rasmussen,C,DET,25,78,20,24,44
32,8476882,Teuvo Teravainen,C,CHI,30,63,18,26,44
32,8477021,Alex Kerfoot,C,UTA,30,72,17,27,44
32,8482092,Ridly Greig,C,OTT,22,75,16,28,44
32,8478472,Mathieu Joseph,R,STL,27,68,14,30,44
32,8477932,Aaron Ekblad,D,FLA,28,70,13,31,44
32,8477495,Seth Jones,D,CHI,30,66,12,32,44
32,8477451,Ryan Hartman,R,MIN,30,68,21,22,43
32,8479525,Ross Colton,C,COL,28,80,21,22,43
32,8482720,Matthew Knies,L,TOR,22,77,19,24,43
32,8474149,Evgenii Dadonov,R,DAL,35,77,18,25,43
32,8481618,Alex Newhook,C,MTL,23,73,13,30,43
32,8482105,Jake Sanderson,D,OTT,22,69,11,32,43
32,8474563,Drew Doughty,D,LAK,35,68,10,33,43
32,8474590,John Carlson,D,WSH,34,63,7,36,43
32,8481606,Jordan Spence,D,LAK,23,66,7,36,43
32,8475799,Nino Niederreiter,R,WPG,32,69,24,18,42
32,8478366,Frank Vatrano,R,ANA,30,77,20,22,42
32,8482705,Cole Sillinger,C,CBJ,21,67,12,30,42
32,8475314,Anders Lee,L,NYI,34,75,21,20,41
32,8476461,Sean Couturier,C,PHI,32,65,19,22,41
32,8482110,Dawson Mercer,C,NJD,23,68,16,25,41
32,8480798,Philipp Kurashev,C,CHI,25,66,15,26,41
32,8477964,Ivan Barbashev,C,VGK,29,75,13,28,41
32,8474565,Alex Pietrangelo,D,VGK,34,62,12,29,41
32,8476872,Scott Laughton,C,PHI,30,72,11,30,41
32,8481546,Cam York,D,PHI,23,69,11,30,41
32,8478500,Ivan Provorov,D,CBJ,27,82,7,34,41
32,8482475,Yegor Chinakhov,R,CBJ,23,57,21,19,40
32,8481533,Trevor Zegras,C,ANA,23,69,19,21,40
32,8481604,Pavel Dorofeyev,L,VGK,24,71,18,22,40
32,8476399,Blake Coleman,C,CGY,33,77,17,23,40
32,8475151,Kyle Palmieri,C,NYI,33,79,14,26,40
32,8477346,MacKenzie Weegar,D,CGY,30,74,13,27,40
32,8476869,Brady Skjei,D,NSH,30,75,10,30,40
32,8477447,Shea Theodore,D,VGK,29,59,8,32,40
32,8478115,Pierre Engvall,L,NYI,28,78,22,17,39
32,8476438,Brandon Saad,L,STL,32,73,20,19,39
32,8478046,Danton Heinen,L,VAN,29,70,14,25,39
32,8483505,Matthew Poitras,C,BOS,20,77,8,31,39
32,8482055,Drew O'Connor,L,PIT,26,65,21,17,38
32,8481560,Arthur Kaliyev,R,LAK,23,80,16,22,38
32,8479390,Taylor Raddysh,R,WSH,26,68,14,24,38
32,8480113,Alex Iafallo,L,WPG,31,65,12,26,38
32,8478891,Mason Appleton,C,WPG,28,67,11,27,38
32,8482133,Thomas Bordeleau,C,SJS,22,62,11,27,38
32,8475848,Brendan Gallagher,R,MTL,32,70,21,16,37
32,8475714,Calle Jarnkrok,C,TOR,33,73,18,19,37
32,8478462,Nicolas Roy,C,VGK,27,76,16,21,37
32,8474189,Lars Eller,C,PIT,35,65,15,22,37
32,8478233,Andrew Mangiapane,L,WSH,28,70,13,24,37
32,8474053,Logan Couture,C,SJS,35,61,13,24,37
32,8476906,Shayne Gostisbehere,D,CAR,31,76,11,26,37
32,8481581,Thomas Harley,D,DAL,23,75,9,28,37
32,8480434,Sean Durzi,D,UTA,26,72,6,31,37
32,8481554,Kaapo Kakko,R,NYR,23,70,21,15,36
32,8481535,Nils Hoglander,L,VAN,24,67,20,16,36
32,8482089,Jake Neighbours,L,STL,22,71,19,17,36
32,8481186,Logan O'Connor,R,COL,28,78,15,21,36
32,8478020,Michael Amadio,R,OTT,28,70,15,21,36
32,8477429,Andrew Copp,C,DET,30,80,13,23,36
32,8482097,Jack Quinn,R,BUF,23,69,11,25,36
32,8482113,Anton Lundell,C,FLA,23,77,11,25,36
32,8480871,Adam Boqvist,D,FLA,24,65,6,30,36
32,8479987,Morgan Geekie,C,BOS,26,73,14,21,35
32,8480829,Jesperi Kotkaniemi,C,CAR,24,64,13,22,35
32,8481577,Philip Tomasino,C,NSH,23,64,11,24,35
32,8478463,Anthony Beauvillier,L,PIT,27,65,11,24,35
32,8478438,Tommy Novak,C,NSH,27,68,10,25,35
32,8476923,Damon Severson,D,CBJ,30,80,9,26,35
32,8482671,Owen Power,D,BUF,22,72,9,26,35
32,8480817,K'Andre Miller,D,NYR,24,74,5,30,35
32,8471698,T.J. Oshie,R,WSH,38,67,19,15,34
32,8482175,JJ Peterka,R,BUF,22,71,17,17,34
32,8477952,Robby Fabbri,C,ANA,28,62,16,18,34
32,8477511,Anthony Mantha,R,CGY,30,77,15,19,34
32,8477953,Kasperi Kapanen,R,STL,28,71,11,23,34
32,8476422,Mike Reilly,D,NYI,31,77,9,25,34
32,8479345,Jakob Chychrun,D,WSH,26,65,8,26,34
32,8475218,Mattias Ekholm,D,EDM,34,72,7,27,34
32,8478055,Gustav Forsling,D,FLA,28,74,6,28,34
32,8480459,Pius Suter,C,VAN,28,71,19,14,33
32,8476458,Ryan Strome,C,ANA,31,71,14,19,33
32,8477505,Alexander Wennberg,C,SJS,30,57,11,22,33
32,8481481,Blake Lizotte,C,PIT,27,67,11,22,33
32,8481523,Kirby Dach,C,MTL,23,72,10,23,33
32,8475171,Oliver Ekman-Larsson,D,TOR,33,68,10,23,33
32,8482712,Oskar Olausson,R,COL,22,79,8,25,33
32,8476958,Jaccob Slavin,D,CAR,30,76,7,26,33
32,8484203,Bradly Nadeau,L,CAR,19,68,16,16,32
32,8480185,Eetu Luostarinen,C,FLA,26,75,14,18,32
32,8474715,Cameron Atkinson,R,TBL,35,79,14,18,32
32,8475722,Jason Zucker,L,BUF,32,63,14,18,32
32,8478057,Dakota Joshua,C,VAN,28,65,13,19,32
32,8476892,Colton Parayko,D,STL,31,76,10,22,32
32,8475149,Marcus Johansson,L,MIN,34,68,9,23,32
32,8476292,Ondrej Palat,L,NJD,33,71,6,26,32
32,8473533,Jordan Staal,C,CAR,36,60,17,14,31
32,8481582,Nicholas Robertson,L,TOR,23,68,17,14,31
32,8477425,Miles Wood,L,COL,29,78,16,15,31
32,8475200,Dmitry Orlov,D,CAR,33,70,15,16,31
32,8478109,Victor Olofsson,L,VGK,29,69,15,16,31
32,8478474,Lawson Crouse,L,UTA,27,76,14,17,31
32,8479661,Tanner Jeannot,L,LAK,27,79,14,17,31
32,8475793,Ryan Johansen,C,PHI,32,75,13,18,31
32,8482149,Cole Perfetti,C,WPG,22,61,12,19,31
32,8482660,Kent Johnson,C,CBJ,22,63,11,20,31
32,8482111,Justin Barron,D,MTL,23,64,10,21,31
32,8481524,Bowen Byram,D,BUF,23,67,9,22,31
32,8483490,Pavel Mintyukov,D,ANA,21,73,5,26,31
32,8475764,Cam Fowler,D,ANA,33,77,4,27,31
32,8479393,Noah Gregor,L,OTT,26,72,16,14,30
32,8476918,Jimmy Vesey,L,NYR,31,71,15,15,30
32,8476921,Jordan Martinook,L,CAR,32,58,12,18,30
32,8479591,Michael Eyssimont,C,TBL,28,80,11,19,30
32,8475760,Nick Bjugstad,C,UTA,32,75,11,19,30
32,8475855,Jesper Fast,R,CAR,33,64,11,19,30
32,8481624,Ilya Mikheyev,R,CHI,30,62,9,21,30
32,8477498,Darnell Nurse,D,EDM,29,77,7,23,30
32,8476480,Vladislav Namestnikov,C,WPG,32,67,6,24,30
32,8474151,Ryan McDonagh,D,TBL,35,76,3,27,30
32,8482074,Connor Zary,C,CGY,23,65,19,10,29
32,8482146,Luke Evangelista,R,NSH,22,67,14,15,29
32,8480813,Joe Veleno,C,DET,24,75,14,15,29
32,8480068,Ryan Poehling,C,PHI,25,67,14,15,29
32,8479293,Brandon Tanev,L,SEA,33,64,14,15,29
32,8475231,Casey Cizikas,C,NYI,33,73,14,15,29
32,8470621,Corey Perry,R,EDM,39,67,13,16,29
32,8481441,Joe Snively,C,DET,28,65,8,21,29
32,8482122,Brock Faber,D,MIN,22,77,6,23,29
32,8477488,Brett Pesce,D,NJD,30,69,6,23,29
32,8480893,Kirill Marchenko,R,CBJ,24,60,21,7,28
32,8478413,Jordan Greenway,L,BUF,27,71,19,9,28
32,8477987,Ryan Donato,C,CHI,28,67,17,11,28
32,8477839,Conor Sheary,L,TBL,32,82,14,14,28
32,8480835,Jack Drury,C,CAR,24,59,13,15,28
32,8480144,David Kampf,C,TOR,29,77,13,15,28
32,8482067,Connor Mackey,D,NYR,28,63,4,24,28
32,8477969,Marcus Pettersson,D,PIT,28,79,3,25,28
32,8473507,Jeff Petry,D,DET,37,68,2,26,28
32,8481014,Alexander Romanov,D,NYI,24,76,2,26,28
32,8475790,Erik Gudbranson,D,CBJ,32,79,2,26,28
32,8477947,Sonny Milano,L,WSH,28,59,15,12,27
32,8480078,Filip Chytil,C,NYR,25,71,11,16,27
32,8482125,Alexander Holtz,R,VGK,22,70,11,16,27
32,8475193,Tomas Tatar,L,NJD,34,67,10,17,27
32,8480802,Ryan McLeod,C,BUF,25,66,9,18,27
32,8481703,Valtteri Puustinen,R,PIT,25,57,8,19,27
32,8478970,Jalen Chatfield,D,CAR,28,73,8,19,27
32,8478458,John (Jack) Roslovic,C,CAR,27,71,7,20,27
32,8478396,Noah Hanifin,D,VGK,27,62,7,20,27
32,8482142,Jamie Drysdale,D,PHI,22,62,3,24,27
32,8482062,Cole Smith,L,NSH,29,59,18,8,26
32,8476981,Josh Anderson,R,MTL,30,67,17,9,26
32,8482809,Jackson Blake,R,CAR,21,62,14,12,26
32,8480789,Oliver Wahlstrom,R,NYI,24,75,13,13,26
32,8481580,Connor McMichael,C,WSH,23,62,12,14,26
32,8482737,Zack Bolduc,C,STL,21,61,11,15,26
32,8478508,Yakov Trenin,C,MIN,27,62,11,15,26
32,8480849,Barrett Hayton,C,UTA,24,72,10,16,26
32,8476979,Erik Gustafsson,D,DET,32,74,9,17,26
32,8482101,Danil Gushchin,L,SJS,22,58,9,17,26
32,8481656,Aliaksei Protas,C,WSH,23,68,8,18,26
32,8473563,Nicklas Backstrom,C,WSH,37,57,7,19,26
32,8477989,Christian Dvorak,C,MTL,28,61,6,20,26
32,8482192,Isaak Phillips,D,CHI,23,50,5,21,26
32,8477506,Ryan Pulock,D,NYI,30,77,5,21,26
32,8476931,Jake McCabe,D,TOR,31,72,4,22,26
32,8475233,David Savard,D,MTL,34,69,2,24,26
32,8479398,Samuel Girard,D,COL,26,70,2,24,26
32,8482079,Marco Rossi,C,MIN,23,57,16,9,25
32,8482259,Bobby McMann,C,TOR,28,65,12,13,25
32,8479353,Brett Howden,C,VGK,26,69,12,13,25
32,8480855,Jack McBain,C,UTA,24,69,12,13,25
32,8480074,Alexandre Texier,C,STL,25,51,12,13,25
32,8473422,Nick Foligno,L,CHI,37,49,11,14,25
32,8475343,Nic Dowd,C,WSH,34,59,11,14,25
32,8476392,Adam Lowry,C,WPG,31,64,10,15,25
32,8476902,Esa Lindell,D,DAL,30,74,9,16,25
32,8478911,Matt Roy,D,WSH,29,71,8,17,25
32,8479976,Juuso Valimaki,D,UTA,26,62,8,17,25
32,8480145,Neal Pionk,D,WPG,29,71,7,18,25
32,8480073,Erik Brannstrom,D,COL,25,59,7,18,25
32,8476925,Colton Sissons,C,NSH,31,56,6,19,25
32,8477435,Ryan Graves,D,PIT,29,76,4,21,25
32,8482073,Braden Schneider,D,NYR,23,63,3,22,25
32,8476917,Adam Pelech,D,NYI,30,80,0,25,25
32,8478432,Christian Fischer,R,DET,27,73,12,12,24
32,8482749,Joshua Roy,R,MTL,21,66,12,12,24
32,8476960,Andreas Athanasiou,C,CHI,30,54,11,13,24
32,8479351,Sam Steel,C,DAL,26,76,10,14,24
32,8476897,Oskar Sundqvist,C,STL,30,64,10,14,24
32,8479316,Luke Kunin,C,SJS,27,59,10,14,24
32,8477478,William Carrier,L,CAR,30,54,9,15,24
32,8480748,Kiefer Sherwood,L,VAN,29,53,9,15,24
32,8481553,Bobby Brink,R,PHI,23,59,8,16,24
32,8482087,Kaiden Guhle,D,MTL,22,64,7,17,24
32,8482245,Artem Zub,D,OTT,29,70,6,18,24
32,8478178,Darren Raddysh,D,TBL,28,70,6,18,24
32,8476312,Josh Manson,D,COL,33,62,5,19,24
32,8476885,Jacob Trouba,D,NYR,30,74,4,20,24
32,8480043,Timothy Liljegren,D,TOR,25,61,2,22,24
32,8480878,Nils Lundkvist,D,DAL,24,72,2,22,24
32,8481093,Rafael Harvey-Pinard,L,MTL,25,65,13,10,23
32,8475791,Taylor Hall,L,CHI,33,55,8,15,23
32,8481704,Juuso Parssinen,C,NSH,23,65,7,16,23
32,8470600,Ryan Suter,D,STL,39,63,7,16,23
32,8477948,Travis Sanheim,D,PHI,28,60,6,17,23
32,8478133,Jake Evans,C,MTL,28,70,5,18,23
32,8482655,Janis Moser,D,TBL,24,79,3,20,23
32,8476879,Cody Ceci,D,EDM,31,70,0,23,23
32,8477015,Connor Brown,R,EDM,30,57,15,7,22
32,8480011,Klim Kostin,C,SJS,25,59,14,8,22
32,8482148,Hendrix Lapierre,C,WSH,22,55,11,11,22
32,8480003,Jesper Boqvist,C,FLA,26,68,10,12,22
32,8479520,Brandon Duhaime,R,WSH,27,57,10,12,22
32,8476329,Travis Boyd,C,MIN,31,50,9,13,22
32,8476822,Luke Glendening,C,TBL,35,78,9,13,22
32,8477353,Tyler Motte,C,DET,29,69,8,14,22
32,8481059,Scott Perunovich,D,STL,26,61,7,15,22
32,8483460,David Jiricek,D,CBJ,21,61,7,15,22
32,8483524,Shane Wright,C,SEA,20,52,6,16,22
32,8479402,Jake Bean,D,CGY,26,64,5,17,22
32,8476467,Jamie Oleksiak,D,SEA,32,68,5,17,22
32,8477369,Carson Soucy,D,VAN,30,62,5,17,22
32,8482451,Mikael Pyyhtia,L,CBJ,23,46,5,17,22
32,8474574,Tyler Myers,D,VAN,34,69,4,18,22
32,8476463,Jonas Brodin,D,MIN,31,77,3,19,22
32,8481178,Egor Zamula,D,PHI,24,55,2,20,22
32,8480873,Rasmus Sandin,D,WSH,24,62,1,21,22
32,8477507,Nikita Zadorov,D,BOS,29,67,1,21,22
32,8476967,Brett Kulak,D,EDM,30,65,1,21,22
32,8476278,Colin Blackwell,C,DAL,31,74,12,9,21
32,8478569,Noel Acciari,C,PIT,33,57,11,10,21
32,8476474,Stefan Noesen,R,NJD,31,68,11,10,21
32,8481477,Nico Sturm,C,SJS,29,63,10,11,21
32,8480806,Isac Lundestrom,C,ANA,25,61,10,11,21
32,8481601,Simon Holmstrom,R,NYI,23,65,9,12,21
32,8478434,Keegan Kolesar,R,VGK,27,69,8,13,21
32,8479368,Max Jones,L,BOS,26,68,7,14,21
32,8475220,Marcus Foligno,L,MIN,33,58,6,15,21
32,8476988,Matt Benning,D,SJS,30,69,6,15,21
32,8477220,Nate Schmidt,D,FLA,33,66,5,16,21
32,8480049,Dylan Samberg,D,WPG,25,70,4,17,21
32,8479026,Philippe Myers,D,TOR,27,55,4,17,21
32,8478136,Jake Middleton,D,MIN,28,74,4,17,21
32,8480035,Henri Jokiharju,D,BUF,25,61,3,18,21
32,8479369,Andrew Peeke,D,BOS,26,69,2,19,21
32,8479414,Nathan Bastian,R,NJD,27,58,16,4,20
32,8476878,Zemgus Girgensons,C,TBL,30,80,13,7,20
32,8478211,Dryden Hunt,L,CGY,29,53,11,9,20
32,8483491,Ivan Miroshnichenko,L,WSH,20,43,10,10,20
32,8476469,Joel Armia,R,MTL,31,64,9,11,20
32,8474716,Jared Spurgeon,D,MIN,35,81,8,12,20
32,8477979,Nicolas Aube-Kubel,R,BUF,28,57,8,12,20
32,8483445,Cutter Gauthier,L,ANA,20,63,5,15,20
32,8476927,Teddy Blueger,C,VAN,30,64,5,15,20
32,8479315,Joey Anderson,R,CHI,26,56,5,15,20
32,8480246,Nick Perbix,D,TBL,26,73,3,17,20
32,8475690,Chris Tanev,D,TOR,35,57,3,17,20
32,8474090,Brendan Smith,D,DAL,35,65,3,17,20
32,8479983,Mario Ferraro,D,SJS,26,73,2,18,20
32,8478851,Alexandre Carrier,D,NSH,28,64,2,18,20
32,8479619,Michael Carcone,L,UTA,28,60,12,7,19
32,8482803,Olen Zellweger,D,ANA,21,67,10,9,19
32,8482679,Matt Coronato,R,CGY,22,64,9,10,19
32,8475188,Brayden McNabb,D,VGK,33,60,8,11,19
32,8479066,Ryan Lomberg,L,CGY,30,63,7,12,19
32,8480222,Sebastian Aho,D,PIT,28,75,6,13,19
32,8476856,Mathew Dumba,D,DAL,30,64,5,14,19
32,8478452,Caleb Jones,D,LAK,27,65,5,14,19
32,8478443,Brandon Carlo,D,BOS,28,58,5,14,19
32,8478451,Ethan Bear,D,WSH,27,49,5,14,19
32,8480336,Sean Walker,D,CAR,30,72,2,17,19
32,8478882,Vladislav Gavrikov,D,LAK,29,72,1,18,19
32,8482155,Alex Laferriere,R,LAK,23,62,14,4,18
32,8475842,Sam Carrick,C,NYR,32,52,11,7,18
32,8480205,Emil Bemstrom,C,PIT,25,60,10,8,18
32,8475279,Ben Chiarot,D,DET,33,68,8,10,18
32,8480995,Pontus Holmberg,R,TOR,25,58,8,10,18
32,8482117,Lukas Reichel,L,CHI,22,57,7,11,18
32,8483457,Lane Hutson,D,MTL,20,63,7,11,18
32,8480448,Parker Kelly,L,COL,25,71,7,11,18
32,8483499,Liam Ohgren,L,MIN,20,53,6,12,18
32,8483565,Nick Blankenburg,D,NSH,26,61,5,13,18
32,8477406,Mattias Janmark,C,EDM,32,66,5,13,18
32,8477919,Frederick Gaudreau,C,MIN,31,68,5,13,18
32,8478013,Jake Walman,D,SJS,28,73,5,13,18
32,8477499,Rasmus Ristolainen,D,PHI,30,65,4,14,18
32,8479370,Tyson Jost,C,CAR,26,58,4,14,18
32,8481567,Henry Thrun,D,SJS,23,44,4,14,18
32,8481522,Peyton Krebs,C,BUF,23,58,3,15,18
32,8478840,Will Borgen,D,SEA,28,68,2,16,18
32,8480001,Urho Vaakanainen,D,ANA,25,58,2,16,18
32,8476891,Matthew Grzelcyk,D,PIT,30,78,1,17,18
32,8477903,Garnet Hathaway,R,PHI,33,61,13,4,17
32,8481032,Paul Cotter,C,NJD,25,61,12,5,17
32,8477931,Tomas Nosek,L,FLA,32,55,10,7,17
32,8477450,Jason Dickinson,C,CHI,29,54,8,9,17
32,8480762,Eric Robinson,L,CAR,29,54,7,10,17
32,8481013,Jonatan Berggren,R,DET,24,59,7,10,17
32,8477508,Curtis Lazar,C,NJD,29,61,6,11,17
32,8478859,Niko Mikkola,D,FLA,28,61,5,12,17
32,8482807,Ethan Del Mastro,D,CHI,21,57,5,12,17
32,8482624,Daniil Miromanov,D,CGY,27,61,4,13,17
32,8479371,Dante Fabbro,D,NSH,26,66,1,16,17
32,8480796,Martin Fehervary,D,WSH,25,55,1,16,17
32,8478507,John Marino,D,UTA,27,67,0,17,17
32,8479941,Justin Danforth,R,CBJ,31,53,11,5,16
32,8479336,Carl Grundstrom,R,SJS,27,47,10,6,16
32,8483495,Simon Nemec,D,NJD,20,59,10,6,16
32,8478043,Sam Lafferty,C,BUF,29,59,9,7,16
32,8482077,Dylan Holloway,L,EDM,23,51,9,7,16
32,8480021,Jack Studnicka,C,LAK,25,58,8,8,16
32,8480289,Morgan Barron,C,WPG,26,51,7,9,16
32,8483482,Tristan Luneau,D,ANA,20,58,5,11,16
32,8474034,Patrick Maroon,L,CHI,36,49,4,12,16
32,8479982,Conor Timmins,D,TOR,26,60,4,12,16
32,8475177,Calvin de Haan,D,COL,33,55,4,12,16
32,8475462,Radko Gudas,D,ANA,34,59,3,13,16
32,8476525,Colin Miller,D,WPG,32,72,3,13,16
32,8478399,Jonas Siegenthaler,D,NJD,27,64,2,14,16
32,8479324,Ryan Lindgren,D,NYR,26,52,1,15,16
32,8475181,Nick Leddy,D,STL,33,65,1,15,16
32,8476457,Adam Larsson,D,SEA,32,68,1,15,16
32,8479249,Andrew Poturalski,C,SJS,30,36,1,15,16
32,8473453,Trevor Lewis,C,LAK,37,72,9,6,15
32,8480025,MacKenzie Entwistle,R,FLA,25,59,9,6,15
32,8476889,Radek Faksa,C,STL,30,53,8,7,15
32,8481751,Lukas Rousek,R,BUF,25,36,8,7,15
32,8480980,Connor Dewar,C,TOR,25,69,7,8,15
32,8480157,Calle Rosen,D,COL,30,51,7,8,15
32,8479344,Jesse Puljujarvi,R,PIT,26,49,6,9,15
32,8483468,Jiri Kulich,C,BUF,20,54,5,10,15
32,8477446,Michael McCarron,R,NSH,29,58,5,10,15
32,8482666,Scott Morrow,D,CAR,22,48,5,10,15
32,8481521,Ronnie Attard,D,PHI,25,57,4,11,15
32,8478421,A.J. Greer,L,FLA,28,61,4,11,15
32,8484149,Gavin Brindley,C,CBJ,20,51,4,11,15
32,8482176,Wyatt Kaiser,D,CHI,22,60,3,12,15
32,8479980,Nicolas Hague,D,VGK,26,62,2,13,15
32,8476331,Dylan DeMelo,D,WPG,31,71,1,14,15
32,8480807,Mattias Samuelsson,D,BUF,24,55,1,14,15
32,8481716,Dmitri Voronkov,L,CBJ,24,48,10,4,14
32,8481592,Jakob Pelletier,L,CGY,23,42,8,6,14
32,8481789,Tye Kartye,L,SEA,23,43,8,6,14
32,8481537,Nikita Okhotiuk,D,CGY,24,53,7,7,14
32,8475225,Craig Smith,C,CHI,35,49,7,7,14
32,8477392,Hudson Fasching,R,NYI,29,63,6,8,14
32,8476624,Barclay Goodrow,C,SJS,31,48,6,8,14
32,8481028,Martin Pospisil,C,CGY,25,58,6,8,14
32,8476873,Mark Jankowski,C,NSH,30,51,4,10,14
32,8481527,Kaedan Korczak,D,VGK,23,46,4,10,14
32,8479639,Dylan Coghlan,D,WPG,26,61,4,10,14
32,8476374,Sean Kuraly,C,CBJ,31,52,4,10,14
32,8479442,Troy Stecher,D,EDM,30,55,3,11,14
32,8475455,Brenden Dillon,D,NJD,34,56,3,11,14
32,8479998,Mikey Anderson,D,LAK,25,59,2,12,14
32,8475208,Brian Dumoulin,D,ANA,33,63,2,12,14
32,8474166,Alec Martinez,D,CHI,37,49,2,12,14
32,8476429,Scott Mayfield,D,NYI,32,68,1,13,14
32,8480891,Michael Kesselring,D,UTA,24,55,0,14,14
32,8477845,Trevor van Riemsdyk,D,WSH,33,54,0,14,14
32,8480281,Alexey Toropchenko,R,STL,25,63,8,5,13
32,8480252,Cole Guttman,C,CHI,25,41,8,5,13
32,8477573,Nathan Walker,L,STL,30,49,8,5,13
32,8482157,Will Cuylle,L,NYR,22,58,7,6,13
32,8480355,Mark Kastelic,C,BOS,25,62,7,6,13
32,8477962,Brendan Lemieux,L,CAR,28,30,7,6,13
32,8479996,Cody Glass,C,NSH,25,57,6,7,13
32,8481641,Joel Kiviranta,L,COL,28,70,6,7,13
32,8474673,TJ Brodie,D,CHI,34,58,5,8,13
32,8479968,Vinni Lettieri,C,BOS,29,50,5,8,13
32,8476874,Olli Maatta,D,DET,30,59,5,8,13
32,8481568,Alex Vlasic,D,CHI,23,57,4,9,13
32,8478017,Mark Friedman,D,VAN,29,39,4,9,13
32,8480860,Kevin Bahl,D,CGY,24,55,3,10,13
32,8474013,Ian Cole,D,UTA,35,54,3,10,13
32,8480834,Ty Emberson,D,SJS,24,36,3,10,13
32,8477365,Connor Clifton,D,BUF,29,56,2,11,13
32,8477034,Jaycob Megna,D,FLA,32,48,2,11,13
32,8481019,David Gustafsson,C,WPG,24,51,2,11,13
32,8481599,Victor Soderstrom,D,UTA,23,44,2,11,13
32,8479328,Julien Gauthier,R,NYI,27,59,7,5,12
32,8476994,Vinnie Hinostroza,C,NSH,30,49,6,6,12
32,8481518,Nolan Foote,L,NJD,24,39,6,6,12
32,8481617,Vasily Podkolzin,R,VAN,23,53,5,7,12
32,8476473,Connor Murphy,D,CHI,31,37,5,7,12
32,8478585,Derek Ryan,C,EDM,38,62,4,8,12
32,8479986,Kole Lind,R,DAL,26,61,4,8,12
32,8479372,Joshua Mahura,D,SEA,26,52,3,9,12
32,8480245,Olle Lycksell,R,PHI,25,40,3,9,12
32,8480727,Zach Whitecloud,D,VGK,28,46,3,9,12
32,8482634,Alex Steeves,C,TOR,25,45,2,10,12
32,8481517,Brett Leason,R,ANA,25,57,2,10,12
32,8478416,Erik Cernak,D,TBL,27,73,1,11,12
32,8475179,Dmitry Kulikov,D,FLA,34,59,1,11,12
32,8477380,Jonny Brodzinski,C,NYR,31,51,5,6,11
32,8480848,Ty Dellandrea,C,SJS,24,42,5,6,11
32,8482964,Arber Xhekaj,D,MTL,23,50,5,6,11
32,8481167,Brayden Pachal,D,CGY,25,46,3,8,11
32,8476867,Brendan Gaunce,C,MIN,30,34,2,9,11
32,8480196,Jacob Bryson,D,BUF,27,49,2,9,11
32,8475324,Nick Jensen,D,OTT,34,64,1,10,11
32,8481701,Santeri Hatakka,D,NJD,23,36,1,10,11
32,8475718,Justin Holl,D,DET,32,58,0,11,11
32,8471677,Jack Johnson,D,CBJ,37,61,0,11,11
32,8480441,Trey Fix-Wolansky,R,CBJ,25,36,8,2,10
32,8476934,Brock McGinn,L,ANA,30,43,7,3,10
32,8482747,Brennan Othmann,L,NYR,21,41,6,4,10
32,8479439,Jacob MacDonald,D,COL,31,40,5,5,10
32,8481550,Adam Beckman,L,NJD,23,43,5,5,10
32,8477070,Liam O'Brien,C,UTA,30,54,4,6,10
32,8480950,Ilya Lyubushkin,D,DAL,30,51,3,7,10
32,8481600,Tobias Bjornfot,D,FLA,23,40,3,7,10
32,8482762,Simon Edvinsson,D,DET,21,62,3,7,10
32,8483466,Kevin Korchinski,D,CHI,20,47,3,7,10
32,8477482,Zachary Sanford,L,CHI,30,38,2,8,10
32,8480292,Carson Meyer,R,ANA,27,37,2,8,10
32,8475762,Derek Forbort,D,VAN,32,50,2,8,10
32,8479972,Mason Shaw,C,WPG,26,35,2,8,10
32,8473446,Erik Johnson,D,PHI,36,54,1,9,10
32,8482861,Vincent Iorio,D,WSH,22,38,1,9,10
32,8471709,Marc-Edouard Vlasic,D,SJS,37,60,0,10,10
32,8479359,Beck Malenstyn,L,BUF,26,40,7,2,9
32,8477473,Justin Bailey,R,SJS,29,28,7,2,9
32,8482166,Shakir Mukhamadullin,D,SJS,22,58,5,4,9
32,8479994,Jaret Anderson-Dolan,C,WPG,25,38,5,4,9
32,8483549,Lucas Condotta,L,MTL,27,35,4,5,9
32,8479671,Mathieu Olivier,R,CBJ,27,52,4,5,9
32,8481147,Reese Johnson,C,MIN,26,37,4,5,9
32,8483493,Frank Nazar,C,CHI,20,44,3,6,9
32,8482730,Brandt Clarke,D,LAK,21,47,3,6,9
32,8479291,Kevin Rooney,C,CGY,31,42,3,6,9
32,8482095,Tyler Kleven,D,OTT,22,44,3,6,9
32,8479536,Axel Jonsson-Fjallby,L,WPG,26,33,3,6,9
32,8482784,Zach Dean,C,STL,21,43,3,6,9
32,8482496,Nils Aman,C,VAN,24,38,3,6,9
32,8480870,Bo Groulx,C,NYR,24,30,3,6,9
32,8479543,Michael Pezzetta,L,MTL,26,56,2,7,9
32,8477018,Ben Hutton,D,VGK,31,49,2,7,9
32,8478874,Adam Gaudette,R,OTT,28,35,2,7,9
32,8477938,Haydn Fleury,D,WPG,28,41,2,7,9
32,8479379,Givani Smith,R,SJS,26,31,2,7,9
32,8480172,Jan Rutta,D,SJS,34,58,1,8,9
32,8481708,Zac Jones,D,NYR,24,48,1,8,9
32,8480879,Jacob Bernard-Docker,D,OTT,24,50,1,8,9
32,8476858,Phillip Di Giuseppe,L,VAN,31,43,5,3,8
32,8482765,Isak Rosen,R,BUF,21,34,5,3,8
32,8477467,Gustav Olofsson,D,SEA,30,17,5,3,8
32,8480192,Johnathan Kovacevic,D,NJD,27,50,4,4,8
32,8475958,Michael Sgarbossa,C,WSH,32,24,4,4,8
32,8479944,Zach Aston-Reese,C,VGK,30,47,4,4,8
32,8480070,Ian Mitchell,D,BOS,25,47,3,5,8
32,8481122,Simon Benoit,D,TOR,26,33,3,5,8
32,8477851,Jordan Oesterle,D,BOS,32,42,3,5,8
32,8476442,Matt Nieto,L,PIT,32,47,2,6,8
32,8478468,Jeremy Lauzon,D,NSH,27,48,2,6,8
32,8476952,Dominic Toninato,C,WPG,30,42,2,6,8
32,8482744,James Malatesta,L,CBJ,21,45,2,6,8
32,8484254,Akito Hirose,D,VAN,25,41,1,7,8
32,8479378,Logan Stanley,D,WPG,26,35,1,7,8
32,8480887,Jordan Harris,D,MTL,24,62,0,8,8
32,8478831,Kevin Stenlund,C,UTA,28,57,6,1,7
32,8478021,William Lagesson,D,DET,28,25,5,2,7
32,8482659,Josh Doan,R,UTA,22,47,4,3,7
32,8483619,Filip Roos,D,OTT,25,44,4,3,7
32,8478424,Jansen Harkins,C,ANA,27,44,3,4,7
32,8481541,Samuel Bolduc,D,NYI,24,26,3,4,7
32,8479718,Alex Barré-Boulet,C,MTL,27,47,2,5,7
32,8475750,Jon Merrill,D,MIN,32,56,2,5,7
32,8477810,Joel Hanley,D,CGY,33,29,2,5,7
32,8480845,Rasmus Kupari,C,WPG,24,35,1,6,7
32,8476441,Joel Edmundson,D,LAK,31,40,1,6,7
32,8482516,Matthew Kessel,D,STL,24,16,1,6,7
32,8479348,Kale Clague,D,BUF,26,39,0,7,7
32,8479772,Zack MacEwen,R,OTT,28,54,4,2,6
32,8483012,Logan Morrison,C,SEA,22,33,4,2,6
32,8471817,Ryan Reaves,R,TOR,37,52,4,2,6
32,8483630,Pavol Regenda,L,ANA,25,31,4,2,6
32,8483763,Maksymilian Szuber,D,UTA,22,32,3,3,6
32,8478409,Anthony Richard,C,PHI,28,26,3,3,6
32,8481532,Alex Turcotte,C,LAK,23,41,2,4,6
32,8480880,Jakub Lauko,C,MIN,24,40,2,4,6
32,8480990,Declan Chisholm,D,MIN,24,41,2,4,6
32,8479981,Jonah Gadjovich,L,FLA,26,42,2,4,6
32,8477335,Kyle Burroughs,D,LAK,29,41,1,5,6
32,8481605,Jackson LaCombe,D,ANA,23,37,1,5,6
32,8474567,Zach Bogosian,D,MIN,34,58,0,6,6
32,8481598,Philip Broberg,D,EDM,23,39,0,6,6
32,8476372,Nick Seeler,D,PHI,31,44,0,6,6
32,8482652,Walker Duehr,R,CGY,27,41,4,1,5
32,8481609,Vladislav Kolyachonok,D,UTA,23,35,4,1,5
32,8481754,Nikita Nesterenko,C,ANA,23,39,4,1,5
32,8478051,Max Willman,C,NJD,29,20,4,1,5
32,8482144,Jack Thompson,D,SJS,22,21,3,2,5
32,8481543,Nikita Alexandrov,C,STL,24,27,3,2,5
32,8482070,Mitchell Chaffee,R,TBL,26,61,3,2,5
32,8480851,Akil Thomas,C,LAK,24,20,3,2,5
32,8481161,Jake Christiansen,D,CBJ,25,48,2,3,5
32,8482153,Brendan Brisson,C,VGK,23,30,2,3,5
32,8482511,Mason Lohrei,D,BOS,23,31,2,3,5
32,8478146,Matthew Highmore,C,OTT,28,36,2,3,5
32,8478011,Louie Belpedio,D,PHI,28,14,2,3,5
32,8481679,Maxence Guenette,D,OTT,23,35,1,4,5
32,8478454,Noah Juulsen,D,VAN,27,37,1,4,5
32,8482177,Marat Khusnutdinov,C,MIN,22,34,1,4,5
32,8474568,Luke Schenn,D,NSH,35,50,0,5,5
32,8477462,Robert Hagg,D,VGK,29,24,0,5,5
32,8476913,Devin Shore,C,MIN,30,31,0,5,5
32,8477320,Anton Blidh,L,NYR,29,28,0,5,5
32,8482250,Callahan Burke,C,VGK,27,21,0,5,5
32,8481065,Angus Crookshank,L,OTT,25,24,4,0,4
32,8482751,Ryan Winterton,C,SEA,21,30,3,1,4
32,8481556,John Beecher,C,BOS,23,33,3,1,4
32,8482141,Lukas Cormier,D,VGK,22,22,3,1,4
32,8479638,Justin Brazeau,R,BOS,26,34,3,1,4
32,8482713,Mackie Samoskevich,R,FLA,22,38,2,2,4
32,8477401,John Hayden,C,SEA,29,24,2,2,4
32,8480844,Grigori Denisenko,L,VGK,24,25,2,2,4
32,8479985,Cale Fleury,D,SEA,26,24,2,2,4
32,8475795,Dylan McIlrath,D,WSH,32,17,2,2,4
32,8480058,Pierre-Olivier Joseph,D,STL,25,50,1,3,4
32,8482859,Zack Ostapchuk,C,OTT,21,50,1,3,4
32,8477149,Scott Sabourin,R,SJS,32,15,1,3,4
32,8480075,Cameron Crotty,D,MIN,25,12,1,3,4
32,8483512,Matthew Savoie,C,EDM,20,22,1,3,4
32,8477887,Patrick Brown,C,BOS,32,46,0,4,4
32,8478450,Parker Wotherspoon,D,BOS,27,30,0,4,4
32,8474612,Travis Hamonic,D,OTT,34,42,0,4,4
32,8477971,Andreas Englund,D,LAK,28,31,0,4,4
32,8477244,Chad Ruhwedel,D,NYR,34,38,0,4,4
32,8482470,Ilya Solovyov,D,CGY,24,17,0,4,4
32,8479320,Maxime Lajoie,D,SEA,27,19,0,4,4
32,8475235,Nicolas Deslauriers,L,PHI,33,54,3,0,3
32,8480007,Jonas Rondbjerg,R,VGK,25,44,2,1,3
32,8479367,William Lockwood,R,FLA,26,19,2,1,3
32,8482094,Daemon Hunt,D,MIN,22,16,2,1,3
32,8483397,Marc McLaughlin,C,BOS,25,31,2,1,3
32,8481422,Jake Lucchini,C,NSH,29,18,2,1,3
32,8479991,Jake Leschyshyn,C,NYR,25,29,2,1,3
32,8482061,Brandon Biro,L,SEA,26,18,2,1,3
32,8482102,Vasily Ponomarev,C,PIT,22,14,2,1,3
32,8482733,Logan Mailloux,D,MTL,31,29,1,2,3
32,8478881,Brett Seney,L,CHI,28,13,1,2,3
32,8477073,Kurtis MacDermid,L,NJD,30,24,1,2,3
32,8475755,Alexander Petrovic,D,DAL,32,13,1,2,3
32,8484911,Collin Graf,R,SJS,22,31,0,3,3
32,8477384,Joshua Brown,D,EDM,30,32,0,3,3
32,8481006,Tyler Tucker,D,STL,24,16,0,3,3
32,8482172,Landon Slaggert,L,CHI,22,29,0,3,3
32,8478502,Dennis Gilbert,D,BUF,28,17,0,3,3
32,8480032,Shane Bowers,C,NJD,25,17,2,0,2
32,8483597,Milos Kelemen,L,UTA,25,11,2,0,2
32,8484255,Jason Polin,R,COL,25,9,2,0,2
32,8480890,Jan Jenik,C,OTT,24,25,1,1,2
32,8482145,Mavrik Bourque,C,DAL,22,48,1,1,2
32,8481056,Spencer Stastney,D,NSH,24,34,1,1,2
32,8480267,Sammy Walker,C,MIN,25,19,1,1,2
32,8481699,Aku Raty,R,UTA,23,14,1,1,2
32,8480468,James Hamblin,L,EDM,25,25,1,1,2
32,8482201,Gage Goncalves,C,TBL,23,19,1,1,2
32,8480874,Adam Ginning,D,PHI,24,11,1,1,2
32,8478477,Mitchell Stephens,C,SEA,27,25,1,1,2
32,8483432,Luca Del Bel Belluz,C,CBJ,31,5,1,1,2
32,8479576,Vincent Desharnais,D,VAN,28,28,0,2,2
32,8484287,Cole McWard,D,VAN,23,20,0,2,2
32,8474062,Riley Nash,C,NYR,35,18,0,2,2
32,8481743,Marc Del Gaizo,D,NSH,25,21,0,2,2
32,8481237,Kyle MacLean,C,NYI,25,27,0,2,2
32,8482118,Sam Colangelo,R,ANA,23,8,0,2,2
32,8482088,Justin Sourdif,R,FLA,22,18,0,2,2
32,8481043,Cole Koepke,L,BOS,26,18,0,2,2
32,8482162,Roby Jarventie,L,EDM,22,17,0,2,2
32,8482787,Nikita Chibrikov,R,WPG,31,8,0,2,2
32,8481534,Raphael Lavoie,C,EDM,24,3,0,2,2
32,8482147,Jean-Luc Foudy,C,COL,22,24,1,0,1
32,8483489,Fraser Minten,C,TOR,31,10,1,0,1
32,8481806,Louis Crevier,D,CHI,23,11,1,0,1
32,8481206,John Ludvig,D,PIT,24,13,1,0,1
32,8478446,Glenn Gawdin,C,LAK,27,14,1,0,1
32,8475780,Chris Wagner,R,COL,33,7,1,0,1
32,8483531,Brian Halonen,L,NJD,25,1,1,0,1
32,8480274,Philip Kemp,D,EDM,25,5,1,0,1
32,8483570,Ben Meyers,C,SEA,26,38,0,1,1
32,8477993,Justin Kirkland,C,CGY,28,8,0,1,1
32,8477527,Ross Johnston,L,ANA,30,26,0,1,1
32,8482858,Ryker Evans,D,SEA,23,28,0,1,1
32,8482165,Yan Kuznetsov,D,CGY,22,16,0,1,1
32,8483407,Brandon Scanlin,D,NYR,25,5,0,1,1
32,8482929,Emil Lilleberg,D,TBL,23,24,0,1,1
32,8481585,Egor Afanasyev,L,SJS,23,13,0,1,1
32,8479362,Riley Tufte,L,BOS,26,15,0,1,1
32,8480084,Nick DeSimone,D,NJD,30,11,0,1,1
32,8479419,Brett Murray,L,BUF,26,19,0,1,1
32,8481719,Maxwell Crozier,D,TBL,24,15,0,1,1
32,8481564,Ryan Johnson,D,BUF,23,9,0,1,1
32,8475413,Justin Dowling,C,NJD,34,9,0,1,1
32,8482476,Emil Heineman,L,MTL,23,5,0,1,1
32,8481593,Jayden Struble,D,MTL,23,13,0,1,1
32,8481024,Linus Karlsson,C,VAN,25,9,0,1,1
32,8483567,Georgii Merkulov,C,BOS,24,9,0,1,1
32,8483395,Arshdeep Bains,L,VAN,23,11,0,1,1
32,8483471,Brad Lambert,C,WPG,31,6,0,1,1
32,8482126,Emil Andrae,D,PHI,31,1,0,1,1
32,8481655,Cole Schwindt,R,CGY,23,7,0,1,1
32,8483609,Adam Klapka,R,CGY,24,3,0,1,1
32,8479587,Rhett Gardner,C,PHI,28,19,0,0,0
32,8484258,Sam Malinski,D,COL,26,18,0,0,0
32,8480823,Alexander Alexeyev,D,WSH,25,12,0,0,0
32,8481030,Jack St. Ivany,D,PIT,25,9,0,0,0
32,8482460,Matt Rempe,C,NYR,22,10,0,0,0
32,8481578,Graeme Clarke,R,MIN,23,15,0,0,0
32,8484304,Uvis Balinskis,D,FLA,28,9,0,0,0
32,8479330,Brandon Gignac,C,MTL,27,9,0,0,0
32,8480306,Grant Hutton,D,NYI,29,7,0,0,0
32,8481462,Mason Morelli,L,VGK,28,18,0,0,0
32,8484325,Waltteri Merela,C,TBL,26,13,0,0,0
32,8482197,Adam Raska,R,MIN,23,6,0,0,0
32,8476323,Max McCormick,L,SEA,32,0,0,0,0
32,8484326,Patrik Koch,D,UTA,28,2,0,0,0
32,8478854,Ryan Shea,D,PIT,27,6,0,0,0
32,8483546,Marshall Rifai,D,TOR,26,5,0,0,0
32,8479421,Jacob Moverare,D,LAK,26,3,0,0,0
32,8481726,Adam Edstrom,C,NYR,24,7,0,0,0
32,8479522,Hardy Haman Aktell,D,WSH,26,6,0,0,0
32,8483398,Declan Carlile,D,TBL,31,2,0,0,0
32,8477541,Dakota Mermis,D,TOR,30,10,0,0,0
32,8478147,Bokondji Imama,L,PIT,28,6,0,0,0
32,8483920,Pierrick Dube,R,WSH,23,7,0,0,0
32,8483401,Marc Johnstone,R,PIT,28,2,0,0,0
32,8484259,Ondrej Pavel,C,COL,31,1,0,0,0
32,8484321,Nikolas Matinpalo,D,OTT,26,0,0,0,0
32,8470794,Joe Pavelski,C,,40,0,0,0,0
32,8479321,Lucas Johansen,D,,27,0,0,0,0
32,8477950,Tony DeAngelo,D,,29,0,0,0,0
32,8471218,Blake Wheeler,R,,38,0,0,0,0
32,8475197,Tyson Barrie,D,,33,0,0,0,0
32,8474157,Max Pacioretty,L,,36,0,0,0,0
32,8475744,Evgeny Kuznetsov,C,,32,0,0,0,0
32,8474037,James van Riemsdyk,L,,35,0,0,0,0
32,8476907,Mackenzie MacEachern,L,,30,0,0,0,0
32,8480216,Jacob Peterson,C,,25,0,0,0,0
32,8474602,Justin Schultz,D,,34,0,0,0,0
32,8482222,Alexander Barabanov,L,,30,0,0,0,0
32,8474031,Kevin Shattenkirk,D,,35,0,0,0,0
32,8477330,Dominik Kubalik,L,,29,0,0,0,0
32,8480884,Calen Addison,D,,24,0,0,0,0
32,8475906,John Klingberg,D,,32,0,0,0,0
32,8480008,Adam Ruzicka,C,,25,0,0,0,0
32,8476884,Derrick Pouliot,D,,30,0,0,0,0
32,8476919,Chris Tierney,C,,30,0,0,0,0
32,8479415,Michael McLeod,C,,26,0,0,0,0
32,8474870,Tyler Johnson,C,,34,0,0,0,0
32,8470604,Jeff Carter,C,,39,0,0,0,0
32,8478104,Sammy Blais,L,,28,0,0,0,0
32,8474884,Mike Hoffman,C,,35,0,0,0,0
32,8481591,Sam Poulin,R,,23,0,0,0,0
32,8471274,Alex Goligoski,D,,39,0,0,0,0
32,8476871,Tanner Pearson,L,,32,0,0,0,0
32,8476393,Nick Cousins,C,,31,0,0,0,0
32,8479977,Kailer Yamamoto,R,,26,0,0,0,0
32,8479346,Dillon Dube,C,,26,0,0,0,0
32,8480184,Gustav Lindstrom,D,,26,0,0,0,0
32,8479376,Victor Mete,D,,26,0,0,0,0
32,8473449,Kyle Okposo,R,,36,0,0,0,0
32,8481058,Jesse Ylonen,R,,25,0,0,0,0
32,8475752,Tyler Pitlick,C,,33,0,0,0,0
32,8481239,Samuel Fagemo,L,,24,0,0,0,0
32,8480821,Filip Zadina,R,,25,0,0,0,0
32,8470966,Mark Giordano,D,,41,0,0,0,0
32,8478495,Denis Gurianov,R,,27,0,0,0,0
32,8477464,Nic Petan,C,,29,0,0,0,0
32,8478099,Kevin Labanc,R,,29,0,0,0,0
32,8482241,Radim Zohorna,L,,28,0,0,0,0
32,8474040,Sam Gagner,C,,35,0,0,0,0
32,8479514,Rem Pitlick,C,,27,0,0,0,0
32,8478430,Oliver Kylington,D,,27,0,0,0,0
32,8479533,Joona Koppanen,L,,26,0,0,0,0
32,8479984,Cal Foote,D,,26,0,0,0,0
32,8477126,Jayson Megna,C,,34,0,0,0,0
32,8475164,Jakob Silfverberg,R,,34,0,0,0,0
32,8474009,Nick Bonino,C,,36,0,0,0,0
32,8479458,Nikita Zaitsev,D,,33,0,0,0,0
32,8477944,Jakub Vrana,L,,28,0,0,0,0
32,8471699,Andrew Cogliano,C,,37,0,0,0,0
32,8478067,Oskar Lindblom,L,,28,0,0,0,0
32,8471686,Marc Staal,D,,37,0,0,0,0
32,8470610,Zach Parise,L,,40,0,0,0,0
32,8478904,Steven Lorentz,C,,28,0,0,0,0
32,8473473,Milan Lucic,L,,36,0,0,0,0
32,8480031,Maxime Comtois,L,,25,0,0,0,0
32,8478512,Austin Czarnik,C,,32,0,0,0,0
32,8473504,Cal Clutterbuck,R,,37,0,0,0,0
32,8477454,Adam Erne,L,,29,0,0,0,0
32,8479383,Boris Katchouk,L,,26,0,0,0,0
32,8475825,Jani Hakanpää,D,,32,0,0,0,0
32,8477846,Ryan Carpenter,C,,33,0,0,0,0
32,8477930,Pierre-Edouard Bellemare,L,,39,0,0,0,0
32,8478400,Colin White,C,,27,0,0,0,0
32,8480226,Marián Studenic,R,,26,0,0,0,0
32,8480853,Liam Foudy,C,,24,0,0,0,0
32,8475797,Jarred Tinordi,D,,32,0,0,0,0
32,8479423,Alex Nylander,L,,26,0,0,0,0
32,8474618,Marco Scandella,D,,34,0,0,0,0
32,8478028,Fredrik Olofsson,L,,28,0,0,0,0
32,8474709,Matt Martin,L,,35,0,0,0,0
32,8481070,Hugh McGing,L,,26,0,0,0,0
32,8479546,Oskar Steen,C,,26,0,0,0,0
32,8474145,Robert Bortuzzo,D,,35,0,0,0,0
32,8476915,Jujhar Khaira,L,,30,0,0,0,0
32,8475278,Byron Froese,C,,33,0,0,0,0
32,8481812,Nikolai Knyzhov,D,,27,0,0,0,0
32,8478408,Travis Dermott,D,,28,0,0,0,0
32,8481077,John Leonard,L,,26,0,0,0,0
32,8479547,Matthew Phillips,R,,26,0,0,0,0
32,8480836,Jonathan Gruden,C,,24,0,0,0,0
32,8481690,Tyler Angle,C,,24,0,0,0,0
32,8475766,Austin Watson,L,,32,0,0,0,0
32,8481016,Ruslan Iskhakov,C,,24,0,0,0,0
32,8478078,Rourke Chartier,C,,28,0,0,0,0
32,8480776,Sheldon Rempal,R,,29,0,0,0,0
32,8478956,Samuel Laberge,L,NJD,27,4,0,0,0
32,8483045,Cameron Butler,R,CBJ,31,1,0,0,0
32,8484314,Jiri Smejkal,L,,28,0,0,0,0
33,8478402,Connor McDavid,C,EDM,27,80,41,115,156
33,8477492,Nathan MacKinnon,C,COL,29,80,58,76,134
33,8476453,Nikita Kucherov,R,TBL,31,82,33,94,127
33,8477934,Leon Draisaitl,C,EDM,29,76,52,69,121
33,8478420,Mikko Rantanen,R,COL,28,82,49,72,121
33,8478483,Mitch Marner,R,TOR,27,80,40,81,121
33,8477956,David Pastrnak,R,BOS,28,78,60,57,117
33,8481559,Jack Hughes,C,NJD,23,72,33,73,106
33,8479318,Auston Matthews,C,TOR,27,80,50,50,100
33,8477939,William Nylander,R,TOR,28,82,41,59,100
33,8480069,Cale Makar,D,COL,26,72,28,72,100
33,8480800,Quinn Hughes,D,VAN,25,78,21,77,98
33,8475172,Nazem Kadri,C,CGY,34,81,39,58,97
33,8479314,Matthew Tkachuk,L,FLA,27,79,38,59,97
33,8478010,Brayden Point,C,TBL,28,82,52,44,96
33,8477404,Jake Guentzel,C,TBL,30,82,38,58,96
33,8482116,Tim Stützle,C,OTT,22,80,34,62,96
33,8480012,Elias Pettersson,C,VAN,26,76,26,70,96
33,8478445,Mathew Barzal,C,NYI,27,79,33,61,94
33,8474564,Steven Stamkos,C,NSH,34,72,36,56,92
33,8478550,Artemi Panarin,L,NYR,33,77,25,66,91
33,8477501,Valeri Nichushkin,R,COL,29,81,45,45,90
33,8478864,Kirill Kaprizov,L,MIN,27,70,36,54,90
33,8480027,Jason Robertson,L,DAL,25,80,29,60,89
33,8479385,Jordan Kyrou,C,STL,26,77,46,42,88
33,8477946,Dylan Larkin,C,DET,28,80,41,47,88
33,8477493,Aleksander Barkov,C,FLA,29,77,22,65,87
33,8480023,Robert Thomas,C,STL,25,78,24,62,86
33,8477942,Kevin Fiala,L,LAK,28,82,31,54,85
33,8476468,J.T. Miller,C,VAN,31,77,30,54,84
33,8481557,Matt Boldy,L,MIN,23,73,37,46,83
33,8474141,Patrick Kane,R,DET,36,81,29,54,83
33,8480865,Noah Dobson,D,NYI,24,81,20,63,83
33,8475168,Matt Duchene,C,DAL,33,82,31,51,82
33,8476887,Filip Forsberg,L,NSH,30,70,37,44,81
33,8471675,Sidney Crosby,C,PIT,37,71,35,46,81
33,8476454,Ryan Nugent-Hopkins,C,EDM,31,76,23,58,81
33,8480036,Miro Heiskanen,D,DAL,25,81,17,64,81
33,8477960,Adrian Kempe,R,LAK,28,81,37,43,80
33,8478439,Travis Konecny,R,PHI,27,77,28,52,80
33,8479337,Alex DeBrincat,R,DET,27,79,46,33,79
33,8479407,Jesper Bratt,L,NJD,26,77,27,52,79
33,8479323,Adam Fox,D,NYR,26,73,14,65,79
33,8476389,Vincent Trocheck,C,NYR,31,77,29,49,78
33,8475786,Zach Hyman,L,EDM,32,77,44,33,77
33,8475810,Bryan Rust,R,PIT,32,74,35,42,77
33,8474600,Roman Josi,D,NSH,34,77,21,56,77
33,8482699,Dylan Guenther,R,UTA,21,72,42,34,76
33,8471214,Alex Ovechkin,L,WSH,39,76,39,37,76
33,8476483,Rickard Rakell,R,PIT,31,71,38,38,76
33,8478449,Roope Hintz,C,DAL,28,82,33,43,76
33,8480039,Martin Necas,C,CAR,25,71,33,43,76
33,8478493,Joel Eriksson Ek,C,MIN,27,76,40,35,75
33,8478398,Kyle Connor,L,WPG,28,69,35,40,75
33,8482740,Wyatt Johnston,C,DAL,21,80,39,34,73
33,8476539,Jonathan Marchessault,R,NSH,34,73,34,39,73
33,8480801,Brady Tkachuk,L,OTT,25,78,33,40,73
33,8480830,Andrei Svechnikov,R,CAR,24,63,28,45,73
33,8478403,Jack Eichel,C,VGK,28,74,30,42,72
33,8476460,Mark Scheifele,C,WPG,31,72,27,45,72
33,8476459,Mika Zibanejad,C,NYR,31,73,26,46,72
33,8478975,Mason Marchment,L,DAL,29,81,21,51,72
33,8476346,Johnny Gaudreau,L,CBJ,31,71,17,55,72
33,8474578,Erik Karlsson,D,PIT,34,77,11,60,71
33,8477402,Pavel Buchnevich,L,STL,29,71,30,40,70
33,8478444,Brock Boeser,R,VAN,27,73,30,40,70
33,8476881,Tomas Hertl,C,VGK,31,76,29,40,69
33,8475166,John Tavares,C,TOR,34,79,28,41,69
33,8480002,Nico Hischier,C,NJD,25,72,21,48,69
33,8477409,Carter Verhaeghe,C,FLA,29,80,34,34,68
33,8477476,Artturi Lehkonen,L,COL,29,81,29,39,68
33,8475913,Mark Stone,R,VGK,32,73,27,41,68
33,8477951,Nick Schmaltz,C,UTA,28,75,26,42,68
33,8478407,Vince Dunn,D,SEA,28,78,21,47,68
33,8475692,Mats Zuccarello,R,MIN,37,66,14,54,68
33,8475784,Jeff Skinner,C,EDM,32,77,34,33,67
33,8481528,Dylan Cozens,C,BUF,23,73,33,34,67
33,8477940,Nikolaj Ehlers,L,WPG,28,74,31,36,67
33,8478414,Timo Meier,R,NJD,28,76,30,37,67
33,8477933,Sam Reinhart,C,FLA,29,78,29,38,67
33,8478427,Sebastian Aho,C,CAR,27,72,28,39,67
33,8473419,Brad Marchand,L,BOS,36,80,16,51,67
33,8480803,Evan Bouchard,D,EDM,25,75,7,60,67
33,8482665,Matty Beniers,C,SEA,22,77,27,39,66
33,8471215,Evgeni Malkin,C,PIT,38,73,23,43,66
33,8479542,Brandon Hagel,L,TBL,26,82,21,45,66
33,8475754,Brock Nelson,C,NYI,33,80,36,29,65
33,8479343,Clayton Keller,R,UTA,26,79,34,31,65
33,8475184,Chris Kreider,L,NYR,33,74,32,32,64
33,8477494,Jonathan Drouin,L,COL,29,81,23,41,64
33,8473512,Claude Giroux,R,OTT,36,79,20,44,64
33,8477496,Elias Lindholm,C,BOS,30,79,25,38,63
33,8476448,William Karlsson,C,VGK,31,78,27,35,62
33,8475745,Charlie Coyle,C,BOS,32,80,24,38,62
33,8484144,Connor Bedard,C,CHI,19,64,23,39,62
33,8479999,Casey Mittelstadt,C,COL,26,79,23,39,62
33,8476456,Jonathan Huberdeau,C,CGY,31,77,15,47,62
33,8474590,John Carlson,D,WSH,34,69,10,52,62
33,8479420,Tage Thompson,C,BUF,27,71,33,28,61
33,8476462,Dougie Hamilton,D,NJD,31,72,22,39,61
33,8478438,Tommy Novak,C,NSH,27,76,19,42,61
33,8478440,Dylan Strome,C,WSH,27,74,14,47,61
33,8474641,Adam Henrique,C,EDM,34,75,30,30,60
33,8475794,Tyler Seguin,C,DAL,32,82,27,33,60
33,8482720,Matthew Knies,L,TOR,22,78,27,32,59
33,8473994,Jamie Benn,L,DAL,35,81,23,36,59
33,8477955,Jared McCann,L,SEA,28,77,27,31,58
33,8471685,Anze Kopitar,C,LAK,37,81,23,35,58
33,8478401,Pavel Zacha,C,BOS,27,78,22,36,58
33,8482159,Tyson Foerster,R,PHI,22,76,21,37,58
33,8471724,Kris Letang,D,PIT,37,79,17,41,58
33,8482078,Lucas Raymond,L,DET,22,82,16,42,58
33,8478873,Troy Terry,R,ANA,27,73,16,42,58
33,8475158,Ryan O'Reilly,C,NSH,33,71,27,30,57
33,8477456,J.T. Compher,L,DET,29,79,25,32,57
33,8475765,Vladimir Tarasenko,R,DET,33,82,19,38,57
33,8477407,Anthony Duclair,L,NYI,29,79,26,30,56
33,8480839,Rasmus Dahlin,D,BUF,24,72,19,37,56
33,8475167,Victor Hedman,D,TBL,34,79,11,45,56
33,8477504,Josh Morrissey,D,WPG,29,75,7,49,56
33,8482093,Seth Jarvis,C,CAR,22,68,26,29,55
33,8480208,Drake Batherson,R,OTT,26,77,22,33,55
33,8478047,Michael Bunting,L,PIT,29,72,20,35,55
33,8474150,Mikael Backlund,C,CGY,35,79,17,38,55
33,8475768,Jaden Schwartz,C,SEA,32,73,23,31,54
33,8477500,Bo Horvat,C,NYI,29,77,21,33,54
33,8478498,Jake DeBrusk,L,VAN,28,75,28,25,53
33,8475169,Evander Kane,L,EDM,33,76,27,26,53
33,8484153,Leo Carlsson,C,ANA,20,74,23,30,53
33,8480018,Nick Suzuki,C,MTL,25,76,22,31,53
33,8478042,Viktor Arvidsson,L,EDM,31,76,13,40,53
33,8480014,Gabriel Vilardi,C,WPG,25,68,30,22,52
33,8477935,Sam Bennett,C,FLA,28,77,29,23,52
33,8477949,Alex Tuch,R,BUF,28,69,22,30,52
33,8474586,Jordan Eberle,R,SEA,34,74,22,30,52
33,8475798,Mikael Granlund,C,SJS,32,70,18,34,52
33,8475753,Justin Faulk,D,STL,32,74,16,36,52
33,8478460,Zach Werenski,D,CBJ,27,82,8,44,52
33,8476880,Tom Wilson,R,WSH,30,68,26,25,51
33,8479365,Trent Frederic,C,BOS,26,78,22,29,51
33,8481533,Trevor Zegras,C,ANA,23,74,21,30,51
33,8476875,Mike Matheson,D,MTL,30,78,11,40,51
33,8482684,Luke Hughes,D,NJD,21,71,10,41,51
33,8478397,Rasmus Andersson,D,CGY,28,72,8,43,51
33,8474565,Alex Pietrangelo,D,VGK,34,59,8,43,51
33,8480188,Fabian Zetterlund,L,SJS,25,72,26,24,50
33,8484166,Adam Fantilli,C,CBJ,20,71,25,25,50
33,8476826,Yanni Gourde,C,SEA,33,75,14,36,50
33,8477416,Oliver Bjorkstrand,R,SEA,29,75,14,36,50
33,8480797,Joel Farabee,L,PHI,24,74,13,37,50
33,8475191,Reilly Smith,R,NYR,33,75,12,38,50
33,8476399,Blake Coleman,C,CGY,33,75,23,26,49
33,8482745,Mason McTavish,C,ANA,21,73,22,27,49
33,8482149,Cole Perfetti,C,WPG,22,74,20,29,49
33,8480798,Philipp Kurashev,C,CHI,25,64,16,33,49
33,8478458,John (Jack) Roslovic,C,CAR,27,67,15,34,49
33,8482124,Quinton Byfield,R,LAK,22,79,13,36,49
33,8474679,Gustav Nyquist,C,NSH,35,74,13,36,49
33,8480434,Sean Durzi,D,UTA,26,69,12,37,49
33,8481542,Moritz Seider,D,DET,23,79,11,38,49
33,8475726,Tyler Toffoli,C,SJS,32,70,23,25,48
33,8482113,Anton Lundell,C,FLA,23,78,23,25,48
33,8471698,T.J. Oshie,R,WSH,38,66,23,25,48
33,8481068,Yegor Sharangovich,C,CGY,26,78,21,27,48
33,8479339,Patrik Laine,L,CBJ,26,74,19,29,48
33,8478038,Devon Toews,D,COL,30,70,10,38,48
33,8477346,MacKenzie Weegar,D,CGY,30,74,9,39,48
33,8483515,Juraj Slafkovsky,L,MTL,20,74,22,25,47
33,8473986,Alex Killorn,L,ANA,35,74,21,26,47
33,8481540,Cole Caufield,R,MTL,23,74,20,27,47
33,8483431,Logan Cooley,C,UTA,20,77,19,28,47
33,8479987,Morgan Geekie,C,BOS,26,75,17,30,47
33,8476854,Hampus Lindholm,D,BOS,30,72,11,36,47
33,8475314,Anders Lee,L,NYI,34,73,23,23,46
33,8478462,Nicolas Roy,C,VGK,27,76,20,26,46
33,8478233,Andrew Mangiapane,L,WSH,28,71,20,26,46
33,8480028,Morgan Frost,C,PHI,25,71,15,31,46
33,8477447,Shea Theodore,D,VGK,29,63,13,33,46
33,8481711,Matias Maccelli,L,UTA,24,78,11,35,46
33,8482146,Luke Evangelista,R,NSH,22,67,19,26,45
33,8475287,Erik Haula,L,NJD,33,73,18,27,45
33,8477964,Ivan Barbashev,C,VGK,29,77,14,31,45
33,8477429,Andrew Copp,C,DET,30,82,13,32,45
33,8483490,Pavel Mintyukov,D,ANA,21,75,7,38,45
33,8482109,Alexis Lafrenière,L,NYR,23,75,29,15,44
33,8480015,Owen Tippett,R,PHI,25,76,25,19,44
33,8475793,Ryan Johansen,C,PHI,32,72,24,20,44
33,8475799,Nino Niederreiter,R,WPG,32,72,23,21,44
33,8477511,Anthony Mantha,R,CGY,30,72,23,21,44
33,8481604,Pavel Dorofeyev,L,VGK,24,78,22,22,44
33,8478519,Anthony Cirelli,C,TBL,27,82,21,23,44
33,8475151,Kyle Palmieri,C,NYI,33,79,21,23,44
33,8479400,Pierre-Luc Dubois,L,WSH,26,66,19,25,44
33,8477998,Warren Foegele,L,LAK,28,79,18,26,44
33,8482475,Yegor Chinakhov,R,CBJ,23,65,18,26,44
33,8481186,Logan O'Connor,R,COL,28,76,17,27,44
33,8476905,Chandler Stephenson,C,SEA,30,74,14,30,44
33,8479325,Charlie McAvoy,D,BOS,27,72,12,32,44
33,8477021,Alex Kerfoot,C,UTA,30,73,10,34,44
33,8476906,Shayne Gostisbehere,D,CAR,31,78,7,37,44
33,8479525,Ross Colton,C,COL,28,82,23,20,43
33,8479992,Michael Rasmussen,C,DET,25,78,19,24,43
33,8483808,Andrei Kuzmenko,L,CGY,28,77,17,26,43
33,8477986,Brandon Montour,D,SEA,30,73,13,30,43
33,8479425,Filip Hronek,D,VAN,27,71,11,32,43
33,8477503,Max Domi,C,TOR,29,77,10,33,43
33,8476853,Morgan Rielly,D,TOR,30,72,8,35,43
33,8477479,Tyler Bertuzzi,L,CHI,29,63,19,23,42
33,8474053,Logan Couture,C,SJS,35,64,14,28,42
33,8477444,Andre Burakovsky,L,SEA,29,67,12,30,42
33,8481618,Alex Newhook,C,MTL,23,74,12,30,42
33,8476958,Jaccob Slavin,D,CAR,30,75,10,32,42
33,8481546,Cam York,D,PHI,23,70,8,34,42
33,8482089,Jake Neighbours,L,STL,22,73,30,11,41
33,8482702,Logan Stankoven,C,DAL,21,81,18,23,41
33,8478856,Conor Garland,R,VAN,28,76,17,24,41
33,8470613,Brent Burns,D,CAR,39,77,16,25,41
33,8482660,Kent Johnson,C,CBJ,22,64,15,26,41
33,8476479,Phillip Danault,C,LAK,31,76,12,29,41
33,8479345,Jakob Chychrun,D,WSH,26,68,12,29,41
33,8475764,Cam Fowler,D,ANA,33,78,8,33,41
33,8474563,Drew Doughty,D,LAK,35,71,7,34,41
33,8482110,Dawson Mercer,C,NJD,23,66,26,14,40
33,8477451,Ryan Hartman,R,MIN,30,66,22,18,40
33,8477497,Sean Monahan,C,CBJ,30,69,20,20,40
33,8484203,Bradly Nadeau,L,CAR,19,65,18,22,40
33,8479675,Trevor Moore,L,LAK,29,80,15,25,40
33,8475848,Brendan Gallagher,R,MTL,32,70,15,25,40
33,8481581,Thomas Harley,D,DAL,23,73,11,29,40
33,8480064,Josh Norris,C,OTT,25,75,23,16,39
33,8477426,Nicholas Paul,L,TBL,29,81,23,16,39
33,8476432,Boone Jenner,C,CBJ,31,69,22,17,39
33,8478474,Lawson Crouse,L,UTA,27,76,22,17,39
33,8476461,Sean Couturier,C,PHI,32,74,15,24,39
33,8475218,Mattias Ekholm,D,EDM,34,73,13,26,39
33,8480009,Eeli Tolvanen,R,SEA,25,68,20,18,38
33,8478466,Daniel Sprong,R,VAN,27,64,17,21,38
33,8477495,Seth Jones,D,CHI,30,70,10,28,38
33,8482097,Jack Quinn,R,BUF,23,70,9,29,38
33,8476923,Damon Severson,D,CBJ,30,80,9,29,38
33,8481560,Arthur Kaliyev,R,LAK,23,76,22,15,37
33,8478046,Danton Heinen,L,VAN,29,72,21,16,37
33,8481554,Kaapo Kakko,R,NYR,23,68,19,18,37
33,8474149,Evgenii Dadonov,R,DAL,35,81,15,22,37
33,8477507,Nikita Zadorov,D,BOS,29,73,9,28,37
33,8477506,Ryan Pulock,D,NYI,30,78,7,30,37
33,8477932,Aaron Ekblad,D,FLA,28,74,6,31,37
33,8482712,Oskar Olausson,R,COL,22,77,6,31,37
33,8478396,Noah Hanifin,D,VGK,27,60,5,32,37
33,8484145,Zach Benson,L,BUF,19,68,18,18,36
33,8482667,William Eklund,L,SJS,22,68,16,20,36
33,8475763,Kevin Hayes,R,PIT,32,72,16,20,36
33,8477498,Darnell Nurse,D,EDM,29,75,15,21,36
33,8480829,Jesperi Kotkaniemi,C,CAR,24,70,13,23,36
33,8480855,Jack McBain,C,UTA,24,68,13,23,36
33,8481577,Philip Tomasino,C,NSH,23,63,12,24,36
33,8480185,Eetu Luostarinen,C,FLA,26,72,12,24,36
33,8476292,Ondrej Palat,L,NJD,33,65,12,24,36
33,8478055,Gustav Forsling,D,FLA,28,70,9,27,36
33,8475170,Brayden Schenn,C,STL,33,70,8,28,36
33,8478469,Thomas Chabot,D,OTT,27,74,6,30,36
33,8479410,Mikhail Sergachev,D,UTA,26,69,4,32,36
33,8478472,Mathieu Joseph,R,STL,27,71,18,17,35
33,8476882,Teuvo Teravainen,C,CHI,30,71,16,19,35
33,8476872,Scott Laughton,C,PHI,30,67,14,21,35
33,8477505,Alexander Wennberg,C,SJS,30,64,14,21,35
33,8476458,Ryan Strome,C,ANA,31,66,10,25,35
33,8481703,Valtteri Puustinen,R,PIT,25,60,10,25,35
33,8477969,Marcus Pettersson,D,PIT,28,78,3,32,35
33,8481582,Nicholas Robertson,L,TOR,23,70,19,15,34
33,8479351,Sam Steel,C,DAL,26,79,14,20,34
33,8480144,David Kampf,C,TOR,29,73,11,23,34
33,8477425,Miles Wood,L,COL,29,76,10,24,34
33,8480145,Neal Pionk,D,WPG,29,70,10,24,34
33,8483505,Matthew Poitras,C,BOS,20,73,5,29,34
33,8476917,Adam Pelech,D,NYI,30,76,3,31,34
33,8477987,Ryan Donato,C,CHI,28,64,19,14,33
33,8476438,Brandon Saad,L,STL,32,72,15,18,33
33,8480813,Joe Veleno,C,DET,24,74,15,18,33
33,8477952,Robby Fabbri,C,ANA,28,64,14,19,33
33,8470621,Corey Perry,R,EDM,39,71,13,20,33
33,8480220,Noah Cates,L,PHI,25,66,12,21,33
33,8476792,Torey Krug,D,STL,33,72,7,26,33
33,8477953,Kasperi Kapanen,R,STL,28,66,18,14,32
33,8479353,Brett Howden,C,VGK,26,70,16,16,32
33,8478020,Michael Amadio,R,OTT,28,75,15,17,32
33,8481624,Ilya Mikheyev,R,CHI,30,60,15,17,32
33,8475760,Nick Bjugstad,C,UTA,32,75,13,19,32
33,8476480,Vladislav Namestnikov,C,WPG,32,63,13,19,32
33,8475149,Marcus Johansson,L,MIN,34,61,12,20,32
33,8479591,Michael Eyssimont,C,TBL,28,81,11,21,32
33,8478115,Pierre Engvall,L,NYI,28,74,10,22,32
33,8477839,Conor Sheary,L,TBL,32,80,10,22,32
33,8482101,Danil Gushchin,L,SJS,22,65,9,23,32
33,8482624,Daniil Miromanov,D,CGY,27,65,7,25,32
33,8475790,Erik Gudbranson,D,CBJ,32,77,4,28,32
33,8476374,Sean Kuraly,C,CBJ,31,58,16,15,31
33,8478366,Frank Vatrano,R,ANA,30,76,15,16,31
33,8482105,Jake Sanderson,D,OTT,22,66,9,22,31
33,8475220,Marcus Foligno,L,MIN,33,70,9,22,31
33,8481524,Bowen Byram,D,BUF,23,68,8,23,31
33,8482122,Brock Faber,D,MIN,22,77,5,26,31
33,8480078,Filip Chytil,C,NYR,25,65,19,11,30
33,8474189,Lars Eller,C,PIT,35,69,18,12,30
33,8475231,Casey Cizikas,C,NYI,33,75,15,15,30
33,8476474,Stefan Noesen,R,NJD,31,67,15,15,30
33,8480068,Ryan Poehling,C,PHI,25,65,13,17,30
33,8478057,Dakota Joshua,C,VAN,28,66,12,18,30
33,8480893,Kirill Marchenko,R,CBJ,24,61,20,9,29
33,8480835,Jack Drury,C,CAR,24,64,14,15,29
33,8476392,Adam Lowry,C,WPG,31,67,12,17,29
33,8482705,Cole Sillinger,C,CBJ,21,62,11,18,29
33,8477948,Travis Sanheim,D,PHI,28,72,11,18,29
33,8475722,Jason Zucker,L,BUF,32,64,10,19,29
33,8477989,Christian Dvorak,C,MTL,28,71,10,19,29
33,8474102,David Perron,L,OTT,36,76,9,20,29
33,8474151,Ryan McDonagh,D,TBL,35,80,7,22,29
33,8479983,Mario Ferraro,D,SJS,26,73,7,22,29
33,8476463,Jonas Brodin,D,MIN,31,76,3,26,29
33,8479661,Tanner Jeannot,L,LAK,27,74,16,12,28
33,8482259,Bobby McMann,C,TOR,28,63,14,14,28
33,8481553,Bobby Brink,R,PHI,23,64,14,14,28
33,8476419,Jean-Gabriel Pageau,C,NYI,32,75,12,16,28
33,8477947,Sonny Milano,L,WSH,28,66,12,16,28
33,8480849,Barrett Hayton,C,UTA,24,71,11,17,28
33,8481523,Kirby Dach,C,MTL,23,69,10,18,28
33,8478542,Evan Rodrigues,C,FLA,31,72,9,19,28
33,8476925,Colton Sissons,C,NSH,31,69,8,20,28
33,8474716,Jared Spurgeon,D,MIN,35,72,7,21,28
33,8482671,Owen Power,D,BUF,22,67,6,22,28
33,8482245,Artem Zub,D,OTT,29,73,5,23,28
33,8481059,Scott Perunovich,D,STL,26,61,3,25,28
33,8480459,Pius Suter,C,VAN,28,67,15,12,27
33,8473533,Jordan Staal,C,CAR,36,66,14,13,27
33,8481596,Shane Pinto,C,OTT,24,76,12,15,27
33,8475791,Taylor Hall,L,CHI,33,60,11,16,27
33,8482092,Ridly Greig,C,OTT,22,72,10,17,27
33,8475714,Calle Jarnkrok,C,TOR,33,70,10,17,27
33,8475171,Oliver Ekman-Larsson,D,TOR,33,67,10,17,27
33,8476921,Jordan Martinook,L,CAR,32,59,10,17,27
33,8476869,Brady Skjei,D,NSH,30,67,9,18,27
33,8481481,Blake Lizotte,C,PIT,27,64,8,19,27
33,8480817,K'Andre Miller,D,NYR,24,73,6,21,27
33,8476927,Teddy Blueger,C,VAN,30,67,6,21,27
33,8475200,Dmitry Orlov,D,CAR,33,71,4,23,27
33,8482055,Drew O'Connor,L,PIT,26,62,16,10,26
33,8478463,Anthony Beauvillier,L,PIT,27,68,16,10,26
33,8479293,Brandon Tanev,L,SEA,33,73,15,11,26
33,8476278,Colin Blackwell,C,DAL,31,79,14,12,26
33,8476469,Joel Armia,R,MTL,31,69,14,12,26
33,8481535,Nils Hoglander,L,VAN,24,61,13,13,26
33,8478508,Yakov Trenin,C,MIN,27,58,13,13,26
33,8477353,Tyler Motte,C,DET,29,72,13,13,26
33,8478109,Victor Olofsson,L,VGK,29,69,12,14,26
33,8482125,Alexander Holtz,R,VGK,22,70,12,14,26
33,8482062,Cole Smith,L,NSH,29,53,12,14,26
33,8481704,Juuso Parssinen,C,NSH,23,55,10,16,26
33,8480113,Alex Iafallo,L,WPG,31,65,9,17,26
33,8482133,Thomas Bordeleau,C,SJS,22,60,9,17,26
33,8478911,Matt Roy,D,WSH,29,65,8,18,26
33,8478500,Ivan Provorov,D,CBJ,27,80,3,23,26
33,8482655,Janis Moser,D,TBL,24,78,2,24,26
33,8479996,Cody Glass,C,NSH,25,70,15,10,25
33,8479066,Ryan Lomberg,L,CGY,30,62,14,11,25
33,8476960,Andreas Athanasiou,C,CHI,30,54,13,12,25
33,8482157,Will Cuylle,L,NYR,22,62,13,12,25
33,8479393,Noah Gregor,L,OTT,26,71,12,13,25
33,8482175,JJ Peterka,R,BUF,22,66,11,14,25
33,8483524,Shane Wright,C,SEA,20,61,11,14,25
33,8483468,Jiri Kulich,C,BUF,20,62,11,14,25
33,8483445,Cutter Gauthier,L,ANA,20,64,10,15,25
33,8476897,Oskar Sundqvist,C,STL,30,66,9,16,25
33,8473563,Nicklas Backstrom,C,WSH,37,55,8,17,25
33,8480878,Nils Lundkvist,D,DAL,24,73,8,17,25
33,8480802,Ryan McLeod,C,BUF,25,69,5,20,25
33,8478013,Jake Walman,D,SJS,28,71,5,20,25
33,8480172,Jan Rutta,D,SJS,34,65,5,20,25
33,8476988,Matt Benning,D,SJS,30,62,4,21,25
33,8478507,John Marino,D,UTA,27,62,3,22,25
33,8475181,Nick Leddy,D,STL,33,71,2,23,25
33,8482074,Connor Zary,C,CGY,23,61,12,12,24
33,8480748,Kiefer Sherwood,L,VAN,29,61,12,12,24
33,8478133,Jake Evans,C,MTL,28,64,7,17,24
33,8480871,Adam Boqvist,D,FLA,24,71,6,18,24
33,8478851,Alexandre Carrier,D,NSH,28,65,5,19,24
33,8480336,Sean Walker,D,CAR,30,79,5,19,24
33,8482803,Olen Zellweger,D,ANA,21,61,11,12,23
33,8480205,Emil Bemstrom,C,PIT,25,60,11,12,23
33,8479639,Dylan Coghlan,D,WPG,26,58,10,13,23
33,8479368,Max Jones,L,BOS,26,62,9,14,23
33,8478891,Mason Appleton,C,WPG,28,54,7,16,23
33,8475193,Tomas Tatar,L,NJD,34,69,7,16,23
33,8476979,Erik Gustafsson,D,DET,32,74,6,17,23
33,8479315,Joey Anderson,R,CHI,26,51,6,17,23
33,8478859,Niko Mikkola,D,FLA,28,61,4,19,23
33,8477435,Ryan Graves,D,PIT,29,75,2,21,23
33,8477478,William Carrier,L,CAR,30,51,13,9,22
33,8478569,Noel Acciari,C,PIT,33,52,12,10,22
33,8477446,Michael McCarron,R,NSH,29,53,12,10,22
33,8474715,Cameron Atkinson,R,TBL,35,80,11,11,22
33,8480789,Oliver Wahlstrom,R,NYI,24,63,11,11,22
33,8478413,Jordan Greenway,L,BUF,27,63,9,13,22
33,8482117,Lukas Reichel,L,CHI,22,53,9,13,22
33,8482679,Matt Coronato,R,CGY,22,68,8,14,22
33,8483493,Frank Nazar,C,CHI,20,59,8,14,22
33,8481606,Jordan Spence,D,LAK,23,63,7,15,22
33,8482809,Jackson Blake,R,CAR,21,60,7,15,22
33,8483457,Lane Hutson,D,MTL,20,66,7,15,22
33,8477220,Nate Schmidt,D,FLA,33,66,6,16,22
33,8481641,Joel Kiviranta,L,COL,28,72,6,16,22
33,8477488,Brett Pesce,D,NJD,30,65,5,17,22
33,8476885,Jacob Trouba,D,NYR,30,72,4,18,22
33,8480043,Timothy Liljegren,D,TOR,25,67,3,19,22
33,8473507,Jeff Petry,D,DET,37,77,2,20,22
33,8483565,Nick Blankenburg,D,NSH,26,64,2,20,22
33,8476891,Matthew Grzelcyk,D,PIT,30,73,2,20,22
33,8479982,Conor Timmins,D,TOR,26,59,2,20,22
33,8476981,Josh Anderson,R,MTL,30,69,18,3,21
33,8479520,Brandon Duhaime,R,WSH,27,58,14,7,21
33,8479390,Taylor Raddysh,R,WSH,26,61,10,11,21
33,8473422,Nick Foligno,L,CHI,37,59,10,11,21
33,8482111,Justin Barron,D,MTL,23,62,9,12,21
33,8475855,Jesper Fast,R,CAR,33,62,9,12,21
33,8481580,Connor McMichael,C,WSH,23,59,8,13,21
33,8482737,Zack Bolduc,C,STL,21,59,8,13,21
33,8477903,Garnet Hathaway,R,PHI,33,63,8,13,21
33,8482142,Jamie Drysdale,D,PHI,22,58,7,14,21
33,8477369,Carson Soucy,D,VAN,30,65,7,14,21
33,8477392,Hudson Fasching,R,NYI,29,72,5,16,21
33,8482067,Connor Mackey,D,NYR,28,62,4,17,21
33,8482192,Isaak Phillips,D,CHI,23,56,4,17,21
33,8476457,Adam Larsson,D,SEA,32,73,3,18,21
33,8476874,Olli Maatta,D,DET,30,63,3,18,21
33,8475462,Radko Gudas,D,ANA,34,65,2,19,21
33,8476878,Zemgus Girgensons,C,TBL,30,80,14,6,20
33,8479619,Michael Carcone,L,UTA,28,59,13,7,20
33,8482749,Joshua Roy,R,MTL,21,64,12,8,20
33,8477015,Connor Brown,R,EDM,30,62,12,8,20
33,8480003,Jesper Boqvist,C,FLA,26,66,12,8,20
33,8476329,Travis Boyd,C,MIN,31,60,8,12,20
33,8481656,Aliaksei Protas,C,WSH,23,66,7,13,20
33,8480448,Parker Kelly,L,COL,25,74,7,13,20
33,8476422,Mike Reilly,D,NYI,31,75,5,15,20
33,8481441,Joe Snively,C,DET,28,63,4,16,20
33,8481014,Alexander Romanov,D,NYI,24,74,3,17,20
33,8480289,Morgan Barron,C,WPG,26,56,11,8,19
33,8476918,Jimmy Vesey,L,NYR,31,65,10,9,19
33,8481032,Paul Cotter,C,NJD,25,60,10,9,19
33,8483482,Tristan Luneau,D,ANA,20,64,10,9,19
33,8475343,Nic Dowd,C,WSH,34,58,9,10,19
33,8479414,Nathan Bastian,R,NJD,27,57,9,10,19
33,8481093,Rafael Harvey-Pinard,L,MTL,25,55,8,11,19
33,8481601,Simon Holmstrom,R,NYI,23,71,8,11,19
33,8477919,Frederick Gaudreau,C,MIN,31,51,7,12,19
33,8481527,Kaedan Korczak,D,VGK,23,57,7,12,19
33,8481477,Nico Sturm,C,SJS,29,54,6,13,19
33,8479998,Mikey Anderson,D,LAK,25,65,6,13,19
33,8476879,Cody Ceci,D,EDM,31,70,5,14,19
33,8475233,David Savard,D,MTL,34,65,4,15,19
33,8481568,Alex Vlasic,D,CHI,23,53,4,15,19
33,8481019,David Gustafsson,C,WPG,24,49,4,15,19
33,8480073,Erik Brannstrom,D,COL,25,61,3,16,19
33,8480246,Nick Perbix,D,TBL,26,72,3,16,19
33,8480807,Mattias Samuelsson,D,BUF,24,56,3,16,19
33,8480049,Dylan Samberg,D,WPG,25,64,2,17,19
33,8476856,Mathew Dumba,D,DAL,30,72,2,17,19
33,8476331,Dylan DeMelo,D,WPG,31,77,2,17,19
33,8480873,Rasmus Sandin,D,WSH,24,61,1,18,19
33,8480806,Isac Lundestrom,C,ANA,25,55,11,7,18
33,8473453,Trevor Lewis,C,LAK,37,79,10,8,18
33,8482079,Marco Rossi,C,MIN,23,55,9,9,18
33,8480281,Alexey Toropchenko,R,STL,25,49,7,11,18
33,8480001,Urho Vaakanainen,D,ANA,25,57,5,13,18
33,8476931,Jake McCabe,D,TOR,31,59,4,14,18
33,8476467,Jamie Oleksiak,D,SEA,32,68,4,14,18
33,8474574,Tyler Myers,D,VAN,34,68,4,14,18
33,8477499,Rasmus Ristolainen,D,PHI,30,61,4,14,18
33,8480762,Eric Robinson,L,CAR,29,61,3,15,18
33,8475179,Dmitry Kulikov,D,FLA,34,59,2,16,18
33,8476892,Colton Parayko,D,STL,31,70,1,17,18
33,8479371,Dante Fabbro,D,NSH,26,67,1,17,18
33,8474013,Ian Cole,D,UTA,35,54,1,17,18
33,8476624,Barclay Goodrow,C,SJS,31,52,9,8,17
33,8478043,Sam Lafferty,C,BUF,29,56,8,9,17
33,8482155,Alex Laferriere,R,LAK,23,63,7,10,17
33,8479671,Mathieu Olivier,R,CBJ,27,54,7,10,17
33,8477406,Mattias Janmark,C,EDM,32,61,6,11,17
33,8474034,Patrick Maroon,L,CHI,36,47,6,11,17
33,8482148,Hendrix Lapierre,C,WSH,22,51,4,13,17
33,8477450,Jason Dickinson,C,CHI,29,44,4,13,17
33,8480860,Kevin Bahl,D,CGY,24,54,3,14,17
33,8478416,Erik Cernak,D,TBL,27,74,3,14,17
33,8479976,Juuso Valimaki,D,UTA,26,63,2,15,17
33,8479369,Andrew Peeke,D,BOS,26,62,2,15,17
33,8482087,Kaiden Guhle,D,MTL,22,73,1,16,17
33,8478840,Will Borgen,D,SEA,28,65,1,16,17
33,8477380,Jonny Brodzinski,C,NYR,31,51,10,6,16
33,8479941,Justin Danforth,R,CBJ,31,54,9,7,16
33,8478451,Ethan Bear,D,WSH,27,52,7,9,16
33,8479344,Jesse Puljujarvi,R,PIT,26,50,7,9,16
33,8478831,Kevin Stenlund,C,UTA,28,50,7,9,16
33,8479370,Tyson Jost,C,CAR,26,47,6,10,16
33,8482634,Alex Steeves,C,TOR,25,46,5,11,16
33,8470600,Ryan Suter,D,STL,39,59,4,12,16
33,8480035,Henri Jokiharju,D,BUF,25,61,4,12,16
33,8479398,Samuel Girard,D,COL,26,63,3,13,16
33,8478136,Jake Middleton,D,MIN,28,73,3,13,16
33,8480222,Sebastian Aho,D,PIT,28,66,3,13,16
33,8481521,Ronnie Attard,D,PHI,25,58,3,13,16
33,8480891,Michael Kesselring,D,UTA,24,53,3,13,16
33,8474673,TJ Brodie,D,CHI,34,62,1,15,16
33,8475842,Sam Carrick,C,NYR,32,54,10,5,15
33,8477979,Nicolas Aube-Kubel,R,BUF,28,62,9,6,15
33,8478421,A.J. Greer,L,FLA,28,59,9,6,15
33,8482666,Scott Morrow,D,CAR,22,48,8,7,15
33,8481517,Brett Leason,R,ANA,25,48,8,7,15
33,8481751,Lukas Rousek,R,BUF,25,35,7,8,15
33,8476312,Josh Manson,D,COL,33,64,6,9,15
33,8482176,Wyatt Kaiser,D,CHI,22,50,6,9,15
33,8476994,Vinnie Hinostroza,C,NSH,30,52,6,9,15
33,8476442,Matt Nieto,L,PIT,32,38,6,9,15
33,8479026,Philippe Myers,D,TOR,27,54,5,10,15
33,8480727,Zach Whitecloud,D,VGK,28,50,5,10,15
33,8482073,Braden Schneider,D,NYR,23,61,4,11,15
33,8480980,Connor Dewar,C,TOR,25,63,4,11,15
33,8479543,Michael Pezzetta,L,MTL,26,54,4,11,15
33,8478882,Vladislav Gavrikov,D,LAK,29,71,3,12,15
33,8476525,Colin Miller,D,WPG,32,62,3,12,15
33,8482762,Simon Edvinsson,D,DET,21,55,9,5,14
33,8479316,Luke Kunin,C,SJS,27,52,7,7,14
33,8477508,Curtis Lazar,C,NJD,29,60,7,7,14
33,8479336,Carl Grundstrom,R,SJS,27,46,7,7,14
33,8479328,Julien Gauthier,R,NYI,27,62,7,7,14
33,8477482,Zachary Sanford,L,CHI,30,40,7,7,14
33,8475225,Craig Smith,C,CHI,35,55,6,8,14
33,8476934,Brock McGinn,L,ANA,30,56,6,8,14
33,8482451,Mikael Pyyhtia,L,CBJ,23,46,5,9,14
33,8475690,Chris Tanev,D,TOR,35,57,5,9,14
33,8478452,Caleb Jones,D,LAK,27,56,4,10,14
33,8475279,Ben Chiarot,D,DET,33,68,4,10,14
33,8476902,Esa Lindell,D,DAL,30,66,3,11,14
33,8479324,Ryan Lindgren,D,NYR,26,56,3,11,14
33,8476429,Scott Mayfield,D,NYI,32,77,3,11,14
33,8479249,Andrew Poturalski,C,SJS,30,33,2,12,14
33,8478443,Brandon Carlo,D,BOS,28,58,1,13,14
33,8480074,Alexandre Texier,C,STL,25,54,7,6,13
33,8478434,Keegan Kolesar,R,VGK,27,68,7,6,13
33,8480011,Klim Kostin,C,SJS,25,45,6,7,13
33,8480796,Martin Fehervary,D,WSH,25,54,6,7,13
33,8480021,Jack Studnicka,C,LAK,25,62,6,7,13
33,8484911,Collin Graf,R,SJS,22,41,6,7,13
33,8478585,Derek Ryan,C,EDM,38,64,5,8,13
33,8483499,Liam Ohgren,L,MIN,20,59,4,9,13
33,8476873,Mark Jankowski,C,NSH,30,47,4,9,13
33,8477938,Haydn Fleury,D,WPG,28,39,4,9,13
33,8478178,Darren Raddysh,D,TBL,28,69,3,10,13
33,8481599,Victor Soderstrom,D,UTA,23,47,3,10,13
33,8481518,Nolan Foote,L,NJD,24,39,9,3,12
33,8482166,Shakir Mukhamadullin,D,SJS,22,53,9,3,12
33,8476822,Luke Glendening,C,TBL,35,77,7,5,12
33,8481537,Nikita Okhotiuk,D,CGY,24,54,7,5,12
33,8480355,Mark Kastelic,C,BOS,25,60,7,5,12
33,8471817,Ryan Reaves,R,TOR,37,56,7,5,12
33,8481592,Jakob Pelletier,L,CGY,23,42,6,6,12
33,8482659,Josh Doan,R,UTA,22,52,6,6,12
33,8483491,Ivan Miroshnichenko,L,WSH,20,62,5,7,12
33,8477931,Tomas Nosek,L,FLA,32,59,5,7,12
33,8483619,Filip Roos,D,OTT,25,34,5,7,12
33,8479442,Troy Stecher,D,EDM,30,49,4,8,12
33,8475718,Justin Holl,D,DET,32,56,4,8,12
33,8482730,Brandt Clarke,D,LAK,21,49,4,8,12
33,8475188,Brayden McNabb,D,VGK,33,57,3,9,12
33,8482807,Ethan Del Mastro,D,CHI,21,45,3,9,12
33,8475324,Nick Jensen,D,OTT,34,64,3,9,12
33,8481178,Egor Zamula,D,PHI,24,54,2,10,12
33,8484149,Gavin Brindley,C,CBJ,20,48,2,10,12
33,8480887,Jordan Harris,D,MTL,24,55,1,11,12
33,8475208,Brian Dumoulin,D,ANA,33,63,0,12,12
33,8478211,Dryden Hunt,L,CGY,29,52,9,2,11
33,8481028,Martin Pospisil,C,CGY,25,58,8,3,11
33,8480880,Jakub Lauko,C,MIN,24,37,8,3,11
33,8481716,Dmitri Voronkov,L,CBJ,24,41,7,4,11
33,8481617,Vasily Podkolzin,R,VAN,23,48,7,4,11
33,8479772,Zack MacEwen,R,OTT,28,48,7,4,11
33,8480441,Trey Fix-Wolansky,R,CBJ,25,36,6,5,11
33,8480845,Rasmus Kupari,C,WPG,24,39,5,6,11
33,8478409,Anthony Richard,C,PHI,28,38,5,6,11
33,8482652,Walker Duehr,R,CGY,27,40,5,6,11
33,8477070,Liam O'Brien,C,UTA,30,56,4,7,11
33,8479291,Kevin Rooney,C,CGY,31,51,4,7,11
33,8479944,Zach Aston-Reese,C,VGK,30,42,4,7,11
33,8478468,Jeremy Lauzon,D,NSH,27,56,4,7,11
33,8474090,Brendan Smith,D,DAL,35,54,3,8,11
33,8478399,Jonas Siegenthaler,D,NJD,27,61,3,8,11
33,8478970,Jalen Chatfield,D,CAR,28,64,2,9,11
33,8481522,Peyton Krebs,C,BUF,23,59,2,9,11
33,8481013,Jonatan Berggren,R,DET,24,60,2,9,11
33,8479980,Nicolas Hague,D,VGK,26,54,2,9,11
33,8475455,Brenden Dillon,D,NJD,34,66,2,9,11
33,8474567,Zach Bogosian,D,MIN,34,71,2,9,11
33,8476867,Brendan Gaunce,C,MIN,30,36,1,10,11
33,8482077,Dylan Holloway,L,EDM,23,51,7,3,10
33,8480007,Jonas Rondbjerg,R,VGK,25,40,6,4,10
33,8480025,MacKenzie Entwistle,R,FLA,25,60,4,6,10
33,8479439,Jacob MacDonald,D,COL,31,48,4,6,10
33,8481598,Philip Broberg,D,EDM,23,49,4,6,10
33,8478432,Christian Fischer,R,DET,27,72,3,7,10
33,8479372,Joshua Mahura,D,SEA,26,47,3,7,10
33,8479994,Jaret Anderson-Dolan,C,WPG,25,40,3,7,10
33,8483495,Simon Nemec,D,NJD,20,53,2,8,10
33,8474166,Alec Martinez,D,CHI,37,50,2,8,10
33,8471677,Jack Johnson,D,CBJ,37,59,2,8,10
33,8480950,Ilya Lyubushkin,D,DAL,30,69,2,8,10
33,8481708,Zac Jones,D,NYR,24,48,2,8,10
33,8479972,Mason Shaw,C,WPG,26,41,1,9,10
33,8471709,Marc-Edouard Vlasic,D,SJS,37,57,1,9,10
33,8482784,Zach Dean,C,STL,21,43,1,9,10
33,8476952,Dominic Toninato,C,WPG,30,37,1,9,10
33,8482744,James Malatesta,L,CBJ,21,36,1,9,10
33,8475177,Calvin de Haan,D,COL,33,45,0,10,10
33,8479536,Axel Jonsson-Fjallby,L,WPG,26,31,0,10,10
33,8480995,Pontus Holmberg,R,TOR,25,59,7,2,9
33,8481789,Tye Kartye,L,SEA,23,40,7,2,9
33,8480890,Jan Jenik,C,OTT,24,29,6,3,9
33,8476889,Radek Faksa,C,STL,30,59,5,4,9
33,8479968,Vinni Lettieri,C,BOS,29,42,5,4,9
33,8478017,Mark Friedman,D,VAN,29,41,5,4,9
33,8480848,Ty Dellandrea,C,SJS,24,39,5,4,9
33,8481567,Henry Thrun,D,SJS,23,49,4,5,9
33,8477365,Connor Clifton,D,BUF,29,50,4,5,9
33,8476473,Connor Murphy,D,CHI,31,40,4,5,9
33,8477851,Jordan Oesterle,D,BOS,32,43,4,5,9
33,8477573,Nathan Walker,L,STL,30,49,3,6,9
33,8479718,Alex Barré-Boulet,C,MTL,27,51,3,6,9
33,8482859,Zack Ostapchuk,C,OTT,21,59,3,6,9
33,8480834,Ty Emberson,D,SJS,24,37,2,7,9
33,8479379,Givani Smith,R,SJS,26,28,2,7,9
33,8481161,Jake Christiansen,D,CBJ,25,58,2,7,9
33,8476967,Brett Kulak,D,EDM,30,64,1,8,9
33,8477845,Trevor van Riemsdyk,D,WSH,33,55,1,8,9
33,8481167,Brayden Pachal,D,CGY,25,40,1,8,9
33,8476441,Joel Edmundson,D,LAK,31,41,1,8,9
33,8479402,Jake Bean,D,CGY,26,67,0,9,9
33,8484254,Akito Hirose,D,VAN,25,35,0,9,9
33,8483397,Marc McLaughlin,C,BOS,25,21,7,1,8
33,8481556,John Beecher,C,BOS,23,41,6,2,8
33,8481532,Alex Turcotte,C,LAK,23,40,5,3,8
33,8477962,Brendan Lemieux,L,CAR,28,38,4,4,8
33,8480245,Olle Lycksell,R,PHI,25,32,4,4,8
33,8479359,Beck Malenstyn,L,BUF,26,43,4,4,8
33,8481585,Egor Afanasyev,L,SJS,23,20,4,4,8
33,8480292,Carson Meyer,R,ANA,27,36,3,5,8
33,8482095,Tyler Kleven,D,OTT,22,42,3,5,8
33,8482747,Brennan Othmann,L,NYR,21,45,2,6,8
33,8477018,Ben Hutton,D,VGK,31,44,2,6,8
33,8479348,Kale Clague,D,BUF,26,44,2,6,8
33,8477335,Kyle Burroughs,D,LAK,29,45,2,6,8
33,8474612,Travis Hamonic,D,OTT,34,46,2,6,8
33,8482964,Arber Xhekaj,D,MTL,23,45,1,7,8
33,8483466,Kevin Korchinski,D,CHI,20,55,1,7,8
33,8478424,Jansen Harkins,C,ANA,27,37,1,7,8
33,8474568,Luke Schenn,D,NSH,35,47,1,7,8
33,8480058,Pierre-Olivier Joseph,D,STL,25,53,1,7,8
33,8481754,Nikita Nesterenko,C,ANA,23,32,7,0,7
33,8482496,Nils Aman,C,VAN,24,40,5,2,7
33,8479638,Justin Brazeau,R,BOS,26,36,5,2,7
33,8480070,Ian Mitchell,D,BOS,25,45,4,3,7
33,8479367,William Lockwood,R,FLA,26,23,4,3,7
33,8480267,Sammy Walker,C,MIN,25,26,4,3,7
33,8475762,Derek Forbort,D,VAN,32,44,3,4,7
33,8483549,Lucas Condotta,L,MTL,27,30,3,4,7
33,8483763,Maksymilian Szuber,D,UTA,22,35,3,4,7
33,8483512,Matthew Savoie,C,EDM,20,21,3,4,7
33,8477887,Patrick Brown,C,BOS,32,49,3,4,7
33,8482733,Logan Mailloux,D,MTL,31,36,3,4,7
33,8477034,Jaycob Megna,D,FLA,32,44,2,5,7
33,8481701,Santeri Hatakka,D,NJD,23,42,2,5,7
33,8480870,Bo Groulx,C,NYR,24,34,2,5,7
33,8482153,Brendan Brisson,C,VGK,23,36,2,5,7
33,8476913,Devin Shore,C,MIN,30,33,2,5,7
33,8479378,Logan Stanley,D,WPG,26,47,1,6,7
33,8477810,Joel Hanley,D,CGY,33,26,1,6,7
33,8482511,Mason Lohrei,D,BOS,23,40,1,6,7
33,8482751,Ryan Winterton,C,SEA,21,33,1,6,7
33,8479986,Kole Lind,R,DAL,26,51,0,7,7
33,8482177,Marat Khusnutdinov,C,MIN,22,30,0,7,7
33,8482165,Yan Kuznetsov,D,CGY,22,22,5,1,6
33,8480252,Cole Guttman,C,CHI,25,36,3,3,6
33,8481147,Reese Johnson,C,MIN,26,42,3,3,6
33,8481122,Simon Benoit,D,TOR,26,46,3,3,6
33,8479362,Riley Tufte,L,BOS,26,17,3,3,6
33,8480157,Calle Rosen,D,COL,30,40,2,4,6
33,8481550,Adam Beckman,L,NJD,23,41,2,4,6
33,8480196,Jacob Bryson,D,BUF,27,43,1,5,6
33,8473446,Erik Johnson,D,PHI,36,49,1,5,6
33,8480879,Jacob Bernard-Docker,D,OTT,24,51,1,5,6
33,8476858,Phillip Di Giuseppe,L,VAN,31,42,1,5,6
33,8482765,Isak Rosen,R,BUF,21,35,1,5,6
33,8476372,Nick Seeler,D,PHI,31,43,1,5,6
33,8478502,Dennis Gilbert,D,BUF,28,19,1,5,6
33,8481237,Kyle MacLean,C,NYI,25,25,5,0,5
33,8481605,Jackson LaCombe,D,ANA,23,29,4,1,5
33,8475235,Nicolas Deslauriers,L,PHI,33,49,4,1,5
33,8482070,Mitchell Chaffee,R,TBL,26,51,3,2,5
33,8477401,John Hayden,C,SEA,29,23,3,2,5
33,8482102,Vasily Ponomarev,C,PIT,22,25,3,2,5
33,8482145,Mavrik Bourque,C,DAL,22,45,3,2,5
33,8481600,Tobias Bjornfot,D,FLA,23,38,2,3,5
33,8482144,Jack Thompson,D,SJS,22,25,2,3,5
33,8478011,Louie Belpedio,D,PHI,28,14,2,3,5
33,8481679,Maxence Guenette,D,OTT,23,41,2,3,5
33,8480844,Grigori Denisenko,L,VGK,24,26,2,3,5
33,8479985,Cale Fleury,D,SEA,26,29,2,3,5
33,8481743,Marc Del Gaizo,D,NSH,25,16,2,3,5
33,8482861,Vincent Iorio,D,WSH,22,36,1,4,5
33,8483012,Logan Morrison,C,SEA,22,31,1,4,5
33,8477971,Andreas Englund,D,LAK,28,27,0,5,5
33,8481543,Nikita Alexandrov,C,STL,24,27,4,0,4
33,8483570,Ben Meyers,C,SEA,26,29,4,0,4
33,8478051,Max Willman,C,NJD,29,21,3,1,4
33,8482147,Jean-Luc Foudy,C,COL,22,26,3,1,4
33,8483630,Pavol Regenda,L,ANA,25,29,2,2,4
33,8481609,Vladislav Kolyachonok,D,UTA,23,38,2,2,4
33,8477462,Robert Hagg,D,VGK,29,22,2,2,4
33,8484258,Sam Malinski,D,COL,26,29,2,2,4
33,8480192,Johnathan Kovacevic,D,NJD,27,48,1,3,4
33,8475958,Michael Sgarbossa,C,WSH,32,22,1,3,4
33,8480990,Declan Chisholm,D,MIN,24,35,1,3,4
33,8478146,Matthew Highmore,C,OTT,28,38,1,3,4
33,8479320,Maxime Lajoie,D,SEA,27,22,1,3,4
33,8482162,Roby Jarventie,L,EDM,22,18,0,4,4
33,8477467,Gustav Olofsson,D,SEA,30,19,3,0,3
33,8484325,Waltteri Merela,C,TBL,26,18,3,0,3
33,8482470,Ilya Solovyov,D,CGY,24,18,2,1,3
33,8481422,Jake Lucchini,C,NSH,29,19,2,1,3
33,8479991,Jake Leschyshyn,C,NYR,25,24,2,1,3
33,8480468,James Hamblin,L,EDM,25,20,2,1,3
33,8482118,Sam Colangelo,R,ANA,23,19,2,1,3
33,8481043,Cole Koepke,L,BOS,26,23,2,1,3
33,8483460,David Jiricek,D,CBJ,21,56,1,2,3
33,8478021,William Lagesson,D,DET,28,20,1,2,3
33,8475750,Jon Merrill,D,MIN,32,58,1,2,3
33,8479981,Jonah Gadjovich,L,FLA,26,52,1,2,3
33,8478454,Noah Juulsen,D,VAN,27,29,1,2,3
33,8478450,Parker Wotherspoon,D,BOS,27,27,1,2,3
33,8482094,Daemon Hunt,D,MIN,22,19,1,2,3
33,8477073,Kurtis MacDermid,L,NJD,30,32,1,2,3
33,8477384,Joshua Brown,D,EDM,30,36,1,2,3
33,8481056,Spencer Stastney,D,NSH,24,33,1,2,3
33,8477527,Ross Johnston,L,ANA,30,34,1,2,3
33,8482929,Emil Lilleberg,D,TBL,23,20,1,2,3
33,8477320,Anton Blidh,L,NYR,29,25,0,3,3
33,8478881,Brett Seney,L,CHI,28,14,2,0,2
33,8484255,Jason Polin,R,COL,25,6,2,0,2
33,8482787,Nikita Chibrikov,R,WPG,31,8,2,0,2
33,8475780,Chris Wagner,R,COL,33,8,2,0,2
33,8481030,Jack St. Ivany,D,PIT,25,19,2,0,2
33,8477473,Justin Bailey,R,SJS,29,29,1,1,2
33,8481006,Tyler Tucker,D,STL,24,11,1,1,2
33,8482172,Landon Slaggert,L,CHI,22,26,1,1,2
33,8483597,Milos Kelemen,L,UTA,25,9,1,1,2
33,8474062,Riley Nash,C,NYR,35,21,1,1,2
33,8481462,Mason Morelli,L,VGK,28,14,1,1,2
33,8483398,Declan Carlile,D,TBL,31,6,1,1,2
33,8478874,Adam Gaudette,R,OTT,28,33,0,2,2
33,8482516,Matthew Kessel,D,STL,24,21,0,2,2
33,8482250,Callahan Burke,C,VGK,27,17,0,2,2
33,8477244,Chad Ruhwedel,D,NYR,34,36,0,2,2
33,8481206,John Ludvig,D,PIT,24,16,0,2,2
33,8482858,Ryker Evans,D,SEA,23,18,0,2,2
33,8480084,Nick DeSimone,D,NJD,30,14,0,2,2
33,8479419,Brett Murray,L,BUF,26,19,0,2,2
33,8480823,Alexander Alexeyev,D,WSH,25,13,0,2,2
33,8477541,Dakota Mermis,D,TOR,30,6,0,2,2
33,8480851,Akil Thomas,C,LAK,24,20,1,0,1
33,8482713,Mackie Samoskevich,R,FLA,22,33,1,0,1
33,8482061,Brandon Biro,L,SEA,26,10,1,0,1
33,8480032,Shane Bowers,C,NJD,25,21,1,0,1
33,8481699,Aku Raty,R,UTA,23,14,1,0,1
33,8478477,Mitchell Stephens,C,SEA,27,22,1,0,1
33,8484287,Cole McWard,D,VAN,23,25,1,0,1
33,8478446,Glenn Gawdin,C,LAK,27,12,1,0,1
33,8481719,Maxwell Crozier,D,TBL,24,14,1,0,1
33,8482197,Adam Raska,R,MIN,23,5,1,0,1
33,8481541,Samuel Bolduc,D,NYI,24,25,0,1,1
33,8482141,Lukas Cormier,D,VGK,22,26,0,1,1
33,8475795,Dylan McIlrath,D,WSH,32,17,0,1,1
33,8477149,Scott Sabourin,R,SJS,32,12,0,1,1
33,8480075,Cameron Crotty,D,MIN,25,11,0,1,1
33,8482201,Gage Goncalves,C,TBL,23,26,0,1,1
33,8480874,Adam Ginning,D,PHI,24,12,0,1,1
33,8479576,Vincent Desharnais,D,VAN,28,36,0,1,1
33,8483489,Fraser Minten,C,TOR,31,8,0,1,1
33,8477993,Justin Kirkland,C,CGY,28,5,0,1,1
33,8483407,Brandon Scanlin,D,NYR,25,11,0,1,1
33,8481564,Ryan Johnson,D,BUF,23,12,0,1,1
33,8475413,Justin Dowling,C,NJD,34,14,0,1,1
33,8482476,Emil Heineman,L,MTL,23,10,0,1,1
33,8481593,Jayden Struble,D,MTL,23,12,0,1,1
33,8483567,Georgii Merkulov,C,BOS,24,12,0,1,1
33,8483395,Arshdeep Bains,L,VAN,23,11,0,1,1
33,8483471,Brad Lambert,C,WPG,31,5,0,1,1
33,8479587,Rhett Gardner,C,PHI,28,20,0,1,1
33,8484304,Uvis Balinskis,D,FLA,28,9,0,1,1
33,8479330,Brandon Gignac,C,MTL,27,10,0,1,1
33,8480306,Grant Hutton,D,NYI,29,6,0,1,1
33,8483546,Marshall Rifai,D,TOR,26,5,0,1,1
33,8481065,Angus Crookshank,L,OTT,25,18,0,0,0
33,8475755,Alexander Petrovic,D,DAL,32,4,0,0,0
33,8483432,Luca Del Bel Belluz,C,CBJ,31,3,0,0,0
33,8482088,Justin Sourdif,R,FLA,22,19,0,0,0
33,8481534,Raphael Lavoie,C,EDM,24,3,0,0,0
33,8481806,Louis Crevier,D,CHI,23,11,0,0,0
33,8483531,Brian Halonen,L,NJD,25,1,0,0,0
33,8480274,Philip Kemp,D,EDM,25,1,0,0,0
33,8481024,Linus Karlsson,C,VAN,25,8,0,0,0
33,8482126,Emil Andrae,D,PHI,31,1,0,0,0
33,8481655,Cole Schwindt,R,CGY,23,2,0,0,0
33,8483609,Adam Klapka,R,CGY,24,4,0,0,0
33,8482460,Matt Rempe,C,NYR,22,13,0,0,0
33,8481578,Graeme Clarke,R,MIN,23,10,0,0,0
33,8476323,Max McCormick,L,SEA,32,2,0,0,0
33,8484326,Patrik Koch,D,UTA,28,2,0,0,0
33,8478854,Ryan Shea,D,PIT,27,9,0,0,0
33,8479421,Jacob Moverare,D,LAK,26,4,0,0,0
33,8481726,Adam Edstrom,C,NYR,24,6,0,0,0
33,8479522,Hardy Haman Aktell,D,WSH,26,2,0,0,0
33,8478147,Bokondji Imama,L,PIT,28,3,0,0,0
33,8483920,Pierrick Dube,R,WSH,23,5,0,0,0
33,8483401,Marc Johnstone,R,PIT,28,0,0,0,0
33,8484259,Ondrej Pavel,C,COL,31,3,0,0,0
33,8484321,Nikolas Matinpalo,D,OTT,26,1,0,0,0
33,8470794,Joe Pavelski,C,,40,0,0,0,0
33,8479321,Lucas Johansen,D,,27,0,0,0,0
33,8477950,Tony DeAngelo,D,,29,0,0,0,0
33,8471218,Blake Wheeler,R,,38,0,0,0,0
33,8475197,Tyson Barrie,D,,33,0,0,0,0
33,8474157,Max Pacioretty,L,,36,0,0,0,0
33,8475744,Evgeny Kuznetsov,C,,32,0,0,0,0
33,8474037,James van Riemsdyk,L,,35,0,0,0,0
33,8476907,Mackenzie MacEachern,L,,30,0,0,0,0
33,8480216,Jacob Peterson,C,,25,0,0,0,0
33,8474602,Justin Schultz,D,,34,0,0,0,0
33,8482222,Alexander Barabanov,L,,30,0,0,0,0
33,8474031,Kevin Shattenkirk,D,,35,0,0,0,0
33,8477330,Dominik Kubalik,L,,29,0,0,0,0
33,8480884,Calen Addison,D,,24,0,0,0,0
33,8475906,John Klingberg,D,,32,0,0,0,0
33,8480008,Adam Ruzicka,C,,25,0,0,0,0
33,8476884,Derrick Pouliot,D,,30,0,0,0,0
33,8476919,Chris Tierney,C,,30,0,0,0,0
33,8479415,Michael McLeod,C,,26,0,0,0,0
33,8474870,Tyler Johnson,C,,34,0,0,0,0
33,8470604,Jeff Carter,C,,39,0,0,0,0
33,8478104,Sammy Blais,L,,28,0,0,0,0
33,8474884,Mike Hoffman,C,,35,0,0,0,0
33,8481591,Sam Poulin,R,,23,0,0,0,0
33,8471274,Alex Goligoski,D,,39,0,0,0,0
33,8476871,Tanner Pearson,L,,32,0,0,0,0
33,8476393,Nick Cousins,C,,31,0,0,0,0
33,8479977,Kailer Yamamoto,R,,26,0,0,0,0
33,8479346,Dillon Dube,C,,26,0,0,0,0
33,8480184,Gustav Lindstrom,D,,26,0,0,0,0
33,8479376,Victor Mete,D,,26,0,0,0,0
33,8473449,Kyle Okposo,R,,36,0,0,0,0
33,8481058,Jesse Ylonen,R,,25,0,0,0,0
33,8475752,Tyler Pitlick,C,,33,0,0,0,0
33,8481239,Samuel Fagemo,L,,24,0,0,0,0
33,8480821,Filip Zadina,R,,25,0,0,0,0
33,8470966,Mark Giordano,D,,41,0,0,0,0
33,8478495,Denis Gurianov,R,,27,0,0,0,0
33,8477464,Nic Petan,C,,29,0,0,0,0
33,8478099,Kevin Labanc,R,,29,0,0,0,0
33,8482241,Radim Zohorna,L,,28,0,0,0,0
33,8474040,Sam Gagner,C,,35,0,0,0,0
33,8479514,Rem Pitlick,C,,27,0,0,0,0
33,8478430,Oliver Kylington,D,,27,0,0,0,0
33,8479533,Joona Koppanen,L,,26,0,0,0,0
33,8479984,Cal Foote,D,,26,0,0,0,0
33,8477126,Jayson Megna,C,,34,0,0,0,0
33,8475164,Jakob Silfverberg,R,,34,0,0,0,0
33,8474009,Nick Bonino,C,,36,0,0,0,0
33,8479458,Nikita Zaitsev,D,,33,0,0,0,0
33,8477944,Jakub Vrana,L,,28,0,0,0,0
33,8471699,Andrew Cogliano,C,,37,0,0,0,0
33,8478067,Oskar Lindblom,L,,28,0,0,0,0
33,8471686,Marc Staal,D,,37,0,0,0,0
33,8470610,Zach Parise,L,,40,0,0,0,0
33,8478904,Steven Lorentz,C,,28,0,0,0,0
33,8473473,Milan Lucic,L,,36,0,0,0,0
33,8480031,Maxime Comtois,L,,25,0,0,0,0
33,8478512,Austin Czarnik,C,,32,0,0,0,0
33,8473504,Cal Clutterbuck,R,,37,0,0,0,0
33,8477454,Adam Erne,L,,29,0,0,0,0
33,8479383,Boris Katchouk,L,,26,0,0,0,0
33,8475825,Jani Hakanpää,D,,32,0,0,0,0
33,8477846,Ryan Carpenter,C,,33,0,0,0,0
33,8477930,Pierre-Edouard Bellemare,L,,39,0,0,0,0
33,8478400,Colin White,C,,27,0,0,0,0
33,8480226,Marián Studenic,R,,26,0,0,0,0
33,8480853,Liam Foudy,C,,24,0,0,0,0
33,8475797,Jarred Tinordi,D,,32,0,0,0,0
33,8479423,Alex Nylander,L,,26,0,0,0,0
33,8474618,Marco Scandella,D,,34,0,0,0,0
33,8478028,Fredrik Olofsson,L,,28,0,0,0,0
33,8474709,Matt Martin,L,,35,0,0,0,0
33,8481070,Hugh McGing,L,,26,0,0,0,0
33,8479546,Oskar Steen,C,,26,0,0,0,0
33,8474145,Robert Bortuzzo,D,,35,0,0,0,0
33,8476915,Jujhar Khaira,L,,30,0,0,0,0
33,8475278,Byron Froese,C,,33,0,0,0,0
33,8481812,Nikolai Knyzhov,D,,27,0,0,0,0
33,8478408,Travis Dermott,D,,28,0,0,0,0
33,8481077,John Leonard,L,,26,0,0,0,0
33,8479547,Matthew Phillips,R,,26,0,0,0,0
33,8480836,Jonathan Gruden,C,,24,0,0,0,0
33,8481690,Tyler Angle,C,,24,0,0,0,0
33,8475766,Austin Watson,L,,32,0,0,0,0
33,8481016,Ruslan Iskhakov,C,,24,0,0,0,0
33,8478078,Rourke Chartier,C,,28,0,0,0,0
33,8480776,Sheldon Rempal,R,,29,0,0,0,0
33,8478956,Samuel Laberge,L,NJD,27,1,0,0,0
33,8483045,Cameron Butler,R,CBJ,31,2,0,0,0
33,8484314,Jiri Smejkal,L,,28,0,0,0,0
34,8476453,Nikita Kucherov,R,TBL,31,82,48,104,152
34,8478402,Connor McDavid,C,EDM,27,78,34,93,127
34,8479314,Matthew Tkachuk,L,FLA,27,79,35,91,126
34,8478483,Mitch Marner,R,TOR,27,80,30,91,121
34,8477492,Nathan MacKinnon,C,COL,29,82,50,70,120
34,8477934,Leon Draisaitl,C,EDM,29,80,52,67,119
34,8481559,Jack Hughes,C,NJD,23,74,43,72,115
34,8479318,Auston Matthews,C,TOR,27,81,60,54,114
34,8480027,Jason Robertson,L,DAL,25,82,41,71,112
34,8477942,Kevin Fiala,L,LAK,28,80,33,77,110
34,8476468,J.T. Miller,C,VAN,31,75,33,77,110
34,8477404,Jake Guentzel,C,TBL,30,82,49,60,109
34,8478550,Artemi Panarin,L,NYR,33,75,36,73,109
34,8482116,Tim Stützle,C,OTT,22,78,43,62,105
34,8479343,Clayton Keller,R,UTA,26,77,45,58,103
34,8478420,Mikko Rantanen,R,COL,28,80,41,54,95
34,8477946,Dylan Larkin,C,DET,28,80,39,56,95
34,8477956,David Pastrnak,R,BOS,28,80,38,57,95
34,8477939,William Nylander,R,TOR,28,78,42,49,91
34,8475172,Nazem Kadri,C,CGY,34,78,34,57,91
34,8476389,Vincent Trocheck,C,NYR,31,79,31,59,90
34,8474564,Steven Stamkos,C,NSH,34,77,35,54,89
34,8478864,Kirill Kaprizov,L,MIN,27,70,46,42,88
34,8471675,Sidney Crosby,C,PIT,37,75,33,54,87
34,8478445,Mathew Barzal,C,NYI,27,77,21,65,86
34,8478398,Kyle Connor,L,WPG,28,74,38,47,85
34,8480801,Brady Tkachuk,L,OTT,25,78,36,49,85
34,8478427,Sebastian Aho,C,CAR,27,67,36,49,85
34,8477409,Carter Verhaeghe,C,FLA,29,79,35,50,85
34,8475913,Mark Stone,R,VGK,32,78,32,53,85
34,8480012,Elias Pettersson,C,VAN,26,73,33,49,82
34,8476887,Filip Forsberg,L,NSH,30,74,44,37,81
34,8477500,Bo Horvat,C,NYI,29,80,43,38,81
34,8478403,Jack Eichel,C,VGK,28,78,33,48,81
34,8476456,Jonathan Huberdeau,C,CGY,31,79,19,62,81
34,8475184,Chris Kreider,L,NYR,33,78,47,33,80
34,8474600,Roman Josi,D,NSH,34,73,18,61,79
34,8480036,Miro Heiskanen,D,DAL,25,74,17,62,79
34,8477493,Aleksander Barkov,C,FLA,29,78,24,54,78
34,8479323,Adam Fox,D,NYR,26,75,14,64,78
34,8477951,Nick Schmaltz,C,UTA,28,79,37,40,77
34,8479407,Jesper Bratt,L,NJD,26,77,30,47,77
34,8471685,Anze Kopitar,C,LAK,37,82,25,52,77
34,8476539,Jonathan Marchessault,R,NSH,34,76,40,36,76
34,8474141,Patrick Kane,R,DET,36,81,37,39,76
34,8476459,Mika Zibanejad,C,NYR,31,79,34,42,76
34,8476346,Johnny Gaudreau,L,CBJ,31,76,20,56,76
34,8477933,Sam Reinhart,C,FLA,29,77,30,45,75
34,8481557,Matt Boldy,L,MIN,23,72,28,47,75
34,8480800,Quinn Hughes,D,VAN,25,76,11,64,75
34,8478449,Roope Hintz,C,DAL,28,81,34,40,74
34,8479542,Brandon Hagel,L,TBL,26,82,31,43,74
34,8480069,Cale Makar,D,COL,26,73,14,60,74
34,8478439,Travis Konecny,R,PHI,27,70,30,43,73
34,8480002,Nico Hischier,C,NJD,25,73,22,51,73
34,8476454,Ryan Nugent-Hopkins,C,EDM,31,76,22,50,72
34,8484144,Connor Bedard,C,CHI,19,67,33,38,71
34,8476448,William Karlsson,C,VGK,31,76,30,41,71
34,8475166,John Tavares,C,TOR,34,77,22,49,71
34,8474679,Gustav Nyquist,C,NSH,35,75,22,49,71
34,8480803,Evan Bouchard,D,EDM,25,81,17,54,71
34,8480865,Noah Dobson,D,NYI,24,82,9,62,71
34,8482740,Wyatt Johnston,C,DAL,21,82,40,30,70
34,8477501,Valeri Nichushkin,R,COL,29,81,37,33,70
34,8480830,Andrei Svechnikov,R,CAR,24,68,33,37,70
34,8478010,Brayden Point,C,TBL,28,82,32,38,70
34,8474578,Erik Karlsson,D,PIT,34,80,15,54,69
34,8475167,Victor Hedman,D,TBL,34,77,6,63,69
34,8479385,Jordan Kyrou,C,STL,26,78,36,32,68
34,8478873,Troy Terry,R,ANA,27,76,31,37,68
34,8482078,Lucas Raymond,L,DET,22,82,27,41,68
34,8476881,Tomas Hertl,C,VGK,31,76,26,42,68
34,8473512,Claude Giroux,R,OTT,36,82,18,50,68
34,8477504,Josh Morrissey,D,WPG,29,76,13,54,67
34,8478414,Timo Meier,R,NJD,28,73,32,34,66
34,8477964,Ivan Barbashev,C,VGK,29,75,32,34,66
34,8475168,Matt Duchene,C,DAL,33,81,29,37,66
34,8475754,Brock Nelson,C,NYI,33,78,29,37,66
34,8473994,Jamie Benn,L,DAL,35,82,25,41,66
34,8477021,Alex Kerfoot,C,UTA,30,75,24,42,66
34,8477416,Oliver Bjorkstrand,R,SEA,29,70,22,44,66
34,8475786,Zach Hyman,L,EDM,32,78,36,29,65
34,8477960,Adrian Kempe,R,LAK,28,80,32,33,65
34,8473419,Brad Marchand,L,BOS,36,80,26,39,65
34,8474102,David Perron,L,OTT,36,76,26,39,65
34,8476853,Morgan Rielly,D,TOR,30,71,15,50,65
34,8482699,Dylan Guenther,R,UTA,21,75,35,29,64
34,8475794,Tyler Seguin,C,DAL,32,82,35,29,64
34,8476460,Mark Scheifele,C,WPG,31,72,23,41,64
34,8476905,Chandler Stephenson,C,SEA,30,73,23,41,64
34,8475158,Ryan O'Reilly,C,NSH,33,74,21,43,64
34,8475692,Mats Zuccarello,R,MIN,37,71,19,45,64
34,8480023,Robert Thomas,C,STL,25,74,16,48,64
34,8481540,Cole Caufield,R,MTL,23,78,25,38,63
34,8475745,Charlie Coyle,C,BOS,32,79,18,45,63
34,8478460,Zach Werenski,D,CBJ,27,81,15,48,63
34,8475784,Jeff Skinner,C,EDM,32,75,28,34,62
34,8479420,Tage Thompson,C,BUF,27,65,27,35,62
34,8475810,Bryan Rust,R,PIT,32,73,26,36,62
34,8477402,Pavel Buchnevich,L,STL,29,69,19,43,62
34,8476462,Dougie Hamilton,D,NJD,31,71,19,43,62
34,8476399,Blake Coleman,C,CGY,33,76,30,31,61
34,8477949,Alex Tuch,R,BUF,28,71,21,40,61
34,8476875,Mike Matheson,D,MTL,30,76,16,45,61
34,8478407,Vince Dunn,D,SEA,28,72,15,46,61
34,8471214,Alex Ovechkin,L,WSH,39,73,36,24,60
34,8478444,Brock Boeser,R,VAN,27,75,35,25,60
34,8477496,Elias Lindholm,C,BOS,30,78,28,32,60
34,8478462,Nicolas Roy,C,VGK,27,76,24,36,60
34,8482159,Tyson Foerster,R,PHI,22,76,36,23,59
34,8476432,Boone Jenner,C,CBJ,31,66,27,32,59
34,8477940,Nikolaj Ehlers,L,WPG,28,69,21,38,59
34,8477935,Sam Bennett,C,FLA,28,76,29,29,58
34,8477511,Anthony Mantha,R,CGY,30,76,23,35,58
34,8480208,Drake Batherson,R,OTT,26,76,22,36,58
34,8476882,Teuvo Teravainen,C,CHI,30,74,18,40,58
34,8481068,Yegor Sharangovich,C,CGY,26,75,33,24,57
34,8480039,Martin Necas,C,CAR,25,70,21,36,57
34,8476479,Phillip Danault,C,LAK,31,79,21,36,57
34,8477346,MacKenzie Weegar,D,CGY,30,69,13,44,57
34,8484166,Adam Fantilli,C,CBJ,20,67,34,21,55
34,8478493,Joel Eriksson Ek,C,MIN,27,70,25,30,55
34,8479337,Alex DeBrincat,R,DET,27,80,24,31,55
34,8483515,Juraj Slafkovsky,L,MTL,20,72,24,31,55
34,8477456,J.T. Compher,L,DET,29,79,20,35,55
34,8477986,Brandon Montour,D,SEA,30,70,15,40,55
34,8474590,John Carlson,D,WSH,34,71,12,43,55
34,8471724,Kris Letang,D,PIT,37,80,10,45,55
34,8480015,Owen Tippett,R,PHI,25,79,23,31,54
34,8483431,Logan Cooley,C,UTA,20,72,22,32,54
34,8482113,Anton Lundell,C,FLA,23,80,19,35,54
34,8480839,Rasmus Dahlin,D,BUF,24,75,18,36,54
34,8479999,Casey Mittelstadt,C,COL,26,79,13,41,54
34,8473986,Alex Killorn,L,ANA,35,73,30,23,53
34,8477955,Jared McCann,L,SEA,28,75,27,26,53
34,8474586,Jordan Eberle,R,SEA,34,73,25,28,53
34,8475314,Anders Lee,L,NYI,34,80,25,28,53
34,8478440,Dylan Strome,C,WSH,27,66,23,30,53
34,8480188,Fabian Zetterlund,L,SJS,25,67,22,31,53
34,8475765,Vladimir Tarasenko,R,DET,33,82,20,33,53
34,8482124,Quinton Byfield,R,LAK,22,77,20,33,53
34,8479675,Trevor Moore,L,LAK,29,80,18,35,53
34,8477447,Shea Theodore,D,VGK,29,63,12,41,53
34,8482684,Luke Hughes,D,NJD,21,76,10,43,53
34,8475798,Mikael Granlund,C,SJS,32,65,9,44,53
34,8475151,Kyle Palmieri,C,NYI,33,79,31,21,52
34,8475726,Tyler Toffoli,C,SJS,32,66,22,30,52
34,8477503,Max Domi,C,TOR,29,74,21,31,52
34,8478401,Pavel Zacha,C,BOS,27,77,20,32,52
34,8482745,Mason McTavish,C,ANA,21,75,15,37,52
34,8479325,Charlie McAvoy,D,BOS,27,71,12,40,52
34,8475169,Evander Kane,L,EDM,33,70,27,24,51
34,8481596,Shane Pinto,C,OTT,24,79,23,28,51
34,8471215,Evgeni Malkin,C,PIT,38,67,21,30,51
34,8478042,Viktor Arvidsson,L,EDM,31,75,20,31,51
34,8479987,Morgan Geekie,C,BOS,26,75,19,32,51
34,8478397,Rasmus Andersson,D,CGY,28,75,13,38,51
34,8481711,Matias Maccelli,L,UTA,24,74,9,42,51
34,8477407,Anthony Duclair,L,NYI,29,79,30,20,50
34,8476458,Ryan Strome,C,ANA,31,69,21,29,50
34,8481604,Pavel Dorofeyev,L,VGK,24,72,17,33,50
34,8480797,Joel Farabee,L,PHI,24,71,16,34,50
34,8480028,Morgan Frost,C,PHI,25,71,16,34,50
34,8474150,Mikael Backlund,C,CGY,35,77,25,24,49
34,8478975,Mason Marchment,L,DAL,29,81,23,26,49
34,8477479,Tyler Bertuzzi,L,CHI,29,64,21,28,49
34,8477476,Artturi Lehkonen,L,COL,29,77,20,29,49
34,8484153,Leo Carlsson,C,ANA,20,68,16,33,49
34,8476826,Yanni Gourde,C,SEA,33,71,16,33,49
34,8476292,Ondrej Palat,L,NJD,33,72,15,34,49
34,8479410,Mikhail Sergachev,D,UTA,26,64,13,36,49
34,8475799,Nino Niederreiter,R,WPG,32,67,29,19,48
34,8480064,Josh Norris,C,OTT,25,76,29,19,48
34,8478366,Frank Vatrano,R,ANA,30,75,27,21,48
34,8481560,Arthur Kaliyev,R,LAK,23,79,23,25,48
34,8477451,Ryan Hartman,R,MIN,30,71,18,30,48
34,8483808,Andrei Kuzmenko,L,CGY,28,75,17,31,48
34,8482665,Matty Beniers,C,SEA,22,72,16,32,48
34,8478469,Thomas Chabot,D,OTT,27,72,11,37,48
34,8481542,Moritz Seider,D,DET,23,77,8,40,48
34,8478057,Dakota Joshua,C,VAN,28,69,25,22,47
34,8482109,Alexis Lafrenière,L,NYR,23,71,22,25,47
34,8477426,Nicholas Paul,L,TBL,29,82,21,26,47
34,8475191,Reilly Smith,R,NYR,33,74,18,29,47
34,8480014,Gabriel Vilardi,C,WPG,25,66,30,16,46
34,8471698,T.J. Oshie,R,WSH,38,68,25,21,46
34,8478474,Lawson Crouse,L,UTA,27,76,23,23,46
34,8478466,Daniel Sprong,R,VAN,27,72,23,23,46
34,8482093,Seth Jarvis,C,CAR,22,66,19,27,46
34,8478856,Conor Garland,R,VAN,28,72,19,27,46
34,8478115,Pierre Engvall,L,NYI,28,79,17,29,46
34,8479339,Patrik Laine,L,CBJ,26,68,12,34,46
34,8477998,Warren Foegele,L,LAK,28,80,25,20,45
34,8480018,Nick Suzuki,C,MTL,25,74,16,29,45
34,8474149,Evgenii Dadonov,R,DAL,35,80,14,31,45
34,8477505,Alexander Wennberg,C,SJS,30,67,14,31,45
34,8477495,Seth Jones,D,CHI,30,66,13,32,45
34,8476958,Jaccob Slavin,D,CAR,30,76,7,38,45
34,8477948,Travis Sanheim,D,PHI,28,71,4,41,45
34,8480009,Eeli Tolvanen,R,SEA,25,70,26,18,44
34,8475760,Nick Bjugstad,C,UTA,32,73,21,23,44
34,8475793,Ryan Johansen,C,PHI,32,74,19,25,44
34,8475170,Brayden Schenn,C,STL,33,72,19,25,44
34,8477444,Andre Burakovsky,L,SEA,29,68,16,28,44
34,8478038,Devon Toews,D,COL,30,72,14,30,44
34,8481577,Philip Tomasino,C,NSH,23,66,11,33,44
34,8481533,Trevor Zegras,C,ANA,23,77,7,37,44
34,8476483,Rickard Rakell,R,PIT,31,76,24,19,43
34,8476880,Tom Wilson,R,WSH,30,71,20,23,43
34,8481523,Kirby Dach,C,MTL,23,67,16,27,43
34,8475753,Justin Faulk,D,STL,32,76,13,30,43
34,8480817,K'Andre Miller,D,NYR,24,75,11,32,43
34,8478519,Anthony Cirelli,C,TBL,27,82,19,23,42
34,8478542,Evan Rodrigues,C,FLA,31,72,19,23,42
34,8478438,Tommy Novak,C,NSH,27,72,17,25,42
34,8482720,Matthew Knies,L,TOR,22,75,17,25,42
34,8475722,Jason Zucker,L,BUF,32,73,17,25,42
34,8476906,Shayne Gostisbehere,D,CAR,31,74,14,28,42
34,8474565,Alex Pietrangelo,D,VGK,34,67,10,32,42
34,8479425,Filip Hronek,D,VAN,27,73,9,33,42
34,8476923,Damon Severson,D,CBJ,30,80,8,34,42
34,8481581,Thomas Harley,D,DAL,23,76,6,36,42
34,8480185,Eetu Luostarinen,C,FLA,26,74,22,19,41
34,8479365,Trent Frederic,C,BOS,26,76,21,20,41
34,8482705,Cole Sillinger,C,CBJ,21,69,21,20,41
34,8475287,Erik Haula,L,NJD,33,71,19,22,41
34,8478498,Jake DeBrusk,L,VAN,28,69,18,23,41
34,8482671,Owen Power,D,BUF,22,70,13,28,41
34,8470613,Brent Burns,D,CAR,39,74,11,30,41
34,8474641,Adam Henrique,C,EDM,34,75,23,17,40
34,8479400,Pierre-Luc Dubois,L,WSH,26,68,22,18,40
34,8482475,Yegor Chinakhov,R,CBJ,23,58,21,19,40
34,8479525,Ross Colton,C,COL,28,79,21,19,40
34,8477497,Sean Monahan,C,CBJ,30,66,19,21,40
34,8477987,Ryan Donato,C,CHI,28,62,18,22,40
34,8480220,Noah Cates,L,PHI,25,68,16,24,40
34,8476925,Colton Sissons,C,NSH,31,72,15,25,40
34,8482146,Luke Evangelista,R,NSH,22,74,14,26,40
34,8477932,Aaron Ekblad,D,FLA,28,71,12,28,40
34,8480145,Neal Pionk,D,WPG,29,72,8,32,40
34,8482149,Cole Perfetti,C,WPG,22,67,17,22,39
34,8482702,Logan Stankoven,C,DAL,21,82,17,22,39
34,8478109,Victor Olofsson,L,VGK,29,69,17,22,39
34,8480798,Philipp Kurashev,C,CHI,25,64,9,30,39
34,8475764,Cam Fowler,D,ANA,33,72,7,32,39
34,8476854,Hampus Lindholm,D,BOS,30,71,6,33,39
34,8482110,Dawson Mercer,C,NJD,23,68,22,16,38
34,8482092,Ridly Greig,C,OTT,22,72,19,19,38
34,8478020,Michael Amadio,R,OTT,28,75,18,20,38
34,8474715,Cameron Atkinson,R,TBL,35,79,18,20,38
34,8478047,Michael Bunting,L,PIT,29,69,16,22,38
34,8477953,Kasperi Kapanen,R,STL,28,72,16,22,38
34,8476885,Jacob Trouba,D,NYR,30,68,14,24,38
34,8477494,Jonathan Drouin,L,COL,29,80,12,26,38
34,8478055,Gustav Forsling,D,FLA,28,72,11,27,38
34,8478458,John (Jack) Roslovic,C,CAR,27,72,8,30,38
34,8482105,Jake Sanderson,D,OTT,22,73,7,31,38
34,8475218,Mattias Ekholm,D,EDM,34,71,5,33,38
34,8478507,John Marino,D,UTA,27,62,3,35,38
34,8482667,William Eklund,L,SJS,22,59,19,18,37
34,8481624,Ilya Mikheyev,R,CHI,30,60,17,20,37
34,8476392,Adam Lowry,C,WPG,31,64,17,20,37
34,8475768,Jaden Schwartz,C,SEA,32,70,16,21,37
34,8482097,Jack Quinn,R,BUF,23,62,16,21,37
34,8480829,Jesperi Kotkaniemi,C,CAR,24,66,13,24,37
34,8478472,Mathieu Joseph,R,STL,27,70,13,24,37
34,8480789,Oliver Wahlstrom,R,NYI,24,71,12,25,37
34,8476792,Torey Krug,D,STL,33,74,8,29,37
34,8476438,Brandon Saad,L,STL,32,68,21,15,36
34,8480893,Kirill Marchenko,R,CBJ,24,58,21,14,35
34,8481535,Nils Hoglander,L,VAN,24,67,18,17,35
34,8476921,Jordan Martinook,L,CAR,32,64,17,18,35
34,8478233,Andrew Mangiapane,L,WSH,28,72,14,21,35
34,8477429,Andrew Copp,C,DET,30,76,14,21,35
34,8474716,Jared Spurgeon,D,MIN,35,79,7,28,35
34,8476979,Erik Gustafsson,D,DET,32,81,6,29,35
34,8482089,Jake Neighbours,L,STL,22,74,22,12,34
34,8481528,Dylan Cozens,C,BUF,23,67,20,14,34
34,8482055,Drew O'Connor,L,PIT,26,61,17,17,34
34,8476474,Stefan Noesen,R,NJD,31,66,16,18,34
34,8479661,Tanner Jeannot,L,LAK,27,72,16,18,34
34,8481186,Logan O'Connor,R,COL,28,79,15,19,34
34,8480078,Filip Chytil,C,NYR,25,67,15,19,34
34,8473422,Nick Foligno,L,CHI,37,60,15,19,34
34,8480813,Joe Veleno,C,DET,24,74,14,20,34
34,8482101,Danil Gushchin,L,SJS,22,62,14,20,34
34,8480871,Adam Boqvist,D,FLA,24,68,13,21,34
34,8478396,Noah Hanifin,D,VGK,27,68,11,23,34
34,8480434,Sean Durzi,D,UTA,26,63,10,24,34
34,8476480,Vladislav Namestnikov,C,WPG,32,67,9,25,34
34,8483490,Pavel Mintyukov,D,ANA,21,68,8,26,34
34,8475200,Dmitry Orlov,D,CAR,33,75,5,29,34
34,8478046,Danton Heinen,L,VAN,29,70,20,13,33
34,8477952,Robby Fabbri,C,ANA,28,63,19,14,33
34,8475149,Marcus Johansson,L,MIN,34,68,17,16,33
34,8475220,Marcus Foligno,L,MIN,33,62,16,17,33
34,8481524,Bowen Byram,D,BUF,23,65,15,18,33
34,8480849,Barrett Hayton,C,UTA,24,74,15,18,33
34,8478463,Anthony Beauvillier,L,PIT,27,68,14,19,33
34,8479353,Brett Howden,C,VGK,26,66,10,23,33
34,8480748,Kiefer Sherwood,L,VAN,29,61,10,23,33
34,8482133,Thomas Bordeleau,C,SJS,22,66,9,24,33
34,8474563,Drew Doughty,D,LAK,35,73,6,27,33
34,8477506,Ryan Pulock,D,NYI,30,78,6,27,33
34,8482122,Brock Faber,D,MIN,22,78,4,29,33
34,8482175,JJ Peterka,R,BUF,22,67,19,13,32
34,8481618,Alex Newhook,C,MTL,23,78,17,15,32
34,8480113,Alex Iafallo,L,WPG,31,68,12,20,32
34,8477979,Nicolas Aube-Kubel,R,BUF,28,60,12,20,32
34,8482660,Kent Johnson,C,CBJ,22,64,10,22,32
34,8484145,Zach Benson,L,BUF,19,71,7,25,32
34,8477425,Miles Wood,L,COL,29,80,17,14,31
34,8477839,Conor Sheary,L,TBL,32,82,17,14,31
34,8481481,Blake Lizotte,C,PIT,27,66,16,15,31
34,8481582,Nicholas Robertson,L,TOR,23,67,15,16,31
34,8480068,Ryan Poehling,C,PHI,25,69,14,17,31
34,8480459,Pius Suter,C,VAN,28,75,14,17,31
34,8480144,David Kampf,C,TOR,29,69,13,18,31
34,8481656,Aliaksei Protas,C,WSH,23,66,10,21,31
34,8477498,Darnell Nurse,D,EDM,29,74,9,22,31
34,8479976,Juuso Valimaki,D,UTA,26,71,3,28,31
34,8475714,Calle Jarnkrok,C,TOR,33,75,16,14,30
34,8479591,Michael Eyssimont,C,TBL,28,80,14,16,30
34,8476981,Josh Anderson,R,MTL,30,74,14,16,30
34,8479351,Sam Steel,C,DAL,26,79,12,18,30
34,8476872,Scott Laughton,C,PHI,30,69,11,19,30
34,8476419,Jean-Gabriel Pageau,C,NYI,32,76,11,19,30
34,8477989,Christian Dvorak,C,MTL,28,66,10,20,30
34,8480802,Ryan McLeod,C,BUF,25,67,9,21,30
34,8477969,Marcus Pettersson,D,PIT,28,79,7,23,30
34,8476927,Teddy Blueger,C,VAN,30,69,7,23,30
34,8481606,Jordan Spence,D,LAK,23,65,7,23,30
34,8474189,Lars Eller,C,PIT,35,68,16,13,29
34,8480995,Pontus Holmberg,R,TOR,25,64,11,18,29
34,8481546,Cam York,D,PHI,23,69,9,20,29
34,8479345,Jakob Chychrun,D,WSH,26,68,8,21,29
34,8479315,Joey Anderson,R,CHI,26,52,8,21,29
34,8475763,Kevin Hayes,R,PIT,32,70,16,12,28
34,8482679,Matt Coronato,R,CGY,22,65,16,12,28
34,8481553,Bobby Brink,R,PHI,23,63,13,15,28
34,8478133,Jake Evans,C,MTL,28,66,11,17,28
34,8474053,Logan Couture,C,SJS,35,63,9,19,28
34,8476869,Brady Skjei,D,NSH,30,74,9,19,28
34,8476278,Colin Blackwell,C,DAL,31,81,9,19,28
34,8475171,Oliver Ekman-Larsson,D,TOR,33,62,8,20,28
34,8481032,Paul Cotter,C,NJD,25,64,16,11,27
34,8478432,Christian Fischer,R,DET,27,73,15,12,27
34,8477353,Tyler Motte,C,DET,29,74,13,14,27
34,8482074,Connor Zary,C,CGY,23,59,11,16,27
34,8478413,Jordan Greenway,L,BUF,27,66,11,16,27
34,8477947,Sonny Milano,L,WSH,28,58,10,17,27
34,8476463,Jonas Brodin,D,MIN,31,76,8,19,27
34,8478452,Caleb Jones,D,LAK,27,52,6,21,27
34,8482712,Oskar Olausson,R,COL,22,82,5,22,27
34,8476891,Matthew Grzelcyk,D,PIT,30,75,5,22,27
34,8477220,Nate Schmidt,D,FLA,33,69,3,24,27
34,8474673,TJ Brodie,D,CHI,34,61,1,26,27
34,8470621,Corey Perry,R,EDM,39,70,15,11,26
34,8481704,Juuso Parssinen,C,NSH,23,50,14,12,26
34,8479941,Justin Danforth,R,CBJ,31,60,14,12,26
34,8476917,Adam Pelech,D,NYI,30,79,7,19,26
34,8482067,Connor Mackey,D,NYR,28,59,6,20,26
34,8476897,Oskar Sundqvist,C,STL,30,65,5,21,26
34,8480043,Timothy Liljegren,D,TOR,25,68,5,21,26
34,8480891,Michael Kesselring,D,UTA,24,60,5,21,26
34,8480878,Nils Lundkvist,D,DAL,24,72,4,22,26
34,8476331,Dylan DeMelo,D,WPG,31,70,3,23,26
34,8479393,Noah Gregor,L,OTT,26,74,13,12,25
34,8476918,Jimmy Vesey,L,NYR,31,70,13,12,25
34,8478013,Jake Walman,D,SJS,28,69,12,13,25
34,8480074,Alexandre Texier,C,STL,25,57,12,13,25
34,8483505,Matthew Poitras,C,BOS,20,73,9,16,25
34,8478508,Yakov Trenin,C,MIN,27,58,9,16,25
34,8480855,Jack McBain,C,UTA,24,64,4,21,25
34,8481703,Valtteri Puustinen,R,PIT,25,60,3,22,25
34,8481554,Kaapo Kakko,R,NYR,23,66,14,10,24
34,8473533,Jordan Staal,C,CAR,36,67,14,10,24
34,8482125,Alexander Holtz,R,VGK,22,72,13,11,24
34,8477507,Nikita Zadorov,D,BOS,29,74,11,13,24
34,8476374,Sean Kuraly,C,CBJ,31,57,11,13,24
34,8479293,Brandon Tanev,L,SEA,33,62,11,13,24
34,8482117,Lukas Reichel,L,CHI,22,71,11,13,24
34,8475193,Tomas Tatar,L,NJD,34,65,10,14,24
34,8477406,Mattias Janmark,C,EDM,32,68,10,14,24
34,8480448,Parker Kelly,L,COL,25,76,9,15,24
34,8479316,Luke Kunin,C,SJS,27,57,9,15,24
34,8483491,Ivan Miroshnichenko,L,WSH,20,46,9,15,24
34,8478891,Mason Appleton,C,WPG,28,64,8,16,24
34,8478399,Jonas Siegenthaler,D,NJD,27,65,6,18,24
34,8479336,Carl Grundstrom,R,SJS,27,45,14,9,23
34,8483565,Nick Blankenburg,D,NSH,26,63,12,11,23
34,8475848,Brendan Gallagher,R,MTL,32,69,11,12,23
34,8475231,Casey Cizikas,C,NYI,33,77,10,13,23
34,8479639,Dylan Coghlan,D,WPG,26,59,10,13,23
34,8479390,Taylor Raddysh,R,WSH,26,70,10,13,23
34,8483445,Cutter Gauthier,L,ANA,20,63,9,14,23
34,8473563,Nicklas Backstrom,C,WSH,37,58,9,14,23
34,8477919,Frederick Gaudreau,C,MIN,31,61,9,14,23
34,8479328,Julien Gauthier,R,NYI,27,61,8,15,23
34,8478851,Alexandre Carrier,D,NSH,28,61,5,18,23
34,8480073,Erik Brannstrom,D,COL,25,64,4,19,23
34,8482073,Braden Schneider,D,NYR,23,65,4,19,23
34,8476902,Esa Lindell,D,DAL,30,73,4,19,23
34,8474151,Ryan McDonagh,D,TBL,35,75,3,20,23
34,8476422,Mike Reilly,D,NYI,31,76,3,20,23
34,8479398,Samuel Girard,D,COL,26,73,1,22,23
34,8480289,Morgan Barron,C,WPG,26,55,17,5,22
34,8484203,Bradly Nadeau,L,CAR,19,63,13,9,22
34,8479368,Max Jones,L,BOS,26,70,12,10,22
34,8483524,Shane Wright,C,SEA,20,61,11,11,22
34,8482809,Jackson Blake,R,CAR,21,61,10,12,22
34,8473453,Trevor Lewis,C,LAK,37,72,10,12,22
34,8483457,Lane Hutson,D,MTL,20,62,8,14,22
34,8474034,Patrick Maroon,L,CHI,36,55,8,14,22
34,8481522,Peyton Krebs,C,BUF,23,58,7,15,22
34,8475855,Jesper Fast,R,CAR,33,62,6,16,22
34,8477365,Connor Clifton,D,BUF,29,54,6,16,22
34,8482655,Janis Moser,D,TBL,24,79,4,18,22
34,8481014,Alexander Romanov,D,NYI,24,73,4,18,22
34,8476931,Jake McCabe,D,TOR,31,70,4,18,22
34,8474574,Tyler Myers,D,VAN,34,73,4,18,22
34,8476892,Colton Parayko,D,STL,31,66,4,18,22
34,8483499,Liam Ohgren,L,MIN,20,49,4,18,22
34,8479980,Nicolas Hague,D,VGK,26,59,4,18,22
34,8479982,Conor Timmins,D,TOR,26,54,2,20,22
34,8478421,A.J. Greer,L,FLA,28,59,16,5,21
34,8476878,Zemgus Girgensons,C,TBL,30,78,14,7,21
34,8482111,Justin Barron,D,MTL,23,65,12,9,21
34,8476960,Andreas Athanasiou,C,CHI,30,49,11,10,21
34,8481601,Simon Holmstrom,R,NYI,23,59,11,10,21
34,8480252,Cole Guttman,C,CHI,25,46,11,10,21
34,8479619,Michael Carcone,L,UTA,28,53,9,12,21
34,8482176,Wyatt Kaiser,D,CHI,22,54,8,13,21
34,8478434,Keegan Kolesar,R,VGK,27,63,8,13,21
34,8483468,Jiri Kulich,C,BUF,20,53,6,15,21
34,8476312,Josh Manson,D,COL,33,54,6,15,21
34,8482624,Daniil Miromanov,D,CGY,27,64,4,17,21
34,8473507,Jeff Petry,D,DET,37,77,3,18,21
34,8480873,Rasmus Sandin,D,WSH,24,65,3,18,21
34,8478500,Ivan Provorov,D,CBJ,27,77,2,19,21
34,8480049,Dylan Samberg,D,WPG,25,65,1,20,21
34,8476822,Luke Glendening,C,TBL,35,77,14,6,20
34,8482259,Bobby McMann,C,TOR,28,55,13,7,20
34,8480336,Sean Walker,D,CAR,30,69,11,9,20
34,8475791,Taylor Hall,L,CHI,33,48,9,11,20
34,8478043,Sam Lafferty,C,BUF,29,58,8,12,20
34,8480205,Emil Bemstrom,C,PIT,25,52,7,13,20
34,8481161,Jake Christiansen,D,CBJ,25,58,7,13,20
34,8479992,Michael Rasmussen,C,DET,25,78,6,14,20
34,8481019,David Gustafsson,C,WPG,24,49,6,14,20
34,8477369,Carson Soucy,D,VAN,30,64,5,15,20
34,8482749,Joshua Roy,R,MTL,21,65,5,15,20
34,8476856,Mathew Dumba,D,DAL,30,73,5,15,20
34,8478911,Matt Roy,D,WSH,29,63,4,16,20
34,8480222,Sebastian Aho,D,PIT,28,65,4,16,20
34,8475181,Nick Leddy,D,STL,33,69,3,17,20
34,8476879,Cody Ceci,D,EDM,31,69,3,17,20
34,8477845,Trevor van Riemsdyk,D,WSH,33,56,2,18,20
34,8475324,Nick Jensen,D,OTT,34,65,1,19,20
34,8477508,Curtis Lazar,C,NJD,29,57,10,9,19
34,8476461,Sean Couturier,C,PHI,32,59,9,10,19
34,8479344,Jesse Puljujarvi,R,PIT,26,53,9,10,19
34,8480003,Jesper Boqvist,C,FLA,26,64,8,11,19
34,8480355,Mark Kastelic,C,BOS,25,62,8,11,19
34,8477478,William Carrier,L,CAR,30,54,7,12,19
34,8481441,Joe Snively,C,DET,28,67,7,12,19
34,8484149,Gavin Brindley,C,CBJ,20,47,7,12,19
34,8481751,Lukas Rousek,R,BUF,25,47,6,13,19
34,8480025,MacKenzie Entwistle,R,FLA,25,55,6,13,19
34,8477488,Brett Pesce,D,NJD,30,71,5,14,19
34,8475179,Dmitry Kulikov,D,FLA,34,67,5,14,19
34,8475279,Ben Chiarot,D,DET,33,67,5,14,19
34,8475790,Erik Gudbranson,D,CBJ,32,79,4,15,19
34,8483493,Frank Nazar,C,CHI,20,49,4,15,19
34,8482192,Isaak Phillips,D,CHI,23,57,4,15,19
34,8476457,Adam Larsson,D,SEA,32,68,4,15,19
34,8480246,Nick Perbix,D,TBL,26,74,4,15,19
34,8479983,Mario Ferraro,D,SJS,26,72,3,16,19
34,8482142,Jamie Drysdale,D,PHI,22,66,3,16,19
34,8470600,Ryan Suter,D,STL,39,60,2,17,19
34,8479371,Dante Fabbro,D,NSH,26,66,1,18,19
34,8480281,Alexey Toropchenko,R,STL,25,65,10,8,18
34,8480980,Connor Dewar,C,TOR,25,67,10,8,18
34,8481580,Connor McMichael,C,WSH,23,68,7,11,18
34,8477392,Hudson Fasching,R,NYI,29,65,7,11,18
34,8476934,Brock McGinn,L,ANA,30,50,7,11,18
34,8475343,Nic Dowd,C,WSH,34,62,5,13,18
34,8481093,Rafael Harvey-Pinard,L,MTL,25,64,5,13,18
34,8482087,Kaiden Guhle,D,MTL,22,74,4,14,18
34,8483460,David Jiricek,D,CBJ,21,57,3,15,18
34,8482245,Artem Zub,D,OTT,29,65,1,17,18
34,8480001,Urho Vaakanainen,D,ANA,25,66,1,17,18
34,8476889,Radek Faksa,C,STL,30,58,12,5,17
34,8476624,Barclay Goodrow,C,SJS,31,54,11,6,17
34,8482737,Zack Bolduc,C,STL,21,56,9,8,17
34,8477903,Garnet Hathaway,R,PHI,33,71,9,8,17
34,8481517,Brett Leason,R,ANA,25,59,9,8,17
34,8478569,Noel Acciari,C,PIT,33,58,8,9,17
34,8481599,Victor Soderstrom,D,UTA,23,59,8,9,17
34,8477435,Ryan Graves,D,PIT,29,79,7,10,17
34,8477450,Jason Dickinson,C,CHI,29,51,7,10,17
34,8480835,Jack Drury,C,CAR,24,54,6,11,17
34,8481013,Jonatan Berggren,R,DET,24,58,6,11,17
34,8477499,Rasmus Ristolainen,D,PHI,30,57,5,12,17
34,8476994,Vinnie Hinostroza,C,NSH,30,37,5,12,17
34,8479998,Mikey Anderson,D,LAK,25,66,4,13,17
34,8480860,Kevin Bahl,D,CGY,24,55,4,13,17
34,8481059,Scott Perunovich,D,STL,26,64,1,16,17
34,8480806,Isac Lundestrom,C,ANA,25,55,10,6,16
34,8482155,Alex Laferriere,R,LAK,23,64,10,6,16
34,8478970,Jalen Chatfield,D,CAR,28,73,7,9,16
34,8482784,Zach Dean,C,STL,21,41,7,9,16
34,8479996,Cody Glass,C,NSH,25,55,5,11,16
34,8479414,Nathan Bastian,R,NJD,27,58,5,11,16
34,8471709,Marc-Edouard Vlasic,D,SJS,37,55,5,11,16
34,8478859,Niko Mikkola,D,FLA,28,58,4,12,16
34,8479520,Brandon Duhaime,R,WSH,27,51,4,12,16
34,8477015,Connor Brown,R,EDM,30,62,4,12,16
34,8478840,Will Borgen,D,SEA,28,64,4,12,16
34,8475233,David Savard,D,MTL,34,65,3,13,16
34,8478882,Vladislav Gavrikov,D,LAK,29,65,3,13,16
34,8476525,Colin Miller,D,WPG,32,62,3,13,16
34,8481701,Santeri Hatakka,D,NJD,23,35,3,13,16
34,8479402,Jake Bean,D,CGY,26,63,0,16,16
34,8479439,Jacob MacDonald,D,COL,31,51,11,4,15
34,8482062,Cole Smith,L,NSH,29,56,9,6,15
34,8481477,Nico Sturm,C,SJS,29,61,9,6,15
34,8479718,Alex Barré-Boulet,C,MTL,27,49,8,7,15
34,8476467,Jamie Oleksiak,D,SEA,32,65,7,8,15
34,8482762,Simon Edvinsson,D,DET,21,55,7,8,15
34,8476867,Brendan Gaunce,C,MIN,30,39,7,8,15
34,8483466,Kevin Korchinski,D,CHI,20,46,7,8,15
34,8482157,Will Cuylle,L,NYR,22,63,6,9,15
34,8482803,Olen Zellweger,D,ANA,21,65,6,9,15
34,8483482,Tristan Luneau,D,ANA,20,59,6,9,15
34,8479291,Kevin Rooney,C,CGY,31,52,6,9,15
34,8477887,Patrick Brown,C,BOS,32,50,6,9,15
34,8476469,Joel Armia,R,MTL,31,59,5,10,15
34,8481708,Zac Jones,D,NYR,24,51,4,11,15
34,8476967,Brett Kulak,D,EDM,30,60,4,11,15
34,8478136,Jake Middleton,D,MIN,28,76,3,12,15
34,8482451,Mikael Pyyhtia,L,CBJ,23,42,1,14,15
34,8475462,Radko Gudas,D,ANA,34,66,0,15,15
34,8475225,Craig Smith,C,CHI,35,45,8,6,14
34,8481537,Nikita Okhotiuk,D,CGY,24,53,8,6,14
34,8477446,Michael McCarron,R,NSH,29,55,7,7,14
34,8480021,Jack Studnicka,C,LAK,25,66,7,7,14
34,8477931,Tomas Nosek,L,FLA,32,61,6,8,14
34,8482859,Zack Ostapchuk,C,OTT,21,51,6,8,14
34,8480762,Eric Robinson,L,CAR,29,52,5,9,14
34,8479370,Tyson Jost,C,CAR,26,48,5,9,14
34,8479543,Michael Pezzetta,L,MTL,26,59,5,9,14
34,8479536,Axel Jonsson-Fjallby,L,WPG,26,38,5,9,14
34,8476874,Olli Maatta,D,DET,30,61,4,10,14
34,8478443,Brandon Carlo,D,BOS,28,62,4,10,14
34,8476329,Travis Boyd,C,MIN,31,58,3,11,14
34,8475208,Brian Dumoulin,D,ANA,33,64,3,11,14
34,8482652,Walker Duehr,R,CGY,27,45,3,11,14
34,8479372,Joshua Mahura,D,SEA,26,62,3,11,14
34,8475188,Brayden McNabb,D,VGK,33,58,1,13,14
34,8479772,Zack MacEwen,R,OTT,28,59,1,13,14
34,8483495,Simon Nemec,D,NJD,20,53,7,6,13
34,8482079,Marco Rossi,C,MIN,23,57,6,7,13
34,8482148,Hendrix Lapierre,C,WSH,22,50,6,7,13
34,8478468,Jeremy Lauzon,D,NSH,27,55,5,8,13
34,8479359,Beck Malenstyn,L,BUF,26,51,4,9,13
34,8477482,Zachary Sanford,L,CHI,30,43,3,10,13
34,8476429,Scott Mayfield,D,NYI,32,77,2,11,13
34,8481518,Nolan Foote,L,NJD,24,39,9,3,12
34,8481716,Dmitri Voronkov,L,CBJ,24,45,9,3,12
34,8482744,James Malatesta,L,CBJ,21,42,8,4,12
34,8482807,Ethan Del Mastro,D,CHI,21,57,7,5,12
34,8477070,Liam O'Brien,C,UTA,30,55,7,5,12
34,8482077,Dylan Holloway,L,EDM,23,57,7,5,12
34,8481028,Martin Pospisil,C,CGY,25,60,6,6,12
34,8481641,Joel Kiviranta,L,COL,28,67,5,7,12
34,8477380,Jonny Brodzinski,C,NYR,31,61,5,7,12
34,8477401,John Hayden,C,SEA,29,34,5,7,12
34,8482730,Brandt Clarke,D,LAK,21,46,4,8,12
34,8480834,Ty Emberson,D,SJS,24,34,4,8,12
34,8480807,Mattias Samuelsson,D,BUF,24,60,3,9,12
34,8480727,Zach Whitecloud,D,VGK,28,52,3,9,12
34,8474567,Zach Bogosian,D,MIN,34,61,3,9,12
34,8476952,Dominic Toninato,C,WPG,30,37,3,9,12
34,8474612,Travis Hamonic,D,OTT,34,45,2,10,12
34,8475690,Chris Tanev,D,TOR,35,61,1,11,12
34,8471677,Jack Johnson,D,CBJ,37,60,1,11,12
34,8479968,Vinni Lettieri,C,BOS,29,52,8,3,11
34,8481527,Kaedan Korczak,D,VGK,23,40,6,5,11
34,8478831,Kevin Stenlund,C,UTA,28,52,6,5,11
34,8480796,Martin Fehervary,D,WSH,25,45,6,5,11
34,8480011,Klim Kostin,C,SJS,25,44,5,6,11
34,8478585,Derek Ryan,C,EDM,38,65,5,6,11
34,8481147,Reese Johnson,C,MIN,26,44,5,6,11
34,8482659,Josh Doan,R,UTA,22,47,4,7,11
34,8475235,Nicolas Deslauriers,L,PHI,33,52,4,7,11
34,8480172,Jan Rutta,D,SJS,34,60,3,8,11
34,8476988,Matt Benning,D,SJS,30,72,3,8,11
34,8471817,Ryan Reaves,R,TOR,37,56,3,8,11
34,8480848,Ty Dellandrea,C,SJS,24,41,3,8,11
34,8482964,Arber Xhekaj,D,MTL,23,49,3,8,11
34,8480157,Calle Rosen,D,COL,30,51,3,8,11
34,8480887,Jordan Harris,D,MTL,24,48,2,9,11
34,8480950,Ilya Lyubushkin,D,DAL,30,62,2,9,11
34,8480070,Ian Mitchell,D,BOS,25,46,2,9,11
34,8481550,Adam Beckman,L,NJD,23,39,2,9,11
34,8481568,Alex Vlasic,D,CHI,23,49,1,10,11
34,8479369,Andrew Peeke,D,BOS,26,55,1,10,11
34,8481178,Egor Zamula,D,PHI,24,57,1,10,11
34,8479324,Ryan Lindgren,D,NYR,26,64,0,11,11
34,8481556,John Beecher,C,BOS,23,37,6,4,10
34,8475842,Sam Carrick,C,NYR,32,56,5,5,10
34,8479944,Zach Aston-Reese,C,VGK,30,47,5,5,10
34,8480007,Jonas Rondbjerg,R,VGK,25,42,5,5,10
34,8476442,Matt Nieto,L,PIT,32,44,4,6,10
34,8479378,Logan Stanley,D,WPG,26,45,4,6,10
34,8476873,Mark Jankowski,C,NSH,30,52,3,7,10
34,8475762,Derek Forbort,D,VAN,32,42,3,7,10
34,8483549,Lucas Condotta,L,MTL,27,33,3,7,10
34,8482634,Alex Steeves,C,TOR,25,53,2,8,10
34,8480879,Jacob Bernard-Docker,D,OTT,24,42,2,8,10
34,8481521,Ronnie Attard,D,PHI,25,51,1,9,10
34,8479249,Andrew Poturalski,C,SJS,30,39,1,9,10
34,8474166,Alec Martinez,D,CHI,37,50,1,9,10
34,8484254,Akito Hirose,D,VAN,25,35,1,9,10
34,8479348,Kale Clague,D,BUF,26,39,1,9,10
34,8478178,Darren Raddysh,D,TBL,28,67,0,10,10
34,8479638,Justin Brazeau,R,BOS,26,37,7,2,9
34,8479026,Philippe Myers,D,TOR,27,55,5,4,9
34,8481617,Vasily Podkolzin,R,VAN,23,43,5,4,9
34,8480845,Rasmus Kupari,C,WPG,24,46,4,5,9
34,8479379,Givani Smith,R,SJS,26,32,4,5,9
34,8477527,Ross Johnston,L,ANA,30,34,4,5,9
34,8478211,Dryden Hunt,L,CGY,29,52,3,6,9
34,8479994,Jaret Anderson-Dolan,C,WPG,25,35,3,6,9
34,8480192,Johnathan Kovacevic,D,NJD,27,46,3,6,9
34,8478409,Anthony Richard,C,PHI,28,32,2,7,9
34,8474013,Ian Cole,D,UTA,35,46,1,8,9
34,8475177,Calvin de Haan,D,COL,33,34,1,8,9
34,8481567,Henry Thrun,D,SJS,23,50,1,8,9
34,8473446,Erik Johnson,D,PHI,36,52,1,8,9
34,8478451,Ethan Bear,D,WSH,27,50,0,9,9
34,8476858,Phillip Di Giuseppe,L,VAN,31,41,7,1,8
34,8475958,Michael Sgarbossa,C,WSH,32,34,5,3,8
34,8482166,Shakir Mukhamadullin,D,SJS,22,52,4,4,8
34,8477573,Nathan Walker,L,STL,30,51,4,4,8
34,8480035,Henri Jokiharju,D,BUF,25,60,3,5,8
34,8481167,Brayden Pachal,D,CGY,25,38,3,5,8
34,8482095,Tyler Kleven,D,OTT,22,44,3,5,8
34,8478416,Erik Cernak,D,TBL,27,69,2,6,8
34,8476441,Joel Edmundson,D,LAK,31,43,2,6,8
34,8480870,Bo Groulx,C,NYR,24,31,2,6,8
34,8479066,Ryan Lomberg,L,CGY,30,63,1,7,8
34,8478017,Mark Friedman,D,VAN,29,33,1,7,8
34,8475750,Jon Merrill,D,MIN,32,62,1,7,8
34,8478454,Noah Juulsen,D,VAN,27,39,0,8,8
34,8481592,Jakob Pelletier,L,CGY,23,36,6,1,7
34,8480245,Olle Lycksell,R,PHI,25,40,6,1,7
34,8483570,Ben Meyers,C,SEA,26,26,5,2,7
34,8480292,Carson Meyer,R,ANA,27,30,4,3,7
34,8479986,Kole Lind,R,DAL,26,44,4,3,7
34,8482070,Mitchell Chaffee,R,TBL,26,51,4,3,7
34,8484911,Collin Graf,R,SJS,22,41,3,4,7
34,8483619,Filip Roos,D,OTT,25,42,3,4,7
34,8477962,Brendan Lemieux,L,CAR,28,50,3,4,7
34,8482165,Yan Kuznetsov,D,CGY,22,28,3,4,7
34,8479985,Cale Fleury,D,SEA,26,28,3,4,7
34,8482861,Vincent Iorio,D,WSH,22,35,3,4,7
34,8482666,Scott Morrow,D,CAR,22,51,2,5,7
34,8475718,Justin Holl,D,DET,32,50,2,5,7
34,8480441,Trey Fix-Wolansky,R,CBJ,25,46,2,5,7
34,8482747,Brennan Othmann,L,NYR,21,44,2,5,7
34,8481743,Marc Del Gaizo,D,NSH,25,17,2,5,7
34,8483012,Logan Morrison,C,SEA,22,33,2,5,7
34,8477938,Haydn Fleury,D,WPG,28,43,1,6,7
34,8482177,Marat Khusnutdinov,C,MIN,22,34,1,6,7
34,8476372,Nick Seeler,D,PHI,31,43,1,6,7
34,8479320,Maxime Lajoie,D,SEA,27,21,1,6,7
34,8477384,Joshua Brown,D,EDM,30,38,1,6,7
34,8479972,Mason Shaw,C,WPG,26,30,0,7,7
34,8480058,Pierre-Olivier Joseph,D,STL,25,49,0,7,7
34,8480084,Nick DeSimone,D,NJD,30,17,0,7,7
34,8482733,Logan Mailloux,D,MTL,31,30,4,2,6
34,8481679,Maxence Guenette,D,OTT,23,40,4,2,6
34,8479981,Jonah Gadjovich,L,FLA,26,48,4,2,6
34,8479442,Troy Stecher,D,EDM,30,54,3,3,6
34,8481789,Tye Kartye,L,SEA,23,44,3,3,6
34,8479367,William Lockwood,R,FLA,26,22,3,3,6
34,8476473,Connor Murphy,D,CHI,31,36,2,4,6
34,8477851,Jordan Oesterle,D,BOS,32,55,2,4,6
34,8477018,Ben Hutton,D,VGK,31,37,2,4,6
34,8480267,Sammy Walker,C,MIN,25,19,2,4,6
34,8476913,Devin Shore,C,MIN,30,34,2,4,6
34,8480196,Jacob Bryson,D,BUF,27,38,2,4,6
34,8482765,Isak Rosen,R,BUF,21,29,2,4,6
34,8482713,Mackie Samoskevich,R,FLA,22,38,2,4,6
34,8479671,Mathieu Olivier,R,CBJ,27,48,1,5,6
34,8474090,Brendan Smith,D,DAL,35,49,1,5,6
34,8475455,Brenden Dillon,D,NJD,34,58,1,5,6
34,8474568,Luke Schenn,D,NSH,35,45,0,6,6
34,8482172,Landon Slaggert,L,CHI,22,18,4,1,5
34,8480844,Grigori Denisenko,L,VGK,24,34,3,2,5
34,8481609,Vladislav Kolyachonok,D,UTA,23,36,3,2,5
34,8480880,Jakub Lauko,C,MIN,24,36,2,3,5
34,8483763,Maksymilian Szuber,D,UTA,22,29,2,3,5
34,8482145,Mavrik Bourque,C,DAL,22,47,2,3,5
34,8480990,Declan Chisholm,D,MIN,24,37,1,4,5
34,8478146,Matthew Highmore,C,OTT,28,30,1,4,5
34,8478874,Adam Gaudette,R,OTT,28,36,1,4,5
34,8479576,Vincent Desharnais,D,VAN,28,39,1,4,5
34,8477335,Kyle Burroughs,D,LAK,29,37,0,5,5
34,8477034,Jaycob Megna,D,FLA,32,39,0,5,5
34,8481600,Tobias Bjornfot,D,FLA,23,39,0,5,5
34,8480468,James Hamblin,L,EDM,25,19,3,1,4
34,8477073,Kurtis MacDermid,L,NJD,30,31,3,1,4
34,8482751,Ryan Winterton,C,SEA,21,39,2,2,4
34,8478021,William Lagesson,D,DET,28,24,2,2,4
34,8478477,Mitchell Stephens,C,SEA,27,22,2,2,4
34,8482496,Nils Aman,C,VAN,24,35,1,3,4
34,8483512,Matthew Savoie,C,EDM,20,18,1,3,4
34,8481122,Simon Benoit,D,TOR,26,37,1,3,4
34,8482144,Jack Thompson,D,SJS,22,28,1,3,4
34,8477971,Andreas Englund,D,LAK,28,33,1,3,4
34,8482470,Ilya Solovyov,D,CGY,24,16,1,3,4
34,8479991,Jake Leschyshyn,C,NYR,25,22,1,3,4
34,8482201,Gage Goncalves,C,TBL,23,24,1,3,4
34,8477810,Joel Hanley,D,CGY,33,31,0,4,4
34,8481532,Alex Turcotte,C,LAK,23,47,3,0,3
34,8482141,Lukas Cormier,D,VGK,22,25,3,0,3
34,8482088,Justin Sourdif,R,FLA,22,22,3,0,3
34,8478424,Jansen Harkins,C,ANA,27,38,2,1,3
34,8481422,Jake Lucchini,C,NSH,29,19,2,1,3
34,8482094,Daemon Hunt,D,MIN,22,11,2,1,3
34,8483397,Marc McLaughlin,C,BOS,25,21,1,2,3
34,8482153,Brendan Brisson,C,VGK,23,21,1,2,3
34,8481605,Jackson LaCombe,D,ANA,23,32,1,2,3
34,8484258,Sam Malinski,D,COL,26,20,1,2,3
34,8478450,Parker Wotherspoon,D,BOS,27,25,1,2,3
34,8481056,Spencer Stastney,D,NSH,24,38,1,2,3
34,8481030,Jack St. Ivany,D,PIT,25,20,1,2,3
34,8477244,Chad Ruhwedel,D,NYR,34,26,1,2,3
34,8481699,Aku Raty,R,UTA,23,27,1,2,3
34,8478446,Glenn Gawdin,C,LAK,27,6,1,2,3
34,8481541,Samuel Bolduc,D,NYI,24,20,1,2,3
34,8481598,Philip Broberg,D,EDM,23,45,0,3,3
34,8478051,Max Willman,C,NJD,29,14,0,3,3
34,8482929,Emil Lilleberg,D,TBL,23,25,0,3,3
34,8482250,Callahan Burke,C,VGK,27,27,0,3,3
34,8475795,Dylan McIlrath,D,WSH,32,22,0,3,3
34,8477149,Scott Sabourin,R,SJS,32,13,0,3,3
34,8481564,Ryan Johnson,D,BUF,23,14,0,3,3
34,8482147,Jean-Luc Foudy,C,COL,22,28,2,0,2
34,8482102,Vasily Ponomarev,C,PIT,22,16,1,1,2
34,8481543,Nikita Alexandrov,C,STL,24,14,1,1,2
34,8477462,Robert Hagg,D,VGK,29,23,1,1,2
34,8484325,Waltteri Merela,C,TBL,26,21,1,1,2
34,8477473,Justin Bailey,R,SJS,29,27,1,1,2
34,8482858,Ryker Evans,D,SEA,23,25,1,1,2
34,8475413,Justin Dowling,C,NJD,34,19,1,1,2
34,8479421,Jacob Moverare,D,LAK,26,12,1,1,2
34,8481754,Nikita Nesterenko,C,ANA,23,38,0,2,2
34,8482511,Mason Lohrei,D,BOS,23,33,0,2,2
34,8478502,Dennis Gilbert,D,BUF,28,17,0,2,2
34,8483630,Pavol Regenda,L,ANA,25,28,0,2,2
34,8482118,Sam Colangelo,R,ANA,23,13,0,2,2
34,8477320,Anton Blidh,L,NYR,29,16,0,2,2
34,8482516,Matthew Kessel,D,STL,24,18,0,2,2
34,8481719,Maxwell Crozier,D,TBL,24,18,0,2,2
34,8480075,Cameron Crotty,D,MIN,25,12,0,2,2
34,8480874,Adam Ginning,D,PHI,24,13,0,2,2
34,8479587,Rhett Gardner,C,PHI,28,20,0,2,2
34,8481585,Egor Afanasyev,L,SJS,23,15,1,0,1
34,8481043,Cole Koepke,L,BOS,26,9,1,0,1
34,8481462,Mason Morelli,L,VGK,28,12,1,0,1
34,8483398,Declan Carlile,D,TBL,31,8,1,0,1
34,8477993,Justin Kirkland,C,CGY,28,4,1,0,1
34,8483546,Marshall Rifai,D,TOR,26,6,1,0,1
34,8481065,Angus Crookshank,L,OTT,25,12,1,0,1
34,8481578,Graeme Clarke,R,MIN,23,8,1,0,1
34,8484326,Patrik Koch,D,UTA,28,2,1,0,1
34,8481237,Kyle MacLean,C,NYI,25,23,0,1,1
34,8477467,Gustav Olofsson,D,SEA,30,17,0,1,1
34,8481006,Tyler Tucker,D,STL,24,16,0,1,1
34,8479419,Brett Murray,L,BUF,26,19,0,1,1
34,8480851,Akil Thomas,C,LAK,24,20,0,1,1
34,8480032,Shane Bowers,C,NJD,25,20,0,1,1
34,8484287,Cole McWard,D,VAN,23,18,0,1,1
34,8483489,Fraser Minten,C,TOR,31,13,0,1,1
34,8483407,Brandon Scanlin,D,NYR,25,9,0,1,1
34,8481593,Jayden Struble,D,MTL,23,23,0,1,1
34,8483567,Georgii Merkulov,C,BOS,24,6,0,1,1
34,8483395,Arshdeep Bains,L,VAN,23,12,0,1,1
34,8483471,Brad Lambert,C,WPG,31,8,0,1,1
34,8484304,Uvis Balinskis,D,FLA,28,9,0,1,1
34,8475755,Alexander Petrovic,D,DAL,32,13,0,1,1
34,8483432,Luca Del Bel Belluz,C,CBJ,31,4,0,1,1
34,8481534,Raphael Lavoie,C,EDM,24,4,0,1,1
34,8481655,Cole Schwindt,R,CGY,23,5,0,1,1
34,8483609,Adam Klapka,R,CGY,24,7,0,1,1
34,8476323,Max McCormick,L,SEA,32,3,0,1,1
34,8481726,Adam Edstrom,C,NYR,24,5,0,1,1
34,8478147,Bokondji Imama,L,PIT,28,7,0,1,1
34,8480890,Jan Jenik,C,OTT,24,30,0,0,0
34,8479362,Riley Tufte,L,BOS,26,22,0,0,0
34,8478011,Louie Belpedio,D,PHI,28,10,0,0,0
34,8482162,Roby Jarventie,L,EDM,22,14,0,0,0
34,8478881,Brett Seney,L,CHI,28,6,0,0,0
34,8484255,Jason Polin,R,COL,25,6,0,0,0
34,8482787,Nikita Chibrikov,R,WPG,31,8,0,0,0
34,8475780,Chris Wagner,R,COL,33,5,0,0,0
34,8483597,Milos Kelemen,L,UTA,25,11,0,0,0
34,8474062,Riley Nash,C,NYR,35,17,0,0,0
34,8481206,John Ludvig,D,PIT,24,11,0,0,0
34,8480823,Alexander Alexeyev,D,WSH,25,11,0,0,0
34,8477541,Dakota Mermis,D,TOR,30,8,0,0,0
34,8482061,Brandon Biro,L,SEA,26,18,0,0,0
34,8482197,Adam Raska,R,MIN,23,3,0,0,0
34,8482476,Emil Heineman,L,MTL,23,7,0,0,0
34,8479330,Brandon Gignac,C,MTL,27,4,0,0,0
34,8480306,Grant Hutton,D,NYI,29,7,0,0,0
34,8481806,Louis Crevier,D,CHI,23,16,0,0,0
34,8483531,Brian Halonen,L,NJD,25,2,0,0,0
34,8480274,Philip Kemp,D,EDM,25,0,0,0,0
34,8481024,Linus Karlsson,C,VAN,25,6,0,0,0
34,8482126,Emil Andrae,D,PHI,31,3,0,0,0
34,8482460,Matt Rempe,C,NYR,22,10,0,0,0
34,8478854,Ryan Shea,D,PIT,27,3,0,0,0
34,8479522,Hardy Haman Aktell,D,WSH,26,6,0,0,0
34,8483920,Pierrick Dube,R,WSH,23,3,0,0,0
34,8483401,Marc Johnstone,R,PIT,28,1,0,0,0
34,8484259,Ondrej Pavel,C,COL,31,3,0,0,0
34,8484321,Nikolas Matinpalo,D,OTT,26,4,0,0,0
34,8470794,Joe Pavelski,C,,40,0,0,0,0
34,8479321,Lucas Johansen,D,,27,0,0,0,0
34,8477950,Tony DeAngelo,D,,29,0,0,0,0
34,8471218,Blake Wheeler,R,,38,0,0,0,0
34,8475197,Tyson Barrie,D,,33,0,0,0,0
34,8474157,Max Pacioretty,L,,36,0,0,0,0
34,8475744,Evgeny Kuznetsov,C,,32,0,0,0,0
34,8474037,James van Riemsdyk,L,,35,0,0,0,0
34,8476907,Mackenzie MacEachern,L,,30,0,0,0,0
34,8480216,Jacob Peterson,C,,25,0,0,0,0
34,8474602,Justin Schultz,D,,34,0,0,0,0
34,8482222,Alexander Barabanov,L,,30,0,0,0,0
34,8474031,Kevin Shattenkirk,D,,35,0,0,0,0
34,8477330,Dominik Kubalik,L,,29,0,0,0,0
34,8480884,Calen Addison,D,,24,0,0,0,0
34,8475906,John Klingberg,D,,32,0,0,0,0
34,8480008,Adam Ruzicka,C,,25,0,0,0,0
34,8476884,Derrick Pouliot,D,,30,0,0,0,0
34,8476919,Chris Tierney,C,,30,0,0,0,0
34,8479415,Michael McLeod,C,,26,0,0,0,0
34,8474870,Tyler Johnson,C,,34,0,0,0,0
34,8470604,Jeff Carter,C,,39,0,0,0,0
34,8478104,Sammy Blais,L,,28,0,0,0,0
34,8474884,Mike Hoffman,C,,35,0,0,0,0
34,8481591,Sam Poulin,R,,23,0,0,0,0
34,8471274,Alex Goligoski,D,,39,0,0,0,0
34,8476871,Tanner Pearson,L,,32,0,0,0,0
34,8476393,Nick Cousins,C,,31,0,0,0,0
34,8479977,Kailer Yamamoto,R,,26,0,0,0,0
34,8479346,Dillon Dube,C,,26,0,0,0,0
34,8480184,Gustav Lindstrom,D,,26,0,0,0,0
34,8479376,Victor Mete,D,,26,0,0,0,0
34,8473449,Kyle Okposo,R,,36,0,0,0,0
34,8481058,Jesse Ylonen,R,,25,0,0,0,0
34,8475752,Tyler Pitlick,C,,33,0,0,0,0
34,8481239,Samuel Fagemo,L,,24,0,0,0,0
34,8480821,Filip Zadina,R,,25,0,0,0,0
34,8470966,Mark Giordano,D,,41,0,0,0,0
34,8478495,Denis Gurianov,R,,27,0,0,0,0
34,8477464,Nic Petan,C,,29,0,0,0,0
34,8478099,Kevin Labanc,R,,29,0,0,0,0
34,8482241,Radim Zohorna,L,,28,0,0,0,0
34,8474040,Sam Gagner,C,,35,0,0,0,0
34,8479514,Rem Pitlick,C,,27,0,0,0,0
34,8478430,Oliver Kylington,D,,27,0,0,0,0
34,8479533,Joona Koppanen,L,,26,0,0,0,0
34,8479984,Cal Foote,D,,26,0,0,0,0
34,8477126,Jayson Megna,C,,34,0,0,0,0
34,8475164,Jakob Silfverberg,R,,34,0,0,0,0
34,8474009,Nick Bonino,C,,36,0,0,0,0
34,8479458,Nikita Zaitsev,D,,33,0,0,0,0
34,8477944,Jakub Vrana,L,,28,0,0,0,0
34,8471699,Andrew Cogliano,C,,37,0,0,0,0
34,8478067,Oskar Lindblom,L,,28,0,0,0,0
34,8471686,Marc Staal,D,,37,0,0,0,0
34,8470610,Zach Parise,L,,40,0,0,0,0
34,8478904,Steven Lorentz,C,,28,0,0,0,0
34,8473473,Milan Lucic,L,,36,0,0,0,0
34,8480031,Maxime Comtois,L,,25,0,0,0,0
34,8478512,Austin Czarnik,C,,32,0,0,0,0
34,8473504,Cal Clutterbuck,R,,37,0,0,0,0
34,8477454,Adam Erne,L,,29,0,0,0,0
34,8479383,Boris Katchouk,L,,26,0,0,0,0
34,8475825,Jani Hakanpää,D,,32,0,0,0,0
34,8477846,Ryan Carpenter,C,,33,0,0,0,0
34,8477930,Pierre-Edouard Bellemare,L,,39,0,0,0,0
34,8478400,Colin White,C,,27,0,0,0,0
34,8480226,Marián Studenic,R,,26,0,0,0,0
34,8480853,Liam Foudy,C,,24,0,0,0,0
34,8475797,Jarred Tinordi,D,,32,0,0,0,0
34,8479423,Alex Nylander,L,,26,0,0,0,0
34,8474618,Marco Scandella,D,,34,0,0,0,0
34,8478028,Fredrik Olofsson,L,,28,0,0,0,0
34,8474709,Matt Martin,L,,35,0,0,0,0
34,8481070,Hugh McGing,L,,26,0,0,0,0
34,8479546,Oskar Steen,C,,26,0,0,0,0
34,8474145,Robert Bortuzzo,D,,35,0,0,0,0
34,8476915,Jujhar Khaira,L,,30,0,0,0,0
34,8475278,Byron Froese,C,,33,0,0,0,0
34,8481812,Nikolai Knyzhov,D,,27,0,0,0,0
34,8478408,Travis Dermott,D,,28,0,0,0,0
34,8481077,John Leonard,L,,26,0,0,0,0
34,8479547,Matthew Phillips,R,,26,0,0,0,0
34,8480836,Jonathan Gruden,C,,24,0,0,0,0
34,8481690,Tyler Angle,C,,24,0,0,0,0
34,8475766,Austin Watson,L,,32,0,0,0,0
34,8481016,Ruslan Iskhakov,C,,24,0,0,0,0
34,8478078,Rourke Chartier,C,,28,0,0,0,0
34,8480776,Sheldon Rempal,R,,29,0,0,0,0
34,8478956,Samuel Laberge,L,NJD,27,2,0,0,0
34,8483045,Cameron Butler,R,CBJ,31,1,0,0,0
34,8484314,Jiri Smejkal,L,,28,0,0,0,0
35,8476453,Nikita Kucherov,R,TBL,31,82,41,90,131
35,8477492,Nathan MacKinnon,C,COL,29,82,34,97,131
35,8478402,Connor McDavid,C,EDM,27,77,42,77,119
35,8478420,Mikko Rantanen,R,COL,28,80,52,63,115
35,8481559,Jack Hughes,C,NJD,23,75,46,64,110
35,8477934,Leon Draisaitl,C,EDM,29,79,46,61,107
35,8477956,David Pastrnak,R,BOS,28,80,45,62,107
35,8480027,Jason Robertson,L,DAL,25,80,39,68,107
35,8478483,Mitch Marner,R,TOR,27,82,37,69,106
35,8476468,J.T. Miller,C,VAN,31,78,36,70,106
35,8478864,Kirill Kaprizov,L,MIN,27,72,53,50,103
35,8479314,Matthew Tkachuk,L,FLA,27,76,35,68,103
35,8478550,Artemi Panarin,L,NYR,33,81,29,70,99
35,8477493,Aleksander Barkov,C,FLA,29,79,22,77,99
35,8477946,Dylan Larkin,C,DET,28,81,43,55,98
35,8479318,Auston Matthews,C,TOR,27,81,49,43,92
35,8478010,Brayden Point,C,TBL,28,82,45,46,91
35,8480800,Quinn Hughes,D,VAN,25,71,14,77,91
35,8477501,Valeri Nichushkin,R,COL,29,82,48,42,90
35,8476389,Vincent Trocheck,C,NYR,31,80,33,56,89
35,8482116,Tim Stützle,C,OTT,22,81,33,54,87
35,8480002,Nico Hischier,C,NJD,25,79,32,55,87
35,8477960,Adrian Kempe,R,LAK,28,81,39,47,86
35,8477939,William Nylander,R,TOR,28,77,33,53,86
35,8480023,Robert Thomas,C,STL,25,77,26,60,86
35,8476887,Filip Forsberg,L,NSH,30,74,38,47,85
35,8480801,Brady Tkachuk,L,OTT,25,79,35,49,84
35,8478403,Jack Eichel,C,VGK,28,77,29,55,84
35,8479420,Tage Thompson,C,BUF,27,77,51,32,83
35,8477933,Sam Reinhart,C,FLA,29,79,40,43,83
35,8479337,Alex DeBrincat,R,DET,27,81,37,46,83
35,8479407,Jesper Bratt,L,NJD,26,74,25,58,83
35,8478445,Mathew Barzal,C,NYI,27,82,17,66,83
35,8478427,Sebastian Aho,C,CAR,27,69,31,51,82
35,8480012,Elias Pettersson,C,VAN,26,76,31,51,82
35,8480036,Miro Heiskanen,D,DAL,25,81,19,63,82
35,8480865,Noah Dobson,D,NYI,24,79,23,58,81
35,8476454,Ryan Nugent-Hopkins,C,EDM,31,78,25,55,80
35,8477404,Jake Guentzel,C,TBL,30,82,34,45,79
35,8475913,Mark Stone,R,VGK,32,72,28,51,79
35,8477409,Carter Verhaeghe,C,FLA,29,77,39,39,78
35,8476459,Mika Zibanejad,C,NYR,31,78,29,49,78
35,8479343,Clayton Keller,R,UTA,26,73,24,54,78
35,8473512,Claude Giroux,R,OTT,36,79,23,55,78
35,8475692,Mats Zuccarello,R,MIN,37,72,17,61,78
35,8475754,Brock Nelson,C,NYI,33,78,36,41,77
35,8471675,Sidney Crosby,C,PIT,37,72,35,42,77
35,8476881,Tomas Hertl,C,VGK,31,77,31,46,77
35,8481557,Matt Boldy,L,MIN,23,74,29,48,77
35,8480018,Nick Suzuki,C,MTL,25,76,29,47,76
35,8478460,Zach Werenski,D,CBJ,27,80,17,59,76
35,8477951,Nick Schmaltz,C,UTA,28,78,31,44,75
35,8473419,Brad Marchand,L,BOS,36,80,30,45,75
35,8475172,Nazem Kadri,C,CGY,34,79,29,46,75
35,8478449,Roope Hintz,C,DAL,28,82,30,44,74
35,8474564,Steven Stamkos,C,NSH,34,71,26,47,73
35,8479323,Adam Fox,D,NYR,26,72,18,55,73
35,8479542,Brandon Hagel,L,TBL,26,82,31,41,72
35,8479385,Jordan Kyrou,C,STL,26,75,32,39,71
35,8477402,Pavel Buchnevich,L,STL,29,76,28,43,71
35,8475166,John Tavares,C,TOR,34,74,24,47,71
35,8480208,Drake Batherson,R,OTT,26,79,22,49,71
35,8475726,Tyler Toffoli,C,SJS,32,70,35,35,70
35,8475168,Matt Duchene,C,DAL,33,80,24,46,70
35,8476346,Johnny Gaudreau,L,CBJ,31,74,14,55,69
35,8475184,Chris Kreider,L,NYR,33,71,39,28,67
35,8482740,Wyatt Johnston,C,DAL,21,81,32,35,67
35,8477500,Bo Horvat,C,NYI,29,81,30,37,67
35,8477942,Kevin Fiala,L,LAK,28,82,29,38,67
35,8477496,Elias Lindholm,C,BOS,30,78,27,40,67
35,8474679,Gustav Nyquist,C,NSH,35,73,24,43,67
35,8474578,Erik Karlsson,D,PIT,34,79,19,48,67
35,8478439,Travis Konecny,R,PHI,27,74,28,38,66
35,8480015,Owen Tippett,R,PHI,25,77,28,38,66
35,8480069,Cale Makar,D,COL,26,69,23,43,66
35,8478398,Kyle Connor,L,WPG,28,72,32,33,65
35,8484144,Connor Bedard,C,CHI,19,64,30,35,65
35,8478444,Brock Boeser,R,VAN,27,75,33,31,64
35,8474150,Mikael Backlund,C,CGY,35,77,25,39,64
35,8479999,Casey Mittelstadt,C,COL,26,81,22,42,64
35,8471215,Evgeni Malkin,C,PIT,38,75,22,42,64
35,8474600,Roman Josi,D,NSH,34,71,20,44,64
35,8474590,John Carlson,D,WSH,34,72,18,46,64
35,8477416,Oliver Bjorkstrand,R,SEA,29,74,32,31,63
35,8475786,Zach Hyman,L,EDM,32,73,32,31,63
35,8476448,William Karlsson,C,VGK,31,79,30,33,63
35,8479675,Trevor Moore,L,LAK,29,82,26,37,63
35,8475167,Victor Hedman,D,TBL,34,80,12,51,63
35,8479325,Charlie McAvoy,D,BOS,27,77,12,51,63
35,8477504,Josh Morrissey,D,WPG,29,71,11,52,63
35,8480803,Evan Bouchard,D,EDM,25,77,9,54,63
35,8478414,Timo Meier,R,NJD,28,73,31,31,62
35,8482124,Quinton Byfield,R,LAK,22,81,22,40,62
35,8474141,Patrick Kane,R,DET,36,82,28,33,61
35,8478493,Joel Eriksson Ek,C,MIN,27,73,29,31,60
35,8475765,Vladimir Tarasenko,R,DET,33,81,27,33,60
35,8476456,Jonathan Huberdeau,C,CGY,31,76,14,46,60
35,8476853,Morgan Rielly,D,TOR,30,69,8,52,60
35,8471214,Alex Ovechkin,L,WSH,39,68,30,29,59
35,8473986,Alex Killorn,L,ANA,35,74,23,36,59
35,8476539,Jonathan Marchessault,R,NSH,34,72,30,28,58
35,8477955,Jared McCann,L,SEA,28,77,27,31,58
35,8482699,Dylan Guenther,R,UTA,21,75,21,37,58
35,8475158,Ryan O'Reilly,C,NSH,33,75,20,38,58
35,8477949,Alex Tuch,R,BUF,28,72,19,39,58
35,8481711,Matias Maccelli,L,UTA,24,75,15,43,58
35,8471685,Anze Kopitar,C,LAK,37,78,14,44,58
35,8474102,David Perron,L,OTT,36,78,30,27,57
35,8482093,Seth Jarvis,C,CAR,22,65,24,33,57
35,8482078,Lucas Raymond,L,DET,22,78,21,36,57
35,8478873,Troy Terry,R,ANA,27,75,19,38,57
35,8477447,Shea Theodore,D,VGK,29,61,11,46,57
35,8475784,Jeff Skinner,C,EDM,32,74,33,23,56
35,8475170,Brayden Schenn,C,STL,33,75,20,36,56
35,8478474,Lawson Crouse,L,UTA,27,76,32,23,55
35,8477940,Nikolaj Ehlers,L,WPG,28,74,21,34,55
35,8482665,Matty Beniers,C,SEA,22,74,20,35,55
35,8478038,Devon Toews,D,COL,30,74,11,44,55
35,8475810,Bryan Rust,R,PIT,32,69,21,33,54
35,8482113,Anton Lundell,C,FLA,23,77,21,33,54
35,8476460,Mark Scheifele,C,WPG,31,68,19,35,54
35,8475794,Tyler Seguin,C,DAL,32,82,27,26,53
35,8481540,Cole Caufield,R,MTL,23,79,27,26,53
35,8477407,Anthony Duclair,L,NYI,29,82,26,27,53
35,8477429,Andrew Copp,C,DET,30,81,19,34,53
35,8471724,Kris Letang,D,PIT,37,81,11,42,53
35,8477964,Ivan Barbashev,C,VGK,29,71,26,26,52
35,8481528,Dylan Cozens,C,BUF,23,73,24,28,52
35,8477511,Anthony Mantha,R,CGY,30,71,20,32,52
35,8475798,Mikael Granlund,C,SJS,32,64,13,39,52
35,8480064,Josh Norris,C,OTT,25,74,28,23,51
35,8479339,Patrik Laine,L,CBJ,26,60,22,29,51
35,8481068,Yegor Sharangovich,C,CGY,26,77,21,30,51
35,8478440,Dylan Strome,C,WSH,27,75,21,30,51
35,8478975,Mason Marchment,L,DAL,29,78,21,30,51
35,8478519,Anthony Cirelli,C,TBL,27,81,21,30,51
35,8483515,Juraj Slafkovsky,L,MTL,20,75,19,32,51
35,8477935,Sam Bennett,C,FLA,28,78,18,33,51
35,8474586,Jordan Eberle,R,SEA,34,70,17,34,51
35,8482159,Tyson Foerster,R,PHI,22,78,26,24,50
35,8475191,Reilly Smith,R,NYR,33,73,22,28,50
35,8473994,Jamie Benn,L,DAL,35,82,16,34,50
35,8475151,Kyle Palmieri,C,NYI,33,78,28,21,49
35,8482475,Yegor Chinakhov,R,CBJ,23,71,24,25,49
35,8476399,Blake Coleman,C,CGY,33,76,23,26,49
35,8482109,Alexis Lafrenière,L,NYR,23,73,22,27,49
35,8478401,Pavel Zacha,C,BOS,27,78,21,28,49
35,8475745,Charlie Coyle,C,BOS,32,78,20,29,49
35,8474563,Drew Doughty,D,LAK,35,74,12,37,49
35,8481542,Moritz Seider,D,DET,23,75,7,42,49
35,8480839,Rasmus Dahlin,D,BUF,24,67,6,43,49
35,8478498,Jake DeBrusk,L,VAN,28,70,27,21,48
35,8480039,Martin Necas,C,CAR,25,68,22,26,48
35,8482745,Mason McTavish,C,ANA,21,73,22,26,48
35,8481560,Arthur Kaliyev,R,LAK,23,79,20,28,48
35,8478047,Michael Bunting,L,PIT,29,72,20,28,48
35,8478407,Vince Dunn,D,SEA,28,69,13,35,48
35,8476905,Chandler Stephenson,C,SEA,30,72,12,36,48
35,8477932,Aaron Ekblad,D,FLA,28,75,12,36,48
35,8480014,Gabriel Vilardi,C,WPG,25,66,34,13,47
35,8477476,Artturi Lehkonen,L,COL,29,82,22,25,47
35,8482702,Logan Stankoven,C,DAL,21,82,19,28,47
35,8476479,Phillip Danault,C,LAK,31,82,18,29,47
35,8477494,Jonathan Drouin,L,COL,29,81,17,30,47
35,8478856,Conor Garland,R,VAN,28,77,16,31,47
35,8479425,Filip Hronek,D,VAN,27,73,15,32,47
35,8476792,Torey Krug,D,STL,33,71,15,32,47
35,8476906,Shayne Gostisbehere,D,CAR,31,76,14,33,47
35,8478469,Thomas Chabot,D,OTT,27,70,12,35,47
35,8478233,Andrew Mangiapane,L,WSH,28,67,25,21,46
35,8481186,Logan O'Connor,R,COL,28,78,21,25,46
35,8478462,Nicolas Roy,C,VGK,27,77,19,27,46
35,8474641,Adam Henrique,C,EDM,34,74,19,27,46
35,8478438,Tommy Novak,C,NSH,27,70,18,28,46
35,8476882,Teuvo Teravainen,C,CHI,30,64,17,29,46
35,8475287,Erik Haula,L,NJD,33,76,17,29,46
35,8481533,Trevor Zegras,C,ANA,23,71,16,30,46
35,8475753,Justin Faulk,D,STL,32,76,13,33,46
35,8476432,Boone Jenner,C,CBJ,31,74,24,21,45
35,8476483,Rickard Rakell,R,PIT,31,67,22,23,45
35,8483808,Andrei Kuzmenko,L,CGY,28,77,20,25,45
35,8478472,Mathieu Joseph,R,STL,27,68,19,26,45
35,8477426,Nicholas Paul,L,TBL,29,82,19,25,44
35,8481596,Shane Pinto,C,OTT,24,77,17,27,44
35,8482092,Ridly Greig,C,OTT,22,76,17,27,44
35,8482660,Kent Johnson,C,CBJ,22,65,15,29,44
35,8481618,Alex Newhook,C,MTL,23,77,14,30,44
35,8478042,Viktor Arvidsson,L,EDM,31,74,18,25,43
35,8478115,Pierre Engvall,L,NYI,28,74,17,26,43
35,8476872,Scott Laughton,C,PHI,30,72,13,30,43
35,8476958,Jaccob Slavin,D,CAR,30,72,10,33,43
35,8474565,Alex Pietrangelo,D,VGK,34,69,9,34,43
35,8476875,Mike Matheson,D,MTL,30,72,6,37,43
35,8478366,Frank Vatrano,R,ANA,30,71,23,19,42
35,8480028,Morgan Frost,C,PHI,25,76,16,26,42
35,8477021,Alex Kerfoot,C,UTA,30,76,15,27,42
35,8478466,Daniel Sprong,R,VAN,27,75,15,27,42
35,8477346,MacKenzie Weegar,D,CGY,30,73,14,28,42
35,8482105,Jake Sanderson,D,OTT,22,77,12,30,42
35,8480434,Sean Durzi,D,UTA,26,72,10,32,42
35,8476462,Dougie Hamilton,D,NJD,31,69,9,33,42
35,8477998,Warren Foegele,L,LAK,28,80,19,22,41
35,8477479,Tyler Bertuzzi,L,CHI,29,67,16,25,41
35,8483431,Logan Cooley,C,UTA,20,72,15,26,41
35,8484145,Zach Benson,L,BUF,19,73,12,29,41
35,8478055,Gustav Forsling,D,FLA,28,74,8,33,41
35,8478396,Noah Hanifin,D,VGK,27,60,7,34,41
35,8482684,Luke Hughes,D,NJD,21,69,6,35,41
35,8481604,Pavel Dorofeyev,L,VGK,24,70,22,18,40
35,8484166,Adam Fantilli,C,CBJ,20,64,20,20,40
35,8482110,Dawson Mercer,C,NJD,23,74,20,20,40
35,8480185,Eetu Luostarinen,C,FLA,26,75,19,21,40
35,8480855,Jack McBain,C,UTA,24,69,16,24,40
35,8477444,Andre Burakovsky,L,SEA,29,69,15,25,40
35,8479992,Michael Rasmussen,C,DET,25,76,14,26,40
35,8470613,Brent Burns,D,CAR,39,73,10,30,40
35,8482705,Cole Sillinger,C,CBJ,21,71,19,20,39
35,8475768,Jaden Schwartz,C,SEA,32,69,19,20,39
35,8478046,Danton Heinen,L,VAN,29,68,19,20,39
35,8476419,Jean-Gabriel Pageau,C,NYI,32,78,18,21,39
35,8481554,Kaapo Kakko,R,NYR,23,67,17,22,39
35,8476461,Sean Couturier,C,PHI,32,71,17,22,39
35,8477986,Brandon Montour,D,SEA,30,73,15,24,39
35,8481577,Philip Tomasino,C,NSH,23,68,13,26,39
35,8479365,Trent Frederic,C,BOS,26,75,13,26,39
35,8479410,Mikhail Sergachev,D,UTA,26,70,9,30,39
35,8477948,Travis Sanheim,D,PHI,28,65,8,31,39
35,8476438,Brandon Saad,L,STL,32,73,25,13,38
35,8475314,Anders Lee,L,NYI,34,78,23,15,38
35,8475799,Nino Niederreiter,R,WPG,32,69,22,16,38
35,8475169,Evander Kane,L,EDM,33,73,18,20,38
35,8475714,Calle Jarnkrok,C,TOR,33,75,17,21,38
35,8479987,Morgan Geekie,C,BOS,26,79,15,23,38
35,8480798,Philipp Kurashev,C,CHI,25,63,13,25,38
35,8475763,Kevin Hayes,R,PIT,32,72,13,25,38
35,8483505,Matthew Poitras,C,BOS,20,70,13,25,38
35,8482667,William Eklund,L,SJS,22,70,12,26,38
35,8481524,Bowen Byram,D,BUF,23,73,10,28,38
35,8479525,Ross Colton,C,COL,28,77,21,16,37
35,8477952,Robby Fabbri,C,ANA,28,69,19,18,37
35,8476880,Tom Wilson,R,WSH,30,70,17,20,37
35,8482133,Thomas Bordeleau,C,SJS,22,64,17,20,37
35,8480830,Andrei Svechnikov,R,CAR,24,66,14,23,37
35,8477503,Max Domi,C,TOR,29,78,14,23,37
35,8484153,Leo Carlsson,C,ANA,20,68,14,23,37
35,8471698,T.J. Oshie,R,WSH,38,65,14,23,37
35,8478397,Rasmus Andersson,D,CGY,28,71,5,32,37
35,8475760,Nick Bjugstad,C,UTA,32,75,18,18,36
35,8482146,Luke Evangelista,R,NSH,22,72,15,21,36
35,8474149,Evgenii Dadonov,R,DAL,35,79,14,22,36
35,8480797,Joel Farabee,L,PHI,24,76,12,24,36
35,8482149,Cole Perfetti,C,WPG,22,64,12,24,36
35,8474716,Jared Spurgeon,D,MIN,35,77,12,24,36
35,8476292,Ondrej Palat,L,NJD,33,63,9,27,36
35,8482122,Brock Faber,D,MIN,22,80,7,29,36
35,8479368,Max Jones,L,BOS,26,67,24,11,35
35,8477456,J.T. Compher,L,DET,29,82,19,16,35
35,8482055,Drew O'Connor,L,PIT,26,66,19,16,35
35,8480113,Alex Iafallo,L,WPG,31,68,19,16,35
35,8478542,Evan Rodrigues,C,FLA,31,75,15,20,35
35,8479400,Pierre-Luc Dubois,L,WSH,26,73,13,22,35
35,8480849,Barrett Hayton,C,UTA,24,69,12,23,35
35,8477497,Sean Monahan,C,CBJ,30,64,11,24,35
35,8476917,Adam Pelech,D,NYI,30,81,5,30,35
35,8482097,Jack Quinn,R,BUF,23,65,20,14,34
35,8480835,Jack Drury,C,CAR,24,64,16,18,34
35,8478020,Michael Amadio,R,OTT,28,71,15,19,34
35,8477505,Alexander Wennberg,C,SJS,30,67,14,20,34
35,8479390,Taylor Raddysh,R,WSH,26,68,13,21,34
35,8478458,John (Jack) Roslovic,C,CAR,27,67,10,24,34
35,8476927,Teddy Blueger,C,VAN,30,71,8,26,34
35,8476902,Esa Lindell,D,DAL,30,72,7,27,34
35,8479619,Michael Carcone,L,UTA,28,63,22,11,33
35,8474715,Cameron Atkinson,R,TBL,35,79,17,16,33
35,8473422,Nick Foligno,L,CHI,37,66,16,17,33
35,8475848,Brendan Gallagher,R,MTL,32,71,16,17,33
35,8477987,Ryan Donato,C,CHI,28,60,15,18,33
35,8480459,Pius Suter,C,VAN,28,71,14,19,33
35,8480188,Fabian Zetterlund,L,SJS,25,67,13,20,33
35,8482720,Matthew Knies,L,TOR,22,74,13,20,33
35,8477451,Ryan Hartman,R,MIN,30,71,10,23,33
35,8480817,K'Andre Miller,D,NYR,24,69,9,24,33
35,8477495,Seth Jones,D,CHI,30,67,5,28,33
35,8482079,Marco Rossi,C,MIN,23,62,16,16,32
35,8479351,Sam Steel,C,DAL,26,79,14,18,32
35,8476897,Oskar Sundqvist,C,STL,30,70,11,21,32
35,8476458,Ryan Strome,C,ANA,31,74,6,26,32
35,8476854,Hampus Lindholm,D,BOS,30,69,6,26,32
35,8476463,Jonas Brodin,D,MIN,31,78,6,26,32
35,8480145,Neal Pionk,D,WPG,29,78,5,27,32
35,8475764,Cam Fowler,D,ANA,33,75,2,30,32
35,8481523,Kirby Dach,C,MTL,23,61,20,11,31
35,8476981,Josh Anderson,R,MTL,30,73,18,13,31
35,8476921,Jordan Martinook,L,CAR,32,62,16,15,31
35,8482175,JJ Peterka,R,BUF,22,73,16,15,31
35,8478057,Dakota Joshua,C,VAN,28,67,14,17,31
35,8476278,Colin Blackwell,C,DAL,31,78,14,17,31
35,8475793,Ryan Johansen,C,PHI,32,74,13,18,31
35,8482809,Jackson Blake,R,CAR,21,63,10,21,31
35,8477839,Conor Sheary,L,TBL,32,80,9,22,31
35,8482671,Owen Power,D,BUF,22,63,6,25,31
35,8475218,Mattias Ekholm,D,EDM,34,78,5,26,31
35,8477506,Ryan Pulock,D,NYI,30,76,4,27,31
35,8480009,Eeli Tolvanen,R,SEA,25,70,16,14,30
35,8475722,Jason Zucker,L,BUF,32,69,16,14,30
35,8480078,Filip Chytil,C,NYR,25,65,13,17,30
35,8478891,Mason Appleton,C,WPG,28,59,12,18,30
35,8480336,Sean Walker,D,CAR,30,79,10,20,30
35,8482624,Daniil Miromanov,D,CGY,27,64,9,21,30
35,8476885,Jacob Trouba,D,NYR,30,70,7,23,30
35,8474053,Logan Couture,C,SJS,35,57,6,24,30
35,8482712,Oskar Olausson,R,COL,22,73,6,24,30
35,8481624,Ilya Mikheyev,R,CHI,30,63,16,13,29
35,8479591,Michael Eyssimont,C,TBL,28,82,14,15,29
35,8482089,Jake Neighbours,L,STL,22,73,13,16,29
35,8482679,Matt Coronato,R,CGY,22,67,13,16,29
35,8476826,Yanni Gourde,C,SEA,33,73,11,18,29
35,8477488,Brett Pesce,D,NJD,30,70,10,19,29
35,8479345,Jakob Chychrun,D,WSH,26,66,9,20,29
35,8477498,Darnell Nurse,D,EDM,29,67,7,22,29
35,8481606,Jordan Spence,D,LAK,23,66,7,22,29
35,8477969,Marcus Pettersson,D,PIT,28,77,5,24,29
35,8479324,Ryan Lindgren,D,NYR,26,61,4,25,29
35,8474151,Ryan McDonagh,D,TBL,35,77,3,26,29
35,8482259,Bobby McMann,C,TOR,28,61,18,10,28
35,8481535,Nils Hoglander,L,VAN,24,66,17,11,28
35,8482101,Danil Gushchin,L,SJS,22,61,16,12,28
35,8479353,Brett Howden,C,VGK,26,67,14,14,28
35,8482125,Alexander Holtz,R,VGK,22,70,13,15,28
35,8480829,Jesperi Kotkaniemi,C,CAR,24,60,11,17,28
35,8477947,Sonny Milano,L,WSH,28,61,11,17,28
35,8476923,Damon Severson,D,CBJ,30,79,7,21,28
35,8477507,Nikita Zadorov,D,BOS,29,72,7,21,28
35,8476869,Brady Skjei,D,NSH,30,72,6,22,28
35,8476979,Erik Gustafsson,D,DET,32,75,1,27,28
35,8479661,Tanner Jeannot,L,LAK,27,72,16,11,27
35,8476918,Jimmy Vesey,L,NYR,31,65,16,11,27
35,8478463,Anthony Beauvillier,L,PIT,27,69,14,13,27
35,8475343,Nic Dowd,C,WSH,34,60,14,13,27
35,8479393,Noah Gregor,L,OTT,26,75,13,14,27
35,8476474,Stefan Noesen,R,NJD,31,70,9,18,27
35,8473533,Jordan Staal,C,CAR,36,66,9,18,27
35,8482749,Joshua Roy,R,MTL,21,69,9,18,27
35,8478970,Jalen Chatfield,D,CAR,28,73,9,18,27
35,8481656,Aliaksei Protas,C,WSH,23,63,7,20,27
35,8475171,Oliver Ekman-Larsson,D,TOR,33,65,7,20,27
35,8477919,Frederick Gaudreau,C,MIN,31,59,14,12,26
35,8480813,Joe Veleno,C,DET,24,78,11,15,26
35,8476392,Adam Lowry,C,WPG,31,63,10,16,26
35,8476925,Colton Sissons,C,NSH,31,69,9,17,26
35,8475200,Dmitry Orlov,D,CAR,33,72,8,18,26
35,8475193,Tomas Tatar,L,NJD,34,71,8,18,26
35,8481546,Cam York,D,PHI,23,72,5,21,26
35,8481703,Valtteri Puustinen,R,PIT,25,59,5,21,26
35,8473507,Jeff Petry,D,DET,37,73,5,21,26
35,8481581,Thomas Harley,D,DAL,23,74,4,22,26
35,8476878,Zemgus Girgensons,C,TBL,30,80,16,9,25
35,8477478,William Carrier,L,CAR,30,61,15,10,25
35,8476960,Andreas Athanasiou,C,CHI,30,59,14,11,25
35,8477425,Miles Wood,L,COL,29,75,13,12,25
35,8475220,Marcus Foligno,L,MIN,33,63,12,13,25
35,8477989,Christian Dvorak,C,MTL,28,61,12,13,25
35,8479370,Tyson Jost,C,CAR,26,54,12,13,25
35,8478413,Jordan Greenway,L,BUF,27,69,11,14,25
35,8482117,Lukas Reichel,L,CHI,22,59,10,15,25
35,8477953,Kasperi Kapanen,R,STL,28,64,9,16,25
35,8480878,Nils Lundkvist,D,DAL,24,70,8,17,25
35,8478133,Jake Evans,C,MTL,28,69,7,18,25
35,8482655,Janis Moser,D,TBL,24,76,7,18,25
35,8479639,Dylan Coghlan,D,WPG,26,62,4,21,25
35,8480049,Dylan Samberg,D,WPG,25,67,0,25,25
35,8480220,Noah Cates,L,PHI,25,77,13,11,24
35,8481032,Paul Cotter,C,NJD,25,58,13,11,24
35,8480281,Alexey Toropchenko,R,STL,25,64,12,12,24
35,8477392,Hudson Fasching,R,NYI,29,63,11,13,24
35,8476422,Mike Reilly,D,NYI,31,73,10,14,24
35,8484203,Bradly Nadeau,L,CAR,19,62,9,15,24
35,8478109,Victor Olofsson,L,VGK,29,71,8,16,24
35,8476480,Vladislav Namestnikov,C,WPG,32,61,8,16,24
35,8481481,Blake Lizotte,C,PIT,27,63,7,17,24
35,8481441,Joe Snively,C,DET,28,67,7,17,24
35,8477015,Connor Brown,R,EDM,30,65,7,17,24
35,8480871,Adam Boqvist,D,FLA,24,71,6,18,24
35,8481014,Alexander Romanov,D,NYI,24,75,4,20,24
35,8480043,Timothy Liljegren,D,TOR,25,71,3,21,24
35,8482073,Braden Schneider,D,NYR,23,60,2,22,24
35,8480873,Rasmus Sandin,D,WSH,24,62,1,23,24
35,8481582,Nicholas Robertson,L,TOR,23,69,16,7,23
35,8480893,Kirill Marchenko,R,CBJ,24,56,15,8,23
35,8475149,Marcus Johansson,L,MIN,34,69,15,8,23
35,8481704,Juuso Parssinen,C,NSH,23,60,12,11,23
35,8480762,Eric Robinson,L,CAR,29,63,11,12,23
35,8482803,Olen Zellweger,D,ANA,21,67,9,14,23
35,8480789,Oliver Wahlstrom,R,NYI,24,68,8,15,23
35,8475231,Casey Cizikas,C,NYI,33,70,8,15,23
35,8483490,Pavel Mintyukov,D,ANA,21,63,6,17,23
35,8478500,Ivan Provorov,D,CBJ,27,76,4,19,23
35,8475181,Nick Leddy,D,STL,33,72,4,19,23
35,8476988,Matt Benning,D,SJS,30,62,4,19,23
35,8476331,Dylan DeMelo,D,WPG,31,72,3,20,23
35,8474574,Tyler Myers,D,VAN,34,69,3,20,23
35,8480222,Sebastian Aho,D,PIT,28,75,3,20,23
35,8482074,Connor Zary,C,CGY,23,66,15,7,22
35,8478569,Noel Acciari,C,PIT,33,60,14,8,22
35,8478043,Sam Lafferty,C,BUF,29,61,11,11,22
35,8480205,Emil Bemstrom,C,PIT,25,66,11,11,22
35,8477406,Mattias Janmark,C,EDM,32,65,9,13,22
35,8483565,Nick Blankenburg,D,NSH,26,58,9,13,22
35,8480003,Jesper Boqvist,C,FLA,26,70,9,13,22
35,8478013,Jake Walman,D,SJS,28,66,8,14,22
35,8482111,Justin Barron,D,MTL,23,69,7,15,22
35,8482737,Zack Bolduc,C,STL,21,59,7,15,22
35,8479293,Brandon Tanev,L,SEA,33,60,5,17,22
35,8476891,Matthew Grzelcyk,D,PIT,30,76,4,18,22
35,8479402,Jake Bean,D,CGY,26,65,4,18,22
35,8476525,Colin Miller,D,WPG,32,62,3,19,22
35,8476469,Joel Armia,R,MTL,31,67,12,9,21
35,8480068,Ryan Poehling,C,PHI,25,68,11,10,21
35,8479996,Cody Glass,C,NSH,25,58,11,10,21
35,8477446,Michael McCarron,R,NSH,29,59,11,10,21
35,8479336,Carl Grundstrom,R,SJS,27,49,9,12,21
35,8480802,Ryan McLeod,C,BUF,25,66,7,14,21
35,8477353,Tyler Motte,C,DET,29,74,7,14,21
35,8476329,Travis Boyd,C,MIN,31,50,7,14,21
35,8482067,Connor Mackey,D,NYR,28,61,6,15,21
35,8478882,Vladislav Gavrikov,D,LAK,29,69,6,15,21
35,8479983,Mario Ferraro,D,SJS,26,67,2,19,21
35,8480891,Michael Kesselring,D,UTA,24,59,1,20,21
35,8479941,Justin Danforth,R,CBJ,31,60,13,7,20
35,8481580,Connor McMichael,C,WSH,23,54,13,7,20
35,8482077,Dylan Holloway,L,EDM,23,62,13,7,20
35,8479066,Ryan Lomberg,L,CGY,30,65,13,7,20
35,8480748,Kiefer Sherwood,L,VAN,29,60,11,9,20
35,8480144,David Kampf,C,TOR,29,73,11,9,20
35,8475791,Taylor Hall,L,CHI,33,54,9,11,20
35,8474189,Lars Eller,C,PIT,35,61,8,12,20
35,8483457,Lane Hutson,D,MTL,20,65,8,12,20
35,8480011,Klim Kostin,C,SJS,25,52,8,12,20
35,8481521,Ronnie Attard,D,PHI,25,60,7,13,20
35,8477979,Nicolas Aube-Kubel,R,BUF,28,54,6,14,20
35,8483499,Liam Ohgren,L,MIN,20,57,4,16,20
35,8478416,Erik Cernak,D,TBL,27,72,4,16,20
35,8479976,Juuso Valimaki,D,UTA,26,67,2,18,20
35,8479398,Samuel Girard,D,COL,26,67,2,18,20
35,8476467,Jamie Oleksiak,D,SEA,32,66,1,19,20
35,8483482,Tristan Luneau,D,ANA,20,63,11,8,19
35,8480448,Parker Kelly,L,COL,25,74,9,10,19
35,8477903,Garnet Hathaway,R,PHI,33,61,9,10,19
35,8483468,Jiri Kulich,C,BUF,20,54,7,12,19
35,8480806,Isac Lundestrom,C,ANA,25,58,7,12,19
35,8470621,Corey Perry,R,EDM,39,63,6,13,19
35,8483445,Cutter Gauthier,L,ANA,20,65,5,14,19
35,8473563,Nicklas Backstrom,C,WSH,37,50,3,16,19
35,8477365,Connor Clifton,D,BUF,29,58,1,18,19
35,8480172,Jan Rutta,D,SJS,34,72,1,18,19
35,8478508,Yakov Trenin,C,MIN,27,58,10,8,18
35,8476374,Sean Kuraly,C,CBJ,31,63,8,10,18
35,8481093,Rafael Harvey-Pinard,L,MTL,25,54,7,11,18
35,8477450,Jason Dickinson,C,CHI,29,56,7,11,18
35,8476892,Colton Parayko,D,STL,31,64,6,12,18
35,8478911,Matt Roy,D,WSH,29,58,6,12,18
35,8480980,Connor Dewar,C,TOR,25,68,6,12,18
35,8481599,Victor Soderstrom,D,UTA,23,52,6,12,18
35,8481537,Nikita Okhotiuk,D,CGY,24,56,6,12,18
35,8477508,Curtis Lazar,C,NJD,29,59,5,13,18
35,8479026,Philippe Myers,D,TOR,27,44,4,14,18
35,8478451,Ethan Bear,D,WSH,27,44,4,14,18
35,8480058,Pierre-Olivier Joseph,D,STL,25,61,4,14,18
35,8479982,Conor Timmins,D,TOR,26,55,3,15,18
35,8477435,Ryan Graves,D,PIT,29,75,3,15,18
35,8479369,Andrew Peeke,D,BOS,26,62,3,15,18
35,8475324,Nick Jensen,D,OTT,34,65,2,16,18
35,8478507,John Marino,D,UTA,27,59,1,17,18
35,8481553,Bobby Brink,R,PHI,23,57,1,17,18
35,8481178,Egor Zamula,D,PHI,24,57,1,17,18
35,8481477,Nico Sturm,C,SJS,29,54,12,5,17
35,8481601,Simon Holmstrom,R,NYI,23,71,11,6,17
35,8482659,Josh Doan,R,UTA,22,51,11,6,17
35,8479316,Luke Kunin,C,SJS,27,50,8,9,17
35,8484149,Gavin Brindley,C,CBJ,20,50,8,9,17
35,8475790,Erik Gudbranson,D,CBJ,32,80,5,12,17
35,8481708,Zac Jones,D,NYR,24,58,5,12,17
35,8482451,Mikael Pyyhtia,L,CBJ,23,52,5,12,17
35,8477931,Tomas Nosek,L,FLA,32,54,5,12,17
35,8477369,Carson Soucy,D,VAN,30,68,4,13,17
35,8482087,Kaiden Guhle,D,MTL,22,61,4,13,17
35,8476429,Scott Mayfield,D,NYI,32,77,4,13,17
35,8474673,TJ Brodie,D,CHI,34,56,3,14,17
35,8482245,Artem Zub,D,OTT,29,71,3,14,17
35,8478840,Will Borgen,D,SEA,28,67,3,14,17
35,8476879,Cody Ceci,D,EDM,31,72,2,15,17
35,8480035,Henri Jokiharju,D,BUF,25,65,2,15,17
35,8475233,David Savard,D,MTL,34,68,1,16,17
35,8480845,Rasmus Kupari,C,WPG,24,47,10,6,16
35,8479328,Julien Gauthier,R,NYI,27,62,9,7,16
35,8479520,Brandon Duhaime,R,WSH,27,57,9,7,16
35,8482176,Wyatt Kaiser,D,CHI,22,62,8,8,16
35,8479414,Nathan Bastian,R,NJD,27,52,8,8,16
35,8482157,Will Cuylle,L,NYR,22,58,8,8,16
35,8480021,Jack Studnicka,C,LAK,25,57,8,8,16
35,8478432,Christian Fischer,R,DET,27,72,6,10,16
35,8477220,Nate Schmidt,D,FLA,33,61,6,10,16
35,8471709,Marc-Edouard Vlasic,D,SJS,37,62,6,10,16
35,8477070,Liam O'Brien,C,UTA,30,58,6,10,16
35,8482142,Jamie Drysdale,D,PHI,22,62,5,11,16
35,8476931,Jake McCabe,D,TOR,31,66,2,14,16
35,8480246,Nick Perbix,D,TBL,26,71,2,14,16
35,8480073,Erik Brannstrom,D,COL,25,62,1,15,16
35,8479371,Dante Fabbro,D,NSH,26,69,1,15,16
35,8478136,Jake Middleton,D,MIN,28,68,1,15,16
35,8483524,Shane Wright,C,SEA,20,62,10,5,15
35,8483491,Ivan Miroshnichenko,L,WSH,20,63,6,9,15
35,8476856,Mathew Dumba,D,DAL,30,72,6,9,15
35,8475279,Ben Chiarot,D,DET,33,73,6,9,15
35,8480007,Jonas Rondbjerg,R,VGK,25,38,6,9,15
35,8478399,Jonas Siegenthaler,D,NJD,27,55,5,10,15
35,8478851,Alexandre Carrier,D,NSH,28,68,5,10,15
35,8483495,Simon Nemec,D,NJD,20,52,5,10,15
35,8475188,Brayden McNabb,D,VGK,33,51,3,12,15
35,8478452,Caleb Jones,D,LAK,27,57,2,13,15
35,8479986,Kole Lind,R,DAL,26,53,2,13,15
35,8479998,Mikey Anderson,D,LAK,25,62,1,14,15
35,8481716,Dmitri Voronkov,L,CBJ,24,38,10,4,14
35,8473453,Trevor Lewis,C,LAK,37,71,9,5,14
35,8481517,Brett Leason,R,ANA,25,52,9,5,14
35,8480025,MacKenzie Entwistle,R,FLA,25,66,8,6,14
35,8481617,Vasily Podkolzin,R,VAN,23,44,8,6,14
35,8481522,Peyton Krebs,C,BUF,23,54,7,7,14
35,8480074,Alexandre Texier,C,STL,25,49,6,8,14
35,8480289,Morgan Barron,C,WPG,26,53,6,8,14
35,8478434,Keegan Kolesar,R,VGK,27,71,6,8,14
35,8482744,James Malatesta,L,CBJ,21,44,6,8,14
35,8479315,Joey Anderson,R,CHI,26,47,5,9,14
35,8483493,Frank Nazar,C,CHI,20,52,5,9,14
35,8480727,Zach Whitecloud,D,VGK,28,46,5,9,14
35,8481568,Alex Vlasic,D,CHI,23,48,4,10,14
35,8476312,Josh Manson,D,COL,33,58,3,11,14
35,8481161,Jake Christiansen,D,CBJ,25,50,3,11,14
35,8480001,Urho Vaakanainen,D,ANA,25,67,3,11,14
35,8483460,David Jiricek,D,CBJ,21,59,2,12,14
35,8476967,Brett Kulak,D,EDM,30,62,2,12,14
35,8482730,Brandt Clarke,D,LAK,21,48,2,12,14
35,8475690,Chris Tanev,D,TOR,35,62,2,12,14
35,8482155,Alex Laferriere,R,LAK,23,59,9,4,13
35,8481592,Jakob Pelletier,L,CGY,23,37,9,4,13
35,8477018,Ben Hutton,D,VGK,31,50,8,5,13
35,8475762,Derek Forbort,D,VAN,32,42,7,6,13
35,8482166,Shakir Mukhamadullin,D,SJS,22,56,7,6,13
35,8482964,Arber Xhekaj,D,MTL,23,51,6,7,13
35,8475855,Jesper Fast,R,CAR,33,56,5,8,13
35,8476873,Mark Jankowski,C,NSH,30,40,4,9,13
35,8475179,Dmitry Kulikov,D,FLA,34,61,3,10,13
35,8470600,Ryan Suter,D,STL,39,64,3,10,13
35,8474567,Zach Bogosian,D,MIN,34,64,3,10,13
35,8480157,Calle Rosen,D,COL,30,55,3,10,13
35,8480070,Ian Mitchell,D,BOS,25,55,3,10,13
35,8471677,Jack Johnson,D,CBJ,37,68,2,11,13
35,8477845,Trevor van Riemsdyk,D,WSH,33,70,1,12,13
35,8475208,Brian Dumoulin,D,ANA,33,58,1,12,13
35,8475842,Sam Carrick,C,NYR,32,63,8,4,12
35,8479944,Zach Aston-Reese,C,VGK,30,46,7,5,12
35,8476913,Devin Shore,C,MIN,30,41,7,5,12
35,8475235,Nicolas Deslauriers,L,PHI,33,47,6,6,12
35,8482148,Hendrix Lapierre,C,WSH,22,54,5,7,12
35,8480950,Ilya Lyubushkin,D,DAL,30,63,5,7,12
35,8479994,Jaret Anderson-Dolan,C,WPG,25,46,5,7,12
35,8476822,Luke Glendening,C,TBL,35,74,4,8,12
35,8482062,Cole Smith,L,NSH,29,59,4,8,12
35,8482807,Ethan Del Mastro,D,CHI,21,56,4,8,12
35,8477401,John Hayden,C,SEA,29,37,4,8,12
35,8482652,Walker Duehr,R,CGY,27,45,3,9,12
35,8481567,Henry Thrun,D,SJS,23,44,3,9,12
35,8479972,Mason Shaw,C,WPG,26,35,3,9,12
35,8479980,Nicolas Hague,D,VGK,26,58,2,10,12
35,8476457,Adam Larsson,D,SEA,32,65,2,10,12
35,8475462,Radko Gudas,D,ANA,34,64,2,10,12
35,8479372,Joshua Mahura,D,SEA,26,53,2,10,12
35,8481527,Kaedan Korczak,D,VGK,23,49,2,10,12
35,8478178,Darren Raddysh,D,TBL,28,66,2,10,12
35,8482192,Isaak Phillips,D,CHI,23,51,1,11,12
35,8477499,Rasmus Ristolainen,D,PHI,30,60,1,11,12
35,8481059,Scott Perunovich,D,STL,26,55,0,12,12
35,8480887,Jordan Harris,D,MTL,24,49,0,12,12
35,8480355,Mark Kastelic,C,BOS,25,70,8,3,11
35,8476889,Radek Faksa,C,STL,30,55,7,4,11
35,8481641,Joel Kiviranta,L,COL,28,71,7,4,11
35,8477380,Jonny Brodzinski,C,NYR,31,53,7,4,11
35,8478585,Derek Ryan,C,EDM,38,65,5,6,11
35,8477335,Kyle Burroughs,D,LAK,29,41,4,7,11
35,8483466,Kevin Korchinski,D,CHI,20,48,3,8,11
35,8476874,Olli Maatta,D,DET,30,65,3,8,11
35,8484254,Akito Hirose,D,VAN,25,36,3,8,11
35,8475455,Brenden Dillon,D,NJD,34,60,3,8,11
35,8481019,David Gustafsson,C,WPG,24,53,2,9,11
35,8477851,Jordan Oesterle,D,BOS,32,41,1,10,11
35,8482762,Simon Edvinsson,D,DET,21,47,9,1,10
35,8481518,Nolan Foote,L,NJD,24,45,8,2,10
35,8480848,Ty Dellandrea,C,SJS,24,40,7,3,10
35,8471817,Ryan Reaves,R,TOR,37,58,6,4,10
35,8480292,Carson Meyer,R,ANA,27,40,6,4,10
35,8480995,Pontus Holmberg,R,TOR,25,55,5,5,10
35,8481028,Martin Pospisil,C,CGY,25,50,5,5,10
35,8479968,Vinni Lettieri,C,BOS,29,49,5,5,10
35,8479671,Mathieu Olivier,R,CBJ,27,41,5,5,10
35,8475225,Craig Smith,C,CHI,35,39,4,6,10
35,8474034,Patrick Maroon,L,CHI,36,55,3,7,10
35,8478443,Brandon Carlo,D,BOS,28,53,3,7,10
35,8478211,Dryden Hunt,L,CGY,29,57,3,7,10
35,8479985,Cale Fleury,D,SEA,26,39,3,7,10
35,8480796,Martin Fehervary,D,WSH,25,50,2,8,10
35,8480879,Jacob Bernard-Docker,D,OTT,24,60,2,8,10
35,8479348,Kale Clague,D,BUF,26,45,2,8,10
35,8477573,Nathan Walker,L,STL,30,45,2,8,10
35,8481167,Brayden Pachal,D,CGY,25,32,2,8,10
35,8478454,Noah Juulsen,D,VAN,27,36,2,8,10
35,8477962,Brendan Lemieux,L,CAR,28,38,2,8,10
35,8482747,Brennan Othmann,L,NYR,21,43,2,8,10
35,8474090,Brendan Smith,D,DAL,35,49,2,8,10
35,8480860,Kevin Bahl,D,CGY,24,60,1,9,10
35,8478450,Parker Wotherspoon,D,BOS,27,34,0,10,10
35,8478831,Kevin Stenlund,C,UTA,28,44,7,2,9
35,8476994,Vinnie Hinostroza,C,NSH,30,43,6,3,9
35,8478421,A.J. Greer,L,FLA,28,59,5,4,9
35,8479344,Jesse Puljujarvi,R,PIT,26,46,5,4,9
35,8483549,Lucas Condotta,L,MTL,27,33,5,4,9
35,8483397,Marc McLaughlin,C,BOS,25,26,5,4,9
35,8480252,Cole Guttman,C,CHI,25,40,4,5,9
35,8481013,Jonatan Berggren,R,DET,24,51,4,5,9
35,8479718,Alex Barré-Boulet,C,MTL,27,48,4,5,9
35,8479291,Kevin Rooney,C,CGY,31,50,4,5,9
35,8476952,Dominic Toninato,C,WPG,30,35,4,5,9
35,8482634,Alex Steeves,C,TOR,25,51,4,5,9
35,8479638,Justin Brazeau,R,BOS,26,35,4,5,9
35,8483570,Ben Meyers,C,SEA,26,32,4,5,9
35,8476624,Barclay Goodrow,C,SJS,31,58,3,6,9
35,8482095,Tyler Kleven,D,OTT,22,47,3,6,9
35,8482751,Ryan Winterton,C,SEA,21,39,3,6,9
35,8476934,Brock McGinn,L,ANA,30,46,2,7,9
35,8479772,Zack MacEwen,R,OTT,28,53,2,7,9
35,8475750,Jon Merrill,D,MIN,32,56,2,7,9
35,8481122,Simon Benoit,D,TOR,26,42,2,7,9
35,8481751,Lukas Rousek,R,BUF,25,34,1,8,9
35,8478859,Niko Mikkola,D,FLA,28,59,1,8,9
35,8478468,Jeremy Lauzon,D,NSH,27,52,0,9,9
35,8479378,Logan Stanley,D,WPG,26,36,0,9,9
35,8479249,Andrew Poturalski,C,SJS,30,38,0,9,9
35,8477384,Joshua Brown,D,EDM,30,43,0,9,9
35,8479439,Jacob MacDonald,D,COL,31,43,5,3,8
35,8476858,Phillip Di Giuseppe,L,VAN,31,39,5,3,8
35,8476442,Matt Nieto,L,PIT,32,45,4,4,8
35,8480192,Johnathan Kovacevic,D,NJD,27,50,4,4,8
35,8480441,Trey Fix-Wolansky,R,CBJ,25,31,4,4,8
35,8481609,Vladislav Kolyachonok,D,UTA,23,28,4,4,8
35,8477034,Jaycob Megna,D,FLA,32,45,4,4,8
35,8481147,Reese Johnson,C,MIN,26,33,3,5,8
35,8481532,Alex Turcotte,C,LAK,23,51,3,5,8
35,8481598,Philip Broberg,D,EDM,23,39,3,5,8
35,8480196,Jacob Bryson,D,BUF,27,37,2,6,8
35,8482250,Callahan Burke,C,VGK,27,29,0,8,8
35,8482070,Mitchell Chaffee,R,TBL,26,55,7,0,7
35,8482145,Mavrik Bourque,C,DAL,22,48,5,2,7
35,8482859,Zack Ostapchuk,C,OTT,21,50,3,4,7
35,8475177,Calvin de Haan,D,COL,33,45,3,4,7
35,8476372,Nick Seeler,D,PHI,31,46,3,4,7
35,8480880,Jakub Lauko,C,MIN,24,30,3,4,7
35,8482153,Brendan Brisson,C,VGK,23,29,3,4,7
35,8481701,Santeri Hatakka,D,NJD,23,49,2,5,7
35,8479543,Michael Pezzetta,L,MTL,26,55,2,5,7
35,8479359,Beck Malenstyn,L,BUF,26,42,2,5,7
35,8474166,Alec Martinez,D,CHI,37,47,1,6,7
35,8479379,Givani Smith,R,SJS,26,27,1,6,7
35,8473446,Erik Johnson,D,PHI,36,40,1,6,7
35,8478017,Mark Friedman,D,VAN,29,48,1,6,7
35,8481679,Maxence Guenette,D,OTT,23,34,1,6,7
35,8474013,Ian Cole,D,UTA,35,53,0,7,7
35,8479536,Axel Jonsson-Fjallby,L,WPG,26,35,5,1,6
35,8482784,Zach Dean,C,STL,21,40,4,2,6
35,8478146,Matthew Highmore,C,OTT,28,36,4,2,6
35,8481600,Tobias Bjornfot,D,FLA,23,33,4,2,6
35,8481550,Adam Beckman,L,NJD,23,32,3,3,6
35,8480245,Olle Lycksell,R,PHI,25,33,3,3,6
35,8482165,Yan Kuznetsov,D,CGY,22,20,3,3,6
35,8477938,Haydn Fleury,D,WPG,28,44,3,3,6
35,8480844,Grigori Denisenko,L,VGK,24,30,3,3,6
35,8482141,Lukas Cormier,D,VGK,22,24,3,3,6
35,8483630,Pavol Regenda,L,ANA,25,30,3,3,6
35,8474568,Luke Schenn,D,NSH,35,41,2,4,6
35,8481422,Jake Lucchini,C,NSH,29,21,2,4,6
35,8477244,Chad Ruhwedel,D,NYR,34,34,2,4,6
35,8479419,Brett Murray,L,BUF,26,22,2,4,6
35,8480890,Jan Jenik,C,OTT,24,31,2,4,6
35,8479981,Jonah Gadjovich,L,FLA,26,43,1,5,6
35,8479442,Troy Stecher,D,EDM,30,53,1,5,6
35,8474612,Travis Hamonic,D,OTT,34,41,0,6,6
35,8475718,Justin Holl,D,DET,32,53,0,6,6
35,8482733,Logan Mailloux,D,MTL,31,37,0,6,6
35,8477887,Patrick Brown,C,BOS,32,39,4,1,5
35,8482144,Jack Thompson,D,SJS,22,28,4,1,5
35,8477473,Justin Bailey,R,SJS,29,16,4,1,5
35,8480870,Bo Groulx,C,NYR,24,20,3,2,5
35,8479320,Maxime Lajoie,D,SEA,27,22,3,2,5
35,8479367,William Lockwood,R,FLA,26,27,3,2,5
35,8482201,Gage Goncalves,C,TBL,23,30,3,2,5
35,8477320,Anton Blidh,L,NYR,29,19,3,2,5
35,8474062,Riley Nash,C,NYR,35,20,3,2,5
35,8480267,Sammy Walker,C,MIN,25,22,2,3,5
35,8483763,Maksymilian Szuber,D,UTA,22,31,2,3,5
35,8482470,Ilya Solovyov,D,CGY,24,21,2,3,5
35,8478424,Jansen Harkins,C,ANA,27,40,2,3,5
35,8477467,Gustav Olofsson,D,SEA,30,22,2,3,5
35,8480834,Ty Emberson,D,SJS,24,35,1,4,5
35,8483619,Filip Roos,D,OTT,25,24,1,4,5
35,8482861,Vincent Iorio,D,WSH,22,29,1,4,5
35,8482666,Scott Morrow,D,CAR,22,47,1,4,5
35,8481789,Tye Kartye,L,SEA,23,38,1,4,5
35,8477971,Andreas Englund,D,LAK,28,32,1,4,5
35,8479991,Jake Leschyshyn,C,NYR,25,31,1,4,5
35,8477462,Robert Hagg,D,VGK,29,24,1,4,5
35,8481719,Maxwell Crozier,D,TBL,24,20,1,4,5
35,8480807,Mattias Samuelsson,D,BUF,24,50,0,5,5
35,8476441,Joel Edmundson,D,LAK,31,36,0,5,5
35,8482177,Marat Khusnutdinov,C,MIN,22,33,0,5,5
35,8482765,Isak Rosen,R,BUF,21,26,0,5,5
35,8482929,Emil Lilleberg,D,TBL,23,21,0,5,5
35,8477482,Zachary Sanford,L,CHI,30,41,3,1,4
35,8482713,Mackie Samoskevich,R,FLA,22,37,3,1,4
35,8478874,Adam Gaudette,R,OTT,28,32,3,1,4
35,8480468,James Hamblin,L,EDM,25,23,3,1,4
35,8478446,Glenn Gawdin,C,LAK,27,12,3,1,4
35,8481043,Cole Koepke,L,BOS,26,20,3,1,4
35,8481556,John Beecher,C,BOS,23,31,2,2,4
35,8484911,Collin Graf,R,SJS,22,46,2,2,4
35,8483012,Logan Morrison,C,SEA,22,34,2,2,4
35,8479576,Vincent Desharnais,D,VAN,28,27,2,2,4
35,8481030,Jack St. Ivany,D,PIT,25,15,2,2,4
35,8481754,Nikita Nesterenko,C,ANA,23,24,2,2,4
35,8478021,William Lagesson,D,DET,28,31,1,3,4
35,8481605,Jackson LaCombe,D,ANA,23,35,1,3,4
35,8478502,Dennis Gilbert,D,BUF,28,24,1,3,4
35,8476473,Connor Murphy,D,CHI,31,44,0,4,4
35,8481056,Spencer Stastney,D,NSH,24,38,0,4,4
35,8481541,Samuel Bolduc,D,NYI,24,27,0,4,4
35,8475795,Dylan McIlrath,D,WSH,32,21,0,4,4
35,8481593,Jayden Struble,D,MTL,23,20,0,4,4
35,8482496,Nils Aman,C,VAN,24,32,2,1,3
35,8482102,Vasily Ponomarev,C,PIT,22,18,2,1,3
35,8481543,Nikita Alexandrov,C,STL,24,21,2,1,3
35,8484287,Cole McWard,D,VAN,23,22,2,1,3
35,8483597,Milos Kelemen,L,UTA,25,14,2,1,3
35,8476867,Brendan Gaunce,C,MIN,30,27,1,2,3
35,8478409,Anthony Richard,C,PHI,28,24,1,2,3
35,8480990,Declan Chisholm,D,MIN,24,46,1,2,3
35,8477073,Kurtis MacDermid,L,NJD,30,32,1,2,3
35,8478051,Max Willman,C,NJD,29,18,1,2,3
35,8482511,Mason Lohrei,D,BOS,23,29,1,2,3
35,8482516,Matthew Kessel,D,STL,24,18,1,2,3
35,8481578,Graeme Clarke,R,MIN,23,10,1,2,3
35,8481237,Kyle MacLean,C,NYI,25,19,1,2,3
35,8481743,Marc Del Gaizo,D,NSH,25,23,0,3,3
35,8478477,Mitchell Stephens,C,SEA,27,19,0,3,3
35,8477810,Joel Hanley,D,CGY,33,30,0,3,3
35,8477149,Scott Sabourin,R,SJS,32,16,0,3,3
35,8480032,Shane Bowers,C,NJD,25,11,2,0,2
35,8481726,Adam Edstrom,C,NYR,24,12,2,0,2
35,8475958,Michael Sgarbossa,C,WSH,32,31,1,1,2
35,8484258,Sam Malinski,D,COL,26,19,1,1,2
35,8481065,Angus Crookshank,L,OTT,25,13,1,1,2
35,8480851,Akil Thomas,C,LAK,24,17,1,1,2
35,8483567,Georgii Merkulov,C,BOS,24,9,1,1,2
35,8481534,Raphael Lavoie,C,EDM,24,5,1,1,2
35,8478011,Louie Belpedio,D,PHI,28,13,1,1,2
35,8481206,John Ludvig,D,PIT,24,12,1,1,2
35,8482476,Emil Heineman,L,MTL,23,9,1,1,2
35,8482172,Landon Slaggert,L,CHI,22,28,0,2,2
35,8483407,Brandon Scanlin,D,NYR,25,7,0,2,2
35,8477527,Ross Johnston,L,ANA,30,33,1,0,1
35,8480084,Nick DeSimone,D,NJD,30,18,1,0,1
35,8481585,Egor Afanasyev,L,SJS,23,18,1,0,1
35,8483489,Fraser Minten,C,TOR,31,8,1,0,1
35,8483432,Luca Del Bel Belluz,C,CBJ,31,6,1,0,1
35,8481655,Cole Schwindt,R,CGY,23,6,1,0,1
35,8480823,Alexander Alexeyev,D,WSH,25,15,1,0,1
35,8482061,Brandon Biro,L,SEA,26,12,1,0,1
35,8484259,Ondrej Pavel,C,COL,31,5,1,0,1
35,8483512,Matthew Savoie,C,EDM,20,18,0,1,1
35,8482088,Justin Sourdif,R,FLA,22,12,0,1,1
35,8482094,Daemon Hunt,D,MIN,22,14,0,1,1
35,8481699,Aku Raty,R,UTA,23,16,0,1,1
35,8481564,Ryan Johnson,D,BUF,23,10,0,1,1
35,8482858,Ryker Evans,D,SEA,23,16,0,1,1
35,8480874,Adam Ginning,D,PHI,24,12,0,1,1
35,8483395,Arshdeep Bains,L,VAN,23,6,0,1,1
35,8482162,Roby Jarventie,L,EDM,22,16,0,1,1
35,8477541,Dakota Mermis,D,TOR,30,11,0,1,1
35,8480306,Grant Hutton,D,NYI,29,4,0,1,1
35,8481806,Louis Crevier,D,CHI,23,13,0,1,1
35,8481024,Linus Karlsson,C,VAN,25,9,0,1,1
35,8482460,Matt Rempe,C,NYR,22,12,0,1,1
35,8483920,Pierrick Dube,R,WSH,23,5,0,1,1
35,8482147,Jean-Luc Foudy,C,COL,22,24,0,0,0
35,8484325,Waltteri Merela,C,TBL,26,13,0,0,0
35,8475413,Justin Dowling,C,NJD,34,21,0,0,0
35,8479421,Jacob Moverare,D,LAK,26,7,0,0,0
35,8482118,Sam Colangelo,R,ANA,23,21,0,0,0
35,8480075,Cameron Crotty,D,MIN,25,9,0,0,0
35,8479587,Rhett Gardner,C,PHI,28,19,0,0,0
35,8481462,Mason Morelli,L,VGK,28,10,0,0,0
35,8483398,Declan Carlile,D,TBL,31,9,0,0,0
35,8477993,Justin Kirkland,C,CGY,28,5,0,0,0
35,8483546,Marshall Rifai,D,TOR,26,7,0,0,0
35,8484326,Patrik Koch,D,UTA,28,1,0,0,0
35,8481006,Tyler Tucker,D,STL,24,11,0,0,0
35,8483471,Brad Lambert,C,WPG,31,11,0,0,0
35,8484304,Uvis Balinskis,D,FLA,28,13,0,0,0
35,8475755,Alexander Petrovic,D,DAL,32,11,0,0,0
35,8483609,Adam Klapka,R,CGY,24,3,0,0,0
35,8476323,Max McCormick,L,SEA,32,3,0,0,0
35,8478147,Bokondji Imama,L,PIT,28,3,0,0,0
35,8479362,Riley Tufte,L,BOS,26,20,0,0,0
35,8478881,Brett Seney,L,CHI,28,7,0,0,0
35,8484255,Jason Polin,R,COL,25,9,0,0,0
35,8482787,Nikita Chibrikov,R,WPG,31,5,0,0,0
35,8475780,Chris Wagner,R,COL,33,10,0,0,0
35,8482197,Adam Raska,R,MIN,23,8,0,0,0
35,8479330,Brandon Gignac,C,MTL,27,7,0,0,0
35,8483531,Brian Halonen,L,NJD,25,1,0,0,0
35,8480274,Philip Kemp,D,EDM,25,1,0,0,0
35,8482126,Emil Andrae,D,PHI,31,5,0,0,0
35,8478854,Ryan Shea,D,PIT,27,2,0,0,0
35,8479522,Hardy Haman Aktell,D,WSH,26,5,0,0,0
35,8483401,Marc Johnstone,R,PIT,28,1,0,0,0
35,8484321,Nikolas Matinpalo,D,OTT,26,3,0,0,0
35,8470794,Joe Pavelski,C,,40,0,0,0,0
35,8479321,Lucas Johansen,D,,27,0,0,0,0
35,8477950,Tony DeAngelo,D,,29,0,0,0,0
35,8471218,Blake Wheeler,R,,38,0,0,0,0
35,8475197,Tyson Barrie,D,,33,0,0,0,0
35,8474157,Max Pacioretty,L,,36,0,0,0,0
35,8475744,Evgeny Kuznetsov,C,,32,0,0,0,0
35,8474037,James van Riemsdyk,L,,35,0,0,0,0
35,8476907,Mackenzie MacEachern,L,,30,0,0,0,0
35,8480216,Jacob Peterson,C,,25,0,0,0,0
35,8474602,Justin Schultz,D,,34,0,0,0,0
35,8482222,Alexander Barabanov,L,,30,0,0,0,0
35,8474031,Kevin Shattenkirk,D,,35,0,0,0,0
35,8477330,Dominik Kubalik,L,,29,0,0,0,0
35,8480884,Calen Addison,D,,24,0,0,0,0
35,8475906,John Klingberg,D,,32,0,0,0,0
35,8480008,Adam Ruzicka,C,,25,0,0,0,0
35,8476884,Derrick Pouliot,D,,30,0,0,0,0
35,8476919,Chris Tierney,C,,30,0,0,0,0
35,8479415,Michael McLeod,C,,26,0,0,0,0
35,8474870,Tyler Johnson,C,,34,0,0,0,0
35,8470604,Jeff Carter,C,,39,0,0,0,0
35,8478104,Sammy Blais,L,,28,0,0,0,0
35,8474884,Mike Hoffman,C,,35,0,0,0,0
35,8481591,Sam Poulin,R,,23,0,0,0,0
35,8471274,Alex Goligoski,D,,39,0,0,0,0
35,8476871,Tanner Pearson,L,,32,0,0,0,0
35,8476393,Nick Cousins,C,,31,0,0,0,0
35,8479977,Kailer Yamamoto,R,,26,0,0,0,0
35,8479346,Dillon Dube,C,,26,0,0,0,0
35,8480184,Gustav Lindstrom,D,,26,0,0,0,0
35,8479376,Victor Mete,D,,26,0,0,0,0
35,8473449,Kyle Okposo,R,,36,0,0,0,0
35,8481058,Jesse Ylonen,R,,25,0,0,0,0
35,8475752,Tyler Pitlick,C,,33,0,0,0,0
35,8481239,Samuel Fagemo,L,,24,0,0,0,0
35,8480821,Filip Zadina,R,,25,0,0,0,0
35,8470966,Mark Giordano,D,,41,0,0,0,0
35,8478495,Denis Gurianov,R,,27,0,0,0,0
35,8477464,Nic Petan,C,,29,0,0,0,0
35,8478099,Kevin Labanc,R,,29,0,0,0,0
35,8482241,Radim Zohorna,L,,28,0,0,0,0
35,8474040,Sam Gagner,C,,35,0,0,0,0
35,8479514,Rem Pitlick,C,,27,0,0,0,0
35,8478430,Oliver Kylington,D,,27,0,0,0,0
35,8479533,Joona Koppanen,L,,26,0,0,0,0
35,8479984,Cal Foote,D,,26,0,0,0,0
35,8477126,Jayson Megna,C,,34,0,0,0,0
35,8475164,Jakob Silfverberg,R,,34,0,0,0,0
35,8474009,Nick Bonino,C,,36,0,0,0,0
35,8479458,Nikita Zaitsev,D,,33,0,0,0,0
35,8477944,Jakub Vrana,L,,28,0,0,0,0
35,8471699,Andrew Cogliano,C,,37,0,0,0,0
35,8478067,Oskar Lindblom,L,,28,0,0,0,0
35,8471686,Marc Staal,D,,37,0,0,0,0
35,8470610,Zach Parise,L,,40,0,0,0,0
35,8478904,Steven Lorentz,C,,28,0,0,0,0
35,8473473,Milan Lucic,L,,36,0,0,0,0
35,8480031,Maxime Comtois,L,,25,0,0,0,0
35,8478512,Austin Czarnik,C,,32,0,0,0,0
35,8473504,Cal Clutterbuck,R,,37,0,0,0,0
35,8477454,Adam Erne,L,,29,0,0,0,0
35,8479383,Boris Katchouk,L,,26,0,0,0,0
35,8475825,Jani Hakanpää,D,,32,0,0,0,0
35,8477846,Ryan Carpenter,C,,33,0,0,0,0
35,8477930,Pierre-Edouard Bellemare,L,,39,0,0,0,0
35,8478400,Colin White,C,,27,0,0,0,0
35,8480226,Marián Studenic,R,,26,0,0,0,0
35,8480853,Liam Foudy,C,,24,0,0,0,0
35,8475797,Jarred Tinordi,D,,32,0,0,0,0
35,8479423,Alex Nylander,L,,26,0,0,0,0
35,8474618,Marco Scandella,D,,34,0,0,0,0
35,8478028,Fredrik Olofsson,L,,28,0,0,0,0
35,8474709,Matt Martin,L,,35,0,0,0,0
35,8481070,Hugh McGing,L,,26,0,0,0,0
35,8479546,Oskar Steen,C,,26,0,0,0,0
35,8474145,Robert Bortuzzo,D,,35,0,0,0,0
35,8476915,Jujhar Khaira,L,,30,0,0,0,0
35,8475278,Byron Froese,C,,33,0,0,0,0
35,8481812,Nikolai Knyzhov,D,,27,0,0,0,0
35,8478408,Travis Dermott,D,,28,0,0,0,0
35,8481077,John Leonard,L,,26,0,0,0,0
35,8479547,Matthew Phillips,R,,26,0,0,0,0
35,8480836,Jonathan Gruden,C,,24,0,0,0,0
35,8481690,Tyler Angle,C,,24,0,0,0,0
35,8475766,Austin Watson,L,,32,0,0,0,0
35,8481016,Ruslan Iskhakov,C,,24,0,0,0,0
35,8478078,Rourke Chartier,C,,28,0,0,0,0
35,8480776,Sheldon Rempal,R,,29,0,0,0,0
35,8478956,Samuel Laberge,L,NJD,27,0,0,0,0
35,8483045,Cameron Butler,R,CBJ,31,0,0,0,0
35,8484314,Jiri Smejkal,L,,28,0,0,0,0
36,8478402,Connor McDavid,C,EDM,27,81,46,110,156
36,8477492,Nathan MacKinnon,C,COL,29,82,64,83,147
36,8478864,Kirill Kaprizov,L,MIN,27,76,57,67,124
36,8476453,Nikita Kucherov,R,TBL,31,82,39,85,124
36,8477934,Leon Draisaitl,C,EDM,29,79,48,74,122
36,8478550,Artemi Panarin,L,NYR,33,77,41,81,122
36,8477956,David Pastrnak,R,BOS,28,79,55,61,116
36,8477939,William Nylander,R,TOR,28,81,46,69,115
36,8479318,Auston Matthews,C,TOR,27,80,66,48,114
36,8481559,Jack Hughes,C,NJD,23,76,45,69,114
36,8479314,Matthew Tkachuk,L,FLA,27,78,34,78,112
36,8478483,Mitch Marner,R,TOR,27,79,29,79,108
36,8477946,Dylan Larkin,C,DET,28,81,45,61,106
36,8480023,Robert Thomas,C,STL,25,76,29,76,105
36,8480012,Elias Pettersson,C,VAN,26,76,50,54,104
36,8480027,Jason Robertson,L,DAL,25,82,40,61,101
36,8477942,Kevin Fiala,L,LAK,28,82,40,60,100
36,8477493,Aleksander Barkov,C,FLA,29,78,34,66,100
36,8479407,Jesper Bratt,L,NJD,26,78,30,70,100
36,8477933,Sam Reinhart,C,FLA,29,78,42,56,98
36,8478420,Mikko Rantanen,R,COL,28,81,40,56,96
36,8476468,J.T. Miller,C,VAN,31,76,27,69,96
36,8478403,Jack Eichel,C,VGK,28,80,47,48,95
36,8477402,Pavel Buchnevich,L,STL,29,75,43,51,94
36,8478010,Brayden Point,C,TBL,28,82,45,47,92
36,8477409,Carter Verhaeghe,C,FLA,29,80,46,45,91
36,8478401,Pavel Zacha,C,BOS,27,79,37,54,91
36,8474600,Roman Josi,D,NSH,34,70,29,61,90
36,8480800,Quinn Hughes,D,VAN,25,75,11,78,89
36,8480002,Nico Hischier,C,NJD,25,72,33,54,87
36,8479385,Jordan Kyrou,C,STL,26,78,33,54,87
36,8471675,Sidney Crosby,C,PIT,37,76,32,55,87
36,8476539,Jonathan Marchessault,R,NSH,34,75,54,32,86
36,8475166,John Tavares,C,TOR,34,78,43,43,86
36,8471215,Evgeni Malkin,C,PIT,38,73,30,56,86
36,8476459,Mika Zibanejad,C,NYR,31,77,26,59,85
36,8475172,Nazem Kadri,C,CGY,34,81,25,58,83
36,8479323,Adam Fox,D,NYR,26,65,15,68,83
36,8480801,Brady Tkachuk,L,OTT,25,80,43,39,82
36,8477404,Jake Guentzel,C,TBL,30,81,37,45,82
36,8477951,Nick Schmaltz,C,UTA,28,74,37,45,82
36,8474141,Patrick Kane,R,DET,36,81,33,48,81
36,8479325,Charlie McAvoy,D,BOS,27,79,27,53,80
36,8478460,Zach Werenski,D,CBJ,27,81,23,57,80
36,8477501,Valeri Nichushkin,R,COL,29,81,40,39,79
36,8482116,Tim Stützle,C,OTT,22,80,29,50,79
36,8480830,Andrei Svechnikov,R,CAR,24,74,25,54,79
36,8478439,Travis Konecny,R,PHI,27,76,39,39,78
36,8478427,Sebastian Aho,C,CAR,27,73,33,45,78
36,8477940,Nikolaj Ehlers,L,WPG,28,76,30,48,78
36,8476456,Jonathan Huberdeau,C,CGY,31,79,17,61,78
36,8476887,Filip Forsberg,L,NSH,30,71,36,40,76
36,8475810,Bryan Rust,R,PIT,32,71,33,43,76
36,8476460,Mark Scheifele,C,WPG,31,75,30,46,76
36,8479343,Clayton Keller,R,UTA,26,79,34,41,75
36,8481557,Matt Boldy,L,MIN,23,74,30,45,75
36,8477960,Adrian Kempe,R,LAK,28,81,27,47,74
36,8480069,Cale Makar,D,COL,26,67,22,52,74
36,8475913,Mark Stone,R,VGK,32,76,20,54,74
36,8475692,Mats Zuccarello,R,MIN,37,75,20,54,74
36,8476881,Tomas Hertl,C,VGK,31,77,38,35,73
36,8475158,Ryan O'Reilly,C,NSH,33,74,22,51,73
36,8478445,Mathew Barzal,C,NYI,27,79,21,52,73
36,8479420,Tage Thompson,C,BUF,27,72,45,27,72
36,8471214,Alex Ovechkin,L,WSH,39,68,37,35,72
36,8477500,Bo Horvat,C,NYI,29,82,36,36,72
36,8473419,Brad Marchand,L,BOS,36,79,22,50,72
36,8476853,Morgan Rielly,D,TOR,30,73,13,59,72
36,8479542,Brandon Hagel,L,TBL,26,82,33,38,71
36,8475170,Brayden Schenn,C,STL,33,76,32,39,71
36,8477504,Josh Morrissey,D,WPG,29,73,13,58,71
36,8478449,Roope Hintz,C,DAL,28,82,44,26,70
36,8478414,Timo Meier,R,NJD,28,78,32,38,70
36,8475754,Brock Nelson,C,NYI,33,80,39,29,68
36,8478440,Dylan Strome,C,WSH,27,73,33,35,68
36,8480208,Drake Batherson,R,OTT,26,78,30,38,68
36,8484144,Connor Bedard,C,CHI,19,66,30,38,68
36,8482078,Lucas Raymond,L,DET,22,80,26,42,68
36,8474564,Steven Stamkos,C,NSH,34,69,20,48,68
36,8481528,Dylan Cozens,C,BUF,23,73,19,49,68
36,8478398,Kyle Connor,L,WPG,28,76,34,33,67
36,8475184,Chris Kreider,L,NYR,33,75,33,34,67
36,8477496,Elias Lindholm,C,BOS,30,78,26,41,67
36,8475784,Jeff Skinner,C,EDM,32,77,24,43,67
36,8480018,Nick Suzuki,C,MTL,25,78,22,45,67
36,8474679,Gustav Nyquist,C,NSH,35,77,20,47,67
36,8478407,Vince Dunn,D,SEA,28,71,12,55,67
36,8475151,Kyle Palmieri,C,NYI,33,81,33,33,66
36,8479337,Alex DeBrincat,R,DET,27,81,30,36,66
36,8477949,Alex Tuch,R,BUF,28,74,27,39,66
36,8478047,Michael Bunting,L,PIT,29,75,26,40,66
36,8475168,Matt Duchene,C,DAL,33,81,17,49,66
36,8480839,Rasmus Dahlin,D,BUF,24,72,11,54,65
36,8475167,Victor Hedman,D,TBL,34,79,6,59,65
36,8475786,Zach Hyman,L,EDM,32,77,31,33,64
36,8477494,Jonathan Drouin,L,COL,29,79,25,39,64
36,8481711,Matias Maccelli,L,UTA,24,69,14,50,64
36,8474590,John Carlson,D,WSH,34,67,10,54,64
36,8482740,Wyatt Johnston,C,DAL,21,80,30,33,63
36,8476454,Ryan Nugent-Hopkins,C,EDM,31,77,23,40,63
36,8477955,Jared McCann,L,SEA,28,72,29,33,62
36,8476389,Vincent Trocheck,C,NYR,31,75,23,39,62
36,8478975,Mason Marchment,L,DAL,29,80,22,40,62
36,8478873,Troy Terry,R,ANA,27,75,30,31,61
36,8480039,Martin Necas,C,CAR,25,73,30,31,61
36,8481540,Cole Caufield,R,MTL,23,79,28,33,61
36,8478444,Brock Boeser,R,VAN,27,74,27,34,61
36,8479675,Trevor Moore,L,LAK,29,80,27,34,61
36,8482665,Matty Beniers,C,SEA,22,74,27,34,61
36,8480865,Noah Dobson,D,NYI,24,79,15,46,61
36,8474150,Mikael Backlund,C,CGY,35,79,34,26,60
36,8476432,Boone Jenner,C,CBJ,31,72,33,27,60
36,8474578,Erik Karlsson,D,PIT,34,81,13,47,60
36,8475745,Charlie Coyle,C,BOS,32,78,21,38,59
36,8482699,Dylan Guenther,R,UTA,21,76,28,30,58
36,8477456,J.T. Compher,L,DET,29,80,25,33,58
36,8479999,Casey Mittelstadt,C,COL,26,81,17,41,58
36,8480015,Owen Tippett,R,PHI,25,78,25,32,57
36,8471685,Anze Kopitar,C,LAK,37,82,22,35,57
36,8474102,David Perron,L,OTT,36,79,22,35,57
36,8473512,Claude Giroux,R,OTT,36,79,21,36,57
36,8480803,Evan Bouchard,D,EDM,25,79,15,42,57
36,8475765,Vladimir Tarasenko,R,DET,33,80,24,32,56
36,8478397,Rasmus Andersson,D,CGY,28,76,11,45,56
36,8480036,Miro Heiskanen,D,DAL,25,76,10,46,56
36,8477511,Anthony Mantha,R,CGY,30,72,27,28,55
36,8475169,Evander Kane,L,EDM,33,77,27,28,55
36,8475726,Tyler Toffoli,C,SJS,32,72,26,29,55
36,8475798,Mikael Granlund,C,SJS,32,65,23,32,55
36,8476346,Johnny Gaudreau,L,CBJ,31,69,12,43,55
36,8478493,Joel Eriksson Ek,C,MIN,27,71,29,25,54
36,8474586,Jordan Eberle,R,SEA,34,73,24,30,54
36,8475191,Reilly Smith,R,NYR,33,72,24,30,54
36,8477416,Oliver Bjorkstrand,R,SEA,29,72,20,34,54
36,8478055,Gustav Forsling,D,FLA,28,77,15,39,54
36,8481542,Moritz Seider,D,DET,23,78,5,49,54
36,8482093,Seth Jarvis,C,CAR,22,70,27,26,53
36,8476448,William Karlsson,C,VGK,31,73,22,31,53
36,8476462,Dougie Hamilton,D,NJD,31,72,18,35,53
36,8478542,Evan Rodrigues,C,FLA,31,77,18,35,53
36,8473994,Jamie Benn,L,DAL,35,81,17,36,53
36,8476479,Phillip Danault,C,LAK,31,78,16,37,53
36,8479345,Jakob Chychrun,D,WSH,26,73,10,43,53
36,8476880,Tom Wilson,R,WSH,30,69,27,25,52
36,8477986,Brandon Montour,D,SEA,30,70,18,34,52
36,8482720,Matthew Knies,L,TOR,22,80,15,37,52
36,8475287,Erik Haula,L,NJD,33,70,27,24,51
36,8483808,Andrei Kuzmenko,L,CGY,28,75,26,25,51
36,8475794,Tyler Seguin,C,DAL,32,80,27,23,50
36,8482110,Dawson Mercer,C,NJD,23,73,25,25,50
36,8483431,Logan Cooley,C,UTA,20,76,22,28,50
36,8481068,Yegor Sharangovich,C,CGY,26,82,21,29,50
36,8475722,Jason Zucker,L,BUF,32,71,21,29,50
36,8481618,Alex Newhook,C,MTL,23,76,17,33,50
36,8477021,Alex Kerfoot,C,UTA,30,75,15,35,50
36,8475753,Justin Faulk,D,STL,32,76,9,41,50
36,8478498,Jake DeBrusk,L,VAN,28,75,28,21,49
36,8477476,Artturi Lehkonen,L,COL,29,82,26,23,49
36,8479992,Michael Rasmussen,C,DET,25,78,23,26,49
36,8482113,Anton Lundell,C,FLA,23,77,22,27,49
36,8476905,Chandler Stephenson,C,SEA,30,71,14,35,49
36,8470613,Brent Burns,D,CAR,39,74,14,35,49
36,8476869,Brady Skjei,D,NSH,30,70,9,40,49
36,8479410,Mikhail Sergachev,D,UTA,26,68,6,43,49
36,8482159,Tyson Foerster,R,PHI,22,76,26,22,48
36,8473986,Alex Killorn,L,ANA,35,75,21,27,48
36,8476872,Scott Laughton,C,PHI,30,74,19,29,48
36,8478472,Mathieu Joseph,R,STL,27,72,14,34,48
36,8475714,Calle Jarnkrok,C,TOR,33,75,23,24,47
36,8477935,Sam Bennett,C,FLA,28,76,21,26,47
36,8481581,Thomas Harley,D,DAL,23,77,21,26,47
36,8482702,Logan Stankoven,C,DAL,21,76,17,30,47
36,8478233,Andrew Mangiapane,L,WSH,28,67,17,30,47
36,8475760,Nick Bjugstad,C,UTA,32,72,17,30,47
36,8476875,Mike Matheson,D,MTL,30,72,12,35,47
36,8476438,Brandon Saad,L,STL,32,69,30,16,46
36,8476483,Rickard Rakell,R,PIT,31,69,27,19,46
36,8479400,Pierre-Luc Dubois,L,WSH,26,67,23,23,46
36,8481604,Pavel Dorofeyev,L,VGK,24,71,21,25,46
36,8482146,Luke Evangelista,R,NSH,22,66,21,25,46
36,8476399,Blake Coleman,C,CGY,33,76,18,28,46
36,8478469,Thomas Chabot,D,OTT,27,71,14,32,46
36,8482712,Oskar Olausson,R,COL,22,78,11,35,46
36,8471724,Kris Letang,D,PIT,37,81,7,39,46
36,8479425,Filip Hronek,D,VAN,27,77,7,39,46
36,8478042,Viktor Arvidsson,L,EDM,31,76,20,25,45
36,8482097,Jack Quinn,R,BUF,23,63,19,26,45
36,8477444,Andre Burakovsky,L,SEA,29,72,17,28,45
36,8477503,Max Domi,C,TOR,29,75,17,28,45
36,8474565,Alex Pietrangelo,D,VGK,34,69,12,33,45
36,8478038,Devon Toews,D,COL,30,73,9,36,45
36,8478046,Danton Heinen,L,VAN,29,64,22,22,44
36,8477998,Warren Foegele,L,LAK,28,77,19,25,44
36,8479351,Sam Steel,C,DAL,26,81,17,27,44
36,8480798,Philipp Kurashev,C,CHI,25,59,15,29,44
36,8477932,Aaron Ekblad,D,FLA,28,67,13,31,44
36,8482124,Quinton Byfield,R,LAK,22,80,10,34,44
36,8475764,Cam Fowler,D,ANA,33,76,5,39,44
36,8478474,Lawson Crouse,L,UTA,27,70,23,20,43
36,8482475,Yegor Chinakhov,R,CBJ,23,67,23,20,43
36,8483515,Juraj Slafkovsky,L,MTL,20,75,15,28,43
36,8484145,Zach Benson,L,BUF,19,70,15,28,43
36,8476906,Shayne Gostisbehere,D,CAR,31,79,14,29,43
36,8477447,Shea Theodore,D,VGK,29,57,10,33,43
36,8476958,Jaccob Slavin,D,CAR,30,77,10,33,43
36,8482109,Alexis Lafrenière,L,NYR,23,71,21,21,42
36,8481554,Kaapo Kakko,R,NYR,23,69,21,21,42
36,8475793,Ryan Johansen,C,PHI,32,74,20,22,42
36,8484153,Leo Carlsson,C,ANA,20,66,17,25,42
36,8483505,Matthew Poitras,C,BOS,20,75,15,27,42
36,8481533,Trevor Zegras,C,ANA,23,73,12,30,42
36,8471698,T.J. Oshie,R,WSH,38,65,21,20,41
36,8477407,Anthony Duclair,L,NYI,29,79,19,22,41
36,8482745,Mason McTavish,C,ANA,21,74,18,23,41
36,8478463,Anthony Beauvillier,L,PIT,27,65,18,23,41
36,8478856,Conor Garland,R,VAN,28,72,16,25,41
36,8480078,Filip Chytil,C,NYR,25,66,14,27,41
36,8482133,Thomas Bordeleau,C,SJS,22,67,8,33,41
36,8477426,Nicholas Paul,L,TBL,29,82,23,17,40
36,8475768,Jaden Schwartz,C,SEA,32,71,21,19,40
36,8476474,Stefan Noesen,R,NJD,31,64,21,19,40
36,8479987,Morgan Geekie,C,BOS,26,79,19,21,40
36,8480014,Gabriel Vilardi,C,WPG,25,67,18,22,40
36,8477479,Tyler Bertuzzi,L,CHI,29,71,18,22,40
36,8482149,Cole Perfetti,C,WPG,22,67,17,23,40
36,8480188,Fabian Zetterlund,L,SJS,25,67,16,24,40
36,8477495,Seth Jones,D,CHI,30,73,11,29,40
36,8476419,Jean-Gabriel Pageau,C,NYI,32,80,10,30,40
36,8480797,Joel Farabee,L,PHI,24,76,10,30,40
36,8482684,Luke Hughes,D,NJD,21,67,6,34,40
36,8480145,Neal Pionk,D,WPG,29,68,4,36,40
36,8481624,Ilya Mikheyev,R,CHI,30,69,25,14,39
36,8480849,Barrett Hayton,C,UTA,24,76,24,15,39
36,8481560,Arthur Kaliyev,R,LAK,23,81,19,20,39
36,8476461,Sean Couturier,C,PHI,32,66,17,22,39
36,8476925,Colton Sissons,C,NSH,31,67,16,23,39
36,8483524,Shane Wright,C,SEA,20,68,16,23,39
36,8478519,Anthony Cirelli,C,TBL,27,80,15,24,39
36,8476792,Torey Krug,D,STL,33,73,11,28,39
36,8477429,Andrew Copp,C,DET,30,79,10,29,39
36,8480434,Sean Durzi,D,UTA,26,73,6,33,39
36,8479365,Trent Frederic,C,BOS,26,70,16,22,38
36,8478115,Pierre Engvall,L,NYI,28,78,21,16,37
36,8482175,JJ Peterka,R,BUF,22,66,20,17,37
36,8474641,Adam Henrique,C,EDM,34,77,19,18,37
36,8479525,Ross Colton,C,COL,28,75,19,18,37
36,8476882,Teuvo Teravainen,C,CHI,30,63,18,19,37
36,8481186,Logan O'Connor,R,COL,28,79,15,22,37
36,8481577,Philip Tomasino,C,NSH,23,67,13,24,37
36,8476927,Teddy Blueger,C,VAN,30,75,13,24,37
36,8481596,Shane Pinto,C,OTT,24,76,12,25,37
36,8478020,Michael Amadio,R,OTT,28,73,12,25,37
36,8477451,Ryan Hartman,R,MIN,30,68,11,26,37
36,8484166,Adam Fantilli,C,CBJ,20,68,19,17,36
36,8479316,Luke Kunin,C,SJS,27,57,18,18,36
36,8478466,Daniel Sprong,R,VAN,27,69,17,19,36
36,8476981,Josh Anderson,R,MTL,30,74,17,19,36
36,8481535,Nils Hoglander,L,VAN,24,67,17,19,36
36,8475763,Kevin Hayes,R,PIT,32,72,14,22,36
36,8481703,Valtteri Puustinen,R,PIT,25,54,12,24,36
36,8475218,Mattias Ekholm,D,EDM,34,76,11,25,36
36,8481656,Aliaksei Protas,C,WSH,23,65,10,26,36
36,8476923,Damon Severson,D,CBJ,30,79,9,27,36
36,8474715,Cameron Atkinson,R,TBL,35,81,22,13,35
36,8482089,Jake Neighbours,L,STL,22,62,18,17,35
36,8479339,Patrik Laine,L,CBJ,26,69,17,18,35
36,8478462,Nicolas Roy,C,VGK,27,74,16,19,35
36,8480009,Eeli Tolvanen,R,SEA,25,70,15,20,35
36,8477953,Kasperi Kapanen,R,STL,28,67,11,24,35
36,8480817,K'Andre Miller,D,NYR,24,69,9,26,35
36,8477498,Darnell Nurse,D,EDM,29,71,9,26,35
36,8482105,Jake Sanderson,D,OTT,22,69,7,28,35
36,8478396,Noah Hanifin,D,VGK,27,66,3,32,35
36,8482055,Drew O'Connor,L,PIT,26,61,18,16,34
36,8480028,Morgan Frost,C,PHI,25,71,16,18,34
36,8480802,Ryan McLeod,C,BUF,25,67,16,18,34
36,8477505,Alexander Wennberg,C,SJS,30,67,13,21,34
36,8480871,Adam Boqvist,D,FLA,24,68,13,21,34
36,8482671,Owen Power,D,BUF,22,70,12,22,34
36,8478438,Tommy Novak,C,NSH,27,59,11,23,34
36,8475200,Dmitry Orlov,D,CAR,33,76,11,23,34
36,8476892,Colton Parayko,D,STL,31,67,4,30,34
36,8481582,Nicholas Robertson,L,TOR,23,58,16,17,33
36,8480064,Josh Norris,C,OTT,25,75,15,18,33
36,8481481,Blake Lizotte,C,PIT,27,61,15,18,33
36,8478057,Dakota Joshua,C,VAN,28,63,14,19,33
36,8480835,Jack Drury,C,CAR,24,62,13,20,33
36,8474149,Evgenii Dadonov,R,DAL,35,80,12,21,33
36,8480829,Jesperi Kotkaniemi,C,CAR,24,65,12,21,33
36,8477346,MacKenzie Weegar,D,CGY,30,68,11,22,33
36,8474563,Drew Doughty,D,LAK,35,71,9,24,33
36,8476854,Hampus Lindholm,D,BOS,30,75,9,24,33
36,8482667,William Eklund,L,SJS,22,61,18,14,32
36,8481093,Rafael Harvey-Pinard,L,MTL,25,63,16,16,32
36,8477964,Ivan Barbashev,C,VGK,29,81,15,17,32
36,8479393,Noah Gregor,L,OTT,26,72,12,20,32
36,8476458,Ryan Strome,C,ANA,31,71,11,21,32
36,8476292,Ondrej Palat,L,NJD,33,67,10,22,32
36,8477987,Ryan Donato,C,CHI,28,61,9,23,32
36,8479353,Brett Howden,C,VGK,26,74,7,25,32
36,8477948,Travis Sanheim,D,PHI,28,66,6,26,32
36,8482122,Brock Faber,D,MIN,22,78,5,27,32
36,8477969,Marcus Pettersson,D,PIT,28,76,5,27,32
36,8476979,Erik Gustafsson,D,DET,32,78,5,27,32
36,8478366,Frank Vatrano,R,ANA,30,73,20,11,31
36,8480995,Pontus Holmberg,R,TOR,25,65,18,13,31
36,8475848,Brendan Gallagher,R,MTL,32,64,15,16,31
36,8480185,Eetu Luostarinen,C,FLA,26,76,14,17,31
36,8482705,Cole Sillinger,C,CBJ,21,63,14,17,31
36,8475193,Tomas Tatar,L,NJD,34,68,14,17,31
36,8478109,Victor Olofsson,L,VGK,29,68,14,17,31
36,8475799,Nino Niederreiter,R,WPG,32,69,13,18,31
36,8476826,Yanni Gourde,C,SEA,33,68,12,19,31
36,8482624,Daniil Miromanov,D,CGY,27,64,11,20,31
36,8484203,Bradly Nadeau,L,CAR,19,64,11,20,31
36,8480113,Alex Iafallo,L,WPG,31,66,14,16,30
36,8476918,Jimmy Vesey,L,NYR,31,69,14,16,30
36,8478891,Mason Appleton,C,WPG,28,61,13,17,30
36,8481524,Bowen Byram,D,BUF,23,65,12,18,30
36,8476891,Matthew Grzelcyk,D,PIT,30,70,6,24,30
36,8482259,Bobby McMann,C,TOR,28,65,20,9,29
36,8477952,Robby Fabbri,C,ANA,28,65,16,13,29
36,8480813,Joe Veleno,C,DET,24,73,15,14,29
36,8475314,Anders Lee,L,NYI,34,77,14,15,29
36,8482092,Ridly Greig,C,OTT,22,78,13,16,29
36,8481523,Kirby Dach,C,MTL,23,67,12,17,29
36,8474053,Logan Couture,C,SJS,35,59,10,19,29
36,8475343,Nic Dowd,C,WSH,34,62,10,19,29
36,8477497,Sean Monahan,C,CBJ,30,62,9,20,29
36,8476885,Jacob Trouba,D,NYR,30,69,9,20,29
36,8477989,Christian Dvorak,C,MTL,28,71,8,21,29
36,8476463,Jonas Brodin,D,MIN,31,75,7,22,29
36,8476917,Adam Pelech,D,NYI,30,77,6,23,29
36,8481546,Cam York,D,PHI,23,65,5,24,29
36,8478911,Matt Roy,D,WSH,29,62,5,24,29
36,8480043,Timothy Liljegren,D,TOR,25,72,4,25,29
36,8480748,Kiefer Sherwood,L,VAN,29,67,15,13,28
36,8482737,Zack Bolduc,C,STL,21,54,13,15,28
36,8476278,Colin Blackwell,C,DAL,31,80,10,18,28
36,8475791,Taylor Hall,L,CHI,33,60,7,21,28
36,8474716,Jared Spurgeon,D,MIN,35,75,6,22,28
36,8483490,Pavel Mintyukov,D,ANA,21,72,6,22,28
36,8482655,Janis Moser,D,TBL,24,76,5,23,28
36,8478500,Ivan Provorov,D,CBJ,27,82,2,26,28
36,8478840,Will Borgen,D,SEA,28,67,2,26,28
36,8481032,Paul Cotter,C,NJD,25,61,13,14,27
36,8477839,Conor Sheary,L,TBL,32,78,12,15,27
36,8480336,Sean Walker,D,CAR,30,71,8,19,27
36,8481522,Peyton Krebs,C,BUF,23,60,8,19,27
36,8482067,Connor Mackey,D,NYR,28,60,6,21,27
36,8481553,Bobby Brink,R,PHI,23,62,6,21,27
36,8479976,Juuso Valimaki,D,UTA,26,61,4,23,27
36,8481580,Connor McMichael,C,WSH,23,67,16,10,26
36,8480205,Emil Bemstrom,C,PIT,25,64,15,11,26
36,8480762,Eric Robinson,L,CAR,29,57,13,13,26
36,8476873,Mark Jankowski,C,NSH,30,56,12,14,26
36,8473422,Nick Foligno,L,CHI,37,58,11,15,26
36,8479996,Cody Glass,C,NSH,25,62,11,15,26
36,8475220,Marcus Foligno,L,MIN,33,57,10,16,26
36,8474189,Lars Eller,C,PIT,35,63,10,16,26
36,8480855,Jack McBain,C,UTA,24,67,9,17,26
36,8473533,Jordan Staal,C,CAR,36,55,9,17,26
36,8479315,Joey Anderson,R,CHI,26,55,9,17,26
36,8478133,Jake Evans,C,MTL,28,70,8,18,26
36,8480220,Noah Cates,L,PHI,25,69,7,19,26
36,8482660,Kent Johnson,C,CBJ,22,65,6,20,26
36,8475171,Oliver Ekman-Larsson,D,TOR,33,72,5,21,26
36,8480873,Rasmus Sandin,D,WSH,24,58,3,23,26
36,8477488,Brett Pesce,D,NJD,30,71,2,24,26
36,8474151,Ryan McDonagh,D,TBL,35,81,1,25,26
36,8480893,Kirill Marchenko,R,CBJ,24,63,19,6,25
36,8482117,Lukas Reichel,L,CHI,22,53,16,9,25
36,8479390,Taylor Raddysh,R,WSH,26,64,14,11,25
36,8477446,Michael McCarron,R,NSH,29,62,13,12,25
36,8477508,Curtis Lazar,C,NJD,29,64,12,13,25
36,8474034,Patrick Maroon,L,CHI,36,54,12,13,25
36,8479591,Michael Eyssimont,C,TBL,28,81,10,15,25
36,8477947,Sonny Milano,L,WSH,28,59,10,15,25
36,8480144,David Kampf,C,TOR,29,72,9,16,25
36,8480068,Ryan Poehling,C,PHI,25,64,8,17,25
36,8483468,Jiri Kulich,C,BUF,20,59,7,18,25
36,8480025,MacKenzie Entwistle,R,FLA,25,67,7,18,25
36,8481441,Joe Snively,C,DET,28,65,6,19,25
36,8475790,Erik Gudbranson,D,CBJ,32,75,6,19,25
36,8476480,Vladislav Namestnikov,C,WPG,32,63,15,9,24
36,8470621,Corey Perry,R,EDM,39,65,15,9,24
36,8482679,Matt Coronato,R,CGY,22,75,14,10,24
36,8476392,Adam Lowry,C,WPG,31,63,14,10,24
36,8480003,Jesper Boqvist,C,FLA,26,67,10,14,24
36,8478013,Jake Walman,D,SJS,28,67,10,14,24
36,8476856,Mathew Dumba,D,DAL,30,72,10,14,24
36,8473563,Nicklas Backstrom,C,WSH,37,62,8,16,24
36,8481704,Juuso Parssinen,C,NSH,23,54,7,17,24
36,8478458,John (Jack) Roslovic,C,CAR,27,65,6,18,24
36,8476312,Josh Manson,D,COL,33,68,5,19,24
36,8477506,Ryan Pulock,D,NYI,30,79,4,20,24
36,8479324,Ryan Lindgren,D,NYR,26,72,3,21,24
36,8478507,John Marino,D,UTA,27,67,0,24,24
36,8482749,Joshua Roy,R,MTL,21,66,10,13,23
36,8482074,Connor Zary,C,CGY,23,59,10,13,23
36,8477979,Nicolas Aube-Kubel,R,BUF,28,60,9,14,23
36,8478434,Keegan Kolesar,R,VGK,27,69,9,14,23
36,8479368,Max Jones,L,BOS,26,70,8,15,23
36,8482111,Justin Barron,D,MTL,23,70,8,15,23
36,8483493,Frank Nazar,C,CHI,20,57,8,15,23
36,8475149,Marcus Johansson,L,MIN,34,65,7,16,23
36,8483460,David Jiricek,D,CBJ,21,55,7,16,23
36,8479983,Mario Ferraro,D,SJS,26,69,4,19,23
36,8476422,Mike Reilly,D,NYI,31,77,3,20,23
36,8477435,Ryan Graves,D,PIT,29,76,3,20,23
36,8474673,TJ Brodie,D,CHI,34,64,3,20,23
36,8480035,Henri Jokiharju,D,BUF,25,60,2,21,23
36,8479619,Michael Carcone,L,UTA,28,61,13,9,22
36,8476921,Jordan Martinook,L,CAR,32,57,11,11,22
36,8476469,Joel Armia,R,MTL,31,59,11,11,22
36,8479982,Conor Timmins,D,TOR,26,54,8,14,22
36,8479414,Nathan Bastian,R,NJD,27,62,8,14,22
36,8479639,Dylan Coghlan,D,WPG,26,67,7,15,22
36,8479402,Jake Bean,D,CGY,26,69,6,16,22
36,8481527,Kaedan Korczak,D,VGK,23,53,6,16,22
36,8476889,Radek Faksa,C,STL,30,63,6,16,22
36,8477392,Hudson Fasching,R,NYI,29,64,5,17,22
36,8476902,Esa Lindell,D,DAL,30,73,3,19,22
36,8475181,Nick Leddy,D,STL,33,64,3,19,22
36,8478851,Alexandre Carrier,D,NSH,28,70,3,19,22
36,8477499,Rasmus Ristolainen,D,PHI,30,62,3,19,22
36,8476879,Cody Ceci,D,EDM,31,64,2,20,22
36,8478508,Yakov Trenin,C,MIN,27,58,13,8,21
36,8480459,Pius Suter,C,VAN,28,61,12,9,21
36,8482125,Alexander Holtz,R,VGK,22,66,12,9,21
36,8480289,Morgan Barron,C,WPG,26,56,11,10,21
36,8478043,Sam Lafferty,C,BUF,29,62,10,11,21
36,8479661,Tanner Jeannot,L,LAK,27,79,9,12,21
36,8483445,Cutter Gauthier,L,ANA,20,55,8,13,21
36,8483491,Ivan Miroshnichenko,L,WSH,20,60,6,15,21
36,8478970,Jalen Chatfield,D,CAR,28,69,5,16,21
36,8476931,Jake McCabe,D,TOR,31,62,4,17,21
36,8477507,Nikita Zadorov,D,BOS,29,69,3,18,21
36,8479398,Samuel Girard,D,COL,26,63,3,18,21
36,8473507,Jeff Petry,D,DET,37,72,2,19,21
36,8475233,David Savard,D,MTL,34,71,2,19,21
36,8481641,Joel Kiviranta,L,COL,28,69,12,8,20
36,8480074,Alexandre Texier,C,STL,25,58,11,9,20
36,8476994,Vinnie Hinostroza,C,NSH,30,43,8,12,20
36,8477425,Miles Wood,L,COL,29,81,7,13,20
36,8477573,Nathan Walker,L,STL,30,54,7,13,20
36,8476331,Dylan DeMelo,D,WPG,31,70,5,15,20
36,8478882,Vladislav Gavrikov,D,LAK,29,68,5,15,20
36,8480807,Mattias Samuelsson,D,BUF,24,57,4,16,20
36,8477931,Tomas Nosek,L,FLA,32,63,3,17,20
36,8482245,Artem Zub,D,OTT,29,70,2,18,20
36,8478136,Jake Middleton,D,MIN,28,74,1,19,20
36,8482809,Jackson Blake,R,CAR,21,58,10,9,19
36,8482079,Marco Rossi,C,MIN,23,53,9,10,19
36,8479370,Tyson Jost,C,CAR,26,57,9,10,19
36,8475855,Jesper Fast,R,CAR,33,63,8,11,19
36,8476897,Oskar Sundqvist,C,STL,30,67,7,12,19
36,8477369,Carson Soucy,D,VAN,30,53,7,12,19
36,8476624,Barclay Goodrow,C,SJS,31,46,7,12,19
36,8481019,David Gustafsson,C,WPG,24,48,5,14,19
36,8481606,Jordan Spence,D,LAK,23,69,4,15,19
36,8476878,Zemgus Girgensons,C,TBL,30,79,4,15,19
36,8478178,Darren Raddysh,D,TBL,28,66,4,15,19
36,8480891,Michael Kesselring,D,UTA,24,59,3,16,19
36,8478416,Erik Cernak,D,TBL,27,73,2,17,19
36,8480172,Jan Rutta,D,SJS,34,71,2,17,19
36,8476429,Scott Mayfield,D,NYI,32,72,1,18,19
36,8476822,Luke Glendening,C,TBL,35,78,13,5,18
36,8482155,Alex Laferriere,R,LAK,23,64,11,7,18
36,8478432,Christian Fischer,R,DET,27,72,9,9,18
36,8483495,Simon Nemec,D,NJD,20,56,8,10,18
36,8483457,Lane Hutson,D,MTL,20,58,7,11,18
36,8481477,Nico Sturm,C,SJS,29,55,7,11,18
36,8482803,Olen Zellweger,D,ANA,21,64,6,12,18
36,8480222,Sebastian Aho,D,PIT,28,74,4,14,18
36,8482192,Isaak Phillips,D,CHI,23,51,4,14,18
36,8474574,Tyler Myers,D,VAN,34,61,3,15,18
36,8476457,Adam Larsson,D,SEA,32,70,3,15,18
36,8480355,Mark Kastelic,C,BOS,25,67,3,15,18
36,8477220,Nate Schmidt,D,FLA,33,60,2,16,18
36,8477406,Mattias Janmark,C,EDM,32,59,10,7,17
36,8477353,Tyler Motte,C,DET,29,71,10,7,17
36,8479941,Justin Danforth,R,CBJ,31,56,10,7,17
36,8480021,Jack Studnicka,C,LAK,25,58,10,7,17
36,8482148,Hendrix Lapierre,C,WSH,22,47,7,10,17
36,8477919,Frederick Gaudreau,C,MIN,31,65,6,11,17
36,8476374,Sean Kuraly,C,CBJ,31,53,6,11,17
36,8476329,Travis Boyd,C,MIN,31,52,5,12,17
36,8477450,Jason Dickinson,C,CHI,29,54,5,12,17
36,8480980,Connor Dewar,C,TOR,25,65,5,12,17
36,8477365,Connor Clifton,D,BUF,29,60,4,13,17
36,8478399,Jonas Siegenthaler,D,NJD,27,56,3,14,17
36,8477845,Trevor van Riemsdyk,D,WSH,33,64,3,14,17
36,8480887,Jordan Harris,D,MTL,24,58,3,14,17
36,8479249,Andrew Poturalski,C,SJS,30,36,3,14,17
36,8475690,Chris Tanev,D,TOR,35,53,1,16,17
36,8481617,Vasily Podkolzin,R,VAN,23,54,9,7,16
36,8478421,A.J. Greer,L,FLA,28,56,9,7,16
36,8481013,Jonatan Berggren,R,DET,24,63,7,9,16
36,8482101,Danil Gushchin,L,SJS,22,58,6,10,16
36,8481517,Brett Leason,R,ANA,25,52,6,10,16
36,8479671,Mathieu Olivier,R,CBJ,27,50,6,10,16
36,8479543,Michael Pezzetta,L,MTL,26,55,6,10,16
36,8477015,Connor Brown,R,EDM,30,67,5,11,16
36,8476467,Jamie Oleksiak,D,SEA,32,66,5,11,16
36,8480789,Oliver Wahlstrom,R,NYI,24,70,4,12,16
36,8473446,Erik Johnson,D,PHI,36,54,4,12,16
36,8482073,Braden Schneider,D,NYR,23,62,3,13,16
36,8478451,Ethan Bear,D,WSH,27,45,3,13,16
36,8482087,Kaiden Guhle,D,MTL,22,63,3,13,16
36,8481178,Egor Zamula,D,PHI,24,48,2,14,16
36,8481568,Alex Vlasic,D,CHI,23,56,2,14,16
36,8480878,Nils Lundkvist,D,DAL,24,72,1,15,16
36,8476967,Brett Kulak,D,EDM,30,65,0,16,16
36,8479293,Brandon Tanev,L,SEA,33,61,11,4,15
36,8478569,Noel Acciari,C,PIT,33,57,10,5,15
36,8481601,Simon Holmstrom,R,NYI,23,69,10,5,15
36,8475842,Sam Carrick,C,NYR,32,69,10,5,15
36,8476934,Brock McGinn,L,ANA,30,53,9,6,15
36,8481537,Nikita Okhotiuk,D,CGY,24,49,8,7,15
36,8479336,Carl Grundstrom,R,SJS,27,52,7,8,15
36,8480448,Parker Kelly,L,COL,25,73,7,8,15
36,8479066,Ryan Lomberg,L,CGY,30,68,6,9,15
36,8483565,Nick Blankenburg,D,NSH,26,54,5,10,15
36,8483482,Tristan Luneau,D,ANA,20,65,5,10,15
36,8479998,Mikey Anderson,D,LAK,25,68,4,11,15
36,8473453,Trevor Lewis,C,LAK,37,71,4,11,15
36,8480796,Martin Fehervary,D,WSH,25,52,4,11,15
36,8480246,Nick Perbix,D,TBL,26,73,3,12,15
36,8478859,Niko Mikkola,D,FLA,28,58,3,12,15
36,8474166,Alec Martinez,D,CHI,37,47,3,12,15
36,8481014,Alexander Romanov,D,NYI,24,79,2,13,15
36,8475279,Ben Chiarot,D,DET,33,65,2,13,15
36,8479371,Dante Fabbro,D,NSH,26,62,1,14,15
36,8482157,Will Cuylle,L,NYR,22,61,8,6,14
36,8482807,Ethan Del Mastro,D,CHI,21,49,8,6,14
36,8478413,Jordan Greenway,L,BUF,27,61,7,7,14
36,8483499,Liam Ohgren,L,MIN,20,54,7,7,14
36,8477903,Garnet Hathaway,R,PHI,33,62,7,7,14
36,8475231,Casey Cizikas,C,NYI,33,68,6,8,14
36,8479520,Brandon Duhaime,R,WSH,27,60,6,8,14
36,8470600,Ryan Suter,D,STL,39,63,6,8,14
36,8478211,Dryden Hunt,L,CGY,29,52,6,8,14
36,8479718,Alex Barré-Boulet,C,MTL,27,44,6,8,14
36,8476988,Matt Benning,D,SJS,30,62,4,10,14
36,8481521,Ronnie Attard,D,PHI,25,54,4,10,14
36,8479026,Philippe Myers,D,TOR,27,51,3,11,14
36,8474567,Zach Bogosian,D,MIN,34,65,3,11,14
36,8475455,Brenden Dillon,D,NJD,34,58,3,11,14
36,8481751,Lukas Rousek,R,BUF,25,35,3,11,14
36,8479439,Jacob MacDonald,D,COL,31,47,3,11,14
36,8475179,Dmitry Kulikov,D,FLA,34,63,1,13,14
36,8481059,Scott Perunovich,D,STL,26,59,1,13,14
36,8474568,Luke Schenn,D,NSH,35,64,0,14,14
36,8480281,Alexey Toropchenko,R,STL,25,49,10,3,13
36,8482659,Josh Doan,R,UTA,22,47,7,6,13
36,8482784,Zach Dean,C,STL,21,42,7,6,13
36,8479981,Jonah Gadjovich,L,FLA,26,43,7,6,13
36,8475225,Craig Smith,C,CHI,35,54,6,7,13
36,8479344,Jesse Puljujarvi,R,PIT,26,53,6,7,13
36,8479359,Beck Malenstyn,L,BUF,26,44,6,7,13
36,8477482,Zachary Sanford,L,CHI,30,37,6,7,13
36,8479972,Mason Shaw,C,WPG,26,36,4,9,13
36,8480879,Jacob Bernard-Docker,D,OTT,24,51,4,9,13
36,8476952,Dominic Toninato,C,WPG,30,36,4,9,13
36,8482861,Vincent Iorio,D,WSH,22,38,4,9,13
36,8482451,Mikael Pyyhtia,L,CBJ,23,44,3,10,13
36,8477018,Ben Hutton,D,VGK,31,51,3,10,13
36,8484254,Akito Hirose,D,VAN,25,45,3,10,13
36,8479348,Kale Clague,D,BUF,26,43,3,10,13
36,8480860,Kevin Bahl,D,CGY,24,58,3,10,13
36,8482142,Jamie Drysdale,D,PHI,22,60,2,11,13
36,8480727,Zach Whitecloud,D,VGK,28,47,2,11,13
36,8477034,Jaycob Megna,D,FLA,32,49,2,11,13
36,8475762,Derek Forbort,D,VAN,32,50,1,12,13
36,8475462,Radko Gudas,D,ANA,34,63,0,13,13
36,8481716,Dmitri Voronkov,L,CBJ,24,44,8,4,12
36,8475235,Nicolas Deslauriers,L,PHI,33,50,8,4,12
36,8482062,Cole Smith,L,NSH,29,62,8,4,12
36,8478585,Derek Ryan,C,EDM,38,60,7,5,12
36,8480848,Ty Dellandrea,C,SJS,24,48,7,5,12
36,8478831,Kevin Stenlund,C,UTA,28,52,7,5,12
36,8479328,Julien Gauthier,R,NYI,27,56,6,6,12
36,8477380,Jonny Brodzinski,C,NYR,31,47,6,6,12
36,8482859,Zack Ostapchuk,C,OTT,21,50,5,7,12
36,8479994,Jaret Anderson-Dolan,C,WPG,25,39,4,8,12
36,8474090,Brendan Smith,D,DAL,35,54,4,8,12
36,8480073,Erik Brannstrom,D,COL,25,56,3,9,12
36,8481701,Santeri Hatakka,D,NJD,23,49,3,9,12
36,8476960,Andreas Athanasiou,C,CHI,30,46,2,10,12
36,8480049,Dylan Samberg,D,WPG,25,64,2,10,12
36,8475208,Brian Dumoulin,D,ANA,33,63,2,10,12
36,8475324,Nick Jensen,D,OTT,34,70,1,11,12
36,8481567,Henry Thrun,D,SJS,23,54,1,11,12
36,8479372,Joshua Mahura,D,SEA,26,59,0,12,12
36,8481532,Alex Turcotte,C,LAK,23,48,6,5,11
36,8480880,Jakub Lauko,C,MIN,24,39,6,5,11
36,8482077,Dylan Holloway,L,EDM,23,48,5,6,11
36,8481708,Zac Jones,D,NYR,24,55,5,6,11
36,8482762,Simon Edvinsson,D,DET,21,53,5,6,11
36,8476525,Colin Miller,D,WPG,32,60,4,7,11
36,8480441,Trey Fix-Wolansky,R,CBJ,25,50,4,7,11
36,8480806,Isac Lundestrom,C,ANA,25,58,3,8,11
36,8478452,Caleb Jones,D,LAK,27,51,3,8,11
36,8482964,Arber Xhekaj,D,MTL,23,48,3,8,11
36,8480192,Johnathan Kovacevic,D,NJD,27,47,3,8,11
36,8482634,Alex Steeves,C,TOR,25,44,2,9,11
36,8479369,Andrew Peeke,D,BOS,26,53,1,10,11
36,8484149,Gavin Brindley,C,CBJ,20,47,1,10,11
36,8482747,Brennan Othmann,L,NYR,21,43,8,2,10
36,8476442,Matt Nieto,L,PIT,32,50,7,3,10
36,8477478,William Carrier,L,CAR,30,48,6,4,10
36,8477887,Patrick Brown,C,BOS,32,46,6,4,10
36,8480845,Rasmus Kupari,C,WPG,24,42,5,5,10
36,8482744,James Malatesta,L,CBJ,21,36,5,5,10
36,8481518,Nolan Foote,L,NJD,24,44,5,5,10
36,8483549,Lucas Condotta,L,MTL,27,30,5,5,10
36,8482070,Mitchell Chaffee,R,TBL,26,41,5,5,10
36,8480011,Klim Kostin,C,SJS,25,49,4,6,10
36,8481599,Victor Soderstrom,D,UTA,23,39,4,6,10
36,8481600,Tobias Bjornfot,D,FLA,23,37,4,6,10
36,8482730,Brandt Clarke,D,LAK,21,48,2,8,10
36,8480157,Calle Rosen,D,COL,30,52,2,8,10
36,8480950,Ilya Lyubushkin,D,DAL,30,60,2,8,10
36,8477851,Jordan Oesterle,D,BOS,32,42,2,8,10
36,8474013,Ian Cole,D,UTA,35,56,2,8,10
36,8479419,Brett Murray,L,BUF,26,21,2,8,10
36,8475718,Justin Holl,D,DET,32,56,1,9,10
36,8479968,Vinni Lettieri,C,BOS,29,46,5,4,9
36,8477962,Brendan Lemieux,L,CAR,28,43,5,4,9
36,8484911,Collin Graf,R,SJS,22,42,5,4,9
36,8471817,Ryan Reaves,R,TOR,37,60,4,5,9
36,8480292,Carson Meyer,R,ANA,27,35,4,5,9
36,8480252,Cole Guttman,C,CHI,25,38,4,5,9
36,8477401,John Hayden,C,SEA,29,27,3,6,9
36,8481028,Martin Pospisil,C,CGY,25,53,3,6,9
36,8479291,Kevin Rooney,C,CGY,31,46,3,6,9
36,8477938,Haydn Fleury,D,WPG,28,47,3,6,9
36,8479442,Troy Stecher,D,EDM,30,54,3,6,9
36,8476372,Nick Seeler,D,PHI,31,50,2,7,9
36,8481056,Spencer Stastney,D,NSH,24,36,2,7,9
36,8480058,Pierre-Olivier Joseph,D,STL,25,55,1,8,9
36,8480001,Urho Vaakanainen,D,ANA,25,58,1,8,9
36,8478450,Parker Wotherspoon,D,BOS,27,31,1,8,9
36,8482666,Scott Morrow,D,CAR,22,46,1,8,9
36,8477070,Liam O'Brien,C,UTA,30,59,4,4,8
36,8478424,Jansen Harkins,C,ANA,27,45,4,4,8
36,8482176,Wyatt Kaiser,D,CHI,22,50,3,5,8
36,8479986,Kole Lind,R,DAL,26,46,3,5,8
36,8481147,Reese Johnson,C,MIN,26,44,3,5,8
36,8479980,Nicolas Hague,D,VGK,26,52,2,6,8
36,8477384,Joshua Brown,D,EDM,30,45,2,6,8
36,8479991,Jake Leschyshyn,C,NYR,25,29,2,6,8
36,8483512,Matthew Savoie,C,EDM,20,24,2,6,8
36,8478443,Brandon Carlo,D,BOS,28,54,1,7,8
36,8482145,Mavrik Bourque,C,DAL,22,55,1,7,8
36,8477527,Ross Johnston,L,ANA,30,35,1,7,8
36,8481609,Vladislav Kolyachonok,D,UTA,23,39,4,3,7
36,8479536,Axel Jonsson-Fjallby,L,WPG,26,31,4,3,7
36,8482733,Logan Mailloux,D,MTL,31,28,4,3,7
36,8482177,Marat Khusnutdinov,C,MIN,22,37,3,4,7
36,8482765,Isak Rosen,R,BUF,21,26,3,4,7
36,8483012,Logan Morrison,C,SEA,22,39,2,5,7
36,8483466,Kevin Korchinski,D,CHI,20,51,1,6,7
36,8481167,Brayden Pachal,D,CGY,25,46,1,6,7
36,8481550,Adam Beckman,L,NJD,23,40,1,6,7
36,8477073,Kurtis MacDermid,L,NJD,30,25,1,6,7
36,8471709,Marc-Edouard Vlasic,D,SJS,37,61,0,7,7
36,8475188,Brayden McNabb,D,VGK,33,45,0,7,7
36,8482153,Brendan Brisson,C,VGK,23,27,6,0,6
36,8481592,Jakob Pelletier,L,CGY,23,30,5,1,6
36,8479944,Zach Aston-Reese,C,VGK,30,41,5,1,6
36,8481789,Tye Kartye,L,SEA,23,39,5,1,6
36,8478409,Anthony Richard,C,PHI,28,30,5,1,6
36,8483570,Ben Meyers,C,SEA,26,27,4,2,6
36,8478017,Mark Friedman,D,VAN,29,36,3,3,6
36,8483619,Filip Roos,D,OTT,25,38,3,3,6
36,8471677,Jack Johnson,D,CBJ,37,67,2,4,6
36,8482652,Walker Duehr,R,CGY,27,45,2,4,6
36,8476874,Olli Maatta,D,DET,30,60,2,4,6
36,8482095,Tyler Kleven,D,OTT,22,42,2,4,6
36,8476473,Connor Murphy,D,CHI,31,38,2,4,6
36,8480990,Declan Chisholm,D,MIN,24,35,2,4,6
36,8475958,Michael Sgarbossa,C,WSH,32,26,2,4,6
36,8478454,Noah Juulsen,D,VAN,27,36,1,5,6
36,8478468,Jeremy Lauzon,D,NSH,27,43,1,5,6
36,8475177,Calvin de Haan,D,COL,33,43,1,5,6
36,8482511,Mason Lohrei,D,BOS,23,44,1,5,6
36,8480245,Olle Lycksell,R,PHI,25,35,0,6,6
36,8474612,Travis Hamonic,D,OTT,34,45,0,6,6
36,8477810,Joel Hanley,D,CGY,33,28,0,6,6
36,8480468,James Hamblin,L,EDM,25,19,4,1,5
36,8476858,Phillip Di Giuseppe,L,VAN,31,33,3,2,5
36,8483630,Pavol Regenda,L,ANA,25,30,3,2,5
36,8482147,Jean-Luc Foudy,C,COL,22,23,3,2,5
36,8480007,Jonas Rondbjerg,R,VGK,25,27,2,3,5
36,8481161,Jake Christiansen,D,CBJ,25,53,2,3,5
36,8480844,Grigori Denisenko,L,VGK,24,40,2,3,5
36,8482144,Jack Thompson,D,SJS,22,27,2,3,5
36,8483763,Maksymilian Szuber,D,UTA,22,28,2,3,5
36,8478051,Max Willman,C,NJD,29,16,2,3,5
36,8480070,Ian Mitchell,D,BOS,25,45,1,4,5
36,8482250,Callahan Burke,C,VGK,27,24,1,4,5
36,8482141,Lukas Cormier,D,VGK,22,36,1,4,5
36,8479320,Maxime Lajoie,D,SEA,27,20,1,4,5
36,8481605,Jackson LaCombe,D,ANA,23,31,1,4,5
36,8475750,Jon Merrill,D,MIN,32,64,0,5,5
36,8481122,Simon Benoit,D,TOR,26,41,0,5,5
36,8481598,Philip Broberg,D,EDM,23,37,0,5,5
36,8482470,Ilya Solovyov,D,CGY,24,13,0,5,5
36,8482929,Emil Lilleberg,D,TBL,23,22,0,5,5
36,8482751,Ryan Winterton,C,SEA,21,45,3,1,4
36,8479367,William Lockwood,R,FLA,26,22,3,1,4
36,8480267,Sammy Walker,C,MIN,25,20,3,1,4
36,8481585,Egor Afanasyev,L,SJS,23,12,3,1,4
36,8481679,Maxence Guenette,D,OTT,23,34,2,2,4
36,8480870,Bo Groulx,C,NYR,24,26,2,2,4
36,8477971,Andreas Englund,D,LAK,28,30,2,2,4
36,8481754,Nikita Nesterenko,C,ANA,23,31,2,2,4
36,8483597,Milos Kelemen,L,UTA,25,16,2,2,4
36,8480823,Alexander Alexeyev,D,WSH,25,13,2,2,4
36,8482858,Ryker Evans,D,SEA,23,20,2,2,4
36,8479378,Logan Stanley,D,WPG,26,43,1,3,4
36,8482201,Gage Goncalves,C,TBL,23,30,1,3,4
36,8479576,Vincent Desharnais,D,VAN,28,37,1,3,4
36,8478021,William Lagesson,D,DET,28,30,1,3,4
36,8482496,Nils Aman,C,VAN,24,35,1,3,4
36,8482172,Landon Slaggert,L,CHI,22,19,1,3,4
36,8482118,Sam Colangelo,R,ANA,23,18,1,3,4
36,8482166,Shakir Mukhamadullin,D,SJS,22,51,0,4,4
36,8483397,Marc McLaughlin,C,BOS,25,30,0,4,4
36,8480890,Jan Jenik,C,OTT,24,29,0,4,4
36,8481065,Angus Crookshank,L,OTT,25,20,3,0,3
36,8478011,Louie Belpedio,D,PHI,28,18,3,0,3
36,8481556,John Beecher,C,BOS,23,31,2,1,3
36,8481543,Nikita Alexandrov,C,STL,24,22,2,1,3
36,8478477,Mitchell Stephens,C,SEA,27,23,2,1,3
36,8481206,John Ludvig,D,PIT,24,13,2,1,3
36,8482061,Brandon Biro,L,SEA,26,11,2,1,3
36,8479985,Cale Fleury,D,SEA,26,26,1,2,3
36,8480196,Jacob Bryson,D,BUF,27,35,1,2,3
36,8477320,Anton Blidh,L,NYR,29,26,1,2,3
36,8474062,Riley Nash,C,NYR,35,18,1,2,3
36,8476441,Joel Edmundson,D,LAK,31,40,1,2,3
36,8483398,Declan Carlile,D,TBL,31,6,1,2,3
36,8477244,Chad Ruhwedel,D,NYR,34,35,0,3,3
36,8477473,Justin Bailey,R,SJS,29,22,0,3,3
36,8480834,Ty Emberson,D,SJS,24,30,0,3,3
36,8482713,Mackie Samoskevich,R,FLA,22,37,0,3,3
36,8478874,Adam Gaudette,R,OTT,28,34,0,3,3
36,8481593,Jayden Struble,D,MTL,23,24,0,3,3
36,8481743,Marc Del Gaizo,D,NSH,25,23,0,3,3
36,8484258,Sam Malinski,D,COL,26,23,0,3,3
36,8480084,Nick DeSimone,D,NJD,30,16,0,3,3
36,8479587,Rhett Gardner,C,PHI,28,21,0,3,3
36,8479638,Justin Brazeau,R,BOS,26,35,2,0,2
36,8479379,Givani Smith,R,SJS,26,33,2,0,2
36,8481422,Jake Lucchini,C,NSH,29,20,2,0,2
36,8479362,Riley Tufte,L,BOS,26,22,2,0,2
36,8477335,Kyle Burroughs,D,LAK,29,40,1,1,2
36,8477467,Gustav Olofsson,D,SEA,30,23,1,1,2
36,8481719,Maxwell Crozier,D,TBL,24,16,1,1,2
36,8482102,Vasily Ponomarev,C,PIT,22,13,1,1,2
36,8484287,Cole McWard,D,VAN,23,22,1,1,2
36,8483920,Pierrick Dube,R,WSH,23,3,1,1,2
36,8476913,Devin Shore,C,MIN,30,31,0,2,2
36,8479772,Zack MacEwen,R,OTT,28,45,0,2,2
36,8477462,Robert Hagg,D,VGK,29,16,0,2,2
36,8481006,Tyler Tucker,D,STL,24,16,0,2,2
36,8482165,Yan Kuznetsov,D,CGY,22,21,1,0,1
36,8475795,Dylan McIlrath,D,WSH,32,16,1,0,1
36,8477149,Scott Sabourin,R,SJS,32,16,1,0,1
36,8481534,Raphael Lavoie,C,EDM,24,4,1,0,1
36,8481655,Cole Schwindt,R,CGY,23,5,1,0,1
36,8482088,Justin Sourdif,R,FLA,22,9,1,0,1
36,8480874,Adam Ginning,D,PHI,24,9,1,0,1
36,8477541,Dakota Mermis,D,TOR,30,7,1,0,1
36,8475755,Alexander Petrovic,D,DAL,32,8,1,0,1
36,8482787,Nikita Chibrikov,R,WPG,31,6,1,0,1
36,8481030,Jack St. Ivany,D,PIT,25,15,0,1,1
36,8478502,Dennis Gilbert,D,BUF,28,17,0,1,1
36,8476867,Brendan Gaunce,C,MIN,30,32,0,1,1
36,8482516,Matthew Kessel,D,STL,24,19,0,1,1
36,8483407,Brandon Scanlin,D,NYR,25,5,0,1,1
36,8482094,Daemon Hunt,D,MIN,22,17,0,1,1
36,8481699,Aku Raty,R,UTA,23,15,0,1,1
36,8483395,Arshdeep Bains,L,VAN,23,11,0,1,1
36,8480306,Grant Hutton,D,NYI,29,7,0,1,1
36,8481806,Louis Crevier,D,CHI,23,13,0,1,1
36,8481024,Linus Karlsson,C,VAN,25,12,0,1,1
36,8483546,Marshall Rifai,D,TOR,26,7,0,1,1
36,8483609,Adam Klapka,R,CGY,24,3,0,1,1
36,8482126,Emil Andrae,D,PHI,31,6,0,1,1
36,8478854,Ryan Shea,D,PIT,27,6,0,1,1
36,8478146,Matthew Highmore,C,OTT,28,36,0,0,0
36,8478446,Glenn Gawdin,C,LAK,27,11,0,0,0
36,8481043,Cole Koepke,L,BOS,26,15,0,0,0
36,8481541,Samuel Bolduc,D,NYI,24,22,0,0,0
36,8481578,Graeme Clarke,R,MIN,23,9,0,0,0
36,8481237,Kyle MacLean,C,NYI,25,21,0,0,0
36,8480032,Shane Bowers,C,NJD,25,10,0,0,0
36,8481726,Adam Edstrom,C,NYR,24,2,0,0,0
36,8480851,Akil Thomas,C,LAK,24,12,0,0,0
36,8483567,Georgii Merkulov,C,BOS,24,5,0,0,0
36,8482476,Emil Heineman,L,MTL,23,4,0,0,0
36,8483489,Fraser Minten,C,TOR,31,7,0,0,0
36,8483432,Luca Del Bel Belluz,C,CBJ,31,6,0,0,0
36,8484259,Ondrej Pavel,C,COL,31,8,0,0,0
36,8481564,Ryan Johnson,D,BUF,23,13,0,0,0
36,8482162,Roby Jarventie,L,EDM,22,17,0,0,0
36,8482460,Matt Rempe,C,NYR,22,12,0,0,0
36,8484325,Waltteri Merela,C,TBL,26,27,0,0,0
36,8475413,Justin Dowling,C,NJD,34,14,0,0,0
36,8479421,Jacob Moverare,D,LAK,26,7,0,0,0
36,8480075,Cameron Crotty,D,MIN,25,9,0,0,0
36,8481462,Mason Morelli,L,VGK,28,16,0,0,0
36,8477993,Justin Kirkland,C,CGY,28,4,0,0,0
36,8484326,Patrik Koch,D,UTA,28,2,0,0,0
36,8483471,Brad Lambert,C,WPG,31,7,0,0,0
36,8484304,Uvis Balinskis,D,FLA,28,13,0,0,0
36,8476323,Max McCormick,L,SEA,32,1,0,0,0
36,8478147,Bokondji Imama,L,PIT,28,6,0,0,0
36,8478881,Brett Seney,L,CHI,28,10,0,0,0
36,8484255,Jason Polin,R,COL,25,2,0,0,0
36,8475780,Chris Wagner,R,COL,33,10,0,0,0
36,8482197,Adam Raska,R,MIN,23,4,0,0,0
36,8479330,Brandon Gignac,C,MTL,27,9,0,0,0
36,8483531,Brian Halonen,L,NJD,25,2,0,0,0
36,8480274,Philip Kemp,D,EDM,25,1,0,0,0
36,8479522,Hardy Haman Aktell,D,WSH,26,4,0,0,0
36,8483401,Marc Johnstone,R,PIT,28,1,0,0,0
36,8484321,Nikolas Matinpalo,D,OTT,26,2,0,0,0
36,8470794,Joe Pavelski,C,,40,0,0,0,0
36,8479321,Lucas Johansen,D,,27,0,0,0,0
36,8477950,Tony DeAngelo,D,,29,0,0,0,0
36,8471218,Blake Wheeler,R,,38,0,0,0,0
36,8475197,Tyson Barrie,D,,33,0,0,0,0
36,8474157,Max Pacioretty,L,,36,0,0,0,0
36,8475744,Evgeny Kuznetsov,C,,32,0,0,0,0
36,8474037,James van Riemsdyk,L,,35,0,0,0,0
36,8476907,Mackenzie MacEachern,L,,30,0,0,0,0
36,8480216,Jacob Peterson,C,,25,0,0,0,0
36,8474602,Justin Schultz,D,,34,0,0,0,0
36,8482222,Alexander Barabanov,L,,30,0,0,0,0
36,8474031,Kevin Shattenkirk,D,,35,0,0,0,0
36,8477330,Dominik Kubalik,L,,29,0,0,0,0
36,8480884,Calen Addison,D,,24,0,0,0,0
36,8475906,John Klingberg,D,,32,0,0,0,0
36,8480008,Adam Ruzicka,C,,25,0,0,0,0
36,8476884,Derrick Pouliot,D,,30,0,0,0,0
36,8476919,Chris Tierney,C,,30,0,0,0,0
36,8479415,Michael McLeod,C,,26,0,0,0,0
36,8474870,Tyler Johnson,C,,34,0,0,0,0
36,8470604,Jeff Carter,C,,39,0,0,0,0
36,8478104,Sammy Blais,L,,28,0,0,0,0
36,8474884,Mike Hoffman,C,,35,0,0,0,0
36,8481591,Sam Poulin,R,,23,0,0,0,0
36,8471274,Alex Goligoski,D,,39,0,0,0,0
36,8476871,Tanner Pearson,L,,32,0,0,0,0
36,8476393,Nick Cousins,C,,31,0,0,0,0
36,8479977,Kailer Yamamoto,R,,26,0,0,0,0
36,8479346,Dillon Dube,C,,26,0,0,0,0
36,8480184,Gustav Lindstrom,D,,26,0,0,0,0
36,8479376,Victor Mete,D,,26,0,0,0,0
36,8473449,Kyle Okposo,R,,36,0,0,0,0
36,8481058,Jesse Ylonen,R,,25,0,0,0,0
36,8475752,Tyler Pitlick,C,,33,0,0,0,0
36,8481239,Samuel Fagemo,L,,24,0,0,0,0
36,8480821,Filip Zadina,R,,25,0,0,0,0
36,8470966,Mark Giordano,D,,41,0,0,0,0
36,8478495,Denis Gurianov,R,,27,0,0,0,0
36,8477464,Nic Petan,C,,29,0,0,0,0
36,8478099,Kevin Labanc,R,,29,0,0,0,0
36,8482241,Radim Zohorna,L,,28,0,0,0,0
36,8474040,Sam Gagner,C,,35,0,0,0,0
36,8479514,Rem Pitlick,C,,27,0,0,0,0
36,8478430,Oliver Kylington,D,,27,0,0,0,0
36,8479533,Joona Koppanen,L,,26,0,0,0,0
36,8479984,Cal Foote,D,,26,0,0,0,0
36,8477126,Jayson Megna,C,,34,0,0,0,0
36,8475164,Jakob Silfverberg,R,,34,0,0,0,0
36,8474009,Nick Bonino,C,,36,0,0,0,0
36,8479458,Nikita Zaitsev,D,,33,0,0,0,0
36,8477944,Jakub Vrana,L,,28,0,0,0,0
36,8471699,Andrew Cogliano,C,,37,0,0,0,0
36,8478067,Oskar Lindblom,L,,28,0,0,0,0
36,8471686,Marc Staal,D,,37,0,0,0,0
36,8470610,Zach Parise,L,,40,0,0,0,0
36,8478904,Steven Lorentz,C,,28,0,0,0,0
36,8473473,Milan Lucic,L,,36,0,0,0,0
36,8480031,Maxime Comtois,L,,25,0,0,0,0
36,8478512,Austin Czarnik,C,,32,0,0,0,0
36,8473504,Cal Clutterbuck,R,,37,0,0,0,0
36,8477454,Adam Erne,L,,29,0,0,0,0
36,8479383,Boris Katchouk,L,,26,0,0,0,0
36,8475825,Jani Hakanpää,D,,32,0,0,0,0
36,8477846,Ryan Carpenter,C,,33,0,0,0,0
36,8477930,Pierre-Edouard Bellemare,L,,39,0,0,0,0
36,8478400,Colin White,C,,27,0,0,0,0
36,8480226,Marián Studenic,R,,26,0,0,0,0
36,8480853,Liam Foudy,C,,24,0,0,0,0
36,8475797,Jarred Tinordi,D,,32,0,0,0,0
36,8479423,Alex Nylander,L,,26,0,0,0,0
36,8474618,Marco Scandella,D,,34,0,0,0,0
36,8478028,Fredrik Olofsson,L,,28,0,0,0,0
36,8474709,Matt Martin,L,,35,0,0,0,0
36,8481070,Hugh McGing,L,,26,0,0,0,0
36,8479546,Oskar Steen,C,,26,0,0,0,0
36,8474145,Robert Bortuzzo,D,,35,0,0,0,0
36,8476915,Jujhar Khaira,L,,30,0,0,0,0
36,8475278,Byron Froese,C,,33,0,0,0,0
36,8481812,Nikolai Knyzhov,D,,27,0,0,0,0
36,8478408,Travis Dermott,D,,28,0,0,0,0
36,8481077,John Leonard,L,,26,0,0,0,0
36,8479547,Matthew Phillips,R,,26,0,0,0,0
36,8480836,Jonathan Gruden,C,,24,0,0,0,0
36,8481690,Tyler Angle,C,,24,0,0,0,0
36,8475766,Austin Watson,L,,32,0,0,0,0
36,8481016,Ruslan Iskhakov,C,,24,0,0,0,0
36,8478078,Rourke Chartier,C,,28,0,0,0,0
36,8480776,Sheldon Rempal,R,,29,0,0,0,0
36,8478956,Samuel Laberge,L,NJD,27,0,0,0,0
36,8483045,Cameron Butler,R,CBJ,31,0,0,0,0
36,8484314,Jiri Smejkal,L,,28,0,0,0,0
37,8477492,Nathan MacKinnon,C,COL,29,81,49,88,137
37,8478402,Connor McDavid,C,EDM,27,76,46,83,129
37,8478550,Artemi Panarin,L,NYR,33,76,42,79,121
37,8479318,Auston Matthews,C,TOR,27,79,70,46,116
37,8476453,Nikita Kucherov,R,TBL,31,82,34,81,115
37,8478864,Kirill Kaprizov,L,MIN,27,77,44,69,113
37,8477934,Leon Draisaitl,C,EDM,29,78,41,69,110
37,8477956,David Pastrnak,R,BOS,28,81,51,58,109
37,8477939,William Nylander,R,TOR,28,81,43,63,106
37,8480002,Nico Hischier,C,NJD,25,74,44,58,102
37,8478483,Mitch Marner,R,TOR,27,81,28,73,101
37,8475172,Nazem Kadri,C,CGY,34,76,39,61,100
37,8478010,Brayden Point,C,TBL,28,80,49,49,98
37,8476468,J.T. Miller,C,VAN,31,79,33,65,98
37,8478420,Mikko Rantanen,R,COL,28,81,37,59,96
37,8482116,Tim Stützle,C,OTT,22,81,36,60,96
37,8477404,Jake Guentzel,C,TBL,30,82,37,58,95
37,8481559,Jack Hughes,C,NJD,23,75,44,50,94
37,8478403,Jack Eichel,C,VGK,28,79,37,56,93
37,8480027,Jason Robertson,L,DAL,25,82,30,63,93
37,8478445,Mathew Barzal,C,NYI,27,82,26,66,92
37,8474564,Steven Stamkos,C,NSH,34,79,40,48,88
37,8477493,Aleksander Barkov,C,FLA,29,80,29,59,88
37,8471685,Anze Kopitar,C,LAK,37,80,29,59,88
37,8475913,Mark Stone,R,VGK,32,77,25,63,88
37,8479314,Matthew Tkachuk,L,FLA,27,81,24,64,88
37,8480023,Robert Thomas,C,STL,25,74,29,58,87
37,8473419,Brad Marchand,L,BOS,36,80,27,60,87
37,8471675,Sidney Crosby,C,PIT,37,74,40,45,85
37,8480012,Elias Pettersson,C,VAN,26,73,38,46,84
37,8475168,Matt Duchene,C,DAL,33,81,33,51,84
37,8478398,Kyle Connor,L,WPG,28,74,45,38,83
37,8475167,Victor Hedman,D,TBL,34,80,16,67,83
37,8476459,Mika Zibanejad,C,NYR,31,79,35,47,82
37,8478439,Travis Konecny,R,PHI,27,81,33,49,82
37,8478427,Sebastian Aho,C,CAR,27,72,32,50,82
37,8480800,Quinn Hughes,D,VAN,25,75,6,76,82
37,8479542,Brandon Hagel,L,TBL,26,82,39,42,81
37,8480801,Brady Tkachuk,L,OTT,25,80,40,40,80
37,8479343,Clayton Keller,R,UTA,26,79,38,42,80
37,8476887,Filip Forsberg,L,NSH,30,73,35,45,80
37,8475166,John Tavares,C,TOR,34,77,27,53,80
37,8477942,Kevin Fiala,L,LAK,28,82,27,52,79
37,8477960,Adrian Kempe,R,LAK,28,79,44,34,78
37,8476346,Johnny Gaudreau,L,CBJ,31,75,20,58,78
37,8478449,Roope Hintz,C,DAL,28,81,34,43,77
37,8476389,Vincent Trocheck,C,NYR,31,76,29,48,77
37,8480830,Andrei Svechnikov,R,CAR,24,74,27,50,77
37,8471214,Alex Ovechkin,L,WSH,39,74,42,34,76
37,8475786,Zach Hyman,L,EDM,32,81,34,42,76
37,8476881,Tomas Hertl,C,VGK,31,76,27,49,76
37,8478440,Dylan Strome,C,WSH,27,72,20,56,76
37,8478444,Brock Boeser,R,VAN,27,76,36,39,75
37,8476448,William Karlsson,C,VGK,31,79,33,42,75
37,8477940,Nikolaj Ehlers,L,WPG,28,74,29,46,75
37,8480839,Rasmus Dahlin,D,BUF,24,70,23,52,75
37,8477946,Dylan Larkin,C,DET,28,81,38,36,74
37,8476454,Ryan Nugent-Hopkins,C,EDM,31,81,25,49,74
37,8477500,Bo Horvat,C,NYI,29,81,37,36,73
37,8477409,Carter Verhaeghe,C,FLA,29,76,39,33,72
37,8481557,Matt Boldy,L,MIN,23,73,28,43,71
37,8473512,Claude Giroux,R,OTT,36,80,28,43,71
37,8478460,Zach Werenski,D,CBJ,27,79,13,58,71
37,8475158,Ryan O'Reilly,C,NSH,33,69,30,40,70
37,8480803,Evan Bouchard,D,EDM,25,74,18,52,70
37,8475184,Chris Kreider,L,NYR,33,73,37,32,69
37,8477501,Valeri Nichushkin,R,COL,29,78,34,35,69
37,8478047,Michael Bunting,L,PIT,29,72,26,43,69
37,8473994,Jamie Benn,L,DAL,35,82,26,43,69
37,8479407,Jesper Bratt,L,NJD,26,78,19,50,69
37,8475692,Mats Zuccarello,R,MIN,37,75,18,51,69
37,8477504,Josh Morrissey,D,WPG,29,73,16,53,69
37,8475784,Jeff Skinner,C,EDM,32,76,38,30,68
37,8484144,Connor Bedard,C,CHI,19,66,32,36,68
37,8480039,Martin Necas,C,CAR,25,75,30,38,68
37,8475754,Brock Nelson,C,NYI,33,77,29,39,68
37,8479675,Trevor Moore,L,LAK,29,81,26,42,68
37,8478407,Vince Dunn,D,SEA,28,77,16,52,68
37,8476456,Jonathan Huberdeau,C,CGY,31,78,14,54,68
37,8477447,Shea Theodore,D,VGK,29,64,13,55,68
37,8476539,Jonathan Marchessault,R,NSH,34,72,34,33,67
37,8480208,Drake Batherson,R,OTT,26,77,29,38,67
37,8479420,Tage Thompson,C,BUF,27,73,28,39,67
37,8478493,Joel Eriksson Ek,C,MIN,27,73,26,41,67
37,8481540,Cole Caufield,R,MTL,23,76,24,43,67
37,8480018,Nick Suzuki,C,MTL,25,73,19,48,67
37,8477951,Nick Schmaltz,C,UTA,28,77,28,38,66
37,8480069,Cale Makar,D,COL,26,69,23,43,66
37,8480865,Noah Dobson,D,NYI,24,81,14,52,66
37,8477933,Sam Reinhart,C,FLA,29,77,32,33,65
37,8482665,Matty Beniers,C,SEA,22,74,27,38,65
37,8477416,Oliver Bjorkstrand,R,SEA,29,73,27,37,64
37,8478519,Anthony Cirelli,C,TBL,27,82,28,35,63
37,8478469,Thomas Chabot,D,OTT,27,77,16,47,63
37,8477402,Pavel Buchnevich,L,STL,29,72,33,29,62
37,8478414,Timo Meier,R,NJD,28,77,31,31,62
37,8479385,Jordan Kyrou,C,STL,26,77,28,34,62
37,8476460,Mark Scheifele,C,WPG,31,74,28,34,62
37,8478873,Troy Terry,R,ANA,27,71,18,44,62
37,8476432,Boone Jenner,C,CBJ,31,71,37,24,61
37,8477955,Jared McCann,L,SEA,28,74,36,25,61
37,8482740,Wyatt Johnston,C,DAL,21,79,27,34,61
37,8475794,Tyler Seguin,C,DAL,32,81,24,37,61
37,8474141,Patrick Kane,R,DET,36,79,20,41,61
37,8482124,Quinton Byfield,R,LAK,22,80,18,43,61
37,8474590,John Carlson,D,WSH,34,73,10,51,61
37,8475810,Bryan Rust,R,PIT,32,73,31,29,60
37,8477496,Elias Lindholm,C,BOS,30,79,28,32,60
37,8481528,Dylan Cozens,C,BUF,23,73,17,43,60
37,8476853,Morgan Rielly,D,TOR,30,65,10,50,60
37,8476399,Blake Coleman,C,CGY,33,80,35,24,59
37,8482093,Seth Jarvis,C,CAR,22,68,28,31,59
37,8476905,Chandler Stephenson,C,SEA,30,73,19,40,59
37,8478542,Evan Rodrigues,C,FLA,31,79,26,32,58
37,8482109,Alexis Lafrenière,L,NYR,23,76,24,34,58
37,8481533,Trevor Zegras,C,ANA,23,72,23,35,58
37,8475798,Mikael Granlund,C,SJS,32,68,21,37,58
37,8481596,Shane Pinto,C,OTT,24,75,21,37,58
37,8477021,Alex Kerfoot,C,UTA,30,79,17,41,58
37,8480036,Miro Heiskanen,D,DAL,25,76,10,48,58
37,8478975,Mason Marchment,L,DAL,29,80,23,34,57
37,8479337,Alex DeBrincat,R,DET,27,81,22,35,57
37,8478401,Pavel Zacha,C,BOS,27,78,21,36,57
37,8482113,Anton Lundell,C,FLA,23,81,18,39,57
37,8479999,Casey Mittelstadt,C,COL,26,81,14,43,57
37,8476875,Mike Matheson,D,MTL,30,70,14,43,57
37,8475151,Kyle Palmieri,C,NYI,33,81,32,24,56
37,8477935,Sam Bennett,C,FLA,28,78,21,35,56
37,8474679,Gustav Nyquist,C,NSH,35,77,15,41,56
37,8474578,Erik Karlsson,D,PIT,34,79,13,43,56
37,8479325,Charlie McAvoy,D,BOS,27,73,12,44,56
37,8478462,Nicolas Roy,C,VGK,27,75,27,28,55
37,8483808,Andrei Kuzmenko,L,CGY,28,74,26,29,55
37,8471215,Evgeni Malkin,C,PIT,38,70,23,32,55
37,8476462,Dougie Hamilton,D,NJD,31,70,17,38,55
37,8477986,Brandon Montour,D,SEA,30,72,13,42,55
37,8474600,Roman Josi,D,NSH,34,75,12,43,55
37,8477503,Max Domi,C,TOR,29,77,12,43,55
37,8482159,Tyson Foerster,R,PHI,22,77,27,27,54
37,8482745,Mason McTavish,C,ANA,21,75,27,27,54
37,8480015,Owen Tippett,R,PHI,25,71,25,29,54
37,8484166,Adam Fantilli,C,CBJ,20,68,25,29,54
37,8475170,Brayden Schenn,C,STL,33,76,21,33,54
37,8482110,Dawson Mercer,C,NJD,23,73,21,33,54
37,8476826,Yanni Gourde,C,SEA,33,76,21,33,54
37,8482078,Lucas Raymond,L,DET,22,80,20,34,54
37,8479323,Adam Fox,D,NYR,26,72,14,40,54
37,8481711,Matias Maccelli,L,UTA,24,69,13,41,54
37,8477476,Artturi Lehkonen,L,COL,29,80,29,24,53
37,8483515,Juraj Slafkovsky,L,MTL,20,77,28,25,53
37,8482175,JJ Peterka,R,BUF,22,68,28,25,53
37,8479525,Ross Colton,C,COL,28,79,26,27,53
37,8477497,Sean Monahan,C,CBJ,30,67,23,30,53
37,8482705,Cole Sillinger,C,CBJ,21,63,22,31,53
37,8475191,Reilly Smith,R,NYR,33,75,19,34,53
37,8471698,T.J. Oshie,R,WSH,38,65,34,18,52
37,8474150,Mikael Backlund,C,CGY,35,79,18,34,52
37,8474641,Adam Henrique,C,EDM,34,77,25,26,51
37,8475765,Vladimir Tarasenko,R,DET,33,79,22,29,51
37,8481524,Bowen Byram,D,BUF,23,68,22,29,51
37,8477494,Jonathan Drouin,L,COL,29,82,21,30,51
37,8475218,Mattias Ekholm,D,EDM,34,74,14,37,51
37,8475726,Tyler Toffoli,C,SJS,32,66,21,29,50
37,8476882,Teuvo Teravainen,C,CHI,30,64,21,29,50
37,8477949,Alex Tuch,R,BUF,28,70,20,30,50
37,8475314,Anders Lee,L,NYI,34,79,18,32,50
37,8481618,Alex Newhook,C,MTL,23,76,17,33,50
37,8477346,MacKenzie Weegar,D,CGY,30,73,15,35,50
37,8482684,Luke Hughes,D,NJD,21,74,7,43,50
37,8482699,Dylan Guenther,R,UTA,21,76,31,18,49
37,8477444,Andre Burakovsky,L,SEA,29,74,24,25,49
37,8480064,Josh Norris,C,OTT,25,75,24,25,49
37,8477964,Ivan Barbashev,C,VGK,29,76,23,26,49
37,8475169,Evander Kane,L,EDM,33,73,17,32,49
37,8476479,Phillip Danault,C,LAK,31,78,16,33,49
37,8474102,David Perron,L,OTT,36,74,15,34,49
37,8479345,Jakob Chychrun,D,WSH,26,67,14,35,49
37,8476958,Jaccob Slavin,D,CAR,30,76,7,42,49
37,8480893,Kirill Marchenko,R,CBJ,24,66,34,14,48
37,8482146,Luke Evangelista,R,NSH,22,72,23,25,48
37,8477407,Anthony Duclair,L,NYI,29,77,23,25,48
37,8484153,Leo Carlsson,C,ANA,20,76,20,28,48
37,8481604,Pavel Dorofeyev,L,VGK,24,73,19,29,48
37,8478115,Pierre Engvall,L,NYI,28,79,19,29,48
37,8476906,Shayne Gostisbehere,D,CAR,31,76,16,32,48
37,8482149,Cole Perfetti,C,WPG,22,65,16,32,48
37,8475722,Jason Zucker,L,BUF,32,66,24,23,47
37,8481068,Yegor Sharangovich,C,CGY,26,78,20,27,47
37,8480014,Gabriel Vilardi,C,WPG,25,68,29,17,46
37,8482702,Logan Stankoven,C,DAL,21,81,22,24,46
37,8478498,Jake DeBrusk,L,VAN,28,73,21,25,46
37,8479400,Pierre-Luc Dubois,L,WSH,26,71,21,25,46
37,8484145,Zach Benson,L,BUF,19,68,17,29,46
37,8470613,Brent Burns,D,CAR,39,77,15,31,46
37,8478438,Tommy Novak,C,NSH,27,75,15,31,46
37,8481577,Philip Tomasino,C,NSH,23,68,14,32,46
37,8481560,Arthur Kaliyev,R,LAK,23,78,30,15,45
37,8476880,Tom Wilson,R,WSH,30,70,22,23,45
37,8477511,Anthony Mantha,R,CGY,30,72,21,24,45
37,8482092,Ridly Greig,C,OTT,22,79,21,24,45
37,8477952,Robby Fabbri,C,ANA,28,68,20,25,45
37,8477495,Seth Jones,D,CHI,30,69,13,32,45
37,8478038,Devon Toews,D,COL,30,72,7,38,45
37,8477426,Nicholas Paul,L,TBL,29,82,22,22,44
37,8474149,Evgenii Dadonov,R,DAL,35,80,21,23,44
37,8474586,Jordan Eberle,R,SEA,34,70,18,26,44
37,8478055,Gustav Forsling,D,FLA,28,75,17,27,44
37,8475760,Nick Bjugstad,C,UTA,32,76,14,30,44
37,8476419,Jean-Gabriel Pageau,C,NYI,32,74,14,30,44
37,8474565,Alex Pietrangelo,D,VGK,34,63,13,31,44
37,8477479,Tyler Bertuzzi,L,CHI,29,66,13,31,44
37,8483431,Logan Cooley,C,UTA,20,77,20,23,43
37,8482667,William Eklund,L,SJS,22,65,17,26,43
37,8477998,Warren Foegele,L,LAK,28,78,15,28,43
37,8475763,Kevin Hayes,R,PIT,32,65,14,29,43
37,8471724,Kris Letang,D,PIT,37,80,5,38,43
37,8480798,Philipp Kurashev,C,CHI,25,62,12,30,42
37,8477932,Aaron Ekblad,D,FLA,28,71,12,30,42
37,8478856,Conor Garland,R,VAN,28,74,18,23,41
37,8479987,Morgan Geekie,C,BOS,26,77,16,25,41
37,8477948,Travis Sanheim,D,PHI,28,67,10,31,41
37,8481542,Moritz Seider,D,DET,23,71,7,34,41
37,8475848,Brendan Gallagher,R,MTL,32,67,22,18,40
37,8477456,J.T. Compher,L,DET,29,81,17,23,40
37,8478233,Andrew Mangiapane,L,WSH,28,70,16,24,40
37,8478133,Jake Evans,C,MTL,28,72,16,24,40
37,8482720,Matthew Knies,L,TOR,22,77,14,26,40
37,8476461,Sean Couturier,C,PHI,32,72,10,30,40
37,8476792,Torey Krug,D,STL,33,77,7,33,40
37,8479365,Trent Frederic,C,BOS,26,77,26,13,39
37,8480829,Jesperi Kotkaniemi,C,CAR,24,59,20,19,39
37,8479339,Patrik Laine,L,CBJ,26,62,12,27,39
37,8478397,Rasmus Andersson,D,CGY,28,70,9,30,39
37,8476869,Brady Skjei,D,NSH,30,73,9,30,39
37,8475768,Jaden Schwartz,C,SEA,32,70,7,32,39
37,8475714,Calle Jarnkrok,C,TOR,33,80,17,21,38
37,8481186,Logan O'Connor,R,COL,28,79,17,21,38
37,8478466,Daniel Sprong,R,VAN,27,66,15,23,38
37,8481581,Thomas Harley,D,DAL,23,74,13,25,38
37,8478396,Noah Hanifin,D,VGK,27,60,10,28,38
37,8476854,Hampus Lindholm,D,BOS,30,77,6,32,38
37,8478366,Frank Vatrano,R,ANA,30,69,20,17,37
37,8476438,Brandon Saad,L,STL,32,69,18,19,37
37,8478474,Lawson Crouse,L,UTA,27,71,18,19,37
37,8480185,Eetu Luostarinen,C,FLA,26,76,18,19,37
37,8482133,Thomas Bordeleau,C,SJS,22,64,16,21,37
37,8479992,Michael Rasmussen,C,DET,25,74,14,23,37
37,8479410,Mikhail Sergachev,D,UTA,26,70,11,26,37
37,8480817,K'Andre Miller,D,NYR,24,74,9,28,37
37,8480434,Sean Durzi,D,UTA,26,70,8,29,37
37,8482712,Oskar Olausson,R,COL,22,82,6,31,37
37,8476483,Rickard Rakell,R,PIT,31,74,20,16,36
37,8480849,Barrett Hayton,C,UTA,24,72,17,19,36
37,8473422,Nick Foligno,L,CHI,37,64,17,19,36
37,8475799,Nino Niederreiter,R,WPG,32,71,15,21,36
37,8478472,Mathieu Joseph,R,STL,27,66,14,22,36
37,8480009,Eeli Tolvanen,R,SEA,25,63,12,24,36
37,8481656,Aliaksei Protas,C,WSH,23,64,11,25,36
37,8480855,Jack McBain,C,UTA,24,68,11,25,36
37,8477220,Nate Schmidt,D,FLA,33,71,8,28,36
37,8476981,Josh Anderson,R,MTL,30,75,19,16,35
37,8480188,Fabian Zetterlund,L,SJS,25,62,15,20,35
37,8474563,Drew Doughty,D,LAK,35,74,11,24,35
37,8480028,Morgan Frost,C,PHI,25,73,17,17,34
37,8482097,Jack Quinn,R,BUF,23,62,15,19,34
37,8476927,Teddy Blueger,C,VAN,30,67,15,19,34
37,8477451,Ryan Hartman,R,MIN,30,66,15,19,34
37,8480835,Jack Drury,C,CAR,24,65,15,19,34
37,8480459,Pius Suter,C,VAN,28,69,15,19,34
37,8474053,Logan Couture,C,SJS,35,63,14,20,34
37,8473986,Alex Killorn,L,ANA,35,67,13,21,34
37,8482475,Yegor Chinakhov,R,CBJ,23,54,12,22,34
37,8475745,Charlie Coyle,C,BOS,32,77,11,23,34
37,8480797,Joel Farabee,L,PHI,24,72,11,23,34
37,8478458,John (Jack) Roslovic,C,CAR,27,68,11,23,34
37,8483490,Pavel Mintyukov,D,ANA,21,77,10,24,34
37,8475753,Justin Faulk,D,STL,32,77,9,25,34
37,8477839,Conor Sheary,L,TBL,32,82,8,26,34
37,8479591,Michael Eyssimont,C,TBL,28,81,18,15,33
37,8475149,Marcus Johansson,L,MIN,34,66,15,18,33
37,8482737,Zack Bolduc,C,STL,21,65,14,19,33
37,8480802,Ryan McLeod,C,BUF,25,67,13,20,33
37,8478057,Dakota Joshua,C,VAN,28,71,13,20,33
37,8481554,Kaapo Kakko,R,NYR,23,70,11,22,33
37,8475793,Ryan Johansen,C,PHI,32,69,10,23,33
37,8481523,Kirby Dach,C,MTL,23,61,10,23,33
37,8476463,Jonas Brodin,D,MIN,31,78,10,23,33
37,8476467,Jamie Oleksiak,D,SEA,32,68,10,23,33
37,8478413,Jordan Greenway,L,BUF,27,61,10,23,33
37,8476458,Ryan Strome,C,ANA,31,74,8,25,33
37,8482660,Kent Johnson,C,CBJ,22,65,4,29,33
37,8476474,Stefan Noesen,R,NJD,31,62,21,11,32
37,8481624,Ilya Mikheyev,R,CHI,30,62,14,18,32
37,8477429,Andrew Copp,C,DET,30,80,13,19,32
37,8480220,Noah Cates,L,PHI,25,71,12,20,32
37,8478042,Viktor Arvidsson,L,EDM,31,78,11,21,32
37,8482122,Brock Faber,D,MIN,22,77,5,27,32
37,8476917,Adam Pelech,D,NYI,30,78,5,27,32
37,8482105,Jake Sanderson,D,OTT,22,71,3,29,32
37,8474715,Cameron Atkinson,R,TBL,35,80,17,14,31
37,8480068,Ryan Poehling,C,PHI,25,69,14,17,31
37,8482074,Connor Zary,C,CGY,23,61,14,17,31
37,8477947,Sonny Milano,L,WSH,28,66,13,18,31
37,8479351,Sam Steel,C,DAL,26,80,12,19,31
37,8478891,Mason Appleton,C,WPG,28,56,11,20,31
37,8476422,Mike Reilly,D,NYI,31,75,11,20,31
37,8477953,Kasperi Kapanen,R,STL,28,68,9,22,31
37,8478970,Jalen Chatfield,D,CAR,28,66,8,23,31
37,8477969,Marcus Pettersson,D,PIT,28,77,7,24,31
37,8475764,Cam Fowler,D,ANA,33,72,5,26,31
37,8476923,Damon Severson,D,CBJ,30,80,5,26,31
37,8479425,Filip Hronek,D,VAN,27,74,3,28,31
37,8475181,Nick Leddy,D,STL,33,66,2,29,31
37,8476872,Scott Laughton,C,PHI,30,77,15,15,30
37,8481582,Nicholas Robertson,L,TOR,23,72,14,16,30
37,8480813,Joe Veleno,C,DET,24,74,11,19,30
37,8483445,Cutter Gauthier,L,ANA,20,67,11,19,30
37,8475287,Erik Haula,L,NJD,33,67,8,22,30
37,8479996,Cody Glass,C,NSH,25,62,8,22,30
37,8476392,Adam Lowry,C,WPG,31,59,7,23,30
37,8479402,Jake Bean,D,CGY,26,65,7,23,30
37,8478109,Victor Olofsson,L,VGK,29,69,16,13,29
37,8478046,Danton Heinen,L,VAN,29,69,12,17,29
37,8477505,Alexander Wennberg,C,SJS,30,64,12,17,29
37,8476878,Zemgus Girgensons,C,TBL,30,79,12,17,29
37,8476292,Ondrej Palat,L,NJD,33,66,11,18,29
37,8483505,Matthew Poitras,C,BOS,20,76,9,20,29
37,8478434,Keegan Kolesar,R,VGK,27,63,9,20,29
37,8478500,Ivan Provorov,D,CBJ,27,78,7,22,29
37,8477506,Ryan Pulock,D,NYI,30,78,7,22,29
37,8482079,Marco Rossi,C,MIN,23,58,18,10,28
37,8482089,Jake Neighbours,L,STL,22,66,15,13,28
37,8476278,Colin Blackwell,C,DAL,31,82,14,14,28
37,8480113,Alex Iafallo,L,WPG,31,65,13,15,28
37,8476921,Jordan Martinook,L,CAR,32,64,10,18,28
37,8475791,Taylor Hall,L,CHI,33,58,9,19,28
37,8482624,Daniil Miromanov,D,CGY,27,68,6,22,28
37,8478882,Vladislav Gavrikov,D,LAK,29,66,6,22,28
37,8478020,Michael Amadio,R,OTT,28,75,16,11,27
37,8481601,Simon Holmstrom,R,NYI,23,69,15,12,27
37,8481580,Connor McMichael,C,WSH,23,58,13,14,27
37,8479316,Luke Kunin,C,SJS,27,60,12,15,27
37,8473533,Jordan Staal,C,CAR,36,61,12,15,27
37,8479661,Tanner Jeannot,L,LAK,27,76,12,15,27
37,8477989,Christian Dvorak,C,MTL,28,65,11,16,27
37,8473453,Trevor Lewis,C,LAK,37,73,11,16,27
37,8480003,Jesper Boqvist,C,FLA,26,58,10,17,27
37,8475220,Marcus Foligno,L,MIN,33,65,9,18,27
37,8476885,Jacob Trouba,D,NYR,30,72,8,19,27
37,8481703,Valtteri Puustinen,R,PIT,25,59,6,21,27
37,8476892,Colton Parayko,D,STL,31,72,6,21,27
37,8480873,Rasmus Sandin,D,WSH,24,64,6,21,27
37,8482655,Janis Moser,D,TBL,24,73,3,24,27
37,8480078,Filip Chytil,C,NYR,25,66,12,14,26
37,8477425,Miles Wood,L,COL,29,78,12,14,26
37,8475225,Craig Smith,C,CHI,35,57,11,15,26
37,8478043,Sam Lafferty,C,BUF,29,53,10,16,26
37,8475200,Dmitry Orlov,D,CAR,33,74,7,19,26
37,8478911,Matt Roy,D,WSH,29,69,6,20,26
37,8476979,Erik Gustafsson,D,DET,32,72,4,22,26
37,8480043,Timothy Liljegren,D,TOR,25,63,2,24,26
37,8482125,Alexander Holtz,R,VGK,22,61,17,8,25
37,8482749,Joshua Roy,R,MTL,21,68,13,12,25
37,8483524,Shane Wright,C,SEA,20,71,11,14,25
37,8479293,Brandon Tanev,L,SEA,33,64,11,14,25
37,8479315,Joey Anderson,R,CHI,26,49,10,15,25
37,8476480,Vladislav Namestnikov,C,WPG,32,69,10,15,25
37,8480871,Adam Boqvist,D,FLA,24,61,7,18,25
37,8480336,Sean Walker,D,CAR,30,70,7,18,25
37,8477015,Connor Brown,R,EDM,30,66,6,19,25
37,8477498,Darnell Nurse,D,EDM,29,72,5,20,25
37,8476988,Matt Benning,D,SJS,30,65,5,20,25
37,8482671,Owen Power,D,BUF,22,67,4,21,25
37,8480887,Jordan Harris,D,MTL,24,58,3,22,25
37,8481546,Cam York,D,PHI,23,71,2,23,25
37,8480891,Michael Kesselring,D,UTA,24,62,1,24,25
37,8480144,David Kampf,C,TOR,29,66,14,10,24
37,8476897,Oskar Sundqvist,C,STL,30,66,12,12,24
37,8481481,Blake Lizotte,C,PIT,27,63,11,13,24
37,8479368,Max Jones,L,BOS,26,63,10,14,24
37,8484203,Bradly Nadeau,L,CAR,19,58,9,15,24
37,8481522,Peyton Krebs,C,BUF,23,56,7,17,24
37,8473563,Nicklas Backstrom,C,WSH,37,51,7,17,24
37,8479983,Mario Ferraro,D,SJS,26,69,6,18,24
37,8478013,Jake Walman,D,SJS,28,67,5,19,24
37,8482192,Isaak Phillips,D,CHI,23,57,5,19,24
37,8477488,Brett Pesce,D,NJD,30,66,4,20,24
37,8475790,Erik Gudbranson,D,CBJ,32,73,3,21,24
37,8481568,Alex Vlasic,D,CHI,23,51,2,22,24
37,8482259,Bobby McMann,C,TOR,28,64,20,3,23
37,8480205,Emil Bemstrom,C,PIT,25,58,16,7,23
37,8476469,Joel Armia,R,MTL,31,68,14,9,23
37,8474189,Lars Eller,C,PIT,35,63,12,11,23
37,8480448,Parker Kelly,L,COL,25,74,12,11,23
37,8477478,William Carrier,L,CAR,30,58,12,11,23
37,8476873,Mark Jankowski,C,NSH,30,49,10,13,23
37,8483468,Jiri Kulich,C,BUF,20,64,9,14,23
37,8478508,Yakov Trenin,C,MIN,27,48,9,14,23
37,8480289,Morgan Barron,C,WPG,26,62,9,14,23
37,8479941,Justin Danforth,R,CBJ,31,62,8,15,23
37,8482111,Justin Barron,D,MTL,23,72,7,16,23
37,8482809,Jackson Blake,R,CAR,21,57,7,16,23
37,8478463,Anthony Beauvillier,L,PIT,27,67,6,17,23
37,8477435,Ryan Graves,D,PIT,29,79,5,18,23
37,8479398,Samuel Girard,D,COL,26,66,5,18,23
37,8476931,Jake McCabe,D,TOR,31,69,3,20,23
37,8483460,David Jiricek,D,CBJ,21,60,2,21,23
37,8476331,Dylan DeMelo,D,WPG,31,67,2,21,23
37,8480980,Connor Dewar,C,TOR,25,61,13,9,22
37,8479393,Noah Gregor,L,OTT,26,78,12,10,22
37,8481441,Joe Snively,C,DET,28,68,11,11,22
37,8477903,Garnet Hathaway,R,PHI,33,66,11,11,22
37,8481032,Paul Cotter,C,NJD,25,58,9,13,22
37,8482142,Jamie Drysdale,D,PHI,22,62,9,13,22
37,8481093,Rafael Harvey-Pinard,L,MTL,25,62,8,14,22
37,8480789,Oliver Wahlstrom,R,NYI,24,68,7,15,22
37,8476429,Scott Mayfield,D,NYI,32,75,6,16,22
37,8477507,Nikita Zadorov,D,BOS,29,66,5,17,22
37,8482679,Matt Coronato,R,CGY,22,66,4,18,22
37,8476902,Esa Lindell,D,DAL,30,77,4,18,22
37,8476457,Adam Larsson,D,SEA,32,67,4,18,22
37,8479619,Michael Carcone,L,UTA,28,56,13,8,21
37,8476374,Sean Kuraly,C,CBJ,31,53,13,8,21
37,8481704,Juuso Parssinen,C,NSH,23,59,11,10,21
37,8477987,Ryan Donato,C,CHI,28,53,9,12,21
37,8477573,Nathan Walker,L,STL,30,54,9,12,21
37,8474716,Jared Spurgeon,D,MIN,35,76,8,13,21
37,8483565,Nick Blankenburg,D,NSH,26,59,8,13,21
37,8482067,Connor Mackey,D,NYR,28,65,7,14,21
37,8480806,Isac Lundestrom,C,ANA,25,59,7,14,21
37,8478851,Alexandre Carrier,D,NSH,28,67,6,15,21
37,8474574,Tyler Myers,D,VAN,34,76,6,15,21
37,8480073,Erik Brannstrom,D,COL,25,61,5,16,21
37,8470600,Ryan Suter,D,STL,39,69,4,17,21
37,8478840,Will Borgen,D,SEA,28,65,2,19,21
37,8475171,Oliver Ekman-Larsson,D,TOR,33,67,2,19,21
37,8478178,Darren Raddysh,D,TBL,28,71,2,19,21
37,8481014,Alexander Romanov,D,NYI,24,78,2,19,21
37,8479944,Zach Aston-Reese,C,VGK,30,58,13,7,20
37,8481535,Nils Hoglander,L,VAN,24,60,12,8,20
37,8481518,Nolan Foote,L,NJD,24,40,12,8,20
37,8479390,Taylor Raddysh,R,WSH,26,61,9,11,20
37,8470621,Corey Perry,R,EDM,39,70,9,11,20
37,8480011,Klim Kostin,C,SJS,25,56,9,11,20
37,8482803,Olen Zellweger,D,ANA,21,62,8,12,20
37,8475193,Tomas Tatar,L,NJD,34,72,7,13,20
37,8475343,Nic Dowd,C,WSH,34,65,7,13,20
37,8481553,Bobby Brink,R,PHI,23,61,7,13,20
37,8475324,Nick Jensen,D,OTT,34,64,6,14,20
37,8479353,Brett Howden,C,VGK,26,64,5,15,20
37,8481606,Jordan Spence,D,LAK,23,66,5,15,20
37,8477406,Mattias Janmark,C,EDM,32,59,5,15,20
37,8482148,Hendrix Lapierre,C,WSH,22,52,5,15,20
37,8480246,Nick Perbix,D,TBL,26,77,5,15,20
37,8480049,Dylan Samberg,D,WPG,25,68,5,15,20
37,8475188,Brayden McNabb,D,VGK,33,55,5,15,20
37,8480145,Neal Pionk,D,WPG,29,73,4,16,20
37,8479976,Juuso Valimaki,D,UTA,26,64,2,18,20
37,8482073,Braden Schneider,D,NYR,23,58,2,18,20
37,8482055,Drew O'Connor,L,PIT,26,62,11,8,19
37,8475855,Jesper Fast,R,CAR,33,62,11,8,19
37,8476822,Luke Glendening,C,TBL,35,79,11,8,19
37,8477450,Jason Dickinson,C,CHI,29,53,10,9,19
37,8483499,Liam Ohgren,L,MIN,20,53,10,9,19
37,8479336,Carl Grundstrom,R,SJS,27,51,9,10,19
37,8477508,Curtis Lazar,C,NJD,29,64,8,11,19
37,8476889,Radek Faksa,C,STL,30,54,8,11,19
37,8477392,Hudson Fasching,R,NYI,29,66,8,11,19
37,8476925,Colton Sissons,C,NSH,31,63,7,12,19
37,8477919,Frederick Gaudreau,C,MIN,31,63,7,12,19
37,8481521,Ronnie Attard,D,PHI,25,61,6,13,19
37,8479026,Philippe Myers,D,TOR,27,54,6,13,19
37,8482730,Brandt Clarke,D,LAK,21,60,6,13,19
37,8479639,Dylan Coghlan,D,WPG,26,66,5,14,19
37,8483457,Lane Hutson,D,MTL,20,64,5,14,19
37,8478136,Jake Middleton,D,MIN,28,75,3,16,19
37,8480172,Jan Rutta,D,SJS,34,62,3,16,19
37,8481567,Henry Thrun,D,SJS,23,46,3,16,19
37,8479998,Mikey Anderson,D,LAK,25,59,2,17,19
37,8480001,Urho Vaakanainen,D,ANA,25,50,1,18,19
37,8479328,Julien Gauthier,R,NYI,27,57,10,8,18
37,8481161,Jake Christiansen,D,CBJ,25,58,10,8,18
37,8477353,Tyler Motte,C,DET,29,69,8,10,18
37,8476329,Travis Boyd,C,MIN,31,57,8,10,18
37,8475279,Ben Chiarot,D,DET,33,65,8,10,18
37,8479359,Beck Malenstyn,L,BUF,26,48,8,10,18
37,8480762,Eric Robinson,L,CAR,29,56,7,11,18
37,8483493,Frank Nazar,C,CHI,20,53,7,11,18
37,8481019,David Gustafsson,C,WPG,24,47,4,14,18
37,8478399,Jonas Siegenthaler,D,NJD,27,64,4,14,18
37,8482101,Danil Gushchin,L,SJS,22,57,4,14,18
37,8476312,Josh Manson,D,COL,33,64,3,15,18
37,8478507,John Marino,D,UTA,27,68,3,15,18
37,8480222,Sebastian Aho,D,PIT,28,68,3,15,18
37,8482095,Tyler Kleven,D,OTT,22,47,3,15,18
37,8476879,Cody Ceci,D,EDM,31,65,2,16,18
37,8480281,Alexey Toropchenko,R,STL,25,63,13,4,17
37,8475231,Casey Cizikas,C,NYI,33,74,11,6,17
37,8476960,Andreas Athanasiou,C,CHI,30,50,10,7,17
37,8480748,Kiefer Sherwood,L,VAN,29,54,9,8,17
37,8478585,Derek Ryan,C,EDM,38,60,9,8,17
37,8482155,Alex Laferriere,R,LAK,23,57,8,9,17
37,8478569,Noel Acciari,C,PIT,33,66,8,9,17
37,8480995,Pontus Holmberg,R,TOR,25,56,7,10,17
37,8481517,Brett Leason,R,ANA,25,54,7,10,17
37,8480035,Henri Jokiharju,D,BUF,25,65,5,12,17
37,8477369,Carson Soucy,D,VAN,30,64,5,12,17
37,8481550,Adam Beckman,L,NJD,23,45,5,12,17
37,8475690,Chris Tanev,D,TOR,35,63,4,13,17
37,8480021,Jack Studnicka,C,LAK,25,54,3,14,17
37,8482087,Kaiden Guhle,D,MTL,22,63,3,14,17
37,8475233,David Savard,D,MTL,34,63,2,15,17
37,8476891,Matthew Grzelcyk,D,PIT,30,78,1,16,17
37,8474151,Ryan McDonagh,D,TBL,35,73,1,16,17
37,8474567,Zach Bogosian,D,MIN,34,58,0,17,17
37,8481641,Joel Kiviranta,L,COL,28,75,10,6,16
37,8471709,Marc-Edouard Vlasic,D,SJS,37,65,8,8,16
37,8482166,Shakir Mukhamadullin,D,SJS,22,51,7,9,16
37,8481527,Kaedan Korczak,D,VGK,23,55,6,10,16
37,8477931,Tomas Nosek,L,FLA,32,57,6,10,16
37,8474034,Patrick Maroon,L,CHI,36,54,5,11,16
37,8476856,Mathew Dumba,D,DAL,30,71,5,11,16
37,8482451,Mikael Pyyhtia,L,CBJ,23,41,5,11,16
37,8480878,Nils Lundkvist,D,DAL,24,68,3,13,16
37,8475179,Dmitry Kulikov,D,FLA,34,64,3,13,16
37,8477018,Ben Hutton,D,VGK,31,48,3,13,16
37,8480860,Kevin Bahl,D,CGY,24,56,3,13,16
37,8479980,Nicolas Hague,D,VGK,26,52,3,13,16
37,8482245,Artem Zub,D,OTT,29,78,2,14,16
37,8476918,Jimmy Vesey,L,NYR,31,72,9,6,15
37,8481028,Martin Pospisil,C,CGY,25,61,9,6,15
37,8479414,Nathan Bastian,R,NJD,27,57,8,7,15
37,8478432,Christian Fischer,R,DET,27,76,7,8,15
37,8483495,Simon Nemec,D,NJD,20,56,6,9,15
37,8480848,Ty Dellandrea,C,SJS,24,48,6,9,15
37,8482666,Scott Morrow,D,CAR,22,53,6,9,15
37,8480025,MacKenzie Entwistle,R,FLA,25,61,4,11,15
37,8484149,Gavin Brindley,C,CBJ,20,55,4,11,15
37,8471677,Jack Johnson,D,CBJ,37,64,3,12,15
37,8479370,Tyson Jost,C,CAR,26,49,2,13,15
37,8478451,Ethan Bear,D,WSH,27,49,2,13,15
37,8474166,Alec Martinez,D,CHI,37,45,1,14,15
37,8481716,Dmitri Voronkov,L,CBJ,24,54,9,5,14
37,8481592,Jakob Pelletier,L,CGY,23,48,9,5,14
37,8482117,Lukas Reichel,L,CHI,22,58,8,6,14
37,8483482,Tristan Luneau,D,ANA,20,64,8,6,14
37,8479344,Jesse Puljujarvi,R,PIT,26,47,8,6,14
37,8477979,Nicolas Aube-Kubel,R,BUF,28,55,7,7,14
37,8475842,Sam Carrick,C,NYR,32,57,7,7,14
37,8477446,Michael McCarron,R,NSH,29,49,6,8,14
37,8478421,A.J. Greer,L,FLA,28,56,6,8,14
37,8479324,Ryan Lindgren,D,NYR,26,71,5,9,14
37,8480796,Martin Fehervary,D,WSH,25,57,5,9,14
37,8481167,Brayden Pachal,D,CGY,25,53,5,9,14
37,8477499,Rasmus Ristolainen,D,PHI,30,62,4,10,14
37,8473507,Jeff Petry,D,DET,37,73,4,10,14
37,8474673,TJ Brodie,D,CHI,34,64,2,12,14
37,8477365,Connor Clifton,D,BUF,29,58,1,13,14
37,8475455,Brenden Dillon,D,NJD,34,63,1,13,14
37,8476874,Olli Maatta,D,DET,30,65,1,13,14
37,8480879,Jacob Bernard-Docker,D,OTT,24,43,0,14,14
37,8481617,Vasily Podkolzin,R,VAN,23,45,7,6,13
37,8479543,Michael Pezzetta,L,MTL,26,51,6,7,13
37,8479066,Ryan Lomberg,L,CGY,30,58,6,7,13
37,8482157,Will Cuylle,L,NYR,22,62,6,7,13
37,8479994,Jaret Anderson-Dolan,C,WPG,25,41,6,7,13
37,8479968,Vinni Lettieri,C,BOS,29,48,6,7,13
37,8478409,Anthony Richard,C,PHI,28,33,6,7,13
37,8476994,Vinnie Hinostroza,C,NSH,30,44,5,8,13
37,8480807,Mattias Samuelsson,D,BUF,24,56,5,8,13
37,8482634,Alex Steeves,C,TOR,25,53,5,8,13
37,8480074,Alexandre Texier,C,STL,25,52,4,9,13
37,8480157,Calle Rosen,D,COL,30,47,4,9,13
37,8478416,Erik Cernak,D,TBL,27,66,2,11,13
37,8483491,Ivan Miroshnichenko,L,WSH,20,60,8,4,12
37,8481477,Nico Sturm,C,SJS,29,58,7,5,12
37,8479536,Axel Jonsson-Fjallby,L,WPG,26,38,6,6,12
37,8481147,Reese Johnson,C,MIN,26,37,5,7,12
37,8477938,Haydn Fleury,D,WPG,28,48,4,8,12
37,8481537,Nikita Okhotiuk,D,CGY,24,44,3,9,12
37,8482747,Brennan Othmann,L,NYR,21,43,3,9,12
37,8479291,Kevin Rooney,C,CGY,31,49,3,9,12
37,8480058,Pierre-Olivier Joseph,D,STL,25,48,3,9,12
37,8482861,Vincent Iorio,D,WSH,22,33,2,10,12
37,8475462,Radko Gudas,D,ANA,34,73,2,10,12
37,8482062,Cole Smith,L,NSH,29,51,1,11,12
37,8483466,Kevin Korchinski,D,CHI,20,56,1,11,12
37,8477845,Trevor van Riemsdyk,D,WSH,33,58,0,12,12
37,8479718,Alex Barré-Boulet,C,MTL,27,44,7,4,11
37,8480844,Grigori Denisenko,L,VGK,24,36,7,4,11
37,8479671,Mathieu Olivier,R,CBJ,27,47,6,5,11
37,8478211,Dryden Hunt,L,CGY,29,53,6,5,11
37,8477962,Brendan Lemieux,L,CAR,28,38,6,5,11
37,8479442,Troy Stecher,D,EDM,30,57,6,5,11
37,8476624,Barclay Goodrow,C,SJS,31,47,5,6,11
37,8482176,Wyatt Kaiser,D,CHI,22,51,5,6,11
37,8480727,Zach Whitecloud,D,VGK,28,43,4,7,11
37,8479772,Zack MacEwen,R,OTT,28,54,4,7,11
37,8481708,Zac Jones,D,NYR,24,50,3,8,11
37,8478452,Caleb Jones,D,LAK,27,47,3,8,11
37,8478859,Niko Mikkola,D,FLA,28,67,2,9,11
37,8479348,Kale Clague,D,BUF,26,35,2,9,11
37,8474090,Brendan Smith,D,DAL,35,57,2,9,11
37,8480192,Johnathan Kovacevic,D,NJD,27,52,2,9,11
37,8482744,James Malatesta,L,CBJ,21,41,2,9,11
37,8477851,Jordan Oesterle,D,BOS,32,47,2,9,11
37,8478443,Brandon Carlo,D,BOS,28,57,2,9,11
37,8482652,Walker Duehr,R,CGY,27,42,2,9,11
37,8476967,Brett Kulak,D,EDM,30,65,1,10,11
37,8475718,Justin Holl,D,DET,32,56,1,10,11
37,8476934,Brock McGinn,L,ANA,30,49,7,3,10
37,8482659,Josh Doan,R,UTA,22,46,6,4,10
37,8482496,Nils Aman,C,VAN,24,41,6,4,10
37,8477482,Zachary Sanford,L,CHI,30,39,5,5,10
37,8480441,Trey Fix-Wolansky,R,CBJ,25,37,4,6,10
37,8482177,Marat Khusnutdinov,C,MIN,22,36,4,6,10
37,8475177,Calvin de Haan,D,COL,33,53,4,6,10
37,8479372,Joshua Mahura,D,SEA,26,48,3,7,10
37,8481599,Victor Soderstrom,D,UTA,23,44,3,7,10
37,8474013,Ian Cole,D,UTA,35,49,3,7,10
37,8479369,Andrew Peeke,D,BOS,26,58,2,8,10
37,8478874,Adam Gaudette,R,OTT,28,30,2,8,10
37,8480950,Ilya Lyubushkin,D,DAL,30,61,1,9,10
37,8479249,Andrew Poturalski,C,SJS,30,29,0,10,10
37,8476525,Colin Miller,D,WPG,32,63,0,10,10
37,8482859,Zack Ostapchuk,C,OTT,21,45,5,4,9
37,8481013,Jonatan Berggren,R,DET,24,62,4,5,9
37,8479520,Brandon Duhaime,R,WSH,27,49,4,5,9
37,8481056,Spencer Stastney,D,NSH,24,34,4,5,9
37,8482964,Arber Xhekaj,D,MTL,23,52,3,6,9
37,8481600,Tobias Bjornfot,D,FLA,23,40,3,6,9
37,8482733,Logan Mailloux,D,MTL,31,30,3,6,9
37,8481122,Simon Benoit,D,TOR,26,43,3,6,9
37,8476441,Joel Edmundson,D,LAK,31,40,3,6,9
37,8481178,Egor Zamula,D,PHI,24,55,2,7,9
37,8474568,Luke Schenn,D,NSH,35,42,2,7,9
37,8484911,Collin Graf,R,SJS,22,35,2,7,9
37,8480252,Cole Guttman,C,CHI,25,47,2,7,9
37,8480007,Jonas Rondbjerg,R,VGK,25,40,2,7,9
37,8479371,Dante Fabbro,D,NSH,26,58,1,8,9
37,8480870,Bo Groulx,C,NYR,24,34,1,8,9
37,8478454,Noah Juulsen,D,VAN,27,37,0,9,9
37,8471817,Ryan Reaves,R,TOR,37,55,5,3,8
37,8477384,Joshua Brown,D,EDM,30,42,5,3,8
37,8482145,Mavrik Bourque,C,DAL,22,38,5,3,8
37,8480355,Mark Kastelic,C,BOS,25,57,4,4,8
37,8482077,Dylan Holloway,L,EDM,23,44,4,4,8
37,8477887,Patrick Brown,C,BOS,32,41,4,4,8
37,8483549,Lucas Condotta,L,MTL,27,29,4,4,8
37,8477380,Jonny Brodzinski,C,NYR,31,50,3,5,8
37,8477070,Liam O'Brien,C,UTA,30,54,3,5,8
37,8481789,Tye Kartye,L,SEA,23,39,3,5,8
37,8483570,Ben Meyers,C,SEA,26,24,3,5,8
37,8475958,Michael Sgarbossa,C,WSH,32,32,3,5,8
37,8476858,Phillip Di Giuseppe,L,VAN,31,44,3,5,8
37,8482751,Ryan Winterton,C,SEA,21,42,3,5,8
37,8479982,Conor Timmins,D,TOR,26,55,2,6,8
37,8475208,Brian Dumoulin,D,ANA,33,65,2,6,8
37,8481598,Philip Broberg,D,EDM,23,42,2,6,8
37,8481059,Scott Perunovich,D,STL,26,55,1,7,8
37,8478450,Parker Wotherspoon,D,BOS,27,36,1,7,8
37,8477335,Kyle Burroughs,D,LAK,29,43,1,7,8
37,8475750,Jon Merrill,D,MIN,32,61,0,8,8
37,8481751,Lukas Rousek,R,BUF,25,45,5,2,7
37,8479439,Jacob MacDonald,D,COL,31,47,5,2,7
37,8480845,Rasmus Kupari,C,WPG,24,38,5,2,7
37,8482147,Jean-Luc Foudy,C,COL,22,26,5,2,7
37,8481605,Jackson LaCombe,D,ANA,23,29,5,2,7
37,8477401,John Hayden,C,SEA,29,28,4,3,7
37,8480070,Ian Mitchell,D,BOS,25,45,4,3,7
37,8476867,Brendan Gaunce,C,MIN,30,39,4,3,7
37,8482784,Zach Dean,C,STL,21,39,3,4,7
37,8476952,Dominic Toninato,C,WPG,30,37,3,4,7
37,8477034,Jaycob Megna,D,FLA,32,34,3,4,7
37,8481701,Santeri Hatakka,D,NJD,23,31,3,4,7
37,8481532,Alex Turcotte,C,LAK,23,48,3,4,7
37,8482762,Simon Edvinsson,D,DET,21,57,3,4,7
37,8478017,Mark Friedman,D,VAN,29,35,3,4,7
37,8480990,Declan Chisholm,D,MIN,24,41,3,4,7
37,8479985,Cale Fleury,D,SEA,26,22,3,4,7
37,8479638,Justin Brazeau,R,BOS,26,36,3,4,7
37,8475235,Nicolas Deslauriers,L,PHI,33,49,2,5,7
37,8478468,Jeremy Lauzon,D,NSH,27,58,2,5,7
37,8482141,Lukas Cormier,D,VGK,22,28,2,5,7
37,8483763,Maksymilian Szuber,D,UTA,22,29,1,6,7
37,8479378,Logan Stanley,D,WPG,26,34,1,6,7
37,8476442,Matt Nieto,L,PIT,32,46,0,7,7
37,8482511,Mason Lohrei,D,BOS,23,33,0,7,7
37,8482165,Yan Kuznetsov,D,CGY,22,18,0,7,7
37,8478831,Kevin Stenlund,C,UTA,28,46,4,2,6
37,8480880,Jakub Lauko,C,MIN,24,25,4,2,6
37,8482070,Mitchell Chaffee,R,TBL,26,47,4,2,6
37,8483012,Logan Morrison,C,SEA,22,30,4,2,6
37,8479379,Givani Smith,R,SJS,26,28,4,2,6
37,8481237,Kyle MacLean,C,NYI,25,20,4,2,6
37,8479419,Brett Murray,L,BUF,26,21,3,3,6
37,8483630,Pavol Regenda,L,ANA,25,31,3,3,6
37,8477473,Justin Bailey,R,SJS,29,23,3,3,6
37,8484287,Cole McWard,D,VAN,23,29,3,3,6
37,8479986,Kole Lind,R,DAL,26,57,2,4,6
37,8476473,Connor Murphy,D,CHI,31,41,1,5,6
37,8479587,Rhett Gardner,C,PHI,28,22,1,5,6
37,8480890,Jan Jenik,C,OTT,24,35,0,6,6
37,8483397,Marc McLaughlin,C,BOS,25,35,5,0,5
37,8481556,John Beecher,C,BOS,23,36,5,0,5
37,8482807,Ethan Del Mastro,D,CHI,21,47,4,1,5
37,8479981,Jonah Gadjovich,L,FLA,26,39,3,2,5
37,8475762,Derek Forbort,D,VAN,32,40,3,2,5
37,8482153,Brendan Brisson,C,VGK,23,31,3,2,5
37,8480196,Jacob Bryson,D,BUF,27,41,3,2,5
37,8483395,Arshdeep Bains,L,VAN,23,14,3,2,5
37,8481541,Samuel Bolduc,D,NYI,24,20,3,2,5
37,8480292,Carson Meyer,R,ANA,27,35,2,3,5
37,8477971,Andreas Englund,D,LAK,28,27,2,3,5
37,8478021,William Lagesson,D,DET,28,33,2,3,5
37,8482172,Landon Slaggert,L,CHI,22,22,2,3,5
37,8482118,Sam Colangelo,R,ANA,23,15,2,3,5
37,8477467,Gustav Olofsson,D,SEA,30,21,2,3,5
37,8479972,Mason Shaw,C,WPG,26,32,1,4,5
37,8474612,Travis Hamonic,D,OTT,34,50,1,4,5
37,8481743,Marc Del Gaizo,D,NSH,25,26,1,4,5
37,8478146,Matthew Highmore,C,OTT,28,33,1,4,5
37,8484254,Akito Hirose,D,VAN,25,34,3,1,4
37,8478424,Jansen Harkins,C,ANA,27,45,2,2,4
37,8479367,William Lockwood,R,FLA,26,25,2,2,4
37,8481754,Nikita Nesterenko,C,ANA,23,27,2,2,4
37,8477320,Anton Blidh,L,NYR,29,16,2,2,4
37,8483512,Matthew Savoie,C,EDM,20,25,1,3,4
37,8482929,Emil Lilleberg,D,TBL,23,23,1,3,4
37,8480834,Ty Emberson,D,SJS,24,35,1,3,4
37,8482102,Vasily Ponomarev,C,PIT,22,16,1,3,4
37,8477527,Ross Johnston,L,ANA,30,30,0,4,4
37,8477073,Kurtis MacDermid,L,NJD,30,31,0,4,4
37,8482250,Callahan Burke,C,VGK,27,17,0,4,4
37,8480874,Adam Ginning,D,PHI,24,7,0,4,4
37,8482201,Gage Goncalves,C,TBL,23,18,3,0,3
37,8479362,Riley Tufte,L,BOS,26,20,3,0,3
37,8473446,Erik Johnson,D,PHI,36,40,2,1,3
37,8481679,Maxence Guenette,D,OTT,23,26,2,1,3
37,8480851,Akil Thomas,C,LAK,24,21,2,1,3
37,8476372,Nick Seeler,D,PHI,31,48,1,2,3
37,8480468,James Hamblin,L,EDM,25,22,1,2,3
37,8481585,Egor Afanasyev,L,SJS,23,20,1,2,3
37,8482858,Ryker Evans,D,SEA,23,26,1,2,3
37,8478011,Louie Belpedio,D,PHI,28,17,1,2,3
37,8474062,Riley Nash,C,NYR,35,19,1,2,3
37,8479991,Jake Leschyshyn,C,NYR,25,25,0,3,3
37,8482765,Isak Rosen,R,BUF,21,34,0,3,3
37,8483619,Filip Roos,D,OTT,25,30,0,3,3
37,8477810,Joel Hanley,D,CGY,33,27,0,3,3
37,8477149,Scott Sabourin,R,SJS,32,20,0,3,3
37,8481422,Jake Lucchini,C,NSH,29,22,2,0,2
37,8476913,Devin Shore,C,MIN,30,31,2,0,2
37,8478881,Brett Seney,L,CHI,28,7,2,0,2
37,8482144,Jack Thompson,D,SJS,22,32,1,1,2
37,8483597,Milos Kelemen,L,UTA,25,18,1,1,2
37,8479576,Vincent Desharnais,D,VAN,28,28,1,1,2
37,8481543,Nikita Alexandrov,C,STL,24,23,1,1,2
37,8482061,Brandon Biro,L,SEA,26,13,1,1,2
37,8482713,Mackie Samoskevich,R,FLA,22,37,1,1,2
37,8475755,Alexander Petrovic,D,DAL,32,8,1,1,2
37,8481024,Linus Karlsson,C,VAN,25,9,1,1,2
37,8478446,Glenn Gawdin,C,LAK,27,19,1,1,2
37,8482162,Roby Jarventie,L,EDM,22,16,1,1,2
37,8482470,Ilya Solovyov,D,CGY,24,18,0,2,2
37,8481206,John Ludvig,D,PIT,24,12,0,2,2
37,8477244,Chad Ruhwedel,D,NYR,34,26,0,2,2
37,8480084,Nick DeSimone,D,NJD,30,16,0,2,2
37,8477462,Robert Hagg,D,VGK,29,24,0,2,2
37,8478502,Dennis Gilbert,D,BUF,28,21,0,2,2
37,8482516,Matthew Kessel,D,STL,24,15,0,2,2
37,8481699,Aku Raty,R,UTA,23,20,0,2,2
37,8480306,Grant Hutton,D,NYI,29,7,0,2,2
37,8481806,Louis Crevier,D,CHI,23,11,0,2,2
37,8483567,Georgii Merkulov,C,BOS,24,10,0,2,2
37,8475413,Justin Dowling,C,NJD,34,11,0,2,2
37,8479421,Jacob Moverare,D,LAK,26,10,0,2,2
37,8484304,Uvis Balinskis,D,FLA,28,9,0,2,2
37,8476323,Max McCormick,L,SEA,32,3,0,2,2
37,8479330,Brandon Gignac,C,MTL,27,11,0,2,2
37,8478051,Max Willman,C,NJD,29,19,1,0,1
37,8480267,Sammy Walker,C,MIN,25,19,1,0,1
37,8480823,Alexander Alexeyev,D,WSH,25,10,1,0,1
37,8481065,Angus Crookshank,L,OTT,25,13,1,0,1
37,8481719,Maxwell Crozier,D,TBL,24,17,1,0,1
37,8481655,Cole Schwindt,R,CGY,23,1,1,0,1
37,8482094,Daemon Hunt,D,MIN,22,15,1,0,1
37,8483546,Marshall Rifai,D,TOR,26,5,1,0,1
37,8481043,Cole Koepke,L,BOS,26,13,1,0,1
37,8480032,Shane Bowers,C,NJD,25,12,1,0,1
37,8477993,Justin Kirkland,C,CGY,28,7,1,0,1
37,8481609,Vladislav Kolyachonok,D,UTA,23,36,0,1,1
37,8480245,Olle Lycksell,R,PHI,25,21,0,1,1
37,8479320,Maxime Lajoie,D,SEA,27,26,0,1,1
37,8478477,Mitchell Stephens,C,SEA,27,23,0,1,1
37,8481593,Jayden Struble,D,MTL,23,20,0,1,1
37,8484258,Sam Malinski,D,COL,26,13,0,1,1
37,8482787,Nikita Chibrikov,R,WPG,31,6,0,1,1
37,8483407,Brandon Scanlin,D,NYR,25,4,0,1,1
37,8481578,Graeme Clarke,R,MIN,23,14,0,1,1
37,8482476,Emil Heineman,L,MTL,23,9,0,1,1
37,8481564,Ryan Johnson,D,BUF,23,11,0,1,1
37,8484325,Waltteri Merela,C,TBL,26,28,0,1,1
37,8478147,Bokondji Imama,L,PIT,28,7,0,1,1
37,8483398,Declan Carlile,D,TBL,31,12,0,0,0
37,8483920,Pierrick Dube,R,WSH,23,4,0,0,0
37,8481006,Tyler Tucker,D,STL,24,13,0,0,0
37,8475795,Dylan McIlrath,D,WSH,32,11,0,0,0
37,8481534,Raphael Lavoie,C,EDM,24,2,0,0,0
37,8482088,Justin Sourdif,R,FLA,22,23,0,0,0
37,8477541,Dakota Mermis,D,TOR,30,8,0,0,0
37,8481030,Jack St. Ivany,D,PIT,25,14,0,0,0
37,8483609,Adam Klapka,R,CGY,24,1,0,0,0
37,8482126,Emil Andrae,D,PHI,31,2,0,0,0
37,8478854,Ryan Shea,D,PIT,27,5,0,0,0
37,8481726,Adam Edstrom,C,NYR,24,6,0,0,0
37,8483489,Fraser Minten,C,TOR,31,5,0,0,0
37,8483432,Luca Del Bel Belluz,C,CBJ,31,2,0,0,0
37,8484259,Ondrej Pavel,C,COL,31,3,0,0,0
37,8482460,Matt Rempe,C,NYR,22,9,0,0,0
37,8480075,Cameron Crotty,D,MIN,25,11,0,0,0
37,8481462,Mason Morelli,L,VGK,28,10,0,0,0
37,8484326,Patrik Koch,D,UTA,28,0,0,0,0
37,8483471,Brad Lambert,C,WPG,31,8,0,0,0
37,8484255,Jason Polin,R,COL,25,3,0,0,0
37,8475780,Chris Wagner,R,COL,33,2,0,0,0
37,8482197,Adam Raska,R,MIN,23,9,0,0,0
37,8483531,Brian Halonen,L,NJD,25,3,0,0,0
37,8480274,Philip Kemp,D,EDM,25,1,0,0,0
37,8479522,Hardy Haman Aktell,D,WSH,26,1,0,0,0
37,8483401,Marc Johnstone,R,PIT,28,2,0,0,0
37,8484321,Nikolas Matinpalo,D,OTT,26,6,0,0,0
37,8470794,Joe Pavelski,C,,40,0,0,0,0
37,8479321,Lucas Johansen,D,,27,0,0,0,0
37,8477950,Tony DeAngelo,D,,29,0,0,0,0
37,8471218,Blake Wheeler,R,,38,0,0,0,0
37,8475197,Tyson Barrie,D,,33,0,0,0,0
37,8474157,Max Pacioretty,L,,36,0,0,0,0
37,8475744,Evgeny Kuznetsov,C,,32,0,0,0,0
37,8474037,James van Riemsdyk,L,,35,0,0,0,0
37,8476907,Mackenzie MacEachern,L,,30,0,0,0,0
37,8480216,Jacob Peterson,C,,25,0,0,0,0
37,8474602,Justin Schultz,D,,34,0,0,0,0
37,8482222,Alexander Barabanov,L,,30,0,0,0,0
37,8474031,Kevin Shattenkirk,D,,35,0,0,0,0
37,8477330,Dominik Kubalik,L,,29,0,0,0,0
37,8480884,Calen Addison,D,,24,0,0,0,0
37,8475906,John Klingberg,D,,32,0,0,0,0
37,8480008,Adam Ruzicka,C,,25,0,0,0,0
37,8476884,Derrick Pouliot,D,,30,0,0,0,0
37,8476919,Chris Tierney,C,,30,0,0,0,0
37,8479415,Michael McLeod,C,,26,0,0,0,0
37,8474870,Tyler Johnson,C,,34,0,0,0,0
37,8470604,Jeff Carter,C,,39,0,0,0,0
37,8478104,Sammy Blais,L,,28,0,0,0,0
37,8474884,Mike Hoffman,C,,35,0,0,0,0
37,8481591,Sam Poulin,R,,23,0,0,0,0
37,8471274,Alex Goligoski,D,,39,0,0,0,0
37,8476871,Tanner Pearson,L,,32,0,0,0,0
37,8476393,Nick Cousins,C,,31,0,0,0,0
37,8479977,Kailer Yamamoto,R,,26,0,0,0,0
37,8479346,Dillon Dube,C,,26,0,0,0,0
37,8480184,Gustav Lindstrom,D,,26,0,0,0,0
37,8479376,Victor Mete,D,,26,0,0,0,0
37,8473449,Kyle Okposo,R,,36,0,0,0,0
37,8481058,Jesse Ylonen,R,,25,0,0,0,0
37,8475752,Tyler Pitlick,C,,33,0,0,0,0
37,8481239,Samuel Fagemo,L,,24,0,0,0,0
37,8480821,Filip Zadina,R,,25,0,0,0,0
37,8470966,Mark Giordano,D,,41,0,0,0,0
37,8478495,Denis Gurianov,R,,27,0,0,0,0
37,8477464,Nic Petan,C,,29,0,0,0,0
37,8478099,Kevin Labanc,R,,29,0,0,0,0
37,8482241,Radim Zohorna,L,,28,0,0,0,0
37,8474040,Sam Gagner,C,,35,0,0,0,0
37,8479514,Rem Pitlick,C,,27,0,0,0,0
37,8478430,Oliver Kylington,D,,27,0,0,0,0
37,8479533,Joona Koppanen,L,,26,0,0,0,0
37,8479984,Cal Foote,D,,26,0,0,0,0
37,8477126,Jayson Megna,C,,34,0,0,0,0
37,8475164,Jakob Silfverberg,R,,34,0,0,0,0
37,8474009,Nick Bonino,C,,36,0,0,0,0
37,8479458,Nikita Zaitsev,D,,33,0,0,0,0
37,8477944,Jakub Vrana,L,,28,0,0,0,0
37,8471699,Andrew Cogliano,C,,37,0,0,0,0
37,8478067,Oskar Lindblom,L,,28,0,0,0,0
37,8471686,Marc Staal,D,,37,0,0,0,0
37,8470610,Zach Parise,L,,40,0,0,0,0
37,8478904,Steven Lorentz,C,,28,0,0,0,0
37,8473473,Milan Lucic,L,,36,0,0,0,0
37,8480031,Maxime Comtois,L,,25,0,0,0,0
37,8478512,Austin Czarnik,C,,32,0,0,0,0
37,8473504,Cal Clutterbuck,R,,37,0,0,0,0
37,8477454,Adam Erne,L,,29,0,0,0,0
37,8479383,Boris Katchouk,L,,26,0,0,0,0
37,8475825,Jani Hakanpää,D,,32,0,0,0,0
37,8477846,Ryan Carpenter,C,,33,0,0,0,0
37,8477930,Pierre-Edouard Bellemare,L,,39,0,0,0,0
37,8478400,Colin White,C,,27,0,0,0,0
37,8480226,Marián Studenic,R,,26,0,0,0,0
37,8480853,Liam Foudy,C,,24,0,0,0,0
37,8475797,Jarred Tinordi,D,,32,0,0,0,0
37,8479423,Alex Nylander,L,,26,0,0,0,0
37,8474618,Marco Scandella,D,,34,0,0,0,0
37,8478028,Fredrik Olofsson,L,,28,0,0,0,0
37,8474709,Matt Martin,L,,35,0,0,0,0
37,8481070,Hugh McGing,L,,26,0,0,0,0
37,8479546,Oskar Steen,C,,26,0,0,0,0
37,8474145,Robert Bortuzzo,D,,35,0,0,0,0
37,8476915,Jujhar Khaira,L,,30,0,0,0,0
37,8475278,Byron Froese,C,,33,0,0,0,0
37,8481812,Nikolai Knyzhov,D,,27,0,0,0,0
37,8478408,Travis Dermott,D,,28,0,0,0,0
37,8481077,John Leonard,L,,26,0,0,0,0
37,8479547,Matthew Phillips,R,,26,0,0,0,0
37,8480836,Jonathan Gruden,C,,24,0,0,0,0
37,8481690,Tyler Angle,C,,24,0,0,0,0
37,8475766,Austin Watson,L,,32,0,0,0,0
37,8481016,Ruslan Iskhakov,C,,24,0,0,0,0
37,8478078,Rourke Chartier,C,,28,0,0,0,0
37,8480776,Sheldon Rempal,R,,29,0,0,0,0
37,8478956,Samuel Laberge,L,NJD,27,0,0,0,0
37,8483045,Cameron Butler,R,CBJ,31,1,0,0,0
37,8484314,Jiri Smejkal,L,,28,0,0,0,0
38,8477492,Nathan MacKinnon,C,COL,29,82,48,95,143
38,8478402,Connor McDavid,C,EDM,27,80,38,92,130
38,8476453,Nikita Kucherov,R,TBL,31,82,34,91,125
38,8479314,Matthew Tkachuk,L,FLA,27,79,35,80,115
38,8477934,Leon Draisaitl,C,EDM,29,77,44,69,113
38,8479318,Auston Matthews,C,TOR,27,77,63,48,111
38,8478550,Artemi Panarin,L,NYR,33,78,41,69,110
38,8478483,Mitch Marner,R,TOR,27,79,28,80,108
38,8480027,Jason Robertson,L,DAL,25,81,39,66,105
38,8476468,J.T. Miller,C,VAN,31,74,41,63,104
38,8481559,Jack Hughes,C,NJD,23,73,46,56,102
38,8478420,Mikko Rantanen,R,COL,28,82,45,56,101
38,8477939,William Nylander,R,TOR,28,79,43,58,101
38,8480012,Elias Pettersson,C,VAN,26,74,37,63,100
38,8477956,David Pastrnak,R,BOS,28,79,65,34,99
38,8476887,Filip Forsberg,L,NSH,30,74,53,45,98
38,8477933,Sam Reinhart,C,FLA,29,78,51,45,96
38,8477493,Aleksander Barkov,C,FLA,29,80,31,64,95
38,8477501,Valeri Nichushkin,R,COL,29,80,43,51,94
38,8475913,Mark Stone,R,VGK,32,73,22,72,94
38,8478427,Sebastian Aho,C,CAR,27,74,34,59,93
38,8477946,Dylan Larkin,C,DET,28,78,51,41,92
38,8480800,Quinn Hughes,D,VAN,25,73,8,81,89
38,8478398,Kyle Connor,L,WPG,28,76,50,38,88
38,8482740,Wyatt Johnston,C,DAL,21,82,46,42,88
38,8478445,Mathew Barzal,C,NYI,27,80,12,75,87
38,8479407,Jesper Bratt,L,NJD,26,77,33,53,86
38,8475167,Victor Hedman,D,TBL,34,75,20,66,86
38,8479323,Adam Fox,D,NYR,26,73,10,76,86
38,8477409,Carter Verhaeghe,C,FLA,29,79,45,40,85
38,8480069,Cale Makar,D,COL,26,76,27,58,85
38,8479420,Tage Thompson,C,BUF,27,71,45,39,84
38,8478439,Travis Konecny,R,PHI,27,76,34,49,83
38,8477942,Kevin Fiala,L,LAK,28,80,24,58,82
38,8480801,Brady Tkachuk,L,OTT,25,81,32,49,81
38,8478864,Kirill Kaprizov,L,MIN,27,74,31,50,81
38,8474600,Roman Josi,D,NSH,34,77,16,65,81
38,8476460,Mark Scheifele,C,WPG,31,75,35,45,80
38,8477404,Jake Guentzel,C,TBL,30,82,33,47,80
38,8477951,Nick Schmaltz,C,UTA,28,77,32,48,80
38,8474564,Steven Stamkos,C,NSH,34,69,31,49,80
38,8475172,Nazem Kadri,C,CGY,34,78,30,50,80
38,8476454,Ryan Nugent-Hopkins,C,EDM,31,80,28,52,80
38,8478010,Brayden Point,C,TBL,28,81,43,36,79
38,8479343,Clayton Keller,R,UTA,26,78,34,45,79
38,8477940,Nikolaj Ehlers,L,WPG,28,68,30,49,79
38,8478403,Jack Eichel,C,VGK,28,78,37,40,77
38,8480023,Robert Thomas,C,STL,25,72,21,56,77
38,8480839,Rasmus Dahlin,D,BUF,24,72,14,62,76
38,8475158,Ryan O'Reilly,C,NSH,33,76,34,41,75
38,8475166,John Tavares,C,TOR,34,80,30,45,75
38,8481557,Matt Boldy,L,MIN,23,71,30,45,75
38,8475810,Bryan Rust,R,PIT,32,75,33,41,74
38,8474141,Patrick Kane,R,DET,36,82,28,46,74
38,8479337,Alex DeBrincat,R,DET,27,80,27,47,74
38,8476456,Jonathan Huberdeau,C,CGY,31,80,23,51,74
38,8471675,Sidney Crosby,C,PIT,37,73,35,38,73
38,8477402,Pavel Buchnevich,L,STL,29,77,34,39,73
38,8477500,Bo Horvat,C,NYI,29,82,35,37,72
38,8477949,Alex Tuch,R,BUF,28,75,30,42,72
38,8476389,Vincent Trocheck,C,NYR,31,75,25,47,72
38,8476459,Mika Zibanejad,C,NYR,31,78,22,50,72
38,8480036,Miro Heiskanen,D,DAL,25,79,11,61,72
38,8478414,Timo Meier,R,NJD,28,70,34,37,71
38,8480830,Andrei Svechnikov,R,CAR,24,74,31,40,71
38,8484144,Connor Bedard,C,CHI,19,70,22,49,71
38,8477960,Adrian Kempe,R,LAK,28,79,34,36,70
38,8480002,Nico Hischier,C,NJD,25,73,25,45,70
38,8475168,Matt Duchene,C,DAL,33,79,24,46,70
38,8471214,Alex Ovechkin,L,WSH,39,77,36,33,69
38,8478449,Roope Hintz,C,DAL,28,81,35,34,69
38,8479542,Brandon Hagel,L,TBL,26,82,34,35,69
38,8481528,Dylan Cozens,C,BUF,23,74,27,42,69
38,8480208,Drake Batherson,R,OTT,26,80,26,43,69
38,8477504,Josh Morrissey,D,WPG,29,72,10,59,69
38,8475786,Zach Hyman,L,EDM,32,74,32,36,68
38,8476479,Phillip Danault,C,LAK,31,80,26,42,68
38,8482116,Tim Stützle,C,OTT,22,78,22,46,68
38,8476881,Tomas Hertl,C,VGK,31,77,31,35,66
38,8478047,Michael Bunting,L,PIT,29,76,28,38,66
38,8478440,Dylan Strome,C,WSH,27,71,26,40,66
38,8471215,Evgeni Malkin,C,PIT,38,69,24,42,66
38,8473994,Jamie Benn,L,DAL,35,81,22,44,66
38,8478873,Troy Terry,R,ANA,27,76,22,44,66
38,8482684,Luke Hughes,D,NJD,21,77,11,55,66
38,8475754,Brock Nelson,C,NYI,33,78,33,32,65
38,8480015,Owen Tippett,R,PHI,25,77,30,35,65
38,8480018,Nick Suzuki,C,MTL,25,77,29,36,65
38,8479385,Jordan Kyrou,C,STL,26,77,26,39,65
38,8474578,Erik Karlsson,D,PIT,34,79,18,47,65
38,8479675,Trevor Moore,L,LAK,29,78,32,32,64
38,8477503,Max Domi,C,TOR,29,80,19,44,63
38,8478460,Zach Werenski,D,CBJ,27,80,18,45,63
38,8480865,Noah Dobson,D,NYI,24,78,17,46,63
38,8479999,Casey Mittelstadt,C,COL,26,82,15,48,63
38,8477494,Jonathan Drouin,L,COL,29,80,20,42,62
38,8480803,Evan Bouchard,D,EDM,25,77,17,45,62
38,8477496,Elias Lindholm,C,BOS,30,79,26,35,61
38,8475184,Chris Kreider,L,NYR,33,79,38,22,60
38,8471685,Anze Kopitar,C,LAK,37,79,16,44,60
38,8479325,Charlie McAvoy,D,BOS,27,76,12,48,60
38,8475794,Tyler Seguin,C,DAL,32,81,32,27,59
38,8482159,Tyson Foerster,R,PHI,22,73,27,32,59
38,8478462,Nicolas Roy,C,VGK,27,74,21,38,59
38,8476875,Mike Matheson,D,MTL,30,75,11,48,59
38,8477407,Anthony Duclair,L,NYI,29,78,27,31,58
38,8478493,Joel Eriksson Ek,C,MIN,27,77,26,32,58
38,8478407,Vince Dunn,D,SEA,28,77,14,44,58
38,8479425,Filip Hronek,D,VAN,27,70,12,46,58
38,8477447,Shea Theodore,D,VGK,29,67,10,48,58
38,8480039,Martin Necas,C,CAR,25,68,24,33,57
38,8478401,Pavel Zacha,C,BOS,27,81,24,33,57
38,8477444,Andre Burakovsky,L,SEA,29,72,22,35,57
38,8476346,Johnny Gaudreau,L,CBJ,31,70,18,39,57
38,8473419,Brad Marchand,L,BOS,36,78,17,40,57
38,8475765,Vladimir Tarasenko,R,DET,33,80,24,32,56
38,8479400,Pierre-Luc Dubois,L,WSH,26,75,21,35,56
38,8478856,Conor Garland,R,VAN,28,76,18,38,56
38,8482109,Alexis Lafrenière,L,NYR,23,75,31,24,55
38,8482093,Seth Jarvis,C,CAR,22,67,27,28,55
38,8478444,Brock Boeser,R,VAN,27,76,26,29,55
38,8480009,Eeli Tolvanen,R,SEA,25,74,22,33,55
38,8475798,Mikael Granlund,C,SJS,32,65,17,38,55
38,8470613,Brent Burns,D,CAR,39,74,14,41,55
38,8475692,Mats Zuccarello,R,MIN,37,74,11,44,55
38,8476853,Morgan Rielly,D,TOR,30,66,7,48,55
38,8483808,Andrei Kuzmenko,L,CGY,28,76,25,29,54
38,8476448,William Karlsson,C,VGK,31,78,23,31,54
38,8479345,Jakob Chychrun,D,WSH,26,67,23,31,54
38,8477021,Alex Kerfoot,C,UTA,30,74,17,37,54
38,8474563,Drew Doughty,D,LAK,35,70,11,43,54
38,8475151,Kyle Palmieri,C,NYI,33,79,29,24,53
38,8476539,Jonathan Marchessault,R,NSH,34,76,25,28,53
38,8482699,Dylan Guenther,R,UTA,21,69,25,28,53
38,8478975,Mason Marchment,L,DAL,29,81,16,37,53
38,8473512,Claude Giroux,R,OTT,36,81,15,38,53
38,8477986,Brandon Montour,D,SEA,30,75,15,38,53
38,8476462,Dougie Hamilton,D,NJD,31,71,13,40,53
38,8481068,Yegor Sharangovich,C,CGY,26,80,26,26,52
38,8483515,Juraj Slafkovsky,L,MTL,20,72,17,35,52
38,8475745,Charlie Coyle,C,BOS,32,79,20,31,51
38,8482702,Logan Stankoven,C,DAL,21,81,19,32,51
38,8481711,Matias Maccelli,L,UTA,24,78,15,36,51
38,8477346,MacKenzie Weegar,D,CGY,30,73,10,41,51
38,8477416,Oliver Bjorkstrand,R,SEA,29,69,25,25,50
38,8475784,Jeff Skinner,C,EDM,32,75,23,27,50
38,8481540,Cole Caufield,R,MTL,23,79,23,27,50
38,8482110,Dawson Mercer,C,NJD,23,71,23,27,50
38,8482078,Lucas Raymond,L,DET,22,78,23,27,50
38,8474102,David Perron,L,OTT,36,79,23,27,50
38,8483431,Logan Cooley,C,UTA,20,77,23,27,50
38,8477955,Jared McCann,L,SEA,28,71,19,31,50
38,8480798,Philipp Kurashev,C,CHI,25,66,19,31,50
38,8478438,Tommy Novak,C,NSH,27,76,14,36,50
38,8481560,Arthur Kaliyev,R,LAK,23,76,31,18,49
38,8477935,Sam Bennett,C,FLA,28,78,24,25,49
38,8478042,Viktor Arvidsson,L,EDM,31,79,24,25,49
38,8476399,Blake Coleman,C,CGY,33,76,23,26,49
38,8475191,Reilly Smith,R,NYR,33,69,19,30,49
38,8474586,Jordan Eberle,R,SEA,34,75,18,31,49
38,8482665,Matty Beniers,C,SEA,22,72,22,26,48
38,8480064,Josh Norris,C,OTT,25,78,22,26,48
38,8478542,Evan Rodrigues,C,FLA,31,77,20,28,48
38,8476882,Teuvo Teravainen,C,CHI,30,65,19,29,48
38,8482475,Yegor Chinakhov,R,CBJ,23,69,18,30,48
38,8476826,Yanni Gourde,C,SEA,33,74,17,31,48
38,8477495,Seth Jones,D,CHI,30,75,13,35,48
38,8481542,Moritz Seider,D,DET,23,77,6,42,48
38,8482745,Mason McTavish,C,ANA,21,74,24,23,47
38,8477998,Warren Foegele,L,LAK,28,78,22,25,47
38,8477964,Ivan Barbashev,C,VGK,29,71,19,28,47
38,8481533,Trevor Zegras,C,ANA,23,78,17,30,47
38,8477479,Tyler Bertuzzi,L,CHI,29,66,17,30,47
38,8479339,Patrik Laine,L,CBJ,26,62,17,30,47
38,8476792,Torey Krug,D,STL,33,74,11,36,47
38,8476905,Chandler Stephenson,C,SEA,30,76,10,37,47
38,8475314,Anders Lee,L,NYI,34,78,27,19,46
38,8477426,Nicholas Paul,L,TBL,29,81,24,22,46
38,8482175,JJ Peterka,R,BUF,22,73,21,25,46
38,8481577,Philip Tomasino,C,NSH,23,65,15,31,46
38,8473986,Alex Killorn,L,ANA,35,74,13,33,46
38,8480028,Morgan Frost,C,PHI,25,73,9,37,46
38,8478519,Anthony Cirelli,C,TBL,27,82,19,26,45
38,8475848,Brendan Gallagher,R,MTL,32,71,19,26,45
38,8477429,Andrew Copp,C,DET,30,80,18,27,45
38,8484145,Zach Benson,L,BUF,19,66,16,29,45
38,8477456,J.T. Compher,L,DET,29,78,15,30,45
38,8476958,Jaccob Slavin,D,CAR,30,76,8,37,45
38,8482089,Jake Neighbours,L,STL,22,73,27,17,44
38,8477476,Artturi Lehkonen,L,COL,29,81,25,19,44
38,8482113,Anton Lundell,C,FLA,23,75,21,23,44
38,8481554,Kaapo Kakko,R,NYR,23,68,20,24,44
38,8478498,Jake DeBrusk,L,VAN,28,70,19,25,44
38,8475170,Brayden Schenn,C,STL,33,61,18,26,44
38,8481624,Ilya Mikheyev,R,CHI,30,60,18,26,44
38,8478463,Anthony Beauvillier,L,PIT,27,65,18,26,44
38,8476432,Boone Jenner,C,CBJ,31,71,22,21,43
38,8475799,Nino Niederreiter,R,WPG,32,70,20,23,43
38,8480185,Eetu Luostarinen,C,FLA,26,73,16,27,43
38,8477839,Conor Sheary,L,TBL,32,80,15,28,43
38,8482720,Matthew Knies,L,TOR,22,76,14,29,43
38,8482124,Quinton Byfield,R,LAK,22,81,13,30,43
38,8478397,Rasmus Andersson,D,CGY,28,76,12,31,43
38,8478469,Thomas Chabot,D,OTT,27,73,10,33,43
38,8474590,John Carlson,D,WSH,34,64,8,35,43
38,8477932,Aaron Ekblad,D,FLA,28,76,6,37,43
38,8471724,Kris Letang,D,PIT,37,81,5,38,43
38,8476483,Rickard Rakell,R,PIT,31,67,29,13,42
38,8475169,Evander Kane,L,EDM,33,75,21,21,42
38,8478466,Daniel Sprong,R,VAN,27,69,19,23,42
38,8482149,Cole Perfetti,C,WPG,22,68,17,25,42
38,8481596,Shane Pinto,C,OTT,24,74,12,30,42
38,8476906,Shayne Gostisbehere,D,CAR,31,78,9,33,42
38,8484166,Adam Fantilli,C,CBJ,20,71,21,20,41
38,8480014,Gabriel Vilardi,C,WPG,25,66,21,20,41
38,8476880,Tom Wilson,R,WSH,30,67,21,20,41
38,8477425,Miles Wood,L,COL,29,74,19,22,41
38,8474679,Gustav Nyquist,C,NSH,35,67,18,23,41
38,8476872,Scott Laughton,C,PHI,30,75,18,23,41
38,8474641,Adam Henrique,C,EDM,34,77,17,24,41
38,8474150,Mikael Backlund,C,CGY,35,75,14,27,41
38,8478472,Mathieu Joseph,R,STL,27,76,13,28,41
38,8482133,Thomas Bordeleau,C,SJS,22,63,12,29,41
38,8480871,Adam Boqvist,D,FLA,24,69,12,29,41
38,8479410,Mikhail Sergachev,D,UTA,26,61,8,33,41
38,8478366,Frank Vatrano,R,ANA,30,70,29,11,40
38,8481618,Alex Newhook,C,MTL,23,71,22,18,40
38,8478474,Lawson Crouse,L,UTA,27,74,22,18,40
38,8481582,Nicholas Robertson,L,TOR,23,69,22,18,40
38,8475726,Tyler Toffoli,C,SJS,32,65,21,19,40
38,8480188,Fabian Zetterlund,L,SJS,25,70,21,19,40
38,8480113,Alex Iafallo,L,WPG,31,72,20,20,40
38,8478115,Pierre Engvall,L,NYI,28,77,18,22,40
38,8475768,Jaden Schwartz,C,SEA,32,71,18,22,40
38,8475714,Calle Jarnkrok,C,TOR,33,76,18,22,40
38,8480797,Joel Farabee,L,PHI,24,73,18,22,40
38,8475793,Ryan Johansen,C,PHI,32,71,18,22,40
38,8476869,Brady Skjei,D,NSH,30,69,10,30,40
38,8477497,Sean Monahan,C,CBJ,30,69,19,20,39
38,8484153,Leo Carlsson,C,ANA,20,78,18,21,39
38,8477989,Christian Dvorak,C,MTL,28,72,16,23,39
38,8480802,Ryan McLeod,C,BUF,25,68,13,26,39
38,8478055,Gustav Forsling,D,FLA,28,77,7,32,39
38,8479525,Ross Colton,C,COL,28,82,21,17,38
38,8475722,Jason Zucker,L,BUF,32,67,14,24,38
38,8479987,Morgan Geekie,C,BOS,26,71,12,26,38
38,8481606,Jordan Spence,D,LAK,23,69,8,30,38
38,8477948,Travis Sanheim,D,PHI,28,71,7,31,38
38,8482671,Owen Power,D,BUF,22,69,7,31,38
38,8480829,Jesperi Kotkaniemi,C,CAR,24,64,21,16,37
38,8476981,Josh Anderson,R,MTL,30,73,18,19,37
38,8477451,Ryan Hartman,R,MIN,30,71,18,19,37
38,8473533,Jordan Staal,C,CAR,36,70,15,22,37
38,8476461,Sean Couturier,C,PHI,32,66,12,25,37
38,8478458,John (Jack) Roslovic,C,CAR,27,67,12,25,37
38,8482122,Brock Faber,D,MIN,22,81,8,29,37
38,8476438,Brandon Saad,L,STL,32,68,19,17,36
38,8481604,Pavel Dorofeyev,L,VGK,24,67,17,19,36
38,8477511,Anthony Mantha,R,CGY,30,74,16,20,36
38,8482092,Ridly Greig,C,OTT,22,73,12,24,36
38,8476292,Ondrej Palat,L,NJD,33,71,12,24,36
38,8480817,K'Andre Miller,D,NYR,24,71,10,26,36
38,8476854,Hampus Lindholm,D,BOS,30,75,6,30,36
38,8475764,Cam Fowler,D,ANA,33,70,4,32,36
38,8482705,Cole Sillinger,C,CBJ,21,67,20,15,35
38,8478046,Danton Heinen,L,VAN,29,67,20,15,35
38,8474149,Evgenii Dadonov,R,DAL,35,78,18,17,35
38,8480220,Noah Cates,L,PHI,25,69,17,18,35
38,8479591,Michael Eyssimont,C,TBL,28,81,15,20,35
38,8480078,Filip Chytil,C,NYR,25,67,15,20,35
38,8478233,Andrew Mangiapane,L,WSH,28,70,13,22,35
38,8482097,Jack Quinn,R,BUF,23,65,13,22,35
38,8483505,Matthew Poitras,C,BOS,20,75,12,23,35
38,8476458,Ryan Strome,C,ANA,31,69,11,24,35
38,8476885,Jacob Trouba,D,NYR,30,73,11,24,35
38,8482660,Kent Johnson,C,CBJ,22,63,10,25,35
38,8474565,Alex Pietrangelo,D,VGK,34,59,9,26,35
38,8475753,Justin Faulk,D,STL,32,69,8,27,35
38,8479390,Taylor Raddysh,R,WSH,26,64,19,15,34
38,8481186,Logan O'Connor,R,COL,28,81,18,16,34
38,8477987,Ryan Donato,C,CHI,28,54,17,17,34
38,8471698,T.J. Oshie,R,WSH,38,68,14,20,34
38,8480849,Barrett Hayton,C,UTA,24,72,14,20,34
38,8474053,Logan Couture,C,SJS,35,60,12,22,34
38,8478038,Devon Toews,D,COL,30,72,9,25,34
38,8478851,Alexandre Carrier,D,NSH,28,71,3,31,34
38,8481535,Nils Hoglander,L,VAN,24,65,21,12,33
38,8474715,Cameron Atkinson,R,TBL,35,79,18,15,33
38,8479353,Brett Howden,C,VGK,26,71,18,15,33
38,8476474,Stefan Noesen,R,NJD,31,71,16,17,33
38,8480068,Ryan Poehling,C,PHI,25,70,15,18,33
38,8482055,Drew O'Connor,L,PIT,26,59,14,19,33
38,8480145,Neal Pionk,D,WPG,29,67,7,26,33
38,8478396,Noah Hanifin,D,VGK,27,57,6,27,33
38,8476923,Damon Severson,D,CBJ,30,80,4,29,33
38,8482146,Luke Evangelista,R,NSH,22,66,17,15,32
38,8477953,Kasperi Kapanen,R,STL,28,69,16,16,32
38,8480003,Jesper Boqvist,C,FLA,26,69,14,18,32
38,8481524,Bowen Byram,D,BUF,23,69,13,19,32
38,8479365,Trent Frederic,C,BOS,26,77,10,22,32
38,8481656,Aliaksei Protas,C,WSH,23,70,8,24,32
38,8480336,Sean Walker,D,CAR,30,74,8,24,32
38,8473563,Nicklas Backstrom,C,WSH,37,63,7,25,32
38,8480434,Sean Durzi,D,UTA,26,72,5,27,32
38,8476892,Colton Parayko,D,STL,31,68,2,30,32
38,8476419,Jean-Gabriel Pageau,C,NYI,32,74,18,13,31
38,8480893,Kirill Marchenko,R,CBJ,24,62,17,14,31
38,8476392,Adam Lowry,C,WPG,31,61,13,18,31
38,8475763,Kevin Hayes,R,PIT,32,67,11,20,31
38,8481581,Thomas Harley,D,DAL,23,74,11,20,31
38,8473422,Nick Foligno,L,CHI,37,53,11,20,31
38,8481546,Cam York,D,PHI,23,65,6,25,31
38,8482111,Justin Barron,D,MTL,23,70,6,25,31
38,8479992,Michael Rasmussen,C,DET,25,79,13,17,30
38,8475287,Erik Haula,L,NJD,33,69,13,17,30
38,8476921,Jordan Martinook,L,CAR,32,61,13,17,30
38,8482074,Connor Zary,C,CGY,23,62,12,18,30
38,8479996,Cody Glass,C,NSH,25,65,10,20,30
38,8474716,Jared Spurgeon,D,MIN,35,77,9,21,30
38,8475218,Mattias Ekholm,D,EDM,34,72,8,22,30
38,8475760,Nick Bjugstad,C,UTA,32,76,15,14,29
38,8479661,Tanner Jeannot,L,LAK,27,78,14,15,29
38,8480789,Oliver Wahlstrom,R,NYI,24,71,13,16,29
38,8477505,Alexander Wennberg,C,SJS,30,66,11,18,29
38,8475791,Taylor Hall,L,CHI,33,58,11,18,29
38,8482624,Daniil Miromanov,D,CGY,27,57,11,18,29
38,8477498,Darnell Nurse,D,EDM,29,75,11,18,29
38,8474189,Lars Eller,C,PIT,35,60,11,18,29
38,8476927,Teddy Blueger,C,VAN,30,67,9,20,29
38,8481523,Kirby Dach,C,MTL,23,67,9,20,29
38,8481703,Valtteri Puustinen,R,PIT,25,72,8,21,29
38,8482712,Oskar Olausson,R,COL,22,76,7,22,29
38,8476422,Mike Reilly,D,NYI,31,77,4,25,29
38,8480043,Timothy Liljegren,D,TOR,25,67,3,26,29
38,8482667,William Eklund,L,SJS,22,63,17,11,28
38,8481032,Paul Cotter,C,NJD,25,64,17,11,28
38,8482079,Marco Rossi,C,MIN,23,65,16,12,28
38,8478413,Jordan Greenway,L,BUF,27,61,15,13,28
38,8481477,Nico Sturm,C,SJS,29,60,15,13,28
38,8480835,Jack Drury,C,CAR,24,60,13,15,28
38,8482105,Jake Sanderson,D,OTT,22,75,7,21,28
38,8477506,Ryan Pulock,D,NYI,30,79,4,24,28
38,8477969,Marcus Pettersson,D,PIT,28,77,2,26,28
38,8478109,Victor Olofsson,L,VGK,29,67,13,14,27
38,8478057,Dakota Joshua,C,VAN,28,66,11,16,27
38,8484203,Bradly Nadeau,L,CAR,19,64,11,16,27
38,8482067,Connor Mackey,D,NYR,28,66,9,18,27
38,8482101,Danil Gushchin,L,SJS,22,58,5,22,27
38,8473507,Jeff Petry,D,DET,37,75,5,22,27
38,8478507,John Marino,D,UTA,27,68,4,23,27
38,8480459,Pius Suter,C,VAN,28,74,22,4,26
38,8482737,Zack Bolduc,C,STL,21,60,13,13,26
38,8476897,Oskar Sundqvist,C,STL,30,66,13,13,26
38,8482125,Alexander Holtz,R,VGK,22,69,12,14,26
38,8482749,Joshua Roy,R,MTL,21,66,10,16,26
38,8476480,Vladislav Namestnikov,C,WPG,32,68,10,16,26
38,8475200,Dmitry Orlov,D,CAR,33,76,6,20,26
38,8477507,Nikita Zadorov,D,BOS,29,67,4,22,26
38,8476891,Matthew Grzelcyk,D,PIT,30,70,3,23,26
38,8477845,Trevor van Riemsdyk,D,WSH,33,69,3,23,26
38,8481014,Alexander Romanov,D,NYI,24,73,2,24,26
38,8479941,Justin Danforth,R,CBJ,31,58,16,9,25
38,8480748,Kiefer Sherwood,L,VAN,29,62,13,12,25
38,8481481,Blake Lizotte,C,PIT,27,64,12,13,25
38,8477353,Tyler Motte,C,DET,29,76,12,13,25
38,8477369,Carson Soucy,D,VAN,30,59,11,14,25
38,8478891,Mason Appleton,C,WPG,28,65,7,18,25
38,8478882,Vladislav Gavrikov,D,LAK,29,70,5,20,25
38,8479398,Samuel Girard,D,COL,26,72,3,22,25
38,8480873,Rasmus Sandin,D,WSH,24,66,1,24,25
38,8475790,Erik Gudbranson,D,CBJ,32,77,1,24,25
38,8480813,Joe Veleno,C,DET,24,76,13,11,24
38,8478020,Michael Amadio,R,OTT,28,76,12,12,24
38,8476624,Barclay Goodrow,C,SJS,31,59,12,12,24
38,8481580,Connor McMichael,C,WSH,23,63,11,13,24
38,8476278,Colin Blackwell,C,DAL,31,78,10,14,24
38,8480252,Cole Guttman,C,CHI,25,40,10,14,24
38,8477488,Brett Pesce,D,NJD,30,69,9,15,24
38,8476925,Colton Sissons,C,NSH,31,61,9,15,24
38,8478911,Matt Roy,D,WSH,29,64,8,16,24
38,8480448,Parker Kelly,L,COL,25,72,7,17,24
38,8479983,Mario Ferraro,D,SJS,26,72,6,18,24
38,8475171,Oliver Ekman-Larsson,D,TOR,33,72,6,18,24
38,8474673,TJ Brodie,D,CHI,34,64,6,18,24
38,8483490,Pavel Mintyukov,D,ANA,21,75,5,19,24
38,8476525,Colin Miller,D,WPG,32,69,5,19,24
38,8476457,Adam Larsson,D,SEA,32,73,2,22,24
38,8483524,Shane Wright,C,SEA,20,64,13,10,23
38,8476873,Mark Jankowski,C,NSH,30,45,9,14,23
38,8481093,Rafael Harvey-Pinard,L,MTL,25,63,8,15,23
38,8483445,Cutter Gauthier,L,ANA,20,60,7,16,23
38,8480855,Jack McBain,C,UTA,24,65,6,17,23
38,8475231,Casey Cizikas,C,NYI,33,73,6,17,23
38,8482451,Mikael Pyyhtia,L,CBJ,23,43,6,17,23
38,8478013,Jake Walman,D,SJS,28,70,2,21,23
38,8479619,Michael Carcone,L,UTA,28,61,16,6,22
38,8476469,Joel Armia,R,MTL,31,65,15,7,22
38,8477446,Michael McCarron,R,NSH,29,61,15,7,22
38,8479066,Ryan Lomberg,L,CGY,30,68,15,7,22
38,8470621,Corey Perry,R,EDM,39,72,11,11,22
38,8476878,Zemgus Girgensons,C,TBL,30,78,10,12,22
38,8477450,Jason Dickinson,C,CHI,29,52,10,12,22
38,8482809,Jackson Blake,R,CAR,21,55,9,13,22
38,8480762,Eric Robinson,L,CAR,29,62,8,14,22
38,8476467,Jamie Oleksiak,D,SEA,32,59,5,17,22
38,8476979,Erik Gustafsson,D,DET,32,79,5,17,22
38,8476988,Matt Benning,D,SJS,30,62,5,17,22
38,8479639,Dylan Coghlan,D,WPG,26,63,5,17,22
38,8478500,Ivan Provorov,D,CBJ,27,76,4,18,22
38,8479998,Mikey Anderson,D,LAK,25,71,2,20,22
38,8479371,Dante Fabbro,D,NSH,26,61,1,21,22
38,8475343,Nic Dowd,C,WSH,34,52,13,8,21
38,8481704,Juuso Parssinen,C,NSH,23,56,12,9,21
38,8475855,Jesper Fast,R,CAR,33,57,11,10,21
38,8479316,Luke Kunin,C,SJS,27,53,10,11,21
38,8475193,Tomas Tatar,L,NJD,34,64,10,11,21
38,8480281,Alexey Toropchenko,R,STL,25,57,10,11,21
38,8482634,Alex Steeves,C,TOR,25,52,10,11,21
38,8477947,Sonny Milano,L,WSH,28,57,9,12,21
38,8480205,Emil Bemstrom,C,PIT,25,59,9,12,21
38,8478133,Jake Evans,C,MTL,28,66,8,13,21
38,8477392,Hudson Fasching,R,NYI,29,65,7,14,21
38,8477931,Tomas Nosek,L,FLA,32,60,7,14,21
38,8480727,Zach Whitecloud,D,VGK,28,53,7,14,21
38,8478970,Jalen Chatfield,D,CAR,28,66,6,15,21
38,8482655,Janis Moser,D,TBL,24,78,4,17,21
38,8476931,Jake McCabe,D,TOR,31,66,3,18,21
38,8476917,Adam Pelech,D,NYI,30,78,2,19,21
38,8474151,Ryan McDonagh,D,TBL,35,77,1,20,21
38,8477406,Mattias Janmark,C,EDM,32,62,14,6,20
38,8481601,Simon Holmstrom,R,NYI,23,67,12,8,20
38,8479393,Noah Gregor,L,OTT,26,67,12,8,20
38,8475149,Marcus Johansson,L,MIN,34,67,10,10,20
38,8479368,Max Jones,L,BOS,26,71,10,10,20
38,8483493,Frank Nazar,C,CHI,20,58,8,12,20
38,8476918,Jimmy Vesey,L,NYR,31,70,8,12,20
38,8482117,Lukas Reichel,L,CHI,22,55,8,12,20
38,8478432,Christian Fischer,R,DET,27,71,7,13,20
38,8476463,Jonas Brodin,D,MIN,31,78,5,15,20
38,8478452,Caleb Jones,D,LAK,27,59,5,15,20
38,8480878,Nils Lundkvist,D,DAL,24,73,4,16,20
38,8479982,Conor Timmins,D,TOR,26,58,4,16,20
38,8476429,Scott Mayfield,D,NYI,32,75,3,17,20
38,8480049,Dylan Samberg,D,WPG,25,65,3,17,20
38,8479372,Joshua Mahura,D,SEA,26,56,3,17,20
38,8475181,Nick Leddy,D,STL,33,68,1,19,20
38,8482062,Cole Smith,L,NSH,29,56,13,6,19
38,8480995,Pontus Holmberg,R,TOR,25,60,9,10,19
38,8477478,William Carrier,L,CAR,30,55,8,11,19
38,8475842,Sam Carrick,C,NYR,32,59,8,11,19
38,8483482,Tristan Luneau,D,ANA,20,71,7,12,19
38,8480172,Jan Rutta,D,SJS,34,69,6,13,19
38,8476879,Cody Ceci,D,EDM,31,73,5,14,19
38,8475233,David Savard,D,MTL,34,68,5,14,19
38,8475762,Derek Forbort,D,VAN,32,57,5,14,19
38,8482142,Jamie Drysdale,D,PHI,22,65,3,16,19
38,8481441,Joe Snively,C,DET,28,63,2,17,19
38,8475324,Nick Jensen,D,OTT,34,74,2,17,19
38,8481178,Egor Zamula,D,PHI,24,61,1,18,19
38,8482679,Matt Coronato,R,CGY,22,62,10,8,18
38,8481553,Bobby Brink,R,PHI,23,59,9,9,18
38,8476856,Mathew Dumba,D,DAL,30,70,9,9,18
38,8477979,Nicolas Aube-Kubel,R,BUF,28,53,8,10,18
38,8482157,Will Cuylle,L,NYR,22,63,8,10,18
38,8478043,Sam Lafferty,C,BUF,29,63,7,11,18
38,8480806,Isac Lundestrom,C,ANA,25,62,7,11,18
38,8479402,Jake Bean,D,CGY,26,64,6,12,18
38,8479315,Joey Anderson,R,CHI,26,53,6,12,18
38,8477952,Robby Fabbri,C,ANA,28,65,5,13,18
38,8477220,Nate Schmidt,D,FLA,33,69,5,13,18
38,8479351,Sam Steel,C,DAL,26,77,5,13,18
38,8478136,Jake Middleton,D,MIN,28,73,5,13,18
38,8483565,Nick Blankenburg,D,NSH,26,66,2,16,18
38,8479976,Juuso Valimaki,D,UTA,26,56,2,16,18
38,8483468,Jiri Kulich,C,BUF,20,56,8,9,17
38,8477508,Curtis Lazar,C,NJD,29,61,8,9,17
38,8478585,Derek Ryan,C,EDM,38,61,8,9,17
38,8474034,Patrick Maroon,L,CHI,36,53,8,9,17
38,8480144,David Kampf,C,TOR,29,71,7,10,17
38,8480980,Connor Dewar,C,TOR,25,61,7,10,17
38,8483499,Liam Ohgren,L,MIN,20,51,6,11,17
38,8480073,Erik Brannstrom,D,COL,25,67,5,12,17
38,8470600,Ryan Suter,D,STL,39,63,5,12,17
38,8482192,Isaak Phillips,D,CHI,23,53,3,14,17
38,8482245,Artem Zub,D,OTT,29,66,3,14,17
38,8480070,Ian Mitchell,D,BOS,25,52,2,15,17
38,8478399,Jonas Siegenthaler,D,NJD,27,62,1,16,17
38,8479293,Brandon Tanev,L,SEA,33,64,10,6,16
38,8480021,Jack Studnicka,C,LAK,25,67,8,8,16
38,8476994,Vinnie Hinostroza,C,NSH,30,53,8,8,16
38,8483491,Ivan Miroshnichenko,L,WSH,20,54,8,8,16
38,8482803,Olen Zellweger,D,ANA,21,68,7,9,16
38,8476960,Andreas Athanasiou,C,CHI,30,57,7,9,16
38,8481527,Kaedan Korczak,D,VGK,23,51,7,9,16
38,8477919,Frederick Gaudreau,C,MIN,31,56,6,10,16
38,8480074,Alexandre Texier,C,STL,25,57,6,10,16
38,8474574,Tyler Myers,D,VAN,34,65,5,11,16
38,8475208,Brian Dumoulin,D,ANA,33,65,5,11,16
38,8478840,Will Borgen,D,SEA,28,64,4,12,16
38,8478859,Niko Mikkola,D,FLA,28,57,4,12,16
38,8480035,Henri Jokiharju,D,BUF,25,65,3,13,16
38,8482087,Kaiden Guhle,D,MTL,22,55,3,13,16
38,8476874,Olli Maatta,D,DET,30,68,3,13,16
38,8480246,Nick Perbix,D,TBL,26,74,2,14,16
38,8482155,Alex Laferriere,R,LAK,23,57,10,5,15
38,8479520,Brandon Duhaime,R,WSH,27,51,10,5,15
38,8482259,Bobby McMann,C,TOR,28,60,9,6,15
38,8478508,Yakov Trenin,C,MIN,27,54,9,6,15
38,8476822,Luke Glendening,C,TBL,35,78,8,7,15
38,8478831,Kevin Stenlund,C,UTA,28,48,8,7,15
38,8475220,Marcus Foligno,L,MIN,33,60,7,8,15
38,8477903,Garnet Hathaway,R,PHI,33,66,7,8,15
38,8481518,Nolan Foote,L,NJD,24,43,7,8,15
38,8476889,Radek Faksa,C,STL,30,58,7,8,15
38,8480025,MacKenzie Entwistle,R,FLA,25,70,7,8,15
38,8482148,Hendrix Lapierre,C,WSH,22,48,6,9,15
38,8476934,Brock McGinn,L,ANA,30,47,6,9,15
38,8477070,Liam O'Brien,C,UTA,30,56,6,9,15
38,8477015,Connor Brown,R,EDM,30,64,4,11,15
38,8477435,Ryan Graves,D,PIT,29,79,4,11,15
38,8480011,Klim Kostin,C,SJS,25,49,4,11,15
38,8476329,Travis Boyd,C,MIN,31,62,4,11,15
38,8479980,Nicolas Hague,D,VGK,26,56,4,11,15
38,8476331,Dylan DeMelo,D,WPG,31,68,3,12,15
38,8475179,Dmitry Kulikov,D,FLA,34,49,3,12,15
38,8482176,Wyatt Kaiser,D,CHI,22,56,3,12,15
38,8480891,Michael Kesselring,D,UTA,24,61,2,13,15
38,8480058,Pierre-Olivier Joseph,D,STL,25,58,2,13,15
38,8475690,Chris Tanev,D,TOR,35,48,1,14,15
38,8475225,Craig Smith,C,CHI,35,54,8,6,14
38,8477018,Ben Hutton,D,VGK,31,51,8,6,14
38,8482807,Ethan Del Mastro,D,CHI,21,35,8,6,14
38,8481641,Joel Kiviranta,L,COL,28,73,7,7,14
38,8479718,Alex Barré-Boulet,C,MTL,27,45,7,7,14
38,8478569,Noel Acciari,C,PIT,33,50,6,8,14
38,8479370,Tyson Jost,C,CAR,26,45,6,8,14
38,8480292,Carson Meyer,R,ANA,27,33,5,9,14
38,8479328,Julien Gauthier,R,NYI,27,61,4,10,14
38,8482166,Shakir Mukhamadullin,D,SJS,22,48,4,10,14
38,8481751,Lukas Rousek,R,BUF,25,50,4,10,14
38,8478178,Darren Raddysh,D,TBL,28,68,3,11,14
38,8474013,Ian Cole,D,UTA,35,58,3,11,14
38,8480887,Jordan Harris,D,MTL,24,52,2,12,14
38,8481537,Nikita Okhotiuk,D,CGY,24,53,2,12,14
38,8476967,Brett Kulak,D,EDM,30,59,2,12,14
38,8478416,Erik Cernak,D,TBL,27,68,0,14,14
38,8481059,Scott Perunovich,D,STL,26,62,0,14,14
38,8477034,Jaycob Megna,D,FLA,32,46,0,14,14
38,8479336,Carl Grundstrom,R,SJS,27,57,10,3,13
38,8481517,Brett Leason,R,ANA,25,58,8,5,13
38,8482666,Scott Morrow,D,CAR,22,48,8,5,13
38,8479981,Jonah Gadjovich,L,FLA,26,42,8,5,13
38,8481522,Peyton Krebs,C,BUF,23,56,7,6,13
38,8471817,Ryan Reaves,R,TOR,37,55,7,6,13
38,8483495,Simon Nemec,D,NJD,20,54,6,7,13
38,8482744,James Malatesta,L,CBJ,21,43,6,7,13
38,8480845,Rasmus Kupari,C,WPG,24,41,6,7,13
38,8481701,Santeri Hatakka,D,NJD,23,38,5,8,13
38,8478434,Keegan Kolesar,R,VGK,27,65,4,9,13
38,8479414,Nathan Bastian,R,NJD,27,58,4,9,13
38,8481708,Zac Jones,D,NYR,24,53,4,9,13
38,8475750,Jon Merrill,D,MIN,32,60,4,9,13
38,8479378,Logan Stanley,D,WPG,26,45,4,9,13
38,8475279,Ben Chiarot,D,DET,33,66,3,10,13
38,8478468,Jeremy Lauzon,D,NSH,27,49,3,10,13
38,8481019,David Gustafsson,C,WPG,24,50,1,12,13
38,8476858,Phillip Di Giuseppe,L,VAN,31,48,9,3,12
38,8481122,Simon Benoit,D,TOR,26,41,8,4,12
38,8474567,Zach Bogosian,D,MIN,34,61,7,5,12
38,8480289,Morgan Barron,C,WPG,26,53,6,6,12
38,8481028,Martin Pospisil,C,CGY,25,60,6,6,12
38,8477380,Jonny Brodzinski,C,NYR,31,57,6,6,12
38,8482073,Braden Schneider,D,NYR,23,62,5,7,12
38,8483457,Lane Hutson,D,MTL,20,71,4,8,12
38,8480001,Urho Vaakanainen,D,ANA,25,55,4,8,12
38,8477938,Haydn Fleury,D,WPG,28,43,4,8,12
38,8477962,Brendan Lemieux,L,CAR,28,41,4,8,12
38,8482784,Zach Dean,C,STL,21,43,4,8,12
38,8481161,Jake Christiansen,D,CBJ,25,58,3,9,12
38,8479324,Ryan Lindgren,D,NYR,26,61,3,9,12
38,8479543,Michael Pezzetta,L,MTL,26,49,3,9,12
38,8478454,Noah Juulsen,D,VAN,27,35,3,9,12
38,8471709,Marc-Edouard Vlasic,D,SJS,37,55,2,10,12
38,8479442,Troy Stecher,D,EDM,30,54,2,10,12
38,8480950,Ilya Lyubushkin,D,DAL,30,62,2,10,12
38,8479369,Andrew Peeke,D,BOS,26,59,1,11,12
38,8477573,Nathan Walker,L,STL,30,42,8,3,11
38,8480844,Grigori Denisenko,L,VGK,24,31,7,4,11
38,8473453,Trevor Lewis,C,LAK,37,71,6,5,11
38,8479772,Zack MacEwen,R,OTT,28,53,6,5,11
38,8482859,Zack Ostapchuk,C,OTT,21,48,6,5,11
38,8479439,Jacob MacDonald,D,COL,31,45,6,5,11
38,8481521,Ronnie Attard,D,PHI,25,54,5,6,11
38,8479344,Jesse Puljujarvi,R,PIT,26,50,5,6,11
38,8478421,A.J. Greer,L,FLA,28,53,5,6,11
38,8477482,Zachary Sanford,L,CHI,30,32,5,6,11
38,8474612,Travis Hamonic,D,OTT,34,47,5,6,11
38,8482730,Brandt Clarke,D,LAK,21,44,4,7,11
38,8479994,Jaret Anderson-Dolan,C,WPG,25,36,4,7,11
38,8481568,Alex Vlasic,D,CHI,23,58,3,8,11
38,8479026,Philippe Myers,D,TOR,27,49,3,8,11
38,8483466,Kevin Korchinski,D,CHI,20,50,3,8,11
38,8482077,Dylan Holloway,L,EDM,23,46,3,8,11
38,8483460,David Jiricek,D,CBJ,21,53,2,9,11
38,8471677,Jack Johnson,D,CBJ,37,68,2,9,11
38,8475455,Brenden Dillon,D,NJD,34,53,2,9,11
38,8480196,Jacob Bryson,D,BUF,27,49,2,9,11
38,8480222,Sebastian Aho,D,PIT,28,65,1,10,11
38,8476902,Esa Lindell,D,DAL,30,73,0,11,11
38,8475235,Nicolas Deslauriers,L,PHI,33,53,8,2,10
38,8479671,Mathieu Olivier,R,CBJ,27,46,6,4,10
38,8481617,Vasily Podkolzin,R,VAN,23,44,5,5,10
38,8479291,Kevin Rooney,C,CGY,31,46,5,5,10
38,8478017,Mark Friedman,D,VAN,29,33,5,5,10
38,8482747,Brennan Othmann,L,NYR,21,41,4,6,10
38,8480860,Kevin Bahl,D,CGY,24,56,3,7,10
38,8478451,Ethan Bear,D,WSH,27,45,3,7,10
38,8479348,Kale Clague,D,BUF,26,33,3,7,10
38,8475718,Justin Holl,D,DET,32,59,3,7,10
38,8476312,Josh Manson,D,COL,33,55,2,8,10
38,8475462,Radko Gudas,D,ANA,34,59,2,8,10
38,8478443,Brandon Carlo,D,BOS,28,58,2,8,10
38,8473446,Erik Johnson,D,PHI,36,48,2,8,10
38,8475188,Brayden McNabb,D,VGK,33,56,1,9,10
38,8480848,Ty Dellandrea,C,SJS,24,42,1,9,10
38,8474568,Luke Schenn,D,NSH,35,46,1,9,10
38,8481716,Dmitri Voronkov,L,CBJ,24,48,6,3,9
38,8479968,Vinni Lettieri,C,BOS,29,47,6,3,9
38,8480007,Jonas Rondbjerg,R,VGK,25,42,5,4,9
38,8481532,Alex Turcotte,C,LAK,23,46,5,4,9
38,8476374,Sean Kuraly,C,CBJ,31,56,4,5,9
38,8480355,Mark Kastelic,C,BOS,25,57,4,5,9
38,8481567,Henry Thrun,D,SJS,23,47,3,6,9
38,8480807,Mattias Samuelsson,D,BUF,24,49,3,6,9
38,8479536,Axel Jonsson-Fjallby,L,WPG,26,31,3,6,9
38,8483630,Pavol Regenda,L,ANA,25,30,3,6,9
38,8479944,Zach Aston-Reese,C,VGK,30,57,2,7,9
38,8484149,Gavin Brindley,C,CBJ,20,47,2,7,9
38,8474090,Brendan Smith,D,DAL,35,50,2,7,9
38,8481598,Philip Broberg,D,EDM,23,38,2,7,9
38,8476442,Matt Nieto,L,PIT,32,47,2,7,9
38,8479972,Mason Shaw,C,WPG,26,36,2,7,9
38,8477499,Rasmus Ristolainen,D,PHI,30,66,1,8,9
38,8480441,Trey Fix-Wolansky,R,CBJ,25,36,1,8,9
38,8481789,Tye Kartye,L,SEA,23,35,6,2,8
38,8483570,Ben Meyers,C,SEA,26,35,5,3,8
38,8482095,Tyler Kleven,D,OTT,22,47,4,4,8
38,8482659,Josh Doan,R,UTA,22,51,4,4,8
38,8480870,Bo Groulx,C,NYR,24,29,4,4,8
38,8481754,Nikita Nesterenko,C,ANA,23,32,4,4,8
38,8481592,Jakob Pelletier,L,CGY,23,45,3,5,8
38,8475177,Calvin de Haan,D,COL,33,43,3,5,8
38,8481599,Victor Soderstrom,D,UTA,23,45,3,5,8
38,8481013,Jonatan Berggren,R,DET,24,63,3,5,8
38,8480880,Jakub Lauko,C,MIN,24,30,3,5,8
38,8480157,Calle Rosen,D,COL,30,45,2,6,8
38,8482652,Walker Duehr,R,CGY,27,46,2,6,8
38,8477384,Joshua Brown,D,EDM,30,42,2,6,8
38,8479986,Kole Lind,R,DAL,26,51,2,6,8
38,8477365,Connor Clifton,D,BUF,29,52,0,8,8
38,8480879,Jacob Bernard-Docker,D,OTT,24,39,0,8,8
38,8482861,Vincent Iorio,D,WSH,22,35,0,8,8
38,8482733,Logan Mailloux,D,MTL,31,35,6,1,7
38,8477401,John Hayden,C,SEA,29,29,5,2,7
38,8483012,Logan Morrison,C,SEA,22,36,5,2,7
38,8481600,Tobias Bjornfot,D,FLA,23,32,3,4,7
38,8477887,Patrick Brown,C,BOS,32,41,3,4,7
38,8482751,Ryan Winterton,C,SEA,21,29,3,4,7
38,8482765,Isak Rosen,R,BUF,21,20,3,4,7
38,8481550,Adam Beckman,L,NJD,23,32,2,5,7
38,8482964,Arber Xhekaj,D,MTL,23,49,2,5,7
38,8482145,Mavrik Bourque,C,DAL,22,53,2,5,7
38,8482511,Mason Lohrei,D,BOS,23,32,2,5,7
38,8481743,Marc Del Gaizo,D,NSH,25,23,2,5,7
38,8480834,Ty Emberson,D,SJS,24,42,2,5,7
38,8474166,Alec Martinez,D,CHI,37,52,1,6,7
38,8481147,Reese Johnson,C,MIN,26,33,1,6,7
38,8482470,Ilya Solovyov,D,CGY,24,23,1,6,7
38,8480796,Martin Fehervary,D,WSH,25,53,0,7,7
38,8481556,John Beecher,C,BOS,23,36,5,1,6
38,8481543,Nikita Alexandrov,C,STL,24,28,5,1,6
38,8484911,Collin Graf,R,SJS,22,39,4,2,6
38,8478146,Matthew Highmore,C,OTT,28,33,4,2,6
38,8478211,Dryden Hunt,L,CGY,29,44,3,3,6
38,8478874,Adam Gaudette,R,OTT,28,36,3,3,6
38,8482141,Lukas Cormier,D,VGK,22,23,3,3,6
38,8476441,Joel Edmundson,D,LAK,31,39,2,4,6
38,8478424,Jansen Harkins,C,ANA,27,29,2,4,6
38,8476913,Devin Shore,C,MIN,30,34,2,4,6
38,8479576,Vincent Desharnais,D,VAN,28,41,2,4,6
38,8477851,Jordan Oesterle,D,BOS,32,37,1,5,6
38,8481056,Spencer Stastney,D,NSH,24,30,1,5,6
38,8477473,Justin Bailey,R,SJS,29,30,1,5,6
38,8480990,Declan Chisholm,D,MIN,24,39,0,6,6
38,8482070,Mitchell Chaffee,R,TBL,26,47,5,0,5
38,8476867,Brendan Gaunce,C,MIN,30,37,4,1,5
38,8482144,Jack Thompson,D,SJS,22,27,3,2,5
38,8481609,Vladislav Kolyachonok,D,UTA,23,37,3,2,5
38,8479359,Beck Malenstyn,L,BUF,26,50,2,3,5
38,8483763,Maksymilian Szuber,D,UTA,22,32,2,3,5
38,8476473,Connor Murphy,D,CHI,31,37,2,3,5
38,8481541,Samuel Bolduc,D,NYI,24,25,2,3,5
38,8483619,Filip Roos,D,OTT,25,31,2,3,5
38,8477810,Joel Hanley,D,CGY,33,26,2,3,5
38,8482496,Nils Aman,C,VAN,24,39,1,4,5
38,8477335,Kyle Burroughs,D,LAK,29,42,1,4,5
38,8482762,Simon Edvinsson,D,DET,21,51,1,4,5
38,8479587,Rhett Gardner,C,PHI,28,20,1,4,5
38,8476372,Nick Seeler,D,PHI,31,35,1,4,5
38,8477462,Robert Hagg,D,VGK,29,19,1,4,5
38,8481030,Jack St. Ivany,D,PIT,25,22,1,4,5
38,8478409,Anthony Richard,C,PHI,28,33,0,5,5
38,8480192,Johnathan Kovacevic,D,NJD,27,54,0,5,5
38,8479249,Andrew Poturalski,C,SJS,30,33,0,5,5
38,8478450,Parker Wotherspoon,D,BOS,27,36,0,5,5
38,8477527,Ross Johnston,L,ANA,30,33,0,5,5
38,8479638,Justin Brazeau,R,BOS,26,38,3,1,4
38,8481679,Maxence Guenette,D,OTT,23,40,3,1,4
38,8482713,Mackie Samoskevich,R,FLA,22,43,3,1,4
38,8483397,Marc McLaughlin,C,BOS,25,32,2,2,4
38,8480468,James Hamblin,L,EDM,25,24,2,2,4
38,8481422,Jake Lucchini,C,NSH,29,18,2,2,4
38,8480032,Shane Bowers,C,NJD,25,15,2,2,4
38,8480245,Olle Lycksell,R,PHI,25,30,2,2,4
38,8484287,Cole McWard,D,VAN,23,19,1,3,4
38,8480890,Jan Jenik,C,OTT,24,28,1,3,4
38,8482172,Landon Slaggert,L,CHI,22,24,1,3,4
38,8479991,Jake Leschyshyn,C,NYR,25,27,1,3,4
38,8477541,Dakota Mermis,D,TOR,30,21,1,3,4
38,8481167,Brayden Pachal,D,CGY,25,46,0,4,4
38,8484254,Akito Hirose,D,VAN,25,40,0,4,4
38,8482250,Callahan Burke,C,VGK,27,23,0,4,4
38,8477244,Chad Ruhwedel,D,NYR,34,32,0,4,4
38,8480084,Nick DeSimone,D,NJD,30,14,0,4,4
38,8478502,Dennis Gilbert,D,BUF,28,16,0,4,4
38,8482162,Roby Jarventie,L,EDM,22,23,3,0,3
38,8479367,William Lockwood,R,FLA,26,12,2,1,3
38,8479362,Riley Tufte,L,BOS,26,21,2,1,3
38,8482061,Brandon Biro,L,SEA,26,11,2,1,3
38,8475413,Justin Dowling,C,NJD,34,15,2,1,3
38,8482177,Marat Khusnutdinov,C,MIN,22,28,1,2,3
38,8483549,Lucas Condotta,L,MTL,27,25,1,2,3
38,8482858,Ryker Evans,D,SEA,23,26,1,2,3
38,8480267,Sammy Walker,C,MIN,25,23,1,2,3
38,8481593,Jayden Struble,D,MTL,23,17,1,2,3
38,8481605,Jackson LaCombe,D,ANA,23,29,0,3,3
38,8477971,Andreas Englund,D,LAK,28,23,0,3,3
38,8482929,Emil Lilleberg,D,TBL,23,19,0,3,3
38,8474062,Riley Nash,C,NYR,35,15,0,3,3
38,8481719,Maxwell Crozier,D,TBL,24,23,0,3,3
38,8479985,Cale Fleury,D,SEA,26,28,2,0,2
38,8482165,Yan Kuznetsov,D,CGY,22,18,2,0,2
38,8479419,Brett Murray,L,BUF,26,16,2,0,2
38,8478021,William Lagesson,D,DET,28,17,2,0,2
38,8475958,Michael Sgarbossa,C,WSH,32,32,1,1,2
38,8479379,Givani Smith,R,SJS,26,27,1,1,2
38,8482153,Brendan Brisson,C,VGK,23,33,1,1,2
38,8482118,Sam Colangelo,R,ANA,23,16,1,1,2
38,8482102,Vasily Ponomarev,C,PIT,22,23,1,1,2
38,8480874,Adam Ginning,D,PHI,24,14,1,1,2
38,8481585,Egor Afanasyev,L,SJS,23,13,1,1,2
38,8478881,Brett Seney,L,CHI,28,14,1,1,2
38,8479320,Maxime Lajoie,D,SEA,27,17,1,1,2
38,8482460,Matt Rempe,C,NYR,22,12,1,1,2
38,8483512,Matthew Savoie,C,EDM,20,14,0,2,2
38,8482201,Gage Goncalves,C,TBL,23,29,0,2,2
38,8483597,Milos Kelemen,L,UTA,25,15,0,2,2
38,8478446,Glenn Gawdin,C,LAK,27,11,0,2,2
38,8481564,Ryan Johnson,D,BUF,23,18,0,2,2
38,8481006,Tyler Tucker,D,STL,24,19,0,2,2
38,8475795,Dylan McIlrath,D,WSH,32,15,0,2,2
38,8480075,Cameron Crotty,D,MIN,25,8,0,2,2
38,8481462,Mason Morelli,L,VGK,28,8,0,2,2
38,8482147,Jean-Luc Foudy,C,COL,22,26,1,0,1
38,8480851,Akil Thomas,C,LAK,24,23,1,0,1
38,8477149,Scott Sabourin,R,SJS,32,12,1,0,1
38,8482516,Matthew Kessel,D,STL,24,11,1,0,1
38,8481065,Angus Crookshank,L,OTT,25,19,1,0,1
38,8484258,Sam Malinski,D,COL,26,17,1,0,1
38,8483398,Declan Carlile,D,TBL,31,10,1,0,1
38,8481726,Adam Edstrom,C,NYR,24,5,1,0,1
38,8483471,Brad Lambert,C,WPG,31,8,1,0,1
38,8476952,Dominic Toninato,C,WPG,30,33,0,1,1
38,8481237,Kyle MacLean,C,NYI,25,21,0,1,1
38,8477467,Gustav Olofsson,D,SEA,30,17,0,1,1
38,8477320,Anton Blidh,L,NYR,29,17,0,1,1
38,8477073,Kurtis MacDermid,L,NJD,30,32,0,1,1
38,8478011,Louie Belpedio,D,PHI,28,9,0,1,1
38,8481024,Linus Karlsson,C,VAN,25,6,0,1,1
38,8481206,John Ludvig,D,PIT,24,12,0,1,1
38,8481699,Aku Raty,R,UTA,23,13,0,1,1
38,8481806,Louis Crevier,D,CHI,23,12,0,1,1
38,8479421,Jacob Moverare,D,LAK,26,5,0,1,1
38,8480823,Alexander Alexeyev,D,WSH,25,11,0,1,1
38,8482787,Nikita Chibrikov,R,WPG,31,7,0,1,1
38,8482088,Justin Sourdif,R,FLA,22,16,0,1,1
38,8483489,Fraser Minten,C,TOR,31,9,0,1,1
38,8483531,Brian Halonen,L,NJD,25,2,0,1,1
38,8483395,Arshdeep Bains,L,VAN,23,7,0,0,0
38,8475755,Alexander Petrovic,D,DAL,32,11,0,0,0
38,8480306,Grant Hutton,D,NYI,29,7,0,0,0
38,8483567,Georgii Merkulov,C,BOS,24,3,0,0,0
38,8484304,Uvis Balinskis,D,FLA,28,17,0,0,0
38,8476323,Max McCormick,L,SEA,32,3,0,0,0
38,8479330,Brandon Gignac,C,MTL,27,9,0,0,0
38,8478051,Max Willman,C,NJD,29,23,0,0,0
38,8481655,Cole Schwindt,R,CGY,23,4,0,0,0
38,8482094,Daemon Hunt,D,MIN,22,15,0,0,0
38,8483546,Marshall Rifai,D,TOR,26,4,0,0,0
38,8481043,Cole Koepke,L,BOS,26,19,0,0,0
38,8477993,Justin Kirkland,C,CGY,28,5,0,0,0
38,8478477,Mitchell Stephens,C,SEA,27,24,0,0,0
38,8483407,Brandon Scanlin,D,NYR,25,1,0,0,0
38,8481578,Graeme Clarke,R,MIN,23,10,0,0,0
38,8482476,Emil Heineman,L,MTL,23,14,0,0,0
38,8484325,Waltteri Merela,C,TBL,26,22,0,0,0
38,8478147,Bokondji Imama,L,PIT,28,5,0,0,0
38,8483920,Pierrick Dube,R,WSH,23,2,0,0,0
38,8481534,Raphael Lavoie,C,EDM,24,1,0,0,0
38,8483609,Adam Klapka,R,CGY,24,3,0,0,0
38,8482126,Emil Andrae,D,PHI,31,4,0,0,0
38,8478854,Ryan Shea,D,PIT,27,7,0,0,0
38,8483432,Luca Del Bel Belluz,C,CBJ,31,3,0,0,0
38,8484259,Ondrej Pavel,C,COL,31,2,0,0,0
38,8484326,Patrik Koch,D,UTA,28,2,0,0,0
38,8484255,Jason Polin,R,COL,25,4,0,0,0
38,8475780,Chris Wagner,R,COL,33,7,0,0,0
38,8482197,Adam Raska,R,MIN,23,7,0,0,0
38,8480274,Philip Kemp,D,EDM,25,2,0,0,0
38,8479522,Hardy Haman Aktell,D,WSH,26,3,0,0,0
38,8483401,Marc Johnstone,R,PIT,28,3,0,0,0
38,8484321,Nikolas Matinpalo,D,OTT,26,0,0,0,0
38,8470794,Joe Pavelski,C,,40,0,0,0,0
38,8479321,Lucas Johansen,D,,27,0,0,0,0
38,8477950,Tony DeAngelo,D,,29,0,0,0,0
38,8471218,Blake Wheeler,R,,38,0,0,0,0
38,8475197,Tyson Barrie,D,,33,0,0,0,0
38,8474157,Max Pacioretty,L,,36,0,0,0,0
38,8475744,Evgeny Kuznetsov,C,,32,0,0,0,0
38,8474037,James van Riemsdyk,L,,35,0,0,0,0
38,8476907,Mackenzie MacEachern,L,,30,0,0,0,0
38,8480216,Jacob Peterson,C,,25,0,0,0,0
38,8474602,Justin Schultz,D,,34,0,0,0,0
38,8482222,Alexander Barabanov,L,,30,0,0,0,0
38,8474031,Kevin Shattenkirk,D,,35,0,0,0,0
38,8477330,Dominik Kubalik,L,,29,0,0,0,0
38,8480884,Calen Addison,D,,24,0,0,0,0
38,8475906,John Klingberg,D,,32,0,0,0,0
38,8480008,Adam Ruzicka,C,,25,0,0,0,0
38,8476884,Derrick Pouliot,D,,30,0,0,0,0
38,8476919,Chris Tierney,C,,30,0,0,0,0
38,8479415,Michael McLeod,C,,26,0,0,0,0
38,8474870,Tyler Johnson,C,,34,0,0,0,0
38,8470604,Jeff Carter,C,,39,0,0,0,0
38,8478104,Sammy Blais,L,,28,0,0,0,0
38,8474884,Mike Hoffman,C,,35,0,0,0,0
38,8481591,Sam Poulin,R,,23,0,0,0,0
38,8471274,Alex Goligoski,D,,39,0,0,0,0
38,8476871,Tanner Pearson,L,,32,0,0,0,0
38,8476393,Nick Cousins,C,,31,0,0,0,0
38,8479977,Kailer Yamamoto,R,,26,0,0,0,0
38,8479346,Dillon Dube,C,,26,0,0,0,0
38,8480184,Gustav Lindstrom,D,,26,0,0,0,0
38,8479376,Victor Mete,D,,26,0,0,0,0
38,8473449,Kyle Okposo,R,,36,0,0,0,0
38,8481058,Jesse Ylonen,R,,25,0,0,0,0
38,8475752,Tyler Pitlick,C,,33,0,0,0,0
38,8481239,Samuel Fagemo,L,,24,0,0,0,0
38,8480821,Filip Zadina,R,,25,0,0,0,0
38,8470966,Mark Giordano,D,,41,0,0,0,0
38,8478495,Denis Gurianov,R,,27,0,0,0,0
38,8477464,Nic Petan,C,,29,0,0,0,0
38,8478099,Kevin Labanc,R,,29,0,0,0,0
38,8482241,Radim Zohorna,L,,28,0,0,0,0
38,8474040,Sam Gagner,C,,35,0,0,0,0
38,8479514,Rem Pitlick,C,,27,0,0,0,0
38,8478430,Oliver Kylington,D,,27,0,0,0,0
38,8479533,Joona Koppanen,L,,26,0,0,0,0
38,8479984,Cal Foote,D,,26,0,0,0,0
38,8477126,Jayson Megna,C,,34,0,0,0,0
38,8475164,Jakob Silfverberg,R,,34,0,0,0,0
38,8474009,Nick Bonino,C,,36,0,0,0,0
38,8479458,Nikita Zaitsev,D,,33,0,0,0,0
38,8477944,Jakub Vrana,L,,28,0,0,0,0
38,8471699,Andrew Cogliano,C,,37,0,0,0,0
38,8478067,Oskar Lindblom,L,,28,0,0,0,0
38,8471686,Marc Staal,D,,37,0,0,0,0
38,8470610,Zach Parise,L,,40,0,0,0,0
38,8478904,Steven Lorentz,C,,28,0,0,0,0
38,8473473,Milan Lucic,L,,36,0,0,0,0
38,8480031,Maxime Comtois,L,,25,0,0,0,0
38,8478512,Austin Czarnik,C,,32,0,0,0,0
38,8473504,Cal Clutterbuck,R,,37,0,0,0,0
38,8477454,Adam Erne,L,,29,0,0,0,0
38,8479383,Boris Katchouk,L,,26,0,0,0,0
38,8475825,Jani Hakanpää,D,,32,0,0,0,0
38,8477846,Ryan Carpenter,C,,33,0,0,0,0
38,8477930,Pierre-Edouard Bellemare,L,,39,0,0,0,0
38,8478400,Colin White,C,,27,0,0,0,0
38,8480226,Marián Studenic,R,,26,0,0,0,0
38,8480853,Liam Foudy,C,,24,0,0,0,0
38,8475797,Jarred Tinordi,D,,32,0,0,0,0
38,8479423,Alex Nylander,L,,26,0,0,0,0
38,8474618,Marco Scandella,D,,34,0,0,0,0
38,8478028,Fredrik Olofsson,L,,28,0,0,0,0
38,8474709,Matt Martin,L,,35,0,0,0,0
38,8481070,Hugh McGing,L,,26,0,0,0,0
38,8479546,Oskar Steen,C,,26,0,0,0,0
38,8474145,Robert Bortuzzo,D,,35,0,0,0,0
38,8476915,Jujhar Khaira,L,,30,0,0,0,0
38,8475278,Byron Froese,C,,33,0,0,0,0
38,8481812,Nikolai Knyzhov,D,,27,0,0,0,0
38,8478408,Travis Dermott,D,,28,0,0,0,0
38,8481077,John Leonard,L,,26,0,0,0,0
38,8479547,Matthew Phillips,R,,26,0,0,0,0
38,8480836,Jonathan Gruden,C,,24,0,0,0,0
38,8481690,Tyler Angle,C,,24,0,0,0,0
38,8475766,Austin Watson,L,,32,0,0,0,0
38,8481016,Ruslan Iskhakov,C,,24,0,0,0,0
38,8478078,Rourke Chartier,C,,28,0,0,0,0
38,8480776,Sheldon Rempal,R,,29,0,0,0,0
38,8478956,Samuel Laberge,L,NJD,27,0,0,0,0
38,8483045,Cameron Butler,R,CBJ,31,0,0,0,0
38,8484314,Jiri Smejkal,L,,28,0,0,0,0
39,8478402,Connor McDavid,C,EDM,27,75,35,113,148
39,8477492,Nathan MacKinnon,C,COL,29,82,54,86,140
39,8476453,Nikita Kucherov,R,TBL,31,82,47,93,140
39,8478420,Mikko Rantanen,R,COL,28,81,52,75,127
39,8481559,Jack Hughes,C,NJD,23,72,46,77,123
39,8479318,Auston Matthews,C,TOR,27,78,64,55,119
39,8478550,Artemi Panarin,L,NYR,33,78,39,78,117
39,8478483,Mitch Marner,R,TOR,27,74,35,81,116
39,8480027,Jason Robertson,L,DAL,25,79,35,73,108
39,8477939,William Nylander,R,TOR,28,81,52,55,107
39,8477404,Jake Guentzel,C,TBL,30,82,43,64,107
39,8478864,Kirill Kaprizov,L,MIN,27,69,41,66,107
39,8476468,J.T. Miller,C,VAN,31,74,38,69,107
39,8480012,Elias Pettersson,C,VAN,26,75,43,62,105
39,8479314,Matthew Tkachuk,L,FLA,27,79,26,78,104
39,8478445,Mathew Barzal,C,NYI,27,80,20,81,101
39,8477942,Kevin Fiala,L,LAK,28,82,37,63,100
39,8477946,Dylan Larkin,C,DET,28,80,41,57,98
39,8477934,Leon Draisaitl,C,EDM,29,78,38,60,98
39,8477409,Carter Verhaeghe,C,FLA,29,79,52,45,97
39,8477956,David Pastrnak,R,BOS,28,80,44,52,96
39,8477493,Aleksander Barkov,C,FLA,29,80,29,67,96
39,8480801,Brady Tkachuk,L,OTT,25,81,38,56,94
39,8471675,Sidney Crosby,C,PIT,37,78,43,50,93
39,8474564,Steven Stamkos,C,NSH,34,74,35,57,92
39,8478427,Sebastian Aho,C,CAR,27,74,44,46,90
39,8475166,John Tavares,C,TOR,34,78,36,54,90
39,8480023,Robert Thomas,C,STL,25,77,31,58,89
39,8479420,Tage Thompson,C,BUF,27,75,46,42,88
39,8477501,Valeri Nichushkin,R,COL,29,81,43,45,88
39,8477960,Adrian Kempe,R,LAK,28,80,38,50,88
39,8480069,Cale Makar,D,COL,26,70,24,64,88
39,8478398,Kyle Connor,L,WPG,28,75,46,41,87
39,8478414,Timo Meier,R,NJD,28,71,34,53,87
39,8479407,Jesper Bratt,L,NJD,26,78,32,55,87
39,8482116,Tim Stützle,C,OTT,22,77,31,56,87
39,8480036,Miro Heiskanen,D,DAL,25,73,23,64,87
39,8478460,Zach Werenski,D,CBJ,27,78,18,69,87
39,8479343,Clayton Keller,R,UTA,26,77,46,40,86
39,8478444,Brock Boeser,R,VAN,27,77,37,48,85
39,8478449,Roope Hintz,C,DAL,28,80,47,37,84
39,8481557,Matt Boldy,L,MIN,23,69,38,45,83
39,8480800,Quinn Hughes,D,VAN,25,71,9,74,83
39,8476346,Johnny Gaudreau,L,CBJ,31,73,17,65,82
39,8476887,Filip Forsberg,L,NSH,30,75,33,48,81
39,8474600,Roman Josi,D,NSH,34,77,21,60,81
39,8479323,Adam Fox,D,NYR,26,74,15,66,81
39,8475172,Nazem Kadri,C,CGY,34,78,36,44,80
39,8478010,Brayden Point,C,TBL,28,82,42,37,79
39,8477402,Pavel Buchnevich,L,STL,29,77,36,41,77
39,8479337,Alex DeBrincat,R,DET,27,79,32,45,77
39,8475184,Chris Kreider,L,NYR,33,74,47,29,76
39,8478403,Jack Eichel,C,VGK,28,78,41,35,76
39,8484144,Connor Bedard,C,CHI,19,70,29,47,76
39,8474590,John Carlson,D,WSH,34,76,21,55,76
39,8476539,Jonathan Marchessault,R,NSH,34,72,37,38,75
39,8482699,Dylan Guenther,R,UTA,21,76,32,43,75
39,8477933,Sam Reinhart,C,FLA,29,76,41,33,74
39,8480002,Nico Hischier,C,NJD,25,75,30,44,74
39,8477951,Nick Schmaltz,C,UTA,28,76,29,45,74
39,8476459,Mika Zibanejad,C,NYR,31,75,33,40,73
39,8475913,Mark Stone,R,VGK,32,75,24,49,73
39,8473419,Brad Marchand,L,BOS,36,81,24,49,73
39,8475168,Matt Duchene,C,DAL,33,82,20,53,73
39,8475692,Mats Zuccarello,R,MIN,37,71,18,55,73
39,8475754,Brock Nelson,C,NYI,33,79,38,34,72
39,8471214,Alex Ovechkin,L,WSH,39,71,35,37,72
39,8475765,Vladimir Tarasenko,R,DET,33,80,25,46,71
39,8476456,Jonathan Huberdeau,C,CGY,31,77,18,53,71
39,8475786,Zach Hyman,L,EDM,32,80,37,33,70
39,8478047,Michael Bunting,L,PIT,29,77,32,38,70
39,8477500,Bo Horvat,C,NYI,29,79,31,39,70
39,8476389,Vincent Trocheck,C,NYR,31,73,28,42,70
39,8482740,Wyatt Johnston,C,DAL,21,82,30,39,69
39,8475167,Victor Hedman,D,TBL,34,81,21,48,69
39,8478975,Mason Marchment,L,DAL,29,82,32,36,68
39,8478493,Joel Eriksson Ek,C,MIN,27,74,24,44,68
39,8482665,Matty Beniers,C,SEA,22,78,33,34,67
39,8475158,Ryan O'Reilly,C,NSH,33,70,31,36,67
39,8474141,Patrick Kane,R,DET,36,79,30,37,67
39,8473512,Claude Giroux,R,OTT,36,79,18,49,67
39,8480830,Andrei Svechnikov,R,CAR,24,67,29,37,66
39,8479542,Brandon Hagel,L,TBL,26,81,27,39,66
39,8479385,Jordan Kyrou,C,STL,26,69,27,39,66
39,8477407,Anthony Duclair,L,NYI,29,77,33,32,65
39,8477494,Jonathan Drouin,L,COL,29,80,18,47,65
39,8471724,Kris Letang,D,PIT,37,79,12,53,65
39,8476853,Morgan Rielly,D,TOR,30,70,10,55,65
39,8475810,Bryan Rust,R,PIT,32,70,31,33,64
39,8482745,Mason McTavish,C,ANA,21,77,31,33,64
39,8478439,Travis Konecny,R,PHI,27,77,26,38,64
39,8477940,Nikolaj Ehlers,L,WPG,28,69,22,42,64
39,8475745,Charlie Coyle,C,BOS,32,78,20,44,64
39,8482078,Lucas Raymond,L,DET,22,79,20,44,64
39,8476454,Ryan Nugent-Hopkins,C,EDM,31,81,19,45,64
39,8471685,Anze Kopitar,C,LAK,37,80,16,48,64
39,8474578,Erik Karlsson,D,PIT,34,79,13,50,63
39,8478466,Daniel Sprong,R,VAN,27,75,25,37,62
39,8477497,Sean Monahan,C,CBJ,30,68,25,37,62
39,8478401,Pavel Zacha,C,BOS,27,76,23,39,62
39,8480015,Owen Tippett,R,PHI,25,78,19,43,62
39,8477504,Josh Morrissey,D,WPG,29,68,11,51,62
39,8479675,Trevor Moore,L,LAK,29,81,31,30,61
39,8477496,Elias Lindholm,C,BOS,30,77,29,31,60
39,8482109,Alexis Lafrenière,L,NYR,23,75,26,34,60
39,8474102,David Perron,L,OTT,36,77,24,36,60
39,8477949,Alex Tuch,R,BUF,28,77,23,37,60
39,8480865,Noah Dobson,D,NYI,24,81,15,45,60
39,8480839,Rasmus Dahlin,D,BUF,24,74,13,47,60
39,8477476,Artturi Lehkonen,L,COL,29,82,28,31,59
39,8482110,Dawson Mercer,C,NJD,23,64,26,33,59
39,8480018,Nick Suzuki,C,MTL,25,72,23,36,59
39,8482684,Luke Hughes,D,NJD,21,70,10,49,59
39,8479410,Mikhail Sergachev,D,UTA,26,70,6,53,59
39,8479525,Ross Colton,C,COL,28,81,30,28,58
39,8476460,Mark Scheifele,C,WPG,31,68,22,36,58
39,8480208,Drake Batherson,R,OTT,26,77,19,39,58
39,8475798,Mikael Granlund,C,SJS,32,69,17,41,58
39,8480014,Gabriel Vilardi,C,WPG,25,75,33,24,57
39,8477935,Sam Bennett,C,FLA,28,78,27,30,57
39,8482149,Cole Perfetti,C,WPG,22,69,25,31,56
39,8470613,Brent Burns,D,CAR,39,79,19,37,56
39,8476479,Phillip Danault,C,LAK,31,80,15,41,56
39,8478397,Rasmus Andersson,D,CGY,28,77,13,43,56
39,8475753,Justin Faulk,D,STL,32,71,12,44,56
39,8479325,Charlie McAvoy,D,BOS,27,76,11,45,56
39,8481540,Cole Caufield,R,MTL,23,73,31,24,55
39,8478856,Conor Garland,R,VAN,28,75,25,30,55
39,8483431,Logan Cooley,C,UTA,20,76,25,30,55
39,8482124,Quinton Byfield,R,LAK,22,80,23,32,55
39,8481533,Trevor Zegras,C,ANA,23,71,18,37,55
39,8480039,Martin Necas,C,CAR,25,73,25,29,54
39,8482092,Ridly Greig,C,OTT,22,76,23,31,54
39,8474150,Mikael Backlund,C,CGY,35,81,21,33,54
39,8478873,Troy Terry,R,ANA,27,74,20,34,54
39,8476875,Mike Matheson,D,MTL,30,76,13,41,54
39,8479425,Filip Hronek,D,VAN,27,73,12,42,54
39,8482159,Tyson Foerster,R,PHI,22,74,30,23,53
39,8475726,Tyler Toffoli,C,SJS,32,70,27,26,53
39,8473986,Alex Killorn,L,ANA,35,77,22,31,53
39,8482093,Seth Jarvis,C,CAR,22,68,21,32,53
39,8481618,Alex Newhook,C,MTL,23,76,21,32,53
39,8481528,Dylan Cozens,C,BUF,23,76,19,34,53
39,8480803,Evan Bouchard,D,EDM,25,76,15,38,53
39,8477503,Max Domi,C,TOR,29,80,14,39,53
39,8481596,Shane Pinto,C,OTT,24,76,22,30,52
39,8477932,Aaron Ekblad,D,FLA,28,74,14,38,52
39,8476432,Boone Jenner,C,CBJ,31,68,28,23,51
39,8471215,Evgeni Malkin,C,PIT,38,66,24,27,51
39,8476881,Tomas Hertl,C,VGK,31,77,20,31,51
39,8481068,Yegor Sharangovich,C,CGY,26,77,26,24,50
39,8479400,Pierre-Luc Dubois,L,WSH,26,63,20,30,50
39,8478440,Dylan Strome,C,WSH,27,75,17,33,50
39,8477447,Shea Theodore,D,VGK,29,65,17,33,50
39,8471698,T.J. Oshie,R,WSH,38,68,17,33,50
39,8481542,Moritz Seider,D,DET,23,75,13,37,50
39,8481560,Arthur Kaliyev,R,LAK,23,75,29,20,49
39,8476483,Rickard Rakell,R,PIT,31,72,25,24,49
39,8475314,Anders Lee,L,NYI,34,77,20,29,49
39,8473994,Jamie Benn,L,DAL,35,80,14,35,49
39,8479999,Casey Mittelstadt,C,COL,26,81,13,36,49
39,8478407,Vince Dunn,D,SEA,28,71,12,37,49
39,8482712,Oskar Olausson,R,COL,22,77,12,37,49
39,8474586,Jordan Eberle,R,SEA,34,73,25,23,48
39,8478042,Viktor Arvidsson,L,EDM,31,73,21,27,48
39,8478519,Anthony Cirelli,C,TBL,27,81,21,27,48
39,8476399,Blake Coleman,C,CGY,33,72,20,28,48
39,8475794,Tyler Seguin,C,DAL,32,80,19,29,48
39,8477416,Oliver Bjorkstrand,R,SEA,29,71,17,31,48
39,8475191,Reilly Smith,R,NYR,33,71,13,35,48
39,8474563,Drew Doughty,D,LAK,35,73,12,36,48
39,8481703,Valtteri Puustinen,R,PIT,25,65,10,38,48
39,8483490,Pavel Mintyukov,D,ANA,21,71,7,41,48
39,8480113,Alex Iafallo,L,WPG,31,73,24,23,47
39,8479345,Jakob Chychrun,D,WSH,26,62,20,27,47
39,8477429,Andrew Copp,C,DET,30,79,20,27,47
39,8475170,Brayden Schenn,C,STL,33,69,20,27,47
39,8477479,Tyler Bertuzzi,L,CHI,29,61,19,28,47
39,8477998,Warren Foegele,L,LAK,28,80,18,29,47
39,8480028,Morgan Frost,C,PHI,25,72,16,31,47
39,8477021,Alex Kerfoot,C,UTA,30,75,15,32,47
39,8476792,Torey Krug,D,STL,33,75,12,35,47
39,8477346,MacKenzie Weegar,D,CGY,30,69,11,36,47
39,8475768,Jaden Schwartz,C,SEA,32,74,20,26,46
39,8483808,Andrei Kuzmenko,L,CGY,28,79,18,28,46
39,8476905,Chandler Stephenson,C,SEA,30,72,17,29,46
39,8480188,Fabian Zetterlund,L,SJS,25,66,17,29,46
39,8477986,Brandon Montour,D,SEA,30,75,15,31,46
39,8480078,Filip Chytil,C,NYR,25,69,27,18,45
39,8475287,Erik Haula,L,NJD,33,75,24,21,45
39,8476438,Brandon Saad,L,STL,32,72,21,24,45
39,8475784,Jeff Skinner,C,EDM,32,78,19,26,45
39,8474565,Alex Pietrangelo,D,VGK,34,66,15,30,45
39,8476923,Damon Severson,D,CBJ,30,79,12,33,45
39,8476906,Shayne Gostisbehere,D,CAR,31,76,9,36,45
39,8482705,Cole Sillinger,C,CBJ,21,70,30,14,44
39,8478498,Jake DeBrusk,L,VAN,28,73,27,17,44
39,8478366,Frank Vatrano,R,ANA,30,75,25,19,44
39,8484145,Zach Benson,L,BUF,19,71,22,22,44
39,8478462,Nicolas Roy,C,VGK,27,76,18,26,44
39,8475218,Mattias Ekholm,D,EDM,34,69,18,26,44
39,8484166,Adam Fantilli,C,CBJ,20,68,16,28,44
39,8483515,Juraj Slafkovsky,L,MTL,20,77,13,31,44
39,8480064,Josh Norris,C,OTT,25,73,29,14,43
39,8475169,Evander Kane,L,EDM,33,72,29,14,43
39,8475722,Jason Zucker,L,BUF,32,70,19,24,43
39,8477511,Anthony Mantha,R,CGY,30,77,19,24,43
39,8480849,Barrett Hayton,C,UTA,24,76,18,25,43
39,8479339,Patrik Laine,L,CBJ,26,70,17,26,43
39,8480797,Joel Farabee,L,PHI,24,74,17,26,43
39,8482133,Thomas Bordeleau,C,SJS,22,70,11,32,43
39,8476292,Ondrej Palat,L,NJD,33,69,21,21,42
39,8477456,J.T. Compher,L,DET,29,77,18,24,42
39,8481624,Ilya Mikheyev,R,CHI,30,63,16,26,42
39,8478458,John (Jack) Roslovic,C,CAR,27,69,11,31,42
39,8476979,Erik Gustafsson,D,DET,32,74,7,35,42
39,8477495,Seth Jones,D,CHI,30,73,6,36,42
39,8475151,Kyle Palmieri,C,NYI,33,78,26,15,41
39,8477426,Nicholas Paul,L,TBL,29,82,25,16,41
39,8478474,Lawson Crouse,L,UTA,27,74,24,17,41
39,8475799,Nino Niederreiter,R,WPG,32,67,23,18,41
39,8482702,Logan Stankoven,C,DAL,21,80,18,23,41
39,8474679,Gustav Nyquist,C,NSH,35,70,16,25,41
39,8478542,Evan Rodrigues,C,FLA,31,78,15,26,41
39,8478055,Gustav Forsling,D,FLA,28,68,13,28,41
39,8476392,Adam Lowry,C,WPG,31,68,12,29,41
39,8483505,Matthew Poitras,C,BOS,20,76,11,30,41
39,8476462,Dougie Hamilton,D,NJD,31,69,10,31,41
39,8480893,Kirill Marchenko,R,CBJ,24,64,24,16,40
39,8476880,Tom Wilson,R,WSH,30,70,22,18,40
39,8478057,Dakota Joshua,C,VAN,28,66,21,19,40
39,8478233,Andrew Mangiapane,L,WSH,28,71,20,20,40
39,8474716,Jared Spurgeon,D,MIN,35,79,17,23,40
39,8480798,Philipp Kurashev,C,CHI,25,67,16,24,40
39,8481711,Matias Maccelli,L,UTA,24,75,15,25,40
39,8475763,Kevin Hayes,R,PIT,32,73,15,25,40
39,8478115,Pierre Engvall,L,NYI,28,72,13,27,40
39,8481581,Thomas Harley,D,DAL,23,72,11,29,40
39,8476854,Hampus Lindholm,D,BOS,30,75,10,30,40
39,8484153,Leo Carlsson,C,ANA,20,74,20,19,39
39,8476448,William Karlsson,C,VGK,31,69,19,20,39
39,8482113,Anton Lundell,C,FLA,23,75,19,20,39
39,8477451,Ryan Hartman,R,MIN,30,70,19,20,39
39,8479987,Morgan Geekie,C,BOS,26,75,18,21,39
39,8474715,Cameron Atkinson,R,TBL,35,81,18,21,39
39,8478472,Mathieu Joseph,R,STL,27,70,16,23,39
39,8477964,Ivan Barbashev,C,VGK,29,76,14,25,39
39,8477444,Andre Burakovsky,L,SEA,29,73,13,26,39
39,8476869,Brady Skjei,D,NSH,30,79,13,26,39
39,8481577,Philip Tomasino,C,NSH,23,72,11,28,39
39,8478469,Thomas Chabot,D,OTT,27,75,11,28,39
39,8476882,Teuvo Teravainen,C,CHI,30,63,9,30,39
39,8480145,Neal Pionk,D,WPG,29,70,7,32,39
39,8478038,Devon Toews,D,COL,30,63,4,35,39
39,8480829,Jesperi Kotkaniemi,C,CAR,24,63,21,17,38
39,8474641,Adam Henrique,C,EDM,34,76,20,18,38
39,8481535,Nils Hoglander,L,VAN,24,73,20,18,38
39,8476461,Sean Couturier,C,PHI,32,74,17,21,38
39,8477498,Darnell Nurse,D,EDM,29,71,16,22,38
39,8477953,Kasperi Kapanen,R,STL,28,72,11,27,38
39,8482624,Daniil Miromanov,D,CGY,27,70,11,27,38
39,8481606,Jordan Spence,D,LAK,23,67,7,31,38
39,8480434,Sean Durzi,D,UTA,26,72,7,31,38
39,8480009,Eeli Tolvanen,R,SEA,25,72,19,18,37
39,8474149,Evgenii Dadonov,R,DAL,35,81,18,19,37
39,8482097,Jack Quinn,R,BUF,23,65,16,21,37
39,8482660,Kent Johnson,C,CBJ,22,66,14,23,37
39,8482720,Matthew Knies,L,TOR,22,75,13,24,37
39,8478396,Noah Hanifin,D,VGK,27,57,11,26,37
39,8475764,Cam Fowler,D,ANA,33,72,4,33,37
39,8477425,Miles Wood,L,COL,29,77,20,16,36
39,8482175,JJ Peterka,R,BUF,22,71,18,18,36
39,8476458,Ryan Strome,C,ANA,31,71,16,20,36
39,8477955,Jared McCann,L,SEA,28,70,15,21,36
39,8480817,K'Andre Miller,D,NYR,24,70,9,27,36
39,8477488,Brett Pesce,D,NJD,30,65,8,28,36
39,8481186,Logan O'Connor,R,COL,28,80,20,15,35
39,8474189,Lars Eller,C,PIT,35,67,20,15,35
39,8475793,Ryan Johansen,C,PHI,32,74,17,18,35
39,8480185,Eetu Luostarinen,C,FLA,26,77,15,20,35
39,8477505,Alexander Wennberg,C,SJS,30,65,12,23,35
39,8476419,Jean-Gabriel Pageau,C,NYI,32,76,11,24,35
39,8482122,Brock Faber,D,MIN,22,78,5,30,35
39,8481604,Pavel Dorofeyev,L,VGK,24,65,18,16,34
39,8479365,Trent Frederic,C,BOS,26,76,16,18,34
39,8482667,William Eklund,L,SJS,22,66,13,21,34
39,8477506,Ryan Pulock,D,NYI,30,76,6,28,34
39,8480813,Joe Veleno,C,DET,24,79,19,14,33
39,8475760,Nick Bjugstad,C,UTA,32,67,13,20,33
39,8480802,Ryan McLeod,C,BUF,25,65,12,21,33
39,8476826,Yanni Gourde,C,SEA,33,69,10,23,33
39,8480336,Sean Walker,D,CAR,30,74,7,26,33
39,8479591,Michael Eyssimont,C,TBL,28,82,15,17,32
39,8481554,Kaapo Kakko,R,NYR,23,69,11,21,32
39,8478046,Danton Heinen,L,VAN,29,74,11,21,32
39,8482105,Jake Sanderson,D,OTT,22,75,10,22,32
39,8478413,Jordan Greenway,L,BUF,27,62,9,23,32
39,8476892,Colton Parayko,D,STL,31,76,8,24,32
39,8482671,Owen Power,D,BUF,22,72,7,25,32
39,8476958,Jaccob Slavin,D,CAR,30,79,6,26,32
39,8480459,Pius Suter,C,VAN,28,68,16,15,31
39,8481093,Rafael Harvey-Pinard,L,MTL,25,61,14,17,31
39,8481523,Kirby Dach,C,MTL,23,68,12,19,31
39,8480835,Jack Drury,C,CAR,24,67,10,21,31
39,8480871,Adam Boqvist,D,FLA,24,69,9,22,31
39,8475193,Tomas Tatar,L,NJD,34,68,9,22,31
39,8478020,Michael Amadio,R,OTT,28,74,17,13,30
39,8476474,Stefan Noesen,R,NJD,31,66,16,14,30
39,8479992,Michael Rasmussen,C,DET,25,77,16,14,30
39,8478508,Yakov Trenin,C,MIN,27,64,15,15,30
39,8475714,Calle Jarnkrok,C,TOR,33,69,14,16,30
39,8476885,Jacob Trouba,D,NYR,30,68,11,19,30
39,8477947,Sonny Milano,L,WSH,28,68,11,19,30
39,8480220,Noah Cates,L,PHI,25,71,9,21,30
39,8477948,Travis Sanheim,D,PHI,28,75,8,22,30
39,8481524,Bowen Byram,D,BUF,23,72,8,22,30
39,8475181,Nick Leddy,D,STL,33,75,7,23,30
39,8478438,Tommy Novak,C,NSH,27,73,5,25,30
39,8479393,Noah Gregor,L,OTT,26,72,17,12,29
39,8482475,Yegor Chinakhov,R,CBJ,23,62,14,15,29
39,8480789,Oliver Wahlstrom,R,NYI,24,72,14,15,29
39,8481032,Paul Cotter,C,NJD,25,66,14,15,29
39,8479353,Brett Howden,C,VGK,26,67,13,16,29
39,8470621,Corey Perry,R,EDM,39,72,13,16,29
39,8473422,Nick Foligno,L,CHI,37,60,12,17,29
39,8482749,Joshua Roy,R,MTL,21,66,12,17,29
39,8476925,Colton Sissons,C,NSH,31,67,12,17,29
39,8474574,Tyler Myers,D,VAN,34,70,4,25,29
39,8482079,Marco Rossi,C,MIN,23,65,15,13,28
39,8476278,Colin Blackwell,C,DAL,31,76,13,15,28
39,8473563,Nicklas Backstrom,C,WSH,37,57,10,18,28
39,8476872,Scott Laughton,C,PHI,30,73,9,19,28
39,8476463,Jonas Brodin,D,MIN,31,76,6,22,28
39,8483468,Jiri Kulich,C,BUF,20,61,6,22,28
39,8480043,Timothy Liljegren,D,TOR,25,66,5,23,28
39,8476525,Colin Miller,D,WPG,32,60,4,24,28
39,8481656,Aliaksei Protas,C,WSH,23,60,17,10,27
39,8479941,Justin Danforth,R,CBJ,31,59,17,10,27
39,8476469,Joel Armia,R,MTL,31,65,15,12,27
39,8478463,Anthony Beauvillier,L,PIT,27,65,14,13,27
39,8478109,Victor Olofsson,L,VGK,29,69,13,14,27
39,8482679,Matt Coronato,R,CGY,22,67,13,14,27
39,8478891,Mason Appleton,C,WPG,28,63,11,16,27
39,8483524,Shane Wright,C,SEA,20,66,10,17,27
39,8479351,Sam Steel,C,DAL,26,78,10,17,27
39,8473533,Jordan Staal,C,CAR,36,69,9,18,27
39,8479390,Taylor Raddysh,R,WSH,26,62,9,18,27
39,8475343,Nic Dowd,C,WSH,34,68,9,18,27
39,8482067,Connor Mackey,D,NYR,28,69,8,19,27
39,8476480,Vladislav Namestnikov,C,WPG,32,63,7,20,27
39,8477839,Conor Sheary,L,TBL,32,77,6,21,27
39,8476927,Teddy Blueger,C,VAN,30,69,6,21,27
39,8481014,Alexander Romanov,D,NYI,24,74,3,24,27
39,8478882,Vladislav Gavrikov,D,LAK,29,62,3,24,27
39,8482125,Alexander Holtz,R,VGK,22,69,14,12,26
39,8478043,Sam Lafferty,C,BUF,29,64,14,12,26
39,8481481,Blake Lizotte,C,PIT,27,62,13,13,26
39,8480003,Jesper Boqvist,C,FLA,26,63,12,14,26
39,8477450,Jason Dickinson,C,CHI,29,61,12,14,26
39,8480806,Isac Lundestrom,C,ANA,25,64,9,17,26
39,8476329,Travis Boyd,C,MIN,31,58,9,17,26
39,8477406,Mattias Janmark,C,EDM,32,60,8,18,26
39,8475179,Dmitry Kulikov,D,FLA,34,59,7,19,26
39,8476457,Adam Larsson,D,SEA,32,64,4,22,26
39,8481441,Joe Snively,C,DET,28,70,4,22,26
39,8478399,Jonas Siegenthaler,D,NJD,27,62,4,22,26
39,8478911,Matt Roy,D,WSH,29,70,2,24,26
39,8477987,Ryan Donato,C,CHI,28,62,14,11,25
39,8476981,Josh Anderson,R,MTL,30,66,13,12,25
39,8481704,Juuso Parssinen,C,NSH,23,61,13,12,25
39,8477353,Tyler Motte,C,DET,29,74,12,13,25
39,8481580,Connor McMichael,C,WSH,23,61,12,13,25
39,8477478,William Carrier,L,CAR,30,53,11,14,25
39,8479639,Dylan Coghlan,D,WPG,26,64,9,16,25
39,8479998,Mikey Anderson,D,LAK,25,64,8,17,25
39,8479982,Conor Timmins,D,TOR,26,62,6,19,25
39,8476331,Dylan DeMelo,D,WPG,31,69,5,20,25
39,8482245,Artem Zub,D,OTT,29,73,4,21,25
39,8480873,Rasmus Sandin,D,WSH,24,63,2,23,25
39,8475225,Craig Smith,C,CHI,35,54,20,4,24
39,8480068,Ryan Poehling,C,PHI,25,65,11,13,24
39,8480289,Morgan Barron,C,WPG,26,58,11,13,24
39,8482074,Connor Zary,C,CGY,23,59,10,14,24
39,8480855,Jack McBain,C,UTA,24,73,10,14,24
39,8475848,Brendan Gallagher,R,MTL,32,71,9,15,24
39,8477989,Christian Dvorak,C,MTL,28,62,8,16,24
39,8484203,Bradly Nadeau,L,CAR,19,59,8,16,24
39,8481546,Cam York,D,PHI,23,68,5,19,24
39,8475790,Erik Gudbranson,D,CBJ,32,78,4,20,24
39,8477220,Nate Schmidt,D,FLA,33,67,3,21,24
39,8477969,Marcus Pettersson,D,PIT,28,80,1,23,24
39,8475149,Marcus Johansson,L,MIN,34,64,11,12,23
39,8475220,Marcus Foligno,L,MIN,33,55,10,13,23
39,8478569,Noel Acciari,C,PIT,33,49,10,13,23
39,8475791,Taylor Hall,L,CHI,33,58,9,14,23
39,8476918,Jimmy Vesey,L,NYR,31,67,8,15,23
39,8476467,Jamie Oleksiak,D,SEA,32,71,6,17,23
39,8475690,Chris Tanev,D,TOR,35,60,6,17,23
39,8475233,David Savard,D,MTL,34,63,4,19,23
39,8482192,Isaak Phillips,D,CHI,23,51,3,20,23
39,8477435,Ryan Graves,D,PIT,29,74,3,20,23
39,8482655,Janis Moser,D,TBL,24,77,2,21,23
39,8482111,Justin Barron,D,MTL,23,72,12,10,22
39,8475231,Casey Cizikas,C,NYI,33,72,12,10,22
39,8479066,Ryan Lomberg,L,CGY,30,68,12,10,22
39,8481601,Simon Holmstrom,R,NYI,23,66,11,11,22
39,8483499,Liam Ohgren,L,MIN,20,56,11,11,22
39,8477952,Robby Fabbri,C,ANA,28,64,9,13,22
39,8481013,Jonatan Berggren,R,DET,24,58,9,13,22
39,8482146,Luke Evangelista,R,NSH,22,67,8,14,22
39,8479315,Joey Anderson,R,CHI,26,52,8,14,22
39,8477903,Garnet Hathaway,R,PHI,33,64,8,14,22
39,8475855,Jesper Fast,R,CAR,33,60,7,15,22
39,8483457,Lane Hutson,D,MTL,20,66,7,15,22
39,8478133,Jake Evans,C,MTL,28,70,6,16,22
39,8478434,Keegan Kolesar,R,VGK,27,68,6,16,22
39,8476917,Adam Pelech,D,NYI,30,75,5,17,22
39,8480035,Henri Jokiharju,D,BUF,25,67,5,17,22
39,8482073,Braden Schneider,D,NYR,23,66,5,17,22
39,8481582,Nicholas Robertson,L,TOR,23,64,13,8,21
39,8482157,Will Cuylle,L,NYR,22,66,12,9,21
39,8479414,Nathan Bastian,R,NJD,27,60,12,9,21
39,8476897,Oskar Sundqvist,C,STL,30,64,10,11,21
39,8480748,Kiefer Sherwood,L,VAN,29,59,9,12,21
39,8482803,Olen Zellweger,D,ANA,21,65,9,12,21
39,8482155,Alex Laferriere,R,LAK,23,67,9,12,21
39,8478970,Jalen Chatfield,D,CAR,28,73,7,14,21
39,8481537,Nikita Okhotiuk,D,CGY,24,57,7,14,21
39,8475200,Dmitry Orlov,D,CAR,33,64,6,15,21
39,8476422,Mike Reilly,D,NYI,31,72,5,16,21
39,8480246,Nick Perbix,D,TBL,26,78,5,16,21
39,8476891,Matthew Grzelcyk,D,PIT,30,69,3,18,21
39,8479398,Samuel Girard,D,COL,26,65,3,18,21
39,8474151,Ryan McDonagh,D,TBL,35,75,3,18,21
39,8476931,Jake McCabe,D,TOR,31,67,2,19,21
39,8480281,Alexey Toropchenko,R,STL,25,56,15,5,20
39,8482762,Simon Edvinsson,D,DET,21,57,14,6,20
39,8476374,Sean Kuraly,C,CBJ,31,56,12,8,20
39,8480980,Connor Dewar,C,TOR,25,71,11,9,20
39,8482055,Drew O'Connor,L,PIT,26,59,10,10,20
39,8478432,Christian Fischer,R,DET,27,73,10,10,20
39,8479293,Brandon Tanev,L,SEA,33,64,8,12,20
39,8477015,Connor Brown,R,EDM,30,63,6,14,20
39,8476312,Josh Manson,D,COL,33,65,4,16,20
39,8478840,Will Borgen,D,SEA,28,65,3,17,20
39,8481059,Scott Perunovich,D,STL,26,53,3,17,20
39,8478136,Jake Middleton,D,MIN,28,73,2,18,20
39,8480891,Michael Kesselring,D,UTA,24,56,2,18,20
39,8478500,Ivan Provorov,D,CBJ,27,77,0,20,20
39,8479619,Michael Carcone,L,UTA,28,58,11,8,19
39,8480878,Nils Lundkvist,D,DAL,24,75,10,9,19
39,8475842,Sam Carrick,C,NYR,32,64,7,12,19
39,8479543,Michael Pezzetta,L,MTL,26,56,7,12,19
39,8477508,Curtis Lazar,C,NJD,29,58,6,13,19
39,8479983,Mario Ferraro,D,SJS,26,71,5,14,19
39,8476822,Luke Glendening,C,TBL,35,80,5,14,19
39,8478507,John Marino,D,UTA,27,63,4,15,19
39,8476967,Brett Kulak,D,EDM,30,65,4,15,19
39,8476429,Scott Mayfield,D,NYI,32,74,3,16,19
39,8480049,Dylan Samberg,D,WPG,25,73,3,16,19
39,8481178,Egor Zamula,D,PHI,24,52,2,17,19
39,8480001,Urho Vaakanainen,D,ANA,25,62,2,17,19
39,8479370,Tyson Jost,C,CAR,26,46,10,8,18
39,8482089,Jake Neighbours,L,STL,22,70,9,9,18
39,8479996,Cody Glass,C,NSH,25,58,9,9,18
39,8477380,Jonny Brodzinski,C,NYR,31,47,9,9,18
39,8478013,Jake Walman,D,SJS,28,68,8,10,18
39,8480205,Emil Bemstrom,C,PIT,25,61,8,10,18
39,8477919,Frederick Gaudreau,C,MIN,31,59,8,10,18
39,8482101,Danil Gushchin,L,SJS,22,60,7,11,18
39,8482809,Jackson Blake,R,CAR,21,52,7,11,18
39,8480762,Eric Robinson,L,CAR,29,55,7,11,18
39,8474053,Logan Couture,C,SJS,35,60,6,12,18
39,8473453,Trevor Lewis,C,LAK,37,68,6,12,18
39,8477931,Tomas Nosek,L,FLA,32,62,5,13,18
39,8480144,David Kampf,C,TOR,29,68,5,13,18
39,8479324,Ryan Lindgren,D,NYR,26,61,4,14,18
39,8480073,Erik Brannstrom,D,COL,25,71,3,15,18
39,8481567,Henry Thrun,D,SJS,23,56,3,15,18
39,8481599,Victor Soderstrom,D,UTA,23,46,3,15,18
39,8474673,TJ Brodie,D,CHI,34,62,2,16,18
39,8476874,Olli Maatta,D,DET,30,63,1,17,18
39,8477034,Jaycob Megna,D,FLA,32,53,1,17,18
39,8475462,Radko Gudas,D,ANA,34,59,1,17,18
39,8480025,MacKenzie Entwistle,R,FLA,25,58,10,7,17
39,8479661,Tanner Jeannot,L,LAK,27,76,9,8,17
39,8481477,Nico Sturm,C,SJS,29,62,9,8,17
39,8474034,Patrick Maroon,L,CHI,36,43,9,8,17
39,8479520,Brandon Duhaime,R,WSH,27,56,9,8,17
39,8480021,Jack Studnicka,C,LAK,25,57,8,9,17
39,8477369,Carson Soucy,D,VAN,30,70,7,10,17
39,8477446,Michael McCarron,R,NSH,29,50,7,10,17
39,8479316,Luke Kunin,C,SJS,27,57,7,10,17
39,8481553,Bobby Brink,R,PHI,23,63,7,10,17
39,8482117,Lukas Reichel,L,CHI,22,57,6,11,17
39,8478451,Ethan Bear,D,WSH,27,53,6,11,17
39,8475762,Derek Forbort,D,VAN,32,41,5,12,17
39,8477979,Nicolas Aube-Kubel,R,BUF,28,48,5,12,17
39,8481617,Vasily Podkolzin,R,VAN,23,49,5,12,17
39,8476856,Mathew Dumba,D,DAL,30,71,4,13,17
39,8479402,Jake Bean,D,CGY,26,64,4,13,17
39,8477845,Trevor van Riemsdyk,D,WSH,33,58,3,14,17
39,8474013,Ian Cole,D,UTA,35,54,3,14,17
39,8478851,Alexandre Carrier,D,NSH,28,60,1,16,17
39,8473507,Jeff Petry,D,DET,37,75,0,17,17
39,8475171,Oliver Ekman-Larsson,D,TOR,33,65,0,17,17
39,8476624,Barclay Goodrow,C,SJS,31,46,10,6,16
39,8476878,Zemgus Girgensons,C,TBL,30,82,9,7,16
39,8476994,Vinnie Hinostroza,C,NSH,30,56,7,9,16
39,8480074,Alexandre Texier,C,STL,25,53,7,9,16
39,8476889,Radek Faksa,C,STL,30,62,7,9,16
39,8481521,Ronnie Attard,D,PHI,25,59,7,9,16
39,8481751,Lukas Rousek,R,BUF,25,38,5,11,16
39,8470600,Ryan Suter,D,STL,39,60,4,12,16
39,8479026,Philippe Myers,D,TOR,27,48,4,12,16
39,8476902,Esa Lindell,D,DAL,30,72,4,12,16
39,8478443,Brandon Carlo,D,BOS,28,60,4,12,16
39,8476879,Cody Ceci,D,EDM,31,70,2,14,16
39,8480222,Sebastian Aho,D,PIT,28,75,2,14,16
39,8480807,Mattias Samuelsson,D,BUF,24,52,2,14,16
39,8479976,Juuso Valimaki,D,UTA,26,64,1,15,16
39,8471709,Marc-Edouard Vlasic,D,SJS,37,62,1,15,16
39,8480252,Cole Guttman,C,CHI,25,36,10,5,15
39,8482077,Dylan Holloway,L,EDM,23,52,8,7,15
39,8481532,Alex Turcotte,C,LAK,23,48,7,8,15
39,8476921,Jordan Martinook,L,CAR,32,69,6,9,15
39,8482142,Jamie Drysdale,D,PHI,22,59,6,9,15
39,8482744,James Malatesta,L,CBJ,21,36,6,9,15
39,8476873,Mark Jankowski,C,NSH,30,46,5,10,15
39,8482148,Hendrix Lapierre,C,WSH,22,54,5,10,15
39,8480950,Ilya Lyubushkin,D,DAL,30,62,2,13,15
39,8482451,Mikael Pyyhtia,L,CBJ,23,46,1,14,15
39,8478416,Erik Cernak,D,TBL,27,73,1,14,15
39,8478421,A.J. Greer,L,FLA,28,53,11,3,14
39,8479336,Carl Grundstrom,R,SJS,27,55,10,4,14
39,8483493,Frank Nazar,C,CHI,20,57,8,6,14
39,8478211,Dryden Hunt,L,CGY,29,55,8,6,14
39,8476867,Brendan Gaunce,C,MIN,30,46,8,6,14
39,8477392,Hudson Fasching,R,NYI,29,59,6,8,14
39,8483565,Nick Blankenburg,D,NSH,26,60,6,8,14
39,8476960,Andreas Athanasiou,C,CHI,30,41,6,8,14
39,8481716,Dmitri Voronkov,L,CBJ,24,36,6,8,14
39,8483466,Kevin Korchinski,D,CHI,20,56,4,10,14
39,8481550,Adam Beckman,L,NJD,23,34,3,11,14
39,8478178,Darren Raddysh,D,TBL,28,67,2,12,14
39,8481019,David Gustafsson,C,WPG,24,44,2,12,14
39,8475455,Brenden Dillon,D,NJD,34,51,2,12,14
39,8475188,Brayden McNabb,D,VGK,33,54,1,13,14
39,8479638,Justin Brazeau,R,BOS,26,40,9,4,13
39,8477573,Nathan Walker,L,STL,30,53,8,5,13
39,8482634,Alex Steeves,C,TOR,25,49,6,7,13
39,8480995,Pontus Holmberg,R,TOR,25,63,6,7,13
39,8481522,Peyton Krebs,C,BUF,23,54,5,8,13
39,8482730,Brandt Clarke,D,LAK,21,51,5,8,13
39,8482737,Zack Bolduc,C,STL,21,58,4,9,13
39,8475324,Nick Jensen,D,OTT,34,69,2,11,13
39,8482807,Ethan Del Mastro,D,CHI,21,43,2,11,13
39,8480887,Jordan Harris,D,MTL,24,57,2,11,13
39,8481708,Zac Jones,D,NYR,24,51,2,11,13
39,8482087,Kaiden Guhle,D,MTL,22,70,0,13,13
39,8480448,Parker Kelly,L,COL,25,72,9,3,12
39,8482259,Bobby McMann,C,TOR,28,64,8,4,12
39,8483495,Simon Nemec,D,NJD,20,59,8,4,12
39,8480848,Ty Dellandrea,C,SJS,24,39,8,4,12
39,8480880,Jakub Lauko,C,MIN,24,29,8,4,12
39,8480355,Mark Kastelic,C,BOS,25,51,7,5,12
39,8478585,Derek Ryan,C,EDM,38,64,6,6,12
39,8479536,Axel Jonsson-Fjallby,L,WPG,26,30,6,6,12
39,8477499,Rasmus Ristolainen,D,PHI,30,58,6,6,12
39,8474568,Luke Schenn,D,NSH,35,51,5,7,12
39,8484149,Gavin Brindley,C,CBJ,20,47,5,7,12
39,8483491,Ivan Miroshnichenko,L,WSH,20,48,4,8,12
39,8481641,Joel Kiviranta,L,COL,28,74,4,8,12
39,8477507,Nikita Zadorov,D,BOS,29,62,3,9,12
39,8476988,Matt Benning,D,SJS,30,63,3,9,12
39,8481527,Kaedan Korczak,D,VGK,23,44,3,9,12
39,8477018,Ben Hutton,D,VGK,31,42,3,9,12
39,8482166,Shakir Mukhamadullin,D,SJS,22,54,3,9,12
39,8479671,Mathieu Olivier,R,CBJ,27,49,3,9,12
39,8474166,Alec Martinez,D,CHI,37,57,3,9,12
39,8479980,Nicolas Hague,D,VGK,26,56,2,10,12
39,8475279,Ben Chiarot,D,DET,33,68,2,10,12
39,8480860,Kevin Bahl,D,CGY,24,59,2,10,12
39,8474090,Brendan Smith,D,DAL,35,53,2,10,12
39,8479986,Kole Lind,R,DAL,26,47,2,10,12
39,8477851,Jordan Oesterle,D,BOS,32,44,2,10,12
39,8478452,Caleb Jones,D,LAK,27,51,1,11,12
39,8475208,Brian Dumoulin,D,ANA,33,63,1,11,12
39,8479249,Andrew Poturalski,C,SJS,30,33,1,11,12
39,8479369,Andrew Peeke,D,BOS,26,64,0,12,12
39,8482062,Cole Smith,L,NSH,29,53,6,5,11
39,8483482,Tristan Luneau,D,ANA,20,67,6,5,11
39,8481517,Brett Leason,R,ANA,25,55,5,6,11
39,8482747,Brennan Othmann,L,NYR,21,44,5,6,11
39,8482659,Josh Doan,R,UTA,22,43,5,6,11
39,8479718,Alex Barré-Boulet,C,MTL,27,55,4,7,11
39,8479291,Kevin Rooney,C,CGY,31,49,4,7,11
39,8479368,Max Jones,L,BOS,26,66,3,8,11
39,8482666,Scott Morrow,D,CAR,22,47,3,8,11
39,8481028,Martin Pospisil,C,CGY,25,58,3,8,11
39,8475718,Justin Holl,D,DET,32,56,3,8,11
39,8480796,Martin Fehervary,D,WSH,25,48,3,8,11
39,8479344,Jesse Puljujarvi,R,PIT,26,50,2,9,11
39,8479944,Zach Aston-Reese,C,VGK,30,43,1,10,11
39,8480727,Zach Whitecloud,D,VGK,28,54,0,11,11
39,8478859,Niko Mikkola,D,FLA,28,56,0,11,11
39,8471817,Ryan Reaves,R,TOR,37,62,7,3,10
39,8476858,Phillip Di Giuseppe,L,VAN,31,28,6,4,10
39,8479439,Jacob MacDonald,D,COL,31,53,6,4,10
39,8479972,Mason Shaw,C,WPG,26,43,6,4,10
39,8480011,Klim Kostin,C,SJS,25,38,5,5,10
39,8480192,Johnathan Kovacevic,D,NJD,27,49,5,5,10
39,8483445,Cutter Gauthier,L,ANA,20,60,4,6,10
39,8479772,Zack MacEwen,R,OTT,28,53,4,6,10
39,8482652,Walker Duehr,R,CGY,27,39,4,6,10
39,8482861,Vincent Iorio,D,WSH,22,33,4,6,10
39,8477335,Kyle Burroughs,D,LAK,29,54,4,6,10
39,8482176,Wyatt Kaiser,D,CHI,22,47,3,7,10
39,8475177,Calvin de Haan,D,COL,33,37,3,7,10
39,8476952,Dominic Toninato,C,WPG,30,33,3,7,10
39,8480172,Jan Rutta,D,SJS,34,63,2,8,10
39,8481701,Santeri Hatakka,D,NJD,23,43,2,8,10
39,8474567,Zach Bogosian,D,MIN,34,60,2,8,10
39,8480844,Grigori Denisenko,L,VGK,24,41,2,8,10
39,8476473,Connor Murphy,D,CHI,31,40,2,8,10
39,8480058,Pierre-Olivier Joseph,D,STL,25,53,1,9,10
39,8480879,Jacob Bernard-Docker,D,OTT,24,46,1,9,10
39,8476442,Matt Nieto,L,PIT,32,46,6,3,9
39,8482145,Mavrik Bourque,C,DAL,22,57,6,3,9
39,8479328,Julien Gauthier,R,NYI,27,62,5,4,9
39,8477482,Zachary Sanford,L,CHI,30,38,5,4,9
39,8481598,Philip Broberg,D,EDM,23,49,5,4,9
39,8480441,Trey Fix-Wolansky,R,CBJ,25,43,5,4,9
39,8475235,Nicolas Deslauriers,L,PHI,33,51,4,5,9
39,8479359,Beck Malenstyn,L,BUF,26,34,4,5,9
39,8479372,Joshua Mahura,D,SEA,26,55,3,6,9
39,8476934,Brock McGinn,L,ANA,30,50,3,6,9
39,8479378,Logan Stanley,D,WPG,26,49,3,6,9
39,8480870,Bo Groulx,C,NYR,24,31,3,6,9
39,8480157,Calle Rosen,D,COL,30,46,3,6,9
39,8481541,Samuel Bolduc,D,NYI,24,34,3,6,9
39,8480845,Rasmus Kupari,C,WPG,24,41,2,7,9
39,8481568,Alex Vlasic,D,CHI,23,49,2,7,9
39,8480007,Jonas Rondbjerg,R,VGK,25,47,2,7,9
39,8475958,Michael Sgarbossa,C,WSH,32,28,2,7,9
39,8482859,Zack Ostapchuk,C,OTT,21,50,1,8,9
39,8481167,Brayden Pachal,D,CGY,25,42,1,8,9
39,8481556,John Beecher,C,BOS,23,38,7,1,8
39,8478831,Kevin Stenlund,C,UTA,28,49,6,2,8
39,8479981,Jonah Gadjovich,L,FLA,26,45,6,2,8
39,8482496,Nils Aman,C,VAN,24,34,5,3,8
39,8479379,Givani Smith,R,SJS,26,28,4,4,8
39,8481518,Nolan Foote,L,NJD,24,30,3,5,8
39,8479994,Jaret Anderson-Dolan,C,WPG,25,33,3,5,8
39,8482713,Mackie Samoskevich,R,FLA,22,40,3,5,8
39,8478468,Jeremy Lauzon,D,NSH,27,49,2,6,8
39,8477938,Haydn Fleury,D,WPG,28,39,2,6,8
39,8480990,Declan Chisholm,D,MIN,24,38,2,6,8
39,8484254,Akito Hirose,D,VAN,25,41,2,6,8
39,8479371,Dante Fabbro,D,NSH,26,61,1,7,8
39,8480070,Ian Mitchell,D,BOS,25,45,1,7,8
39,8475750,Jon Merrill,D,MIN,32,60,1,7,8
39,8483549,Lucas Condotta,L,MTL,27,31,1,7,8
39,8474612,Travis Hamonic,D,OTT,34,39,0,8,8
39,8477365,Connor Clifton,D,BUF,29,46,0,8,8
39,8482511,Mason Lohrei,D,BOS,23,30,0,8,8
39,8477887,Patrick Brown,C,BOS,32,46,5,2,7
39,8477070,Liam O'Brien,C,UTA,30,50,4,3,7
39,8479968,Vinni Lettieri,C,BOS,29,47,4,3,7
39,8482784,Zach Dean,C,STL,21,39,3,4,7
39,8471677,Jack Johnson,D,CBJ,37,66,3,4,7
39,8477473,Justin Bailey,R,SJS,29,30,3,4,7
39,8478450,Parker Wotherspoon,D,BOS,27,36,3,4,7
39,8481679,Maxence Guenette,D,OTT,23,33,3,4,7
39,8481161,Jake Christiansen,D,CBJ,25,60,2,5,7
39,8481592,Jakob Pelletier,L,CGY,23,35,2,5,7
39,8478874,Adam Gaudette,R,OTT,28,33,2,5,7
39,8476913,Devin Shore,C,MIN,30,31,2,5,7
39,8481609,Vladislav Kolyachonok,D,UTA,23,36,2,5,7
39,8478146,Matthew Highmore,C,OTT,28,35,1,6,7
39,8483619,Filip Roos,D,OTT,25,36,1,6,7
39,8478424,Jansen Harkins,C,ANA,27,34,5,1,6
39,8481754,Nikita Nesterenko,C,ANA,23,29,4,2,6
39,8477401,John Hayden,C,SEA,29,32,4,2,6
39,8478017,Mark Friedman,D,VAN,29,43,3,3,6
39,8479348,Kale Clague,D,BUF,26,39,3,3,6
39,8481543,Nikita Alexandrov,C,STL,24,23,3,3,6
39,8484911,Collin Graf,R,SJS,22,40,3,3,6
39,8477962,Brendan Lemieux,L,CAR,28,40,2,4,6
39,8483012,Logan Morrison,C,SEA,22,37,2,4,6
39,8482858,Ryker Evans,D,SEA,23,26,2,4,6
39,8481122,Simon Benoit,D,TOR,26,40,1,5,6
39,8477384,Joshua Brown,D,EDM,30,47,1,5,6
39,8481056,Spencer Stastney,D,NSH,24,35,1,5,6
39,8478454,Noah Juulsen,D,VAN,27,30,0,6,6
39,8473446,Erik Johnson,D,PHI,36,45,0,6,6
39,8478409,Anthony Richard,C,PHI,28,29,0,6,6
39,8482250,Callahan Burke,C,VGK,27,22,0,6,6
39,8480032,Shane Bowers,C,NJD,25,21,5,0,5
39,8479419,Brett Murray,L,BUF,26,18,4,1,5
39,8480292,Carson Meyer,R,ANA,27,38,3,2,5
39,8482153,Brendan Brisson,C,VGK,23,29,3,2,5
39,8479442,Troy Stecher,D,EDM,30,44,2,3,5
39,8480196,Jacob Bryson,D,BUF,27,48,2,3,5
39,8481600,Tobias Bjornfot,D,FLA,23,37,2,3,5
39,8476441,Joel Edmundson,D,LAK,31,40,2,3,5
39,8479576,Vincent Desharnais,D,VAN,28,32,2,3,5
39,8477527,Ross Johnston,L,ANA,30,29,2,3,5
39,8480245,Olle Lycksell,R,PHI,25,27,2,3,5
39,8483630,Pavol Regenda,L,ANA,25,27,1,4,5
39,8483570,Ben Meyers,C,SEA,26,31,1,4,5
39,8482095,Tyler Kleven,D,OTT,22,44,1,4,5
39,8480834,Ty Emberson,D,SJS,24,30,1,4,5
39,8476372,Nick Seeler,D,PHI,31,45,1,4,5
39,8480890,Jan Jenik,C,OTT,24,30,1,4,5
39,8482177,Marat Khusnutdinov,C,MIN,22,34,1,4,5
39,8481605,Jackson LaCombe,D,ANA,23,33,1,4,5
39,8484258,Sam Malinski,D,COL,26,22,1,4,5
39,8484287,Cole McWard,D,VAN,23,21,3,1,4
39,8482929,Emil Lilleberg,D,TBL,23,18,3,1,4
39,8482751,Ryan Winterton,C,SEA,21,38,2,2,4
39,8479991,Jake Leschyshyn,C,NYR,25,26,2,2,4
39,8481462,Mason Morelli,L,VGK,28,13,2,2,4
39,8483460,David Jiricek,D,CBJ,21,54,1,3,4
39,8482733,Logan Mailloux,D,MTL,31,22,1,3,4
39,8481147,Reese Johnson,C,MIN,26,35,1,3,4
39,8482165,Yan Kuznetsov,D,CGY,22,18,1,3,4
39,8478477,Mitchell Stephens,C,SEA,27,13,1,3,4
39,8482141,Lukas Cormier,D,VGK,22,28,0,4,4
39,8482061,Brandon Biro,L,SEA,26,19,3,0,3
39,8481789,Tye Kartye,L,SEA,23,27,2,1,3
39,8482765,Isak Rosen,R,BUF,21,35,2,1,3
39,8482144,Jack Thompson,D,SJS,22,25,2,1,3
39,8477462,Robert Hagg,D,VGK,29,26,2,1,3
39,8478502,Dennis Gilbert,D,BUF,28,12,2,1,3
39,8479362,Riley Tufte,L,BOS,26,18,2,1,3
39,8477467,Gustav Olofsson,D,SEA,30,23,2,1,3
39,8481743,Marc Del Gaizo,D,NSH,25,20,1,2,3
39,8483763,Maksymilian Szuber,D,UTA,22,29,1,2,3
39,8479587,Rhett Gardner,C,PHI,28,18,1,2,3
39,8483397,Marc McLaughlin,C,BOS,25,36,1,2,3
39,8479985,Cale Fleury,D,SEA,26,18,1,2,3
39,8480075,Cameron Crotty,D,MIN,25,13,1,2,3
39,8477149,Scott Sabourin,R,SJS,32,16,1,2,3
39,8481699,Aku Raty,R,UTA,23,23,1,2,3
39,8484325,Waltteri Merela,C,TBL,26,23,1,2,3
39,8482964,Arber Xhekaj,D,MTL,23,49,0,3,3
39,8482118,Sam Colangelo,R,ANA,23,15,0,3,3
39,8482201,Gage Goncalves,C,TBL,23,18,0,3,3
39,8475795,Dylan McIlrath,D,WSH,32,14,0,3,3
39,8477320,Anton Blidh,L,NYR,29,24,0,3,3
39,8482102,Vasily Ponomarev,C,PIT,22,18,2,0,2
39,8480874,Adam Ginning,D,PHI,24,10,2,0,2
39,8483512,Matthew Savoie,C,EDM,20,27,2,0,2
39,8481237,Kyle MacLean,C,NYI,25,35,2,0,2
39,8480267,Sammy Walker,C,MIN,25,20,1,1,2
39,8474062,Riley Nash,C,NYR,35,15,1,1,2
39,8480851,Akil Thomas,C,LAK,24,21,1,1,2
39,8478011,Louie Belpedio,D,PHI,28,16,1,1,2
39,8481806,Louis Crevier,D,CHI,23,14,1,1,2
39,8480823,Alexander Alexeyev,D,WSH,25,13,1,1,2
39,8483489,Fraser Minten,C,TOR,31,8,1,1,2
39,8482094,Daemon Hunt,D,MIN,22,15,1,1,2
39,8482070,Mitchell Chaffee,R,TBL,26,51,0,2,2
39,8480084,Nick DeSimone,D,NJD,30,24,0,2,2
39,8477971,Andreas Englund,D,LAK,28,23,0,2,2
39,8481719,Maxwell Crozier,D,TBL,24,14,0,2,2
39,8478021,William Lagesson,D,DET,28,24,0,2,2
39,8479320,Maxime Lajoie,D,SEA,27,24,0,2,2
39,8482147,Jean-Luc Foudy,C,COL,22,22,0,2,2
39,8477073,Kurtis MacDermid,L,NJD,30,34,0,2,2
39,8483531,Brian Halonen,L,NJD,25,3,0,2,2
39,8481030,Jack St. Ivany,D,PIT,25,15,1,0,1
39,8480468,James Hamblin,L,EDM,25,20,1,0,1
39,8481422,Jake Lucchini,C,NSH,29,20,1,0,1
39,8477541,Dakota Mermis,D,TOR,30,9,1,0,1
39,8479367,William Lockwood,R,FLA,26,28,1,0,1
39,8475413,Justin Dowling,C,NJD,34,17,1,0,1
39,8481585,Egor Afanasyev,L,SJS,23,14,1,0,1
39,8478881,Brett Seney,L,CHI,28,19,1,0,1
39,8483395,Arshdeep Bains,L,VAN,23,10,1,0,1
39,8475755,Alexander Petrovic,D,DAL,32,14,1,0,1
39,8479330,Brandon Gignac,C,MTL,27,8,1,0,1
39,8483546,Marshall Rifai,D,TOR,26,5,1,0,1
39,8481043,Cole Koepke,L,BOS,26,14,1,0,1
39,8481578,Graeme Clarke,R,MIN,23,5,1,0,1
39,8482470,Ilya Solovyov,D,CGY,24,17,0,1,1
39,8482172,Landon Slaggert,L,CHI,22,22,0,1,1
39,8477244,Chad Ruhwedel,D,NYR,34,28,0,1,1
39,8482162,Roby Jarventie,L,EDM,22,13,0,1,1
39,8481006,Tyler Tucker,D,STL,24,12,0,1,1
39,8481726,Adam Edstrom,C,NYR,24,11,0,1,1
39,8481024,Linus Karlsson,C,VAN,25,5,0,1,1
39,8481206,John Ludvig,D,PIT,24,15,0,1,1
39,8482088,Justin Sourdif,R,FLA,22,13,0,1,1
39,8480306,Grant Hutton,D,NYI,29,6,0,1,1
39,8478051,Max Willman,C,NJD,29,23,0,1,1
39,8483407,Brandon Scanlin,D,NYR,25,5,0,1,1
39,8482126,Emil Andrae,D,PHI,31,5,0,1,1
39,8475780,Chris Wagner,R,COL,33,5,0,1,1
39,8477810,Joel Hanley,D,CGY,33,19,0,0,0
39,8481593,Jayden Struble,D,MTL,23,17,0,0,0
39,8482460,Matt Rempe,C,NYR,22,5,0,0,0
39,8483597,Milos Kelemen,L,UTA,25,16,0,0,0
39,8478446,Glenn Gawdin,C,LAK,27,9,0,0,0
39,8481564,Ryan Johnson,D,BUF,23,10,0,0,0
39,8482516,Matthew Kessel,D,STL,24,17,0,0,0
39,8481065,Angus Crookshank,L,OTT,25,21,0,0,0
39,8483398,Declan Carlile,D,TBL,31,9,0,0,0
39,8483471,Brad Lambert,C,WPG,31,8,0,0,0
39,8479421,Jacob Moverare,D,LAK,26,7,0,0,0
39,8482787,Nikita Chibrikov,R,WPG,31,4,0,0,0
39,8483567,Georgii Merkulov,C,BOS,24,9,0,0,0
39,8484304,Uvis Balinskis,D,FLA,28,9,0,0,0
39,8476323,Max McCormick,L,SEA,32,5,0,0,0
39,8481655,Cole Schwindt,R,CGY,23,6,0,0,0
39,8477993,Justin Kirkland,C,CGY,28,2,0,0,0
39,8482476,Emil Heineman,L,MTL,23,7,0,0,0
39,8478147,Bokondji Imama,L,PIT,28,6,0,0,0
39,8483920,Pierrick Dube,R,WSH,23,4,0,0,0
39,8481534,Raphael Lavoie,C,EDM,24,0,0,0,0
39,8483609,Adam Klapka,R,CGY,24,5,0,0,0
39,8478854,Ryan Shea,D,PIT,27,6,0,0,0
39,8483432,Luca Del Bel Belluz,C,CBJ,31,2,0,0,0
39,8484259,Ondrej Pavel,C,COL,31,2,0,0,0
39,8484326,Patrik Koch,D,UTA,28,2,0,0,0
39,8484255,Jason Polin,R,COL,25,7,0,0,0
39,8482197,Adam Raska,R,MIN,23,10,0,0,0
39,8480274,Philip Kemp,D,EDM,25,1,0,0,0
39,8479522,Hardy Haman Aktell,D,WSH,26,2,0,0,0
39,8483401,Marc Johnstone,R,PIT,28,0,0,0,0
39,8484321,Nikolas Matinpalo,D,OTT,26,2,0,0,0
39,8470794,Joe Pavelski,C,,40,0,0,0,0
39,8479321,Lucas Johansen,D,,27,0,0,0,0
39,8477950,Tony DeAngelo,D,,29,0,0,0,0
39,8471218,Blake Wheeler,R,,38,0,0,0,0
39,8475197,Tyson Barrie,D,,33,0,0,0,0
39,8474157,Max Pacioretty,L,,36,0,0,0,0
39,8475744,Evgeny Kuznetsov,C,,32,0,0,0,0
39,8474037,James van Riemsdyk,L,,35,0,0,0,0
39,8476907,Mackenzie MacEachern,L,,30,0,0,0,0
39,8480216,Jacob Peterson,C,,25,0,0,0,0
39,8474602,Justin Schultz,D,,34,0,0,0,0
39,8482222,Alexander Barabanov,L,,30,0,0,0,0
39,8474031,Kevin Shattenkirk,D,,35,0,0,0,0
39,8477330,Dominik Kubalik,L,,29,0,0,0,0
39,8480884,Calen Addison,D,,24,0,0,0,0
39,8475906,John Klingberg,D,,32,0,0,0,0
39,8480008,Adam Ruzicka,C,,25,0,0,0,0
39,8476884,Derrick Pouliot,D,,30,0,0,0,0
39,8476919,Chris Tierney,C,,30,0,0,0,0
39,8479415,Michael McLeod,C,,26,0,0,0,0
39,8474870,Tyler Johnson,C,,34,0,0,0,0
39,8470604,Jeff Carter,C,,39,0,0,0,0
39,8478104,Sammy Blais,L,,28,0,0,0,0
39,8474884,Mike Hoffman,C,,35,0,0,0,0
39,8481591,Sam Poulin,R,,23,0,0,0,0
39,8471274,Alex Goligoski,D,,39,0,0,0,0
39,8476871,Tanner Pearson,L,,32,0,0,0,0
39,8476393,Nick Cousins,C,,31,0,0,0,0
39,8479977,Kailer Yamamoto,R,,26,0,0,0,0
39,8479346,Dillon Dube,C,,26,0,0,0,0
39,8480184,Gustav Lindstrom,D,,26,0,0,0,0
39,8479376,Victor Mete,D,,26,0,0,0,0
39,8473449,Kyle Okposo,R,,36,0,0,0,0
39,8481058,Jesse Ylonen,R,,25,0,0,0,0
39,8475752,Tyler Pitlick,C,,33,0,0,0,0
39,8481239,Samuel Fagemo,L,,24,0,0,0,0
39,8480821,Filip Zadina,R,,25,0,0,0,0
39,8470966,Mark Giordano,D,,41,0,0,0,0
39,8478495,Denis Gurianov,R,,27,0,0,0,0
39,8477464,Nic Petan,C,,29,0,0,0,0
39,8478099,Kevin Labanc,R,,29,0,0,0,0
39,8482241,Radim Zohorna,L,,28,0,0,0,0
39,8474040,Sam Gagner,C,,35,0,0,0,0
39,8479514,Rem Pitlick,C,,27,0,0,0,0
39,8478430,Oliver Kylington,D,,27,0,0,0,0
39,8479533,Joona Koppanen,L,,26,0,0,0,0
39,8479984,Cal Foote,D,,26,0,0,0,0
39,8477126,Jayson Megna,C,,34,0,0,0,0
39,8475164,Jakob Silfverberg,R,,34,0,0,0,0
39,8474009,Nick Bonino,C,,36,0,0,0,0
39,8479458,Nikita Zaitsev,D,,33,0,0,0,0
39,8477944,Jakub Vrana,L,,28,0,0,0,0
39,8471699,Andrew Cogliano,C,,37,0,0,0,0
39,8478067,Oskar Lindblom,L,,28,0,0,0,0
39,8471686,Marc Staal,D,,37,0,0,0,0
39,8470610,Zach Parise,L,,40,0,0,0,0
39,8478904,Steven Lorentz,C,,28,0,0,0,0
39,8473473,Milan Lucic,L,,36,0,0,0,0
39,8480031,Maxime Comtois,L,,25,0,0,0,0
39,8478512,Austin Czarnik,C,,32,0,0,0,0
39,8473504,Cal Clutterbuck,R,,37,0,0,0,0
39,8477454,Adam Erne,L,,29,0,0,0,0
39,8479383,Boris Katchouk,L,,26,0,0,0,0
39,8475825,Jani Hakanpää,D,,32,0,0,0,0
39,8477846,Ryan Carpenter,C,,33,0,0,0,0
39,8477930,Pierre-Edouard Bellemare,L,,39,0,0,0,0
39,8478400,Colin White,C,,27,0,0,0,0
39,8480226,Marián Studenic,R,,26,0,0,0,0
39,8480853,Liam Foudy,C,,24,0,0,0,0
39,8475797,Jarred Tinordi,D,,32,0,0,0,0
39,8479423,Alex Nylander,L,,26,0,0,0,0
39,8474618,Marco Scandella,D,,34,0,0,0,0
39,8478028,Fredrik Olofsson,L,,28,0,0,0,0
39,8474709,Matt Martin,L,,35,0,0,0,0
39,8481070,Hugh McGing,L,,26,0,0,0,0
39,8479546,Oskar Steen,C,,26,0,0,0,0
39,8474145,Robert Bortuzzo,D,,35,0,0,0,0
39,8476915,Jujhar Khaira,L,,30,0,0,0,0
39,8475278,Byron Froese,C,,33,0,0,0,0
39,8481812,Nikolai Knyzhov,D,,27,0,0,0,0
39,8478408,Travis Dermott,D,,28,0,0,0,0
39,8481077,John Leonard,L,,26,0,0,0,0
39,8479547,Matthew Phillips,R,,26,0,0,0,0
39,8480836,Jonathan Gruden,C,,24,0,0,0,0
39,8481690,Tyler Angle,C,,24,0,0,0,0
39,8475766,Austin Watson,L,,32,0,0,0,0
39,8481016,Ruslan Iskhakov,C,,24,0,0,0,0
39,8478078,Rourke Chartier,C,,28,0,0,0,0
39,8480776,Sheldon Rempal,R,,29,0,0,0,0
39,8478956,Samuel Laberge,L,NJD,27,0,0,0,0
39,8483045,Cameron Butler,R,CBJ,31,1,0,0,0
39,8484314,Jiri Smejkal,L,,28,0,0,0,0
40,8477492,Nathan MacKinnon,C,COL,29,82,47,84,131
40,8477934,Leon Draisaitl,C,EDM,29,81,47,81,128
40,8476453,Nikita Kucherov,R,TBL,31,81,40,88,128
40,8478402,Connor McDavid,C,EDM,27,73,38,90,128
40,8479314,Matthew Tkachuk,L,FLA,27,79,40,83,123
40,8477942,Kevin Fiala,L,LAK,28,80,41,77,118
40,8477956,David Pastrnak,R,BOS,28,80,52,64,116
40,8478483,Mitch Marner,R,TOR,27,80,36,74,110
40,8480027,Jason Robertson,L,DAL,25,81,46,62,108
40,8481559,Jack Hughes,C,NJD,23,77,38,70,108
40,8478550,Artemi Panarin,L,NYR,33,81,37,68,105
40,8477404,Jake Guentzel,C,TBL,30,82,42,61,103
40,8478420,Mikko Rantanen,R,COL,28,81,36,64,100
40,8477939,William Nylander,R,TOR,28,79,45,54,99
40,8478864,Kirill Kaprizov,L,MIN,27,76,40,57,97
40,8476468,J.T. Miller,C,VAN,31,76,30,67,97
40,8479318,Auston Matthews,C,TOR,27,79,51,44,95
40,8475913,Mark Stone,R,VGK,32,74,21,72,93
40,8477946,Dylan Larkin,C,DET,28,82,45,47,92
40,8477933,Sam Reinhart,C,FLA,29,78,42,50,92
40,8476887,Filip Forsberg,L,NSH,30,73,43,48,91
40,8478403,Jack Eichel,C,VGK,28,79,43,46,89
40,8475172,Nazem Kadri,C,CGY,34,78,34,55,89
40,8480023,Robert Thomas,C,STL,25,75,27,62,89
40,8480002,Nico Hischier,C,NJD,25,78,41,47,88
40,8479323,Adam Fox,D,NYR,26,72,20,68,88
40,8481557,Matt Boldy,L,MIN,23,77,34,53,87
40,8482116,Tim Stützle,C,OTT,22,79,25,62,87
40,8478010,Brayden Point,C,TBL,28,82,39,47,86
40,8480012,Elias Pettersson,C,VAN,26,75,35,50,85
40,8471675,Sidney Crosby,C,PIT,37,74,34,50,84
40,8476454,Ryan Nugent-Hopkins,C,EDM,31,79,25,59,84
40,8471214,Alex Ovechkin,L,WSH,39,71,40,43,83
40,8477493,Aleksander Barkov,C,FLA,29,80,30,53,83
40,8477501,Valeri Nichushkin,R,COL,29,81,45,37,82
40,8480208,Drake Batherson,R,OTT,26,80,32,50,82
40,8475166,John Tavares,C,TOR,34,81,37,44,81
40,8477940,Nikolaj Ehlers,L,WPG,28,71,33,48,81
40,8479420,Tage Thompson,C,BUF,27,72,46,34,80
40,8480801,Brady Tkachuk,L,OTT,25,81,33,47,80
40,8476459,Mika Zibanejad,C,NYR,31,78,33,47,80
40,8473512,Claude Giroux,R,OTT,36,79,29,51,80
40,8478445,Mathew Barzal,C,NYI,27,77,26,54,80
40,8477402,Pavel Buchnevich,L,STL,29,72,32,47,79
40,8476456,Jonathan Huberdeau,C,CGY,31,81,18,61,79
40,8477409,Carter Verhaeghe,C,FLA,29,78,40,38,78
40,8480036,Miro Heiskanen,D,DAL,25,76,10,68,78
40,8478414,Timo Meier,R,NJD,28,75,39,38,77
40,8471685,Anze Kopitar,C,LAK,37,80,36,40,76
40,8475168,Matt Duchene,C,DAL,33,81,27,49,76
40,8475692,Mats Zuccarello,R,MIN,37,70,12,64,76
40,8474600,Roman Josi,D,NSH,34,72,18,57,75
40,8479542,Brandon Hagel,L,TBL,26,82,31,43,74
40,8480069,Cale Makar,D,COL,26,74,25,49,74
40,8478398,Kyle Connor,L,WPG,28,75,36,37,73
40,8480830,Andrei Svechnikov,R,CAR,24,74,21,52,73
40,8475765,Vladimir Tarasenko,R,DET,33,81,25,47,72
40,8478427,Sebastian Aho,C,CAR,27,71,33,38,71
40,8479999,Casey Mittelstadt,C,COL,26,81,15,56,71
40,8484144,Connor Bedard,C,CHI,19,68,34,36,70
40,8478439,Travis Konecny,R,PHI,27,75,29,41,70
40,8482078,Lucas Raymond,L,DET,22,80,27,43,70
40,8477951,Nick Schmaltz,C,UTA,28,73,24,46,70
40,8476346,Johnny Gaudreau,L,CBJ,31,74,17,53,70
40,8480803,Evan Bouchard,D,EDM,25,76,10,60,70
40,8479343,Clayton Keller,R,UTA,26,75,34,35,69
40,8481540,Cole Caufield,R,MTL,23,78,34,35,69
40,8476881,Tomas Hertl,C,VGK,31,76,30,38,68
40,8476905,Chandler Stephenson,C,SEA,30,72,13,55,68
40,8477960,Adrian Kempe,R,LAK,28,82,27,40,67
40,8482665,Matty Beniers,C,SEA,22,74,23,44,67
40,8478440,Dylan Strome,C,WSH,27,67,22,45,67
40,8475167,Victor Hedman,D,TBL,34,81,15,52,67
40,8478449,Roope Hintz,C,DAL,28,79,32,34,66
40,8480015,Owen Tippett,R,PHI,25,79,32,34,66
40,8475810,Bryan Rust,R,PIT,32,75,28,38,66
40,8479385,Jordan Kyrou,C,STL,26,75,25,41,66
40,8477476,Artturi Lehkonen,L,COL,29,79,33,32,65
40,8473419,Brad Marchand,L,BOS,36,79,27,38,65
40,8480018,Nick Suzuki,C,MTL,25,76,22,43,65
40,8478444,Brock Boeser,R,VAN,27,74,28,36,64
40,8474141,Patrick Kane,R,DET,36,81,22,42,64
40,8478460,Zach Werenski,D,CBJ,27,81,13,51,64
40,8475798,Mikael Granlund,C,SJS,32,71,12,52,64
40,8480800,Quinn Hughes,D,VAN,25,71,10,54,64
40,8477955,Jared McCann,L,SEA,28,73,37,26,63
40,8476399,Blake Coleman,C,CGY,33,76,29,34,63
40,8476479,Phillip Danault,C,LAK,31,79,17,46,63
40,8476448,William Karlsson,C,VGK,31,77,32,30,62
40,8479675,Trevor Moore,L,LAK,29,80,31,31,62
40,8474564,Steven Stamkos,C,NSH,34,71,24,38,62
40,8479407,Jesper Bratt,L,NJD,26,73,21,41,62
40,8477494,Jonathan Drouin,L,COL,29,80,15,47,62
40,8475753,Justin Faulk,D,STL,32,75,14,48,62
40,8482109,Alexis Lafrenière,L,NYR,23,74,28,33,61
40,8475794,Tyler Seguin,C,DAL,32,82,26,35,61
40,8477447,Shea Theodore,D,VGK,29,62,9,52,61
40,8477935,Sam Bennett,C,FLA,28,73,33,27,60
40,8474102,David Perron,L,OTT,36,79,27,33,60
40,8478856,Conor Garland,R,VAN,28,73,25,35,60
40,8480039,Martin Necas,C,CAR,25,68,21,39,60
40,8476906,Shayne Gostisbehere,D,CAR,31,76,14,46,60
40,8474578,Erik Karlsson,D,PIT,34,78,11,49,60
40,8479325,Charlie McAvoy,D,BOS,27,77,9,51,60
40,8476539,Jonathan Marchessault,R,NSH,34,74,37,22,59
40,8471215,Evgeni Malkin,C,PIT,38,74,23,36,59
40,8475754,Brock Nelson,C,NYI,33,79,21,38,59
40,8476792,Torey Krug,D,STL,33,77,21,38,59
40,8478407,Vince Dunn,D,SEA,28,73,11,48,59
40,8480839,Rasmus Dahlin,D,BUF,24,72,10,49,59
40,8478366,Frank Vatrano,R,ANA,30,63,31,27,58
40,8481068,Yegor Sharangovich,C,CGY,26,78,28,30,58
40,8475191,Reilly Smith,R,NYR,33,73,28,30,58
40,8475158,Ryan O'Reilly,C,NSH,33,73,22,36,58
40,8477986,Brandon Montour,D,SEA,30,75,20,38,58
40,8476460,Mark Scheifele,C,WPG,31,69,19,39,58
40,8477949,Alex Tuch,R,BUF,28,70,18,40,58
40,8477504,Josh Morrissey,D,WPG,29,72,13,45,58
40,8480865,Noah Dobson,D,NYI,24,79,11,47,58
40,8478873,Troy Terry,R,ANA,27,71,26,31,57
40,8484166,Adam Fantilli,C,CBJ,20,66,26,31,57
40,8474150,Mikael Backlund,C,CGY,35,80,25,32,57
40,8482684,Luke Hughes,D,NJD,21,71,10,47,57
40,8478397,Rasmus Andersson,D,CGY,28,75,10,47,57
40,8476875,Mike Matheson,D,MTL,30,72,8,49,57
40,8479337,Alex DeBrincat,R,DET,27,82,28,28,56
40,8482093,Seth Jarvis,C,CAR,22,71,25,31,56
40,8475170,Brayden Schenn,C,STL,33,71,20,36,56
40,8478462,Nicolas Roy,C,VGK,27,74,24,31,55
40,8477496,Elias Lindholm,C,BOS,30,80,22,33,55
40,8482699,Dylan Guenther,R,UTA,21,71,20,35,55
40,8481528,Dylan Cozens,C,BUF,23,69,20,35,55
40,8480798,Philipp Kurashev,C,CHI,25,68,20,35,55
40,8475784,Jeff Skinner,C,EDM,32,76,33,21,54
40,8475184,Chris Kreider,L,NYR,33,78,31,23,54
40,8475786,Zach Hyman,L,EDM,32,73,28,26,54
40,8484153,Leo Carlsson,C,ANA,20,73,28,26,54
40,8478975,Mason Marchment,L,DAL,29,82,23,31,54
40,8478493,Joel Eriksson Ek,C,MIN,27,71,21,33,54
40,8478401,Pavel Zacha,C,BOS,27,80,20,34,54
40,8474679,Gustav Nyquist,C,NSH,35,76,16,38,54
40,8484145,Zach Benson,L,BUF,19,72,14,40,54
40,8482745,Mason McTavish,C,ANA,21,68,23,30,53
40,8482110,Dawson Mercer,C,NJD,23,76,23,30,53
40,8481711,Matias Maccelli,L,UTA,24,73,19,34,53
40,8475151,Kyle Palmieri,C,NYI,33,77,32,20,52
40,8482740,Wyatt Johnston,C,DAL,21,81,23,29,52
40,8476389,Vincent Trocheck,C,NYR,31,75,21,31,52
40,8473994,Jamie Benn,L,DAL,35,81,18,34,52
40,8479525,Ross Colton,C,COL,28,79,32,19,51
40,8482159,Tyson Foerster,R,PHI,22,73,27,24,51
40,8475287,Erik Haula,L,NJD,33,76,23,28,51
40,8474641,Adam Henrique,C,EDM,34,75,23,28,51
40,8479400,Pierre-Luc Dubois,L,WSH,26,66,22,29,51
40,8482124,Quinton Byfield,R,LAK,22,80,19,32,51
40,8470613,Brent Burns,D,CAR,39,76,16,35,51
40,8476462,Dougie Hamilton,D,NJD,31,70,16,35,51
40,8474565,Alex Pietrangelo,D,VGK,34,64,14,37,51
40,8474590,John Carlson,D,WSH,34,68,10,41,51
40,8475169,Evander Kane,L,EDM,33,78,33,17,50
40,8477407,Anthony Duclair,L,NYI,29,76,22,28,50
40,8481533,Trevor Zegras,C,ANA,23,72,18,32,50
40,8477456,J.T. Compher,L,DET,29,81,20,29,49
40,8476826,Yanni Gourde,C,SEA,33,75,16,33,49
40,8476853,Morgan Rielly,D,TOR,30,71,5,44,49
40,8475745,Charlie Coyle,C,BOS,32,77,21,27,48
40,8483505,Matthew Poitras,C,BOS,20,76,21,27,48
40,8477451,Ryan Hartman,R,MIN,30,71,21,27,48
40,8477021,Alex Kerfoot,C,UTA,30,74,15,33,48
40,8478469,Thomas Chabot,D,OTT,27,76,15,33,48
40,8478038,Devon Toews,D,COL,30,69,11,37,48
40,8479410,Mikhail Sergachev,D,UTA,26,69,8,40,48
40,8476880,Tom Wilson,R,WSH,30,71,27,20,47
40,8474586,Jordan Eberle,R,SEA,34,72,16,31,47
40,8478042,Viktor Arvidsson,L,EDM,31,77,15,32,47
40,8471724,Kris Letang,D,PIT,37,82,10,37,47
40,8476432,Boone Jenner,C,CBJ,31,69,30,16,46
40,8477964,Ivan Barbashev,C,VGK,29,75,24,22,46
40,8480064,Josh Norris,C,OTT,25,78,22,24,46
40,8477426,Nicholas Paul,L,TBL,29,82,22,24,46
40,8478047,Michael Bunting,L,PIT,29,71,20,26,46
40,8477503,Max Domi,C,TOR,29,78,18,28,46
40,8478466,Daniel Sprong,R,VAN,27,72,17,29,46
40,8481524,Bowen Byram,D,BUF,23,72,14,32,46
40,8481577,Philip Tomasino,C,NSH,23,74,12,34,46
40,8478115,Pierre Engvall,L,NYI,28,75,10,36,46
40,8476438,Brandon Saad,L,STL,32,74,25,20,45
40,8482149,Cole Perfetti,C,WPG,22,70,19,26,45
40,8475760,Nick Bjugstad,C,UTA,32,77,18,27,45
40,8483515,Juraj Slafkovsky,L,MTL,20,72,16,29,45
40,8475218,Mattias Ekholm,D,EDM,34,71,9,36,45
40,8483431,Logan Cooley,C,UTA,20,76,23,21,44
40,8478498,Jake DeBrusk,L,VAN,28,75,22,22,44
40,8478542,Evan Rodrigues,C,FLA,31,75,16,28,44
40,8481604,Pavel Dorofeyev,L,VGK,24,73,16,28,44
40,8482720,Matthew Knies,L,TOR,22,76,15,29,44
40,8480797,Joel Farabee,L,PHI,24,73,14,30,44
40,8476923,Damon Severson,D,CBJ,30,76,5,39,44
40,8480014,Gabriel Vilardi,C,WPG,25,62,28,15,43
40,8479992,Michael Rasmussen,C,DET,25,77,23,20,43
40,8481186,Logan O'Connor,R,COL,28,79,22,21,43
40,8477416,Oliver Bjorkstrand,R,SEA,29,71,17,26,43
40,8479425,Filip Hronek,D,VAN,27,72,7,36,43
40,8481656,Aliaksei Protas,C,WSH,23,67,6,37,43
40,8476483,Rickard Rakell,R,PIT,31,71,26,16,42
40,8477500,Bo Horvat,C,NYI,29,80,22,20,42
40,8475726,Tyler Toffoli,C,SJS,32,61,22,20,42
40,8477497,Sean Monahan,C,CBJ,30,70,20,22,42
40,8481560,Arthur Kaliyev,R,LAK,23,76,18,24,42
40,8482667,William Eklund,L,SJS,22,66,16,26,42
40,8475763,Kevin Hayes,R,PIT,32,65,14,28,42
40,8476882,Teuvo Teravainen,C,CHI,30,68,10,32,42
40,8482105,Jake Sanderson,D,OTT,22,75,10,32,42
40,8477346,MacKenzie Weegar,D,CGY,30,68,7,35,42
40,8480802,Ryan McLeod,C,BUF,25,64,19,22,41
40,8482702,Logan Stankoven,C,DAL,21,79,18,23,41
40,8477479,Tyler Bertuzzi,L,CHI,29,60,17,24,41
40,8476925,Colton Sissons,C,NSH,31,69,16,25,41
40,8479345,Jakob Chychrun,D,WSH,26,64,11,30,41
40,8473986,Alex Killorn,L,ANA,35,74,18,22,40
40,8480009,Eeli Tolvanen,R,SEA,25,70,18,22,40
40,8478519,Anthony Cirelli,C,TBL,27,82,17,23,40
40,8480028,Morgan Frost,C,PHI,25,74,15,25,40
40,8480829,Jesperi Kotkaniemi,C,CAR,24,62,14,26,40
40,8478396,Noah Hanifin,D,VGK,27,58,11,29,40
40,8474053,Logan Couture,C,SJS,35,67,11,29,40
40,8481581,Thomas Harley,D,DAL,23,73,7,33,40
40,8478474,Lawson Crouse,L,UTA,27,73,21,18,39
40,8482092,Ridly Greig,C,OTT,22,73,19,20,39
40,8478233,Andrew Mangiapane,L,WSH,28,70,19,20,39
40,8479365,Trent Frederic,C,BOS,26,77,17,22,39
40,8477511,Anthony Mantha,R,CGY,30,73,15,24,39
40,8482133,Thomas Bordeleau,C,SJS,22,59,13,26,39
40,8478438,Tommy Novak,C,NSH,27,68,13,26,39
40,8482660,Kent Johnson,C,CBJ,22,67,9,30,39
40,8476958,Jaccob Slavin,D,CAR,30,74,9,30,39
40,8483808,Andrei Kuzmenko,L,CGY,28,76,22,16,38
40,8475714,Calle Jarnkrok,C,TOR,33,73,18,20,38
40,8482097,Jack Quinn,R,BUF,23,71,16,22,38
40,8478472,Mathieu Joseph,R,STL,27,64,14,24,38
40,8476292,Ondrej Palat,L,NJD,33,66,13,25,38
40,8482705,Cole Sillinger,C,CBJ,21,72,21,16,37
40,8481535,Nils Hoglander,L,VAN,24,65,19,18,37
40,8477998,Warren Foegele,L,LAK,28,82,17,20,37
40,8482113,Anton Lundell,C,FLA,23,76,14,23,37
40,8479987,Morgan Geekie,C,BOS,26,76,14,23,37
40,8481523,Kirby Dach,C,MTL,23,68,14,23,37
40,8477932,Aaron Ekblad,D,FLA,28,70,11,26,37
40,8482101,Danil Gushchin,L,SJS,22,65,11,26,37
40,8477498,Darnell Nurse,D,EDM,29,75,8,29,37
40,8480434,Sean Durzi,D,UTA,26,69,3,34,37
40,8476469,Joel Armia,R,MTL,31,66,23,13,36
40,8481618,Alex Newhook,C,MTL,23,74,18,18,36
40,8474715,Cameron Atkinson,R,TBL,35,79,18,18,36
40,8470621,Corey Perry,R,EDM,39,71,18,18,36
40,8477952,Robby Fabbri,C,ANA,28,62,18,18,36
40,8478057,Dakota Joshua,C,VAN,28,64,17,19,36
40,8474149,Evgenii Dadonov,R,DAL,35,81,17,19,36
40,8477429,Andrew Copp,C,DET,30,78,16,20,36
40,8476461,Sean Couturier,C,PHI,32,72,16,20,36
40,8476474,Stefan Noesen,R,NJD,31,71,16,20,36
40,8477839,Conor Sheary,L,TBL,32,81,15,21,36
40,8476927,Teddy Blueger,C,VAN,30,66,14,22,36
40,8482671,Owen Power,D,BUF,22,64,12,24,36
40,8482122,Brock Faber,D,MIN,22,75,10,26,36
40,8476897,Oskar Sundqvist,C,STL,30,69,17,18,35
40,8475768,Jaden Schwartz,C,SEA,32,68,16,19,35
40,8475220,Marcus Foligno,L,MIN,33,60,16,19,35
40,8477505,Alexander Wennberg,C,SJS,30,66,14,21,35
40,8476458,Ryan Strome,C,ANA,31,74,13,22,35
40,8478434,Keegan Kolesar,R,VGK,27,67,13,22,35
40,8484203,Bradly Nadeau,L,CAR,19,56,11,24,35
40,8477444,Andre Burakovsky,L,SEA,29,70,10,25,35
40,8476869,Brady Skjei,D,NSH,30,74,9,26,35
40,8476892,Colton Parayko,D,STL,31,71,8,27,35
40,8476885,Jacob Trouba,D,NYR,30,68,8,27,35
40,8478500,Ivan Provorov,D,CBJ,27,77,3,32,35
40,8476979,Erik Gustafsson,D,DET,32,79,2,33,35
40,8475314,Anders Lee,L,NYI,34,74,19,15,34
40,8483524,Shane Wright,C,SEA,20,60,19,15,34
40,8481596,Shane Pinto,C,OTT,24,74,18,16,34
40,8475799,Nino Niederreiter,R,WPG,32,67,16,18,34
40,8483468,Jiri Kulich,C,BUF,20,56,16,18,34
40,8477987,Ryan Donato,C,CHI,28,61,16,18,34
40,8480185,Eetu Luostarinen,C,FLA,26,74,13,21,34
40,8478413,Jordan Greenway,L,BUF,27,68,13,21,34
40,8478458,John (Jack) Roslovic,C,CAR,27,64,11,23,34
40,8478055,Gustav Forsling,D,FLA,28,75,5,29,34
40,8475764,Cam Fowler,D,ANA,33,73,4,30,34
40,8480817,K'Andre Miller,D,NYR,24,70,1,33,34
40,8476392,Adam Lowry,C,WPG,31,64,16,17,33
40,8477450,Jason Dickinson,C,CHI,29,66,14,19,33
40,8474716,Jared Spurgeon,D,MIN,35,79,9,24,33
40,8477495,Seth Jones,D,CHI,30,70,8,25,33
40,8477948,Travis Sanheim,D,PHI,28,72,7,26,33
40,8475722,Jason Zucker,L,BUF,32,69,18,14,32
40,8480188,Fabian Zetterlund,L,SJS,25,63,16,16,32
40,8479339,Patrik Laine,L,CBJ,26,64,15,17,32
40,8480459,Pius Suter,C,VAN,28,70,15,17,32
40,8478463,Anthony Beauvillier,L,PIT,27,67,15,17,32
40,8480205,Emil Bemstrom,C,PIT,25,59,13,19,32
40,8476921,Jordan Martinook,L,CAR,32,67,13,19,32
40,8478840,Will Borgen,D,SEA,28,71,7,25,32
40,8482089,Jake Neighbours,L,STL,22,74,19,12,31
40,8482679,Matt Coronato,R,CGY,22,68,17,14,31
40,8482146,Luke Evangelista,R,NSH,22,66,17,14,31
40,8481582,Nicholas Robertson,L,TOR,23,69,17,14,31
40,8477947,Sonny Milano,L,WSH,28,58,16,15,31
40,8476419,Jean-Gabriel Pageau,C,NYI,32,74,15,16,31
40,8482749,Joshua Roy,R,MTL,21,70,15,16,31
40,8476480,Vladislav Namestnikov,C,WPG,32,66,9,22,31
40,8480336,Sean Walker,D,CAR,30,71,4,27,31
40,8479941,Justin Danforth,R,CBJ,31,62,18,12,30
40,8471698,T.J. Oshie,R,WSH,38,65,17,13,30
40,8477425,Miles Wood,L,COL,29,77,16,14,30
40,8479393,Noah Gregor,L,OTT,26,73,16,14,30
40,8480849,Barrett Hayton,C,UTA,24,69,14,16,30
40,8479390,Taylor Raddysh,R,WSH,26,68,12,18,30
40,8475200,Dmitry Orlov,D,CAR,33,74,12,18,30
40,8479315,Joey Anderson,R,CHI,26,54,10,20,30
40,8475149,Marcus Johansson,L,MIN,34,56,9,21,30
40,8477969,Marcus Pettersson,D,PIT,28,77,7,23,30
40,8476917,Adam Pelech,D,NYI,30,80,5,25,30
40,8477220,Nate Schmidt,D,FLA,33,67,2,28,30
40,8480835,Jack Drury,C,CAR,24,59,18,11,29
40,8476981,Josh Anderson,R,MTL,30,73,18,11,29
40,8480220,Noah Cates,L,PHI,25,67,12,17,29
40,8478046,Danton Heinen,L,VAN,29,72,11,18,29
40,8482245,Artem Zub,D,OTT,29,70,7,22,29
40,8478133,Jake Evans,C,MTL,28,65,7,22,29
40,8478882,Vladislav Gavrikov,D,LAK,29,71,6,23,29
40,8480873,Rasmus Sandin,D,WSH,24,61,5,24,29
40,8481542,Moritz Seider,D,DET,23,75,4,25,29
40,8476854,Hampus Lindholm,D,BOS,30,71,3,26,29
40,8479293,Brandon Tanev,L,SEA,33,62,17,11,28
40,8477903,Garnet Hathaway,R,PHI,33,67,16,12,28
40,8479591,Michael Eyssimont,C,TBL,28,80,13,15,28
40,8475793,Ryan Johansen,C,PHI,32,73,11,17,28
40,8476872,Scott Laughton,C,PHI,30,78,11,17,28
40,8481580,Connor McMichael,C,WSH,23,67,11,17,28
40,8480144,David Kampf,C,TOR,29,74,8,20,28
40,8482117,Lukas Reichel,L,CHI,22,53,8,20,28
40,8479371,Dante Fabbro,D,NSH,26,68,4,24,28
40,8476931,Jake McCabe,D,TOR,31,69,2,26,28
40,8477953,Kasperi Kapanen,R,STL,28,70,16,11,27
40,8482079,Marco Rossi,C,MIN,23,61,15,12,27
40,8480762,Eric Robinson,L,CAR,29,62,15,12,27
40,8482175,JJ Peterka,R,BUF,22,63,13,14,27
40,8479351,Sam Steel,C,DAL,26,79,13,14,27
40,8483499,Liam Ohgren,L,MIN,20,57,13,14,27
40,8480113,Alex Iafallo,L,WPG,31,63,12,15,27
40,8476457,Adam Larsson,D,SEA,32,68,12,15,27
40,8477406,Mattias Janmark,C,EDM,32,65,11,16,27
40,8481601,Simon Holmstrom,R,NYI,23,70,11,16,27
40,8482125,Alexander Holtz,R,VGK,22,68,10,17,27
40,8474563,Drew Doughty,D,LAK,35,67,8,19,27
40,8479639,Dylan Coghlan,D,WPG,26,64,7,20,27
40,8480043,Timothy Liljegren,D,TOR,25,69,2,25,27
40,8474673,TJ Brodie,D,CHI,34,65,2,25,27
40,8482259,Bobby McMann,C,TOR,28,57,14,12,26
40,8475855,Jesper Fast,R,CAR,33,61,13,13,26
40,8480074,Alexandre Texier,C,STL,25,58,11,15,26
40,8480078,Filip Chytil,C,NYR,25,69,10,16,26
40,8477919,Frederick Gaudreau,C,MIN,31,63,9,17,26
40,8477369,Carson Soucy,D,VAN,30,61,9,17,26
40,8481606,Jordan Spence,D,LAK,23,73,6,20,26
40,8480145,Neal Pionk,D,WPG,29,73,5,21,26
40,8478508,Yakov Trenin,C,MIN,27,60,14,11,25
40,8476278,Colin Blackwell,C,DAL,31,74,12,13,25
40,8475848,Brendan Gallagher,R,MTL,32,67,12,13,25
40,8479336,Carl Grundstrom,R,SJS,27,62,12,13,25
40,8481704,Juuso Parssinen,C,NSH,23,56,11,14,25
40,8476902,Esa Lindell,D,DAL,30,78,11,14,25
40,8478911,Matt Roy,D,WSH,29,66,8,17,25
40,8478451,Ethan Bear,D,WSH,27,55,7,18,25
40,8478891,Mason Appleton,C,WPG,28,59,6,19,25
40,8483490,Pavel Mintyukov,D,ANA,21,70,5,20,25
40,8480878,Nils Lundkvist,D,DAL,24,67,5,20,25
40,8481059,Scott Perunovich,D,STL,26,57,4,21,25
40,8476879,Cody Ceci,D,EDM,31,65,4,21,25
40,8482655,Janis Moser,D,TBL,24,79,3,22,25
40,8474151,Ryan McDonagh,D,TBL,35,77,2,23,25
40,8482712,Oskar Olausson,R,COL,22,76,0,25,25
40,8480893,Kirill Marchenko,R,CBJ,24,62,19,5,24
40,8481481,Blake Lizotte,C,PIT,27,64,13,11,24
40,8481554,Kaapo Kakko,R,NYR,23,68,12,12,24
40,8473422,Nick Foligno,L,CHI,37,61,12,12,24
40,8477989,Christian Dvorak,C,MTL,28,62,12,12,24
40,8476918,Jimmy Vesey,L,NYR,31,63,11,13,24
40,8477392,Hudson Fasching,R,NYI,29,68,11,13,24
40,8479353,Brett Howden,C,VGK,26,72,10,14,24
40,8483445,Cutter Gauthier,L,ANA,20,61,9,15,24
40,8475231,Casey Cizikas,C,NYI,33,73,8,16,24
40,8479370,Tyson Jost,C,CAR,26,60,8,16,24
40,8480871,Adam Boqvist,D,FLA,24,68,7,17,24
40,8476463,Jonas Brodin,D,MIN,31,76,6,18,24
40,8475181,Nick Leddy,D,STL,33,73,2,22,24
40,8475193,Tomas Tatar,L,NJD,34,64,16,7,23
40,8482055,Drew O'Connor,L,PIT,26,62,14,9,23
40,8476329,Travis Boyd,C,MIN,31,56,11,12,23
40,8478020,Michael Amadio,R,OTT,28,75,10,13,23
40,8482111,Justin Barron,D,MTL,23,68,7,16,23
40,8479398,Samuel Girard,D,COL,26,58,4,19,23
40,8477845,Trevor van Riemsdyk,D,WSH,33,52,4,19,23
40,8475455,Brenden Dillon,D,NJD,34,62,3,20,23
40,8473563,Nicklas Backstrom,C,WSH,37,54,2,21,23
40,8478432,Christian Fischer,R,DET,27,71,15,7,22
40,8482475,Yegor Chinakhov,R,CBJ,23,59,14,8,22
40,8473533,Jordan Staal,C,CAR,36,60,12,10,22
40,8479996,Cody Glass,C,NSH,25,60,8,14,22
40,8479661,Tanner Jeannot,L,LAK,27,74,8,14,22
40,8482964,Arber Xhekaj,D,MTL,23,55,8,14,22
40,8480003,Jesper Boqvist,C,FLA,26,69,7,15,22
40,8481546,Cam York,D,PHI,23,67,5,17,22
40,8476891,Matthew Grzelcyk,D,PIT,30,78,5,17,22
40,8480073,Erik Brannstrom,D,COL,25,66,5,17,22
40,8481703,Valtteri Puustinen,R,PIT,25,59,4,18,22
40,8481441,Joe Snively,C,DET,28,63,4,18,22
40,8477488,Brett Pesce,D,NJD,30,75,3,19,22
40,8479619,Michael Carcone,L,UTA,28,67,16,5,21
40,8475343,Nic Dowd,C,WSH,34,60,11,10,21
40,8480855,Jack McBain,C,UTA,24,68,11,10,21
40,8480748,Kiefer Sherwood,L,VAN,29,62,11,10,21
40,8480813,Joe Veleno,C,DET,24,76,10,11,21
40,8478109,Victor Olofsson,L,VGK,29,66,10,11,21
40,8481537,Nikita Okhotiuk,D,CGY,24,55,9,12,21
40,8473453,Trevor Lewis,C,LAK,37,76,9,12,21
40,8482148,Hendrix Lapierre,C,WSH,22,58,8,13,21
40,8479066,Ryan Lomberg,L,CGY,30,65,7,14,21
40,8479402,Jake Bean,D,CGY,26,66,5,16,21
40,8479980,Nicolas Hague,D,VGK,26,51,5,16,21
40,8476422,Mike Reilly,D,NYI,31,77,4,17,21
40,8482624,Daniil Miromanov,D,CGY,27,63,3,18,21
40,8482737,Zack Bolduc,C,STL,21,57,13,7,20
40,8481553,Bobby Brink,R,PHI,23,57,11,9,20
40,8480995,Pontus Holmberg,R,TOR,25,50,11,9,20
40,8480980,Connor Dewar,C,TOR,25,70,10,10,20
40,8476878,Zemgus Girgensons,C,TBL,30,82,10,10,20
40,8481522,Peyton Krebs,C,BUF,23,49,9,11,20
40,8477018,Ben Hutton,D,VGK,31,51,8,12,20
40,8478399,Jonas Siegenthaler,D,NJD,27,60,7,13,20
40,8476960,Andreas Athanasiou,C,CHI,30,54,7,13,20
40,8477979,Nicolas Aube-Kubel,R,BUF,28,63,6,14,20
40,8479998,Mikey Anderson,D,LAK,25,62,5,15,20
40,8476467,Jamie Oleksiak,D,SEA,32,64,4,16,20
40,8473507,Jeff Petry,D,DET,37,69,4,16,20
40,8478416,Erik Cernak,D,TBL,27,72,4,16,20
40,8480192,Johnathan Kovacevic,D,NJD,27,50,4,16,20
40,8475171,Oliver Ekman-Larsson,D,TOR,33,67,3,17,20
40,8480860,Kevin Bahl,D,CGY,24,61,3,17,20
40,8476429,Scott Mayfield,D,NYI,32,76,1,19,20
40,8475233,David Savard,D,MTL,34,67,0,20,20
40,8482077,Dylan Holloway,L,EDM,23,64,13,6,19
40,8475791,Taylor Hall,L,CHI,33,56,10,9,19
40,8482176,Wyatt Kaiser,D,CHI,22,51,9,10,19
40,8480789,Oliver Wahlstrom,R,NYI,24,71,7,12,19
40,8478569,Noel Acciari,C,PIT,33,59,7,12,19
40,8477435,Ryan Graves,D,PIT,29,76,7,12,19
40,8479369,Andrew Peeke,D,BOS,26,63,7,12,19
40,8480068,Ryan Poehling,C,PHI,25,65,5,14,19
40,8478136,Jake Middleton,D,MIN,28,70,5,14,19
40,8479368,Max Jones,L,BOS,26,63,5,14,19
40,8474574,Tyler Myers,D,VAN,34,70,4,15,19
40,8476525,Colin Miller,D,WPG,32,64,4,15,19
40,8479983,Mario Ferraro,D,SJS,26,67,2,17,19
40,8478507,John Marino,D,UTA,27,66,2,17,19
40,8482166,Shakir Mukhamadullin,D,SJS,22,58,10,8,18
40,8474189,Lars Eller,C,PIT,35,59,9,9,18
40,8477478,William Carrier,L,CAR,30,54,9,9,18
40,8480448,Parker Kelly,L,COL,25,72,9,9,18
40,8479328,Julien Gauthier,R,NYI,27,66,9,9,18
40,8482809,Jackson Blake,R,CAR,21,57,8,10,18
40,8481477,Nico Sturm,C,SJS,29,55,7,11,18
40,8478421,A.J. Greer,L,FLA,28,62,7,11,18
40,8479291,Kevin Rooney,C,CGY,31,50,7,11,18
40,8481093,Rafael Harvey-Pinard,L,MTL,25,62,6,12,18
40,8482803,Olen Zellweger,D,ANA,21,72,6,12,18
40,8483491,Ivan Miroshnichenko,L,WSH,20,52,6,12,18
40,8479372,Joshua Mahura,D,SEA,26,51,5,13,18
40,8482142,Jamie Drysdale,D,PHI,22,68,3,15,18
40,8477365,Connor Clifton,D,BUF,29,59,3,15,18
40,8479324,Ryan Lindgren,D,NYR,26,62,2,16,18
40,8479520,Brandon Duhaime,R,WSH,27,60,14,3,17
40,8482155,Alex Laferriere,R,LAK,23,65,10,7,17
40,8478043,Sam Lafferty,C,BUF,29,60,9,8,17
40,8477931,Tomas Nosek,L,FLA,32,61,9,8,17
40,8477446,Michael McCarron,R,NSH,29,53,9,8,17
40,8481624,Ilya Mikheyev,R,CHI,30,56,6,11,17
40,8481032,Paul Cotter,C,NJD,25,61,6,11,17
40,8481019,David Gustafsson,C,WPG,24,59,6,11,17
40,8477353,Tyler Motte,C,DET,29,74,5,12,17
40,8476988,Matt Benning,D,SJS,30,67,5,12,17
40,8484149,Gavin Brindley,C,CBJ,20,46,4,13,17
40,8483482,Tristan Luneau,D,ANA,20,59,4,13,17
40,8477506,Ryan Pulock,D,NYI,30,77,3,14,17
40,8475179,Dmitry Kulikov,D,FLA,34,64,3,14,17
40,8478970,Jalen Chatfield,D,CAR,28,70,3,14,17
40,8481527,Kaedan Korczak,D,VGK,23,50,3,14,17
40,8482067,Connor Mackey,D,NYR,28,67,2,15,17
40,8478585,Derek Ryan,C,EDM,38,63,11,5,16
40,8479316,Luke Kunin,C,SJS,27,57,9,7,16
40,8481751,Lukas Rousek,R,BUF,25,41,9,7,16
40,8480289,Morgan Barron,C,WPG,26,61,8,8,16
40,8483493,Frank Nazar,C,CHI,20,41,8,8,16
40,8479414,Nathan Bastian,R,NJD,27,56,7,9,16
40,8478013,Jake Walman,D,SJS,28,71,7,9,16
40,8478452,Caleb Jones,D,LAK,27,66,7,9,16
40,8480157,Calle Rosen,D,COL,30,50,7,9,16
40,8483457,Lane Hutson,D,MTL,20,60,6,10,16
40,8481521,Ronnie Attard,D,PHI,25,60,6,10,16
40,8480252,Cole Guttman,C,CHI,25,42,6,10,16
40,8480035,Henri Jokiharju,D,BUF,25,61,5,11,16
40,8476856,Mathew Dumba,D,DAL,30,64,5,11,16
40,8481641,Joel Kiviranta,L,COL,28,72,5,11,16
40,8481517,Brett Leason,R,ANA,25,62,5,11,16
40,8482095,Tyler Kleven,D,OTT,22,44,5,11,16
40,8475690,Chris Tanev,D,TOR,35,52,4,12,16
40,8480891,Michael Kesselring,D,UTA,24,59,4,12,16
40,8481014,Alexander Romanov,D,NYI,24,74,3,13,16
40,8475462,Radko Gudas,D,ANA,34,69,2,14,16
40,8477499,Rasmus Ristolainen,D,PHI,30,63,2,14,16
40,8475790,Erik Gudbranson,D,CBJ,32,77,1,15,16
40,8475188,Brayden McNabb,D,VGK,33,55,1,15,16
40,8480806,Isac Lundestrom,C,ANA,25,56,8,7,15
40,8475225,Craig Smith,C,CHI,35,52,8,7,15
40,8477380,Jonny Brodzinski,C,NYR,31,54,8,7,15
40,8477482,Zachary Sanford,L,CHI,30,40,8,7,15
40,8480281,Alexey Toropchenko,R,STL,25,57,7,8,15
40,8481147,Reese Johnson,C,MIN,26,37,7,8,15
40,8476374,Sean Kuraly,C,CBJ,31,53,6,9,15
40,8477070,Liam O'Brien,C,UTA,30,57,5,10,15
40,8474034,Patrick Maroon,L,CHI,36,48,4,11,15
40,8480807,Mattias Samuelsson,D,BUF,24,53,4,11,15
40,8480222,Sebastian Aho,D,PIT,28,71,3,12,15
40,8482807,Ethan Del Mastro,D,CHI,21,52,3,12,15
40,8477507,Nikita Zadorov,D,BOS,29,72,3,12,15
40,8479982,Conor Timmins,D,TOR,26,57,2,13,15
40,8478851,Alexandre Carrier,D,NSH,28,67,2,13,15
40,8480049,Dylan Samberg,D,WPG,25,63,1,14,15
40,8482074,Connor Zary,C,CGY,23,55,11,3,14
40,8482157,Will Cuylle,L,NYR,22,58,9,5,14
40,8481716,Dmitri Voronkov,L,CBJ,24,48,9,5,14
40,8480848,Ty Dellandrea,C,SJS,24,49,9,5,14
40,8481754,Nikita Nesterenko,C,ANA,23,40,7,7,14
40,8477508,Curtis Lazar,C,NJD,29,61,6,8,14
40,8480796,Martin Fehervary,D,WSH,25,63,6,8,14
40,8481599,Victor Soderstrom,D,UTA,23,39,5,9,14
40,8482062,Cole Smith,L,NSH,29,54,5,9,14
40,8479976,Juuso Valimaki,D,UTA,26,64,4,10,14
40,8480001,Urho Vaakanainen,D,ANA,25,56,3,11,14
40,8480172,Jan Rutta,D,SJS,34,63,3,11,14
40,8484254,Akito Hirose,D,VAN,25,44,3,11,14
40,8480021,Jack Studnicka,C,LAK,25,61,2,12,14
40,8482087,Kaiden Guhle,D,MTL,22,67,2,12,14
40,8474567,Zach Bogosian,D,MIN,34,61,2,12,14
40,8476331,Dylan DeMelo,D,WPG,31,66,1,13,14
40,8479026,Philippe Myers,D,TOR,27,53,1,13,14
40,8475208,Brian Dumoulin,D,ANA,33,60,1,13,14
40,8476822,Luke Glendening,C,TBL,35,78,6,7,13
40,8479968,Vinni Lettieri,C,BOS,29,57,6,7,13
40,8482192,Isaak Phillips,D,CHI,23,49,4,9,13
40,8476312,Josh Manson,D,COL,33,56,4,9,13
40,8479944,Zach Aston-Reese,C,VGK,30,46,4,9,13
40,8480727,Zach Whitecloud,D,VGK,28,48,4,9,13
40,8478146,Matthew Highmore,C,OTT,28,40,4,9,13
40,8475718,Justin Holl,D,DET,32,58,3,10,13
40,8478859,Niko Mikkola,D,FLA,28,49,3,10,13
40,8476934,Brock McGinn,L,ANA,30,50,3,10,13
40,8480070,Ian Mitchell,D,BOS,25,40,3,10,13
40,8476994,Vinnie Hinostroza,C,NSH,30,48,2,11,13
40,8483565,Nick Blankenburg,D,NSH,26,64,2,11,13
40,8481178,Egor Zamula,D,PHI,24,60,1,12,13
40,8476873,Mark Jankowski,C,NSH,30,54,8,4,12
40,8477573,Nathan Walker,L,STL,30,40,5,7,12
40,8482666,Scott Morrow,D,CAR,22,51,5,7,12
40,8480845,Rasmus Kupari,C,WPG,24,37,5,7,12
40,8478211,Dryden Hunt,L,CGY,29,51,4,8,12
40,8481028,Martin Pospisil,C,CGY,25,56,4,8,12
40,8480246,Nick Perbix,D,TBL,26,74,3,9,12
40,8475842,Sam Carrick,C,NYR,32,60,3,9,12
40,8482859,Zack Ostapchuk,C,OTT,21,49,3,9,12
40,8483460,David Jiricek,D,CBJ,21,64,3,9,12
40,8476624,Barclay Goodrow,C,SJS,31,43,2,10,12
40,8482073,Braden Schneider,D,NYR,23,62,1,11,12
40,8482451,Mikael Pyyhtia,L,CBJ,23,45,1,11,12
40,8478468,Jeremy Lauzon,D,NSH,27,50,1,11,12
40,8482659,Josh Doan,R,UTA,22,55,8,3,11
40,8480025,MacKenzie Entwistle,R,FLA,25,65,7,4,11
40,8476442,Matt Nieto,L,PIT,32,53,6,5,11
40,8478409,Anthony Richard,C,PHI,28,33,6,5,11
40,8482762,Simon Edvinsson,D,DET,21,53,5,6,11
40,8475279,Ben Chiarot,D,DET,33,70,5,6,11
40,8479344,Jesse Puljujarvi,R,PIT,26,45,5,6,11
40,8480011,Klim Kostin,C,SJS,25,42,5,6,11
40,8478017,Mark Friedman,D,VAN,29,43,5,6,11
40,8482765,Isak Rosen,R,BUF,21,33,5,6,11
40,8471709,Marc-Edouard Vlasic,D,SJS,37,64,3,8,11
40,8476867,Brendan Gaunce,C,MIN,30,38,3,8,11
40,8474013,Ian Cole,D,UTA,35,58,2,9,11
40,8470600,Ryan Suter,D,STL,39,54,2,9,11
40,8481708,Zac Jones,D,NYR,24,57,2,9,11
40,8474166,Alec Martinez,D,CHI,37,48,2,9,11
40,8481701,Santeri Hatakka,D,NJD,23,38,2,9,11
40,8477938,Haydn Fleury,D,WPG,28,47,2,9,11
40,8478450,Parker Wotherspoon,D,BOS,27,40,2,9,11
40,8478178,Darren Raddysh,D,TBL,28,65,1,10,11
40,8480058,Pierre-Olivier Joseph,D,STL,25,55,1,10,11
40,8476858,Phillip Di Giuseppe,L,VAN,31,41,5,5,10
40,8479994,Jaret Anderson-Dolan,C,WPG,25,42,5,5,10
40,8475750,Jon Merrill,D,MIN,32,61,4,6,10
40,8483630,Pavol Regenda,L,ANA,25,24,4,6,10
40,8479320,Maxime Lajoie,D,SEA,27,32,4,6,10
40,8482730,Brandt Clarke,D,LAK,21,46,3,7,10
40,8481568,Alex Vlasic,D,CHI,23,58,3,7,10
40,8478443,Brandon Carlo,D,BOS,28,61,2,8,10
40,8477335,Kyle Burroughs,D,LAK,29,42,2,8,10
40,8480950,Ilya Lyubushkin,D,DAL,30,62,1,9,10
40,8476473,Connor Murphy,D,CHI,31,44,1,9,10
40,8476967,Brett Kulak,D,EDM,30,66,0,10,10
40,8475324,Nick Jensen,D,OTT,34,61,0,10,10
40,8482861,Vincent Iorio,D,WSH,22,37,0,10,10
40,8476952,Dominic Toninato,C,WPG,30,29,7,2,9
40,8471817,Ryan Reaves,R,TOR,37,54,6,3,9
40,8477015,Connor Brown,R,EDM,30,50,5,4,9
40,8479439,Jacob MacDonald,D,COL,31,50,5,4,9
40,8480007,Jonas Rondbjerg,R,VGK,25,39,5,4,9
40,8481679,Maxence Guenette,D,OTT,23,29,5,4,9
40,8482634,Alex Steeves,C,TOR,25,51,4,5,9
40,8479536,Axel Jonsson-Fjallby,L,WPG,26,33,4,5,9
40,8481167,Brayden Pachal,D,CGY,25,50,4,5,9
40,8484911,Collin Graf,R,SJS,22,36,4,5,9
40,8482733,Logan Mailloux,D,MTL,31,33,4,5,9
40,8476889,Radek Faksa,C,STL,30,60,3,6,9
40,8477887,Patrick Brown,C,BOS,32,39,3,6,9
40,8481550,Adam Beckman,L,NJD,23,37,2,7,9
40,8479671,Mathieu Olivier,R,CBJ,27,39,2,7,9
40,8474090,Brendan Smith,D,DAL,35,64,2,7,9
40,8479981,Jonah Gadjovich,L,FLA,26,47,2,7,9
40,8477384,Joshua Brown,D,EDM,30,52,2,7,9
40,8483466,Kevin Korchinski,D,CHI,20,44,1,8,9
40,8474568,Luke Schenn,D,NSH,35,44,0,9,9
40,8480355,Mark Kastelic,C,BOS,25,54,6,2,8
40,8481617,Vasily Podkolzin,R,VAN,23,46,5,3,8
40,8480880,Jakub Lauko,C,MIN,24,33,5,3,8
40,8478831,Kevin Stenlund,C,UTA,28,54,5,3,8
40,8481543,Nikita Alexandrov,C,STL,24,26,5,3,8
40,8477034,Jaycob Megna,D,FLA,32,52,4,4,8
40,8479718,Alex Barré-Boulet,C,MTL,27,44,4,4,8
40,8481567,Henry Thrun,D,SJS,23,46,3,5,8
40,8475762,Derek Forbort,D,VAN,32,43,3,5,8
40,8482744,James Malatesta,L,CBJ,21,42,3,5,8
40,8477851,Jordan Oesterle,D,BOS,32,31,3,5,8
40,8479359,Beck Malenstyn,L,BUF,26,45,3,5,8
40,8479986,Kole Lind,R,DAL,26,57,2,6,8
40,8471677,Jack Johnson,D,CBJ,37,64,2,6,8
40,8479972,Mason Shaw,C,WPG,26,42,1,7,8
40,8481592,Jakob Pelletier,L,CGY,23,43,0,8,8
40,8481556,John Beecher,C,BOS,23,35,7,0,7
40,8482652,Walker Duehr,R,CGY,27,40,5,2,7
40,8475235,Nicolas Deslauriers,L,PHI,33,44,5,2,7
40,8483570,Ben Meyers,C,SEA,26,31,4,3,7
40,8482751,Ryan Winterton,C,SEA,21,40,4,3,7
40,8475177,Calvin de Haan,D,COL,33,48,3,4,7
40,8480870,Bo Groulx,C,NYR,24,23,3,4,7
40,8482784,Zach Dean,C,STL,21,42,3,4,7
40,8476913,Devin Shore,C,MIN,30,33,3,4,7
40,8479543,Michael Pezzetta,L,MTL,26,54,2,5,7
40,8483495,Simon Nemec,D,NJD,20,49,2,5,7
40,8480879,Jacob Bernard-Docker,D,OTT,24,53,2,5,7
40,8480990,Declan Chisholm,D,MIN,24,45,2,5,7
40,8481161,Jake Christiansen,D,CBJ,25,53,2,5,7
40,8481600,Tobias Bjornfot,D,FLA,23,42,2,5,7
40,8480267,Sammy Walker,C,MIN,25,20,2,5,7
40,8479249,Andrew Poturalski,C,SJS,30,29,1,6,7
40,8479378,Logan Stanley,D,WPG,26,43,1,6,7
40,8481518,Nolan Foote,L,NJD,24,32,1,6,7
40,8473446,Erik Johnson,D,PHI,36,42,1,6,7
40,8481122,Simon Benoit,D,TOR,26,40,0,7,7
40,8482070,Mitchell Chaffee,R,TBL,26,41,5,1,6
40,8480032,Shane Bowers,C,NJD,25,12,4,2,6
40,8480851,Akil Thomas,C,LAK,24,21,4,2,6
40,8479772,Zack MacEwen,R,OTT,28,50,3,3,6
40,8482145,Mavrik Bourque,C,DAL,22,47,3,3,6
40,8477401,John Hayden,C,SEA,29,36,3,3,6
40,8482201,Gage Goncalves,C,TBL,23,30,3,3,6
40,8482516,Matthew Kessel,D,STL,24,19,3,3,6
40,8480441,Trey Fix-Wolansky,R,CBJ,25,35,2,4,6
40,8481609,Vladislav Kolyachonok,D,UTA,23,38,2,4,6
40,8479442,Troy Stecher,D,EDM,30,45,2,4,6
40,8479576,Vincent Desharnais,D,VAN,28,32,1,5,6
40,8476372,Nick Seeler,D,PHI,31,39,1,5,6
40,8476874,Olli Maatta,D,DET,30,63,0,6,6
40,8475958,Michael Sgarbossa,C,WSH,32,27,0,6,6
40,8478424,Jansen Harkins,C,ANA,27,46,0,6,6
40,8481605,Jackson LaCombe,D,ANA,23,33,0,6,6
40,8477467,Gustav Olofsson,D,SEA,30,13,5,0,5
40,8482141,Lukas Cormier,D,VGK,22,30,4,1,5
40,8482172,Landon Slaggert,L,CHI,22,26,3,2,5
40,8482511,Mason Lohrei,D,BOS,23,37,2,3,5
40,8477962,Brendan Lemieux,L,CAR,28,38,2,3,5
40,8482153,Brendan Brisson,C,VGK,23,33,2,3,5
40,8481789,Tye Kartye,L,SEA,23,43,2,3,5
40,8481743,Marc Del Gaizo,D,NSH,25,20,2,3,5
40,8483763,Maksymilian Szuber,D,UTA,22,28,2,3,5
40,8481013,Jonatan Berggren,R,DET,24,58,1,4,5
40,8481598,Philip Broberg,D,EDM,23,41,1,4,5
40,8483549,Lucas Condotta,L,MTL,27,34,1,4,5
40,8474612,Travis Hamonic,D,OTT,34,43,1,4,5
40,8479348,Kale Clague,D,BUF,26,37,1,4,5
40,8480292,Carson Meyer,R,ANA,27,37,1,4,5
40,8480834,Ty Emberson,D,SJS,24,34,1,4,5
40,8482929,Emil Lilleberg,D,TBL,23,25,1,4,5
40,8482102,Vasily Ponomarev,C,PIT,22,23,1,4,5
40,8480887,Jordan Harris,D,MTL,24,52,0,5,5
40,8482496,Nils Aman,C,VAN,24,39,0,5,5
40,8479587,Rhett Gardner,C,PHI,28,28,0,5,5
40,8477971,Andreas Englund,D,LAK,28,29,0,5,5
40,8477320,Anton Blidh,L,NYR,29,26,3,1,4
40,8481585,Egor Afanasyev,L,SJS,23,21,3,1,4
40,8478881,Brett Seney,L,CHI,28,10,3,1,4
40,8479638,Justin Brazeau,R,BOS,26,34,2,2,4
40,8480844,Grigori Denisenko,L,VGK,24,29,2,2,4
40,8481541,Samuel Bolduc,D,NYI,24,27,2,2,4
40,8483012,Logan Morrison,C,SEA,22,31,2,2,4
40,8482858,Ryker Evans,D,SEA,23,23,2,2,4
40,8482177,Marat Khusnutdinov,C,MIN,22,30,2,2,4
40,8482470,Ilya Solovyov,D,CGY,24,20,2,2,4
40,8481532,Alex Turcotte,C,LAK,23,42,1,3,4
40,8483619,Filip Roos,D,OTT,25,35,1,3,4
40,8478454,Noah Juulsen,D,VAN,27,32,1,3,4
40,8477462,Robert Hagg,D,VGK,29,23,1,3,4
40,8479985,Cale Fleury,D,SEA,26,22,1,3,4
40,8480823,Alexander Alexeyev,D,WSH,25,10,1,3,4
40,8475413,Justin Dowling,C,NJD,34,15,1,3,4
40,8482747,Brennan Othmann,L,NYR,21,32,0,4,4
40,8476441,Joel Edmundson,D,LAK,31,31,0,4,4
40,8478021,William Lagesson,D,DET,28,25,0,4,4
40,8480890,Jan Jenik,C,OTT,24,24,3,0,3
40,8482144,Jack Thompson,D,SJS,22,22,3,0,3
40,8477149,Scott Sabourin,R,SJS,32,15,3,0,3
40,8484325,Waltteri Merela,C,TBL,26,22,3,0,3
40,8482147,Jean-Luc Foudy,C,COL,22,24,3,0,3
40,8479379,Givani Smith,R,SJS,26,33,2,1,3
40,8480196,Jacob Bryson,D,BUF,27,44,2,1,3
40,8477527,Ross Johnston,L,ANA,30,34,2,1,3
40,8480245,Olle Lycksell,R,PHI,25,26,2,1,3
40,8483512,Matthew Savoie,C,EDM,20,22,2,1,3
40,8479991,Jake Leschyshyn,C,NYR,25,27,1,2,3
40,8480874,Adam Ginning,D,PHI,24,10,1,2,3
40,8474062,Riley Nash,C,NYR,35,22,1,2,3
40,8480084,Nick DeSimone,D,NJD,30,17,1,2,3
40,8479367,William Lockwood,R,FLA,26,15,1,2,3
40,8481065,Angus Crookshank,L,OTT,25,13,1,2,3
40,8478874,Adam Gaudette,R,OTT,28,37,0,3,3
40,8477810,Joel Hanley,D,CGY,33,23,0,3,3
40,8481056,Spencer Stastney,D,NSH,24,33,2,0,2
40,8481237,Kyle MacLean,C,NYI,25,24,2,0,2
40,8477473,Justin Bailey,R,SJS,29,24,1,1,2
40,8479419,Brett Murray,L,BUF,26,19,1,1,2
40,8484258,Sam Malinski,D,COL,26,21,1,1,2
40,8484287,Cole McWard,D,VAN,23,24,1,1,2
40,8482094,Daemon Hunt,D,MIN,22,11,1,1,2
40,8477244,Chad Ruhwedel,D,NYR,34,30,1,1,2
40,8481726,Adam Edstrom,C,NYR,24,11,1,1,2
40,8482460,Matt Rempe,C,NYR,22,12,1,1,2
40,8483567,Georgii Merkulov,C,BOS,24,8,1,1,2
40,8476323,Max McCormick,L,SEA,32,4,1,1,2
40,8478502,Dennis Gilbert,D,BUF,28,22,0,2,2
40,8483397,Marc McLaughlin,C,BOS,25,35,0,2,2
40,8481806,Louis Crevier,D,CHI,23,11,0,2,2
40,8477073,Kurtis MacDermid,L,NJD,30,36,0,2,2
40,8481030,Jack St. Ivany,D,PIT,25,16,0,2,2
40,8480468,James Hamblin,L,EDM,25,20,0,2,2
40,8479330,Brandon Gignac,C,MTL,27,9,0,2,2
40,8478051,Max Willman,C,NJD,29,16,0,2,2
40,8482713,Mackie Samoskevich,R,FLA,22,33,1,0,1
40,8481462,Mason Morelli,L,VGK,28,18,1,0,1
40,8482165,Yan Kuznetsov,D,CGY,22,11,1,0,1
40,8482061,Brandon Biro,L,SEA,26,12,1,0,1
40,8481719,Maxwell Crozier,D,TBL,24,13,1,0,1
40,8481422,Jake Lucchini,C,NSH,29,15,1,0,1
40,8482088,Justin Sourdif,R,FLA,22,19,1,0,1
40,8483597,Milos Kelemen,L,UTA,25,13,1,0,1
40,8483432,Luca Del Bel Belluz,C,CBJ,31,9,1,0,1
40,8482250,Callahan Burke,C,VGK,27,18,0,1,1
40,8478477,Mitchell Stephens,C,SEA,27,20,0,1,1
40,8480075,Cameron Crotty,D,MIN,25,14,0,1,1
40,8481699,Aku Raty,R,UTA,23,9,0,1,1
40,8482118,Sam Colangelo,R,ANA,23,17,0,1,1
40,8475795,Dylan McIlrath,D,WSH,32,12,0,1,1
40,8481043,Cole Koepke,L,BOS,26,16,0,1,1
40,8481024,Linus Karlsson,C,VAN,25,10,0,1,1
40,8481593,Jayden Struble,D,MTL,23,18,0,1,1
40,8482787,Nikita Chibrikov,R,WPG,31,7,0,1,1
40,8484304,Uvis Balinskis,D,FLA,28,5,0,1,1
40,8477993,Justin Kirkland,C,CGY,28,5,0,1,1
40,8482476,Emil Heineman,L,MTL,23,10,0,1,1
40,8478854,Ryan Shea,D,PIT,27,4,0,1,1
40,8484255,Jason Polin,R,COL,25,5,0,1,1
40,8479522,Hardy Haman Aktell,D,WSH,26,4,0,1,1
40,8484321,Nikolas Matinpalo,D,OTT,26,6,0,1,1
40,8479362,Riley Tufte,L,BOS,26,18,0,0,0
40,8478011,Louie Belpedio,D,PHI,28,10,0,0,0
40,8483489,Fraser Minten,C,TOR,31,13,0,0,0
40,8483531,Brian Halonen,L,NJD,25,2,0,0,0
40,8477541,Dakota Mermis,D,TOR,30,8,0,0,0
40,8483395,Arshdeep Bains,L,VAN,23,4,0,0,0
40,8475755,Alexander Petrovic,D,DAL,32,8,0,0,0
40,8483546,Marshall Rifai,D,TOR,26,6,0,0,0
40,8481578,Graeme Clarke,R,MIN,23,8,0,0,0
40,8482162,Roby Jarventie,L,EDM,22,14,0,0,0
40,8481006,Tyler Tucker,D,STL,24,11,0,0,0
40,8481206,John Ludvig,D,PIT,24,10,0,0,0
40,8480306,Grant Hutton,D,NYI,29,2,0,0,0
40,8483407,Brandon Scanlin,D,NYR,25,4,0,0,0
40,8482126,Emil Andrae,D,PHI,31,1,0,0,0
40,8475780,Chris Wagner,R,COL,33,13,0,0,0
40,8478446,Glenn Gawdin,C,LAK,27,6,0,0,0
40,8481564,Ryan Johnson,D,BUF,23,8,0,0,0
40,8483398,Declan Carlile,D,TBL,31,6,0,0,0
40,8483471,Brad Lambert,C,WPG,31,8,0,0,0
40,8479421,Jacob Moverare,D,LAK,26,5,0,0,0
40,8481655,Cole Schwindt,R,CGY,23,4,0,0,0
40,8478147,Bokondji Imama,L,PIT,28,3,0,0,0
40,8483920,Pierrick Dube,R,WSH,23,3,0,0,0
40,8481534,Raphael Lavoie,C,EDM,24,3,0,0,0
40,8483609,Adam Klapka,R,CGY,24,5,0,0,0
40,8484259,Ondrej Pavel,C,COL,31,3,0,0,0
40,8484326,Patrik Koch,D,UTA,28,2,0,0,0
40,8482197,Adam Raska,R,MIN,23,7,0,0,0
40,8480274,Philip Kemp,D,EDM,25,1,0,0,0
40,8483401,Marc Johnstone,R,PIT,28,1,0,0,0
40,8470794,Joe Pavelski,C,,40,0,0,0,0
40,8479321,Lucas Johansen,D,,27,0,0,0,0
40,8477950,Tony DeAngelo,D,,29,0,0,0,0
40,8471218,Blake Wheeler,R,,38,0,0,0,0
40,8475197,Tyson Barrie,D,,33,0,0,0,0
40,8474157,Max Pacioretty,L,,36,0,0,0,0
40,8475744,Evgeny Kuznetsov,C,,32,0,0,0,0
40,8474037,James van Riemsdyk,L,,35,0,0,0,0
40,8476907,Mackenzie MacEachern,L,,30,0,0,0,0
40,8480216,Jacob Peterson,C,,25,0,0,0,0
40,8474602,Justin Schultz,D,,34,0,0,0,0
40,8482222,Alexander Barabanov,L,,30,0,0,0,0
40,8474031,Kevin Shattenkirk,D,,35,0,0,0,0
40,8477330,Dominik Kubalik,L,,29,0,0,0,0
40,8480884,Calen Addison,D,,24,0,0,0,0
40,8475906,John Klingberg,D,,32,0,0,0,0
40,8480008,Adam Ruzicka,C,,25,0,0,0,0
40,8476884,Derrick Pouliot,D,,30,0,0,0,0
40,8476919,Chris Tierney,C,,30,0,0,0,0
40,8479415,Michael McLeod,C,,26,0,0,0,0
40,8474870,Tyler Johnson,C,,34,0,0,0,0
40,8470604,Jeff Carter,C,,39,0,0,0,0
40,8478104,Sammy Blais,L,,28,0,0,0,0
40,8474884,Mike Hoffman,C,,35,0,0,0,0
40,8481591,Sam Poulin,R,,23,0,0,0,0
40,8471274,Alex Goligoski,D,,39,0,0,0,0
40,8476871,Tanner Pearson,L,,32,0,0,0,0
40,8476393,Nick Cousins,C,,31,0,0,0,0
40,8479977,Kailer Yamamoto,R,,26,0,0,0,0
40,8479346,Dillon Dube,C,,26,0,0,0,0
40,8480184,Gustav Lindstrom,D,,26,0,0,0,0
40,8479376,Victor Mete,D,,26,0,0,0,0
40,8473449,Kyle Okposo,R,,36,0,0,0,0
40,8481058,Jesse Ylonen,R,,25,0,0,0,0
40,8475752,Tyler Pitlick,C,,33,0,0,0,0
40,8481239,Samuel Fagemo,L,,24,0,0,0,0
40,8480821,Filip Zadina,R,,25,0,0,0,0
40,8470966,Mark Giordano,D,,41,0,0,0,0
40,8478495,Denis Gurianov,R,,27,0,0,0,0
40,8477464,Nic Petan,C,,29,0,0,0,0
40,8478099,Kevin Labanc,R,,29,0,0,0,0
40,8482241,Radim Zohorna,L,,28,0,0,0,0
40,8474040,Sam Gagner,C,,35,0,0,0,0
40,8479514,Rem Pitlick,C,,27,0,0,0,0
40,8478430,Oliver Kylington,D,,27,0,0,0,0
40,8479533,Joona Koppanen,L,,26,0,0,0,0
40,8479984,Cal Foote,D,,26,0,0,0,0
40,8477126,Jayson Megna,C,,34,0,0,0,0
40,8475164,Jakob Silfverberg,R,,34,0,0,0,0
40,8474009,Nick Bonino,C,,36,0,0,0,0
40,8479458,Nikita Zaitsev,D,,33,0,0,0,0
40,8477944,Jakub Vrana,L,,28,0,0,0,0
40,8471699,Andrew Cogliano,C,,37,0,0,0,0
40,8478067,Oskar Lindblom,L,,28,0,0,0,0
40,8471686,Marc Staal,D,,37,0,0,0,0
40,8470610,Zach Parise,L,,40,0,0,0,0
40,8478904,Steven Lorentz,C,,28,0,0,0,0
40,8473473,Milan Lucic,L,,36,0,0,0,0
40,8480031,Maxime Comtois,L,,25,0,0,0,0
40,8478512,Austin Czarnik,C,,32,0,0,0,0
40,8473504,Cal Clutterbuck,R,,37,0,0,0,0
40,8477454,Adam Erne,L,,29,0,0,0,0
40,8479383,Boris Katchouk,L,,26,0,0,0,0
40,8475825,Jani Hakanpää,D,,32,0,0,0,0
40,8477846,Ryan Carpenter,C,,33,0,0,0,0
40,8477930,Pierre-Edouard Bellemare,L,,39,0,0,0,0
40,8478400,Colin White,C,,27,0,0,0,0
40,8480226,Marián Studenic,R,,26,0,0,0,0
40,8480853,Liam Foudy,C,,24,0,0,0,0
40,8475797,Jarred Tinordi,D,,32,0,0,0,0
40,8479423,Alex Nylander,L,,26,0,0,0,0
40,8474618,Marco Scandella,D,,34,0,0,0,0
40,8478028,Fredrik Olofsson,L,,28,0,0,0,0
40,8474709,Matt Martin,L,,35,0,0,0,0
40,8481070,Hugh McGing,L,,26,0,0,0,0
40,8479546,Oskar Steen,C,,26,0,0,0,0
40,8474145,Robert Bortuzzo,D,,35,0,0,0,0
40,8476915,Jujhar Khaira,L,,30,0,0,0,0
40,8475278,Byron Froese,C,,33,0,0,0,0
40,8481812,Nikolai Knyzhov,D,,27,0,0,0,0
40,8478408,Travis Dermott,D,,28,0,0,0,0
40,8481077,John Leonard,L,,26,0,0,0,0
40,8479547,Matthew Phillips,R,,26,0,0,0,0
40,8480836,Jonathan Gruden,C,,24,0,0,0,0
40,8481690,Tyler Angle,C,,24,0,0,0,0
40,8475766,Austin Watson,L,,32,0,0,0,0
40,8481016,Ruslan Iskhakov,C,,24,0,0,0,0
40,8478078,Rourke Chartier,C,,28,0,0,0,0
40,8480776,Sheldon Rempal,R,,29,0,0,0,0
40,8478956,Samuel Laberge,L,NJD,27,0,0,0,0
40,8483045,Cameron Butler,R,CBJ,31,2,0,0,0
40,8484314,Jiri Smejkal,L,,28,0,0,0,0
41,8478402,Connor McDavid,C,EDM,27,77,43,95,138
41,8476453,Nikita Kucherov,R,TBL,31,82,46,87,133
41,8481559,Jack Hughes,C,NJD,23,71,44,89,133
41,8477492,Nathan MacKinnon,C,COL,29,81,45,85,130
41,8479314,Matthew Tkachuk,L,FLA,27,81,47,81,128
41,8477934,Leon Draisaitl,C,EDM,29,80,45,82,127
41,8477956,David Pastrnak,R,BOS,28,79,58,63,121
41,8478864,Kirill Kaprizov,L,MIN,27,77,52,69,121
41,8477939,William Nylander,R,TOR,28,81,50,60,110
41,8480069,Cale Makar,D,COL,26,74,25,83,108
41,8478550,Artemi Panarin,L,NYR,33,76,34,69,103
41,8480002,Nico Hischier,C,NJD,25,74,44,58,102
41,8477501,Valeri Nichushkin,R,COL,29,81,51,49,100
41,8471675,Sidney Crosby,C,PIT,37,77,43,57,100
41,8478420,Mikko Rantanen,R,COL,28,78,51,48,99
41,8479318,Auston Matthews,C,TOR,27,78,59,38,97
41,8478483,Mitch Marner,R,TOR,27,78,27,69,96
41,8476887,Filip Forsberg,L,NSH,30,78,43,50,93
41,8478449,Roope Hintz,C,DAL,28,82,42,51,93
41,8480800,Quinn Hughes,D,VAN,25,72,9,83,92
41,8477933,Sam Reinhart,C,FLA,29,76,38,53,91
41,8476459,Mika Zibanejad,C,NYR,31,79,37,53,90
41,8476468,J.T. Miller,C,VAN,31,76,33,57,90
41,8478445,Mathew Barzal,C,NYI,27,78,31,58,89
41,8482116,Tim Stützle,C,OTT,22,79,30,59,89
41,8478439,Travis Konecny,R,PHI,27,78,40,48,88
41,8473419,Brad Marchand,L,BOS,36,82,32,56,88
41,8477409,Carter Verhaeghe,C,FLA,29,77,44,43,87
41,8480830,Andrei Svechnikov,R,CAR,24,77,34,52,86
41,8482740,Wyatt Johnston,C,DAL,21,82,50,34,84
41,8477942,Kevin Fiala,L,LAK,28,81,38,46,84
41,8477946,Dylan Larkin,C,DET,28,82,38,46,84
41,8480012,Elias Pettersson,C,VAN,26,76,29,55,84
41,8480027,Jason Robertson,L,DAL,25,80,39,43,82
41,8478403,Jack Eichel,C,VGK,28,80,34,48,82
41,8475168,Matt Duchene,C,DAL,33,81,25,57,82
41,8480023,Robert Thomas,C,STL,25,77,20,62,82
41,8478427,Sebastian Aho,C,CAR,27,65,41,40,81
41,8476460,Mark Scheifele,C,WPG,31,77,37,44,81
41,8479407,Jesper Bratt,L,NJD,26,71,33,48,81
41,8480036,Miro Heiskanen,D,DAL,25,74,12,69,81
41,8479343,Clayton Keller,R,UTA,26,77,32,48,80
41,8478398,Kyle Connor,L,WPG,28,76,30,50,80
41,8476346,Johnny Gaudreau,L,CBJ,31,72,27,53,80
41,8477493,Aleksander Barkov,C,FLA,29,75,24,56,80
41,8477404,Jake Guentzel,C,TBL,30,82,39,40,79
41,8479385,Jordan Kyrou,C,STL,26,77,40,38,78
41,8477951,Nick Schmaltz,C,UTA,28,79,31,47,78
41,8475913,Mark Stone,R,VGK,32,76,30,48,78
41,8474564,Steven Stamkos,C,NSH,34,77,29,48,77
41,8480018,Nick Suzuki,C,MTL,25,76,35,41,76
41,8475765,Vladimir Tarasenko,R,DET,33,81,34,42,76
41,8477402,Pavel Buchnevich,L,STL,29,74,32,44,76
41,8484144,Connor Bedard,C,CHI,19,68,29,47,76
41,8480803,Evan Bouchard,D,EDM,25,76,22,54,76
41,8477504,Josh Morrissey,D,WPG,29,78,16,60,76
41,8480865,Noah Dobson,D,NYI,24,78,12,64,76
41,8478010,Brayden Point,C,TBL,28,82,39,36,75
41,8480801,Brady Tkachuk,L,OTT,25,81,36,39,75
41,8476454,Ryan Nugent-Hopkins,C,EDM,31,75,22,53,75
41,8475784,Jeff Skinner,C,EDM,32,79,34,40,74
41,8481557,Matt Boldy,L,MIN,23,71,31,43,74
41,8478460,Zach Werenski,D,CBJ,27,78,17,57,74
41,8475184,Chris Kreider,L,NYR,33,75,45,28,73
41,8475794,Tyler Seguin,C,DAL,32,81,31,42,73
41,8476389,Vincent Trocheck,C,NYR,31,79,30,42,72
41,8479323,Adam Fox,D,NYR,26,69,10,62,72
41,8479420,Tage Thompson,C,BUF,27,75,34,36,70
41,8478440,Dylan Strome,C,WSH,27,76,26,44,70
41,8477447,Shea Theodore,D,VGK,29,63,14,56,70
41,8480839,Rasmus Dahlin,D,BUF,24,73,13,57,70
41,8475166,John Tavares,C,TOR,34,76,30,39,69
41,8477949,Alex Tuch,R,BUF,28,77,22,47,69
41,8479337,Alex DeBrincat,R,DET,27,77,29,39,68
41,8474600,Roman Josi,D,NSH,34,75,22,46,68
41,8477496,Elias Lindholm,C,BOS,30,75,19,49,68
41,8480015,Owen Tippett,R,PHI,25,76,30,37,67
41,8475754,Brock Nelson,C,NYI,33,82,29,38,67
41,8475692,Mats Zuccarello,R,MIN,37,69,14,53,67
41,8477500,Bo Horvat,C,NYI,29,80,34,32,66
41,8478444,Brock Boeser,R,VAN,27,77,33,33,66
41,8476881,Tomas Hertl,C,VGK,31,75,26,40,66
41,8478873,Troy Terry,R,ANA,27,75,23,43,66
41,8475172,Nazem Kadri,C,CGY,34,77,22,44,66
41,8480208,Drake Batherson,R,OTT,26,76,22,44,66
41,8474141,Patrick Kane,R,DET,36,81,20,46,66
41,8471724,Kris Letang,D,PIT,37,76,19,47,66
41,8474578,Erik Karlsson,D,PIT,34,80,18,48,66
41,8478414,Timo Meier,R,NJD,28,68,37,28,65
41,8476539,Jonathan Marchessault,R,NSH,34,77,32,33,65
41,8477476,Artturi Lehkonen,L,COL,29,80,29,36,65
41,8477940,Nikolaj Ehlers,L,WPG,28,70,21,44,65
41,8471215,Evgeni Malkin,C,PIT,38,71,18,47,65
41,8476853,Morgan Rielly,D,TOR,30,74,12,53,65
41,8478498,Jake DeBrusk,L,VAN,28,73,29,35,64
41,8475798,Mikael Granlund,C,SJS,32,70,21,43,64
41,8482078,Lucas Raymond,L,DET,22,81,22,41,63
41,8471685,Anze Kopitar,C,LAK,37,81,24,38,62
41,8481533,Trevor Zegras,C,ANA,23,73,23,39,62
41,8477503,Max Domi,C,TOR,29,80,22,40,62
41,8475151,Kyle Palmieri,C,NYI,33,79,31,30,61
41,8477960,Adrian Kempe,R,LAK,28,81,27,34,61
41,8482093,Seth Jarvis,C,CAR,22,68,24,37,61
41,8479542,Brandon Hagel,L,TBL,26,82,23,38,61
41,8476456,Jonathan Huberdeau,C,CGY,31,76,13,48,61
41,8475167,Victor Hedman,D,TBL,34,81,11,50,61
41,8475786,Zach Hyman,L,EDM,32,77,34,26,60
41,8481540,Cole Caufield,R,MTL,23,75,29,31,60
41,8478493,Joel Eriksson Ek,C,MIN,27,75,26,34,60
41,8474590,John Carlson,D,WSH,34,68,20,40,60
41,8477964,Ivan Barbashev,C,VGK,29,77,23,36,59
41,8475810,Bryan Rust,R,PIT,32,69,26,32,58
41,8478975,Mason Marchment,L,DAL,29,81,23,35,58
41,8478047,Michael Bunting,L,PIT,29,69,23,35,58
41,8475745,Charlie Coyle,C,BOS,32,77,22,36,58
41,8482113,Anton Lundell,C,FLA,23,75,22,36,58
41,8479999,Casey Mittelstadt,C,COL,26,80,21,37,58
41,8477456,J.T. Compher,L,DET,29,78,24,33,57
41,8473994,Jamie Benn,L,DAL,35,80,22,35,57
41,8478407,Vince Dunn,D,SEA,28,72,11,46,57
41,8473512,Claude Giroux,R,OTT,36,77,22,34,56
41,8479339,Patrik Laine,L,CBJ,26,66,19,37,56
41,8474641,Adam Henrique,C,EDM,34,74,30,25,55
41,8471214,Alex Ovechkin,L,WSH,39,72,25,30,55
41,8476882,Teuvo Teravainen,C,CHI,30,68,24,31,55
41,8482699,Dylan Guenther,R,UTA,21,77,21,34,55
41,8474679,Gustav Nyquist,C,NSH,35,76,18,37,55
41,8477494,Jonathan Drouin,L,COL,29,81,14,41,55
41,8482745,Mason McTavish,C,ANA,21,75,26,28,54
41,8481068,Yegor Sharangovich,C,CGY,26,80,24,30,54
41,8478401,Pavel Zacha,C,BOS,27,78,20,34,54
41,8479325,Charlie McAvoy,D,BOS,27,74,10,44,54
41,8475158,Ryan O'Reilly,C,NSH,33,71,25,28,53
41,8483431,Logan Cooley,C,UTA,20,72,24,29,53
41,8482124,Quinton Byfield,R,LAK,22,78,21,32,53
41,8476905,Chandler Stephenson,C,SEA,30,71,20,33,53
41,8477497,Sean Monahan,C,CBJ,30,70,18,35,53
41,8470613,Brent Burns,D,CAR,39,76,13,40,53
41,8480014,Gabriel Vilardi,C,WPG,25,64,30,22,52
41,8484153,Leo Carlsson,C,ANA,20,71,21,31,52
41,8482665,Matty Beniers,C,SEA,22,69,19,33,52
41,8480028,Morgan Frost,C,PHI,25,75,18,34,52
41,8483515,Juraj Slafkovsky,L,MTL,20,72,17,35,52
41,8476462,Dougie Hamilton,D,NJD,31,70,14,38,52
41,8477932,Aaron Ekblad,D,FLA,28,73,12,40,52
41,8478397,Rasmus Andersson,D,CGY,28,68,11,41,52
41,8475763,Kevin Hayes,R,PIT,32,74,24,27,51
41,8478462,Nicolas Roy,C,VGK,27,78,20,31,51
41,8478856,Conor Garland,R,VAN,28,72,19,32,51
41,8477021,Alex Kerfoot,C,UTA,30,78,18,33,51
41,8479425,Filip Hronek,D,VAN,27,73,13,38,51
41,8477416,Oliver Bjorkstrand,R,SEA,29,76,19,31,50
41,8480039,Martin Necas,C,CAR,25,72,17,33,50
41,8475191,Reilly Smith,R,NYR,33,74,15,35,50
41,8475753,Justin Faulk,D,STL,32,75,12,38,50
41,8475169,Evander Kane,L,EDM,33,74,31,18,49
41,8476483,Rickard Rakell,R,PIT,31,76,24,25,49
41,8474102,David Perron,L,OTT,36,81,21,28,49
41,8476458,Ryan Strome,C,ANA,31,76,14,35,49
41,8477426,Nicholas Paul,L,TBL,29,82,26,22,48
41,8476399,Blake Coleman,C,CGY,33,75,24,24,48
41,8481560,Arthur Kaliyev,R,LAK,23,82,21,27,48
41,8477986,Brandon Montour,D,SEA,30,73,17,31,48
41,8478042,Viktor Arvidsson,L,EDM,31,71,13,35,48
41,8476292,Ondrej Palat,L,NJD,33,69,13,35,48
41,8476875,Mike Matheson,D,MTL,30,69,11,37,48
41,8476448,William Karlsson,C,VGK,31,73,24,23,47
41,8477935,Sam Bennett,C,FLA,28,75,23,24,47
41,8477987,Ryan Donato,C,CHI,28,54,21,26,47
41,8475170,Brayden Schenn,C,STL,33,72,19,28,47
41,8482159,Tyson Foerster,R,PHI,22,73,18,29,47
41,8477407,Anthony Duclair,L,NYI,29,76,17,30,47
41,8482097,Jack Quinn,R,BUF,23,67,17,30,47
41,8476461,Sean Couturier,C,PHI,32,70,17,30,47
41,8482684,Luke Hughes,D,NJD,21,70,6,41,47
41,8482705,Cole Sillinger,C,CBJ,21,72,23,23,46
41,8478542,Evan Rodrigues,C,FLA,31,77,16,30,46
41,8481711,Matias Maccelli,L,UTA,24,77,12,34,46
41,8478046,Danton Heinen,L,VAN,29,68,29,16,45
41,8479525,Ross Colton,C,COL,28,80,26,19,45
41,8475726,Tyler Toffoli,C,SJS,32,68,22,23,45
41,8481596,Shane Pinto,C,OTT,24,78,20,25,45
41,8476872,Scott Laughton,C,PHI,30,74,19,26,45
41,8476479,Phillip Danault,C,LAK,31,81,17,28,45
41,8477495,Seth Jones,D,CHI,30,65,13,32,45
41,8475287,Erik Haula,L,NJD,33,73,12,33,45
41,8479410,Mikhail Sergachev,D,UTA,26,64,9,36,45
41,8481542,Moritz Seider,D,DET,23,73,7,38,45
41,8482109,Alexis Lafrenière,L,NYR,23,72,24,20,44
41,8482667,William Eklund,L,SJS,22,63,21,23,44
41,8477429,Andrew Copp,C,DET,30,77,17,27,44
41,8479675,Trevor Moore,L,LAK,29,81,15,29,44
41,8480798,Philipp Kurashev,C,CHI,25,58,14,30,44
41,8478438,Tommy Novak,C,NSH,27,67,12,32,44
41,8478366,Frank Vatrano,R,ANA,30,73,26,17,43
41,8477998,Warren Foegele,L,LAK,28,81,22,21,43
41,8475793,Ryan Johansen,C,PHI,32,68,19,24,43
41,8477451,Ryan Hartman,R,MIN,30,76,18,25,43
41,8474149,Evgenii Dadonov,R,DAL,35,82,18,25,43
41,8480064,Josh Norris,C,OTT,25,74,17,26,43
41,8479400,Pierre-Luc Dubois,L,WSH,26,66,13,30,43
41,8476981,Josh Anderson,R,MTL,30,71,24,18,42
41,8480813,Joe Veleno,C,DET,24,72,21,21,42
41,8482092,Ridly Greig,C,OTT,22,77,18,24,42
41,8482175,JJ Peterka,R,BUF,22,72,18,24,42
41,8482110,Dawson Mercer,C,NJD,23,72,17,25,42
41,8480068,Ryan Poehling,C,PHI,25,68,17,25,42
41,8476392,Adam Lowry,C,WPG,31,70,16,26,42
41,8478474,Lawson Crouse,L,UTA,27,75,22,19,41
41,8482133,Thomas Bordeleau,C,SJS,22,71,15,26,41
41,8474150,Mikael Backlund,C,CGY,35,78,14,27,41
41,8476906,Shayne Gostisbehere,D,CAR,31,73,12,29,41
41,8478396,Noah Hanifin,D,VGK,27,68,11,30,41
41,8478472,Mathieu Joseph,R,STL,27,67,10,31,41
41,8480434,Sean Durzi,D,UTA,26,64,9,32,41
41,8479398,Samuel Girard,D,COL,26,62,5,36,41
41,8477955,Jared McCann,L,SEA,28,76,28,12,40
41,8474189,Lars Eller,C,PIT,35,62,22,18,40
41,8476419,Jean-Gabriel Pageau,C,NYI,32,73,16,24,40
41,8478519,Anthony Cirelli,C,TBL,27,82,15,25,40
41,8473986,Alex Killorn,L,ANA,35,71,14,26,40
41,8478055,Gustav Forsling,D,FLA,28,74,11,29,40
41,8476885,Jacob Trouba,D,NYR,30,76,8,32,40
41,8474563,Drew Doughty,D,LAK,35,67,8,32,40
41,8475764,Cam Fowler,D,ANA,33,75,7,33,40
41,8471698,T.J. Oshie,R,WSH,38,72,23,16,39
41,8477479,Tyler Bertuzzi,L,CHI,29,63,18,21,39
41,8476826,Yanni Gourde,C,SEA,33,76,16,23,39
41,8474586,Jordan Eberle,R,SEA,34,67,16,23,39
41,8478109,Victor Olofsson,L,VGK,29,74,15,24,39
41,8476480,Vladislav Namestnikov,C,WPG,32,70,13,26,39
41,8477444,Andre Burakovsky,L,SEA,29,72,12,27,39
41,8478469,Thomas Chabot,D,OTT,27,75,11,28,39
41,8476958,Jaccob Slavin,D,CAR,30,79,9,30,39
41,8480797,Joel Farabee,L,PHI,24,71,23,15,38
41,8481535,Nils Hoglander,L,VAN,24,67,23,15,38
41,8475314,Anders Lee,L,NYI,34,76,19,19,38
41,8475760,Nick Bjugstad,C,UTA,32,70,18,20,38
41,8480835,Jack Drury,C,CAR,24,55,18,20,38
41,8480188,Fabian Zetterlund,L,SJS,25,63,15,23,38
41,8480220,Noah Cates,L,PHI,25,69,13,25,38
41,8477498,Darnell Nurse,D,EDM,29,70,10,28,38
41,8476792,Torey Krug,D,STL,33,77,9,29,38
41,8477948,Travis Sanheim,D,PHI,28,66,9,29,38
41,8479987,Morgan Geekie,C,BOS,26,78,16,21,37
41,8477953,Kasperi Kapanen,R,STL,28,68,16,21,37
41,8480185,Eetu Luostarinen,C,FLA,26,70,14,23,37
41,8478466,Daniel Sprong,R,VAN,27,68,13,24,37
41,8482105,Jake Sanderson,D,OTT,22,75,11,26,37
41,8481546,Cam York,D,PHI,23,68,10,27,37
41,8475218,Mattias Ekholm,D,EDM,34,72,8,29,37
41,8474565,Alex Pietrangelo,D,VGK,34,62,6,31,37
41,8479365,Trent Frederic,C,BOS,26,82,20,16,36
41,8478413,Jordan Greenway,L,BUF,27,61,19,17,36
41,8482149,Cole Perfetti,C,WPG,22,63,17,19,36
41,8476880,Tom Wilson,R,WSH,30,70,16,20,36
41,8482702,Logan Stankoven,C,DAL,21,79,13,23,36
41,8474053,Logan Couture,C,SJS,35,68,12,24,36
41,8483490,Pavel Mintyukov,D,ANA,21,77,11,25,36
41,8476438,Brandon Saad,L,STL,32,73,24,11,35
41,8483808,Andrei Kuzmenko,L,CGY,28,74,15,20,35
41,8481528,Dylan Cozens,C,BUF,23,71,13,22,35
41,8480336,Sean Walker,D,CAR,30,71,12,23,35
41,8475714,Calle Jarnkrok,C,TOR,33,75,11,24,35
41,8481577,Philip Tomasino,C,NSH,23,69,10,25,35
41,8481703,Valtteri Puustinen,R,PIT,25,64,10,25,35
41,8480849,Barrett Hayton,C,UTA,24,71,9,26,35
41,8482712,Oskar Olausson,R,COL,22,77,6,29,35
41,8482122,Brock Faber,D,MIN,22,80,4,31,35
41,8481186,Logan O'Connor,R,COL,28,80,22,12,34
41,8475799,Nino Niederreiter,R,WPG,32,69,21,13,34
41,8476927,Teddy Blueger,C,VAN,30,74,17,17,34
41,8475193,Tomas Tatar,L,NJD,34,67,17,17,34
41,8482720,Matthew Knies,L,TOR,22,79,16,18,34
41,8475768,Jaden Schwartz,C,SEA,32,67,16,18,34
41,8477952,Robby Fabbri,C,ANA,28,71,15,19,34
41,8479351,Sam Steel,C,DAL,26,80,15,19,34
41,8482475,Yegor Chinakhov,R,CBJ,23,63,15,19,34
41,8478115,Pierre Engvall,L,NYI,28,77,14,20,34
41,8480459,Pius Suter,C,VAN,28,64,13,21,34
41,8479345,Jakob Chychrun,D,WSH,26,59,11,23,34
41,8476869,Brady Skjei,D,NSH,30,68,10,24,34
41,8475200,Dmitry Orlov,D,CAR,33,72,10,24,34
41,8482671,Owen Power,D,BUF,22,68,9,25,34
41,8480817,K'Andre Miller,D,NYR,24,73,9,25,34
41,8478038,Devon Toews,D,COL,30,65,8,26,34
41,8479976,Juuso Valimaki,D,UTA,26,64,5,29,34
41,8482146,Luke Evangelista,R,NSH,22,67,18,15,33
41,8481604,Pavel Dorofeyev,L,VGK,24,67,17,16,33
41,8475149,Marcus Johansson,L,MIN,34,68,14,19,33
41,8478432,Christian Fischer,R,DET,27,74,14,19,33
41,8479992,Michael Rasmussen,C,DET,25,78,12,21,33
41,8476923,Damon Severson,D,CBJ,30,80,9,24,33
41,8481581,Thomas Harley,D,DAL,23,73,5,28,33
41,8476917,Adam Pelech,D,NYI,30,79,4,29,33
41,8474151,Ryan McDonagh,D,TBL,35,76,4,29,33
41,8478233,Andrew Mangiapane,L,WSH,28,65,20,12,32
41,8475231,Casey Cizikas,C,NYI,33,77,18,14,32
41,8482055,Drew O'Connor,L,PIT,26,70,17,15,32
41,8476432,Boone Jenner,C,CBJ,31,62,16,16,32
41,8480829,Jesperi Kotkaniemi,C,CAR,24,65,14,18,32
41,8475855,Jesper Fast,R,CAR,33,63,14,18,32
41,8478458,John (Jack) Roslovic,C,CAR,27,69,12,20,32
41,8481523,Kirby Dach,C,MTL,23,60,11,21,32
41,8476854,Hampus Lindholm,D,BOS,30,73,6,26,32
41,8477506,Ryan Pulock,D,NYI,30,80,6,26,32
41,8482125,Alexander Holtz,R,VGK,22,73,21,10,31
41,8475722,Jason Zucker,L,BUF,32,73,19,12,31
41,8478891,Mason Appleton,C,WPG,28,65,16,15,31
41,8484166,Adam Fantilli,C,CBJ,20,66,14,17,31
41,8476921,Jordan Martinook,L,CAR,32,63,14,17,31
41,8481582,Nicholas Robertson,L,TOR,23,70,14,17,31
41,8477511,Anthony Mantha,R,CGY,30,75,13,18,31
41,8474716,Jared Spurgeon,D,MIN,35,79,11,20,31
41,8482111,Justin Barron,D,MTL,23,74,11,20,31
41,8477488,Brett Pesce,D,NJD,30,69,11,20,31
41,8480893,Kirill Marchenko,R,CBJ,24,61,18,12,30
41,8480855,Jack McBain,C,UTA,24,67,12,18,30
41,8483505,Matthew Poitras,C,BOS,20,73,9,21,30
41,8481656,Aliaksei Protas,C,WSH,23,66,8,22,30
41,8480009,Eeli Tolvanen,R,SEA,25,73,15,14,29
41,8482089,Jake Neighbours,L,STL,22,65,15,14,29
41,8478057,Dakota Joshua,C,VAN,28,65,13,16,29
41,8481618,Alex Newhook,C,MTL,23,65,12,17,29
41,8482117,Lukas Reichel,L,CHI,22,58,12,17,29
41,8477947,Sonny Milano,L,WSH,28,64,10,19,29
41,8478500,Ivan Provorov,D,CBJ,27,82,7,22,29
41,8480871,Adam Boqvist,D,FLA,24,73,7,22,29
41,8476902,Esa Lindell,D,DAL,30,75,6,23,29
41,8480878,Nils Lundkvist,D,DAL,24,76,4,25,29
41,8480043,Timothy Liljegren,D,TOR,25,63,3,26,29
41,8481032,Paul Cotter,C,NJD,25,58,20,8,28
41,8475220,Marcus Foligno,L,MIN,33,62,17,11,28
41,8479941,Justin Danforth,R,CBJ,31,53,14,14,28
41,8474715,Cameron Atkinson,R,TBL,35,81,13,15,28
41,8478463,Anthony Beauvillier,L,PIT,27,64,13,15,28
41,8477425,Miles Wood,L,COL,29,76,13,15,28
41,8480748,Kiefer Sherwood,L,VAN,29,62,12,16,28
41,8477839,Conor Sheary,L,TBL,32,79,10,18,28
41,8476925,Colton Sissons,C,NSH,31,63,5,23,28
41,8477346,MacKenzie Weegar,D,CGY,30,72,4,24,28
41,8482074,Connor Zary,C,CGY,23,65,15,12,27
41,8483445,Cutter Gauthier,L,ANA,20,69,12,15,27
41,8481524,Bowen Byram,D,BUF,23,67,10,17,27
41,8480113,Alex Iafallo,L,WPG,31,71,9,18,27
41,8476979,Erik Gustafsson,D,DET,32,73,5,22,27
41,8480873,Rasmus Sandin,D,WSH,24,72,5,22,27
41,8476463,Jonas Brodin,D,MIN,31,78,5,22,27
41,8479996,Cody Glass,C,NSH,25,54,16,10,26
41,8483524,Shane Wright,C,SEA,20,67,14,12,26
41,8477450,Jason Dickinson,C,CHI,29,66,14,12,26
41,8481554,Kaapo Kakko,R,NYR,23,71,13,13,26
41,8478020,Michael Amadio,R,OTT,28,71,13,13,26
41,8477505,Alexander Wennberg,C,SJS,30,59,11,15,26
41,8476918,Jimmy Vesey,L,NYR,31,62,11,15,26
41,8473563,Nicklas Backstrom,C,WSH,37,47,11,15,26
41,8480078,Filip Chytil,C,NYR,25,67,10,16,26
41,8473422,Nick Foligno,L,CHI,37,55,9,17,26
41,8476329,Travis Boyd,C,MIN,31,54,9,17,26
41,8481624,Ilya Mikheyev,R,CHI,30,63,9,17,26
41,8481606,Jordan Spence,D,LAK,23,65,5,21,26
41,8477969,Marcus Pettersson,D,PIT,28,79,3,23,26
41,8476469,Joel Armia,R,MTL,31,70,13,12,25
41,8475791,Taylor Hall,L,CHI,33,52,12,13,25
41,8480003,Jesper Boqvist,C,FLA,26,66,11,14,25
41,8478434,Keegan Kolesar,R,VGK,27,63,10,15,25
41,8479393,Noah Gregor,L,OTT,26,73,10,15,25
41,8484203,Bradly Nadeau,L,CAR,19,58,9,16,25
41,8470621,Corey Perry,R,EDM,39,69,8,17,25
41,8477989,Christian Dvorak,C,MTL,28,71,7,18,25
41,8473507,Jeff Petry,D,DET,37,76,6,19,25
41,8475188,Brayden McNabb,D,VGK,33,52,6,19,25
41,8482749,Joshua Roy,R,MTL,21,67,5,20,25
41,8482655,Janis Moser,D,TBL,24,77,5,20,25
41,8482809,Jackson Blake,R,CAR,21,54,13,11,24
41,8484145,Zach Benson,L,BUF,19,70,12,12,24
41,8483499,Liam Ohgren,L,MIN,20,57,10,14,24
41,8476278,Colin Blackwell,C,DAL,31,72,10,14,24
41,8480762,Eric Robinson,L,CAR,29,64,9,15,24
41,8483468,Jiri Kulich,C,BUF,20,57,8,16,24
41,8479639,Dylan Coghlan,D,WPG,26,62,6,18,24
41,8476422,Mike Reilly,D,NYI,31,74,5,19,24
41,8478507,John Marino,D,UTA,27,70,5,19,24
41,8476312,Josh Manson,D,COL,33,60,3,21,24
41,8480049,Dylan Samberg,D,WPG,25,67,1,23,24
41,8479368,Max Jones,L,BOS,26,69,15,8,23
41,8482624,Daniil Miromanov,D,CGY,27,63,12,11,23
41,8482660,Kent Johnson,C,CBJ,22,64,11,12,23
41,8482062,Cole Smith,L,NSH,29,63,11,12,23
41,8480995,Pontus Holmberg,R,TOR,25,62,10,13,23
41,8482157,Will Cuylle,L,NYR,22,63,10,13,23
41,8480145,Neal Pionk,D,WPG,29,69,9,14,23
41,8479353,Brett Howden,C,VGK,26,70,9,14,23
41,8481093,Rafael Harvey-Pinard,L,MTL,25,59,9,14,23
41,8477435,Ryan Graves,D,PIT,29,75,5,18,23
41,8478882,Vladislav Gavrikov,D,LAK,29,64,2,21,23
41,8474574,Tyler Myers,D,VAN,34,66,2,21,23
41,8481601,Simon Holmstrom,R,NYI,23,71,12,10,22
41,8476474,Stefan Noesen,R,NJD,31,70,10,12,22
41,8478133,Jake Evans,C,MTL,28,73,10,12,22
41,8479661,Tanner Jeannot,L,LAK,27,78,10,12,22
41,8480205,Emil Bemstrom,C,PIT,25,58,9,13,22
41,8477919,Frederick Gaudreau,C,MIN,31,60,9,13,22
41,8477015,Connor Brown,R,EDM,30,67,9,13,22
41,8477979,Nicolas Aube-Kubel,R,BUF,28,61,7,15,22
41,8475171,Oliver Ekman-Larsson,D,TOR,33,68,6,16,22
41,8478911,Matt Roy,D,WSH,29,64,5,17,22
41,8478013,Jake Walman,D,SJS,28,78,5,17,22
41,8476892,Colton Parayko,D,STL,31,64,4,18,22
41,8479315,Joey Anderson,R,CHI,26,51,4,18,22
41,8480035,Henri Jokiharju,D,BUF,25,58,4,18,22
41,8476879,Cody Ceci,D,EDM,31,71,3,19,22
41,8476891,Matthew Grzelcyk,D,PIT,30,73,3,19,22
41,8478399,Jonas Siegenthaler,D,NJD,27,58,3,19,22
41,8482067,Connor Mackey,D,NYR,28,56,3,19,22
41,8477380,Jonny Brodzinski,C,NYR,31,57,13,8,21
41,8481477,Nico Sturm,C,SJS,29,57,12,9,21
41,8478421,A.J. Greer,L,FLA,28,58,12,9,21
41,8480448,Parker Kelly,L,COL,25,74,10,11,21
41,8480802,Ryan McLeod,C,BUF,25,64,9,12,21
41,8477903,Garnet Hathaway,R,PHI,33,64,9,12,21
41,8480074,Alexandre Texier,C,STL,25,54,8,13,21
41,8475848,Brendan Gallagher,R,MTL,32,71,8,13,21
41,8483491,Ivan Miroshnichenko,L,WSH,20,63,8,13,21
41,8482101,Danil Gushchin,L,SJS,22,50,7,14,21
41,8477018,Ben Hutton,D,VGK,31,46,5,16,21
41,8475233,David Savard,D,MTL,34,64,4,17,21
41,8479982,Conor Timmins,D,TOR,26,56,3,18,21
41,8480172,Jan Rutta,D,SJS,34,67,2,19,21
41,8479619,Michael Carcone,L,UTA,28,67,15,5,20
41,8480144,David Kampf,C,TOR,29,68,9,11,20
41,8481553,Bobby Brink,R,PHI,23,58,9,11,20
41,8476960,Andreas Athanasiou,C,CHI,30,51,9,11,20
41,8483457,Lane Hutson,D,MTL,20,65,9,11,20
41,8479390,Taylor Raddysh,R,WSH,26,58,8,12,20
41,8478585,Derek Ryan,C,EDM,38,67,8,12,20
41,8480289,Morgan Barron,C,WPG,26,57,7,13,20
41,8479591,Michael Eyssimont,C,TBL,28,82,6,14,20
41,8482803,Olen Zellweger,D,ANA,21,65,4,16,20
41,8481527,Kaedan Korczak,D,VGK,23,47,4,16,20
41,8476331,Dylan DeMelo,D,WPG,31,66,4,16,20
41,8476457,Adam Larsson,D,SEA,32,73,3,17,20
41,8481014,Alexander Romanov,D,NYI,24,70,3,17,20
41,8482245,Artem Zub,D,OTT,29,64,2,18,20
41,8482259,Bobby McMann,C,TOR,28,64,11,8,19
41,8478508,Yakov Trenin,C,MIN,27,58,11,8,19
41,8478043,Sam Lafferty,C,BUF,29,57,10,9,19
41,8480281,Alexey Toropchenko,R,STL,25,57,10,9,19
41,8479316,Luke Kunin,C,SJS,27,61,9,10,19
41,8480355,Mark Kastelic,C,BOS,25,64,9,10,19
41,8473453,Trevor Lewis,C,LAK,37,70,7,12,19
41,8479402,Jake Bean,D,CGY,26,73,7,12,19
41,8481481,Blake Lizotte,C,PIT,27,61,6,13,19
41,8480980,Connor Dewar,C,TOR,25,61,5,14,19
41,8480073,Erik Brannstrom,D,COL,25,62,4,15,19
41,8476429,Scott Mayfield,D,NYI,32,74,4,15,19
41,8477499,Rasmus Ristolainen,D,PHI,30,58,4,15,19
41,8476988,Matt Benning,D,SJS,30,62,3,16,19
41,8479371,Dante Fabbro,D,NSH,26,62,1,18,19
41,8480058,Pierre-Olivier Joseph,D,STL,25,58,1,18,19
41,8483493,Frank Nazar,C,CHI,20,49,10,8,18
41,8481580,Connor McMichael,C,WSH,23,65,9,9,18
41,8477392,Hudson Fasching,R,NYI,29,65,9,9,18
41,8475225,Craig Smith,C,CHI,35,56,9,9,18
41,8481441,Joe Snively,C,DET,28,69,8,10,18
41,8481522,Peyton Krebs,C,BUF,23,60,8,10,18
41,8477508,Curtis Lazar,C,NJD,29,58,8,10,18
41,8477406,Mattias Janmark,C,EDM,32,63,7,11,18
41,8482148,Hendrix Lapierre,C,WSH,22,51,7,11,18
41,8477220,Nate Schmidt,D,FLA,33,65,6,12,18
41,8476856,Mathew Dumba,D,DAL,30,65,6,12,18
41,8483495,Simon Nemec,D,NJD,20,63,6,12,18
41,8482176,Wyatt Kaiser,D,CHI,22,51,5,13,18
41,8478840,Will Borgen,D,SEA,28,66,2,16,18
41,8479372,Joshua Mahura,D,SEA,26,56,1,17,18
41,8478851,Alexandre Carrier,D,NSH,28,70,0,18,18
41,8479293,Brandon Tanev,L,SEA,33,61,11,6,17
41,8481641,Joel Kiviranta,L,COL,28,70,10,7,17
41,8475343,Nic Dowd,C,WSH,34,54,7,10,17
41,8480806,Isac Lundestrom,C,ANA,25,61,7,10,17
41,8480252,Cole Guttman,C,CHI,25,36,5,12,17
41,8478136,Jake Middleton,D,MIN,28,74,3,14,17
41,8475181,Nick Leddy,D,STL,33,70,2,15,17
41,8482142,Jamie Drysdale,D,PHI,22,62,2,15,17
41,8475324,Nick Jensen,D,OTT,34,67,2,15,17
41,8474673,TJ Brodie,D,CHI,34,67,0,17,17
41,8482679,Matt Coronato,R,CGY,22,66,13,3,16
41,8479336,Carl Grundstrom,R,SJS,27,50,12,4,16
41,8476897,Oskar Sundqvist,C,STL,30,65,9,7,16
41,8479414,Nathan Bastian,R,NJD,27,65,7,9,16
41,8482155,Alex Laferriere,R,LAK,23,60,5,11,16
41,8480021,Jack Studnicka,C,LAK,25,66,5,11,16
41,8475179,Dmitry Kulikov,D,FLA,34,55,4,12,16
41,8477034,Jaycob Megna,D,FLA,32,49,4,12,16
41,8476467,Jamie Oleksiak,D,SEA,32,76,3,13,16
41,8475455,Brenden Dillon,D,NJD,34,55,2,14,16
41,8479980,Nicolas Hague,D,VGK,26,54,2,14,16
41,8482095,Tyler Kleven,D,OTT,22,48,2,14,16
41,8482087,Kaiden Guhle,D,MTL,22,62,2,14,16
41,8480246,Nick Perbix,D,TBL,26,74,2,14,16
41,8482079,Marco Rossi,C,MIN,23,55,9,6,15
41,8473533,Jordan Staal,C,CAR,36,59,8,7,15
41,8476374,Sean Kuraly,C,CBJ,31,59,8,7,15
41,8476934,Brock McGinn,L,ANA,30,43,7,8,15
41,8480025,MacKenzie Entwistle,R,FLA,25,67,7,8,15
41,8476624,Barclay Goodrow,C,SJS,31,55,6,9,15
41,8470600,Ryan Suter,D,STL,39,52,6,9,15
41,8477369,Carson Soucy,D,VAN,30,59,4,11,15
41,8475690,Chris Tanev,D,TOR,35,61,4,11,15
41,8480789,Oliver Wahlstrom,R,NYI,24,67,3,12,15
41,8480222,Sebastian Aho,D,PIT,28,75,3,12,15
41,8482073,Braden Schneider,D,NYR,23,67,3,12,15
41,8482451,Mikael Pyyhtia,L,CBJ,23,52,3,12,15
41,8483565,Nick Blankenburg,D,NSH,26,65,2,13,15
41,8478443,Brandon Carlo,D,BOS,28,64,2,13,15
41,8480891,Michael Kesselring,D,UTA,24,55,1,14,15
41,8481178,Egor Zamula,D,PHI,24,56,1,14,15
41,8476967,Brett Kulak,D,EDM,30,65,1,14,15
41,8481059,Scott Perunovich,D,STL,26,61,0,15,15
41,8475842,Sam Carrick,C,NYR,32,56,10,4,14
41,8479328,Julien Gauthier,R,NYI,27,61,9,5,14
41,8481013,Jonatan Berggren,R,DET,24,60,8,6,14
41,8479066,Ryan Lomberg,L,CGY,30,62,7,7,14
41,8477478,William Carrier,L,CAR,30,56,7,7,14
41,8479344,Jesse Puljujarvi,R,PIT,26,43,7,7,14
41,8477353,Tyler Motte,C,DET,29,74,6,8,14
41,8477070,Liam O'Brien,C,UTA,30,49,6,8,14
41,8479026,Philippe Myers,D,TOR,27,50,6,8,14
41,8479968,Vinni Lettieri,C,BOS,29,48,5,9,14
41,8476873,Mark Jankowski,C,NSH,30,43,4,10,14
41,8482634,Alex Steeves,C,TOR,25,46,4,10,14
41,8481550,Adam Beckman,L,NJD,23,38,4,10,14
41,8481019,David Gustafsson,C,WPG,24,44,3,11,14
41,8481521,Ronnie Attard,D,PHI,25,59,3,11,14
41,8475462,Radko Gudas,D,ANA,34,62,3,11,14
41,8482192,Isaak Phillips,D,CHI,23,50,3,11,14
41,8476931,Jake McCabe,D,TOR,31,68,2,12,14
41,8479369,Andrew Peeke,D,BOS,26,66,2,12,14
41,8479249,Andrew Poturalski,C,SJS,30,36,2,12,14
41,8476525,Colin Miller,D,WPG,32,65,1,13,14
41,8477365,Connor Clifton,D,BUF,29,60,1,13,14
41,8479324,Ryan Lindgren,D,NYR,26,58,1,13,14
41,8478970,Jalen Chatfield,D,CAR,28,71,1,13,14
41,8478859,Niko Mikkola,D,FLA,28,61,1,13,14
41,8480807,Mattias Samuelsson,D,BUF,24,53,0,14,14
41,8478831,Kevin Stenlund,C,UTA,28,54,10,3,13
41,8478569,Noel Acciari,C,PIT,33,56,8,5,13
41,8478424,Jansen Harkins,C,ANA,27,40,8,5,13
41,8477482,Zachary Sanford,L,CHI,30,43,7,6,13
41,8482737,Zack Bolduc,C,STL,21,57,6,7,13
41,8474034,Patrick Maroon,L,CHI,36,48,6,7,13
41,8476889,Radek Faksa,C,STL,30,59,6,7,13
41,8479370,Tyson Jost,C,CAR,26,56,5,8,13
41,8480848,Ty Dellandrea,C,SJS,24,48,5,8,13
41,8481704,Juuso Parssinen,C,NSH,23,51,4,9,13
41,8477931,Tomas Nosek,L,FLA,32,57,4,9,13
41,8481517,Brett Leason,R,ANA,25,49,4,9,13
41,8477573,Nathan Walker,L,STL,30,55,4,9,13
41,8478178,Darren Raddysh,D,TBL,28,65,4,9,13
41,8479439,Jacob MacDonald,D,COL,31,52,3,10,13
41,8481567,Henry Thrun,D,SJS,23,40,3,10,13
41,8475208,Brian Dumoulin,D,ANA,33,69,2,11,13
41,8475279,Ben Chiarot,D,DET,33,71,2,11,13
41,8481568,Alex Vlasic,D,CHI,23,54,2,11,13
41,8477851,Jordan Oesterle,D,BOS,32,41,2,11,13
41,8479986,Kole Lind,R,DAL,26,54,2,11,13
41,8475790,Erik Gudbranson,D,CBJ,32,75,1,12,13
41,8476878,Zemgus Girgensons,C,TBL,30,81,10,2,12
41,8481518,Nolan Foote,L,NJD,24,39,9,3,12
41,8482166,Shakir Mukhamadullin,D,SJS,22,60,8,4,12
41,8482762,Simon Edvinsson,D,DET,21,49,8,4,12
41,8483482,Tristan Luneau,D,ANA,20,60,7,5,12
41,8481679,Maxence Guenette,D,OTT,23,39,7,5,12
41,8476442,Matt Nieto,L,PIT,32,44,6,6,12
41,8479543,Michael Pezzetta,L,MTL,26,57,6,6,12
41,8482730,Brandt Clarke,D,LAK,21,50,5,7,12
41,8481537,Nikita Okhotiuk,D,CGY,24,57,4,8,12
41,8480860,Kevin Bahl,D,CGY,24,51,4,8,12
41,8480011,Klim Kostin,C,SJS,25,41,4,8,12
41,8484149,Gavin Brindley,C,CBJ,20,49,3,9,12
41,8481161,Jake Christiansen,D,CBJ,25,63,3,9,12
41,8480887,Jordan Harris,D,MTL,24,60,3,9,12
41,8480070,Ian Mitchell,D,BOS,25,52,2,10,12
41,8480796,Martin Fehervary,D,WSH,25,49,1,11,12
41,8474090,Brendan Smith,D,DAL,35,48,1,11,12
41,8481028,Martin Pospisil,C,CGY,25,54,7,4,11
41,8483012,Logan Morrison,C,SEA,22,36,7,4,11
41,8482077,Dylan Holloway,L,EDM,23,47,6,5,11
41,8480441,Trey Fix-Wolansky,R,CBJ,25,40,6,5,11
41,8479944,Zach Aston-Reese,C,VGK,30,45,5,6,11
41,8478211,Dryden Hunt,L,CGY,29,53,5,6,11
41,8482859,Zack Ostapchuk,C,OTT,21,50,5,6,11
41,8481532,Alex Turcotte,C,LAK,23,42,5,6,11
41,8482807,Ethan Del Mastro,D,CHI,21,50,4,7,11
41,8481599,Victor Soderstrom,D,UTA,23,50,4,7,11
41,8479442,Troy Stecher,D,EDM,30,56,4,7,11
41,8471817,Ryan Reaves,R,TOR,37,54,3,8,11
41,8479291,Kevin Rooney,C,CGY,31,49,2,9,11
41,8477446,Michael McCarron,R,NSH,29,54,2,9,11
41,8478452,Caleb Jones,D,LAK,27,62,2,9,11
41,8481147,Reese Johnson,C,MIN,26,35,2,9,11
41,8482733,Logan Mailloux,D,MTL,31,40,2,9,11
41,8476874,Olli Maatta,D,DET,30,64,2,9,11
41,8481598,Philip Broberg,D,EDM,23,35,2,9,11
41,8477845,Trevor van Riemsdyk,D,WSH,33,54,1,10,11
41,8477507,Nikita Zadorov,D,BOS,29,61,1,10,11
41,8475718,Justin Holl,D,DET,32,58,1,10,11
41,8481701,Santeri Hatakka,D,NJD,23,41,1,10,11
41,8479983,Mario Ferraro,D,SJS,26,68,0,11,11
41,8481708,Zac Jones,D,NYR,24,45,0,11,11
41,8476994,Vinnie Hinostroza,C,NSH,30,57,7,3,10
41,8482784,Zach Dean,C,STL,21,39,7,3,10
41,8480845,Rasmus Kupari,C,WPG,24,49,6,4,10
41,8476867,Brendan Gaunce,C,MIN,30,40,6,4,10
41,8480870,Bo Groulx,C,NYR,24,28,5,5,10
41,8480245,Olle Lycksell,R,PHI,25,34,5,5,10
41,8481716,Dmitri Voronkov,L,CBJ,24,39,4,6,10
41,8480727,Zach Whitecloud,D,VGK,28,48,4,6,10
41,8482861,Vincent Iorio,D,WSH,22,38,4,6,10
41,8479671,Mathieu Olivier,R,CBJ,27,54,4,6,10
41,8482666,Scott Morrow,D,CAR,22,50,3,7,10
41,8474166,Alec Martinez,D,CHI,37,55,3,7,10
41,8481617,Vasily Podkolzin,R,VAN,23,53,3,7,10
41,8479718,Alex Barré-Boulet,C,MTL,27,41,3,7,10
41,8479359,Beck Malenstyn,L,BUF,26,44,3,7,10
41,8478451,Ethan Bear,D,WSH,27,49,2,8,10
41,8478416,Erik Cernak,D,TBL,27,70,2,8,10
41,8476952,Dominic Toninato,C,WPG,30,38,2,8,10
41,8480196,Jacob Bryson,D,BUF,27,40,1,9,10
41,8478468,Jeremy Lauzon,D,NSH,27,59,0,10,10
41,8482659,Josh Doan,R,UTA,22,50,6,3,9
41,8479772,Zack MacEwen,R,OTT,28,49,5,4,9
41,8474013,Ian Cole,D,UTA,35,49,4,5,9
41,8478450,Parker Wotherspoon,D,BOS,27,26,4,5,9
41,8476822,Luke Glendening,C,TBL,35,81,3,6,9
41,8483460,David Jiricek,D,CBJ,21,53,3,6,9
41,8477887,Patrick Brown,C,BOS,32,46,3,6,9
41,8483466,Kevin Korchinski,D,CHI,20,53,3,6,9
41,8471677,Jack Johnson,D,CBJ,37,61,3,6,9
41,8481609,Vladislav Kolyachonok,D,UTA,23,39,3,6,9
41,8478874,Adam Gaudette,R,OTT,28,39,3,6,9
41,8484254,Akito Hirose,D,VAN,25,41,2,7,9
41,8475750,Jon Merrill,D,MIN,32,61,2,7,9
41,8482747,Brennan Othmann,L,NYR,21,45,2,7,9
41,8480950,Ilya Lyubushkin,D,DAL,30,71,1,8,9
41,8475177,Calvin de Haan,D,COL,33,53,1,8,9
41,8476372,Nick Seeler,D,PHI,31,40,1,8,9
41,8473446,Erik Johnson,D,PHI,36,45,0,9,9
41,8477962,Brendan Lemieux,L,CAR,28,40,0,9,9
41,8481751,Lukas Rousek,R,BUF,25,31,7,1,8
41,8479520,Brandon Duhaime,R,WSH,27,55,6,2,8
41,8480468,James Hamblin,L,EDM,25,23,6,2,8
41,8482153,Brendan Brisson,C,VGK,23,30,5,3,8
41,8479348,Kale Clague,D,BUF,26,37,4,4,8
41,8481592,Jakob Pelletier,L,CGY,23,52,3,5,8
41,8481122,Simon Benoit,D,TOR,26,40,3,5,8
41,8482144,Jack Thompson,D,SJS,22,33,3,5,8
41,8478409,Anthony Richard,C,PHI,28,35,2,6,8
41,8471709,Marc-Edouard Vlasic,D,SJS,37,58,2,6,8
41,8477938,Haydn Fleury,D,WPG,28,45,2,6,8
41,8477335,Kyle Burroughs,D,LAK,29,46,2,6,8
41,8481167,Brayden Pachal,D,CGY,25,43,2,6,8
41,8479998,Mikey Anderson,D,LAK,25,57,1,7,8
41,8480192,Johnathan Kovacevic,D,NJD,27,52,1,7,8
41,8480001,Urho Vaakanainen,D,ANA,25,54,0,8,8
41,8480157,Calle Rosen,D,COL,30,47,4,3,7
41,8478146,Matthew Highmore,C,OTT,28,42,4,3,7
41,8482145,Mavrik Bourque,C,DAL,22,50,4,3,7
41,8479536,Axel Jonsson-Fjallby,L,WPG,26,34,3,4,7
41,8484911,Collin Graf,R,SJS,22,37,3,4,7
41,8482751,Ryan Winterton,C,SEA,21,38,3,4,7
41,8484287,Cole McWard,D,VAN,23,30,3,4,7
41,8482964,Arber Xhekaj,D,MTL,23,40,2,5,7
41,8479994,Jaret Anderson-Dolan,C,WPG,25,28,2,5,7
41,8482652,Walker Duehr,R,CGY,27,38,2,5,7
41,8476473,Connor Murphy,D,CHI,31,35,1,6,7
41,8475762,Derek Forbort,D,VAN,32,39,1,6,7
41,8482744,James Malatesta,L,CBJ,21,34,0,7,7
41,8481056,Spencer Stastney,D,NSH,24,22,0,7,7
41,8477401,John Hayden,C,SEA,29,30,5,1,6
41,8477462,Robert Hagg,D,VGK,29,27,5,1,6
41,8480007,Jonas Rondbjerg,R,VGK,25,34,4,2,6
41,8479972,Mason Shaw,C,WPG,26,26,3,3,6
41,8482250,Callahan Burke,C,VGK,27,25,3,3,6
41,8474567,Zach Bogosian,D,MIN,34,63,2,4,6
41,8474568,Luke Schenn,D,NSH,35,48,2,4,6
41,8475235,Nicolas Deslauriers,L,PHI,33,49,2,4,6
41,8479378,Logan Stanley,D,WPG,26,40,2,4,6
41,8478454,Noah Juulsen,D,VAN,27,36,2,4,6
41,8479576,Vincent Desharnais,D,VAN,28,38,1,5,6
41,8481605,Jackson LaCombe,D,ANA,23,30,1,5,6
41,8478477,Mitchell Stephens,C,SEA,27,24,1,5,6
41,8483549,Lucas Condotta,L,MTL,27,39,0,6,6
41,8481030,Jack St. Ivany,D,PIT,25,25,0,6,6
41,8481754,Nikita Nesterenko,C,ANA,23,39,3,2,5
41,8482511,Mason Lohrei,D,BOS,23,35,3,2,5
41,8477320,Anton Blidh,L,NYR,29,22,3,2,5
41,8481422,Jake Lucchini,C,NSH,29,17,3,2,5
41,8483630,Pavol Regenda,L,ANA,25,27,2,3,5
41,8479981,Jonah Gadjovich,L,FLA,26,44,2,3,5
41,8482070,Mitchell Chaffee,R,TBL,26,46,2,3,5
41,8477971,Andreas Englund,D,LAK,28,35,2,3,5
41,8477244,Chad Ruhwedel,D,NYR,34,37,2,3,5
41,8480879,Jacob Bernard-Docker,D,OTT,24,46,1,4,5
41,8476441,Joel Edmundson,D,LAK,31,42,1,4,5
41,8479379,Givani Smith,R,SJS,26,29,1,4,5
41,8480084,Nick DeSimone,D,NJD,30,14,1,4,5
41,8483619,Filip Roos,D,OTT,25,29,0,5,5
41,8482102,Vasily Ponomarev,C,PIT,22,17,4,0,4
41,8481789,Tye Kartye,L,SEA,23,35,3,1,4
41,8482496,Nils Aman,C,VAN,24,35,3,1,4
41,8482147,Jean-Luc Foudy,C,COL,22,26,3,1,4
41,8479991,Jake Leschyshyn,C,NYR,25,22,3,1,4
41,8478017,Mark Friedman,D,VAN,29,38,2,2,4
41,8476858,Phillip Di Giuseppe,L,VAN,31,36,2,2,4
41,8480880,Jakub Lauko,C,MIN,24,30,2,2,4
41,8483512,Matthew Savoie,C,EDM,20,23,2,2,4
41,8482118,Sam Colangelo,R,ANA,23,18,2,2,4
41,8481006,Tyler Tucker,D,STL,24,17,2,2,4
41,8482765,Isak Rosen,R,BUF,21,28,1,3,4
41,8477384,Joshua Brown,D,EDM,30,46,1,3,4
41,8476913,Devin Shore,C,MIN,30,38,1,3,4
41,8480990,Declan Chisholm,D,MIN,24,33,1,3,4
41,8480292,Carson Meyer,R,ANA,27,23,1,3,4
41,8480844,Grigori Denisenko,L,VGK,24,28,1,3,4
41,8482177,Marat Khusnutdinov,C,MIN,22,26,1,3,4
41,8478502,Dennis Gilbert,D,BUF,28,22,1,3,4
41,8474612,Travis Hamonic,D,OTT,34,48,0,4,4
41,8484258,Sam Malinski,D,COL,26,17,0,4,4
41,8482713,Mackie Samoskevich,R,FLA,22,39,0,4,4
41,8481593,Jayden Struble,D,MTL,23,18,0,4,4
41,8479638,Justin Brazeau,R,BOS,26,22,3,0,3
41,8481556,John Beecher,C,BOS,23,37,2,1,3
41,8482141,Lukas Cormier,D,VGK,22,25,2,1,3
41,8482172,Landon Slaggert,L,CHI,22,29,2,1,3
41,8482858,Ryker Evans,D,SEA,23,22,2,1,3
41,8479985,Cale Fleury,D,SEA,26,18,2,1,3
41,8480890,Jan Jenik,C,OTT,24,27,2,1,3
41,8483397,Marc McLaughlin,C,BOS,25,29,2,1,3
41,8482516,Matthew Kessel,D,STL,24,18,1,2,3
41,8483763,Maksymilian Szuber,D,UTA,22,33,1,2,3
41,8480834,Ty Emberson,D,SJS,24,26,1,2,3
41,8482929,Emil Lilleberg,D,TBL,23,25,1,2,3
41,8481585,Egor Afanasyev,L,SJS,23,18,1,2,3
41,8474062,Riley Nash,C,NYR,35,13,1,2,3
41,8479367,William Lockwood,R,FLA,26,29,1,2,3
41,8477473,Justin Bailey,R,SJS,29,23,1,2,3
41,8478051,Max Willman,C,NJD,29,21,1,2,3
41,8481600,Tobias Bjornfot,D,FLA,23,36,0,3,3
41,8475958,Michael Sgarbossa,C,WSH,32,36,0,3,3
41,8480823,Alexander Alexeyev,D,WSH,25,15,0,3,3
41,8477527,Ross Johnston,L,ANA,30,30,0,3,3
41,8477073,Kurtis MacDermid,L,NJD,30,30,0,3,3
41,8482165,Yan Kuznetsov,D,CGY,22,19,0,3,3
41,8481719,Maxwell Crozier,D,TBL,24,20,0,3,3
41,8475795,Dylan McIlrath,D,WSH,32,22,0,3,3
41,8481541,Samuel Bolduc,D,NYI,24,30,2,0,2
41,8481743,Marc Del Gaizo,D,NSH,25,23,1,1,2
41,8475413,Justin Dowling,C,NJD,34,13,1,1,2
41,8481237,Kyle MacLean,C,NYI,25,22,1,1,2
41,8481806,Louis Crevier,D,CHI,23,12,1,1,2
41,8479362,Riley Tufte,L,BOS,26,25,1,1,2
41,8482162,Roby Jarventie,L,EDM,22,15,1,1,2
41,8479421,Jacob Moverare,D,LAK,26,4,1,1,2
41,8479320,Maxime Lajoie,D,SEA,27,21,0,2,2
41,8480032,Shane Bowers,C,NJD,25,22,0,2,2
41,8480874,Adam Ginning,D,PHI,24,20,0,2,2
41,8478854,Ryan Shea,D,PIT,27,5,0,2,2
41,8483570,Ben Meyers,C,SEA,26,25,1,0,1
41,8480851,Akil Thomas,C,LAK,24,13,1,0,1
41,8482201,Gage Goncalves,C,TBL,23,22,1,0,1
41,8477467,Gustav Olofsson,D,SEA,30,15,1,0,1
41,8481462,Mason Morelli,L,VGK,28,16,1,0,1
41,8482088,Justin Sourdif,R,FLA,22,18,1,0,1
41,8483597,Milos Kelemen,L,UTA,25,10,1,0,1
41,8481699,Aku Raty,R,UTA,23,11,1,0,1
41,8481043,Cole Koepke,L,BOS,26,14,1,0,1
41,8481024,Linus Karlsson,C,VAN,25,9,1,0,1
41,8484304,Uvis Balinskis,D,FLA,28,6,1,0,1
41,8478011,Louie Belpedio,D,PHI,28,16,1,0,1
41,8483395,Arshdeep Bains,L,VAN,23,9,1,0,1
41,8475780,Chris Wagner,R,COL,33,14,1,0,1
41,8481543,Nikita Alexandrov,C,STL,24,25,0,1,1
41,8480267,Sammy Walker,C,MIN,25,18,0,1,1
41,8478881,Brett Seney,L,CHI,28,16,0,1,1
41,8482470,Ilya Solovyov,D,CGY,24,22,0,1,1
41,8477149,Scott Sabourin,R,SJS,32,17,0,1,1
41,8477810,Joel Hanley,D,CGY,33,24,0,1,1
41,8482094,Daemon Hunt,D,MIN,22,15,0,1,1
41,8484255,Jason Polin,R,COL,25,4,0,1,1
41,8483489,Fraser Minten,C,TOR,31,12,0,1,1
41,8475755,Alexander Petrovic,D,DAL,32,10,0,1,1
41,8481206,John Ludvig,D,PIT,24,4,0,1,1
41,8480306,Grant Hutton,D,NYI,29,7,0,1,1
41,8483407,Brandon Scanlin,D,NYR,25,11,0,1,1
41,8481564,Ryan Johnson,D,BUF,23,14,0,1,1
41,8484326,Patrik Koch,D,UTA,28,4,0,1,1
41,8479587,Rhett Gardner,C,PHI,28,22,0,0,0
41,8478021,William Lagesson,D,DET,28,28,0,0,0
41,8484325,Waltteri Merela,C,TBL,26,20,0,0,0
41,8481065,Angus Crookshank,L,OTT,25,10,0,0,0
41,8479419,Brett Murray,L,BUF,26,16,0,0,0
41,8481726,Adam Edstrom,C,NYR,24,9,0,0,0
41,8482460,Matt Rempe,C,NYR,22,14,0,0,0
41,8483567,Georgii Merkulov,C,BOS,24,6,0,0,0
41,8476323,Max McCormick,L,SEA,32,3,0,0,0
41,8479330,Brandon Gignac,C,MTL,27,8,0,0,0
41,8482061,Brandon Biro,L,SEA,26,18,0,0,0
41,8483432,Luca Del Bel Belluz,C,CBJ,31,7,0,0,0
41,8480075,Cameron Crotty,D,MIN,25,9,0,0,0
41,8482787,Nikita Chibrikov,R,WPG,31,3,0,0,0
41,8477993,Justin Kirkland,C,CGY,28,3,0,0,0
41,8482476,Emil Heineman,L,MTL,23,9,0,0,0
41,8479522,Hardy Haman Aktell,D,WSH,26,2,0,0,0
41,8484321,Nikolas Matinpalo,D,OTT,26,1,0,0,0
41,8483531,Brian Halonen,L,NJD,25,4,0,0,0
41,8477541,Dakota Mermis,D,TOR,30,11,0,0,0
41,8483546,Marshall Rifai,D,TOR,26,1,0,0,0
41,8481578,Graeme Clarke,R,MIN,23,10,0,0,0
41,8482126,Emil Andrae,D,PHI,31,2,0,0,0
41,8478446,Glenn Gawdin,C,LAK,27,9,0,0,0
41,8483398,Declan Carlile,D,TBL,31,4,0,0,0
41,8483471,Brad Lambert,C,WPG,31,10,0,0,0
41,8481655,Cole Schwindt,R,CGY,23,5,0,0,0
41,8478147,Bokondji Imama,L,PIT,28,8,0,0,0
41,8483920,Pierrick Dube,R,WSH,23,4,0,0,0
41,8481534,Raphael Lavoie,C,EDM,24,3,0,0,0
41,8483609,Adam Klapka,R,CGY,24,2,0,0,0
41,8484259,Ondrej Pavel,C,COL,31,2,0,0,0
41,8482197,Adam Raska,R,MIN,23,5,0,0,0
41,8480274,Philip Kemp,D,EDM,25,1,0,0,0
41,8483401,Marc Johnstone,R,PIT,28,1,0,0,0
41,8470794,Joe Pavelski,C,,40,0,0,0,0
41,8479321,Lucas Johansen,D,,27,0,0,0,0
41,8477950,Tony DeAngelo,D,,29,0,0,0,0
41,8471218,Blake Wheeler,R,,38,0,0,0,0
41,8475197,Tyson Barrie,D,,33,0,0,0,0
41,8474157,Max Pacioretty,L,,36,0,0,0,0
41,8475744,Evgeny Kuznetsov,C,,32,0,0,0,0
41,8474037,James van Riemsdyk,L,,35,0,0,0,0
41,8476907,Mackenzie MacEachern,L,,30,0,0,0,0
41,8480216,Jacob Peterson,C,,25,0,0,0,0
41,8474602,Justin Schultz,D,,34,0,0,0,0
41,8482222,Alexander Barabanov,L,,30,0,0,0,0
41,8474031,Kevin Shattenkirk,D,,35,0,0,0,0
41,8477330,Dominik Kubalik,L,,29,0,0,0,0
41,8480884,Calen Addison,D,,24,0,0,0,0
41,8475906,John Klingberg,D,,32,0,0,0,0
41,8480008,Adam Ruzicka,C,,25,0,0,0,0
41,8476884,Derrick Pouliot,D,,30,0,0,0,0
41,8476919,Chris Tierney,C,,30,0,0,0,0
41,8479415,Michael McLeod,C,,26,0,0,0,0
41,8474870,Tyler Johnson,C,,34,0,0,0,0
41,8470604,Jeff Carter,C,,39,0,0,0,0
41,8478104,Sammy Blais,L,,28,0,0,0,0
41,8474884,Mike Hoffman,C,,35,0,0,0,0
41,8481591,Sam Poulin,R,,23,0,0,0,0
41,8471274,Alex Goligoski,D,,39,0,0,0,0
41,8476871,Tanner Pearson,L,,32,0,0,0,0
41,8476393,Nick Cousins,C,,31,0,0,0,0
41,8479977,Kailer Yamamoto,R,,26,0,0,0,0
41,8479346,Dillon Dube,C,,26,0,0,0,0
41,8480184,Gustav Lindstrom,D,,26,0,0,0,0
41,8479376,Victor Mete,D,,26,0,0,0,0
41,8473449,Kyle Okposo,R,,36,0,0,0,0
41,8481058,Jesse Ylonen,R,,25,0,0,0,0
41,8475752,Tyler Pitlick,C,,33,0,0,0,0
41,8481239,Samuel Fagemo,L,,24,0,0,0,0
41,8480821,Filip Zadina,R,,25,0,0,0,0
41,8470966,Mark Giordano,D,,41,0,0,0,0
41,8478495,Denis Gurianov,R,,27,0,0,0,0
41,8477464,Nic Petan,C,,29,0,0,0,0
41,8478099,Kevin Labanc,R,,29,0,0,0,0
41,8482241,Radim Zohorna,L,,28,0,0,0,0
41,8474040,Sam Gagner,C,,35,0,0,0,0
41,8479514,Rem Pitlick,C,,27,0,0,0,0
41,8478430,Oliver Kylington,D,,27,0,0,0,0
41,8479533,Joona Koppanen,L,,26,0,0,0,0
41,8479984,Cal Foote,D,,26,0,0,0,0
41,8477126,Jayson Megna,C,,34,0,0,0,0
41,8475164,Jakob Silfverberg,R,,34,0,0,0,0
41,8474009,Nick Bonino,C,,36,0,0,0,0
41,8479458,Nikita Zaitsev,D,,33,0,0,0,0
41,8477944,Jakub Vrana,L,,28,0,0,0,0
41,8471699,Andrew Cogliano,C,,37,0,0,0,0
41,8478067,Oskar Lindblom,L,,28,0,0,0,0
41,8471686,Marc Staal,D,,37,0,0,0,0
41,8470610,Zach Parise,L,,40,0,0,0,0
41,8478904,Steven Lorentz,C,,28,0,0,0,0
41,8473473,Milan Lucic,L,,36,0,0,0,0
41,8480031,Maxime Comtois,L,,25,0,0,0,0
41,8478512,Austin Czarnik,C,,32,0,0,0,0
41,8473504,Cal Clutterbuck,R,,37,0,0,0,0
41,8477454,Adam Erne,L,,29,0,0,0,0
41,8479383,Boris Katchouk,L,,26,0,0,0,0
41,8475825,Jani Hakanpää,D,,32,0,0,0,0
41,8477846,Ryan Carpenter,C,,33,0,0,0,0
41,8477930,Pierre-Edouard Bellemare,L,,39,0,0,0,0
41,8478400,Colin White,C,,27,0,0,0,0
41,8480226,Marián Studenic,R,,26,0,0,0,0
41,8480853,Liam Foudy,C,,24,0,0,0,0
41,8475797,Jarred Tinordi,D,,32,0,0,0,0
41,8479423,Alex Nylander,L,,26,0,0,0,0
41,8474618,Marco Scandella,D,,34,0,0,0,0
41,8478028,Fredrik Olofsson,L,,28,0,0,0,0
41,8474709,Matt Martin,L,,35,0,0,0,0
41,8481070,Hugh McGing,L,,26,0,0,0,0
41,8479546,Oskar Steen,C,,26,0,0,0,0
41,8474145,Robert Bortuzzo,D,,35,0,0,0,0
41,8476915,Jujhar Khaira,L,,30,0,0,0,0
41,8475278,Byron Froese,C,,33,0,0,0,0
41,8481812,Nikolai Knyzhov,D,,27,0,0,0,0
41,8478408,Travis Dermott,D,,28,0,0,0,0
41,8481077,John Leonard,L,,26,0,0,0,0
41,8479547,Matthew Phillips,R,,26,0,0,0,0
41,8480836,Jonathan Gruden,C,,24,0,0,0,0
41,8481690,Tyler Angle,C,,24,0,0,0,0
41,8475766,Austin Watson,L,,32,0,0,0,0
41,8481016,Ruslan Iskhakov,C,,24,0,0,0,0
41,8478078,Rourke Chartier,C,,28,0,0,0,0
41,8480776,Sheldon Rempal,R,,29,0,0,0,0
41,8478956,Samuel Laberge,L,NJD,27,1,0,0,0
41,8483045,Cameron Butler,R,CBJ,31,1,0,0,0
41,8484314,Jiri Smejkal,L,,28,0,0,0,0
42,8478402,Connor McDavid,C,EDM,27,78,41,90,131
42,8476453,Nikita Kucherov,R,TBL,31,82,28,102,130
42,8477492,Nathan MacKinnon,C,COL,29,81,53,75,128
42,8479318,Auston Matthews,C,TOR,27,78,64,53,117
42,8478483,Mitch Marner,R,TOR,27,79,29,87,116
42,8477934,Leon Draisaitl,C,EDM,29,78,39,76,115
42,8477939,William Nylander,R,TOR,28,78,42,70,112
42,8477956,David Pastrnak,R,BOS,28,77,53,56,109
42,8478420,Mikko Rantanen,R,COL,28,82,36,73,109
42,8481559,Jack Hughes,C,NJD,23,78,42,64,106
42,8481557,Matt Boldy,L,MIN,23,76,38,66,104
42,8477493,Aleksander Barkov,C,FLA,29,80,38,64,102
42,8471675,Sidney Crosby,C,PIT,37,72,47,53,100
42,8480801,Brady Tkachuk,L,OTT,25,80,44,56,100
42,8477946,Dylan Larkin,C,DET,28,80,50,49,99
42,8480027,Jason Robertson,L,DAL,25,82,38,61,99
42,8475184,Chris Kreider,L,NYR,33,79,55,43,98
42,8478550,Artemi Panarin,L,NYR,33,77,29,68,97
42,8480023,Robert Thomas,C,STL,25,76,30,66,96
42,8476887,Filip Forsberg,L,NSH,30,75,42,52,94
42,8478864,Kirill Kaprizov,L,MIN,27,71,51,41,92
42,8478010,Brayden Point,C,TBL,28,81,39,53,92
42,8477409,Carter Verhaeghe,C,FLA,29,77,39,52,91
42,8477504,Josh Morrissey,D,WPG,29,78,18,73,91
42,8479314,Matthew Tkachuk,L,FLA,27,75,35,55,90
42,8477416,Oliver Bjorkstrand,R,SEA,29,76,37,52,89
42,8479343,Clayton Keller,R,UTA,26,75,42,46,88
42,8477942,Kevin Fiala,L,LAK,28,80,35,53,88
42,8475167,Victor Hedman,D,TBL,34,81,23,65,88
42,8477404,Jake Guentzel,C,TBL,30,82,38,49,87
42,8480830,Andrei Svechnikov,R,CAR,24,74,33,53,86
42,8476468,J.T. Miller,C,VAN,31,75,29,57,86
42,8477933,Sam Reinhart,C,FLA,29,78,43,42,85
42,8474564,Steven Stamkos,C,NSH,34,73,38,47,85
42,8475913,Mark Stone,R,VGK,32,78,33,52,85
42,8480012,Elias Pettersson,C,VAN,26,77,28,57,85
42,8479420,Tage Thompson,C,BUF,27,78,52,32,84
42,8473512,Claude Giroux,R,OTT,36,79,26,58,84
42,8478449,Roope Hintz,C,DAL,28,80,41,42,83
42,8478403,Jack Eichel,C,VGK,28,72,46,36,82
42,8479542,Brandon Hagel,L,TBL,26,82,40,42,82
42,8475166,John Tavares,C,TOR,34,79,32,50,82
42,8476459,Mika Zibanejad,C,NYR,31,77,38,43,81
42,8475172,Nazem Kadri,C,CGY,34,80,25,56,81
42,8479323,Adam Fox,D,NYR,26,77,21,60,81
42,8477402,Pavel Buchnevich,L,STL,29,75,29,51,80
42,8480800,Quinn Hughes,D,VAN,25,76,10,70,80
42,8482116,Tim Stützle,C,OTT,22,79,29,50,79
42,8478427,Sebastian Aho,C,CAR,27,73,40,38,78
42,8479385,Jordan Kyrou,C,STL,26,78,33,45,78
42,8479337,Alex DeBrincat,R,DET,27,79,27,50,77
42,8480208,Drake Batherson,R,OTT,26,81,27,50,77
42,8478460,Zach Werenski,D,CBJ,27,81,23,54,77
42,8478445,Mathew Barzal,C,NYI,27,80,20,57,77
42,8476454,Ryan Nugent-Hopkins,C,EDM,31,77,19,58,77
42,8476456,Jonathan Huberdeau,C,CGY,31,78,17,60,77
42,8478439,Travis Konecny,R,PHI,27,74,38,38,76
42,8476460,Mark Scheifele,C,WPG,31,73,33,43,76
42,8475170,Brayden Schenn,C,STL,33,77,33,43,76
42,8477501,Valeri Nichushkin,R,COL,29,81,46,29,75
42,8475726,Tyler Toffoli,C,SJS,32,69,42,33,75
42,8477500,Bo Horvat,C,NYI,29,82,38,37,75
42,8475168,Matt Duchene,C,DAL,33,82,28,47,75
42,8484144,Connor Bedard,C,CHI,19,71,34,40,74
42,8476389,Vincent Trocheck,C,NYR,31,77,34,40,74
42,8478493,Joel Eriksson Ek,C,MIN,27,71,31,43,74
42,8475754,Brock Nelson,C,NYI,33,81,30,44,74
42,8480039,Martin Necas,C,CAR,25,74,26,48,74
42,8474600,Roman Josi,D,NSH,34,77,16,58,74
42,8476539,Jonathan Marchessault,R,NSH,34,75,40,33,73
42,8480036,Miro Heiskanen,D,DAL,25,77,18,55,73
42,8479407,Jesper Bratt,L,NJD,26,75,26,46,72
42,8477496,Elias Lindholm,C,BOS,30,80,31,40,71
42,8475692,Mats Zuccarello,R,MIN,37,71,18,53,71
42,8471685,Anze Kopitar,C,LAK,37,78,16,55,71
42,8471214,Alex Ovechkin,L,WSH,39,76,40,30,70
42,8476853,Morgan Rielly,D,TOR,30,76,17,53,70
42,8480069,Cale Makar,D,COL,26,67,10,59,69
42,8477960,Adrian Kempe,R,LAK,28,81,34,34,68
42,8477940,Nikolaj Ehlers,L,WPG,28,75,33,35,68
42,8480002,Nico Hischier,C,NJD,25,79,32,36,68
42,8482740,Wyatt Johnston,C,DAL,21,80,31,37,68
42,8479675,Trevor Moore,L,LAK,29,81,29,39,68
42,8480018,Nick Suzuki,C,MTL,25,74,19,49,68
42,8480803,Evan Bouchard,D,EDM,25,75,11,57,68
42,8475786,Zach Hyman,L,EDM,32,77,39,28,67
42,8477951,Nick Schmaltz,C,UTA,28,76,24,43,67
42,8471215,Evgeni Malkin,C,PIT,38,70,22,45,67
42,8474578,Erik Karlsson,D,PIT,34,77,13,54,67
42,8475784,Jeff Skinner,C,EDM,32,79,31,35,66
42,8476448,William Karlsson,C,VGK,31,71,21,45,66
42,8475798,Mikael Granlund,C,SJS,32,70,16,50,66
42,8476881,Tomas Hertl,C,VGK,31,79,30,35,65
42,8474141,Patrick Kane,R,DET,36,82,19,46,65
42,8481068,Yegor Sharangovich,C,CGY,26,76,34,30,64
42,8484153,Leo Carlsson,C,ANA,20,73,28,36,64
42,8477955,Jared McCann,L,SEA,28,71,24,40,64
42,8477949,Alex Tuch,R,BUF,28,74,21,43,64
42,8478440,Dylan Strome,C,WSH,27,76,20,44,64
42,8478407,Vince Dunn,D,SEA,28,77,12,52,64
42,8480839,Rasmus Dahlin,D,BUF,24,65,11,53,64
42,8478975,Mason Marchment,L,DAL,29,82,28,35,63
42,8480865,Noah Dobson,D,NYI,24,80,13,50,63
42,8476346,Johnny Gaudreau,L,CBJ,31,74,11,52,63
42,8477476,Artturi Lehkonen,L,COL,29,81,35,27,62
42,8475810,Bryan Rust,R,PIT,32,72,34,28,62
42,8478398,Kyle Connor,L,WPG,28,73,31,31,62
42,8477451,Ryan Hartman,R,MIN,30,69,29,33,62
42,8473994,Jamie Benn,L,DAL,35,80,24,38,62
42,8477935,Sam Bennett,C,FLA,28,79,31,30,61
42,8478474,Lawson Crouse,L,UTA,27,73,31,30,61
42,8478444,Brock Boeser,R,VAN,27,77,30,31,61
42,8478047,Michael Bunting,L,PIT,29,70,22,38,60
42,8477503,Max Domi,C,TOR,29,79,18,42,60
42,8480014,Gabriel Vilardi,C,WPG,25,71,40,19,59
42,8474102,David Perron,L,OTT,36,78,30,29,59
42,8477407,Anthony Duclair,L,NYI,29,80,23,36,59
42,8482078,Lucas Raymond,L,DET,22,79,24,34,58
42,8478038,Devon Toews,D,COL,30,71,14,44,58
42,8479325,Charlie McAvoy,D,BOS,27,81,10,48,58
42,8473419,Brad Marchand,L,BOS,36,81,27,30,57
42,8476479,Phillip Danault,C,LAK,31,81,22,35,57
42,8478401,Pavel Zacha,C,BOS,27,78,18,39,57
42,8482124,Quinton Byfield,R,LAK,22,80,16,41,57
42,8478414,Timo Meier,R,NJD,28,77,32,24,56
42,8483431,Logan Cooley,C,UTA,20,78,22,34,56
42,8477447,Shea Theodore,D,VGK,29,66,14,42,56
42,8476792,Torey Krug,D,STL,33,73,13,43,56
42,8477456,J.T. Compher,L,DET,29,79,23,32,55
42,8475191,Reilly Smith,R,NYR,33,73,21,34,55
42,8478873,Troy Terry,R,ANA,27,72,16,39,55
42,8471698,T.J. Oshie,R,WSH,38,71,29,25,54
42,8480015,Owen Tippett,R,PHI,25,79,25,29,54
42,8476483,Rickard Rakell,R,PIT,31,67,25,29,54
42,8475765,Vladimir Tarasenko,R,DET,33,81,22,32,54
42,8475158,Ryan O'Reilly,C,NSH,33,69,20,34,54
42,8474679,Gustav Nyquist,C,NSH,35,75,17,37,54
42,8481711,Matias Maccelli,L,UTA,24,74,16,38,54
42,8474590,John Carlson,D,WSH,34,71,11,43,54
42,8482702,Logan Stankoven,C,DAL,21,81,29,24,53
42,8483515,Juraj Slafkovsky,L,MTL,20,76,26,27,53
42,8482110,Dawson Mercer,C,NJD,23,76,22,31,53
42,8477494,Jonathan Drouin,L,COL,29,79,18,35,53
42,8482097,Jack Quinn,R,BUF,23,70,16,37,53
42,8474586,Jordan Eberle,R,SEA,34,67,27,25,52
42,8484166,Adam Fantilli,C,CBJ,20,69,26,26,52
42,8482699,Dylan Guenther,R,UTA,21,72,21,31,52
42,8481528,Dylan Cozens,C,BUF,23,67,19,33,52
42,8477986,Brandon Montour,D,SEA,30,71,13,39,52
42,8478519,Anthony Cirelli,C,TBL,27,82,22,29,51
42,8476880,Tom Wilson,R,WSH,30,70,22,29,51
42,8474150,Mikael Backlund,C,CGY,35,74,21,30,51
42,8477964,Ivan Barbashev,C,VGK,29,73,17,34,51
42,8471724,Kris Letang,D,PIT,37,81,15,36,51
42,8474563,Drew Doughty,D,LAK,35,72,15,36,51
42,8481540,Cole Caufield,R,MTL,23,68,24,26,50
42,8478856,Conor Garland,R,VAN,28,76,22,28,50
42,8482159,Tyson Foerster,R,PHI,22,76,22,28,50
42,8475169,Evander Kane,L,EDM,33,78,28,21,49
42,8476399,Blake Coleman,C,CGY,33,74,28,21,49
42,8476432,Boone Jenner,C,CBJ,31,73,27,22,49
42,8480028,Morgan Frost,C,PHI,25,73,23,26,49
42,8482665,Matty Beniers,C,SEA,22,71,16,33,49
42,8478397,Rasmus Andersson,D,CGY,28,71,14,35,49
42,8476462,Dougie Hamilton,D,NJD,31,68,9,40,49
42,8475768,Jaden Schwartz,C,SEA,32,71,23,25,48
42,8481618,Alex Newhook,C,MTL,23,74,22,26,48
42,8482093,Seth Jarvis,C,CAR,22,70,20,28,48
42,8478396,Noah Hanifin,D,VGK,27,59,14,34,48
42,8475151,Kyle Palmieri,C,NYI,33,80,22,25,47
42,8478462,Nicolas Roy,C,VGK,27,78,21,26,47
42,8483808,Andrei Kuzmenko,L,CGY,28,75,21,26,47
42,8484145,Zach Benson,L,BUF,19,63,21,26,47
42,8480009,Eeli Tolvanen,R,SEA,25,72,19,28,47
42,8482149,Cole Perfetti,C,WPG,22,72,18,29,47
42,8479992,Michael Rasmussen,C,DET,25,78,16,31,47
42,8482671,Owen Power,D,BUF,22,63,13,34,47
42,8476923,Damon Severson,D,CBJ,30,79,7,40,47
42,8481596,Shane Pinto,C,OTT,24,75,19,27,46
42,8480188,Fabian Zetterlund,L,SJS,25,61,18,28,46
42,8476292,Ondrej Palat,L,NJD,33,72,13,33,46
42,8478438,Tommy Novak,C,NSH,27,64,13,33,46
42,8479525,Ross Colton,C,COL,28,80,26,19,45
42,8477479,Tyler Bertuzzi,L,CHI,29,70,17,28,45
42,8476905,Chandler Stephenson,C,SEA,30,77,16,29,45
42,8480434,Sean Durzi,D,UTA,26,67,15,30,45
42,8478469,Thomas Chabot,D,OTT,27,74,15,30,45
42,8481546,Cam York,D,PHI,23,72,14,31,45
42,8476869,Brady Skjei,D,NSH,30,77,9,36,45
42,8481560,Arthur Kaliyev,R,LAK,23,78,23,21,44
42,8480064,Josh Norris,C,OTT,25,78,23,21,44
42,8477426,Nicholas Paul,L,TBL,29,81,22,22,44
42,8481604,Pavel Dorofeyev,L,VGK,24,72,22,22,44
42,8482745,Mason McTavish,C,ANA,21,76,21,23,44
42,8475794,Tyler Seguin,C,DAL,32,81,16,28,44
42,8477497,Sean Monahan,C,CBJ,30,60,16,28,44
42,8473986,Alex Killorn,L,ANA,35,78,14,30,44
42,8483490,Pavel Mintyukov,D,ANA,21,73,12,32,44
42,8478055,Gustav Forsling,D,FLA,28,75,10,34,44
42,8481703,Valtteri Puustinen,R,PIT,25,62,8,36,44
42,8476906,Shayne Gostisbehere,D,CAR,31,74,5,39,44
42,8475722,Jason Zucker,L,BUF,32,66,23,20,43
42,8479400,Pierre-Luc Dubois,L,WSH,26,69,19,24,43
42,8479339,Patrik Laine,L,CBJ,26,68,17,26,43
42,8479987,Morgan Geekie,C,BOS,26,79,17,26,43
42,8478458,John (Jack) Roslovic,C,CAR,27,73,17,26,43
42,8477346,MacKenzie Weegar,D,CGY,30,76,10,33,43
42,8481533,Trevor Zegras,C,ANA,23,72,19,23,42
42,8480849,Barrett Hayton,C,UTA,24,69,16,26,42
42,8478115,Pierre Engvall,L,NYI,28,79,14,28,42
42,8479999,Casey Mittelstadt,C,COL,26,82,13,29,42
42,8476392,Adam Lowry,C,WPG,31,69,13,29,42
42,8479345,Jakob Chychrun,D,WSH,26,64,13,29,42
42,8476854,Hampus Lindholm,D,BOS,30,72,11,31,42
42,8482684,Luke Hughes,D,NJD,21,73,5,37,42
42,8478498,Jake DeBrusk,L,VAN,28,75,21,20,41
42,8482113,Anton Lundell,C,FLA,23,75,18,23,41
42,8475714,Calle Jarnkrok,C,TOR,33,76,18,23,41
42,8477932,Aaron Ekblad,D,FLA,28,69,15,26,41
42,8476458,Ryan Strome,C,ANA,31,66,15,26,41
42,8480798,Philipp Kurashev,C,CHI,25,66,14,27,41
42,8470613,Brent Burns,D,CAR,39,79,12,29,41
42,8477495,Seth Jones,D,CHI,30,69,9,32,41
42,8475314,Anders Lee,L,NYI,34,79,20,20,40
42,8475745,Charlie Coyle,C,BOS,32,75,19,21,40
42,8474641,Adam Henrique,C,EDM,34,76,19,21,40
42,8482109,Alexis Lafrenière,L,NYR,23,73,19,21,40
42,8475763,Kevin Hayes,R,PIT,32,70,13,27,40
42,8476875,Mike Matheson,D,MTL,30,70,12,28,40
42,8481581,Thomas Harley,D,DAL,23,75,11,29,40
42,8476958,Jaccob Slavin,D,CAR,30,76,8,32,40
42,8477948,Travis Sanheim,D,PHI,28,69,7,33,40
42,8482122,Brock Faber,D,MIN,22,75,6,34,40
42,8477998,Warren Foegele,L,LAK,28,78,20,19,39
42,8476438,Brandon Saad,L,STL,32,74,16,23,39
42,8481523,Kirby Dach,C,MTL,23,68,16,23,39
42,8474053,Logan Couture,C,SJS,35,62,14,25,39
42,8479425,Filip Hronek,D,VAN,27,74,13,26,39
42,8475753,Justin Faulk,D,STL,32,70,12,27,39
42,8481606,Jordan Spence,D,LAK,23,75,3,36,39
42,8478046,Danton Heinen,L,VAN,29,70,15,23,38
42,8477429,Andrew Copp,C,DET,30,81,14,24,38
42,8482092,Ridly Greig,C,OTT,22,74,14,24,38
42,8482667,William Eklund,L,SJS,22,67,11,27,38
42,8480113,Alex Iafallo,L,WPG,31,63,16,21,37
42,8478542,Evan Rodrigues,C,FLA,31,75,10,27,37
42,8482133,Thomas Bordeleau,C,SJS,22,68,10,27,37
42,8480871,Adam Boqvist,D,FLA,24,67,10,27,37
42,8475200,Dmitry Orlov,D,CAR,33,72,7,30,37
42,8482712,Oskar Olausson,R,COL,22,76,3,34,37
42,8475793,Ryan Johansen,C,PHI,32,72,18,18,36
42,8483524,Shane Wright,C,SEA,20,64,17,19,36
42,8477511,Anthony Mantha,R,CGY,30,78,15,21,36
42,8481624,Ilya Mikheyev,R,CHI,30,63,15,21,36
42,8478413,Jordan Greenway,L,BUF,27,69,14,22,36
42,8476882,Teuvo Teravainen,C,CHI,30,58,13,23,36
42,8478463,Anthony Beauvillier,L,PIT,27,67,12,24,36
42,8477021,Alex Kerfoot,C,UTA,30,74,11,25,36
42,8476885,Jacob Trouba,D,NYR,30,71,9,27,36
42,8476463,Jonas Brodin,D,MIN,31,76,6,30,36
42,8479293,Brandon Tanev,L,SEA,33,67,20,15,35
42,8478042,Viktor Arvidsson,L,EDM,31,72,17,18,35
42,8473422,Nick Foligno,L,CHI,37,63,17,18,35
42,8476826,Yanni Gourde,C,SEA,33,72,16,19,35
42,8479591,Michael Eyssimont,C,TBL,28,81,16,19,35
42,8481186,Logan O'Connor,R,COL,28,77,15,20,35
42,8480185,Eetu Luostarinen,C,FLA,26,75,13,22,35
42,8477839,Conor Sheary,L,TBL,32,80,13,22,35
42,8476872,Scott Laughton,C,PHI,30,74,12,23,35
42,8478891,Mason Appleton,C,WPG,28,66,10,25,35
42,8479410,Mikhail Sergachev,D,UTA,26,71,8,27,35
42,8478366,Frank Vatrano,R,ANA,30,74,21,13,34
42,8475799,Nino Niederreiter,R,WPG,32,69,21,13,34
42,8482475,Yegor Chinakhov,R,CBJ,23,63,20,14,34
42,8478466,Daniel Sprong,R,VAN,27,73,15,19,34
42,8476925,Colton Sissons,C,NSH,31,71,15,19,34
42,8478472,Mathieu Joseph,R,STL,27,63,13,21,34
42,8480797,Joel Farabee,L,PHI,24,70,13,21,34
42,8481577,Philip Tomasino,C,NSH,23,62,13,21,34
42,8475287,Erik Haula,L,NJD,33,67,12,22,34
42,8476461,Sean Couturier,C,PHI,32,68,11,23,34
42,8482720,Matthew Knies,L,TOR,22,77,11,23,34
42,8481524,Bowen Byram,D,BUF,23,66,11,23,34
42,8480068,Ryan Poehling,C,PHI,25,68,8,26,34
42,8474565,Alex Pietrangelo,D,VGK,34,58,7,27,34
42,8477488,Brett Pesce,D,NJD,30,66,5,29,34
42,8476892,Colton Parayko,D,STL,31,75,5,29,34
42,8481542,Moritz Seider,D,DET,23,76,3,31,34
42,8475760,Nick Bjugstad,C,UTA,32,75,19,14,33
42,8480459,Pius Suter,C,VAN,28,65,19,14,33
42,8481554,Kaapo Kakko,R,NYR,23,69,17,16,33
42,8480829,Jesperi Kotkaniemi,C,CAR,24,68,15,18,33
42,8477989,Christian Dvorak,C,MTL,28,67,15,18,33
42,8479365,Trent Frederic,C,BOS,26,77,13,20,33
42,8477979,Nicolas Aube-Kubel,R,BUF,28,56,11,22,33
42,8483445,Cutter Gauthier,L,ANA,20,72,9,24,33
42,8477444,Andre Burakovsky,L,SEA,29,68,7,26,33
42,8477498,Darnell Nurse,D,EDM,29,77,7,26,33
42,8476981,Josh Anderson,R,MTL,30,63,19,13,32
42,8482175,JJ Peterka,R,BUF,22,71,15,17,32
42,8482111,Justin Barron,D,MTL,23,70,9,23,32
42,8478500,Ivan Provorov,D,CBJ,27,81,6,26,32
42,8477506,Ryan Pulock,D,NYI,30,76,4,28,32
42,8480220,Noah Cates,L,PHI,25,69,16,15,31
42,8481032,Paul Cotter,C,NJD,25,62,15,16,31
42,8479941,Justin Danforth,R,CBJ,31,61,15,16,31
42,8484203,Bradly Nadeau,L,CAR,19,56,12,19,31
42,8480802,Ryan McLeod,C,BUF,25,66,12,19,31
42,8477947,Sonny Milano,L,WSH,28,58,10,21,31
42,8482105,Jake Sanderson,D,OTT,22,76,9,22,31
42,8475218,Mattias Ekholm,D,EDM,34,69,8,23,31
42,8480817,K'Andre Miller,D,NYR,24,73,6,25,31
42,8476979,Erik Gustafsson,D,DET,32,74,4,27,31
42,8482055,Drew O'Connor,L,PIT,26,69,19,11,30
42,8482259,Bobby McMann,C,TOR,28,58,18,12,30
42,8482705,Cole Sillinger,C,CBJ,21,64,17,13,30
42,8475193,Tomas Tatar,L,NJD,34,69,10,20,30
42,8476927,Teddy Blueger,C,VAN,30,61,9,21,30
42,8477505,Alexander Wennberg,C,SJS,30,60,7,23,30
42,8475171,Oliver Ekman-Larsson,D,TOR,33,71,6,24,30
42,8479983,Mario Ferraro,D,SJS,26,77,6,24,30
42,8477969,Marcus Pettersson,D,PIT,28,78,3,27,30
42,8478109,Victor Olofsson,L,VGK,29,75,13,16,29
42,8477952,Robby Fabbri,C,ANA,28,65,12,17,29
42,8480855,Jack McBain,C,UTA,24,66,10,19,29
42,8475848,Brendan Gallagher,R,MTL,32,69,10,19,29
42,8482624,Daniil Miromanov,D,CGY,27,63,9,20,29
42,8482660,Kent Johnson,C,CBJ,22,67,8,21,29
42,8479351,Sam Steel,C,DAL,26,81,11,17,28
42,8482146,Luke Evangelista,R,NSH,22,69,11,17,28
42,8478233,Andrew Mangiapane,L,WSH,28,70,9,19,28
42,8478133,Jake Evans,C,MTL,28,66,7,21,28
42,8479398,Samuel Girard,D,COL,26,67,6,22,28
42,8476902,Esa Lindell,D,DAL,30,79,6,22,28
42,8480878,Nils Lundkvist,D,DAL,24,72,2,26,28
42,8482089,Jake Neighbours,L,STL,22,72,19,8,27
42,8481580,Connor McMichael,C,WSH,23,63,18,9,27
42,8474189,Lars Eller,C,PIT,35,62,15,12,27
42,8476474,Stefan Noesen,R,NJD,31,64,14,13,27
42,8477478,William Carrier,L,CAR,30,66,14,13,27
42,8479390,Taylor Raddysh,R,WSH,26,60,13,14,27
42,8475231,Casey Cizikas,C,NYI,33,69,12,15,27
42,8476921,Jordan Martinook,L,CAR,32,62,11,16,27
42,8477919,Frederick Gaudreau,C,MIN,31,65,10,17,27
42,8477435,Ryan Graves,D,PIT,29,77,7,20,27
42,8477220,Nate Schmidt,D,FLA,33,70,7,20,27
42,8482142,Jamie Drysdale,D,PHI,22,64,7,20,27
42,8475181,Nick Leddy,D,STL,33,70,6,21,27
42,8475764,Cam Fowler,D,ANA,33,70,2,25,27
42,8473533,Jordan Staal,C,CAR,36,61,16,10,26
42,8478043,Sam Lafferty,C,BUF,29,61,15,11,26
42,8481656,Aliaksei Protas,C,WSH,23,64,9,17,26
42,8480074,Alexandre Texier,C,STL,25,56,9,17,26
42,8475149,Marcus Johansson,L,MIN,34,58,8,18,26
42,8483505,Matthew Poitras,C,BOS,20,80,8,18,26
42,8480043,Timothy Liljegren,D,TOR,25,68,8,18,26
42,8482101,Danil Gushchin,L,SJS,22,59,8,18,26
42,8482067,Connor Mackey,D,NYR,28,58,5,21,26
42,8476480,Vladislav Namestnikov,C,WPG,32,67,4,22,26
42,8480049,Dylan Samberg,D,WPG,25,63,4,22,26
42,8481178,Egor Zamula,D,PHI,24,60,3,23,26
42,8480873,Rasmus Sandin,D,WSH,24,67,2,24,26
42,8481535,Nils Hoglander,L,VAN,24,60,18,7,25
42,8474715,Cameron Atkinson,R,TBL,35,80,15,10,25
42,8481582,Nicholas Robertson,L,TOR,23,70,13,12,25
42,8476918,Jimmy Vesey,L,NYR,31,66,12,13,25
42,8479661,Tanner Jeannot,L,LAK,27,77,11,14,25
42,8480003,Jesper Boqvist,C,FLA,26,66,10,15,25
42,8476278,Colin Blackwell,C,DAL,31,78,10,15,25
42,8479619,Michael Carcone,L,UTA,28,58,10,15,25
42,8477953,Kasperi Kapanen,R,STL,28,68,9,16,25
42,8480144,David Kampf,C,TOR,29,79,9,16,25
42,8474716,Jared Spurgeon,D,MIN,35,76,7,18,25
42,8480078,Filip Chytil,C,NYR,25,72,7,18,25
42,8476960,Andreas Athanasiou,C,CHI,30,57,6,19,25
42,8480891,Michael Kesselring,D,UTA,24,62,4,21,25
42,8478507,John Marino,D,UTA,27,69,1,24,25
42,8482079,Marco Rossi,C,MIN,23,60,15,9,24
42,8476469,Joel Armia,R,MTL,31,71,11,13,24
42,8481093,Rafael Harvey-Pinard,L,MTL,25,57,11,13,24
42,8482117,Lukas Reichel,L,CHI,22,57,10,14,24
42,8482074,Connor Zary,C,CGY,23,57,10,14,24
42,8478057,Dakota Joshua,C,VAN,28,65,9,15,24
42,8477353,Tyler Motte,C,DET,29,76,8,16,24
42,8478970,Jalen Chatfield,D,CAR,28,72,5,19,24
42,8478911,Matt Roy,D,WSH,29,65,4,20,24
42,8476331,Dylan DeMelo,D,WPG,31,65,2,22,24
42,8475225,Craig Smith,C,CHI,35,55,16,7,23
42,8477425,Miles Wood,L,COL,29,72,13,10,23
42,8473563,Nicklas Backstrom,C,WSH,37,53,10,13,23
42,8476897,Oskar Sundqvist,C,STL,30,66,10,13,23
42,8480336,Sean Walker,D,CAR,30,73,9,14,23
42,8482749,Joshua Roy,R,MTL,21,64,9,14,23
42,8474149,Evgenii Dadonov,R,DAL,35,79,8,15,23
42,8476374,Sean Kuraly,C,CBJ,31,61,8,15,23
42,8475343,Nic Dowd,C,WSH,34,61,7,16,23
42,8482655,Janis Moser,D,TBL,24,80,6,17,23
42,8479324,Ryan Lindgren,D,NYR,26,65,5,18,23
42,8476879,Cody Ceci,D,EDM,31,72,3,20,23
42,8482087,Kaiden Guhle,D,MTL,22,71,2,21,23
42,8480893,Kirill Marchenko,R,CBJ,24,60,14,8,22
42,8481601,Simon Holmstrom,R,NYI,23,68,14,8,22
42,8479344,Jesse Puljujarvi,R,PIT,26,54,13,9,22
42,8478432,Christian Fischer,R,DET,27,75,11,11,22
42,8479439,Jacob MacDonald,D,COL,31,56,11,11,22
42,8476878,Zemgus Girgensons,C,TBL,30,81,11,11,22
42,8476419,Jean-Gabriel Pageau,C,NYI,32,77,10,12,22
42,8480205,Emil Bemstrom,C,PIT,25,63,10,12,22
42,8480835,Jack Drury,C,CAR,24,57,9,13,22
42,8482125,Alexander Holtz,R,VGK,22,68,9,13,22
42,8480748,Kiefer Sherwood,L,VAN,29,67,9,13,22
42,8476422,Mike Reilly,D,NYI,31,73,9,13,22
42,8475791,Taylor Hall,L,CHI,33,56,8,14,22
42,8478508,Yakov Trenin,C,MIN,27,56,8,14,22
42,8478434,Keegan Kolesar,R,VGK,27,76,7,15,22
42,8474574,Tyler Myers,D,VAN,34,67,6,16,22
42,8478882,Vladislav Gavrikov,D,LAK,29,69,5,17,22
42,8478851,Alexandre Carrier,D,NSH,28,67,5,17,22
42,8479976,Juuso Valimaki,D,UTA,26,65,2,20,22
42,8476917,Adam Pelech,D,NYI,30,78,2,20,22
42,8474151,Ryan McDonagh,D,TBL,35,81,2,20,22
42,8481477,Nico Sturm,C,SJS,29,61,15,6,21
42,8480448,Parker Kelly,L,COL,25,77,13,8,21
42,8477903,Garnet Hathaway,R,PHI,33,65,11,10,21
42,8482679,Matt Coronato,R,CGY,22,54,11,10,21
42,8482737,Zack Bolduc,C,STL,21,54,11,10,21
42,8476889,Radek Faksa,C,STL,30,59,11,10,21
42,8482155,Alex Laferriere,R,LAK,23,61,10,11,21
42,8478013,Jake Walman,D,SJS,28,72,9,12,21
42,8476988,Matt Benning,D,SJS,30,60,8,13,21
42,8478020,Michael Amadio,R,OTT,28,74,7,14,21
42,8479982,Conor Timmins,D,TOR,26,58,7,14,21
42,8476624,Barclay Goodrow,C,SJS,31,49,7,14,21
42,8475220,Marcus Foligno,L,MIN,33,58,5,16,21
42,8483491,Ivan Miroshnichenko,L,WSH,20,53,5,16,21
42,8482245,Artem Zub,D,OTT,29,67,5,16,21
42,8478840,Will Borgen,D,SEA,28,64,4,17,21
42,8479402,Jake Bean,D,CGY,26,70,2,19,21
42,8480145,Neal Pionk,D,WPG,29,74,1,20,21
42,8476467,Jamie Oleksiak,D,SEA,32,69,1,20,21
42,8479368,Max Jones,L,BOS,26,56,12,8,20
42,8479066,Ryan Lomberg,L,CGY,30,68,11,9,20
42,8477406,Mattias Janmark,C,EDM,32,65,9,11,20
42,8480289,Morgan Barron,C,WPG,26,52,8,12,20
42,8481481,Blake Lizotte,C,PIT,27,55,7,13,20
42,8483495,Simon Nemec,D,NJD,20,58,7,13,20
42,8476856,Mathew Dumba,D,DAL,30,68,5,15,20
42,8475324,Nick Jensen,D,OTT,34,71,4,16,20
42,8476457,Adam Larsson,D,SEA,32,69,2,18,20
42,8481028,Martin Pospisil,C,CGY,25,65,13,6,19
42,8478569,Noel Acciari,C,PIT,33,55,10,9,19
42,8479393,Noah Gregor,L,OTT,26,71,7,12,19
42,8481527,Kaedan Korczak,D,VGK,23,52,7,12,19
42,8476994,Vinnie Hinostroza,C,NSH,30,49,7,12,19
42,8477507,Nikita Zadorov,D,BOS,29,64,5,14,19
42,8480073,Erik Brannstrom,D,COL,25,60,4,15,19
42,8479980,Nicolas Hague,D,VGK,26,54,4,15,19
42,8481704,Juuso Parssinen,C,NSH,23,56,4,15,19
42,8480796,Martin Fehervary,D,WSH,25,54,4,15,19
42,8475188,Brayden McNabb,D,VGK,33,53,3,16,19
42,8482073,Braden Schneider,D,NYR,23,65,3,16,19
42,8479348,Kale Clague,D,BUF,26,50,2,17,19
42,8476891,Matthew Grzelcyk,D,PIT,30,77,1,18,19
42,8481550,Adam Beckman,L,NJD,23,38,13,5,18
42,8481553,Bobby Brink,R,PHI,23,63,11,7,18
42,8479996,Cody Glass,C,NSH,25,57,10,8,18
42,8479353,Brett Howden,C,VGK,26,64,10,8,18
42,8477392,Hudson Fasching,R,NYI,29,60,10,8,18
42,8470621,Corey Perry,R,EDM,39,66,9,9,18
42,8481641,Joel Kiviranta,L,COL,28,69,9,9,18
42,8480789,Oliver Wahlstrom,R,NYI,24,71,9,9,18
42,8482157,Will Cuylle,L,NYR,22,67,8,10,18
42,8480762,Eric Robinson,L,CAR,29,53,7,11,18
42,8477508,Curtis Lazar,C,NJD,29,55,7,11,18
42,8479414,Nathan Bastian,R,NJD,27,53,7,11,18
42,8475790,Erik Gudbranson,D,CBJ,32,77,6,12,18
42,8479316,Luke Kunin,C,SJS,27,57,5,13,18
42,8479718,Alex Barré-Boulet,C,MTL,27,54,5,13,18
42,8475233,David Savard,D,MTL,34,63,1,17,18
42,8476873,Mark Jankowski,C,NSH,30,54,13,4,17
42,8481716,Dmitri Voronkov,L,CBJ,24,47,11,6,17
42,8480995,Pontus Holmberg,R,TOR,25,58,10,7,17
42,8480813,Joe Veleno,C,DET,24,73,9,8,17
42,8482809,Jackson Blake,R,CAR,21,50,9,8,17
42,8481517,Brett Leason,R,ANA,25,59,9,8,17
42,8483457,Lane Hutson,D,MTL,20,64,8,9,17
42,8474034,Patrick Maroon,L,CHI,36,57,8,9,17
42,8479639,Dylan Coghlan,D,WPG,26,63,7,10,17
42,8482062,Cole Smith,L,NSH,29,57,7,10,17
42,8482451,Mikael Pyyhtia,L,CBJ,23,54,7,10,17
42,8477450,Jason Dickinson,C,CHI,29,56,6,11,17
42,8473453,Trevor Lewis,C,LAK,37,74,6,11,17
42,8480172,Jan Rutta,D,SJS,34,62,5,12,17
42,8482192,Isaak Phillips,D,CHI,23,56,5,12,17
42,8483468,Jiri Kulich,C,BUF,20,54,4,13,17
42,8470600,Ryan Suter,D,STL,39,60,4,13,17
42,8480222,Sebastian Aho,D,PIT,28,71,3,14,17
42,8477845,Trevor van Riemsdyk,D,WSH,33,60,3,14,17
42,8483466,Kevin Korchinski,D,CHI,20,52,3,14,17
42,8480727,Zach Whitecloud,D,VGK,28,43,2,15,17
42,8478416,Erik Cernak,D,TBL,27,73,2,15,17
42,8479315,Joey Anderson,R,CHI,26,45,9,7,16
42,8480021,Jack Studnicka,C,LAK,25,61,9,7,16
42,8479543,Michael Pezzetta,L,MTL,26,57,9,7,16
42,8481013,Jonatan Berggren,R,DET,24,56,8,8,16
42,8477987,Ryan Donato,C,CHI,28,59,7,9,16
42,8480025,MacKenzie Entwistle,R,FLA,25,58,7,9,16
42,8477015,Connor Brown,R,EDM,30,64,6,10,16
42,8477365,Connor Clifton,D,BUF,29,56,6,10,16
42,8475455,Brenden Dillon,D,NJD,34,59,4,12,16
42,8484149,Gavin Brindley,C,CBJ,20,50,4,12,16
42,8480950,Ilya Lyubushkin,D,DAL,30,60,4,12,16
42,8474567,Zach Bogosian,D,MIN,34,63,4,12,16
42,8480035,Henri Jokiharju,D,BUF,25,63,3,13,16
42,8476931,Jake McCabe,D,TOR,31,66,3,13,16
42,8481014,Alexander Romanov,D,NYI,24,78,2,14,16
42,8478136,Jake Middleton,D,MIN,28,74,2,14,16
42,8478399,Jonas Siegenthaler,D,NJD,27,60,1,15,16
42,8478443,Brandon Carlo,D,BOS,28,64,1,15,16
42,8474673,TJ Brodie,D,CHI,34,59,0,16,16
42,8482659,Josh Doan,R,UTA,22,49,10,5,15
42,8478211,Dryden Hunt,L,CGY,29,58,9,6,15
42,8477446,Michael McCarron,R,NSH,29,50,9,6,15
42,8480980,Connor Dewar,C,TOR,25,69,8,7,15
42,8482859,Zack Ostapchuk,C,OTT,21,58,8,7,15
42,8477401,John Hayden,C,SEA,29,30,8,7,15
42,8482807,Ethan Del Mastro,D,CHI,21,50,7,8,15
42,8475279,Ben Chiarot,D,DET,33,71,6,9,15
42,8481537,Nikita Okhotiuk,D,CGY,24,53,5,10,15
42,8477931,Tomas Nosek,L,FLA,32,67,4,11,15
42,8475855,Jesper Fast,R,CAR,33,52,3,12,15
42,8473507,Jeff Petry,D,DET,37,69,3,12,15
42,8480058,Pierre-Olivier Joseph,D,STL,25,54,3,12,15
42,8481568,Alex Vlasic,D,CHI,23,53,3,12,15
42,8474013,Ian Cole,D,UTA,35,54,3,12,15
42,8477499,Rasmus Ristolainen,D,PHI,30,66,2,13,15
42,8481522,Peyton Krebs,C,BUF,23,63,2,13,15
42,8480807,Mattias Samuelsson,D,BUF,24,57,1,14,15
42,8478178,Darren Raddysh,D,TBL,28,67,1,14,15
42,8480011,Klim Kostin,C,SJS,25,50,1,14,15
42,8480887,Jordan Harris,D,MTL,24,59,1,14,15
42,8481518,Nolan Foote,L,NJD,24,43,8,6,14
42,8480355,Mark Kastelic,C,BOS,25,64,7,7,14
42,8482148,Hendrix Lapierre,C,WSH,22,49,7,7,14
42,8479370,Tyson Jost,C,CAR,26,55,7,7,14
42,8481592,Jakob Pelletier,L,CGY,23,39,6,8,14
42,8477380,Jonny Brodzinski,C,NYR,31,46,5,9,14
42,8483493,Frank Nazar,C,CHI,20,47,5,9,14
42,8477369,Carson Soucy,D,VAN,30,61,5,9,14
42,8479369,Andrew Peeke,D,BOS,26,56,5,9,14
42,8480246,Nick Perbix,D,TBL,26,73,4,10,14
42,8476934,Brock McGinn,L,ANA,30,53,4,10,14
42,8475462,Radko Gudas,D,ANA,34,67,4,10,14
42,8474568,Luke Schenn,D,NSH,35,55,4,10,14
42,8482176,Wyatt Kaiser,D,CHI,22,57,3,11,14
42,8475179,Dmitry Kulikov,D,FLA,34,61,3,11,14
42,8481059,Scott Perunovich,D,STL,26,58,3,11,14
42,8479026,Philippe Myers,D,TOR,27,49,3,11,14
42,8476525,Colin Miller,D,WPG,32,62,3,11,14
42,8481617,Vasily Podkolzin,R,VAN,23,46,3,11,14
42,8476429,Scott Mayfield,D,NYI,32,74,2,12,14
42,8484911,Collin Graf,R,SJS,22,35,9,4,13
42,8478585,Derek Ryan,C,EDM,38,61,8,5,13
42,8476822,Luke Glendening,C,TBL,35,80,7,6,13
42,8479328,Julien Gauthier,R,NYI,27,56,6,7,13
42,8477070,Liam O'Brien,C,UTA,30,64,6,7,13
42,8482166,Shakir Mukhamadullin,D,SJS,22,57,6,7,13
42,8479291,Kevin Rooney,C,CGY,31,53,5,8,13
42,8481708,Zac Jones,D,NYR,24,50,5,8,13
42,8479359,Beck Malenstyn,L,BUF,26,46,5,8,13
42,8483499,Liam Ohgren,L,MIN,20,57,4,9,13
42,8479671,Mathieu Olivier,R,CBJ,27,38,4,9,13
42,8478421,A.J. Greer,L,FLA,28,61,3,10,13
42,8477335,Kyle Burroughs,D,LAK,29,39,3,10,13
42,8480192,Johnathan Kovacevic,D,NJD,27,54,3,10,13
42,8476312,Josh Manson,D,COL,33,57,1,12,13
42,8476967,Brett Kulak,D,EDM,30,60,1,12,13
42,8477573,Nathan Walker,L,STL,30,53,8,4,12
42,8479336,Carl Grundstrom,R,SJS,27,55,6,6,12
42,8482751,Ryan Winterton,C,SEA,21,42,6,6,12
42,8477018,Ben Hutton,D,VGK,31,48,5,7,12
42,8471709,Marc-Edouard Vlasic,D,SJS,37,56,5,7,12
42,8480157,Calle Rosen,D,COL,30,46,5,7,12
42,8476329,Travis Boyd,C,MIN,31,56,4,8,12
42,8476874,Olli Maatta,D,DET,30,66,4,8,12
42,8471677,Jack Johnson,D,CBJ,37,70,4,8,12
42,8479520,Brandon Duhaime,R,WSH,27,49,4,8,12
42,8476913,Devin Shore,C,MIN,30,31,4,8,12
42,8478452,Caleb Jones,D,LAK,27,55,3,9,12
42,8475718,Justin Holl,D,DET,32,57,3,9,12
42,8481441,Joe Snively,C,DET,28,65,2,10,12
42,8481019,David Gustafsson,C,WPG,24,52,2,10,12
42,8476442,Matt Nieto,L,PIT,32,48,2,10,12
42,8480860,Kevin Bahl,D,CGY,24,60,2,10,12
42,8479998,Mikey Anderson,D,LAK,25,55,1,11,12
42,8482744,James Malatesta,L,CBJ,21,40,1,11,12
42,8479371,Dante Fabbro,D,NSH,26,62,0,12,12
42,8482077,Dylan Holloway,L,EDM,23,54,8,3,11
42,8482803,Olen Zellweger,D,ANA,21,68,7,4,11
42,8483482,Tristan Luneau,D,ANA,20,70,7,4,11
42,8481147,Reese Johnson,C,MIN,26,42,7,4,11
42,8481161,Jake Christiansen,D,CBJ,25,50,5,6,11
42,8481751,Lukas Rousek,R,BUF,25,34,5,6,11
42,8481600,Tobias Bjornfot,D,FLA,23,34,5,6,11
42,8475690,Chris Tanev,D,TOR,35,51,3,8,11
42,8481521,Ronnie Attard,D,PHI,25,52,3,8,11
42,8483012,Logan Morrison,C,SEA,22,40,3,8,11
42,8480879,Jacob Bernard-Docker,D,OTT,24,50,2,9,11
42,8473446,Erik Johnson,D,PHI,36,51,1,10,11
42,8483565,Nick Blankenburg,D,NSH,26,54,7,3,10
42,8481754,Nikita Nesterenko,C,ANA,23,37,6,4,10
42,8482496,Nils Aman,C,VAN,24,39,6,4,10
42,8479994,Jaret Anderson-Dolan,C,WPG,25,39,5,5,10
42,8476867,Brendan Gaunce,C,MIN,30,34,4,6,10
42,8480001,Urho Vaakanainen,D,ANA,25,51,4,6,10
42,8481789,Tye Kartye,L,SEA,23,34,4,6,10
42,8478017,Mark Friedman,D,VAN,29,37,4,6,10
42,8479944,Zach Aston-Reese,C,VGK,30,48,3,7,10
42,8477962,Brendan Lemieux,L,CAR,28,40,3,7,10
42,8479419,Brett Murray,L,BUF,26,20,3,7,10
42,8474166,Alec Martinez,D,CHI,37,47,2,8,10
42,8481056,Spencer Stastney,D,NSH,24,37,2,8,10
42,8479249,Andrew Poturalski,C,SJS,30,39,1,9,10
42,8480990,Declan Chisholm,D,MIN,24,46,1,9,10
42,8481609,Vladislav Kolyachonok,D,UTA,23,35,6,3,9
42,8480845,Rasmus Kupari,C,WPG,24,43,5,4,9
42,8480806,Isac Lundestrom,C,ANA,25,55,4,5,9
42,8477482,Zachary Sanford,L,CHI,30,32,4,5,9
42,8480281,Alexey Toropchenko,R,STL,25,52,3,6,9
42,8478424,Jansen Harkins,C,ANA,27,35,3,6,9
42,8478468,Jeremy Lauzon,D,NSH,27,47,3,6,9
42,8478451,Ethan Bear,D,WSH,27,46,2,7,9
42,8477938,Haydn Fleury,D,WPG,28,40,2,7,9
42,8482095,Tyler Kleven,D,OTT,22,45,1,8,9
42,8475208,Brian Dumoulin,D,ANA,33,53,1,8,9
42,8482964,Arber Xhekaj,D,MTL,23,44,1,8,9
42,8480252,Cole Guttman,C,CHI,25,38,6,2,8
42,8480848,Ty Dellandrea,C,SJS,24,42,6,2,8
42,8480441,Trey Fix-Wolansky,R,CBJ,25,28,5,3,8
42,8479372,Joshua Mahura,D,SEA,26,51,3,5,8
42,8477034,Jaycob Megna,D,FLA,32,56,3,5,8
42,8475842,Sam Carrick,C,NYR,32,60,3,5,8
42,8481567,Henry Thrun,D,SJS,23,49,3,5,8
42,8482733,Logan Mailloux,D,MTL,31,35,3,5,8
42,8482666,Scott Morrow,D,CAR,22,46,3,5,8
42,8480844,Grigori Denisenko,L,VGK,24,34,3,5,8
42,8482634,Alex Steeves,C,TOR,25,40,2,6,8
42,8477851,Jordan Oesterle,D,BOS,32,37,2,6,8
42,8479986,Kole Lind,R,DAL,26,57,2,6,8
42,8481598,Philip Broberg,D,EDM,23,40,2,6,8
42,8479378,Logan Stanley,D,WPG,26,47,2,6,8
42,8483460,David Jiricek,D,CBJ,21,54,0,8,8
42,8480880,Jakub Lauko,C,MIN,24,33,6,1,7
42,8471817,Ryan Reaves,R,TOR,37,54,5,2,7
42,8482730,Brandt Clarke,D,LAK,21,46,4,3,7
42,8481532,Alex Turcotte,C,LAK,23,44,4,3,7
42,8482652,Walker Duehr,R,CGY,27,40,4,3,7
42,8481556,John Beecher,C,BOS,23,41,4,3,7
42,8478874,Adam Gaudette,R,OTT,28,40,3,4,7
42,8481599,Victor Soderstrom,D,UTA,23,37,2,5,7
42,8475750,Jon Merrill,D,MIN,32,56,2,5,7
42,8482153,Brendan Brisson,C,VGK,23,26,2,5,7
42,8477384,Joshua Brown,D,EDM,30,44,2,5,7
42,8474090,Brendan Smith,D,DAL,35,53,1,6,7
42,8479772,Zack MacEwen,R,OTT,28,54,1,6,7
42,8478146,Matthew Highmore,C,OTT,28,32,1,6,7
42,8482141,Lukas Cormier,D,VGK,22,29,1,6,7
42,8483570,Ben Meyers,C,SEA,26,32,6,0,6
42,8484254,Akito Hirose,D,VAN,25,36,4,2,6
42,8482144,Jack Thompson,D,SJS,22,26,4,2,6
42,8475235,Nicolas Deslauriers,L,PHI,33,45,4,2,6
42,8482762,Simon Edvinsson,D,DET,21,53,3,3,6
42,8476372,Nick Seeler,D,PHI,31,43,3,3,6
42,8479576,Vincent Desharnais,D,VAN,28,33,3,3,6
42,8479320,Maxime Lajoie,D,SEA,27,24,3,3,6
42,8479968,Vinni Lettieri,C,BOS,29,55,2,4,6
42,8479442,Troy Stecher,D,EDM,30,53,2,4,6
42,8480007,Jonas Rondbjerg,R,VGK,25,38,2,4,6
42,8483549,Lucas Condotta,L,MTL,27,34,2,4,6
42,8476441,Joel Edmundson,D,LAK,31,43,2,4,6
42,8484258,Sam Malinski,D,COL,26,18,2,4,6
42,8482858,Ryker Evans,D,SEA,23,19,2,4,6
42,8480834,Ty Emberson,D,SJS,24,33,2,4,6
42,8481167,Brayden Pachal,D,CGY,25,39,1,5,6
42,8475762,Derek Forbort,D,VAN,32,52,1,5,6
42,8483619,Filip Roos,D,OTT,25,30,1,5,6
42,8477473,Justin Bailey,R,SJS,29,23,1,5,6
42,8480070,Ian Mitchell,D,BOS,25,51,0,6,6
42,8475177,Calvin de Haan,D,COL,33,50,0,6,6
42,8481122,Simon Benoit,D,TOR,26,33,0,6,6
42,8478502,Dennis Gilbert,D,BUF,28,20,0,6,6
42,8482765,Isak Rosen,R,BUF,21,26,4,1,5
42,8479638,Justin Brazeau,R,BOS,26,36,4,1,5
42,8477467,Gustav Olofsson,D,SEA,30,20,4,1,5
42,8478409,Anthony Richard,C,PHI,28,29,3,2,5
42,8479536,Axel Jonsson-Fjallby,L,WPG,26,40,3,2,5
42,8482070,Mitchell Chaffee,R,TBL,26,52,3,2,5
42,8479379,Givani Smith,R,SJS,26,37,3,2,5
42,8478859,Niko Mikkola,D,FLA,28,54,2,3,5
42,8478831,Kevin Stenlund,C,UTA,28,52,2,3,5
42,8480245,Olle Lycksell,R,PHI,25,36,2,3,5
42,8480196,Jacob Bryson,D,BUF,27,37,2,3,5
42,8477887,Patrick Brown,C,BOS,32,36,2,3,5
42,8482145,Mavrik Bourque,C,DAL,22,41,2,3,5
42,8483630,Pavol Regenda,L,ANA,25,26,2,3,5
42,8474612,Travis Hamonic,D,OTT,34,45,2,3,5
42,8483763,Maksymilian Szuber,D,UTA,22,31,2,3,5
42,8476952,Dominic Toninato,C,WPG,30,28,1,4,5
42,8478454,Noah Juulsen,D,VAN,27,35,1,4,5
42,8481605,Jackson LaCombe,D,ANA,23,40,1,4,5
42,8482177,Marat Khusnutdinov,C,MIN,22,37,1,4,5
42,8477244,Chad Ruhwedel,D,NYR,34,32,0,5,5
42,8481679,Maxence Guenette,D,OTT,23,31,4,0,4
42,8482784,Zach Dean,C,STL,21,38,3,1,4
42,8481422,Jake Lucchini,C,NSH,29,28,3,1,4
42,8480468,James Hamblin,L,EDM,25,18,2,2,4
42,8479981,Jonah Gadjovich,L,FLA,26,38,2,2,4
42,8481699,Aku Raty,R,UTA,23,19,2,2,4
42,8480267,Sammy Walker,C,MIN,25,21,2,2,4
42,8482861,Vincent Iorio,D,WSH,22,29,1,3,4
42,8479972,Mason Shaw,C,WPG,26,22,1,3,4
42,8480084,Nick DeSimone,D,NJD,30,18,1,3,4
42,8482713,Mackie Samoskevich,R,FLA,22,36,1,3,4
42,8482516,Matthew Kessel,D,STL,24,21,1,3,4
42,8479367,William Lockwood,R,FLA,26,21,1,3,4
42,8478450,Parker Wotherspoon,D,BOS,27,27,0,4,4
42,8476473,Connor Murphy,D,CHI,31,38,0,4,4
42,8482250,Callahan Burke,C,VGK,27,29,0,4,4
42,8477320,Anton Blidh,L,NYR,29,20,0,4,4
42,8481006,Tyler Tucker,D,STL,24,11,0,4,4
42,8479587,Rhett Gardner,C,PHI,28,23,0,4,4
42,8482511,Mason Lohrei,D,BOS,23,40,2,1,3
42,8483397,Marc McLaughlin,C,BOS,25,26,2,1,3
42,8479330,Brandon Gignac,C,MTL,27,13,2,1,3
42,8482102,Vasily Ponomarev,C,PIT,22,20,1,2,3
42,8476858,Phillip Di Giuseppe,L,VAN,31,39,1,2,3
42,8483512,Matthew Savoie,C,EDM,20,22,1,2,3
42,8480292,Carson Meyer,R,ANA,27,27,1,2,3
42,8482172,Landon Slaggert,L,CHI,22,24,1,2,3
42,8479985,Cale Fleury,D,SEA,26,28,1,2,3
42,8478051,Max Willman,C,NJD,29,17,1,2,3
42,8477073,Kurtis MacDermid,L,NJD,30,28,1,2,3
42,8483395,Arshdeep Bains,L,VAN,23,11,1,2,3
42,8481543,Nikita Alexandrov,C,STL,24,23,1,2,3
42,8477810,Joel Hanley,D,CGY,33,27,1,2,3
42,8478021,William Lagesson,D,DET,28,26,1,2,3
42,8481585,Egor Afanasyev,L,SJS,23,10,0,3,3
42,8474062,Riley Nash,C,NYR,35,24,0,3,3
42,8475958,Michael Sgarbossa,C,WSH,32,37,0,3,3
42,8481806,Louis Crevier,D,CHI,23,11,0,3,3
42,8482201,Gage Goncalves,C,TBL,23,22,0,3,3
42,8481564,Ryan Johnson,D,BUF,23,15,0,3,3
42,8480823,Alexander Alexeyev,D,WSH,25,17,2,0,2
42,8478446,Glenn Gawdin,C,LAK,27,13,2,0,2
42,8483471,Brad Lambert,C,WPG,31,6,2,0,2
42,8480870,Bo Groulx,C,NYR,24,31,1,1,2
42,8484287,Cole McWard,D,VAN,23,21,1,1,2
42,8477462,Robert Hagg,D,VGK,29,30,1,1,2
42,8481030,Jack St. Ivany,D,PIT,25,13,1,1,2
42,8479991,Jake Leschyshyn,C,NYR,25,20,1,1,2
42,8480890,Jan Jenik,C,OTT,24,17,1,1,2
42,8479362,Riley Tufte,L,BOS,26,14,1,1,2
42,8480851,Akil Thomas,C,LAK,24,17,1,1,2
42,8475780,Chris Wagner,R,COL,33,9,1,1,2
42,8482094,Daemon Hunt,D,MIN,22,15,1,1,2
42,8483546,Marshall Rifai,D,TOR,26,5,1,1,2
42,8481701,Santeri Hatakka,D,NJD,23,36,0,2,2
42,8482747,Brennan Othmann,L,NYR,21,43,0,2,2
42,8477971,Andreas Englund,D,LAK,28,31,0,2,2
42,8482118,Sam Colangelo,R,ANA,23,16,0,2,2
42,8477527,Ross Johnston,L,ANA,30,28,0,2,2
42,8482165,Yan Kuznetsov,D,CGY,22,16,0,2,2
42,8482088,Justin Sourdif,R,FLA,22,23,0,2,2
42,8477149,Scott Sabourin,R,SJS,32,10,0,2,2
42,8482147,Jean-Luc Foudy,C,COL,22,33,1,0,1
42,8481237,Kyle MacLean,C,NYI,25,22,1,0,1
42,8482162,Roby Jarventie,L,EDM,22,17,1,0,1
42,8480032,Shane Bowers,C,NJD,25,15,1,0,1
42,8481462,Mason Morelli,L,VGK,28,3,1,0,1
42,8481024,Linus Karlsson,C,VAN,25,8,1,0,1
42,8478881,Brett Seney,L,CHI,28,10,1,0,1
42,8482470,Ilya Solovyov,D,CGY,24,17,1,0,1
42,8483489,Fraser Minten,C,TOR,31,10,1,0,1
42,8484325,Waltteri Merela,C,TBL,26,18,1,0,1
42,8476323,Max McCormick,L,SEA,32,4,1,0,1
42,8482061,Brandon Biro,L,SEA,26,9,1,0,1
42,8480075,Cameron Crotty,D,MIN,25,11,1,0,1
42,8482197,Adam Raska,R,MIN,23,9,1,0,1
42,8481719,Maxwell Crozier,D,TBL,24,9,0,1,1
42,8475795,Dylan McIlrath,D,WSH,32,15,0,1,1
42,8481541,Samuel Bolduc,D,NYI,24,25,0,1,1
42,8480874,Adam Ginning,D,PHI,24,6,0,1,1
42,8483597,Milos Kelemen,L,UTA,25,10,0,1,1
42,8481206,John Ludvig,D,PIT,24,12,0,1,1
42,8481065,Angus Crookshank,L,OTT,25,14,0,1,1
42,8481726,Adam Edstrom,C,NYR,24,5,0,1,1
42,8482460,Matt Rempe,C,NYR,22,5,0,1,1
42,8483567,Georgii Merkulov,C,BOS,24,12,0,1,1
42,8477993,Justin Kirkland,C,CGY,28,7,0,1,1
42,8482476,Emil Heineman,L,MTL,23,9,0,1,1
42,8484321,Nikolas Matinpalo,D,OTT,26,3,0,1,1
42,8477541,Dakota Mermis,D,TOR,30,15,0,1,1
42,8481578,Graeme Clarke,R,MIN,23,9,0,1,1
42,8478477,Mitchell Stephens,C,SEA,27,17,0,0,0
42,8481593,Jayden Struble,D,MTL,23,16,0,0,0
42,8482929,Emil Lilleberg,D,TBL,23,24,0,0,0
42,8481743,Marc Del Gaizo,D,NSH,25,16,0,0,0
42,8475413,Justin Dowling,C,NJD,34,11,0,0,0
42,8479421,Jacob Moverare,D,LAK,26,7,0,0,0
42,8478854,Ryan Shea,D,PIT,27,6,0,0,0
42,8481043,Cole Koepke,L,BOS,26,17,0,0,0
42,8484304,Uvis Balinskis,D,FLA,28,6,0,0,0
42,8478011,Louie Belpedio,D,PHI,28,7,0,0,0
42,8484255,Jason Polin,R,COL,25,4,0,0,0
42,8475755,Alexander Petrovic,D,DAL,32,8,0,0,0
42,8480306,Grant Hutton,D,NYI,29,8,0,0,0
42,8483407,Brandon Scanlin,D,NYR,25,1,0,0,0
42,8484326,Patrik Koch,D,UTA,28,1,0,0,0
42,8483432,Luca Del Bel Belluz,C,CBJ,31,7,0,0,0
42,8482787,Nikita Chibrikov,R,WPG,31,4,0,0,0
42,8479522,Hardy Haman Aktell,D,WSH,26,4,0,0,0
42,8483531,Brian Halonen,L,NJD,25,3,0,0,0
42,8482126,Emil Andrae,D,PHI,31,2,0,0,0
42,8483398,Declan Carlile,D,TBL,31,4,0,0,0
42,8481655,Cole Schwindt,R,CGY,23,5,0,0,0
42,8478147,Bokondji Imama,L,PIT,28,8,0,0,0
42,8483920,Pierrick Dube,R,WSH,23,5,0,0,0
42,8481534,Raphael Lavoie,C,EDM,24,2,0,0,0
42,8483609,Adam Klapka,R,CGY,24,3,0,0,0
42,8484259,Ondrej Pavel,C,COL,31,1,0,0,0
42,8480274,Philip Kemp,D,EDM,25,2,0,0,0
42,8483401,Marc Johnstone,R,PIT,28,0,0,0,0
42,8470794,Joe Pavelski,C,,40,0,0,0,0
42,8479321,Lucas Johansen,D,,27,0,0,0,0
42,8477950,Tony DeAngelo,D,,29,0,0,0,0
42,8471218,Blake Wheeler,R,,38,0,0,0,0
42,8475197,Tyson Barrie,D,,33,0,0,0,0
42,8474157,Max Pacioretty,L,,36,0,0,0,0
42,8475744,Evgeny Kuznetsov,C,,32,0,0,0,0
42,8474037,James van Riemsdyk,L,,35,0,0,0,0
42,8476907,Mackenzie MacEachern,L,,30,0,0,0,0
42,8480216,Jacob Peterson,C,,25,0,0,0,0
42,8474602,Justin Schultz,D,,34,0,0,0,0
42,8482222,Alexander Barabanov,L,,30,0,0,0,0
42,8474031,Kevin Shattenkirk,D,,35,0,0,0,0
42,8477330,Dominik Kubalik,L,,29,0,0,0,0
42,8480884,Calen Addison,D,,24,0,0,0,0
42,8475906,John Klingberg,D,,32,0,0,0,0
42,8480008,Adam Ruzicka,C,,25,0,0,0,0
42,8476884,Derrick Pouliot,D,,30,0,0,0,0
42,8476919,Chris Tierney,C,,30,0,0,0,0
42,8479415,Michael McLeod,C,,26,0,0,0,0
42,8474870,Tyler Johnson,C,,34,0,0,0,0
42,8470604,Jeff Carter,C,,39,0,0,0,0
42,8478104,Sammy Blais,L,,28,0,0,0,0
42,8474884,Mike Hoffman,C,,35,0,0,0,0
42,8481591,Sam Poulin,R,,23,0,0,0,0
42,8471274,Alex Goligoski,D,,39,0,0,0,0
42,8476871,Tanner Pearson,L,,32,0,0,0,0
42,8476393,Nick Cousins,C,,31,0,0,0,0
42,8479977,Kailer Yamamoto,R,,26,0,0,0,0
42,8479346,Dillon Dube,C,,26,0,0,0,0
42,8480184,Gustav Lindstrom,D,,26,0,0,0,0
42,8479376,Victor Mete,D,,26,0,0,0,0
42,8473449,Kyle Okposo,R,,36,0,0,0,0
42,8481058,Jesse Ylonen,R,,25,0,0,0,0
42,8475752,Tyler Pitlick,C,,33,0,0,0,0
42,8481239,Samuel Fagemo,L,,24,0,0,0,0
42,8480821,Filip Zadina,R,,25,0,0,0,0
42,8470966,Mark Giordano,D,,41,0,0,0,0
42,8478495,Denis Gurianov,R,,27,0,0,0,0
42,8477464,Nic Petan,C,,29,0,0,0,0
42,8478099,Kevin Labanc,R,,29,0,0,0,0
42,8482241,Radim Zohorna,L,,28,0,0,0,0
42,8474040,Sam Gagner,C,,35,0,0,0,0
42,8479514,Rem Pitlick,C,,27,0,0,0,0
42,8478430,Oliver Kylington,D,,27,0,0,0,0
42,8479533,Joona Koppanen,L,,26,0,0,0,0
42,8479984,Cal Foote,D,,26,0,0,0,0
42,8477126,Jayson Megna,C,,34,0,0,0,0
42,8475164,Jakob Silfverberg,R,,34,0,0,0,0
42,8474009,Nick Bonino,C,,36,0,0,0,0
42,8479458,Nikita Zaitsev,D,,33,0,0,0,0
42,8477944,Jakub Vrana,L,,28,0,0,0,0
42,8471699,Andrew Cogliano,C,,37,0,0,0,0
42,8478067,Oskar Lindblom,L,,28,0,0,0,0
42,8471686,Marc Staal,D,,37,0,0,0,0
42,8470610,Zach Parise,L,,40,0,0,0,0
42,8478904,Steven Lorentz,C,,28,0,0,0,0
42,8473473,Milan Lucic,L,,36,0,0,0,0
42,8480031,Maxime Comtois,L,,25,0,0,0,0
42,8478512,Austin Czarnik,C,,32,0,0,0,0
42,8473504,Cal Clutterbuck,R,,37,0,0,0,0
42,8477454,Adam Erne,L,,29,0,0,0,0
42,8479383,Boris Katchouk,L,,26,0,0,0,0
42,8475825,Jani Hakanpää,D,,32,0,0,0,0
42,8477846,Ryan Carpenter,C,,33,0,0,0,0
42,8477930,Pierre-Edouard Bellemare,L,,39,0,0,0,0
42,8478400,Colin White,C,,27,0,0,0,0
42,8480226,Marián Studenic,R,,26,0,0,0,0
42,8480853,Liam Foudy,C,,24,0,0,0,0
42,8475797,Jarred Tinordi,D,,32,0,0,0,0
42,8479423,Alex Nylander,L,,26,0,0,0,0
42,8474618,Marco Scandella,D,,34,0,0,0,0
42,8478028,Fredrik Olofsson,L,,28,0,0,0,0
42,8474709,Matt Martin,L,,35,0,0,0,0
42,8481070,Hugh McGing,L,,26,0,0,0,0
42,8479546,Oskar Steen,C,,26,0,0,0,0
42,8474145,Robert Bortuzzo,D,,35,0,0,0,0
42,8476915,Jujhar Khaira,L,,30,0,0,0,0
42,8475278,Byron Froese,C,,33,0,0,0,0
42,8481812,Nikolai Knyzhov,D,,27,0,0,0,0
42,8478408,Travis Dermott,D,,28,0,0,0,0
42,8481077,John Leonard,L,,26,0,0,0,0
42,8479547,Matthew Phillips,R,,26,0,0,0,0
42,8480836,Jonathan Gruden,C,,24,0,0,0,0
42,8481690,Tyler Angle,C,,24,0,0,0,0
42,8475766,Austin Watson,L,,32,0,0,0,0
42,8481016,Ruslan Iskhakov,C,,24,0,0,0,0
42,8478078,Rourke Chartier,C,,28,0,0,0,0
42,8480776,Sheldon Rempal,R,,29,0,0,0,0
42,8478956,Samuel Laberge,L,NJD,27,2,0,0,0
42,8483045,Cameron Butler,R,CBJ,31,0,0,0,0
42,8484314,Jiri Smejkal,L,,28,0,0,0,0
43,8477492,Nathan MacKinnon,C,COL,29,82,58,84,142
43,8478402,Connor McDavid,C,EDM,27,80,33,102,135
43,8478483,Mitch Marner,R,TOR,27,76,44,84,128
43,8481559,Jack Hughes,C,NJD,23,72,44,75,119
43,8479314,Matthew Tkachuk,L,FLA,27,80,35,82,117
43,8476453,Nikita Kucherov,R,TBL,31,82,23,88,111
43,8477934,Leon Draisaitl,C,EDM,29,81,50,60,110
43,8480012,Elias Pettersson,C,VAN,26,74,41,68,109
43,8477404,Jake Guentzel,C,TBL,30,82,51,57,108
43,8477939,William Nylander,R,TOR,28,80,40,67,107
43,8477956,David Pastrnak,R,BOS,28,81,51,54,105
43,8478010,Brayden Point,C,TBL,28,82,53,51,104
43,8478550,Artemi Panarin,L,NYR,33,75,35,67,102
43,8480800,Quinn Hughes,D,VAN,25,77,10,91,101
43,8475913,Mark Stone,R,VGK,32,76,33,66,99
43,8474600,Roman Josi,D,NSH,34,74,35,63,98
43,8478439,Travis Konecny,R,PHI,27,78,41,56,97
43,8476468,J.T. Miller,C,VAN,31,73,33,64,97
43,8479318,Auston Matthews,C,TOR,27,76,53,43,96
43,8474564,Steven Stamkos,C,NSH,34,75,38,58,96
43,8477942,Kevin Fiala,L,LAK,28,81,33,63,96
43,8477946,Dylan Larkin,C,DET,28,82,41,51,92
43,8478864,Kirill Kaprizov,L,MIN,27,74,40,51,91
43,8477951,Nick Schmaltz,C,UTA,28,76,34,57,91
43,8477493,Aleksander Barkov,C,FLA,29,78,27,64,91
43,8477933,Sam Reinhart,C,FLA,29,80,40,47,87
43,8471685,Anze Kopitar,C,LAK,37,81,29,58,87
43,8479343,Clayton Keller,R,UTA,26,80,37,49,86
43,8478420,Mikko Rantanen,R,COL,28,79,35,51,86
43,8479407,Jesper Bratt,L,NJD,26,79,32,54,86
43,8479323,Adam Fox,D,NYR,26,76,18,68,86
43,8480801,Brady Tkachuk,L,OTT,25,81,43,41,84
43,8478460,Zach Werenski,D,CBJ,27,80,18,64,82
43,8477960,Adrian Kempe,R,LAK,28,80,33,48,81
43,8474141,Patrick Kane,R,DET,36,82,33,48,81
43,8475172,Nazem Kadri,C,CGY,34,78,25,56,81
43,8476389,Vincent Trocheck,C,NYR,31,72,35,45,80
43,8471675,Sidney Crosby,C,PIT,37,73,33,47,80
43,8476887,Filip Forsberg,L,NSH,30,74,32,48,80
43,8480002,Nico Hischier,C,NJD,25,76,30,50,80
43,8478403,Jack Eichel,C,VGK,28,81,38,41,79
43,8480027,Jason Robertson,L,DAL,25,82,30,49,79
43,8476460,Mark Scheifele,C,WPG,31,75,35,43,78
43,8480069,Cale Makar,D,COL,26,68,35,43,78
43,8476459,Mika Zibanejad,C,NYR,31,82,29,49,78
43,8476454,Ryan Nugent-Hopkins,C,EDM,31,76,25,52,77
43,8478427,Sebastian Aho,C,CAR,27,74,24,53,77
43,8478407,Vince Dunn,D,SEA,28,77,15,61,76
43,8480865,Noah Dobson,D,NYI,24,79,12,64,76
43,8484144,Connor Bedard,C,CHI,19,70,26,49,75
43,8477409,Carter Verhaeghe,C,FLA,29,81,32,42,74
43,8479542,Brandon Hagel,L,TBL,26,82,31,43,74
43,8478445,Mathew Barzal,C,NYI,27,80,13,61,74
43,8479675,Trevor Moore,L,LAK,29,77,46,27,73
43,8477501,Valeri Nichushkin,R,COL,29,81,36,37,73
43,8480208,Drake Batherson,R,OTT,26,81,28,45,73
43,8475166,John Tavares,C,TOR,34,76,23,50,73
43,8479337,Alex DeBrincat,R,DET,27,80,34,38,72
43,8482093,Seth Jarvis,C,CAR,22,76,34,38,72
43,8478401,Pavel Zacha,C,BOS,27,77,26,45,71
43,8480023,Robert Thomas,C,STL,25,72,21,49,70
43,8482740,Wyatt Johnston,C,DAL,21,81,36,33,69
43,8477949,Alex Tuch,R,BUF,28,75,21,48,69
43,8477940,Nikolaj Ehlers,L,WPG,28,70,30,38,68
43,8480018,Nick Suzuki,C,MTL,25,75,29,39,68
43,8478398,Kyle Connor,L,WPG,28,69,27,41,68
43,8476346,Johnny Gaudreau,L,CBJ,31,70,17,51,68
43,8476432,Boone Jenner,C,CBJ,31,72,42,25,67
43,8477402,Pavel Buchnevich,L,STL,29,77,36,31,67
43,8481557,Matt Boldy,L,MIN,23,74,29,38,67
43,8475784,Jeff Skinner,C,EDM,32,79,24,43,67
43,8475692,Mats Zuccarello,R,MIN,37,70,12,55,67
43,8473419,Brad Marchand,L,BOS,36,79,23,43,66
43,8473512,Claude Giroux,R,OTT,36,77,20,46,66
43,8478440,Dylan Strome,C,WSH,27,73,31,34,65
43,8473994,Jamie Benn,L,DAL,35,78,29,36,65
43,8474563,Drew Doughty,D,LAK,35,70,14,51,65
43,8476853,Morgan Rielly,D,TOR,30,71,13,52,65
43,8477504,Josh Morrissey,D,WPG,29,77,11,54,65
43,8477500,Bo Horvat,C,NYI,29,82,32,32,64
43,8480036,Miro Heiskanen,D,DAL,25,76,14,50,64
43,8475184,Chris Kreider,L,NYR,33,79,37,26,63
43,8479420,Tage Thompson,C,BUF,27,75,31,32,63
43,8476448,William Karlsson,C,VGK,31,77,25,38,63
43,8479425,Filip Hronek,D,VAN,27,71,16,47,63
43,8480803,Evan Bouchard,D,EDM,25,74,15,48,63
43,8477494,Jonathan Drouin,L,COL,29,81,14,49,63
43,8478449,Roope Hintz,C,DAL,28,81,24,38,62
43,8475167,Victor Hedman,D,TBL,34,79,8,54,62
43,8475786,Zach Hyman,L,EDM,32,78,30,31,61
43,8482116,Tim Stützle,C,OTT,22,80,17,44,61
43,8478414,Timo Meier,R,NJD,28,76,32,28,60
43,8475810,Bryan Rust,R,PIT,32,70,24,36,60
43,8475754,Brock Nelson,C,NYI,33,79,30,29,59
43,8478493,Joel Eriksson Ek,C,MIN,27,73,26,33,59
43,8475798,Mikael Granlund,C,SJS,32,72,15,44,59
43,8478397,Rasmus Andersson,D,CGY,28,75,13,46,59
43,8474590,John Carlson,D,WSH,34,67,12,47,59
43,8476539,Jonathan Marchessault,R,NSH,34,74,29,28,57
43,8477955,Jared McCann,L,SEA,28,76,29,28,57
43,8481540,Cole Caufield,R,MTL,23,74,29,28,57
43,8471214,Alex Ovechkin,L,WSH,39,71,25,32,57
43,8477496,Elias Lindholm,C,BOS,30,77,20,37,57
43,8471215,Evgeni Malkin,C,PIT,38,74,19,38,57
43,8478975,Mason Marchment,L,DAL,29,82,18,39,57
43,8477986,Brandon Montour,D,SEA,30,73,13,44,57
43,8476875,Mike Matheson,D,MTL,30,75,13,44,57
43,8475794,Tyler Seguin,C,DAL,32,81,30,26,56
43,8482699,Dylan Guenther,R,UTA,21,73,23,33,56
43,8483808,Andrei Kuzmenko,L,CGY,28,75,21,35,56
43,8482684,Luke Hughes,D,NJD,21,77,7,49,56
43,8479385,Jordan Kyrou,C,STL,26,74,26,29,55
43,8475768,Jaden Schwartz,C,SEA,32,73,24,31,55
43,8474102,David Perron,L,OTT,36,79,20,35,55
43,8475158,Ryan O'Reilly,C,NSH,33,76,18,37,55
43,8474578,Erik Karlsson,D,PIT,34,79,15,40,55
43,8476456,Jonathan Huberdeau,C,CGY,31,74,12,43,55
43,8478474,Lawson Crouse,L,UTA,27,75,26,28,54
43,8475170,Brayden Schenn,C,STL,33,75,22,32,54
43,8471724,Kris Letang,D,PIT,37,81,15,39,54
43,8481711,Matias Maccelli,L,UTA,24,73,14,40,54
43,8478057,Dakota Joshua,C,VAN,28,68,20,33,53
43,8477416,Oliver Bjorkstrand,R,SEA,29,73,21,31,52
43,8478047,Michael Bunting,L,PIT,29,69,18,34,52
43,8475753,Justin Faulk,D,STL,32,75,18,34,52
43,8479999,Casey Mittelstadt,C,COL,26,81,17,35,52
43,8475151,Kyle Palmieri,C,NYI,33,79,28,23,51
43,8476881,Tomas Hertl,C,VGK,31,77,26,25,51
43,8482109,Alexis Lafrenière,L,NYR,23,75,26,25,51
43,8477964,Ivan Barbashev,C,VGK,29,76,23,28,51
43,8480839,Rasmus Dahlin,D,BUF,24,71,18,33,51
43,8476905,Chandler Stephenson,C,SEA,30,76,13,38,51
43,8478519,Anthony Cirelli,C,TBL,27,82,19,31,50
43,8480830,Andrei Svechnikov,R,CAR,24,70,18,32,50
43,8476927,Teddy Blueger,C,VAN,30,65,18,32,50
43,8476906,Shayne Gostisbehere,D,CAR,31,77,15,35,50
43,8481542,Moritz Seider,D,DET,23,79,11,39,50
43,8475726,Tyler Toffoli,C,SJS,32,72,32,17,49
43,8482159,Tyson Foerster,R,PHI,22,78,24,25,49
43,8477503,Max Domi,C,TOR,29,77,20,29,49
43,8478458,John (Jack) Roslovic,C,CAR,27,64,20,29,49
43,8475191,Reilly Smith,R,NYR,33,76,16,33,49
43,8475765,Vladimir Tarasenko,R,DET,33,79,13,36,49
43,8475169,Evander Kane,L,EDM,33,71,29,19,48
43,8480014,Gabriel Vilardi,C,WPG,25,71,28,20,48
43,8478462,Nicolas Roy,C,VGK,27,75,26,22,48
43,8481068,Yegor Sharangovich,C,CGY,26,80,25,23,48
43,8480015,Owen Tippett,R,PHI,25,75,25,23,48
43,8477935,Sam Bennett,C,FLA,28,73,24,24,48
43,8482078,Lucas Raymond,L,DET,22,81,23,25,48
43,8475168,Matt Duchene,C,DAL,33,81,20,28,48
43,8475287,Erik Haula,L,NJD,33,76,19,29,48
43,8476479,Phillip Danault,C,LAK,31,79,17,31,48
43,8475745,Charlie Coyle,C,BOS,32,77,14,34,48
43,8476882,Teuvo Teravainen,C,CHI,30,63,14,34,48
43,8478498,Jake DeBrusk,L,VAN,28,70,31,16,47
43,8478233,Andrew Mangiapane,L,WSH,28,62,25,22,47
43,8480797,Joel Farabee,L,PHI,24,71,21,26,47
43,8478873,Troy Terry,R,ANA,27,74,20,27,47
43,8474150,Mikael Backlund,C,CGY,35,74,19,28,47
43,8481560,Arthur Kaliyev,R,LAK,23,79,19,28,47
43,8482113,Anton Lundell,C,FLA,23,77,27,19,46
43,8477407,Anthony Duclair,L,NYI,29,78,16,30,46
43,8478055,Gustav Forsling,D,FLA,28,69,11,35,46
43,8482667,William Eklund,L,SJS,22,72,19,26,45
43,8482745,Mason McTavish,C,ANA,21,74,12,33,45
43,8478038,Devon Toews,D,COL,30,74,10,35,45
43,8482110,Dawson Mercer,C,NJD,23,70,25,19,44
43,8476483,Rickard Rakell,R,PIT,31,72,23,21,44
43,8479591,Michael Eyssimont,C,TBL,28,81,21,23,44
43,8475799,Nino Niederreiter,R,WPG,32,66,21,23,44
43,8477456,J.T. Compher,L,DET,29,78,19,25,44
43,8474586,Jordan Eberle,R,SEA,34,76,18,26,44
43,8478444,Brock Boeser,R,VAN,27,69,15,29,44
43,8474679,Gustav Nyquist,C,NSH,35,73,15,29,44
43,8480798,Philipp Kurashev,C,CHI,25,67,12,32,44
43,8477932,Aaron Ekblad,D,FLA,28,69,8,36,44
43,8480064,Josh Norris,C,OTT,25,76,23,20,43
43,8476399,Blake Coleman,C,CGY,33,77,22,21,43
43,8482665,Matty Beniers,C,SEA,22,71,20,23,43
43,8484153,Leo Carlsson,C,ANA,20,71,19,24,43
43,8481186,Logan O'Connor,R,COL,28,78,19,24,43
43,8481596,Shane Pinto,C,OTT,24,78,18,25,43
43,8477346,MacKenzie Weegar,D,CGY,30,71,17,26,43
43,8477447,Shea Theodore,D,VGK,29,61,11,32,43
43,8480039,Martin Necas,C,CAR,25,71,26,16,42
43,8476438,Brandon Saad,L,STL,32,72,19,23,42
43,8476458,Ryan Strome,C,ANA,31,72,18,24,42
43,8482097,Jack Quinn,R,BUF,23,69,17,25,42
43,8484166,Adam Fantilli,C,CBJ,20,65,17,25,42
43,8477476,Artturi Lehkonen,L,COL,29,80,15,27,42
43,8476792,Torey Krug,D,STL,33,73,14,28,42
43,8479345,Jakob Chychrun,D,WSH,26,66,11,31,42
43,8478396,Noah Hanifin,D,VGK,27,69,9,33,42
43,8482124,Quinton Byfield,R,LAK,22,79,8,34,42
43,8470613,Brent Burns,D,CAR,39,76,8,34,42
43,8476923,Damon Severson,D,CBJ,30,80,7,35,42
43,8476958,Jaccob Slavin,D,CAR,30,79,5,37,42
43,8482702,Logan Stankoven,C,DAL,21,79,25,16,41
43,8475848,Brendan Gallagher,R,MTL,32,74,19,22,41
43,8482092,Ridly Greig,C,OTT,22,74,17,24,41
43,8476419,Jean-Gabriel Pageau,C,NYI,32,80,17,24,41
43,8481528,Dylan Cozens,C,BUF,23,63,16,25,41
43,8479325,Charlie McAvoy,D,BOS,27,76,9,32,41
43,8481581,Thomas Harley,D,DAL,23,73,9,32,41
43,8480434,Sean Durzi,D,UTA,26,70,7,34,41
43,8477426,Nicholas Paul,L,TBL,29,82,26,14,40
43,8481582,Nicholas Robertson,L,TOR,23,64,23,17,40
43,8471698,T.J. Oshie,R,WSH,38,65,20,20,40
43,8483515,Juraj Slafkovsky,L,MTL,20,76,19,21,40
43,8477444,Andre Burakovsky,L,SEA,29,68,19,21,40
43,8479400,Pierre-Luc Dubois,L,WSH,26,75,17,23,40
43,8477998,Warren Foegele,L,LAK,28,79,17,23,40
43,8476872,Scott Laughton,C,PHI,30,75,17,23,40
43,8482705,Cole Sillinger,C,CBJ,21,65,16,24,40
43,8480188,Fabian Zetterlund,L,SJS,25,68,15,25,40
43,8480849,Barrett Hayton,C,UTA,24,76,14,26,40
43,8483431,Logan Cooley,C,UTA,20,75,13,27,40
43,8476869,Brady Skjei,D,NSH,30,72,13,27,40
43,8475200,Dmitry Orlov,D,CAR,33,76,12,28,40
43,8477948,Travis Sanheim,D,PHI,28,72,10,30,40
43,8481577,Philip Tomasino,C,NSH,23,66,9,31,40
43,8474641,Adam Henrique,C,EDM,34,73,21,18,39
43,8477451,Ryan Hartman,R,MIN,30,68,20,19,39
43,8479987,Morgan Geekie,C,BOS,26,76,20,19,39
43,8477479,Tyler Bertuzzi,L,CHI,29,67,19,20,39
43,8480028,Morgan Frost,C,PHI,25,75,18,21,39
43,8475149,Marcus Johansson,L,MIN,34,60,16,23,39
43,8473986,Alex Killorn,L,ANA,35,74,15,24,39
43,8477429,Andrew Copp,C,DET,30,79,14,25,39
43,8482122,Brock Faber,D,MIN,22,76,13,26,39
43,8478366,Frank Vatrano,R,ANA,30,74,21,17,38
43,8476474,Stefan Noesen,R,NJD,31,69,21,17,38
43,8479525,Ross Colton,C,COL,28,78,20,18,38
43,8478856,Conor Garland,R,VAN,28,72,18,20,38
43,8477497,Sean Monahan,C,CBJ,30,66,17,21,38
43,8478438,Tommy Novak,C,NSH,27,70,11,27,38
43,8474151,Ryan McDonagh,D,TBL,35,76,4,34,38
43,8480459,Pius Suter,C,VAN,28,69,21,16,37
43,8478466,Daniel Sprong,R,VAN,27,70,19,18,37
43,8482149,Cole Perfetti,C,WPG,22,69,17,20,37
43,8479339,Patrik Laine,L,CBJ,26,62,17,20,37
43,8478042,Viktor Arvidsson,L,EDM,31,66,15,22,37
43,8481618,Alex Newhook,C,MTL,23,73,11,26,37
43,8482712,Oskar Olausson,R,COL,22,76,10,27,37
43,8478472,Mathieu Joseph,R,STL,27,69,10,27,37
43,8478469,Thomas Chabot,D,OTT,27,74,9,28,37
43,8474565,Alex Pietrangelo,D,VGK,34,65,7,30,37
43,8477511,Anthony Mantha,R,CGY,30,76,18,18,36
43,8474715,Cameron Atkinson,R,TBL,35,82,18,18,36
43,8481546,Cam York,D,PHI,23,72,11,25,36
43,8480871,Adam Boqvist,D,FLA,24,73,10,26,36
43,8477498,Darnell Nurse,D,EDM,29,75,8,28,36
43,8479410,Mikhail Sergachev,D,UTA,26,64,7,29,36
43,8478463,Anthony Beauvillier,L,PIT,27,64,18,17,35
43,8476880,Tom Wilson,R,WSH,30,68,17,18,35
43,8481533,Trevor Zegras,C,ANA,23,69,17,18,35
43,8475763,Kevin Hayes,R,PIT,32,65,17,18,35
43,8474149,Evgenii Dadonov,R,DAL,35,81,17,18,35
43,8478115,Pierre Engvall,L,NYI,28,78,15,20,35
43,8475793,Ryan Johansen,C,PHI,32,67,14,21,35
43,8482105,Jake Sanderson,D,OTT,22,72,14,21,35
43,8480113,Alex Iafallo,L,WPG,31,62,12,23,35
43,8476462,Dougie Hamilton,D,NJD,31,67,11,24,35
43,8481524,Bowen Byram,D,BUF,23,65,11,24,35
43,8475218,Mattias Ekholm,D,EDM,34,72,11,24,35
43,8477947,Sonny Milano,L,WSH,28,62,9,26,35
43,8475314,Anders Lee,L,NYI,34,75,21,13,34
43,8475760,Nick Bjugstad,C,UTA,32,69,18,16,34
43,8474053,Logan Couture,C,SJS,35,64,17,17,34
43,8481535,Nils Hoglander,L,VAN,24,69,16,18,34
43,8478542,Evan Rodrigues,C,FLA,31,71,14,20,34
43,8476461,Sean Couturier,C,PHI,32,70,9,25,34
43,8482133,Thomas Bordeleau,C,SJS,22,63,8,26,34
43,8480893,Kirill Marchenko,R,CBJ,24,65,20,13,33
43,8475714,Calle Jarnkrok,C,TOR,33,74,19,14,33
43,8482475,Yegor Chinakhov,R,CBJ,23,63,15,18,33
43,8479390,Taylor Raddysh,R,WSH,26,55,13,20,33
43,8481604,Pavel Dorofeyev,L,VGK,24,67,11,22,33
43,8475722,Jason Zucker,L,BUF,32,69,11,22,33
43,8481606,Jordan Spence,D,LAK,23,69,8,25,33
43,8482671,Owen Power,D,BUF,22,73,7,26,33
43,8476979,Erik Gustafsson,D,DET,32,79,5,28,33
43,8482175,JJ Peterka,R,BUF,22,68,20,12,32
43,8482720,Matthew Knies,L,TOR,22,71,16,16,32
43,8480009,Eeli Tolvanen,R,SEA,25,71,13,19,32
43,8476292,Ondrej Palat,L,NJD,33,72,12,20,32
43,8478133,Jake Evans,C,MTL,28,70,8,24,32
43,8483505,Matthew Poitras,C,BOS,20,73,8,24,32
43,8476826,Yanni Gourde,C,SEA,33,65,16,15,31
43,8482146,Luke Evangelista,R,NSH,22,68,16,15,31
43,8479365,Trent Frederic,C,BOS,26,71,15,16,31
43,8480185,Eetu Luostarinen,C,FLA,26,76,14,17,31
43,8477021,Alex Kerfoot,C,UTA,30,72,12,19,31
43,8478891,Mason Appleton,C,WPG,28,68,12,19,31
43,8482111,Justin Barron,D,MTL,23,68,12,19,31
43,8473533,Jordan Staal,C,CAR,36,64,11,20,31
43,8476885,Jacob Trouba,D,NYR,30,71,8,23,31
43,8476854,Hampus Lindholm,D,BOS,30,72,6,25,31
43,8477495,Seth Jones,D,CHI,30,69,6,25,31
43,8477425,Miles Wood,L,COL,29,77,19,11,30
43,8478109,Victor Olofsson,L,VGK,29,72,15,15,30
43,8478046,Danton Heinen,L,VAN,29,66,12,18,30
43,8480144,David Kampf,C,TOR,29,73,11,19,30
43,8480145,Neal Pionk,D,WPG,29,74,9,21,30
43,8475193,Tomas Tatar,L,NJD,34,74,8,22,30
43,8477506,Ryan Pulock,D,NYI,30,76,5,25,30
43,8477969,Marcus Pettersson,D,PIT,28,79,3,27,30
43,8477987,Ryan Donato,C,CHI,28,68,22,7,29
43,8479992,Michael Rasmussen,C,DET,25,78,18,11,29
43,8480829,Jesperi Kotkaniemi,C,CAR,24,64,17,12,29
43,8482660,Kent Johnson,C,CBJ,22,54,10,19,29
43,8482803,Olen Zellweger,D,ANA,21,64,8,21,29
43,8484145,Zach Benson,L,BUF,19,68,7,22,29
43,8473563,Nicklas Backstrom,C,WSH,37,56,6,23,29
43,8480073,Erik Brannstrom,D,COL,25,66,6,23,29
43,8481014,Alexander Romanov,D,NYI,24,75,6,23,29
43,8479402,Jake Bean,D,CGY,26,66,1,28,29
43,8483524,Shane Wright,C,SEA,20,60,16,12,28
43,8482089,Jake Neighbours,L,STL,22,69,12,16,28
43,8481624,Ilya Mikheyev,R,CHI,30,58,11,17,28
43,8480220,Noah Cates,L,PHI,25,69,8,20,28
43,8480802,Ryan McLeod,C,BUF,25,64,8,20,28
43,8483445,Cutter Gauthier,L,ANA,20,64,7,21,28
43,8480817,K'Andre Miller,D,NYR,24,68,5,23,28
43,8480043,Timothy Liljegren,D,TOR,25,64,4,24,28
43,8480835,Jack Drury,C,CAR,24,55,16,11,27
43,8473422,Nick Foligno,L,CHI,37,55,15,12,27
43,8481580,Connor McMichael,C,WSH,23,63,15,12,27
43,8481032,Paul Cotter,C,NJD,25,57,14,13,27
43,8478020,Michael Amadio,R,OTT,28,75,13,14,27
43,8477952,Robby Fabbri,C,ANA,28,65,12,15,27
43,8476918,Jimmy Vesey,L,NYR,31,78,12,15,27
43,8480068,Ryan Poehling,C,PHI,25,71,11,16,27
43,8476392,Adam Lowry,C,WPG,31,66,10,17,27
43,8481523,Kirby Dach,C,MTL,23,65,10,17,27
43,8482624,Daniil Miromanov,D,CGY,27,74,10,17,27
43,8479661,Tanner Jeannot,L,LAK,27,72,10,17,27
43,8479351,Sam Steel,C,DAL,26,78,7,20,27
43,8476917,Adam Pelech,D,NYI,30,77,7,20,27
43,8476931,Jake McCabe,D,TOR,31,64,7,20,27
43,8478911,Matt Roy,D,WSH,29,65,6,21,27
43,8476902,Esa Lindell,D,DAL,30,75,1,26,27
43,8481554,Kaapo Kakko,R,NYR,23,62,16,10,26
43,8479393,Noah Gregor,L,OTT,26,75,16,10,26
43,8474189,Lars Eller,C,PIT,35,68,15,11,26
43,8480855,Jack McBain,C,UTA,24,67,14,12,26
43,8481703,Valtteri Puustinen,R,PIT,25,68,6,20,26
43,8481656,Aliaksei Protas,C,WSH,23,62,6,20,26
43,8476480,Vladislav Namestnikov,C,WPG,32,69,5,21,26
43,8474716,Jared Spurgeon,D,MIN,35,80,5,21,26
43,8480878,Nils Lundkvist,D,DAL,24,69,4,22,26
43,8476892,Colton Parayko,D,STL,31,71,2,24,26
43,8479941,Justin Danforth,R,CBJ,31,54,15,10,25
43,8470621,Corey Perry,R,EDM,39,63,13,12,25
43,8475231,Casey Cizikas,C,NYI,33,77,12,13,25
43,8477953,Kasperi Kapanen,R,STL,28,70,12,13,25
43,8476960,Andreas Athanasiou,C,CHI,30,49,12,13,25
43,8475343,Nic Dowd,C,WSH,34,71,11,14,25
43,8480078,Filip Chytil,C,NYR,25,65,10,15,25
43,8477508,Curtis Lazar,C,NJD,29,55,10,15,25
43,8476329,Travis Boyd,C,MIN,31,53,9,16,25
43,8478507,John Marino,D,UTA,27,69,5,20,25
43,8479983,Mario Ferraro,D,SJS,26,71,4,21,25
43,8479398,Samuel Girard,D,COL,26,58,3,22,25
43,8475764,Cam Fowler,D,ANA,33,76,2,23,25
43,8473507,Jeff Petry,D,DET,37,77,1,24,25
43,8482055,Drew O'Connor,L,PIT,26,62,16,8,24
43,8473453,Trevor Lewis,C,LAK,37,71,13,11,24
43,8484203,Bradly Nadeau,L,CAR,19,60,12,12,24
43,8477919,Frederick Gaudreau,C,MIN,31,61,9,15,24
43,8482809,Jackson Blake,R,CAR,21,57,9,15,24
43,8483565,Nick Blankenburg,D,NSH,26,63,7,17,24
43,8476312,Josh Manson,D,COL,33,67,6,18,24
43,8482067,Connor Mackey,D,NYR,28,65,5,19,24
43,8478136,Jake Middleton,D,MIN,28,78,3,21,24
43,8478508,Yakov Trenin,C,MIN,27,64,17,6,23
43,8480762,Eric Robinson,L,CAR,29,50,14,9,23
43,8479996,Cody Glass,C,NSH,25,66,11,12,23
43,8477505,Alexander Wennberg,C,SJS,30,61,10,13,23
43,8478413,Jordan Greenway,L,BUF,27,61,9,14,23
43,8479293,Brandon Tanev,L,SEA,33,67,9,14,23
43,8478432,Christian Fischer,R,DET,27,77,8,15,23
43,8478882,Vladislav Gavrikov,D,LAK,29,68,6,17,23
43,8479369,Andrew Peeke,D,BOS,26,57,6,17,23
43,8477839,Conor Sheary,L,TBL,32,80,5,18,23
43,8479982,Conor Timmins,D,TOR,26,59,5,18,23
43,8475855,Jesper Fast,R,CAR,33,59,4,19,23
43,8483490,Pavel Mintyukov,D,ANA,21,73,3,20,23
43,8478500,Ivan Provorov,D,CBJ,27,78,2,21,23
43,8475181,Nick Leddy,D,STL,33,68,2,21,23
43,8480873,Rasmus Sandin,D,WSH,24,62,2,21,23
43,8476858,Phillip Di Giuseppe,L,VAN,31,51,15,7,22
43,8479066,Ryan Lomberg,L,CGY,30,72,13,9,22
43,8482062,Cole Smith,L,NSH,29,55,13,9,22
43,8477507,Nikita Zadorov,D,BOS,29,68,12,10,22
43,8477931,Tomas Nosek,L,FLA,32,62,12,10,22
43,8483482,Tristan Luneau,D,ANA,20,62,12,10,22
43,8477478,William Carrier,L,CAR,30,56,11,11,22
43,8479316,Luke Kunin,C,SJS,27,52,11,11,22
43,8480748,Kiefer Sherwood,L,VAN,29,62,10,12,22
43,8479370,Tyson Jost,C,CAR,26,58,9,13,22
43,8479336,Carl Grundstrom,R,SJS,27,54,9,13,22
43,8479315,Joey Anderson,R,CHI,26,52,8,14,22
43,8478569,Noel Acciari,C,PIT,33,55,7,15,22
43,8475220,Marcus Foligno,L,MIN,33,64,6,16,22
43,8483493,Frank Nazar,C,CHI,20,50,6,16,22
43,8478013,Jake Walman,D,SJS,28,66,5,17,22
43,8475790,Erik Gudbranson,D,CBJ,32,76,5,17,22
43,8476463,Jonas Brodin,D,MIN,31,77,4,18,22
43,8477435,Ryan Graves,D,PIT,29,78,4,18,22
43,8477488,Brett Pesce,D,NJD,30,68,3,19,22
43,8475455,Brenden Dillon,D,NJD,34,59,2,20,22
43,8482125,Alexander Holtz,R,VGK,22,69,13,8,21
43,8483468,Jiri Kulich,C,BUF,20,56,12,9,21
43,8480448,Parker Kelly,L,COL,25,73,9,12,21
43,8482117,Lukas Reichel,L,CHI,22,49,8,13,21
43,8480336,Sean Walker,D,CAR,30,74,8,13,21
43,8481028,Martin Pospisil,C,CGY,25,50,8,13,21
43,8480995,Pontus Holmberg,R,TOR,25,59,8,13,21
43,8481704,Juuso Parssinen,C,NSH,23,55,7,14,21
43,8476994,Vinnie Hinostroza,C,NSH,30,45,6,15,21
43,8482655,Janis Moser,D,TBL,24,75,4,17,21
43,8477369,Carson Soucy,D,VAN,30,63,4,17,21
43,8475171,Oliver Ekman-Larsson,D,TOR,33,62,3,18,21
43,8479980,Nicolas Hague,D,VGK,26,54,3,18,21
43,8480035,Henri Jokiharju,D,BUF,25,69,3,18,21
43,8481601,Simon Holmstrom,R,NYI,23,69,14,6,20
43,8480281,Alexey Toropchenko,R,STL,25,62,14,6,20
43,8479619,Michael Carcone,L,UTA,28,62,13,7,20
43,8476889,Radek Faksa,C,STL,30,64,13,7,20
43,8476278,Colin Blackwell,C,DAL,31,80,12,8,20
43,8484149,Gavin Brindley,C,CBJ,20,52,12,8,20
43,8480252,Cole Guttman,C,CHI,25,43,12,8,20
43,8480789,Oliver Wahlstrom,R,NYI,24,68,11,9,20
43,8479414,Nathan Bastian,R,NJD,27,53,10,10,20
43,8476981,Josh Anderson,R,MTL,30,72,9,11,20
43,8480813,Joe Veleno,C,DET,24,76,9,11,20
43,8479671,Mathieu Olivier,R,CBJ,27,57,9,11,20
43,8482101,Danil Gushchin,L,SJS,22,50,8,12,20
43,8477406,Mattias Janmark,C,EDM,32,66,8,12,20
43,8480003,Jesper Boqvist,C,FLA,26,71,7,13,20
43,8479353,Brett Howden,C,VGK,26,69,7,13,20
43,8481521,Ronnie Attard,D,PHI,25,56,7,13,20
43,8482166,Shakir Mukhamadullin,D,SJS,22,55,6,14,20
43,8482749,Joshua Roy,R,MTL,21,62,4,16,20
43,8476457,Adam Larsson,D,SEA,32,65,4,16,20
43,8480070,Ian Mitchell,D,BOS,25,49,4,16,20
43,8479639,Dylan Coghlan,D,WPG,26,62,3,17,20
43,8480246,Nick Perbix,D,TBL,26,71,3,17,20
43,8482073,Braden Schneider,D,NYR,23,64,2,18,20
43,8482142,Jamie Drysdale,D,PHI,22,64,0,20,20
43,8474673,TJ Brodie,D,CHI,34,62,0,20,20
43,8481522,Peyton Krebs,C,BUF,23,62,11,8,19
43,8476374,Sean Kuraly,C,CBJ,31,63,9,10,19
43,8478434,Keegan Kolesar,R,VGK,27,69,9,10,19
43,8477903,Garnet Hathaway,R,PHI,33,58,9,10,19
43,8475842,Sam Carrick,C,NYR,32,54,9,10,19
43,8479344,Jesse Puljujarvi,R,PIT,26,46,8,11,19
43,8474034,Patrick Maroon,L,CHI,36,54,8,11,19
43,8477070,Liam O'Brien,C,UTA,30,53,8,11,19
43,8475235,Nicolas Deslauriers,L,PHI,33,54,8,11,19
43,8480205,Emil Bemstrom,C,PIT,25,63,7,12,19
43,8481481,Blake Lizotte,C,PIT,27,63,7,12,19
43,8477573,Nathan Walker,L,STL,30,47,7,12,19
43,8476422,Mike Reilly,D,NYI,31,71,5,14,19
43,8476429,Scott Mayfield,D,NYI,32,76,3,16,19
43,8475462,Radko Gudas,D,ANA,34,68,2,17,19
43,8481477,Nico Sturm,C,SJS,29,57,12,6,18
43,8476873,Mark Jankowski,C,NSH,30,52,11,7,18
43,8482155,Alex Laferriere,R,LAK,23,64,10,8,18
43,8480025,MacKenzie Entwistle,R,FLA,25,64,10,8,18
43,8478043,Sam Lafferty,C,BUF,29,57,9,9,18
43,8483491,Ivan Miroshnichenko,L,WSH,20,52,9,9,18
43,8479520,Brandon Duhaime,R,WSH,27,57,9,9,18
43,8476469,Joel Armia,R,MTL,31,63,8,10,18
43,8482679,Matt Coronato,R,CGY,22,66,8,10,18
43,8476925,Colton Sissons,C,NSH,31,64,7,11,18
43,8482079,Marco Rossi,C,MIN,23,52,7,11,18
43,8477220,Nate Schmidt,D,FLA,33,63,6,12,18
43,8476897,Oskar Sundqvist,C,STL,30,60,6,12,18
43,8483457,Lane Hutson,D,MTL,20,69,5,13,18
43,8481441,Joe Snively,C,DET,28,65,5,13,18
43,8470600,Ryan Suter,D,STL,39,57,4,14,18
43,8480891,Michael Kesselring,D,UTA,24,51,3,15,18
43,8479976,Juuso Valimaki,D,UTA,26,67,3,15,18
43,8479026,Philippe Myers,D,TOR,27,49,3,15,18
43,8481178,Egor Zamula,D,PHI,24,56,2,16,18
43,8481716,Dmitri Voronkov,L,CBJ,24,46,10,7,17
43,8477989,Christian Dvorak,C,MTL,28,60,8,9,17
43,8477979,Nicolas Aube-Kubel,R,BUF,28,56,8,9,17
43,8476921,Jordan Martinook,L,CAR,32,64,7,10,17
43,8478421,A.J. Greer,L,FLA,28,55,7,10,17
43,8476988,Matt Benning,D,SJS,30,61,6,11,17
43,8477353,Tyler Motte,C,DET,29,75,5,12,17
43,8479324,Ryan Lindgren,D,NYR,26,62,5,12,17
43,8477384,Joshua Brown,D,EDM,30,48,5,12,17
43,8482451,Mikael Pyyhtia,L,CBJ,23,42,4,13,17
43,8477845,Trevor van Riemsdyk,D,WSH,33,63,3,14,17
43,8478178,Darren Raddysh,D,TBL,28,71,3,14,17
43,8478452,Caleb Jones,D,LAK,27,55,3,14,17
43,8478859,Niko Mikkola,D,FLA,28,53,3,14,17
43,8478970,Jalen Chatfield,D,CAR,28,66,2,15,17
43,8476891,Matthew Grzelcyk,D,PIT,30,80,1,16,17
43,8478399,Jonas Siegenthaler,D,NJD,27,58,1,16,17
43,8482659,Josh Doan,R,UTA,22,50,10,6,16
43,8480355,Mark Kastelic,C,BOS,25,65,10,6,16
43,8476822,Luke Glendening,C,TBL,35,78,10,6,16
43,8481093,Rafael Harvey-Pinard,L,MTL,25,57,9,7,16
43,8482074,Connor Zary,C,CGY,23,66,9,7,16
43,8482964,Arber Xhekaj,D,MTL,23,49,7,9,16
43,8474574,Tyler Myers,D,VAN,34,71,6,10,16
43,8480289,Morgan Barron,C,WPG,26,54,6,10,16
43,8480172,Jan Rutta,D,SJS,34,70,5,11,16
43,8482192,Isaak Phillips,D,CHI,23,52,5,11,16
43,8480727,Zach Whitecloud,D,VGK,28,41,5,11,16
43,8476856,Mathew Dumba,D,DAL,30,70,2,14,16
43,8478416,Erik Cernak,D,TBL,27,73,2,14,16
43,8475179,Dmitry Kulikov,D,FLA,34,68,2,14,16
43,8479371,Dante Fabbro,D,NSH,26,60,1,15,16
43,8475324,Nick Jensen,D,OTT,34,68,0,16,16
43,8476878,Zemgus Girgensons,C,TBL,30,80,10,5,15
43,8482077,Dylan Holloway,L,EDM,23,52,10,5,15
43,8478831,Kevin Stenlund,C,UTA,28,52,10,5,15
43,8481553,Bobby Brink,R,PHI,23,61,5,10,15
43,8477392,Hudson Fasching,R,NYI,29,62,5,10,15
43,8477015,Connor Brown,R,EDM,30,63,5,10,15
43,8480980,Connor Dewar,C,TOR,25,73,5,10,15
43,8477380,Jonny Brodzinski,C,NYR,31,54,5,10,15
43,8479291,Kevin Rooney,C,CGY,31,55,5,10,15
43,8482245,Artem Zub,D,OTT,29,75,3,12,15
43,8481161,Jake Christiansen,D,CBJ,25,59,3,12,15
43,8477499,Rasmus Ristolainen,D,PHI,30,54,2,13,15
43,8480049,Dylan Samberg,D,WPG,25,62,1,14,15
43,8478851,Alexandre Carrier,D,NSH,28,61,1,14,15
43,8475188,Brayden McNabb,D,VGK,33,54,0,15,15
43,8477446,Michael McCarron,R,NSH,29,56,9,5,14
43,8479718,Alex Barré-Boulet,C,MTL,27,53,8,6,14
43,8471817,Ryan Reaves,R,TOR,37,60,8,6,14
43,8483499,Liam Ohgren,L,MIN,20,50,6,8,14
43,8482737,Zack Bolduc,C,STL,21,51,5,9,14
43,8480441,Trey Fix-Wolansky,R,CBJ,25,40,5,9,14
43,8475791,Taylor Hall,L,CHI,33,51,4,10,14
43,8476525,Colin Miller,D,WPG,32,63,4,10,14
43,8479328,Julien Gauthier,R,NYI,27,56,4,10,14
43,8478451,Ethan Bear,D,WSH,27,48,4,10,14
43,8479543,Michael Pezzetta,L,MTL,26,57,3,11,14
43,8477450,Jason Dickinson,C,CHI,29,53,2,12,14
43,8478468,Jeremy Lauzon,D,NSH,27,61,2,12,14
43,8482087,Kaiden Guhle,D,MTL,22,62,1,13,14
43,8482730,Brandt Clarke,D,LAK,21,50,1,13,14
43,8476331,Dylan DeMelo,D,WPG,31,66,0,14,14
43,8483460,David Jiricek,D,CBJ,21,56,0,14,14
43,8480806,Isac Lundestrom,C,ANA,25,61,8,5,13
43,8480021,Jack Studnicka,C,LAK,25,60,7,6,13
43,8482176,Wyatt Kaiser,D,CHI,22,59,6,7,13
43,8480845,Rasmus Kupari,C,WPG,24,47,6,7,13
43,8481599,Victor Soderstrom,D,UTA,23,47,6,7,13
43,8480796,Martin Fehervary,D,WSH,25,51,5,8,13
43,8478211,Dryden Hunt,L,CGY,29,56,5,8,13
43,8477034,Jaycob Megna,D,FLA,32,47,5,8,13
43,8476934,Brock McGinn,L,ANA,30,48,4,9,13
43,8480058,Pierre-Olivier Joseph,D,STL,25,56,3,10,13
43,8475690,Chris Tanev,D,TOR,35,59,3,10,13
43,8479944,Zach Aston-Reese,C,VGK,30,47,3,10,13
43,8480001,Urho Vaakanainen,D,ANA,25,56,1,12,13
43,8482259,Bobby McMann,C,TOR,28,62,9,3,12
43,8481754,Nikita Nesterenko,C,ANA,23,40,9,3,12
43,8481517,Brett Leason,R,ANA,25,57,8,4,12
43,8480848,Ty Dellandrea,C,SJS,24,32,8,4,12
43,8481518,Nolan Foote,L,NJD,24,46,6,6,12
43,8479439,Jacob MacDonald,D,COL,31,53,5,7,12
43,8475279,Ben Chiarot,D,DET,33,67,5,7,12
43,8481568,Alex Vlasic,D,CHI,23,57,4,8,12
43,8476624,Barclay Goodrow,C,SJS,31,56,3,9,12
43,8481013,Jonatan Berggren,R,DET,24,52,3,9,12
43,8481708,Zac Jones,D,NYR,24,50,3,9,12
43,8477018,Ben Hutton,D,VGK,31,49,3,9,12
43,8481019,David Gustafsson,C,WPG,24,40,3,9,12
43,8479998,Mikey Anderson,D,LAK,25,62,2,10,12
43,8476879,Cody Ceci,D,EDM,31,63,0,12,12
43,8475762,Derek Forbort,D,VAN,32,46,0,12,12
43,8482762,Simon Edvinsson,D,DET,21,51,9,2,11
43,8482157,Will Cuylle,L,NYR,22,59,8,3,11
43,8480292,Carson Meyer,R,ANA,27,37,7,4,11
43,8481550,Adam Beckman,L,NJD,23,35,5,6,11
43,8477401,John Hayden,C,SEA,29,34,5,6,11
43,8481537,Nikita Okhotiuk,D,CGY,24,50,5,6,11
43,8482148,Hendrix Lapierre,C,WSH,22,59,5,6,11
43,8479368,Max Jones,L,BOS,26,68,4,7,11
43,8479348,Kale Clague,D,BUF,26,42,4,7,11
43,8481641,Joel Kiviranta,L,COL,28,72,4,7,11
43,8479442,Troy Stecher,D,EDM,30,58,4,7,11
43,8482145,Mavrik Bourque,C,DAL,22,56,4,7,11
43,8476442,Matt Nieto,L,PIT,32,48,3,8,11
43,8480860,Kevin Bahl,D,CGY,24,55,3,8,11
43,8482744,James Malatesta,L,CBJ,21,40,3,8,11
43,8481567,Henry Thrun,D,SJS,23,50,3,8,11
43,8477365,Connor Clifton,D,BUF,29,56,2,9,11
43,8481751,Lukas Rousek,R,BUF,25,38,2,9,11
43,8481701,Santeri Hatakka,D,NJD,23,39,2,9,11
43,8476467,Jamie Oleksiak,D,SEA,32,62,1,10,11
43,8480950,Ilya Lyubushkin,D,DAL,30,63,1,10,11
43,8483495,Simon Nemec,D,NJD,20,61,6,4,10
43,8479536,Axel Jonsson-Fjallby,L,WPG,26,38,6,4,10
43,8478443,Brandon Carlo,D,BOS,28,56,5,5,10
43,8477938,Haydn Fleury,D,WPG,28,41,5,5,10
43,8482141,Lukas Cormier,D,VGK,22,32,4,6,10
43,8482807,Ethan Del Mastro,D,CHI,21,48,3,7,10
43,8478585,Derek Ryan,C,EDM,38,68,3,7,10
43,8482095,Tyler Kleven,D,OTT,22,46,3,7,10
43,8482496,Nils Aman,C,VAN,24,31,2,8,10
43,8474166,Alec Martinez,D,CHI,37,49,2,8,10
43,8477851,Jordan Oesterle,D,BOS,32,47,2,8,10
43,8480157,Calle Rosen,D,COL,30,45,1,9,10
43,8476372,Nick Seeler,D,PHI,31,49,1,9,10
43,8475233,David Savard,D,MTL,34,68,0,10,10
43,8479638,Justin Brazeau,R,BOS,26,34,7,2,9
43,8479994,Jaret Anderson-Dolan,C,WPG,25,29,6,3,9
43,8479378,Logan Stanley,D,WPG,26,47,5,4,9
43,8482747,Brennan Othmann,L,NYR,21,45,5,4,9
43,8481147,Reese Johnson,C,MIN,26,39,4,5,9
43,8481600,Tobias Bjornfot,D,FLA,23,38,4,5,9
43,8478409,Anthony Richard,C,PHI,28,35,4,5,9
43,8481543,Nikita Alexandrov,C,STL,24,25,4,5,9
43,8481527,Kaedan Korczak,D,VGK,23,38,3,6,9
43,8480222,Sebastian Aho,D,PIT,28,63,3,6,9
43,8481592,Jakob Pelletier,L,CGY,23,33,3,6,9
43,8475718,Justin Holl,D,DET,32,55,3,6,9
43,8471677,Jack Johnson,D,CBJ,37,63,2,7,9
43,8476867,Brendan Gaunce,C,MIN,30,38,2,7,9
43,8474612,Travis Hamonic,D,OTT,34,40,2,7,9
43,8482861,Vincent Iorio,D,WSH,22,38,2,7,9
43,8480807,Mattias Samuelsson,D,BUF,24,44,1,8,9
43,8475208,Brian Dumoulin,D,ANA,33,65,1,8,9
43,8480844,Grigori Denisenko,L,VGK,24,37,1,8,9
43,8478840,Will Borgen,D,SEA,28,64,0,9,9
43,8480879,Jacob Bernard-Docker,D,OTT,24,48,0,9,9
43,8479972,Mason Shaw,C,WPG,26,46,0,9,9
43,8481617,Vasily Podkolzin,R,VAN,23,57,6,2,8
43,8481556,John Beecher,C,BOS,23,38,6,2,8
43,8480990,Declan Chisholm,D,MIN,24,30,5,3,8
43,8475225,Craig Smith,C,CHI,35,49,4,4,8
43,8482634,Alex Steeves,C,TOR,25,48,4,4,8
43,8480887,Jordan Harris,D,MTL,24,53,3,5,8
43,8479359,Beck Malenstyn,L,BUF,26,46,3,5,8
43,8482751,Ryan Winterton,C,SEA,21,31,3,5,8
43,8475750,Jon Merrill,D,MIN,32,59,3,5,8
43,8477887,Patrick Brown,C,BOS,32,42,3,5,8
43,8473446,Erik Johnson,D,PHI,36,47,2,6,8
43,8476441,Joel Edmundson,D,LAK,31,43,2,6,8
43,8480011,Klim Kostin,C,SJS,25,43,1,7,8
43,8481056,Spencer Stastney,D,NSH,24,36,1,7,8
43,8474013,Ian Cole,D,UTA,35,49,0,8,8
43,8481059,Scott Perunovich,D,STL,26,57,0,8,8
43,8480834,Ty Emberson,D,SJS,24,31,0,8,8
43,8480196,Jacob Bryson,D,BUF,27,44,0,8,8
43,8476473,Connor Murphy,D,CHI,31,38,0,8,8
43,8477962,Brendan Lemieux,L,CAR,28,42,4,3,7
43,8481609,Vladislav Kolyachonok,D,UTA,23,42,4,3,7
43,8477482,Zachary Sanford,L,CHI,30,40,4,3,7
43,8483549,Lucas Condotta,L,MTL,27,35,4,3,7
43,8479981,Jonah Gadjovich,L,FLA,26,37,4,3,7
43,8480074,Alexandre Texier,C,STL,25,57,3,4,7
43,8482859,Zack Ostapchuk,C,OTT,21,54,3,4,7
43,8483012,Logan Morrison,C,SEA,22,47,3,4,7
43,8478017,Mark Friedman,D,VAN,29,35,3,4,7
43,8482652,Walker Duehr,R,CGY,27,37,3,4,7
43,8482765,Isak Rosen,R,BUF,21,34,3,4,7
43,8483466,Kevin Korchinski,D,CHI,20,43,2,5,7
43,8484911,Collin Graf,R,SJS,22,33,2,5,7
43,8482144,Jack Thompson,D,SJS,22,27,2,5,7
43,8482784,Zach Dean,C,STL,21,40,2,5,7
43,8479985,Cale Fleury,D,SEA,26,29,2,5,7
43,8479372,Joshua Mahura,D,SEA,26,51,1,6,7
43,8479379,Givani Smith,R,SJS,26,32,1,6,7
43,8476874,Olli Maatta,D,DET,30,63,0,7,7
43,8479249,Andrew Poturalski,C,SJS,30,31,0,7,7
43,8481532,Alex Turcotte,C,LAK,23,49,3,3,6
43,8479320,Maxime Lajoie,D,SEA,27,27,3,3,6
43,8477810,Joel Hanley,D,CGY,33,31,3,3,6
43,8475958,Michael Sgarbossa,C,WSH,32,28,3,3,6
43,8481564,Ryan Johnson,D,BUF,23,15,3,3,6
43,8478477,Mitchell Stephens,C,SEA,27,24,3,3,6
43,8478874,Adam Gaudette,R,OTT,28,31,2,4,6
43,8481167,Brayden Pachal,D,CGY,25,38,2,4,6
43,8477244,Chad Ruhwedel,D,NYR,34,33,2,4,6
43,8476967,Brett Kulak,D,EDM,30,58,1,5,6
43,8482733,Logan Mailloux,D,MTL,31,30,1,5,6
43,8479986,Kole Lind,R,DAL,26,44,1,5,6
43,8481598,Philip Broberg,D,EDM,23,42,1,5,6
43,8474090,Brendan Smith,D,DAL,35,55,1,5,6
43,8479968,Vinni Lettieri,C,BOS,29,50,1,5,6
43,8481679,Maxence Guenette,D,OTT,23,39,1,5,6
43,8482511,Mason Lohrei,D,BOS,23,36,1,5,6
43,8474567,Zach Bogosian,D,MIN,34,66,0,6,6
43,8480192,Johnathan Kovacevic,D,NJD,27,49,0,6,6
43,8481122,Simon Benoit,D,TOR,26,47,0,6,6
43,8484254,Akito Hirose,D,VAN,25,35,3,2,5
43,8482172,Landon Slaggert,L,CHI,22,28,3,2,5
43,8482201,Gage Goncalves,C,TBL,23,27,3,2,5
43,8484287,Cole McWard,D,VAN,23,28,3,2,5
43,8480890,Jan Jenik,C,OTT,24,26,3,2,5
43,8480007,Jonas Rondbjerg,R,VGK,25,34,2,3,5
43,8483619,Filip Roos,D,OTT,25,29,2,3,5
43,8477473,Justin Bailey,R,SJS,29,28,2,3,5
43,8474062,Riley Nash,C,NYR,35,26,2,3,5
43,8477335,Kyle Burroughs,D,LAK,29,47,1,4,5
43,8482666,Scott Morrow,D,CAR,22,44,1,4,5
43,8480880,Jakub Lauko,C,MIN,24,34,1,4,5
43,8480245,Olle Lycksell,R,PHI,25,27,1,4,5
43,8483397,Marc McLaughlin,C,BOS,25,30,1,4,5
43,8477971,Andreas Englund,D,LAK,28,23,1,4,5
43,8478502,Dennis Gilbert,D,BUF,28,13,0,5,5
43,8483763,Maksymilian Szuber,D,UTA,22,30,4,0,4
43,8480032,Shane Bowers,C,NJD,25,18,4,0,4
43,8478424,Jansen Harkins,C,ANA,27,37,3,1,4
43,8478450,Parker Wotherspoon,D,BOS,27,31,3,1,4
43,8478051,Max Willman,C,NJD,29,18,3,1,4
43,8483570,Ben Meyers,C,SEA,26,29,2,2,4
43,8482177,Marat Khusnutdinov,C,MIN,22,32,2,2,4
43,8483512,Matthew Savoie,C,EDM,20,23,2,2,4
43,8481585,Egor Afanasyev,L,SJS,23,24,2,2,4
43,8480823,Alexander Alexeyev,D,WSH,25,15,2,2,4
43,8482147,Jean-Luc Foudy,C,COL,22,25,2,2,4
43,8481578,Graeme Clarke,R,MIN,23,11,2,2,4
43,8478146,Matthew Highmore,C,OTT,28,31,1,3,4
43,8479576,Vincent Desharnais,D,VAN,28,38,1,3,4
43,8478454,Noah Juulsen,D,VAN,27,28,1,3,4
43,8482713,Mackie Samoskevich,R,FLA,22,40,1,3,4
43,8482470,Ilya Solovyov,D,CGY,24,17,1,3,4
43,8475177,Calvin de Haan,D,COL,33,35,0,4,4
43,8482250,Callahan Burke,C,VGK,27,22,0,4,4
43,8477462,Robert Hagg,D,VGK,29,29,0,4,4
43,8482088,Justin Sourdif,R,FLA,22,17,0,4,4
43,8481743,Marc Del Gaizo,D,NSH,25,17,0,4,4
43,8481541,Samuel Bolduc,D,NYI,24,25,3,0,3
43,8476913,Devin Shore,C,MIN,30,39,2,1,3
43,8481789,Tye Kartye,L,SEA,23,29,2,1,3
43,8477467,Gustav Olofsson,D,SEA,30,23,2,1,3
43,8482070,Mitchell Chaffee,R,TBL,26,47,2,1,3
43,8483630,Pavol Regenda,L,ANA,25,29,2,1,3
43,8481422,Jake Lucchini,C,NSH,29,15,2,1,3
43,8484325,Waltteri Merela,C,TBL,26,17,2,1,3
43,8475795,Dylan McIlrath,D,WSH,32,13,2,1,3
43,8475413,Justin Dowling,C,NJD,34,12,2,1,3
43,8484304,Uvis Balinskis,D,FLA,28,12,2,1,3
43,8478011,Louie Belpedio,D,PHI,28,11,2,1,3
43,8474568,Luke Schenn,D,NSH,35,48,1,2,3
43,8479772,Zack MacEwen,R,OTT,28,52,1,2,3
43,8481699,Aku Raty,R,UTA,23,17,1,2,3
43,8480267,Sammy Walker,C,MIN,25,17,1,2,3
43,8477320,Anton Blidh,L,NYR,29,24,1,2,3
43,8481237,Kyle MacLean,C,NYI,25,21,1,2,3
43,8477541,Dakota Mermis,D,TOR,30,12,1,2,3
43,8482153,Brendan Brisson,C,VGK,23,25,0,3,3
43,8481605,Jackson LaCombe,D,ANA,23,28,0,3,3
43,8478021,William Lagesson,D,DET,28,21,0,3,3
43,8484258,Sam Malinski,D,COL,26,26,2,0,2
43,8483471,Brad Lambert,C,WPG,31,10,2,0,2
43,8479419,Brett Murray,L,BUF,26,23,1,1,2
43,8476952,Dominic Toninato,C,WPG,30,33,1,1,2
43,8482162,Roby Jarventie,L,EDM,22,21,1,1,2
43,8482061,Brandon Biro,L,SEA,26,10,1,1,2
43,8482197,Adam Raska,R,MIN,23,11,1,1,2
43,8480874,Adam Ginning,D,PHI,24,7,1,1,2
43,8481065,Angus Crookshank,L,OTT,25,14,1,1,2
43,8482929,Emil Lilleberg,D,TBL,23,19,1,1,2
43,8481043,Cole Koepke,L,BOS,26,20,1,1,2
43,8471709,Marc-Edouard Vlasic,D,SJS,37,61,0,2,2
43,8482858,Ryker Evans,D,SEA,23,21,0,2,2
43,8479991,Jake Leschyshyn,C,NYR,25,17,0,2,2
43,8483546,Marshall Rifai,D,TOR,26,5,0,2,2
43,8477149,Scott Sabourin,R,SJS,32,20,0,2,2
43,8483489,Fraser Minten,C,TOR,31,15,0,2,2
43,8483567,Georgii Merkulov,C,BOS,24,8,0,2,2
43,8481593,Jayden Struble,D,MTL,23,18,0,2,2
43,8475755,Alexander Petrovic,D,DAL,32,11,0,2,2
43,8483432,Luca Del Bel Belluz,C,CBJ,31,8,0,2,2
43,8482102,Vasily Ponomarev,C,PIT,22,14,1,0,1
43,8481806,Louis Crevier,D,CHI,23,15,1,0,1
43,8480870,Bo Groulx,C,NYR,24,25,1,0,1
43,8480851,Akil Thomas,C,LAK,24,19,1,0,1
43,8482118,Sam Colangelo,R,ANA,23,14,1,0,1
43,8482165,Yan Kuznetsov,D,CGY,22,15,1,0,1
43,8481719,Maxwell Crozier,D,TBL,24,19,1,0,1
43,8482476,Emil Heineman,L,MTL,23,6,1,0,1
43,8480306,Grant Hutton,D,NYI,29,13,1,0,1
43,8482126,Emil Andrae,D,PHI,31,4,1,0,1
43,8480468,James Hamblin,L,EDM,25,24,0,1,1
43,8480084,Nick DeSimone,D,NJD,30,14,0,1,1
43,8482516,Matthew Kessel,D,STL,24,20,0,1,1
43,8479367,William Lockwood,R,FLA,26,22,0,1,1
43,8481006,Tyler Tucker,D,STL,24,15,0,1,1
43,8477073,Kurtis MacDermid,L,NJD,30,22,0,1,1
43,8483395,Arshdeep Bains,L,VAN,23,11,0,1,1
43,8478881,Brett Seney,L,CHI,28,18,0,1,1
43,8480075,Cameron Crotty,D,MIN,25,10,0,1,1
43,8481206,John Ludvig,D,PIT,24,11,0,1,1
43,8478854,Ryan Shea,D,PIT,27,9,0,1,1
43,8483920,Pierrick Dube,R,WSH,23,5,0,1,1
43,8479587,Rhett Gardner,C,PHI,28,20,0,0,0
43,8479330,Brandon Gignac,C,MTL,27,12,0,0,0
43,8478446,Glenn Gawdin,C,LAK,27,14,0,0,0
43,8481030,Jack St. Ivany,D,PIT,25,12,0,0,0
43,8479362,Riley Tufte,L,BOS,26,18,0,0,0
43,8475780,Chris Wagner,R,COL,33,14,0,0,0
43,8482094,Daemon Hunt,D,MIN,22,16,0,0,0
43,8477527,Ross Johnston,L,ANA,30,24,0,0,0
43,8481462,Mason Morelli,L,VGK,28,11,0,0,0
43,8481024,Linus Karlsson,C,VAN,25,7,0,0,0
43,8476323,Max McCormick,L,SEA,32,4,0,0,0
43,8483597,Milos Kelemen,L,UTA,25,14,0,0,0
43,8481726,Adam Edstrom,C,NYR,24,6,0,0,0
43,8482460,Matt Rempe,C,NYR,22,10,0,0,0
43,8477993,Justin Kirkland,C,CGY,28,9,0,0,0
43,8484321,Nikolas Matinpalo,D,OTT,26,1,0,0,0
43,8479421,Jacob Moverare,D,LAK,26,5,0,0,0
43,8484255,Jason Polin,R,COL,25,6,0,0,0
43,8483407,Brandon Scanlin,D,NYR,25,3,0,0,0
43,8484326,Patrik Koch,D,UTA,28,3,0,0,0
43,8482787,Nikita Chibrikov,R,WPG,31,2,0,0,0
43,8479522,Hardy Haman Aktell,D,WSH,26,4,0,0,0
43,8483531,Brian Halonen,L,NJD,25,3,0,0,0
43,8483398,Declan Carlile,D,TBL,31,9,0,0,0
43,8481655,Cole Schwindt,R,CGY,23,3,0,0,0
43,8478147,Bokondji Imama,L,PIT,28,8,0,0,0
43,8481534,Raphael Lavoie,C,EDM,24,0,0,0,0
43,8483609,Adam Klapka,R,CGY,24,3,0,0,0
43,8484259,Ondrej Pavel,C,COL,31,1,0,0,0
43,8480274,Philip Kemp,D,EDM,25,2,0,0,0
43,8483401,Marc Johnstone,R,PIT,28,2,0,0,0
43,8470794,Joe Pavelski,C,,40,0,0,0,0
43,8479321,Lucas Johansen,D,,27,0,0,0,0
43,8477950,Tony DeAngelo,D,,29,0,0,0,0
43,8471218,Blake Wheeler,R,,38,0,0,0,0
43,8475197,Tyson Barrie,D,,33,0,0,0,0
43,8474157,Max Pacioretty,L,,36,0,0,0,0
43,8475744,Evgeny Kuznetsov,C,,32,0,0,0,0
43,8474037,James van Riemsdyk,L,,35,0,0,0,0
43,8476907,Mackenzie MacEachern,L,,30,0,0,0,0
43,8480216,Jacob Peterson,C,,25,0,0,0,0
43,8474602,Justin Schultz,D,,34,0,0,0,0
43,8482222,Alexander Barabanov,L,,30,0,0,0,0
43,8474031,Kevin Shattenkirk,D,,35,0,0,0,0
43,8477330,Dominik Kubalik,L,,29,0,0,0,0
43,8480884,Calen Addison,D,,24,0,0,0,0
43,8475906,John Klingberg,D,,32,0,0,0,0
43,8480008,Adam Ruzicka,C,,25,0,0,0,0
43,8476884,Derrick Pouliot,D,,30,0,0,0,0
43,8476919,Chris Tierney,C,,30,0,0,0,0
43,8479415,Michael McLeod,C,,26,0,0,0,0
43,8474870,Tyler Johnson,C,,34,0,0,0,0
43,8470604,Jeff Carter,C,,39,0,0,0,0
43,8478104,Sammy Blais,L,,28,0,0,0,0
43,8474884,Mike Hoffman,C,,35,0,0,0,0
43,8481591,Sam Poulin,R,,23,0,0,0,0
43,8471274,Alex Goligoski,D,,39,0,0,0,0
43,8476871,Tanner Pearson,L,,32,0,0,0,0
43,8476393,Nick Cousins,C,,31,0,0,0,0
43,8479977,Kailer Yamamoto,R,,26,0,0,0,0
43,8479346,Dillon Dube,C,,26,0,0,0,0
43,8480184,Gustav Lindstrom,D,,26,0,0,0,0
43,8479376,Victor Mete,D,,26,0,0,0,0
43,8473449,Kyle Okposo,R,,36,0,0,0,0
43,8481058,Jesse Ylonen,R,,25,0,0,0,0
43,8475752,Tyler Pitlick,C,,33,0,0,0,0
43,8481239,Samuel Fagemo,L,,24,0,0,0,0
43,8480821,Filip Zadina,R,,25,0,0,0,0
43,8470966,Mark Giordano,D,,41,0,0,0,0
43,8478495,Denis Gurianov,R,,27,0,0,0,0
43,8477464,Nic Petan,C,,29,0,0,0,0
43,8478099,Kevin Labanc,R,,29,0,0,0,0
43,8482241,Radim Zohorna,L,,28,0,0,0,0
43,8474040,Sam Gagner,C,,35,0,0,0,0
43,8479514,Rem Pitlick,C,,27,0,0,0,0
43,8478430,Oliver Kylington,D,,27,0,0,0,0
43,8479533,Joona Koppanen,L,,26,0,0,0,0
43,8479984,Cal Foote,D,,26,0,0,0,0
43,8477126,Jayson Megna,C,,34,0,0,0,0
43,8475164,Jakob Silfverberg,R,,34,0,0,0,0
43,8474009,Nick Bonino,C,,36,0,0,0,0
43,8479458,Nikita Zaitsev,D,,33,0,0,0,0
43,8477944,Jakub Vrana,L,,28,0,0,0,0
43,8471699,Andrew Cogliano,C,,37,0,0,0,0
43,8478067,Oskar Lindblom,L,,28,0,0,0,0
43,8471686,Marc Staal,D,,37,0,0,0,0
43,8470610,Zach Parise,L,,40,0,0,0,0
43,8478904,Steven Lorentz,C,,28,0,0,0,0
43,8473473,Milan Lucic,L,,36,0,0,0,0
43,8480031,Maxime Comtois,L,,25,0,0,0,0
43,8478512,Austin Czarnik,C,,32,0,0,0,0
43,8473504,Cal Clutterbuck,R,,37,0,0,0,0
43,8477454,Adam Erne,L,,29,0,0,0,0
43,8479383,Boris Katchouk,L,,26,0,0,0,0
43,8475825,Jani Hakanpää,D,,32,0,0,0,0
43,8477846,Ryan Carpenter,C,,33,0,0,0,0
43,8477930,Pierre-Edouard Bellemare,L,,39,0,0,0,0
43,8478400,Colin White,C,,27,0,0,0,0
43,8480226,Marián Studenic,R,,26,0,0,0,0
43,8480853,Liam Foudy,C,,24,0,0,0,0
43,8475797,Jarred Tinordi,D,,32,0,0,0,0
43,8479423,Alex Nylander,L,,26,0,0,0,0
43,8474618,Marco Scandella,D,,34,0,0,0,0
43,8478028,Fredrik Olofsson,L,,28,0,0,0,0
43,8474709,Matt Martin,L,,35,0,0,0,0
43,8481070,Hugh McGing,L,,26,0,0,0,0
43,8479546,Oskar Steen,C,,26,0,0,0,0
43,8474145,Robert Bortuzzo,D,,35,0,0,0,0
43,8476915,Jujhar Khaira,L,,30,0,0,0,0
43,8475278,Byron Froese,C,,33,0,0,0,0
43,8481812,Nikolai Knyzhov,D,,27,0,0,0,0
43,8478408,Travis Dermott,D,,28,0,0,0,0
43,8481077,John Leonard,L,,26,0,0,0,0
43,8479547,Matthew Phillips,R,,26,0,0,0,0
43,8480836,Jonathan Gruden,C,,24,0,0,0,0
43,8481690,Tyler Angle,C,,24,0,0,0,0
43,8475766,Austin Watson,L,,32,0,0,0,0
43,8481016,Ruslan Iskhakov,C,,24,0,0,0,0
43,8478078,Rourke Chartier,C,,28,0,0,0,0
43,8480776,Sheldon Rempal,R,,29,0,0,0,0
43,8478956,Samuel Laberge,L,NJD,27,1,0,0,0
43,8483045,Cameron Butler,R,CBJ,31,0,0,0,0
43,8484314,Jiri Smejkal,L,,28,0,0,0,0
44,8476453,Nikita Kucherov,R,TBL,31,82,39,105,144
44,8477492,Nathan MacKinnon,C,COL,29,80,48,83,131
44,8478483,Mitch Marner,R,TOR,27,80,45,84,129
44,8478550,Artemi Panarin,L,NYR,33,77,38,86,124
44,8478420,Mikko Rantanen,R,COL,28,81,47,74,121
44,8481559,Jack Hughes,C,NJD,23,75,45,72,117
44,8478402,Connor McDavid,C,EDM,27,71,46,66,112
44,8482116,Tim Stützle,C,OTT,22,81,30,79,109
44,8479318,Auston Matthews,C,TOR,27,80,54,53,107
44,8477956,David Pastrnak,R,BOS,28,76,44,62,106
44,8477939,William Nylander,R,TOR,28,78,42,64,106
44,8477934,Leon Draisaitl,C,EDM,29,79,38,66,104
44,8477404,Jake Guentzel,C,TBL,30,81,42,58,100
44,8478398,Kyle Connor,L,WPG,28,74,40,60,100
44,8478864,Kirill Kaprizov,L,MIN,27,72,34,66,100
44,8480801,Brady Tkachuk,L,OTT,25,78,53,45,98
44,8480027,Jason Robertson,L,DAL,25,82,37,61,98
44,8480830,Andrei Svechnikov,R,CAR,24,73,30,68,98
44,8479314,Matthew Tkachuk,L,FLA,27,80,37,57,94
44,8480002,Nico Hischier,C,NJD,25,80,33,60,93
44,8478010,Brayden Point,C,TBL,28,82,46,46,92
44,8477409,Carter Verhaeghe,C,FLA,29,80,46,45,91
44,8476468,J.T. Miller,C,VAN,31,77,36,53,89
44,8477942,Kevin Fiala,L,LAK,28,81,35,54,89
44,8480023,Robert Thomas,C,STL,25,75,26,63,89
44,8480800,Quinn Hughes,D,VAN,25,74,12,77,89
44,8477493,Aleksander Barkov,C,FLA,29,80,28,60,88
44,8473512,Claude Giroux,R,OTT,36,80,30,56,86
44,8479385,Jordan Kyrou,C,STL,26,75,32,53,85
44,8480208,Drake Batherson,R,OTT,26,78,34,49,83
44,8476887,Filip Forsberg,L,NSH,30,74,39,43,82
44,8478403,Jack Eichel,C,VGK,28,79,35,47,82
44,8476389,Vincent Trocheck,C,NYR,31,79,33,49,82
44,8482093,Seth Jarvis,C,CAR,22,70,33,49,82
44,8480018,Nick Suzuki,C,MTL,25,79,31,51,82
44,8479343,Clayton Keller,R,UTA,26,78,39,42,81
44,8480039,Martin Necas,C,CAR,25,71,33,48,81
44,8476454,Ryan Nugent-Hopkins,C,EDM,31,79,20,61,81
44,8475786,Zach Hyman,L,EDM,32,79,43,37,80
44,8478439,Travis Konecny,R,PHI,27,76,32,48,80
44,8477940,Nikolaj Ehlers,L,WPG,28,74,31,49,80
44,8475692,Mats Zuccarello,R,MIN,37,74,18,62,80
44,8478427,Sebastian Aho,C,CAR,27,69,33,46,79
44,8477946,Dylan Larkin,C,DET,28,81,32,47,79
44,8479323,Adam Fox,D,NYR,26,73,15,64,79
44,8474141,Patrick Kane,R,DET,36,82,32,46,78
44,8482740,Wyatt Johnston,C,DAL,21,80,49,28,77
44,8479542,Brandon Hagel,L,TBL,26,80,36,41,77
44,8484144,Connor Bedard,C,CHI,19,66,29,48,77
44,8480069,Cale Makar,D,COL,26,70,18,59,77
44,8477960,Adrian Kempe,R,LAK,28,80,35,41,76
44,8473419,Brad Marchand,L,BOS,36,79,33,43,76
44,8479337,Alex DeBrincat,R,DET,27,80,32,44,76
44,8477402,Pavel Buchnevich,L,STL,29,76,32,44,76
44,8474564,Steven Stamkos,C,NSH,34,72,41,34,75
44,8477933,Sam Reinhart,C,FLA,29,78,40,35,75
44,8479420,Tage Thompson,C,BUF,27,76,36,39,75
44,8478414,Timo Meier,R,NJD,28,76,34,41,75
44,8481557,Matt Boldy,L,MIN,23,73,33,42,75
44,8480012,Elias Pettersson,C,VAN,26,72,32,43,75
44,8475913,Mark Stone,R,VGK,32,73,27,47,74
44,8478445,Mathew Barzal,C,NYI,27,80,20,54,74
44,8475167,Victor Hedman,D,TBL,34,79,13,61,74
44,8477501,Valeri Nichushkin,R,COL,29,80,40,33,73
44,8475170,Brayden Schenn,C,STL,33,76,28,45,73
44,8475184,Chris Kreider,L,NYR,33,75,36,36,72
44,8477504,Josh Morrissey,D,WPG,29,76,14,58,72
44,8476460,Mark Scheifele,C,WPG,31,74,30,41,71
44,8471214,Alex Ovechkin,L,WSH,39,66,34,36,70
44,8475166,John Tavares,C,TOR,34,79,33,37,70
44,8471215,Evgeni Malkin,C,PIT,38,72,30,39,69
44,8475172,Nazem Kadri,C,CGY,34,76,24,45,69
44,8478440,Dylan Strome,C,WSH,27,77,22,47,69
44,8478873,Troy Terry,R,ANA,27,75,30,38,68
44,8477476,Artturi Lehkonen,L,COL,29,80,28,40,68
44,8476459,Mika Zibanejad,C,NYR,31,78,23,45,68
44,8481540,Cole Caufield,R,MTL,23,78,38,29,67
44,8478449,Roope Hintz,C,DAL,28,82,31,36,67
44,8481528,Dylan Cozens,C,BUF,23,70,29,38,67
44,8478493,Joel Eriksson Ek,C,MIN,27,73,27,40,67
44,8479407,Jesper Bratt,L,NJD,26,80,19,48,67
44,8482745,Mason McTavish,C,ANA,21,72,31,35,66
44,8476346,Johnny Gaudreau,L,CBJ,31,79,16,49,65
44,8474578,Erik Karlsson,D,PIT,34,77,11,54,65
44,8477955,Jared McCann,L,SEA,28,72,37,27,64
44,8477500,Bo Horvat,C,NYI,29,81,33,31,64
44,8478233,Andrew Mangiapane,L,WSH,28,65,22,42,64
44,8480803,Evan Bouchard,D,EDM,25,76,14,50,64
44,8480014,Gabriel Vilardi,C,WPG,25,71,38,25,63
44,8482092,Ridly Greig,C,OTT,22,78,28,35,63
44,8475810,Bryan Rust,R,PIT,32,73,26,37,63
44,8478047,Michael Bunting,L,PIT,29,73,25,38,63
44,8475168,Matt Duchene,C,DAL,33,80,24,39,63
44,8474586,Jordan Eberle,R,SEA,34,77,22,41,63
44,8476905,Chandler Stephenson,C,SEA,30,79,20,43,63
44,8475314,Anders Lee,L,NYI,34,78,35,27,62
44,8482159,Tyson Foerster,R,PHI,22,77,29,33,62
44,8471675,Sidney Crosby,C,PIT,37,76,24,38,62
44,8477496,Elias Lindholm,C,BOS,30,79,24,38,62
44,8474600,Roman Josi,D,NSH,34,70,15,47,62
44,8480865,Noah Dobson,D,NYI,24,81,15,47,62
44,8482124,Quinton Byfield,R,LAK,22,80,15,47,62
44,8475169,Evander Kane,L,EDM,33,77,36,25,61
44,8477951,Nick Schmaltz,C,UTA,28,77,20,41,61
44,8473994,Jamie Benn,L,DAL,35,81,18,43,61
44,8476456,Jonathan Huberdeau,C,CGY,31,77,17,44,61
44,8475754,Brock Nelson,C,NYI,33,80,28,32,60
44,8475765,Vladimir Tarasenko,R,DET,33,81,28,31,59
44,8479525,Ross Colton,C,COL,28,79,22,37,59
44,8471685,Anze Kopitar,C,LAK,37,80,15,44,59
44,8475798,Mikael Granlund,C,SJS,32,69,14,45,59
44,8475726,Tyler Toffoli,C,SJS,32,75,28,30,58
44,8476881,Tomas Hertl,C,VGK,31,76,23,35,58
44,8481533,Trevor Zegras,C,ANA,23,72,22,36,58
44,8477416,Oliver Bjorkstrand,R,SEA,29,75,16,42,58
44,8478460,Zach Werenski,D,CBJ,27,78,13,45,58
44,8480036,Miro Heiskanen,D,DAL,25,74,13,45,58
44,8478407,Vince Dunn,D,SEA,28,72,12,46,58
44,8482109,Alexis Lafrenière,L,NYR,23,75,27,30,57
44,8475191,Reilly Smith,R,NYR,33,79,26,31,57
44,8477935,Sam Bennett,C,FLA,28,80,26,31,57
44,8476448,William Karlsson,C,VGK,31,76,24,33,57
44,8476906,Shayne Gostisbehere,D,CAR,31,76,16,41,57
44,8477456,J.T. Compher,L,DET,29,80,15,42,57
44,8478498,Jake DeBrusk,L,VAN,28,75,26,30,56
44,8475794,Tyler Seguin,C,DAL,32,82,24,32,56
44,8480015,Owen Tippett,R,PHI,25,73,22,34,56
44,8476792,Torey Krug,D,STL,33,73,12,44,56
44,8476875,Mike Matheson,D,MTL,30,73,11,45,56
44,8477964,Ivan Barbashev,C,VGK,29,71,25,30,55
44,8484153,Leo Carlsson,C,ANA,20,78,24,31,55
44,8475158,Ryan O'Reilly,C,NSH,33,73,23,32,55
44,8478975,Mason Marchment,L,DAL,29,81,20,35,55
44,8482667,William Eklund,L,SJS,22,69,18,37,55
44,8476853,Morgan Rielly,D,TOR,30,67,11,44,55
44,8479675,Trevor Moore,L,LAK,29,79,23,31,54
44,8477407,Anthony Duclair,L,NYI,29,75,23,31,54
44,8473986,Alex Killorn,L,ANA,35,72,23,31,54
44,8479999,Casey Mittelstadt,C,COL,26,79,21,33,54
44,8478466,Daniel Sprong,R,VAN,27,72,20,34,54
44,8477949,Alex Tuch,R,BUF,28,69,18,36,54
44,8478397,Rasmus Andersson,D,CGY,28,72,15,39,54
44,8480839,Rasmus Dahlin,D,BUF,24,70,14,40,54
44,8478366,Frank Vatrano,R,ANA,30,73,25,28,53
44,8478856,Conor Garland,R,VAN,28,74,24,29,53
44,8474641,Adam Henrique,C,EDM,34,78,20,33,53
44,8479400,Pierre-Luc Dubois,L,WSH,26,71,17,36,53
44,8478444,Brock Boeser,R,VAN,27,74,26,26,52
44,8478462,Nicolas Roy,C,VGK,27,76,21,31,52
44,8481596,Shane Pinto,C,OTT,24,76,21,31,52
44,8478438,Tommy Novak,C,NSH,27,70,19,33,52
44,8482684,Luke Hughes,D,NJD,21,70,13,39,52
44,8471724,Kris Letang,D,PIT,37,79,9,43,52
44,8475764,Cam Fowler,D,ANA,33,73,5,47,52
44,8476438,Brandon Saad,L,STL,32,73,29,22,51
44,8481618,Alex Newhook,C,MTL,23,74,20,31,51
44,8476479,Phillip Danault,C,LAK,31,79,18,33,51
44,8475784,Jeff Skinner,C,EDM,32,74,21,29,50
44,8475287,Erik Haula,L,NJD,33,74,21,29,50
44,8477444,Andre Burakovsky,L,SEA,29,74,21,29,50
44,8477494,Jonathan Drouin,L,COL,29,81,14,36,50
44,8475753,Justin Faulk,D,STL,32,70,13,37,50
44,8478469,Thomas Chabot,D,OTT,27,75,12,38,50
44,8470613,Brent Burns,D,CAR,39,77,7,43,50
44,8476399,Blake Coleman,C,CGY,33,75,28,21,49
44,8476539,Jonathan Marchessault,R,NSH,34,74,27,22,49
44,8476432,Boone Jenner,C,CBJ,31,71,26,23,49
44,8476483,Rickard Rakell,R,PIT,31,75,26,23,49
44,8478401,Pavel Zacha,C,BOS,27,79,20,29,49
44,8480113,Alex Iafallo,L,WPG,31,63,18,31,49
44,8477948,Travis Sanheim,D,PHI,28,73,13,36,49
44,8479325,Charlie McAvoy,D,BOS,27,74,7,42,49
44,8475722,Jason Zucker,L,BUF,32,71,25,23,48
44,8475151,Kyle Palmieri,C,NYI,33,79,23,25,48
44,8482110,Dawson Mercer,C,NJD,23,73,22,26,48
44,8482699,Dylan Guenther,R,UTA,21,73,21,27,48
44,8482097,Jack Quinn,R,BUF,23,67,21,27,48
44,8478519,Anthony Cirelli,C,TBL,27,82,20,28,48
44,8474102,David Perron,L,OTT,36,77,16,32,48
44,8477503,Max Domi,C,TOR,29,74,16,32,48
44,8482078,Lucas Raymond,L,DET,22,77,16,32,48
44,8481068,Yegor Sharangovich,C,CGY,26,79,29,18,47
44,8478458,John (Jack) Roslovic,C,CAR,27,63,18,29,47
44,8478042,Viktor Arvidsson,L,EDM,31,75,17,30,47
44,8477451,Ryan Hartman,R,MIN,30,67,26,20,46
44,8475745,Charlie Coyle,C,BOS,32,79,23,23,46
44,8482149,Cole Perfetti,C,WPG,22,59,22,24,46
44,8483515,Juraj Slafkovsky,L,MTL,20,74,21,25,46
44,8482113,Anton Lundell,C,FLA,23,76,18,28,46
44,8484145,Zach Benson,L,BUF,19,70,13,33,46
44,8477932,Aaron Ekblad,D,FLA,28,74,8,38,46
44,8480188,Fabian Zetterlund,L,SJS,25,59,16,29,45
44,8480798,Philipp Kurashev,C,CHI,25,67,15,30,45
44,8474150,Mikael Backlund,C,CGY,35,78,12,33,45
44,8476872,Scott Laughton,C,PHI,30,70,24,20,44
44,8475763,Kevin Hayes,R,PIT,32,68,20,24,44
44,8483431,Logan Cooley,C,UTA,20,72,19,25,44
44,8477986,Brandon Montour,D,SEA,30,75,16,28,44
44,8476419,Jean-Gabriel Pageau,C,NYI,32,76,13,31,44
44,8481711,Matias Maccelli,L,UTA,24,73,7,37,44
44,8477511,Anthony Mantha,R,CGY,30,75,21,22,43
44,8478046,Danton Heinen,L,VAN,29,71,17,26,43
44,8476882,Teuvo Teravainen,C,CHI,30,64,14,29,43
44,8474565,Alex Pietrangelo,D,VGK,34,66,12,31,43
44,8474590,John Carlson,D,WSH,34,66,11,32,43
44,8474563,Drew Doughty,D,LAK,35,74,8,35,43
44,8477447,Shea Theodore,D,VGK,29,57,5,38,43
44,8480064,Josh Norris,C,OTT,25,76,24,18,42
44,8476880,Tom Wilson,R,WSH,30,62,22,20,42
44,8481604,Pavel Dorofeyev,L,VGK,24,73,20,22,42
44,8477497,Sean Monahan,C,CBJ,30,72,17,25,42
44,8482671,Owen Power,D,BUF,22,63,7,35,42
44,8476958,Jaccob Slavin,D,CAR,30,75,6,36,42
44,8479987,Morgan Geekie,C,BOS,26,75,22,19,41
44,8477998,Warren Foegele,L,LAK,28,80,21,20,41
44,8474149,Evgenii Dadonov,R,DAL,35,80,21,20,41
44,8480797,Joel Farabee,L,PHI,24,71,17,24,41
44,8475714,Calle Jarnkrok,C,TOR,33,72,17,24,41
44,8476480,Vladislav Namestnikov,C,WPG,32,62,11,30,41
44,8479345,Jakob Chychrun,D,WSH,26,64,8,33,41
44,8476462,Dougie Hamilton,D,NJD,31,69,8,33,41
44,8482665,Matty Beniers,C,SEA,22,71,18,22,40
44,8482702,Logan Stankoven,C,DAL,21,79,17,23,40
44,8480078,Filip Chytil,C,NYR,25,69,15,25,40
44,8478542,Evan Rodrigues,C,FLA,31,75,14,26,40
44,8477021,Alex Kerfoot,C,UTA,30,79,13,27,40
44,8475848,Brendan Gallagher,R,MTL,32,67,12,28,40
44,8479339,Patrik Laine,L,CBJ,26,65,12,28,40
44,8482712,Oskar Olausson,R,COL,22,76,12,28,40
44,8481703,Valtteri Puustinen,R,PIT,25,68,11,29,40
44,8477495,Seth Jones,D,CHI,30,69,9,31,40
44,8479992,Michael Rasmussen,C,DET,25,81,17,22,39
44,8476474,Stefan Noesen,R,NJD,31,67,16,23,39
44,8480817,K'Andre Miller,D,NYR,24,76,15,24,39
44,8476292,Ondrej Palat,L,NJD,33,69,11,28,39
44,8474679,Gustav Nyquist,C,NSH,35,74,9,30,39
44,8479425,Filip Hronek,D,VAN,27,71,7,32,39
44,8484166,Adam Fantilli,C,CBJ,20,63,22,16,38
44,8480802,Ryan McLeod,C,BUF,25,71,21,17,38
44,8477426,Nicholas Paul,L,TBL,29,81,18,20,38
44,8471698,T.J. Oshie,R,WSH,38,63,18,20,38
44,8477479,Tyler Bertuzzi,L,CHI,29,66,17,21,38
44,8483808,Andrei Kuzmenko,L,CGY,28,76,14,24,38
44,8482105,Jake Sanderson,D,OTT,22,71,7,31,38
44,8481560,Arthur Kaliyev,R,LAK,23,77,20,17,37
44,8480459,Pius Suter,C,VAN,28,70,18,19,37
44,8478115,Pierre Engvall,L,NYI,28,80,18,19,37
44,8481554,Kaapo Kakko,R,NYR,23,69,16,21,37
44,8480849,Barrett Hayton,C,UTA,24,69,15,22,37
44,8480028,Morgan Frost,C,PHI,25,74,14,23,37
44,8482146,Luke Evangelista,R,NSH,22,67,13,24,37
44,8481523,Kirby Dach,C,MTL,23,67,13,24,37
44,8480185,Eetu Luostarinen,C,FLA,26,79,12,25,37
44,8480871,Adam Boqvist,D,FLA,24,76,11,26,37
44,8474151,Ryan McDonagh,D,TBL,35,79,6,31,37
44,8478474,Lawson Crouse,L,UTA,27,72,21,15,36
44,8475768,Jaden Schwartz,C,SEA,32,71,20,16,36
44,8481582,Nicholas Robertson,L,TOR,23,67,19,17,36
44,8480009,Eeli Tolvanen,R,SEA,25,69,15,21,36
44,8476826,Yanni Gourde,C,SEA,33,73,15,21,36
44,8478020,Michael Amadio,R,OTT,28,73,15,21,36
44,8481656,Aliaksei Protas,C,WSH,23,68,15,21,36
44,8481577,Philip Tomasino,C,NSH,23,70,13,23,36
44,8476892,Colton Parayko,D,STL,31,68,8,28,36
44,8478038,Devon Toews,D,COL,30,71,7,29,36
44,8479976,Juuso Valimaki,D,UTA,26,66,3,33,36
44,8479316,Luke Kunin,C,SJS,27,60,20,15,35
44,8478057,Dakota Joshua,C,VAN,28,66,16,19,35
44,8481186,Logan O'Connor,R,COL,28,80,16,19,35
44,8482055,Drew O'Connor,L,PIT,26,63,16,19,35
44,8473422,Nick Foligno,L,CHI,37,63,14,21,35
44,8479365,Trent Frederic,C,BOS,26,76,13,22,35
44,8477952,Robby Fabbri,C,ANA,28,69,13,22,35
44,8480220,Noah Cates,L,PHI,25,64,12,23,35
44,8476458,Ryan Strome,C,ANA,31,68,11,24,35
44,8481581,Thomas Harley,D,DAL,23,69,9,26,35
44,8480829,Jesperi Kotkaniemi,C,CAR,24,66,19,15,34
44,8475799,Nino Niederreiter,R,WPG,32,72,18,16,34
44,8478891,Mason Appleton,C,WPG,28,63,15,19,34
44,8479390,Taylor Raddysh,R,WSH,26,69,12,22,34
44,8470621,Corey Perry,R,EDM,39,71,12,22,34
44,8483445,Cutter Gauthier,L,ANA,20,67,11,23,34
44,8482133,Thomas Bordeleau,C,SJS,22,66,9,25,34
44,8476923,Damon Severson,D,CBJ,30,81,8,26,34
44,8482720,Matthew Knies,L,TOR,22,74,6,28,34
44,8483565,Nick Blankenburg,D,NSH,26,64,6,28,34
44,8478396,Noah Hanifin,D,VGK,27,62,5,29,34
44,8482089,Jake Neighbours,L,STL,22,73,20,13,33
44,8476918,Jimmy Vesey,L,NYR,31,67,16,17,33
44,8478413,Jordan Greenway,L,BUF,27,65,15,18,33
44,8481624,Ilya Mikheyev,R,CHI,30,62,13,20,33
44,8477989,Christian Dvorak,C,MTL,28,69,11,22,33
44,8476854,Hampus Lindholm,D,BOS,30,76,9,24,33
44,8477953,Kasperi Kapanen,R,STL,28,65,9,24,33
44,8480893,Kirill Marchenko,R,CBJ,24,62,18,14,32
44,8478970,Jalen Chatfield,D,CAR,28,71,15,17,32
44,8474053,Logan Couture,C,SJS,35,66,12,20,32
44,8481542,Moritz Seider,D,DET,23,76,8,24,32
44,8481546,Cam York,D,PHI,23,64,7,25,32
44,8480145,Neal Pionk,D,WPG,29,70,7,25,32
44,8479402,Jake Bean,D,CGY,26,65,7,25,32
44,8479619,Michael Carcone,L,UTA,28,71,18,13,31
44,8475760,Nick Bjugstad,C,UTA,32,71,15,16,31
44,8476392,Adam Lowry,C,WPG,31,59,14,17,31
44,8477498,Darnell Nurse,D,EDM,29,71,10,21,31
44,8475793,Ryan Johansen,C,PHI,32,69,10,21,31
44,8475218,Mattias Ekholm,D,EDM,34,69,10,21,31
44,8483505,Matthew Poitras,C,BOS,20,74,10,21,31
44,8476925,Colton Sissons,C,NSH,31,72,10,21,31
44,8477505,Alexander Wennberg,C,SJS,30,63,8,23,31
44,8476331,Dylan DeMelo,D,WPG,31,73,8,23,31
44,8476869,Brady Skjei,D,NSH,30,69,7,24,31
44,8478500,Ivan Provorov,D,CBJ,27,79,6,25,31
44,8480043,Timothy Liljegren,D,TOR,25,65,2,29,31
44,8477478,William Carrier,L,CAR,30,56,19,11,30
44,8482705,Cole Sillinger,C,CBJ,21,70,15,15,30
44,8478472,Mathieu Joseph,R,STL,27,70,14,16,30
44,8480835,Jack Drury,C,CAR,24,62,14,16,30
44,8475149,Marcus Johansson,L,MIN,34,65,12,18,30
44,8479661,Tanner Jeannot,L,LAK,27,74,12,18,30
44,8480336,Sean Walker,D,CAR,30,70,12,18,30
44,8481606,Jordan Spence,D,LAK,23,67,9,21,30
44,8479398,Samuel Girard,D,COL,26,64,6,24,30
44,8483490,Pavel Mintyukov,D,ANA,21,64,4,26,30
44,8481535,Nils Hoglander,L,VAN,24,65,15,14,29
44,8474189,Lars Eller,C,PIT,35,65,15,14,29
44,8476461,Sean Couturier,C,PHI,32,67,14,15,29
44,8480748,Kiefer Sherwood,L,VAN,29,66,14,15,29
44,8479393,Noah Gregor,L,OTT,26,74,13,16,29
44,8479353,Brett Howden,C,VGK,26,71,13,16,29
44,8476897,Oskar Sundqvist,C,STL,30,64,13,16,29
44,8479591,Michael Eyssimont,C,TBL,28,81,12,17,29
44,8475193,Tomas Tatar,L,NJD,34,62,11,18,29
44,8477346,MacKenzie Weegar,D,CGY,30,69,4,25,29
44,8473533,Jordan Staal,C,CAR,36,67,12,16,28
44,8480434,Sean Durzi,D,UTA,26,61,10,18,28
44,8478911,Matt Roy,D,WSH,29,65,10,18,28
44,8481524,Bowen Byram,D,BUF,23,64,9,19,28
44,8479351,Sam Steel,C,DAL,26,80,9,19,28
44,8478133,Jake Evans,C,MTL,28,64,6,22,28
44,8474715,Cameron Atkinson,R,TBL,35,82,14,13,27
44,8481032,Paul Cotter,C,NJD,25,69,12,15,27
44,8477429,Andrew Copp,C,DET,30,76,9,18,27
44,8476927,Teddy Blueger,C,VAN,30,64,8,19,27
44,8474716,Jared Spurgeon,D,MIN,35,75,8,19,27
44,8479639,Dylan Coghlan,D,WPG,26,63,7,20,27
44,8482624,Daniil Miromanov,D,CGY,27,66,6,21,27
44,8473507,Jeff Petry,D,DET,37,74,4,23,27
44,8482655,Janis Moser,D,TBL,24,76,3,24,27
44,8477506,Ryan Pulock,D,NYI,30,78,1,26,27
44,8476878,Zemgus Girgensons,C,TBL,30,78,17,9,26
44,8477947,Sonny Milano,L,WSH,28,70,14,12,26
44,8478432,Christian Fischer,R,DET,27,76,14,12,26
44,8476981,Josh Anderson,R,MTL,30,73,14,12,26
44,8480068,Ryan Poehling,C,PHI,25,63,13,13,26
44,8477220,Nate Schmidt,D,FLA,33,69,9,17,26
44,8476979,Erik Gustafsson,D,DET,32,75,8,18,26
44,8476463,Jonas Brodin,D,MIN,31,77,8,18,26
44,8482142,Jamie Drysdale,D,PHI,22,68,8,18,26
44,8475200,Dmitry Orlov,D,CAR,33,73,6,20,26
44,8479410,Mikhail Sergachev,D,UTA,26,69,6,20,26
44,8476931,Jake McCabe,D,TOR,31,73,4,22,26
44,8478463,Anthony Beauvillier,L,PIT,27,58,18,7,25
44,8480448,Parker Kelly,L,COL,25,78,15,10,25
44,8475343,Nic Dowd,C,WSH,34,62,12,13,25
44,8477839,Conor Sheary,L,TBL,32,80,12,13,25
44,8477903,Garnet Hathaway,R,PHI,33,65,11,14,25
44,8481522,Peyton Krebs,C,BUF,23,61,9,16,25
44,8477488,Brett Pesce,D,NJD,30,69,7,18,25
44,8476312,Josh Manson,D,COL,33,65,6,19,25
44,8483491,Ivan Miroshnichenko,L,WSH,20,56,6,19,25
44,8478055,Gustav Forsling,D,FLA,28,65,3,22,25
44,8480878,Nils Lundkvist,D,DAL,24,71,3,22,25
44,8482475,Yegor Chinakhov,R,CBJ,23,62,13,11,24
44,8478109,Victor Olofsson,L,VGK,29,73,13,11,24
44,8479293,Brandon Tanev,L,SEA,33,64,13,11,24
44,8475791,Taylor Hall,L,CHI,33,57,11,13,24
44,8481093,Rafael Harvey-Pinard,L,MTL,25,66,10,14,24
44,8484203,Bradly Nadeau,L,CAR,19,63,8,16,24
44,8479996,Cody Glass,C,NSH,25,55,8,16,24
44,8476885,Jacob Trouba,D,NYR,30,71,5,19,24
44,8473563,Nicklas Backstrom,C,WSH,37,55,5,19,24
44,8480873,Rasmus Sandin,D,WSH,24,61,4,20,24
44,8480049,Dylan Samberg,D,WPG,25,69,1,23,24
44,8477425,Miles Wood,L,COL,29,76,14,9,23
44,8475231,Casey Cizikas,C,NYI,33,73,14,9,23
44,8480011,Klim Kostin,C,SJS,25,53,14,9,23
44,8482125,Alexander Holtz,R,VGK,22,63,13,10,23
44,8479941,Justin Danforth,R,CBJ,31,60,12,11,23
44,8483524,Shane Wright,C,SEA,20,61,11,12,23
44,8475855,Jesper Fast,R,CAR,33,53,11,12,23
44,8479315,Joey Anderson,R,CHI,26,48,11,12,23
44,8480205,Emil Bemstrom,C,PIT,25,55,11,12,23
44,8482074,Connor Zary,C,CGY,23,61,11,12,23
44,8481553,Bobby Brink,R,PHI,23,62,11,12,23
44,8482749,Joshua Roy,R,MTL,21,63,8,15,23
44,8482122,Brock Faber,D,MIN,22,78,6,17,23
44,8481481,Blake Lizotte,C,PIT,27,59,6,17,23
44,8470600,Ryan Suter,D,STL,39,58,6,17,23
44,8479983,Mario Ferraro,D,SJS,26,76,5,18,23
44,8479371,Dante Fabbro,D,NSH,26,55,5,18,23
44,8478507,John Marino,D,UTA,27,74,2,21,23
44,8478434,Keegan Kolesar,R,VGK,27,59,9,13,22
44,8477380,Jonny Brodzinski,C,NYR,31,52,9,13,22
44,8482730,Brandt Clarke,D,LAK,21,60,9,13,22
44,8482660,Kent Johnson,C,CBJ,22,62,8,14,22
44,8477406,Mattias Janmark,C,EDM,32,66,8,14,22
44,8476889,Radek Faksa,C,STL,30,57,7,15,22
44,8478882,Vladislav Gavrikov,D,LAK,29,64,5,17,22
44,8480789,Oliver Wahlstrom,R,NYI,24,68,5,17,22
44,8474574,Tyler Myers,D,VAN,34,66,5,17,22
44,8477969,Marcus Pettersson,D,PIT,28,81,4,18,22
44,8474673,TJ Brodie,D,CHI,34,60,4,18,22
44,8475179,Dmitry Kulikov,D,FLA,34,57,3,19,22
44,8478508,Yakov Trenin,C,MIN,27,65,14,7,21
44,8482155,Alex Laferriere,R,LAK,23,64,14,7,21
44,8482079,Marco Rossi,C,MIN,23,54,14,7,21
44,8477573,Nathan Walker,L,STL,30,49,13,8,21
44,8480144,David Kampf,C,TOR,29,71,11,10,21
44,8480252,Cole Guttman,C,CHI,25,42,9,12,21
44,8477015,Connor Brown,R,EDM,30,63,9,12,21
44,8482175,JJ Peterka,R,BUF,22,61,8,13,21
44,8477919,Frederick Gaudreau,C,MIN,31,66,8,13,21
44,8482111,Justin Barron,D,MTL,23,64,3,18,21
44,8475208,Brian Dumoulin,D,ANA,33,64,3,18,21
44,8477499,Rasmus Ristolainen,D,PHI,30,60,2,19,21
44,8478043,Sam Lafferty,C,BUF,29,60,16,4,20
44,8478569,Noel Acciari,C,PIT,33,53,14,6,20
44,8476469,Joel Armia,R,MTL,31,62,14,6,20
44,8480003,Jesper Boqvist,C,FLA,26,70,11,9,20
44,8481580,Connor McMichael,C,WSH,23,58,10,10,20
44,8482737,Zack Bolduc,C,STL,21,52,10,10,20
44,8479066,Ryan Lomberg,L,CGY,30,63,8,12,20
44,8483482,Tristan Luneau,D,ANA,20,67,7,13,20
44,8482117,Lukas Reichel,L,CHI,22,48,7,13,20
44,8479982,Conor Timmins,D,TOR,26,55,6,14,20
44,8476457,Adam Larsson,D,SEA,32,64,6,14,20
44,8481441,Joe Snively,C,DET,28,68,6,14,20
44,8476467,Jamie Oleksiak,D,SEA,32,66,6,14,20
44,8482245,Artem Zub,D,OTT,29,70,4,16,20
44,8482176,Wyatt Kaiser,D,CHI,22,60,4,16,20
44,8476879,Cody Ceci,D,EDM,31,69,4,16,20
44,8475181,Nick Leddy,D,STL,33,67,3,17,20
44,8476422,Mike Reilly,D,NYI,31,78,3,17,20
44,8482077,Dylan Holloway,L,EDM,23,53,12,7,19
44,8481704,Juuso Parssinen,C,NSH,23,59,11,8,19
44,8481601,Simon Holmstrom,R,NYI,23,65,11,8,19
44,8482259,Bobby McMann,C,TOR,28,70,11,8,19
44,8476329,Travis Boyd,C,MIN,31,50,10,9,19
44,8484149,Gavin Brindley,C,CBJ,20,49,10,9,19
44,8480806,Isac Lundestrom,C,ANA,25,54,10,9,19
44,8482803,Olen Zellweger,D,ANA,21,68,9,10,19
44,8478451,Ethan Bear,D,WSH,27,51,9,10,19
44,8480074,Alexandre Texier,C,STL,25,50,9,10,19
44,8477435,Ryan Graves,D,PIT,29,73,6,13,19
44,8475220,Marcus Foligno,L,MIN,33,57,5,14,19
44,8476856,Mathew Dumba,D,DAL,30,73,5,14,19
44,8476902,Esa Lindell,D,DAL,30,74,4,15,19
44,8480246,Nick Perbix,D,TBL,26,73,4,15,19
44,8480796,Martin Fehervary,D,WSH,25,56,4,15,19
44,8480891,Michael Kesselring,D,UTA,24,61,3,16,19
44,8478452,Caleb Jones,D,LAK,27,55,3,16,19
44,8475171,Oliver Ekman-Larsson,D,TOR,33,65,2,17,19
44,8476822,Luke Glendening,C,TBL,35,81,13,5,18
44,8477987,Ryan Donato,C,CHI,28,63,10,8,18
44,8480855,Jack McBain,C,UTA,24,62,9,9,18
44,8473453,Trevor Lewis,C,LAK,37,73,9,9,18
44,8476624,Barclay Goodrow,C,SJS,31,55,9,9,18
44,8481028,Martin Pospisil,C,CGY,25,59,8,10,18
44,8482807,Ethan Del Mastro,D,CHI,21,50,8,10,18
44,8479372,Joshua Mahura,D,SEA,26,56,6,12,18
44,8481521,Ronnie Attard,D,PHI,25,56,5,13,18
44,8480058,Pierre-Olivier Joseph,D,STL,25,57,5,13,18
44,8479378,Logan Stanley,D,WPG,26,48,5,13,18
44,8478136,Jake Middleton,D,MIN,28,73,4,14,18
44,8475188,Brayden McNabb,D,VGK,33,54,4,14,18
44,8476917,Adam Pelech,D,NYI,30,77,3,15,18
44,8478399,Jonas Siegenthaler,D,NJD,27,58,3,15,18
44,8477369,Carson Soucy,D,VAN,30,62,2,16,18
44,8481568,Alex Vlasic,D,CHI,23,50,1,17,18
44,8480073,Erik Brannstrom,D,COL,25,56,0,18,18
44,8480281,Alexey Toropchenko,R,STL,25,66,12,5,17
44,8477446,Michael McCarron,R,NSH,29,54,9,8,17
44,8481517,Brett Leason,R,ANA,25,58,9,8,17
44,8480995,Pontus Holmberg,R,TOR,25,65,7,10,17
44,8476994,Vinnie Hinostroza,C,NSH,30,54,6,11,17
44,8482087,Kaiden Guhle,D,MTL,22,71,6,11,17
44,8481641,Joel Kiviranta,L,COL,28,67,6,11,17
44,8478851,Alexandre Carrier,D,NSH,28,69,4,13,17
44,8475790,Erik Gudbranson,D,CBJ,32,76,2,15,17
44,8475233,David Savard,D,MTL,34,63,2,15,17
44,8481014,Alexander Romanov,D,NYI,24,81,1,16,17
44,8480860,Kevin Bahl,D,CGY,24,59,1,16,17
44,8478211,Dryden Hunt,L,CGY,29,60,10,6,16
44,8476278,Colin Blackwell,C,DAL,31,78,9,7,16
44,8479439,Jacob MacDonald,D,COL,31,59,8,8,16
44,8482062,Cole Smith,L,NSH,29,57,7,9,16
44,8475462,Radko Gudas,D,ANA,34,65,7,9,16
44,8479718,Alex Barré-Boulet,C,MTL,27,50,7,9,16
44,8480762,Eric Robinson,L,CAR,29,65,5,11,16
44,8483468,Jiri Kulich,C,BUF,20,55,5,11,16
44,8477353,Tyler Motte,C,DET,29,74,5,11,16
44,8481527,Kaedan Korczak,D,VGK,23,50,5,11,16
44,8477931,Tomas Nosek,L,FLA,32,64,4,12,16
44,8476429,Scott Mayfield,D,NYI,32,77,3,13,16
44,8475324,Nick Jensen,D,OTT,34,61,3,13,16
44,8477507,Nikita Zadorov,D,BOS,29,70,2,14,16
44,8481059,Scott Perunovich,D,STL,26,63,2,14,16
44,8477845,Trevor van Riemsdyk,D,WSH,33,67,1,15,16
44,8482762,Simon Edvinsson,D,DET,21,59,11,4,15
44,8480813,Joe Veleno,C,DET,24,75,9,6,15
44,8477450,Jason Dickinson,C,CHI,29,59,9,6,15
44,8480980,Connor Dewar,C,TOR,25,63,8,7,15
44,8479944,Zach Aston-Reese,C,VGK,30,50,8,7,15
44,8475225,Craig Smith,C,CHI,35,46,8,7,15
44,8476960,Andreas Athanasiou,C,CHI,30,49,7,8,15
44,8477508,Curtis Lazar,C,NJD,29,60,7,8,15
44,8482101,Danil Gushchin,L,SJS,22,47,7,8,15
44,8483493,Frank Nazar,C,CHI,20,54,6,9,15
44,8479370,Tyson Jost,C,CAR,26,56,4,11,15
44,8479980,Nicolas Hague,D,VGK,26,57,3,12,15
44,8482861,Vincent Iorio,D,WSH,22,36,2,13,15
44,8478840,Will Borgen,D,SEA,28,64,1,14,15
44,8481178,Egor Zamula,D,PHI,24,59,0,15,15
44,8476891,Matthew Grzelcyk,D,PIT,30,75,0,15,15
44,8476967,Brett Kulak,D,EDM,30,61,0,15,15
44,8479336,Carl Grundstrom,R,SJS,27,46,11,3,14
44,8475842,Sam Carrick,C,NYR,32,52,10,4,14
44,8482679,Matt Coronato,R,CGY,22,63,9,5,14
44,8478585,Derek Ryan,C,EDM,38,55,8,6,14
44,8482809,Jackson Blake,R,CAR,21,53,7,7,14
44,8480025,MacKenzie Entwistle,R,FLA,25,66,7,7,14
44,8476921,Jordan Martinook,L,CAR,32,61,7,7,14
44,8478013,Jake Walman,D,SJS,28,69,6,8,14
44,8482166,Shakir Mukhamadullin,D,SJS,22,53,6,8,14
44,8479026,Philippe Myers,D,TOR,27,57,6,8,14
44,8477979,Nicolas Aube-Kubel,R,BUF,28,55,6,8,14
44,8480007,Jonas Rondbjerg,R,VGK,25,42,6,8,14
44,8475455,Brenden Dillon,D,NJD,34,65,5,9,14
44,8480021,Jack Studnicka,C,LAK,25,62,5,9,14
44,8476934,Brock McGinn,L,ANA,30,43,5,9,14
44,8479368,Max Jones,L,BOS,26,61,5,9,14
44,8483457,Lane Hutson,D,MTL,20,65,4,10,14
44,8476988,Matt Benning,D,SJS,30,62,4,10,14
44,8482859,Zack Ostapchuk,C,OTT,21,54,4,10,14
44,8481708,Zac Jones,D,NYR,24,49,3,11,14
44,8482067,Connor Mackey,D,NYR,28,55,2,12,14
44,8482073,Braden Schneider,D,NYR,23,62,1,13,14
44,8478178,Darren Raddysh,D,TBL,28,71,1,13,14
44,8475690,Chris Tanev,D,TOR,35,58,1,13,14
44,8480807,Mattias Samuelsson,D,BUF,24,53,0,14,14
44,8476858,Phillip Di Giuseppe,L,VAN,31,38,11,2,13
44,8479414,Nathan Bastian,R,NJD,27,53,9,4,13
44,8481537,Nikita Okhotiuk,D,CGY,24,48,9,4,13
44,8482148,Hendrix Lapierre,C,WSH,22,52,8,5,13
44,8477482,Zachary Sanford,L,CHI,30,41,8,5,13
44,8477392,Hudson Fasching,R,NYI,29,61,7,6,13
44,8476374,Sean Kuraly,C,CBJ,31,48,5,8,13
44,8474034,Patrick Maroon,L,CHI,36,56,5,8,13
44,8478421,A.J. Greer,L,FLA,28,52,5,8,13
44,8480355,Mark Kastelic,C,BOS,25,55,5,8,13
44,8479328,Julien Gauthier,R,NYI,27,66,5,8,13
44,8479972,Mason Shaw,C,WPG,26,35,5,8,13
44,8479359,Beck Malenstyn,L,BUF,26,45,5,8,13
44,8479671,Mathieu Olivier,R,CBJ,27,45,4,9,13
44,8482192,Isaak Phillips,D,CHI,23,60,4,9,13
44,8481019,David Gustafsson,C,WPG,24,53,4,9,13
44,8483495,Simon Nemec,D,NJD,20,52,4,9,13
44,8480834,Ty Emberson,D,SJS,24,42,4,9,13
44,8471709,Marc-Edouard Vlasic,D,SJS,37,51,4,9,13
44,8480035,Henri Jokiharju,D,BUF,25,65,3,10,13
44,8477365,Connor Clifton,D,BUF,29,57,3,10,13
44,8476873,Mark Jankowski,C,NSH,30,47,2,11,13
44,8479324,Ryan Lindgren,D,NYR,26,63,2,11,13
44,8479291,Kevin Rooney,C,CGY,31,53,2,11,13
44,8480001,Urho Vaakanainen,D,ANA,25,58,2,11,13
44,8476874,Olli Maatta,D,DET,30,67,2,11,13
44,8481477,Nico Sturm,C,SJS,29,54,6,6,12
44,8479520,Brandon Duhaime,R,WSH,27,60,6,6,12
44,8480289,Morgan Barron,C,WPG,26,59,6,6,12
44,8480845,Rasmus Kupari,C,WPG,24,47,5,7,12
44,8479981,Jonah Gadjovich,L,FLA,26,37,5,7,12
44,8483499,Liam Ohgren,L,MIN,20,58,4,8,12
44,8479998,Mikey Anderson,D,LAK,25,61,4,8,12
44,8480157,Calle Rosen,D,COL,30,47,4,8,12
44,8480222,Sebastian Aho,D,PIT,28,72,4,8,12
44,8477018,Ben Hutton,D,VGK,31,44,3,9,12
44,8481751,Lukas Rousek,R,BUF,25,40,3,9,12
44,8479543,Michael Pezzetta,L,MTL,26,54,2,10,12
44,8480950,Ilya Lyubushkin,D,DAL,30,62,2,10,12
44,8479369,Andrew Peeke,D,BOS,26,61,1,11,12
44,8475279,Ben Chiarot,D,DET,33,67,1,11,12
44,8474568,Luke Schenn,D,NSH,35,50,1,11,12
44,8481518,Nolan Foote,L,NJD,24,34,8,3,11
44,8481716,Dmitri Voronkov,L,CBJ,24,46,7,4,11
44,8483466,Kevin Korchinski,D,CHI,20,48,7,4,11
44,8482666,Scott Morrow,D,CAR,22,50,6,5,11
44,8482659,Josh Doan,R,UTA,22,54,4,7,11
44,8479442,Troy Stecher,D,EDM,30,56,4,7,11
44,8480172,Jan Rutta,D,SJS,34,64,3,8,11
44,8479344,Jesse Puljujarvi,R,PIT,26,52,2,9,11
44,8480727,Zach Whitecloud,D,VGK,28,46,2,9,11
44,8481550,Adam Beckman,L,NJD,23,33,2,9,11
44,8477384,Joshua Brown,D,EDM,30,46,1,10,11
44,8478450,Parker Wotherspoon,D,BOS,27,32,1,10,11
44,8478831,Kevin Stenlund,C,UTA,28,52,8,2,10
44,8478468,Jeremy Lauzon,D,NSH,27,51,7,3,10
44,8480192,Johnathan Kovacevic,D,NJD,27,58,7,3,10
44,8482964,Arber Xhekaj,D,MTL,23,47,5,5,10
44,8481161,Jake Christiansen,D,CBJ,25,58,5,5,10
44,8481532,Alex Turcotte,C,LAK,23,50,5,5,10
44,8482157,Will Cuylle,L,NYR,22,60,4,6,10
44,8477070,Liam O'Brien,C,UTA,30,54,3,7,10
44,8481567,Henry Thrun,D,SJS,23,50,2,8,10
44,8480844,Grigori Denisenko,L,VGK,24,27,2,8,10
44,8480196,Jacob Bryson,D,BUF,27,49,2,8,10
44,8481167,Brayden Pachal,D,CGY,25,44,2,8,10
44,8476952,Dominic Toninato,C,WPG,30,31,2,8,10
44,8476525,Colin Miller,D,WPG,32,61,1,9,10
44,8479348,Kale Clague,D,BUF,26,36,1,9,10
44,8478859,Niko Mikkola,D,FLA,28,58,0,10,10
44,8474166,Alec Martinez,D,CHI,37,45,0,10,10
44,8481013,Jonatan Berggren,R,DET,24,53,4,5,9
44,8476442,Matt Nieto,L,PIT,32,45,4,5,9
44,8482496,Nils Aman,C,VAN,24,41,4,5,9
44,8483549,Lucas Condotta,L,MTL,27,36,4,5,9
44,8479968,Vinni Lettieri,C,BOS,29,44,4,5,9
44,8482451,Mikael Pyyhtia,L,CBJ,23,47,3,6,9
44,8480441,Trey Fix-Wolansky,R,CBJ,25,36,3,6,9
44,8482747,Brennan Othmann,L,NYR,21,38,3,6,9
44,8482733,Logan Mailloux,D,MTL,31,41,3,6,9
44,8480245,Olle Lycksell,R,PHI,25,42,3,6,9
44,8477034,Jaycob Megna,D,FLA,32,42,2,7,9
44,8476441,Joel Edmundson,D,LAK,31,40,2,7,9
44,8481056,Spencer Stastney,D,NSH,24,39,2,7,9
44,8476473,Connor Murphy,D,CHI,31,44,2,7,9
44,8479249,Andrew Poturalski,C,SJS,30,31,1,8,9
44,8481701,Santeri Hatakka,D,NJD,23,33,0,9,9
44,8480879,Jacob Bernard-Docker,D,OTT,24,46,0,9,9
44,8473446,Erik Johnson,D,PHI,36,43,0,9,9
44,8478454,Noah Juulsen,D,VAN,27,40,0,9,9
44,8481592,Jakob Pelletier,L,CGY,23,40,7,1,8
44,8471817,Ryan Reaves,R,TOR,37,50,5,3,8
44,8482070,Mitchell Chaffee,R,TBL,26,43,5,3,8
44,8484287,Cole McWard,D,VAN,23,22,4,4,8
44,8483619,Filip Roos,D,OTT,25,45,4,4,8
44,8482751,Ryan Winterton,C,SEA,21,39,3,5,8
44,8474013,Ian Cole,D,UTA,35,53,3,5,8
44,8482652,Walker Duehr,R,CGY,27,37,3,5,8
44,8482153,Brendan Brisson,C,VGK,23,38,3,5,8
44,8481599,Victor Soderstrom,D,UTA,23,45,2,6,8
44,8480292,Carson Meyer,R,ANA,27,28,2,6,8
44,8480990,Declan Chisholm,D,MIN,24,44,2,6,8
44,8475762,Derek Forbort,D,VAN,32,42,1,7,8
44,8474612,Travis Hamonic,D,OTT,34,50,1,7,8
44,8484911,Collin Graf,R,SJS,22,33,1,7,8
44,8478146,Matthew Highmore,C,OTT,28,38,1,7,8
44,8479986,Kole Lind,R,DAL,26,44,0,8,8
44,8475235,Nicolas Deslauriers,L,PHI,33,51,4,3,7
44,8479379,Givani Smith,R,SJS,26,36,4,3,7
44,8481679,Maxence Guenette,D,OTT,23,29,4,3,7
44,8478424,Jansen Harkins,C,ANA,27,41,4,3,7
44,8483630,Pavol Regenda,L,ANA,25,28,4,3,7
44,8481754,Nikita Nesterenko,C,ANA,23,32,3,4,7
44,8481147,Reese Johnson,C,MIN,26,41,3,4,7
44,8481617,Vasily Podkolzin,R,VAN,23,36,3,4,7
44,8481122,Simon Benoit,D,TOR,26,39,3,4,7
44,8477401,John Hayden,C,SEA,29,24,2,5,7
44,8478443,Brandon Carlo,D,BOS,28,59,2,5,7
44,8483012,Logan Morrison,C,SEA,22,33,2,5,7
44,8478017,Mark Friedman,D,VAN,29,47,2,5,7
44,8474567,Zach Bogosian,D,MIN,34,58,2,5,7
44,8477462,Robert Hagg,D,VGK,29,25,2,5,7
44,8482095,Tyler Kleven,D,OTT,22,42,1,6,7
44,8476372,Nick Seeler,D,PHI,31,42,1,6,7
44,8476867,Brendan Gaunce,C,MIN,30,30,1,6,7
44,8475750,Jon Merrill,D,MIN,32,63,1,6,7
44,8479985,Cale Fleury,D,SEA,26,29,1,6,7
44,8479576,Vincent Desharnais,D,VAN,28,29,1,6,7
44,8479587,Rhett Gardner,C,PHI,28,24,1,6,7
44,8474062,Riley Nash,C,NYR,35,21,4,2,6
44,8478409,Anthony Richard,C,PHI,28,36,3,3,6
44,8479536,Axel Jonsson-Fjallby,L,WPG,26,34,2,4,6
44,8481600,Tobias Bjornfot,D,FLA,23,40,2,4,6
44,8482634,Alex Steeves,C,TOR,25,51,2,4,6
44,8482765,Isak Rosen,R,BUF,21,36,2,4,6
44,8481598,Philip Broberg,D,EDM,23,43,2,4,6
44,8480880,Jakub Lauko,C,MIN,24,37,2,4,6
44,8477527,Ross Johnston,L,ANA,30,36,2,4,6
44,8478416,Erik Cernak,D,TBL,27,70,1,5,6
44,8480848,Ty Dellandrea,C,SJS,24,43,1,5,6
44,8471677,Jack Johnson,D,CBJ,37,63,1,5,6
44,8477244,Chad Ruhwedel,D,NYR,34,39,1,5,6
44,8474090,Brendan Smith,D,DAL,35,63,1,5,6
44,8480070,Ian Mitchell,D,BOS,25,41,0,6,6
44,8477335,Kyle Burroughs,D,LAK,29,40,0,6,6
44,8475177,Calvin de Haan,D,COL,33,36,4,1,5
44,8482141,Lukas Cormier,D,VGK,22,31,3,2,5
44,8479362,Riley Tufte,L,BOS,26,27,3,2,5
44,8481609,Vladislav Kolyachonok,D,UTA,23,32,2,3,5
44,8484258,Sam Malinski,D,COL,26,24,2,3,5
44,8483460,David Jiricek,D,CBJ,21,57,1,4,5
44,8482145,Mavrik Bourque,C,DAL,22,55,1,4,5
44,8477887,Patrick Brown,C,BOS,32,42,1,4,5
44,8477810,Joel Hanley,D,CGY,33,23,1,4,5
44,8478874,Adam Gaudette,R,OTT,28,30,1,4,5
44,8484254,Akito Hirose,D,VAN,25,39,1,4,5
44,8483570,Ben Meyers,C,SEA,26,31,1,4,5
44,8481605,Jackson LaCombe,D,ANA,23,33,1,4,5
44,8479419,Brett Murray,L,BUF,26,12,1,4,5
44,8480468,James Hamblin,L,EDM,25,26,1,4,5
44,8481006,Tyler Tucker,D,STL,24,15,1,4,5
44,8477851,Jordan Oesterle,D,BOS,32,44,0,5,5
44,8475718,Justin Holl,D,DET,32,59,0,5,5
44,8479772,Zack MacEwen,R,OTT,28,45,0,5,5
44,8479638,Justin Brazeau,R,BOS,26,36,4,0,4
44,8479320,Maxime Lajoie,D,SEA,27,23,3,1,4
44,8479367,William Lockwood,R,FLA,26,15,3,1,4
44,8481543,Nikita Alexandrov,C,STL,24,24,2,2,4
44,8482784,Zach Dean,C,STL,21,39,2,2,4
44,8482511,Mason Lohrei,D,BOS,23,35,2,2,4
44,8481585,Egor Afanasyev,L,SJS,23,16,2,2,4
44,8480870,Bo Groulx,C,NYR,24,28,2,2,4
44,8482165,Yan Kuznetsov,D,CGY,22,22,2,2,4
44,8477938,Haydn Fleury,D,WPG,28,32,1,3,4
44,8481556,John Beecher,C,BOS,23,38,1,3,4
44,8477962,Brendan Lemieux,L,CAR,28,36,1,3,4
44,8482201,Gage Goncalves,C,TBL,23,25,1,3,4
44,8481789,Tye Kartye,L,SEA,23,31,1,3,4
44,8480887,Jordan Harris,D,MTL,24,47,0,4,4
44,8481564,Ryan Johnson,D,BUF,23,17,0,4,4
44,8481237,Kyle MacLean,C,NYI,25,22,0,4,4
44,8482858,Ryker Evans,D,SEA,23,28,0,4,4
44,8481593,Jayden Struble,D,MTL,23,21,0,4,4
44,8479994,Jaret Anderson-Dolan,C,WPG,25,38,3,0,3
44,8483397,Marc McLaughlin,C,BOS,25,40,3,0,3
44,8482744,James Malatesta,L,CBJ,21,39,2,1,3
44,8475795,Dylan McIlrath,D,WSH,32,15,2,1,3
44,8477320,Anton Blidh,L,NYR,29,17,2,1,3
44,8482787,Nikita Chibrikov,R,WPG,31,5,2,1,3
44,8482144,Jack Thompson,D,SJS,22,25,1,2,3
44,8480890,Jan Jenik,C,OTT,24,33,1,2,3
44,8478051,Max Willman,C,NJD,29,15,1,2,3
44,8477467,Gustav Olofsson,D,SEA,30,15,1,2,3
44,8478021,William Lagesson,D,DET,28,15,1,2,3
44,8482118,Sam Colangelo,R,ANA,23,18,1,2,3
44,8480075,Cameron Crotty,D,MIN,25,10,1,2,3
44,8483395,Arshdeep Bains,L,VAN,23,13,0,3,3
44,8481422,Jake Lucchini,C,NSH,29,12,2,0,2
44,8482516,Matthew Kessel,D,STL,24,21,2,0,2
44,8482172,Landon Slaggert,L,CHI,22,18,1,1,2
44,8483512,Matthew Savoie,C,EDM,20,24,1,1,2
44,8482147,Jean-Luc Foudy,C,COL,22,24,1,1,2
44,8476913,Devin Shore,C,MIN,30,37,1,1,2
44,8475413,Justin Dowling,C,NJD,34,14,1,1,2
44,8482929,Emil Lilleberg,D,TBL,23,20,1,1,2
44,8481043,Cole Koepke,L,BOS,26,11,1,1,2
44,8479991,Jake Leschyshyn,C,NYR,25,29,1,1,2
44,8483489,Fraser Minten,C,TOR,31,10,1,1,2
44,8481206,John Ludvig,D,PIT,24,13,1,1,2
44,8482094,Daemon Hunt,D,MIN,22,14,1,1,2
44,8477993,Justin Kirkland,C,CGY,28,5,1,1,2
44,8478477,Mitchell Stephens,C,SEA,27,27,0,2,2
44,8482713,Mackie Samoskevich,R,FLA,22,36,0,2,2
44,8478011,Louie Belpedio,D,PHI,28,13,0,2,2
44,8481699,Aku Raty,R,UTA,23,12,0,2,2
44,8482162,Roby Jarventie,L,EDM,22,12,0,2,2
44,8483567,Georgii Merkulov,C,BOS,24,13,0,2,2
44,8480084,Nick DeSimone,D,NJD,30,18,0,2,2
44,8477473,Justin Bailey,R,SJS,29,27,1,0,1
44,8480032,Shane Bowers,C,NJD,25,14,1,0,1
44,8482250,Callahan Burke,C,VGK,27,25,1,0,1
44,8484304,Uvis Balinskis,D,FLA,28,11,1,0,1
44,8480267,Sammy Walker,C,MIN,25,17,1,0,1
44,8483471,Brad Lambert,C,WPG,31,11,1,0,1
44,8480874,Adam Ginning,D,PHI,24,12,1,0,1
44,8477149,Scott Sabourin,R,SJS,32,16,1,0,1
44,8475755,Alexander Petrovic,D,DAL,32,6,1,0,1
44,8482102,Vasily Ponomarev,C,PIT,22,20,1,0,1
44,8480851,Akil Thomas,C,LAK,24,14,1,0,1
44,8478854,Ryan Shea,D,PIT,27,7,1,0,1
44,8475780,Chris Wagner,R,COL,33,12,1,0,1
44,8481726,Adam Edstrom,C,NYR,24,5,1,0,1
44,8475958,Michael Sgarbossa,C,WSH,32,29,0,1,1
44,8477971,Andreas Englund,D,LAK,28,22,0,1,1
44,8478502,Dennis Gilbert,D,BUF,28,18,0,1,1
44,8483763,Maksymilian Szuber,D,UTA,22,29,0,1,1
44,8482177,Marat Khusnutdinov,C,MIN,22,28,0,1,1
44,8482470,Ilya Solovyov,D,CGY,24,24,0,1,1
44,8482088,Justin Sourdif,R,FLA,22,16,0,1,1
44,8481743,Marc Del Gaizo,D,NSH,25,25,0,1,1
44,8484325,Waltteri Merela,C,TBL,26,26,0,1,1
44,8477541,Dakota Mermis,D,TOR,30,10,0,1,1
44,8482061,Brandon Biro,L,SEA,26,11,0,1,1
44,8481719,Maxwell Crozier,D,TBL,24,20,0,1,1
44,8478881,Brett Seney,L,CHI,28,15,0,1,1
44,8483597,Milos Kelemen,L,UTA,25,15,0,1,1
44,8482460,Matt Rempe,C,NYR,22,14,0,1,1
44,8484321,Nikolas Matinpalo,D,OTT,26,3,0,1,1
44,8483398,Declan Carlile,D,TBL,31,4,0,1,1
44,8480823,Alexander Alexeyev,D,WSH,25,11,0,0,0
44,8481578,Graeme Clarke,R,MIN,23,10,0,0,0
44,8481541,Samuel Bolduc,D,NYI,24,20,0,0,0
44,8482197,Adam Raska,R,MIN,23,10,0,0,0
44,8481065,Angus Crookshank,L,OTT,25,13,0,0,0
44,8483546,Marshall Rifai,D,TOR,26,3,0,0,0
44,8483432,Luca Del Bel Belluz,C,CBJ,31,8,0,0,0
44,8481806,Louis Crevier,D,CHI,23,6,0,0,0
44,8482476,Emil Heineman,L,MTL,23,1,0,0,0
44,8480306,Grant Hutton,D,NYI,29,0,0,0,0
44,8482126,Emil Andrae,D,PHI,31,2,0,0,0
44,8477073,Kurtis MacDermid,L,NJD,30,31,0,0,0
44,8483920,Pierrick Dube,R,WSH,23,1,0,0,0
44,8479330,Brandon Gignac,C,MTL,27,7,0,0,0
44,8478446,Glenn Gawdin,C,LAK,27,11,0,0,0
44,8481030,Jack St. Ivany,D,PIT,25,15,0,0,0
44,8481462,Mason Morelli,L,VGK,28,12,0,0,0
44,8481024,Linus Karlsson,C,VAN,25,10,0,0,0
44,8476323,Max McCormick,L,SEA,32,2,0,0,0
44,8479421,Jacob Moverare,D,LAK,26,9,0,0,0
44,8484255,Jason Polin,R,COL,25,9,0,0,0
44,8483407,Brandon Scanlin,D,NYR,25,4,0,0,0
44,8484326,Patrik Koch,D,UTA,28,2,0,0,0
44,8479522,Hardy Haman Aktell,D,WSH,26,0,0,0,0
44,8483531,Brian Halonen,L,NJD,25,1,0,0,0
44,8481655,Cole Schwindt,R,CGY,23,4,0,0,0
44,8478147,Bokondji Imama,L,PIT,28,7,0,0,0
44,8481534,Raphael Lavoie,C,EDM,24,2,0,0,0
44,8483609,Adam Klapka,R,CGY,24,3,0,0,0
44,8484259,Ondrej Pavel,C,COL,31,2,0,0,0
44,8480274,Philip Kemp,D,EDM,25,1,0,0,0
44,8483401,Marc Johnstone,R,PIT,28,2,0,0,0
44,8470794,Joe Pavelski,C,,40,0,0,0,0
44,8479321,Lucas Johansen,D,,27,0,0,0,0
44,8477950,Tony DeAngelo,D,,29,0,0,0,0
44,8471218,Blake Wheeler,R,,38,0,0,0,0
44,8475197,Tyson Barrie,D,,33,0,0,0,0
44,8474157,Max Pacioretty,L,,36,0,0,0,0
44,8475744,Evgeny Kuznetsov,C,,32,0,0,0,0
44,8474037,James van Riemsdyk,L,,35,0,0,0,0
44,8476907,Mackenzie MacEachern,L,,30,0,0,0,0
44,8480216,Jacob Peterson,C,,25,0,0,0,0
44,8474602,Justin Schultz,D,,34,0,0,0,0
44,8482222,Alexander Barabanov,L,,30,0,0,0,0
44,8474031,Kevin Shattenkirk,D,,35,0,0,0,0
44,8477330,Dominik Kubalik,L,,29,0,0,0,0
44,8480884,Calen Addison,D,,24,0,0,0,0
44,8475906,John Klingberg,D,,32,0,0,0,0
44,8480008,Adam Ruzicka,C,,25,0,0,0,0
44,8476884,Derrick Pouliot,D,,30,0,0,0,0
44,8476919,Chris Tierney,C,,30,0,0,0,0
44,8479415,Michael McLeod,C,,26,0,0,0,0
44,8474870,Tyler Johnson,C,,34,0,0,0,0
44,8470604,Jeff Carter,C,,39,0,0,0,0
44,8478104,Sammy Blais,L,,28,0,0,0,0
44,8474884,Mike Hoffman,C,,35,0,0,0,0
44,8481591,Sam Poulin,R,,23,0,0,0,0
44,8471274,Alex Goligoski,D,,39,0,0,0,0
44,8476871,Tanner Pearson,L,,32,0,0,0,0
44,8476393,Nick Cousins,C,,31,0,0,0,0
44,8479977,Kailer Yamamoto,R,,26,0,0,0,0
44,8479346,Dillon Dube,C,,26,0,0,0,0
44,8480184,Gustav Lindstrom,D,,26,0,0,0,0
44,8479376,Victor Mete,D,,26,0,0,0,0
44,8473449,Kyle Okposo,R,,36,0,0,0,0
44,8481058,Jesse Ylonen,R,,25,0,0,0,0
44,8475752,Tyler Pitlick,C,,33,0,0,0,0
44,8481239,Samuel Fagemo,L,,24,0,0,0,0
44,8480821,Filip Zadina,R,,25,0,0,0,0
44,8470966,Mark Giordano,D,,41,0,0,0,0
44,8478495,Denis Gurianov,R,,27,0,0,0,0
44,8477464,Nic Petan,C,,29,0,0,0,0
44,8478099,Kevin Labanc,R,,29,0,0,0,0
44,8482241,Radim Zohorna,L,,28,0,0,0,0
44,8474040,Sam Gagner,C,,35,0,0,0,0
44,8479514,Rem Pitlick,C,,27,0,0,0,0
44,8478430,Oliver Kylington,D,,27,0,0,0,0
44,8479533,Joona Koppanen,L,,26,0,0,0,0
44,8479984,Cal Foote,D,,26,0,0,0,0
44,8477126,Jayson Megna,C,,34,0,0,0,0
44,8475164,Jakob Silfverberg,R,,34,0,0,0,0
44,8474009,Nick Bonino,C,,36,0,0,0,0
44,8479458,Nikita Zaitsev,D,,33,0,0,0,0
44,8477944,Jakub Vrana,L,,28,0,0,0,0
44,8471699,Andrew Cogliano,C,,37,0,0,0,0
44,8478067,Oskar Lindblom,L,,28,0,0,0,0
44,8471686,Marc Staal,D,,37,0,0,0,0
44,8470610,Zach Parise,L,,40,0,0,0,0
44,8478904,Steven Lorentz,C,,28,0,0,0,0
44,8473473,Milan Lucic,L,,36,0,0,0,0
44,8480031,Maxime Comtois,L,,25,0,0,0,0
44,8478512,Austin Czarnik,C,,32,0,0,0,0
44,8473504,Cal Clutterbuck,R,,37,0,0,0,0
44,8477454,Adam Erne,L,,29,0,0,0,0
44,8479383,Boris Katchouk,L,,26,0,0,0,0
44,8475825,Jani Hakanpää,D,,32,0,0,0,0
44,8477846,Ryan Carpenter,C,,33,0,0,0,0
44,8477930,Pierre-Edouard Bellemare,L,,39,0,0,0,0
44,8478400,Colin White,C,,27,0,0,0,0
44,8480226,Marián Studenic,R,,26,0,0,0,0
44,8480853,Liam Foudy,C,,24,0,0,0,0
44,8475797,Jarred Tinordi,D,,32,0,0,0,0
44,8479423,Alex Nylander,L,,26,0,0,0,0
44,8474618,Marco Scandella,D,,34,0,0,0,0
44,8478028,Fredrik Olofsson,L,,28,0,0,0,0
44,8474709,Matt Martin,L,,35,0,0,0,0
44,8481070,Hugh McGing,L,,26,0,0,0,0
44,8479546,Oskar Steen,C,,26,0,0,0,0
44,8474145,Robert Bortuzzo,D,,35,0,0,0,0
44,8476915,Jujhar Khaira,L,,30,0,0,0,0
44,8475278,Byron Froese,C,,33,0,0,0,0
44,8481812,Nikolai Knyzhov,D,,27,0,0,0,0
44,8478408,Travis Dermott,D,,28,0,0,0,0
44,8481077,John Leonard,L,,26,0,0,0,0
44,8479547,Matthew Phillips,R,,26,0,0,0,0
44,8480836,Jonathan Gruden,C,,24,0,0,0,0
44,8481690,Tyler Angle,C,,24,0,0,0,0
44,8475766,Austin Watson,L,,32,0,0,0,0
44,8481016,Ruslan Iskhakov,C,,24,0,0,0,0
44,8478078,Rourke Chartier,C,,28,0,0,0,0
44,8480776,Sheldon Rempal,R,,29,0,0,0,0
44,8478956,Samuel Laberge,L,NJD,27,4,0,0,0
44,8483045,Cameron Butler,R,CBJ,31,0,0,0,0
44,8484314,Jiri Smejkal,L,,28,0,0,0,0
45,8478402,Connor McDavid,C,EDM,27,77,40,111,151
45,8481559,Jack Hughes,C,NJD,23,78,52,84,136
45,8479318,Auston Matthews,C,TOR,27,78,64,59,123
45,8477934,Leon Draisaitl,C,EDM,29,80,45,77,122
45,8477492,Nathan MacKinnon,C,COL,29,81,53,68,121
45,8477956,David Pastrnak,R,BOS,28,82,55,64,119
45,8478420,Mikko Rantanen,R,COL,28,82,55,62,117
45,8477939,William Nylander,R,TOR,28,80,54,58,112
45,8476453,Nikita Kucherov,R,TBL,31,82,40,72,112
45,8479314,Matthew Tkachuk,L,FLA,27,80,36,75,111
45,8478483,Mitch Marner,R,TOR,27,80,28,78,106
45,8478550,Artemi Panarin,L,NYR,33,73,28,76,104
45,8477942,Kevin Fiala,L,LAK,28,78,31,70,101
45,8477493,Aleksander Barkov,C,FLA,29,76,27,74,101
45,8480801,Brady Tkachuk,L,OTT,25,80,41,58,99
45,8477946,Dylan Larkin,C,DET,28,79,43,54,97
45,8479343,Clayton Keller,R,UTA,26,78,36,61,97
45,8476887,Filip Forsberg,L,NSH,30,70,40,56,96
45,8477404,Jake Guentzel,C,TBL,30,82,37,58,95
45,8477933,Sam Reinhart,C,FLA,29,82,44,50,94
45,8477501,Valeri Nichushkin,R,COL,29,81,48,45,93
45,8479407,Jesper Bratt,L,NJD,26,76,31,61,92
45,8478864,Kirill Kaprizov,L,MIN,27,74,43,47,90
45,8478445,Mathew Barzal,C,NYI,27,80,18,69,87
45,8484144,Connor Bedard,C,CHI,19,68,33,53,86
45,8476468,J.T. Miller,C,VAN,31,76,38,46,84
45,8476459,Mika Zibanejad,C,NYR,31,73,23,61,84
45,8480069,Cale Makar,D,COL,26,63,18,65,83
45,8471675,Sidney Crosby,C,PIT,37,73,30,52,82
45,8473419,Brad Marchand,L,BOS,36,78,29,53,82
45,8478403,Jack Eichel,C,VGK,28,76,37,44,81
45,8478427,Sebastian Aho,C,CAR,27,74,36,45,81
45,8479337,Alex DeBrincat,R,DET,27,82,32,49,81
45,8480036,Miro Heiskanen,D,DAL,25,77,17,63,80
45,8477960,Adrian Kempe,R,LAK,28,80,37,42,79
45,8475166,John Tavares,C,TOR,34,81,29,50,79
45,8475172,Nazem Kadri,C,CGY,34,78,29,50,79
45,8476456,Jonathan Huberdeau,C,CGY,31,79,19,60,79
45,8474600,Roman Josi,D,NSH,34,74,14,65,79
45,8478010,Brayden Point,C,TBL,28,82,40,38,78
45,8477409,Carter Verhaeghe,C,FLA,29,80,31,47,78
45,8480023,Robert Thomas,C,STL,25,75,28,50,78
45,8479323,Adam Fox,D,NYR,26,75,16,62,78
45,8480012,Elias Pettersson,C,VAN,26,70,31,46,77
45,8480027,Jason Robertson,L,DAL,25,82,25,52,77
45,8475754,Brock Nelson,C,NYI,33,77,37,39,76
45,8482116,Tim Stützle,C,OTT,22,79,34,42,76
45,8476460,Mark Scheifele,C,WPG,31,76,33,43,76
45,8478401,Pavel Zacha,C,BOS,27,82,32,44,76
45,8482078,Lucas Raymond,L,DET,22,80,31,45,76
45,8477496,Elias Lindholm,C,BOS,30,80,25,50,75
45,8477951,Nick Schmaltz,C,UTA,28,77,31,43,74
45,8480830,Andrei Svechnikov,R,CAR,24,71,34,38,72
45,8478439,Travis Konecny,R,PHI,27,77,32,40,72
45,8479420,Tage Thompson,C,BUF,27,71,32,40,72
45,8478873,Troy Terry,R,ANA,27,79,28,44,72
45,8471215,Evgeni Malkin,C,PIT,38,74,26,46,72
45,8474578,Erik Karlsson,D,PIT,34,81,19,53,72
45,8476346,Johnny Gaudreau,L,CBJ,31,71,17,55,72
45,8481540,Cole Caufield,R,MTL,23,73,44,27,71
45,8475765,Vladimir Tarasenko,R,DET,33,79,27,44,71
45,8482684,Luke Hughes,D,NJD,21,72,11,60,71
45,8478398,Kyle Connor,L,WPG,28,65,36,34,70
45,8474564,Steven Stamkos,C,NSH,34,70,31,39,70
45,8476389,Vincent Trocheck,C,NYR,31,78,30,40,70
45,8475158,Ryan O'Reilly,C,NSH,33,72,23,47,70
45,8475810,Bryan Rust,R,PIT,32,71,35,34,69
45,8476399,Blake Coleman,C,CGY,33,80,33,35,68
45,8471214,Alex Ovechkin,L,WSH,39,78,30,38,68
45,8478444,Brock Boeser,R,VAN,27,78,23,45,68
45,8476905,Chandler Stephenson,C,SEA,30,75,20,48,68
45,8480002,Nico Hischier,C,NJD,25,75,34,33,67
45,8474141,Patrick Kane,R,DET,36,78,23,44,67
45,8475913,Mark Stone,R,VGK,32,79,17,50,67
45,8480803,Evan Bouchard,D,EDM,25,77,15,52,67
45,8475167,Victor Hedman,D,TBL,34,76,11,56,67
45,8478407,Vince Dunn,D,SEA,28,71,11,56,67
45,8475184,Chris Kreider,L,NYR,33,75,44,22,66
45,8482093,Seth Jarvis,C,CAR,22,70,33,33,66
45,8478449,Roope Hintz,C,DAL,28,81,30,36,66
45,8477500,Bo Horvat,C,NYI,29,82,30,36,66
45,8477935,Sam Bennett,C,FLA,28,81,30,35,65
45,8478047,Michael Bunting,L,PIT,29,71,27,38,65
45,8475784,Jeff Skinner,C,EDM,32,81,27,38,65
45,8478440,Dylan Strome,C,WSH,27,75,26,39,65
45,8479999,Casey Mittelstadt,C,COL,26,82,20,45,65
45,8475786,Zach Hyman,L,EDM,32,78,36,28,64
45,8479385,Jordan Kyrou,C,STL,26,73,32,32,64
45,8476881,Tomas Hertl,C,VGK,31,75,32,32,64
45,8478414,Timo Meier,R,NJD,28,75,31,33,64
45,8479525,Ross Colton,C,COL,28,80,30,34,64
45,8477402,Pavel Buchnevich,L,STL,29,74,24,40,64
45,8475798,Mikael Granlund,C,SJS,32,69,17,47,64
45,8477504,Josh Morrissey,D,WPG,29,74,15,49,64
45,8476539,Jonathan Marchessault,R,NSH,34,72,40,23,63
45,8478493,Joel Eriksson Ek,C,MIN,27,71,30,33,63
45,8481557,Matt Boldy,L,MIN,23,66,36,26,62
45,8473986,Alex Killorn,L,ANA,35,76,30,32,62
45,8480208,Drake Batherson,R,OTT,26,75,23,39,62
45,8480018,Nick Suzuki,C,MTL,25,72,19,43,62
45,8474102,David Perron,L,OTT,36,79,19,43,62
45,8476875,Mike Matheson,D,MTL,30,73,13,49,62
45,8480865,Noah Dobson,D,NYI,24,78,11,51,62
45,8477416,Oliver Bjorkstrand,R,SEA,29,69,24,37,61
45,8476448,William Karlsson,C,VGK,31,76,21,40,61
45,8476454,Ryan Nugent-Hopkins,C,EDM,31,75,17,44,61
45,8483515,Juraj Slafkovsky,L,MTL,20,74,16,45,61
45,8477949,Alex Tuch,R,BUF,28,70,22,38,60
45,8480039,Martin Necas,C,CAR,25,71,20,40,60
45,8471685,Anze Kopitar,C,LAK,37,78,18,42,60
45,8480839,Rasmus Dahlin,D,BUF,24,73,13,47,60
45,8479675,Trevor Moore,L,LAK,29,78,33,26,59
45,8477955,Jared McCann,L,SEA,28,75,26,33,59
45,8477940,Nikolaj Ehlers,L,WPG,28,70,21,38,59
45,8481528,Dylan Cozens,C,BUF,23,77,19,40,59
45,8475692,Mats Zuccarello,R,MIN,37,71,10,49,59
45,8479542,Brandon Hagel,L,TBL,26,82,31,27,58
45,8474150,Mikael Backlund,C,CGY,35,79,23,35,58
45,8475745,Charlie Coyle,C,BOS,32,77,28,29,57
45,8475168,Matt Duchene,C,DAL,33,81,21,36,57
45,8477986,Brandon Montour,D,SEA,30,72,21,36,57
45,8478460,Zach Werenski,D,CBJ,27,81,16,41,57
45,8482740,Wyatt Johnston,C,DAL,21,81,37,19,56
45,8476483,Rickard Rakell,R,PIT,31,73,25,31,56
45,8480113,Alex Iafallo,L,WPG,31,72,24,32,56
45,8475191,Reilly Smith,R,NYR,33,75,21,35,56
45,8477503,Max Domi,C,TOR,29,79,20,36,56
45,8480800,Quinn Hughes,D,VAN,25,75,8,48,56
45,8479325,Charlie McAvoy,D,BOS,27,75,7,49,56
45,8480064,Josh Norris,C,OTT,25,76,34,21,55
45,8480015,Owen Tippett,R,PHI,25,78,25,30,55
45,8475170,Brayden Schenn,C,STL,33,75,21,34,55
45,8478462,Nicolas Roy,C,VGK,27,77,20,35,55
45,8473512,Claude Giroux,R,OTT,36,77,19,36,55
45,8478975,Mason Marchment,L,DAL,29,81,14,41,55
45,8475768,Jaden Schwartz,C,SEA,32,69,23,31,54
45,8477426,Nicholas Paul,L,TBL,29,82,29,24,53
45,8477476,Artturi Lehkonen,L,COL,29,80,27,26,53
45,8481596,Shane Pinto,C,OTT,24,78,21,32,53
45,8481711,Matias Maccelli,L,UTA,24,74,21,32,53
45,8482745,Mason McTavish,C,ANA,21,70,18,35,53
45,8478856,Conor Garland,R,VAN,28,69,25,27,52
45,8482159,Tyson Foerster,R,PHI,22,75,23,29,52
45,8473994,Jamie Benn,L,DAL,35,82,21,31,52
45,8475169,Evander Kane,L,EDM,33,78,30,21,51
45,8482109,Alexis Lafrenière,L,NYR,23,73,28,23,51
45,8476880,Tom Wilson,R,WSH,30,74,27,24,51
45,8475793,Ryan Johansen,C,PHI,32,76,26,25,51
45,8481533,Trevor Zegras,C,ANA,23,67,21,30,51
45,8476479,Phillip Danault,C,LAK,31,80,16,35,51
45,8471724,Kris Letang,D,PIT,37,79,14,37,51
45,8478038,Devon Toews,D,COL,30,67,7,44,51
45,8482699,Dylan Guenther,R,UTA,21,77,21,29,50
45,8482665,Matty Beniers,C,SEA,22,69,19,31,50
45,8476462,Dougie Hamilton,D,NJD,31,75,17,33,50
45,8479410,Mikhail Sergachev,D,UTA,26,72,12,38,50
45,8477497,Sean Monahan,C,CBJ,30,66,24,25,49
45,8478233,Andrew Mangiapane,L,WSH,28,72,22,27,49
45,8474586,Jordan Eberle,R,SEA,34,75,22,27,49
45,8474679,Gustav Nyquist,C,NSH,35,72,19,30,49
45,8477407,Anthony Duclair,L,NYI,29,78,16,33,49
45,8470613,Brent Burns,D,CAR,39,74,9,40,49
45,8475753,Justin Faulk,D,STL,32,75,8,41,49
45,8480014,Gabriel Vilardi,C,WPG,25,66,27,21,48
45,8476432,Boone Jenner,C,CBJ,31,74,24,24,48
45,8481068,Yegor Sharangovich,C,CGY,26,76,24,24,48
45,8478115,Pierre Engvall,L,NYI,28,79,20,28,48
45,8482092,Ridly Greig,C,OTT,22,79,17,31,48
45,8476882,Teuvo Teravainen,C,CHI,30,65,14,34,48
45,8481577,Philip Tomasino,C,NSH,23,72,12,36,48
45,8478397,Rasmus Andersson,D,CGY,28,75,11,37,48
45,8474590,John Carlson,D,WSH,34,65,7,41,48
45,8478469,Thomas Chabot,D,OTT,27,74,6,42,48
45,8475794,Tyler Seguin,C,DAL,32,81,24,23,47
45,8478498,Jake DeBrusk,L,VAN,28,71,23,24,47
45,8477456,J.T. Compher,L,DET,29,78,19,28,47
45,8474563,Drew Doughty,D,LAK,35,76,11,36,47
45,8484166,Adam Fantilli,C,CBJ,20,68,26,20,46
45,8482113,Anton Lundell,C,FLA,23,73,23,23,46
45,8482667,William Eklund,L,SJS,22,72,17,29,46
45,8480798,Philipp Kurashev,C,CHI,25,69,15,31,46
45,8476958,Jaccob Slavin,D,CAR,30,76,9,37,46
45,8478042,Viktor Arvidsson,L,EDM,31,72,25,20,45
45,8481604,Pavel Dorofeyev,L,VGK,24,70,24,21,45
45,8477998,Warren Foegele,L,LAK,28,80,24,21,45
45,8474641,Adam Henrique,C,EDM,34,74,23,22,45
45,8483431,Logan Cooley,C,UTA,20,75,20,25,45
45,8480028,Morgan Frost,C,PHI,25,79,8,37,45
45,8475726,Tyler Toffoli,C,SJS,32,76,24,20,44
45,8478519,Anthony Cirelli,C,TBL,27,82,20,24,44
45,8477021,Alex Kerfoot,C,UTA,30,73,19,25,44
45,8481560,Arthur Kaliyev,R,LAK,23,76,18,26,44
45,8478542,Evan Rodrigues,C,FLA,31,77,17,27,44
45,8477494,Jonathan Drouin,L,COL,29,81,12,32,44
45,8481581,Thomas Harley,D,DAL,23,77,12,32,44
45,8476792,Torey Krug,D,STL,33,77,7,37,44
45,8476853,Morgan Rielly,D,TOR,30,66,7,37,44
45,8477447,Shea Theodore,D,VGK,29,67,4,40,44
45,8478366,Frank Vatrano,R,ANA,30,70,26,17,43
45,8478474,Lawson Crouse,L,UTA,27,75,24,19,43
45,8479400,Pierre-Luc Dubois,L,WSH,26,72,23,20,43
45,8476458,Ryan Strome,C,ANA,31,71,16,27,43
45,8475287,Erik Haula,L,NJD,33,70,15,28,43
45,8479987,Morgan Geekie,C,BOS,26,81,13,30,43
45,8476906,Shayne Gostisbehere,D,CAR,31,73,9,34,43
45,8481542,Moritz Seider,D,DET,23,75,8,35,43
45,8477479,Tyler Bertuzzi,L,CHI,29,65,17,25,42
45,8480336,Sean Walker,D,CAR,30,76,14,28,42
45,8476872,Scott Laughton,C,PHI,30,67,13,29,42
45,8480817,K'Andre Miller,D,NYR,24,73,13,29,42
45,8479339,Patrik Laine,L,CBJ,26,59,11,31,42
45,8478458,John (Jack) Roslovic,C,CAR,27,71,10,32,42
45,8482124,Quinton Byfield,R,LAK,22,80,9,33,42
45,8477952,Robby Fabbri,C,ANA,28,66,14,27,41
45,8476869,Brady Skjei,D,NSH,30,71,13,28,41
45,8478396,Noah Hanifin,D,VGK,27,56,12,29,41
45,8477451,Ryan Hartman,R,MIN,30,65,19,21,40
45,8473533,Jordan Staal,C,CAR,36,62,19,21,40
45,8475151,Kyle Palmieri,C,NYI,33,79,18,22,40
45,8476474,Stefan Noesen,R,NJD,31,69,18,22,40
45,8482702,Logan Stankoven,C,DAL,21,80,15,25,40
45,8483490,Pavel Mintyukov,D,ANA,21,73,5,35,40
45,8482705,Cole Sillinger,C,CBJ,21,70,22,17,39
45,8480068,Ryan Poehling,C,PHI,25,68,20,19,39
45,8478438,Tommy Novak,C,NSH,27,72,17,22,39
45,8475799,Nino Niederreiter,R,WPG,32,64,17,22,39
45,8477964,Ivan Barbashev,C,VGK,29,78,15,24,39
45,8478472,Mathieu Joseph,R,STL,27,69,13,26,39
45,8480849,Barrett Hayton,C,UTA,24,70,11,28,39
45,8478109,Victor Olofsson,L,VGK,29,68,24,14,38
45,8477511,Anthony Mantha,R,CGY,30,76,21,17,38
45,8482089,Jake Neighbours,L,STL,22,71,21,17,38
45,8480009,Eeli Tolvanen,R,SEA,25,63,20,18,38
45,8475760,Nick Bjugstad,C,UTA,32,75,20,18,38
45,8482149,Cole Perfetti,C,WPG,22,69,17,21,38
45,8471698,T.J. Oshie,R,WSH,38,64,17,21,38
45,8482105,Jake Sanderson,D,OTT,22,75,16,22,38
45,8477932,Aaron Ekblad,D,FLA,28,72,13,25,38
45,8481524,Bowen Byram,D,BUF,23,63,11,27,38
45,8475218,Mattias Ekholm,D,EDM,34,73,9,29,38
45,8480188,Fabian Zetterlund,L,SJS,25,70,20,17,37
45,8482146,Luke Evangelista,R,NSH,22,69,19,18,37
45,8480185,Eetu Luostarinen,C,FLA,26,80,18,19,37
45,8477444,Andre Burakovsky,L,SEA,29,71,15,22,37
45,8474149,Evgenii Dadonov,R,DAL,35,80,15,22,37
45,8474053,Logan Couture,C,SJS,35,65,13,24,37
45,8477498,Darnell Nurse,D,EDM,29,72,9,28,37
45,8479591,Michael Eyssimont,C,TBL,28,81,9,28,37
45,8476438,Brandon Saad,L,STL,32,78,21,15,36
45,8482055,Drew O'Connor,L,PIT,26,63,20,16,36
45,8484153,Leo Carlsson,C,ANA,20,72,15,21,36
45,8477429,Andrew Copp,C,DET,30,80,15,21,36
45,8481523,Kirby Dach,C,MTL,23,73,14,22,36
45,8480220,Noah Cates,L,PHI,25,70,14,22,36
45,8484145,Zach Benson,L,BUF,19,69,13,23,36
45,8482720,Matthew Knies,L,TOR,22,77,13,23,36
45,8478133,Jake Evans,C,MTL,28,69,5,31,36
45,8479425,Filip Hronek,D,VAN,27,74,4,32,36
45,8478466,Daniel Sprong,R,VAN,27,68,17,18,35
45,8482110,Dawson Mercer,C,NJD,23,71,17,18,35
45,8479992,Michael Rasmussen,C,DET,25,80,16,19,35
45,8480459,Pius Suter,C,VAN,28,73,16,19,35
45,8475763,Kevin Hayes,R,PIT,32,77,15,20,35
45,8477953,Kasperi Kapanen,R,STL,28,67,13,22,35
45,8477495,Seth Jones,D,CHI,30,68,10,25,35
45,8480145,Neal Pionk,D,WPG,29,74,9,26,35
45,8479351,Sam Steel,C,DAL,26,80,9,26,35
45,8482712,Oskar Olausson,R,COL,22,78,8,27,35
45,8476854,Hampus Lindholm,D,BOS,30,75,4,31,35
45,8481618,Alex Newhook,C,MTL,23,67,16,18,34
45,8483808,Andrei Kuzmenko,L,CGY,28,74,16,18,34
45,8478046,Danton Heinen,L,VAN,29,63,15,19,34
45,8480078,Filip Chytil,C,NYR,25,70,14,20,34
45,8481554,Kaapo Kakko,R,NYR,23,68,13,21,34
45,8482671,Owen Power,D,BUF,22,67,12,22,34
45,8480797,Joel Farabee,L,PHI,24,73,11,23,34
45,8475791,Taylor Hall,L,CHI,33,52,11,23,34
45,8483505,Matthew Poitras,C,BOS,20,73,10,24,34
45,8476923,Damon Severson,D,CBJ,30,79,6,28,34
45,8483491,Ivan Miroshnichenko,L,WSH,20,58,16,17,33
45,8473422,Nick Foligno,L,CHI,37,60,15,18,33
45,8481582,Nicholas Robertson,L,TOR,23,71,13,20,33
45,8480829,Jesperi Kotkaniemi,C,CAR,24,62,12,21,33
45,8481656,Aliaksei Protas,C,WSH,23,61,10,23,33
45,8476419,Jean-Gabriel Pageau,C,NYI,32,77,8,25,33
45,8474565,Alex Pietrangelo,D,VGK,34,61,8,25,33
45,8475200,Dmitry Orlov,D,CAR,33,74,4,29,33
45,8479365,Trent Frederic,C,BOS,26,72,18,14,32
45,8481093,Rafael Harvey-Pinard,L,MTL,25,62,18,14,32
45,8475722,Jason Zucker,L,BUF,32,64,16,16,32
45,8477989,Christian Dvorak,C,MTL,28,69,12,20,32
45,8476826,Yanni Gourde,C,SEA,33,66,10,22,32
45,8477948,Travis Sanheim,D,PHI,28,66,8,24,32
45,8479345,Jakob Chychrun,D,WSH,26,62,8,24,32
45,8478055,Gustav Forsling,D,FLA,28,71,8,24,32
45,8477346,MacKenzie Weegar,D,CGY,30,71,5,27,32
45,8483524,Shane Wright,C,SEA,20,69,20,11,31
45,8482175,JJ Peterka,R,BUF,22,66,17,14,31
45,8482097,Jack Quinn,R,BUF,23,61,12,19,31
45,8479402,Jake Bean,D,CGY,26,70,10,21,31
45,8477505,Alexander Wennberg,C,SJS,30,66,10,21,31
45,8480871,Adam Boqvist,D,FLA,24,72,9,22,31
45,8478463,Anthony Beauvillier,L,PIT,27,66,9,22,31
45,8476422,Mike Reilly,D,NYI,31,75,8,23,31
45,8480873,Rasmus Sandin,D,WSH,24,69,3,28,31
45,8474189,Lars Eller,C,PIT,35,66,15,15,30
45,8481601,Simon Holmstrom,R,NYI,23,66,14,16,30
45,8475220,Marcus Foligno,L,MIN,33,69,13,17,30
45,8482101,Danil Gushchin,L,SJS,22,56,13,17,30
45,8483468,Jiri Kulich,C,BUF,20,68,11,19,30
45,8475848,Brendan Gallagher,R,MTL,32,66,10,20,30
45,8479353,Brett Howden,C,VGK,26,69,10,20,30
45,8484203,Bradly Nadeau,L,CAR,19,60,10,20,30
45,8476461,Sean Couturier,C,PHI,32,61,9,21,30
45,8481703,Valtteri Puustinen,R,PIT,25,67,7,23,30
45,8477839,Conor Sheary,L,TBL,32,81,6,24,30
45,8482122,Brock Faber,D,MIN,22,78,3,27,30
45,8477478,William Carrier,L,CAR,30,60,16,13,29
45,8481535,Nils Hoglander,L,VAN,24,73,13,16,29
45,8475855,Jesper Fast,R,CAR,33,63,13,16,29
45,8475714,Calle Jarnkrok,C,TOR,33,74,11,18,29
45,8476469,Joel Armia,R,MTL,31,66,10,19,29
45,8476463,Jonas Brodin,D,MIN,31,77,7,22,29
45,8481546,Cam York,D,PHI,23,66,6,23,29
45,8474715,Cameron Atkinson,R,TBL,35,82,17,11,28
45,8480835,Jack Drury,C,CAR,24,63,15,13,28
45,8479393,Noah Gregor,L,OTT,26,72,15,13,28
45,8479293,Brandon Tanev,L,SEA,33,64,15,13,28
45,8482624,Daniil Miromanov,D,CGY,27,70,13,15,28
45,8482157,Will Cuylle,L,NYR,22,66,13,15,28
45,8482133,Thomas Bordeleau,C,SJS,22,70,11,17,28
45,8480813,Joe Veleno,C,DET,24,77,11,17,28
45,8477450,Jason Dickinson,C,CHI,29,62,11,17,28
45,8482111,Justin Barron,D,MTL,23,65,10,18,28
45,8475171,Oliver Ekman-Larsson,D,TOR,33,65,10,18,28
45,8476292,Ondrej Palat,L,NJD,33,70,9,19,28
45,8476925,Colton Sissons,C,NSH,31,60,8,20,28
45,8476979,Erik Gustafsson,D,DET,32,74,7,21,28
45,8478882,Vladislav Gavrikov,D,LAK,29,70,6,22,28
45,8474673,TJ Brodie,D,CHI,34,66,2,26,28
45,8475314,Anders Lee,L,NYI,34,80,20,7,27
45,8476981,Josh Anderson,R,MTL,30,67,19,8,27
45,8476960,Andreas Athanasiou,C,CHI,30,59,16,11,27
45,8477425,Miles Wood,L,COL,29,75,15,12,27
45,8470621,Corey Perry,R,EDM,39,73,14,13,27
45,8479996,Cody Glass,C,NSH,25,61,13,14,27
45,8481553,Bobby Brink,R,PHI,23,65,13,14,27
45,8480448,Parker Kelly,L,COL,25,78,12,15,27
45,8482475,Yegor Chinakhov,R,CBJ,23,70,12,15,27
45,8478013,Jake Walman,D,SJS,28,67,11,16,27
45,8483445,Cutter Gauthier,L,ANA,20,70,10,17,27
45,8477987,Ryan Donato,C,CHI,28,54,9,18,27
45,8481186,Logan O'Connor,R,COL,28,82,7,20,27
45,8478891,Mason Appleton,C,WPG,28,67,7,20,27
45,8477018,Ben Hutton,D,VGK,31,52,7,20,27
45,8478851,Alexandre Carrier,D,NSH,28,64,4,23,27
45,8476278,Colin Blackwell,C,DAL,31,79,19,7,26
45,8482809,Jackson Blake,R,CAR,21,56,15,11,26
45,8477406,Mattias Janmark,C,EDM,32,68,13,13,26
45,8478413,Jordan Greenway,L,BUF,27,67,12,14,26
45,8475193,Tomas Tatar,L,NJD,34,68,12,14,26
45,8477903,Garnet Hathaway,R,PHI,33,67,11,15,26
45,8478569,Noel Acciari,C,PIT,33,59,10,16,26
45,8477488,Brett Pesce,D,NJD,30,68,6,20,26
45,8479324,Ryan Lindgren,D,NYR,26,67,4,22,26
45,8480434,Sean Durzi,D,UTA,26,69,3,23,26
45,8475764,Cam Fowler,D,ANA,33,72,2,24,26
45,8476879,Cody Ceci,D,EDM,31,72,1,25,26
45,8480802,Ryan McLeod,C,BUF,25,62,15,10,25
45,8476918,Jimmy Vesey,L,NYR,31,67,15,10,25
45,8480893,Kirill Marchenko,R,CBJ,24,64,15,10,25
45,8478432,Christian Fischer,R,DET,27,71,11,14,25
45,8478043,Sam Lafferty,C,BUF,29,64,11,14,25
45,8475149,Marcus Johansson,L,MIN,34,66,9,16,25
45,8477353,Tyler Motte,C,DET,29,73,9,16,25
45,8477508,Curtis Lazar,C,NJD,29,56,9,16,25
45,8482749,Joshua Roy,R,MTL,21,65,8,17,25
45,8473563,Nicklas Backstrom,C,WSH,37,58,7,18,25
45,8482660,Kent Johnson,C,CBJ,22,62,7,18,25
45,8473507,Jeff Petry,D,DET,37,75,6,19,25
45,8477220,Nate Schmidt,D,FLA,33,68,6,19,25
45,8477969,Marcus Pettersson,D,PIT,28,78,5,20,25
45,8477435,Ryan Graves,D,PIT,29,77,5,20,25
45,8474716,Jared Spurgeon,D,MIN,35,76,4,21,25
45,8479398,Samuel Girard,D,COL,26,69,3,22,25
45,8476892,Colton Parayko,D,STL,31,76,2,23,25
45,8476902,Esa Lindell,D,DAL,30,74,2,23,25
45,8478500,Ivan Provorov,D,CBJ,27,81,1,24,25
45,8478507,John Marino,D,UTA,27,68,1,24,25
45,8478057,Dakota Joshua,C,VAN,28,68,13,11,24
45,8479316,Luke Kunin,C,SJS,27,61,12,12,24
45,8481624,Ilya Mikheyev,R,CHI,30,54,12,12,24
45,8480855,Jack McBain,C,UTA,24,65,12,12,24
45,8482074,Connor Zary,C,CGY,23,58,11,13,24
45,8477947,Sonny Milano,L,WSH,28,66,9,15,24
45,8480073,Erik Brannstrom,D,COL,25,70,7,17,24
45,8475181,Nick Leddy,D,STL,33,66,6,18,24
45,8476885,Jacob Trouba,D,NYR,30,70,5,19,24
45,8482655,Janis Moser,D,TBL,24,76,3,21,24
45,8476917,Adam Pelech,D,NYI,30,79,3,21,24
45,8478840,Will Borgen,D,SEA,28,63,2,22,24
45,8480281,Alexey Toropchenko,R,STL,25,63,17,6,23
45,8475231,Casey Cizikas,C,NYI,33,70,15,8,23
45,8476873,Mark Jankowski,C,NSH,30,60,11,12,23
45,8476480,Vladislav Namestnikov,C,WPG,32,64,10,13,23
45,8476392,Adam Lowry,C,WPG,31,69,10,13,23
45,8481580,Connor McMichael,C,WSH,23,58,9,14,23
45,8479390,Taylor Raddysh,R,WSH,26,54,8,15,23
45,8476897,Oskar Sundqvist,C,STL,30,62,8,15,23
45,8477919,Frederick Gaudreau,C,MIN,31,66,8,15,23
45,8476994,Vinnie Hinostroza,C,NSH,30,56,7,16,23
45,8482148,Hendrix Lapierre,C,WSH,22,51,7,16,23
45,8476312,Josh Manson,D,COL,33,59,5,18,23
45,8480049,Dylan Samberg,D,WPG,25,72,5,18,23
45,8482073,Braden Schneider,D,NYR,23,67,5,18,23
45,8481606,Jordan Spence,D,LAK,23,60,3,20,23
45,8482245,Artem Zub,D,OTT,29,63,3,20,23
45,8480192,Johnathan Kovacevic,D,NJD,27,52,3,20,23
45,8476921,Jordan Martinook,L,CAR,32,62,13,9,22
45,8478508,Yakov Trenin,C,MIN,27,60,12,10,22
45,8482259,Bobby McMann,C,TOR,28,64,12,10,22
45,8480205,Emil Bemstrom,C,PIT,25,58,11,11,22
45,8478020,Michael Amadio,R,OTT,28,67,10,12,22
45,8480003,Jesper Boqvist,C,FLA,26,68,10,12,22
45,8482117,Lukas Reichel,L,CHI,22,64,10,12,22
45,8480748,Kiefer Sherwood,L,VAN,29,56,9,13,22
45,8482062,Cole Smith,L,NSH,29,57,9,13,22
45,8479315,Joey Anderson,R,CHI,26,48,8,14,22
45,8481441,Joe Snively,C,DET,28,70,7,15,22
45,8478970,Jalen Chatfield,D,CAR,28,70,5,17,22
45,8479661,Tanner Jeannot,L,LAK,27,75,5,17,22
45,8478443,Brandon Carlo,D,BOS,28,69,5,17,22
45,8480043,Timothy Liljegren,D,TOR,25,76,4,18,22
45,8476891,Matthew Grzelcyk,D,PIT,30,79,3,19,22
45,8479976,Juuso Valimaki,D,UTA,26,68,1,21,22
45,8479619,Michael Carcone,L,UTA,28,62,13,8,21
45,8481481,Blake Lizotte,C,PIT,27,65,13,8,21
45,8481032,Paul Cotter,C,NJD,25,59,12,9,21
45,8477507,Nikita Zadorov,D,BOS,29,70,11,10,21
45,8479941,Justin Danforth,R,CBJ,31,59,10,11,21
45,8477015,Connor Brown,R,EDM,30,66,10,11,21
45,8483565,Nick Blankenburg,D,NSH,26,59,9,12,21
45,8480995,Pontus Holmberg,R,TOR,25,64,7,14,21
45,8476429,Scott Mayfield,D,NYI,32,72,5,16,21
45,8481059,Scott Perunovich,D,STL,26,56,5,16,21
45,8482142,Jamie Drysdale,D,PHI,22,63,3,18,21
45,8480035,Henri Jokiharju,D,BUF,25,64,3,18,21
45,8482125,Alexander Holtz,R,VGK,22,67,13,7,20
45,8480789,Oliver Wahlstrom,R,NYI,24,72,13,7,20
45,8480806,Isac Lundestrom,C,ANA,25,62,12,8,20
45,8480144,David Kampf,C,TOR,29,72,10,10,20
45,8480762,Eric Robinson,L,CAR,29,56,10,10,20
45,8479414,Nathan Bastian,R,NJD,27,57,10,10,20
45,8479718,Alex Barré-Boulet,C,MTL,27,53,9,11,20
45,8476927,Teddy Blueger,C,VAN,30,65,8,12,20
45,8478178,Darren Raddysh,D,TBL,28,68,8,12,20
45,8483493,Frank Nazar,C,CHI,20,49,7,13,20
45,8475790,Erik Gudbranson,D,CBJ,32,77,4,16,20
45,8476525,Colin Miller,D,WPG,32,65,4,16,20
45,8476931,Jake McCabe,D,TOR,31,66,3,17,20
45,8477845,Trevor van Riemsdyk,D,WSH,33,63,3,17,20
45,8480878,Nils Lundkvist,D,DAL,24,73,2,18,20
45,8478416,Erik Cernak,D,TBL,27,73,2,18,20
45,8482155,Alex Laferriere,R,LAK,23,69,12,7,19
45,8480980,Connor Dewar,C,TOR,25,65,11,8,19
45,8476329,Travis Boyd,C,MIN,31,55,10,9,19
45,8480021,Jack Studnicka,C,LAK,25,66,9,10,19
45,8477392,Hudson Fasching,R,NYI,29,65,8,11,19
45,8470600,Ryan Suter,D,STL,39,62,7,12,19
45,8476934,Brock McGinn,L,ANA,30,56,7,12,19
45,8481550,Adam Beckman,L,NJD,23,38,7,12,19
45,8482803,Olen Zellweger,D,ANA,21,65,6,13,19
45,8479980,Nicolas Hague,D,VGK,26,56,6,13,19
45,8474151,Ryan McDonagh,D,TBL,35,74,4,15,19
45,8480891,Michael Kesselring,D,UTA,24,62,4,15,19
45,8480001,Urho Vaakanainen,D,ANA,25,64,4,15,19
45,8477506,Ryan Pulock,D,NYI,30,79,3,16,19
45,8482087,Kaiden Guhle,D,MTL,22,69,3,16,19
45,8480222,Sebastian Aho,D,PIT,28,75,2,17,19
45,8475455,Brenden Dillon,D,NJD,34,55,1,18,19
45,8476878,Zemgus Girgensons,C,TBL,30,77,10,8,18
45,8473453,Trevor Lewis,C,LAK,37,74,10,8,18
45,8479368,Max Jones,L,BOS,26,57,10,8,18
45,8476889,Radek Faksa,C,STL,30,55,9,9,18
45,8482807,Ethan Del Mastro,D,CHI,21,50,9,9,18
45,8481522,Peyton Krebs,C,BUF,23,60,8,10,18
45,8483495,Simon Nemec,D,NJD,20,56,6,12,18
45,8483499,Liam Ohgren,L,MIN,20,56,6,12,18
45,8482192,Isaak Phillips,D,CHI,23,48,5,13,18
45,8479639,Dylan Coghlan,D,WPG,26,60,4,14,18
45,8481178,Egor Zamula,D,PHI,24,61,4,14,18
45,8479371,Dante Fabbro,D,NSH,26,62,2,16,18
45,8477979,Nicolas Aube-Kubel,R,BUF,28,59,2,16,18
45,8478136,Jake Middleton,D,MIN,28,70,0,18,18
45,8475343,Nic Dowd,C,WSH,34,54,9,8,17
45,8483482,Tristan Luneau,D,ANA,20,73,9,8,17
45,8482762,Simon Edvinsson,D,DET,21,65,9,8,17
45,8482067,Connor Mackey,D,NYR,28,60,9,8,17
45,8481013,Jonatan Berggren,R,DET,24,57,6,11,17
45,8480289,Morgan Barron,C,WPG,26,51,5,12,17
45,8478911,Matt Roy,D,WSH,29,64,4,13,17
45,8482176,Wyatt Kaiser,D,CHI,22,58,4,13,17
45,8480157,Calle Rosen,D,COL,30,52,4,13,17
45,8480074,Alexandre Texier,C,STL,25,55,9,7,16
45,8481716,Dmitri Voronkov,L,CBJ,24,52,9,7,16
45,8475842,Sam Carrick,C,NYR,32,57,8,8,16
45,8480025,MacKenzie Entwistle,R,FLA,25,62,8,8,16
45,8478452,Caleb Jones,D,LAK,27,60,7,9,16
45,8483457,Lane Hutson,D,MTL,20,60,7,9,16
45,8482679,Matt Coronato,R,CGY,22,61,6,10,16
45,8480860,Kevin Bahl,D,CGY,24,57,5,11,16
45,8474568,Luke Schenn,D,NSH,35,56,4,12,16
45,8477369,Carson Soucy,D,VAN,30,59,3,13,16
45,8476331,Dylan DeMelo,D,WPG,31,66,1,15,16
45,8475225,Craig Smith,C,CHI,35,54,9,6,15
45,8478585,Derek Ryan,C,EDM,38,61,9,6,15
45,8481704,Juuso Parssinen,C,NSH,23,48,8,7,15
45,8479671,Mathieu Olivier,R,CBJ,27,47,8,7,15
45,8482079,Marco Rossi,C,MIN,23,50,7,8,15
45,8474034,Patrick Maroon,L,CHI,36,44,7,8,15
45,8478434,Keegan Kolesar,R,VGK,27,71,6,9,15
45,8477573,Nathan Walker,L,STL,30,48,6,9,15
45,8477931,Tomas Nosek,L,FLA,32,54,6,9,15
45,8477070,Liam O'Brien,C,UTA,30,52,6,9,15
45,8480252,Cole Guttman,C,CHI,25,43,5,10,15
45,8477499,Rasmus Ristolainen,D,PHI,30,65,5,10,15
45,8475233,David Savard,D,MTL,34,67,5,10,15
45,8476457,Adam Larsson,D,SEA,32,71,4,11,15
45,8476467,Jamie Oleksiak,D,SEA,32,69,4,11,15
45,8474166,Alec Martinez,D,CHI,37,53,4,11,15
45,8481592,Jakob Pelletier,L,CGY,23,42,4,11,15
45,8476988,Matt Benning,D,SJS,30,68,2,13,15
45,8475690,Chris Tanev,D,TOR,35,62,2,13,15
45,8474574,Tyler Myers,D,VAN,34,65,1,14,15
45,8480246,Nick Perbix,D,TBL,26,75,1,14,15
45,8475179,Dmitry Kulikov,D,FLA,34,63,0,15,15
45,8482737,Zack Bolduc,C,STL,21,55,10,4,14
45,8481518,Nolan Foote,L,NJD,24,41,10,4,14
45,8478421,A.J. Greer,L,FLA,28,51,8,6,14
45,8477446,Michael McCarron,R,NSH,29,56,7,7,14
45,8479439,Jacob MacDonald,D,COL,31,53,7,7,14
45,8479336,Carl Grundstrom,R,SJS,27,45,7,7,14
45,8482730,Brandt Clarke,D,LAK,21,52,6,8,14
45,8479370,Tyson Jost,C,CAR,26,47,6,8,14
45,8475188,Brayden McNabb,D,VGK,33,51,5,9,14
45,8481019,David Gustafsson,C,WPG,24,49,5,9,14
45,8481477,Nico Sturm,C,SJS,29,49,5,9,14
45,8481617,Vasily Podkolzin,R,VAN,23,49,5,9,14
45,8479983,Mario Ferraro,D,SJS,26,65,4,10,14
45,8481527,Kaedan Korczak,D,VGK,23,48,4,10,14
45,8475324,Nick Jensen,D,OTT,34,67,4,10,14
45,8481599,Victor Soderstrom,D,UTA,23,43,4,10,14
45,8481014,Alexander Romanov,D,NYI,24,72,3,11,14
45,8479026,Philippe Myers,D,TOR,27,45,3,11,14
45,8479543,Michael Pezzetta,L,MTL,26,58,3,11,14
45,8475208,Brian Dumoulin,D,ANA,33,58,1,13,14
45,8480355,Mark Kastelic,C,BOS,25,63,10,3,13
45,8479638,Justin Brazeau,R,BOS,26,43,10,3,13
45,8484149,Gavin Brindley,C,CBJ,20,45,7,6,13
45,8479972,Mason Shaw,C,WPG,26,36,6,7,13
45,8479359,Beck Malenstyn,L,BUF,26,48,6,7,13
45,8482964,Arber Xhekaj,D,MTL,23,51,5,8,13
45,8477380,Jonny Brodzinski,C,NYR,31,56,4,9,13
45,8479328,Julien Gauthier,R,NYI,27,52,4,9,13
45,8480727,Zach Whitecloud,D,VGK,28,44,4,9,13
45,8478468,Jeremy Lauzon,D,NSH,27,53,4,9,13
45,8475462,Radko Gudas,D,ANA,34,55,3,10,13
45,8480058,Pierre-Olivier Joseph,D,STL,25,53,2,11,13
45,8476967,Brett Kulak,D,EDM,30,61,2,11,13
45,8478859,Niko Mikkola,D,FLA,28,55,2,11,13
45,8481568,Alex Vlasic,D,CHI,23,50,1,12,13
45,8477482,Zachary Sanford,L,CHI,30,38,7,5,12
45,8482166,Shakir Mukhamadullin,D,SJS,22,53,6,6,12
45,8481754,Nikita Nesterenko,C,ANA,23,49,6,6,12
45,8479536,Axel Jonsson-Fjallby,L,WPG,26,42,6,6,12
45,8481028,Martin Pospisil,C,CGY,25,57,5,7,12
45,8479944,Zach Aston-Reese,C,VGK,30,44,5,7,12
45,8480011,Klim Kostin,C,SJS,25,50,4,8,12
45,8479291,Kevin Rooney,C,CGY,31,51,4,8,12
45,8475279,Ben Chiarot,D,DET,33,66,4,8,12
45,8481701,Santeri Hatakka,D,NJD,23,34,4,8,12
45,8482666,Scott Morrow,D,CAR,22,49,3,9,12
45,8477938,Haydn Fleury,D,WPG,28,43,2,10,12
45,8480887,Jordan Harris,D,MTL,24,46,2,10,12
45,8481537,Nikita Okhotiuk,D,CGY,24,48,1,11,12
45,8481567,Henry Thrun,D,SJS,23,52,0,12,12
45,8476856,Mathew Dumba,D,DAL,30,67,7,4,11
45,8483012,Logan Morrison,C,SEA,22,42,7,4,11
45,8479066,Ryan Lomberg,L,CGY,30,66,6,5,11
45,8481517,Brett Leason,R,ANA,25,43,6,5,11
45,8476374,Sean Kuraly,C,CBJ,31,55,6,5,11
45,8482659,Josh Doan,R,UTA,22,47,6,5,11
45,8480848,Ty Dellandrea,C,SJS,24,46,5,6,11
45,8481521,Ronnie Attard,D,PHI,25,55,4,7,11
45,8479968,Vinni Lettieri,C,BOS,29,48,4,7,11
45,8481605,Jackson LaCombe,D,ANA,23,32,4,7,11
45,8482077,Dylan Holloway,L,EDM,23,48,3,8,11
45,8478451,Ethan Bear,D,WSH,27,51,3,8,11
45,8478399,Jonas Siegenthaler,D,NJD,27,65,3,8,11
45,8479442,Troy Stecher,D,EDM,30,50,3,8,11
45,8474090,Brendan Smith,D,DAL,35,56,3,8,11
45,8483460,David Jiricek,D,CBJ,21,54,3,8,11
45,8482634,Alex Steeves,C,TOR,25,46,2,9,11
45,8477971,Andreas Englund,D,LAK,28,25,2,9,11
45,8481708,Zac Jones,D,NYR,24,46,1,10,11
45,8481167,Brayden Pachal,D,CGY,25,46,1,10,11
45,8478831,Kevin Stenlund,C,UTA,28,56,7,3,10
45,8471817,Ryan Reaves,R,TOR,37,47,5,5,10
45,8479520,Brandon Duhaime,R,WSH,27,58,4,6,10
45,8484254,Akito Hirose,D,VAN,25,37,4,6,10
45,8479344,Jesse Puljujarvi,R,PIT,26,40,3,7,10
45,8484911,Collin Graf,R,SJS,22,34,3,7,10
45,8481641,Joel Kiviranta,L,COL,28,70,2,8,10
45,8482451,Mikael Pyyhtia,L,CBJ,23,41,2,8,10
45,8479982,Conor Timmins,D,TOR,26,56,1,9,10
45,8479372,Joshua Mahura,D,SEA,26,55,1,9,10
45,8479998,Mikey Anderson,D,LAK,25,58,1,9,10
45,8480172,Jan Rutta,D,SJS,34,58,1,9,10
45,8479348,Kale Clague,D,BUF,26,43,1,9,10
45,8475177,Calvin de Haan,D,COL,33,36,1,9,10
45,8483570,Ben Meyers,C,SEA,26,30,6,3,9
45,8478211,Dryden Hunt,L,CGY,29,53,5,4,9
45,8482859,Zack Ostapchuk,C,OTT,21,53,4,5,9
45,8481751,Lukas Rousek,R,BUF,25,30,4,5,9
45,8476442,Matt Nieto,L,PIT,32,46,4,5,9
45,8477034,Jaycob Megna,D,FLA,32,48,4,5,9
45,8482141,Lukas Cormier,D,VGK,22,31,4,5,9
45,8477962,Brendan Lemieux,L,CAR,28,36,4,5,9
45,8480807,Mattias Samuelsson,D,BUF,24,51,3,6,9
45,8480845,Rasmus Kupari,C,WPG,24,43,3,6,9
45,8476952,Dominic Toninato,C,WPG,30,39,3,6,9
45,8483549,Lucas Condotta,L,MTL,27,38,3,6,9
45,8477365,Connor Clifton,D,BUF,29,58,2,7,9
45,8479369,Andrew Peeke,D,BOS,26,56,1,8,9
45,8480879,Jacob Bernard-Docker,D,OTT,24,52,1,8,9
45,8475750,Jon Merrill,D,MIN,32,63,1,8,9
45,8478409,Anthony Richard,C,PHI,28,34,1,8,9
45,8476822,Luke Glendening,C,TBL,35,76,6,2,8
45,8481789,Tye Kartye,L,SEA,23,33,6,2,8
45,8482733,Logan Mailloux,D,MTL,31,40,5,3,8
45,8476858,Phillip Di Giuseppe,L,VAN,31,48,4,4,8
45,8479981,Jonah Gadjovich,L,FLA,26,40,4,4,8
45,8480441,Trey Fix-Wolansky,R,CBJ,25,38,4,4,8
45,8483619,Filip Roos,D,OTT,25,35,4,4,8
45,8483630,Pavol Regenda,L,ANA,25,23,4,4,8
45,8482744,James Malatesta,L,CBJ,21,39,4,4,8
45,8482153,Brendan Brisson,C,VGK,23,32,2,6,8
45,8477384,Joshua Brown,D,EDM,30,48,1,7,8
45,8482095,Tyler Kleven,D,OTT,22,45,1,7,8
45,8479378,Logan Stanley,D,WPG,26,38,0,8,8
45,8478454,Noah Juulsen,D,VAN,27,39,0,8,8
45,8471677,Jack Johnson,D,CBJ,37,58,0,8,8
45,8475718,Justin Holl,D,DET,32,56,0,8,8
45,8476473,Connor Murphy,D,CHI,31,37,5,2,7
45,8482070,Mitchell Chaffee,R,TBL,26,50,4,3,7
45,8477887,Patrick Brown,C,BOS,32,44,4,3,7
45,8476624,Barclay Goodrow,C,SJS,31,43,3,4,7
45,8476441,Joel Edmundson,D,LAK,31,42,3,4,7
45,8477401,John Hayden,C,SEA,29,36,3,4,7
45,8481598,Philip Broberg,D,EDM,23,38,3,4,7
45,8482784,Zach Dean,C,STL,21,37,3,4,7
45,8482747,Brennan Othmann,L,NYR,21,40,2,5,7
45,8479367,William Lockwood,R,FLA,26,22,2,5,7
45,8476874,Olli Maatta,D,DET,30,55,1,6,7
45,8480950,Ilya Lyubushkin,D,DAL,30,60,1,6,7
45,8474612,Travis Hamonic,D,OTT,34,48,1,6,7
45,8480070,Ian Mitchell,D,BOS,25,47,1,6,7
45,8482496,Nils Aman,C,VAN,24,38,0,7,7
45,8479249,Andrew Poturalski,C,SJS,30,31,0,7,7
45,8480870,Bo Groulx,C,NYR,24,24,6,0,6
45,8479379,Givani Smith,R,SJS,26,32,4,2,6
45,8481556,John Beecher,C,BOS,23,30,4,2,6
45,8478146,Matthew Highmore,C,OTT,28,35,3,3,6
45,8479772,Zack MacEwen,R,OTT,28,53,3,3,6
45,8483466,Kevin Korchinski,D,CHI,20,45,2,4,6
45,8480292,Carson Meyer,R,ANA,27,31,2,4,6
45,8481147,Reese Johnson,C,MIN,26,36,2,4,6
45,8482765,Isak Rosen,R,BUF,21,27,2,4,6
45,8477851,Jordan Oesterle,D,BOS,32,44,2,4,6
45,8480084,Nick DeSimone,D,NJD,30,15,2,4,6
45,8482861,Vincent Iorio,D,WSH,22,37,1,5,6
45,8471709,Marc-Edouard Vlasic,D,SJS,37,54,1,5,6
45,8473446,Erik Johnson,D,PHI,36,44,1,5,6
45,8475762,Derek Forbort,D,VAN,32,48,1,5,6
45,8481122,Simon Benoit,D,TOR,26,44,1,5,6
45,8481600,Tobias Bjornfot,D,FLA,23,34,1,5,6
45,8477527,Ross Johnston,L,ANA,30,32,1,5,6
45,8475958,Michael Sgarbossa,C,WSH,32,28,1,5,6
45,8476372,Nick Seeler,D,PHI,31,41,0,6,6
45,8481532,Alex Turcotte,C,LAK,23,36,4,1,5
45,8480834,Ty Emberson,D,SJS,24,43,3,2,5
45,8480844,Grigori Denisenko,L,VGK,24,33,3,2,5
45,8479986,Kole Lind,R,DAL,26,42,3,2,5
45,8475235,Nicolas Deslauriers,L,PHI,33,42,3,2,5
45,8478424,Jansen Harkins,C,ANA,27,30,3,2,5
45,8476913,Devin Shore,C,MIN,30,43,3,2,5
45,8481161,Jake Christiansen,D,CBJ,25,62,2,3,5
45,8482751,Ryan Winterton,C,SEA,21,41,2,3,5
45,8481679,Maxence Guenette,D,OTT,23,29,2,3,5
45,8478017,Mark Friedman,D,VAN,29,36,2,3,5
45,8479985,Cale Fleury,D,SEA,26,28,2,3,5
45,8479991,Jake Leschyshyn,C,NYR,25,27,2,3,5
45,8480796,Martin Fehervary,D,WSH,25,52,1,4,5
45,8474013,Ian Cole,D,UTA,35,50,1,4,5
45,8477244,Chad Ruhwedel,D,NYR,34,29,1,4,5
45,8481609,Vladislav Kolyachonok,D,UTA,23,31,1,4,5
45,8482713,Mackie Samoskevich,R,FLA,22,34,1,4,5
45,8482162,Roby Jarventie,L,EDM,22,19,1,4,5
45,8478450,Parker Wotherspoon,D,BOS,27,30,0,5,5
45,8474567,Zach Bogosian,D,MIN,34,57,0,5,5
45,8477335,Kyle Burroughs,D,LAK,29,42,0,5,5
45,8480032,Shane Bowers,C,NJD,25,22,4,0,4
45,8480245,Olle Lycksell,R,PHI,25,30,3,1,4
45,8478874,Adam Gaudette,R,OTT,28,36,3,1,4
45,8483763,Maksymilian Szuber,D,UTA,22,28,3,1,4
45,8482652,Walker Duehr,R,CGY,27,40,2,2,4
45,8482201,Gage Goncalves,C,TBL,23,23,2,2,4
45,8481206,John Ludvig,D,PIT,24,13,2,2,4
45,8477473,Justin Bailey,R,SJS,29,20,2,2,4
45,8481056,Spencer Stastney,D,NSH,24,31,1,3,4
45,8480990,Declan Chisholm,D,MIN,24,37,1,3,4
45,8479576,Vincent Desharnais,D,VAN,28,34,1,3,4
45,8484258,Sam Malinski,D,COL,26,23,1,3,4
45,8477467,Gustav Olofsson,D,SEA,30,21,1,3,4
45,8480196,Jacob Bryson,D,BUF,27,46,0,4,4
45,8479419,Brett Murray,L,BUF,26,21,0,4,4
45,8480267,Sammy Walker,C,MIN,25,22,0,4,4
45,8477149,Scott Sabourin,R,SJS,32,11,0,4,4
45,8481564,Ryan Johnson,D,BUF,23,14,3,0,3
45,8481726,Adam Edstrom,C,NYR,24,8,3,0,3
45,8476867,Brendan Gaunce,C,MIN,30,33,2,1,3
45,8477810,Joel Hanley,D,CGY,33,25,2,1,3
45,8481237,Kyle MacLean,C,NYI,25,27,2,1,3
45,8481719,Maxwell Crozier,D,TBL,24,14,2,1,3
45,8480007,Jonas Rondbjerg,R,VGK,25,33,1,2,3
45,8480880,Jakub Lauko,C,MIN,24,27,1,2,3
45,8482145,Mavrik Bourque,C,DAL,22,54,1,2,3
45,8481543,Nikita Alexandrov,C,STL,24,27,1,2,3
45,8483397,Marc McLaughlin,C,BOS,25,28,1,2,3
45,8482144,Jack Thompson,D,SJS,22,32,1,2,3
45,8482118,Sam Colangelo,R,ANA,23,17,1,2,3
45,8483489,Fraser Minten,C,TOR,31,6,1,2,3
45,8478477,Mitchell Stephens,C,SEA,27,18,1,2,3
45,8481699,Aku Raty,R,UTA,23,15,1,2,3
45,8482102,Vasily Ponomarev,C,PIT,22,10,1,2,3
45,8482511,Mason Lohrei,D,BOS,23,26,0,3,3
45,8480890,Jan Jenik,C,OTT,24,20,0,3,3
45,8481541,Samuel Bolduc,D,NYI,24,31,0,3,3
45,8479421,Jacob Moverare,D,LAK,26,7,0,3,3
45,8477320,Anton Blidh,L,NYR,29,23,2,0,2
45,8481043,Cole Koepke,L,BOS,26,16,2,0,2
45,8480874,Adam Ginning,D,PHI,24,17,2,0,2
45,8478881,Brett Seney,L,CHI,28,12,2,0,2
45,8481578,Graeme Clarke,R,MIN,23,15,2,0,2
45,8477073,Kurtis MacDermid,L,NJD,30,31,2,0,2
45,8477462,Robert Hagg,D,VGK,29,26,1,1,2
45,8479587,Rhett Gardner,C,PHI,28,22,1,1,2
45,8481585,Egor Afanasyev,L,SJS,23,18,1,1,2
45,8475795,Dylan McIlrath,D,WSH,32,17,1,1,2
45,8482147,Jean-Luc Foudy,C,COL,22,24,1,1,2
45,8482929,Emil Lilleberg,D,TBL,23,27,1,1,2
45,8480851,Akil Thomas,C,LAK,24,22,1,1,2
45,8482470,Ilya Solovyov,D,CGY,24,10,1,1,2
45,8482088,Justin Sourdif,R,FLA,22,24,1,1,2
45,8484287,Cole McWard,D,VAN,23,25,0,2,2
45,8481006,Tyler Tucker,D,STL,24,15,0,2,2
45,8479320,Maxime Lajoie,D,SEA,27,22,0,2,2
45,8481593,Jayden Struble,D,MTL,23,21,0,2,2
45,8478021,William Lagesson,D,DET,28,26,0,2,2
45,8482094,Daemon Hunt,D,MIN,22,23,0,2,2
45,8482250,Callahan Burke,C,VGK,27,20,0,2,2
45,8482177,Marat Khusnutdinov,C,MIN,22,28,0,2,2
45,8481743,Marc Del Gaizo,D,NSH,25,22,0,2,2
45,8483398,Declan Carlile,D,TBL,31,9,0,2,2
45,8481065,Angus Crookshank,L,OTT,25,25,0,2,2
45,8483407,Brandon Scanlin,D,NYR,25,5,0,2,2
45,8479994,Jaret Anderson-Dolan,C,WPG,25,23,1,0,1
45,8482787,Nikita Chibrikov,R,WPG,31,6,1,0,1
45,8478051,Max Willman,C,NJD,29,12,1,0,1
45,8480075,Cameron Crotty,D,MIN,25,11,1,0,1
45,8482172,Landon Slaggert,L,CHI,22,24,1,0,1
45,8475413,Justin Dowling,C,NJD,34,14,1,0,1
45,8483432,Luca Del Bel Belluz,C,CBJ,31,3,1,0,1
45,8481806,Louis Crevier,D,CHI,23,17,1,0,1
45,8483920,Pierrick Dube,R,WSH,23,3,1,0,1
45,8481462,Mason Morelli,L,VGK,28,16,1,0,1
45,8484259,Ondrej Pavel,C,COL,31,4,1,0,1
45,8474062,Riley Nash,C,NYR,35,19,0,1,1
45,8482858,Ryker Evans,D,SEA,23,20,0,1,1
45,8481422,Jake Lucchini,C,NSH,29,17,0,1,1
45,8483567,Georgii Merkulov,C,BOS,24,8,0,1,1
45,8484304,Uvis Balinskis,D,FLA,28,9,0,1,1
45,8478502,Dennis Gilbert,D,BUF,28,13,0,1,1
45,8484325,Waltteri Merela,C,TBL,26,22,0,1,1
45,8483597,Milos Kelemen,L,UTA,25,13,0,1,1
45,8482460,Matt Rempe,C,NYR,22,12,0,1,1
45,8482197,Adam Raska,R,MIN,23,11,0,1,1
45,8479330,Brandon Gignac,C,MTL,27,6,0,1,1
45,8481030,Jack St. Ivany,D,PIT,25,9,0,1,1
45,8476323,Max McCormick,L,SEA,32,5,0,1,1
45,8479362,Riley Tufte,L,BOS,26,22,0,0,0
45,8480468,James Hamblin,L,EDM,25,18,0,0,0
45,8482165,Yan Kuznetsov,D,CGY,22,20,0,0,0
45,8483395,Arshdeep Bains,L,VAN,23,9,0,0,0
45,8482516,Matthew Kessel,D,STL,24,12,0,0,0
45,8483512,Matthew Savoie,C,EDM,20,16,0,0,0
45,8477993,Justin Kirkland,C,CGY,28,8,0,0,0
45,8478011,Louie Belpedio,D,PHI,28,11,0,0,0
45,8483471,Brad Lambert,C,WPG,31,13,0,0,0
45,8475755,Alexander Petrovic,D,DAL,32,8,0,0,0
45,8478854,Ryan Shea,D,PIT,27,1,0,0,0
45,8475780,Chris Wagner,R,COL,33,3,0,0,0
45,8477541,Dakota Mermis,D,TOR,30,10,0,0,0
45,8482061,Brandon Biro,L,SEA,26,14,0,0,0
45,8484321,Nikolas Matinpalo,D,OTT,26,4,0,0,0
45,8480823,Alexander Alexeyev,D,WSH,25,9,0,0,0
45,8483546,Marshall Rifai,D,TOR,26,2,0,0,0
45,8482476,Emil Heineman,L,MTL,23,6,0,0,0
45,8480306,Grant Hutton,D,NYI,29,6,0,0,0
45,8482126,Emil Andrae,D,PHI,31,3,0,0,0
45,8478446,Glenn Gawdin,C,LAK,27,12,0,0,0
45,8481024,Linus Karlsson,C,VAN,25,10,0,0,0
45,8484255,Jason Polin,R,COL,25,3,0,0,0
45,8484326,Patrik Koch,D,UTA,28,1,0,0,0
45,8479522,Hardy Haman Aktell,D,WSH,26,3,0,0,0
45,8483531,Brian Halonen,L,NJD,25,1,0,0,0
45,8481655,Cole Schwindt,R,CGY,23,4,0,0,0
45,8478147,Bokondji Imama,L,PIT,28,5,0,0,0
45,8481534,Raphael Lavoie,C,EDM,24,0,0,0,0
45,8483609,Adam Klapka,R,CGY,24,2,0,0,0
45,8480274,Philip Kemp,D,EDM,25,1,0,0,0
45,8483401,Marc Johnstone,R,PIT,28,0,0,0,0
45,8470794,Joe Pavelski,C,,40,0,0,0,0
45,8479321,Lucas Johansen,D,,27,0,0,0,0
45,8477950,Tony DeAngelo,D,,29,0,0,0,0
45,8471218,Blake Wheeler,R,,38,0,0,0,0
45,8475197,Tyson Barrie,D,,33,0,0,0,0
45,8474157,Max Pacioretty,L,,36,0,0,0,0
45,8475744,Evgeny Kuznetsov,C,,32,0,0,0,0
45,8474037,James van Riemsdyk,L,,35,0,0,0,0
45,8476907,Mackenzie MacEachern,L,,30,0,0,0,0
45,8480216,Jacob Peterson,C,,25,0,0,0,0
45,8474602,Justin Schultz,D,,34,0,0,0,0
45,8482222,Alexander Barabanov,L,,30,0,0,0,0
45,8474031,Kevin Shattenkirk,D,,35,0,0,0,0
45,8477330,Dominik Kubalik,L,,29,0,0,0,0
45,8480884,Calen Addison,D,,24,0,0,0,0
45,8475906,John Klingberg,D,,32,0,0,0,0
45,8480008,Adam Ruzicka,C,,25,0,0,0,0
45,8476884,Derrick Pouliot,D,,30,0,0,0,0
45,8476919,Chris Tierney,C,,30,0,0,0,0
45,8479415,Michael McLeod,C,,26,0,0,0,0
45,8474870,Tyler Johnson,C,,34,0,0,0,0
45,8470604,Jeff Carter,C,,39,0,0,0,0
45,8478104,Sammy Blais,L,,28,0,0,0,0
45,8474884,Mike Hoffman,C,,35,0,0,0,0
45,8481591,Sam Poulin,R,,23,0,0,0,0
45,8471274,Alex Goligoski,D,,39,0,0,0,0
45,8476871,Tanner Pearson,L,,32,0,0,0,0
45,8476393,Nick Cousins,C,,31,0,0,0,0
45,8479977,Kailer Yamamoto,R,,26,0,0,0,0
45,8479346,Dillon Dube,C,,26,0,0,0,0
45,8480184,Gustav Lindstrom,D,,26,0,0,0,0
45,8479376,Victor Mete,D,,26,0,0,0,0
45,8473449,Kyle Okposo,R,,36,0,0,0,0
45,8481058,Jesse Ylonen,R,,25,0,0,0,0
45,8475752,Tyler Pitlick,C,,33,0,0,0,0
45,8481239,Samuel Fagemo,L,,24,0,0,0,0
45,8480821,Filip Zadina,R,,25,0,0,0,0
45,8470966,Mark Giordano,D,,41,0,0,0,0
45,8478495,Denis Gurianov,R,,27,0,0,0,0
45,8477464,Nic Petan,C,,29,0,0,0,0
45,8478099,Kevin Labanc,R,,29,0,0,0,0
45,8482241,Radim Zohorna,L,,28,0,0,0,0
45,8474040,Sam Gagner,C,,35,0,0,0,0
45,8479514,Rem Pitlick,C,,27,0,0,0,0
45,8478430,Oliver Kylington,D,,27,0,0,0,0
45,8479533,Joona Koppanen,L,,26,0,0,0,0
45,8479984,Cal Foote,D,,26,0,0,0,0
45,8477126,Jayson Megna,C,,34,0,0,0,0
45,8475164,Jakob Silfverberg,R,,34,0,0,0,0
45,8474009,Nick Bonino,C,,36,0,0,0,0
45,8479458,Nikita Zaitsev,D,,33,0,0,0,0
45,8477944,Jakub Vrana,L,,28,0,0,0,0
45,8471699,Andrew Cogliano,C,,37,0,0,0,0
45,8478067,Oskar Lindblom,L,,28,0,0,0,0
45,8471686,Marc Staal,D,,37,0,0,0,0
45,8470610,Zach Parise,L,,40,0,0,0,0
45,8478904,Steven Lorentz,C,,28,0,0,0,0
45,8473473,Milan Lucic,L,,36,0,0,0,0
45,8480031,Maxime Comtois,L,,25,0,0,0,0
45,8478512,Austin Czarnik,C,,32,0,0,0,0
45,8473504,Cal Clutterbuck,R,,37,0,0,0,0
45,8477454,Adam Erne,L,,29,0,0,0,0
45,8479383,Boris Katchouk,L,,26,0,0,0,0
45,8475825,Jani Hakanpää,D,,32,0,0,0,0
45,8477846,Ryan Carpenter,C,,33,0,0,0,0
45,8477930,Pierre-Edouard Bellemare,L,,39,0,0,0,0
45,8478400,Colin White,C,,27,0,0,0,0
45,8480226,Marián Studenic,R,,26,0,0,0,0
45,8480853,Liam Foudy,C,,24,0,0,0,0
45,8475797,Jarred Tinordi,D,,32,0,0,0,0
45,8479423,Alex Nylander,L,,26,0,0,0,0
45,8474618,Marco Scandella,D,,34,0,0,0,0
45,8478028,Fredrik Olofsson,L,,28,0,0,0,0
45,8474709,Matt Martin,L,,35,0,0,0,0
45,8481070,Hugh McGing,L,,26,0,0,0,0
45,8479546,Oskar Steen,C,,26,0,0,0,0
45,8474145,Robert Bortuzzo,D,,35,0,0,0,0
45,8476915,Jujhar Khaira,L,,30,0,0,0,0
45,8475278,Byron Froese,C,,33,0,0,0,0
45,8481812,Nikolai Knyzhov,D,,27,0,0,0,0
45,8478408,Travis Dermott,D,,28,0,0,0,0
45,8481077,John Leonard,L,,26,0,0,0,0
45,8479547,Matthew Phillips,R,,26,0,0,0,0
45,8480836,Jonathan Gruden,C,,24,0,0,0,0
45,8481690,Tyler Angle,C,,24,0,0,0,0
45,8475766,Austin Watson,L,,32,0,0,0,0
45,8481016,Ruslan Iskhakov,C,,24,0,0,0,0
45,8478078,Rourke Chartier,C,,28,0,0,0,0
45,8480776,Sheldon Rempal,R,,29,0,0,0,0
45,8478956,Samuel Laberge,L,NJD,27,1,0,0,0
45,8483045,Cameron Butler,R,CBJ,31,1,0,0,0
45,8484314,Jiri Smejkal,L,,28,0,0,0,0
46,8478550,Artemi Panarin,L,NYR,33,78,41,97,138
46,8478402,Connor McDavid,C,EDM,27,78,47,90,137
46,8477492,Nathan MacKinnon,C,COL,29,80,54,81,135
46,8476453,Nikita Kucherov,R,TBL,31,81,39,86,125
46,8481559,Jack Hughes,C,NJD,23,77,43,77,120
46,8477934,Leon Draisaitl,C,EDM,29,77,38,82,120
46,8477404,Jake Guentzel,C,TBL,30,82,44,73,117
46,8478420,Mikko Rantanen,R,COL,28,79,57,56,113
46,8479318,Auston Matthews,C,TOR,27,80,64,47,111
46,8477956,David Pastrnak,R,BOS,28,81,46,61,107
46,8478483,Mitch Marner,R,TOR,27,82,27,75,102
46,8476468,J.T. Miller,C,VAN,31,80,27,74,101
46,8479314,Matthew Tkachuk,L,FLA,27,78,29,71,100
46,8476887,Filip Forsberg,L,NSH,30,78,46,52,98
46,8480801,Brady Tkachuk,L,OTT,25,78,47,49,96
46,8477942,Kevin Fiala,L,LAK,28,81,31,65,96
46,8478864,Kirill Kaprizov,L,MIN,27,71,42,52,94
46,8474600,Roman Josi,D,NSH,34,78,28,65,93
46,8478439,Travis Konecny,R,PHI,27,76,47,45,92
46,8477939,William Nylander,R,TOR,28,77,42,49,91
46,8480012,Elias Pettersson,C,VAN,26,75,34,57,91
46,8477493,Aleksander Barkov,C,FLA,29,79,28,61,89
46,8480002,Nico Hischier,C,NJD,25,73,40,48,88
46,8475184,Chris Kreider,L,NYR,33,73,59,28,87
46,8476881,Tomas Hertl,C,VGK,31,80,38,49,87
46,8480036,Miro Heiskanen,D,DAL,25,78,17,70,87
46,8479385,Jordan Kyrou,C,STL,26,76,38,48,86
46,8480027,Jason Robertson,L,DAL,25,82,30,56,86
46,8480023,Robert Thomas,C,STL,25,75,14,72,86
46,8477946,Dylan Larkin,C,DET,28,80,36,49,85
46,8479407,Jesper Bratt,L,NJD,26,74,31,54,85
46,8477409,Carter Verhaeghe,C,FLA,29,80,41,43,84
46,8478403,Jack Eichel,C,VGK,28,73,38,46,84
46,8471675,Sidney Crosby,C,PIT,37,76,26,57,83
46,8479323,Adam Fox,D,NYR,26,73,18,65,83
46,8480800,Quinn Hughes,D,VAN,25,77,14,69,83
46,8480208,Drake Batherson,R,OTT,26,75,40,42,82
46,8475913,Mark Stone,R,VGK,32,77,26,56,82
46,8478398,Kyle Connor,L,WPG,28,72,42,39,81
46,8478010,Brayden Point,C,TBL,28,80,39,42,81
46,8479542,Brandon Hagel,L,TBL,26,82,35,46,81
46,8476459,Mika Zibanejad,C,NYR,31,77,33,48,81
46,8479420,Tage Thompson,C,BUF,27,75,48,32,80
46,8477933,Sam Reinhart,C,FLA,29,79,34,46,80
46,8476389,Vincent Trocheck,C,NYR,31,77,31,49,80
46,8478445,Mathew Barzal,C,NYI,27,80,29,51,80
46,8476539,Jonathan Marchessault,R,NSH,34,75,42,37,79
46,8473419,Brad Marchand,L,BOS,36,80,33,46,79
46,8482116,Tim Stützle,C,OTT,22,79,27,52,79
46,8474564,Steven Stamkos,C,NSH,34,71,28,49,77
46,8478427,Sebastian Aho,C,CAR,27,71,37,39,76
46,8475172,Nazem Kadri,C,CGY,34,77,37,38,75
46,8481557,Matt Boldy,L,MIN,23,69,36,39,75
46,8479343,Clayton Keller,R,UTA,26,76,33,42,75
46,8478444,Brock Boeser,R,VAN,27,76,33,42,75
46,8477402,Pavel Buchnevich,L,STL,29,74,30,45,75
46,8477960,Adrian Kempe,R,LAK,28,82,41,33,74
46,8475167,Victor Hedman,D,TBL,34,77,19,55,74
46,8481068,Yegor Sharangovich,C,CGY,26,77,34,39,73
46,8475191,Reilly Smith,R,NYR,33,78,22,50,72
46,8477949,Alex Tuch,R,BUF,28,75,31,40,71
46,8474141,Patrick Kane,R,DET,36,80,29,42,71
46,8480018,Nick Suzuki,C,MTL,25,78,26,45,71
46,8476454,Ryan Nugent-Hopkins,C,EDM,31,77,20,51,71
46,8477503,Max Domi,C,TOR,29,80,12,59,71
46,8478407,Vince Dunn,D,SEA,28,76,11,59,70
46,8477500,Bo Horvat,C,NYI,29,81,36,33,69
46,8477955,Jared McCann,L,SEA,28,76,36,33,69
46,8477951,Nick Schmaltz,C,UTA,28,74,23,46,69
46,8478975,Mason Marchment,L,DAL,29,82,21,48,69
46,8480069,Cale Makar,D,COL,26,69,20,49,69
46,8475166,John Tavares,C,TOR,34,80,33,35,68
46,8480839,Rasmus Dahlin,D,BUF,24,70,14,54,68
46,8481540,Cole Caufield,R,MTL,23,74,37,30,67
46,8476460,Mark Scheifele,C,WPG,31,66,34,33,67
46,8478414,Timo Meier,R,NJD,28,76,34,33,67
46,8482159,Tyson Foerster,R,PHI,22,74,34,33,67
46,8476448,William Karlsson,C,VGK,31,77,33,34,67
46,8478440,Dylan Strome,C,WSH,27,73,25,42,67
46,8479337,Alex DeBrincat,R,DET,27,81,22,45,67
46,8479999,Casey Mittelstadt,C,COL,26,80,22,45,67
46,8480830,Andrei Svechnikov,R,CAR,24,70,34,32,66
46,8475786,Zach Hyman,L,EDM,32,76,34,31,65
46,8478449,Roope Hintz,C,DAL,28,80,32,33,65
46,8477504,Josh Morrissey,D,WPG,29,78,8,57,65
46,8484145,Zach Benson,L,BUF,19,74,29,35,64
46,8475784,Jeff Skinner,C,EDM,32,78,24,40,64
46,8478519,Anthony Cirelli,C,TBL,27,81,24,40,64
46,8475692,Mats Zuccarello,R,MIN,37,71,15,49,64
46,8475754,Brock Nelson,C,NYI,33,80,35,28,63
46,8476456,Jonathan Huberdeau,C,CGY,31,79,26,37,63
46,8471685,Anze Kopitar,C,LAK,37,78,23,40,63
46,8475726,Tyler Toffoli,C,SJS,32,68,40,22,62
46,8477476,Artturi Lehkonen,L,COL,29,81,32,30,62
46,8475168,Matt Duchene,C,DAL,33,82,28,34,62
46,8474102,David Perron,L,OTT,36,80,27,35,62
46,8482699,Dylan Guenther,R,UTA,21,78,21,41,62
46,8475794,Tyler Seguin,C,DAL,32,82,35,26,61
46,8482093,Seth Jarvis,C,CAR,22,74,24,37,61
46,8471215,Evgeni Malkin,C,PIT,38,73,26,34,60
46,8477986,Brandon Montour,D,SEA,30,73,22,38,60
46,8474578,Erik Karlsson,D,PIT,34,78,18,42,60
46,8482740,Wyatt Johnston,C,DAL,21,82,33,26,59
46,8478047,Michael Bunting,L,PIT,29,76,20,39,59
46,8473994,Jamie Benn,L,DAL,35,81,20,39,59
46,8473512,Claude Giroux,R,OTT,36,78,15,44,59
46,8479675,Trevor Moore,L,LAK,29,82,27,31,58
46,8477416,Oliver Bjorkstrand,R,SEA,29,71,24,34,58
46,8475170,Brayden Schenn,C,STL,33,74,21,37,58
46,8478401,Pavel Zacha,C,BOS,27,79,19,39,58
46,8476346,Johnny Gaudreau,L,CBJ,31,71,14,44,58
46,8475158,Ryan O'Reilly,C,NSH,33,73,31,26,57
46,8475810,Bryan Rust,R,PIT,32,70,27,30,57
46,8475745,Charlie Coyle,C,BOS,32,78,24,33,57
46,8476399,Blake Coleman,C,CGY,33,76,33,23,56
46,8476432,Boone Jenner,C,CBJ,31,73,32,24,56
46,8475151,Kyle Palmieri,C,NYI,33,80,31,25,56
46,8480015,Owen Tippett,R,PHI,25,73,26,30,56
46,8477496,Elias Lindholm,C,BOS,30,79,25,31,56
46,8484144,Connor Bedard,C,CHI,19,65,23,33,56
46,8477940,Nikolaj Ehlers,L,WPG,28,69,21,35,56
46,8482124,Quinton Byfield,R,LAK,22,80,19,37,56
46,8474679,Gustav Nyquist,C,NSH,35,73,17,39,56
46,8483515,Juraj Slafkovsky,L,MTL,20,78,22,33,55
46,8480039,Martin Necas,C,CAR,25,66,21,34,55
46,8474586,Jordan Eberle,R,SEA,34,74,20,35,55
46,8477998,Warren Foegele,L,LAK,28,77,27,27,54
46,8478462,Nicolas Roy,C,VGK,27,76,21,33,54
46,8482149,Cole Perfetti,C,WPG,22,73,21,33,54
46,8480188,Fabian Zetterlund,L,SJS,25,70,20,34,54
46,8481711,Matias Maccelli,L,UTA,24,73,16,38,54
46,8476905,Chandler Stephenson,C,SEA,30,76,12,42,54
46,8470613,Brent Burns,D,CAR,39,77,12,42,54
46,8480865,Noah Dobson,D,NYI,24,78,10,44,54
46,8476483,Rickard Rakell,R,PIT,31,68,25,28,53
46,8475765,Vladimir Tarasenko,R,DET,33,80,17,36,53
46,8482745,Mason McTavish,C,ANA,21,73,25,27,52
46,8477501,Valeri Nichushkin,R,COL,29,80,20,32,52
46,8478460,Zach Werenski,D,CBJ,27,81,16,36,52
46,8476875,Mike Matheson,D,MTL,30,77,8,44,52
46,8478498,Jake DeBrusk,L,VAN,28,74,31,20,51
46,8482665,Matty Beniers,C,SEA,22,68,26,25,51
46,8477511,Anthony Mantha,R,CGY,30,76,11,40,51
46,8475798,Mikael Granlund,C,SJS,32,72,9,42,51
46,8478397,Rasmus Andersson,D,CGY,28,69,7,44,51
46,8476853,Morgan Rielly,D,TOR,30,70,7,44,51
46,8482109,Alexis Lafrenière,L,NYR,23,73,27,23,50
46,8478873,Troy Terry,R,ANA,27,74,25,25,50
46,8471214,Alex Ovechkin,L,WSH,39,71,23,27,50
46,8477964,Ivan Barbashev,C,VGK,29,69,22,28,50
46,8481596,Shane Pinto,C,OTT,24,78,16,34,50
46,8481528,Dylan Cozens,C,BUF,23,70,19,30,49
46,8483808,Andrei Kuzmenko,L,CGY,28,75,17,32,49
46,8471724,Kris Letang,D,PIT,37,77,16,33,49
46,8482105,Jake Sanderson,D,OTT,22,73,13,36,49
46,8482113,Anton Lundell,C,FLA,23,80,26,22,48
46,8483431,Logan Cooley,C,UTA,20,77,24,24,48
46,8482078,Lucas Raymond,L,DET,22,82,22,26,48
46,8482146,Luke Evangelista,R,NSH,22,73,21,27,48
46,8475793,Ryan Johansen,C,PHI,32,72,20,28,48
46,8480797,Joel Farabee,L,PHI,24,75,20,28,48
46,8482097,Jack Quinn,R,BUF,23,64,19,29,48
46,8477932,Aaron Ekblad,D,FLA,28,73,18,30,48
46,8478458,John (Jack) Roslovic,C,CAR,27,69,17,31,48
46,8477444,Andre Burakovsky,L,SEA,29,61,14,34,48
46,8474590,John Carlson,D,WSH,34,72,13,35,48
46,8476906,Shayne Gostisbehere,D,CAR,31,75,12,36,48
46,8482684,Luke Hughes,D,NJD,21,74,8,40,48
46,8474641,Adam Henrique,C,EDM,34,75,25,22,47
46,8478046,Danton Heinen,L,VAN,29,67,21,26,47
46,8477429,Andrew Copp,C,DET,30,78,17,30,47
46,8480803,Evan Bouchard,D,EDM,25,72,6,41,47
46,8480064,Josh Norris,C,OTT,25,74,29,17,46
46,8477426,Nicholas Paul,L,TBL,29,81,27,19,46
46,8475169,Evander Kane,L,EDM,33,75,26,20,46
46,8478493,Joel Eriksson Ek,C,MIN,27,76,24,22,46
46,8477935,Sam Bennett,C,FLA,28,77,17,29,46
46,8478856,Conor Garland,R,VAN,28,73,17,29,46
46,8480802,Ryan McLeod,C,BUF,25,67,17,29,46
46,8478396,Noah Hanifin,D,VGK,27,60,12,34,46
46,8477447,Shea Theodore,D,VGK,29,66,6,40,46
46,8481542,Moritz Seider,D,DET,23,77,6,40,46
46,8480893,Kirill Marchenko,R,CBJ,24,60,28,17,45
46,8476981,Josh Anderson,R,MTL,30,67,24,21,45
46,8474150,Mikael Backlund,C,CGY,35,79,22,23,45
46,8481524,Bowen Byram,D,BUF,23,69,17,28,45
46,8478115,Pierre Engvall,L,NYI,28,78,16,29,45
46,8484153,Leo Carlsson,C,ANA,20,74,15,30,45
46,8482624,Daniil Miromanov,D,CGY,27,69,12,33,45
46,8481577,Philip Tomasino,C,NSH,23,69,11,34,45
46,8482671,Owen Power,D,BUF,22,68,7,38,45
46,8479425,Filip Hronek,D,VAN,27,77,6,39,45
46,8475799,Nino Niederreiter,R,WPG,32,69,20,24,44
46,8478042,Viktor Arvidsson,L,EDM,31,73,19,25,44
46,8476880,Tom Wilson,R,WSH,30,63,18,26,44
46,8476462,Dougie Hamilton,D,NJD,31,66,13,31,44
46,8476885,Jacob Trouba,D,NYR,30,73,10,34,44
46,8482175,JJ Peterka,R,BUF,22,73,27,16,43
46,8480009,Eeli Tolvanen,R,SEA,25,75,17,26,43
46,8478472,Mathieu Joseph,R,STL,27,70,16,27,43
46,8479400,Pierre-Luc Dubois,L,WSH,26,66,12,31,43
46,8475848,Brendan Gallagher,R,MTL,32,74,11,32,43
46,8479325,Charlie McAvoy,D,BOS,27,75,7,36,43
46,8484166,Adam Fantilli,C,CBJ,20,68,19,23,42
46,8478466,Daniel Sprong,R,VAN,27,75,18,24,42
46,8478055,Gustav Forsling,D,FLA,28,73,13,29,42
46,8480028,Morgan Frost,C,PHI,25,78,11,31,42
46,8476854,Hampus Lindholm,D,BOS,30,79,8,34,42
46,8482712,Oskar Olausson,R,COL,22,79,7,35,42
46,8478474,Lawson Crouse,L,UTA,27,76,22,19,41
46,8482110,Dawson Mercer,C,NJD,23,75,21,20,41
46,8477407,Anthony Duclair,L,NYI,29,79,20,21,41
46,8477479,Tyler Bertuzzi,L,CHI,29,68,20,21,41
46,8471698,T.J. Oshie,R,WSH,38,69,19,22,41
46,8483505,Matthew Poitras,C,BOS,20,76,19,22,41
46,8476826,Yanni Gourde,C,SEA,33,71,17,24,41
46,8481618,Alex Newhook,C,MTL,23,78,15,26,41
46,8476479,Phillip Danault,C,LAK,31,81,12,29,41
46,8477346,MacKenzie Weegar,D,CGY,30,73,3,38,41
46,8481533,Trevor Zegras,C,ANA,23,65,18,22,40
46,8481523,Kirby Dach,C,MTL,23,63,15,25,40
46,8476392,Adam Lowry,C,WPG,31,62,15,25,40
46,8475314,Anders Lee,L,NYI,34,77,26,13,39
46,8478366,Frank Vatrano,R,ANA,30,72,22,17,39
46,8478542,Evan Rodrigues,C,FLA,31,77,19,20,39
46,8479339,Patrik Laine,L,CBJ,26,68,18,21,39
46,8482702,Logan Stankoven,C,DAL,21,79,18,21,39
46,8482705,Cole Sillinger,C,CBJ,21,63,15,24,39
46,8477494,Jonathan Drouin,L,COL,29,80,12,27,39
46,8479410,Mikhail Sergachev,D,UTA,26,64,10,29,39
46,8477948,Travis Sanheim,D,PHI,28,61,6,33,39
46,8476469,Joel Armia,R,MTL,31,69,23,15,38
46,8477947,Sonny Milano,L,WSH,28,69,22,16,38
46,8475714,Calle Jarnkrok,C,TOR,33,72,19,19,38
46,8477498,Darnell Nurse,D,EDM,29,73,17,21,38
46,8478057,Dakota Joshua,C,VAN,28,69,17,21,38
46,8476292,Ondrej Palat,L,NJD,33,69,15,23,38
46,8480220,Noah Cates,L,PHI,25,70,14,24,38
46,8480078,Filip Chytil,C,NYR,25,67,13,25,38
46,8476882,Teuvo Teravainen,C,CHI,30,63,10,28,38
46,8481581,Thomas Harley,D,DAL,23,72,10,28,38
46,8476869,Brady Skjei,D,NSH,30,75,8,30,38
46,8480835,Jack Drury,C,CAR,24,66,24,13,37
46,8481604,Pavel Dorofeyev,L,VGK,24,66,17,20,37
46,8482667,William Eklund,L,SJS,22,69,16,21,37
46,8481553,Bobby Brink,R,PHI,23,61,16,21,37
46,8479345,Jakob Chychrun,D,WSH,26,65,9,28,37
46,8473533,Jordan Staal,C,CAR,36,69,19,17,36
46,8479390,Taylor Raddysh,R,WSH,26,67,18,18,36
46,8479525,Ross Colton,C,COL,28,81,16,20,36
46,8479591,Michael Eyssimont,C,TBL,28,80,16,20,36
46,8479393,Noah Gregor,L,OTT,26,77,14,22,36
46,8477497,Sean Monahan,C,CBJ,30,67,13,23,36
46,8477456,J.T. Compher,L,DET,29,74,13,23,36
46,8477451,Ryan Hartman,R,MIN,30,69,13,23,36
46,8478469,Thomas Chabot,D,OTT,27,77,12,24,36
46,8477021,Alex Kerfoot,C,UTA,30,68,10,26,36
46,8476458,Ryan Strome,C,ANA,31,75,9,27,36
46,8478438,Tommy Novak,C,NSH,27,66,9,27,36
46,8480014,Gabriel Vilardi,C,WPG,25,65,24,11,35
46,8482089,Jake Neighbours,L,STL,22,65,24,11,35
46,8481554,Kaapo Kakko,R,NYR,23,66,20,15,35
46,8478233,Andrew Mangiapane,L,WSH,28,72,17,18,35
46,8474149,Evgenii Dadonov,R,DAL,35,81,17,18,35
46,8481624,Ilya Mikheyev,R,CHI,30,59,15,20,35
46,8476474,Stefan Noesen,R,NJD,31,66,14,21,35
46,8479996,Cody Glass,C,NSH,25,63,13,22,35
46,8482092,Ridly Greig,C,OTT,22,76,10,25,35
46,8482122,Brock Faber,D,MIN,22,78,8,27,35
46,8475764,Cam Fowler,D,ANA,33,73,5,30,35
46,8478500,Ivan Provorov,D,CBJ,27,81,3,32,35
46,8476958,Jaccob Slavin,D,CAR,30,73,2,33,35
46,8476438,Brandon Saad,L,STL,32,73,20,14,34
46,8480185,Eetu Luostarinen,C,FLA,26,73,16,18,34
46,8475768,Jaden Schwartz,C,SEA,32,68,14,20,34
46,8474715,Cameron Atkinson,R,TBL,35,80,12,22,34
46,8477987,Ryan Donato,C,CHI,28,67,12,22,34
46,8478133,Jake Evans,C,MTL,28,67,9,25,34
46,8476923,Damon Severson,D,CBJ,30,79,9,25,34
46,8475200,Dmitry Orlov,D,CAR,33,76,8,26,34
46,8482067,Connor Mackey,D,NYR,28,62,8,26,34
46,8475287,Erik Haula,L,NJD,33,69,14,19,33
46,8478970,Jalen Chatfield,D,CAR,28,66,12,21,33
46,8476872,Scott Laughton,C,PHI,30,72,10,23,33
46,8477495,Seth Jones,D,CHI,30,66,10,23,33
46,8473563,Nicklas Backstrom,C,WSH,37,54,10,23,33
46,8476463,Jonas Brodin,D,MIN,31,78,9,24,33
46,8474563,Drew Doughty,D,LAK,35,72,4,29,33
46,8480205,Emil Bemstrom,C,PIT,25,56,16,16,32
46,8475218,Mattias Ekholm,D,EDM,34,71,15,17,32
46,8476419,Jean-Gabriel Pageau,C,NYI,32,77,13,19,32
46,8478109,Victor Olofsson,L,VGK,29,64,12,20,32
46,8476927,Teddy Blueger,C,VAN,30,62,12,20,32
46,8482475,Yegor Chinakhov,R,CBJ,23,68,11,21,32
46,8473986,Alex Killorn,L,ANA,35,76,10,22,32
46,8474565,Alex Pietrangelo,D,VGK,34,56,10,22,32
46,8482749,Joshua Roy,R,MTL,21,68,9,23,32
46,8476480,Vladislav Namestnikov,C,WPG,32,65,9,23,32
46,8480798,Philipp Kurashev,C,CHI,25,64,7,25,32
46,8478038,Devon Toews,D,COL,30,63,6,26,32
46,8477488,Brett Pesce,D,NJD,30,73,6,26,32
46,8481560,Arthur Kaliyev,R,LAK,23,79,14,17,31
46,8480068,Ryan Poehling,C,PHI,25,72,14,17,31
46,8480813,Joe Veleno,C,DET,24,79,13,18,31
46,8480113,Alex Iafallo,L,WPG,31,63,10,21,31
46,8479402,Jake Bean,D,CGY,26,68,10,21,31
46,8479987,Morgan Geekie,C,BOS,26,72,9,22,31
46,8481546,Cam York,D,PHI,23,66,8,23,31
46,8480849,Barrett Hayton,C,UTA,24,69,7,24,31
46,8480043,Timothy Liljegren,D,TOR,25,70,6,25,31
46,8480817,K'Andre Miller,D,NYR,24,64,2,29,31
46,8476979,Erik Gustafsson,D,DET,32,69,1,30,31
46,8481535,Nils Hoglander,L,VAN,24,60,22,8,30
46,8481580,Connor McMichael,C,WSH,23,61,16,14,30
46,8478020,Michael Amadio,R,OTT,28,71,14,16,30
46,8475763,Kevin Hayes,R,PIT,32,69,13,17,30
46,8475753,Justin Faulk,D,STL,32,71,12,18,30
46,8482133,Thomas Bordeleau,C,SJS,22,57,12,18,30
46,8479351,Sam Steel,C,DAL,26,79,11,19,30
46,8479365,Trent Frederic,C,BOS,26,71,11,19,30
46,8480145,Neal Pionk,D,WPG,29,71,7,23,30
46,8477969,Marcus Pettersson,D,PIT,28,80,7,23,30
46,8482055,Drew O'Connor,L,PIT,26,62,17,12,29
46,8475760,Nick Bjugstad,C,UTA,32,68,14,15,29
46,8481582,Nicholas Robertson,L,TOR,23,68,14,15,29
46,8479661,Tanner Jeannot,L,LAK,27,77,9,20,29
46,8481656,Aliaksei Protas,C,WSH,23,65,8,21,29
46,8481703,Valtteri Puustinen,R,PIT,25,64,8,21,29
46,8482720,Matthew Knies,L,TOR,22,77,7,22,29
46,8480871,Adam Boqvist,D,FLA,24,65,7,22,29
46,8475220,Marcus Foligno,L,MIN,33,52,6,23,29
46,8479619,Michael Carcone,L,UTA,28,67,19,9,28
46,8482079,Marco Rossi,C,MIN,23,58,18,10,28
46,8480829,Jesperi Kotkaniemi,C,CAR,24,66,11,17,28
46,8476792,Torey Krug,D,STL,33,68,9,19,28
46,8475149,Marcus Johansson,L,MIN,34,65,9,19,28
46,8475193,Tomas Tatar,L,NJD,34,63,8,20,28
46,8478413,Jordan Greenway,L,BUF,27,68,3,25,28
46,8480434,Sean Durzi,D,UTA,26,67,3,25,28
46,8482125,Alexander Holtz,R,VGK,22,69,19,8,27
46,8479992,Michael Rasmussen,C,DET,25,79,17,10,27
46,8480459,Pius Suter,C,VAN,28,67,14,13,27
46,8477353,Tyler Motte,C,DET,29,70,12,15,27
46,8477989,Christian Dvorak,C,MTL,28,68,9,18,27
46,8481481,Blake Lizotte,C,PIT,27,67,8,19,27
46,8482087,Kaiden Guhle,D,MTL,22,65,7,20,27
46,8479371,Dante Fabbro,D,NSH,26,59,7,20,27
46,8476917,Adam Pelech,D,NYI,30,73,5,22,27
46,8478882,Vladislav Gavrikov,D,LAK,29,66,3,24,27
46,8476331,Dylan DeMelo,D,WPG,31,73,1,26,27
46,8481032,Paul Cotter,C,NJD,25,56,16,10,26
46,8476878,Zemgus Girgensons,C,TBL,30,79,15,11,26
46,8479316,Luke Kunin,C,SJS,27,59,13,13,26
46,8482679,Matt Coronato,R,CGY,22,61,13,13,26
46,8483524,Shane Wright,C,SEA,20,66,12,14,26
46,8481186,Logan O'Connor,R,COL,28,80,12,14,26
46,8480789,Oliver Wahlstrom,R,NYI,24,74,11,15,26
46,8477392,Hudson Fasching,R,NYI,29,69,11,15,26
46,8478891,Mason Appleton,C,WPG,28,59,10,16,26
46,8474716,Jared Spurgeon,D,MIN,35,76,10,16,26
46,8480003,Jesper Boqvist,C,FLA,26,72,10,16,26
46,8476329,Travis Boyd,C,MIN,31,59,9,17,26
46,8483445,Cutter Gauthier,L,ANA,20,61,7,19,26
46,8476312,Josh Manson,D,COL,33,66,4,22,26
46,8479398,Samuel Girard,D,COL,26,66,2,24,26
46,8477506,Ryan Pulock,D,NYI,30,76,1,25,26
46,8480144,David Kampf,C,TOR,29,70,15,10,25
46,8477952,Robby Fabbri,C,ANA,28,64,14,11,25
46,8477425,Miles Wood,L,COL,29,77,13,12,25
46,8481441,Joe Snively,C,DET,28,67,13,12,25
46,8482074,Connor Zary,C,CGY,23,62,12,13,25
46,8480855,Jack McBain,C,UTA,24,67,11,14,25
46,8483565,Nick Blankenburg,D,NSH,26,72,9,16,25
46,8476461,Sean Couturier,C,PHI,32,65,7,18,25
46,8475171,Oliver Ekman-Larsson,D,TOR,33,70,7,18,25
46,8480074,Alexandre Texier,C,STL,25,60,7,18,25
46,8476422,Mike Reilly,D,NYI,31,78,5,20,25
46,8476892,Colton Parayko,D,STL,31,70,5,20,25
46,8476918,Jimmy Vesey,L,NYR,31,68,10,14,24
46,8475842,Sam Carrick,C,NYR,32,68,10,14,24
46,8474189,Lars Eller,C,PIT,35,64,9,15,24
46,8478911,Matt Roy,D,WSH,29,60,9,15,24
46,8476921,Jordan Martinook,L,CAR,32,64,7,17,24
46,8479639,Dylan Coghlan,D,WPG,26,60,6,18,24
46,8481606,Jordan Spence,D,LAK,23,66,4,20,24
46,8474151,Ryan McDonagh,D,TBL,35,79,4,20,24
46,8479941,Justin Danforth,R,CBJ,31,59,13,10,23
46,8480336,Sean Walker,D,CAR,30,67,10,13,23
46,8475722,Jason Zucker,L,BUF,32,63,10,13,23
46,8476897,Oskar Sundqvist,C,STL,30,63,9,14,23
46,8475855,Jesper Fast,R,CAR,33,62,8,15,23
46,8482117,Lukas Reichel,L,CHI,22,56,8,15,23
46,8482660,Kent Johnson,C,CBJ,22,65,7,16,23
46,8480762,Eric Robinson,L,CAR,29,54,7,16,23
46,8476902,Esa Lindell,D,DAL,30,75,4,19,23
46,8478507,John Marino,D,UTA,27,68,4,19,23
46,8475231,Casey Cizikas,C,NYI,33,71,3,20,23
46,8480878,Nils Lundkvist,D,DAL,24,72,3,20,23
46,8480873,Rasmus Sandin,D,WSH,24,64,1,22,23
46,8482155,Alex Laferriere,R,LAK,23,67,17,5,22
46,8473422,Nick Foligno,L,CHI,37,62,15,7,22
46,8482737,Zack Bolduc,C,STL,21,58,12,10,22
46,8479066,Ryan Lomberg,L,CGY,30,64,11,11,22
46,8479520,Brandon Duhaime,R,WSH,27,58,11,11,22
46,8483457,Lane Hutson,D,MTL,20,67,10,12,22
46,8477953,Kasperi Kapanen,R,STL,28,69,9,13,22
46,8477507,Nikita Zadorov,D,BOS,29,63,8,14,22
46,8477839,Conor Sheary,L,TBL,32,82,7,15,22
46,8474053,Logan Couture,C,SJS,35,61,6,16,22
46,8478851,Alexandre Carrier,D,NSH,28,74,5,17,22
46,8477499,Rasmus Ristolainen,D,PHI,30,56,5,17,22
46,8476278,Colin Blackwell,C,DAL,31,75,4,18,22
46,8476891,Matthew Grzelcyk,D,PIT,30,76,2,20,22
46,8481014,Alexander Romanov,D,NYI,24,76,2,20,22
46,8475181,Nick Leddy,D,STL,33,70,1,21,22
46,8476873,Mark Jankowski,C,NSH,30,41,13,8,21
46,8477015,Connor Brown,R,EDM,30,68,11,10,21
46,8477505,Alexander Wennberg,C,SJS,30,64,10,11,21
46,8480980,Connor Dewar,C,TOR,25,71,10,11,21
46,8481028,Martin Pospisil,C,CGY,25,58,10,11,21
46,8475343,Nic Dowd,C,WSH,34,60,9,12,21
46,8475791,Taylor Hall,L,CHI,33,57,7,14,21
46,8482111,Justin Barron,D,MTL,23,66,7,14,21
46,8480246,Nick Perbix,D,TBL,26,73,6,15,21
46,8480073,Erik Brannstrom,D,COL,25,58,5,16,21
46,8479976,Juuso Valimaki,D,UTA,26,62,5,16,21
46,8478451,Ethan Bear,D,WSH,27,50,5,16,21
46,8479372,Joshua Mahura,D,SEA,26,64,5,16,21
46,8479980,Nicolas Hague,D,VGK,26,57,4,17,21
46,8482142,Jamie Drysdale,D,PHI,22,63,3,18,21
46,8475462,Radko Gudas,D,ANA,34,68,2,19,21
46,8481093,Rafael Harvey-Pinard,L,MTL,25,55,12,8,20
46,8479370,Tyson Jost,C,CAR,26,58,12,8,20
46,8482259,Bobby McMann,C,TOR,28,56,11,9,20
46,8479293,Brandon Tanev,L,SEA,33,65,10,10,20
46,8483466,Kevin Korchinski,D,CHI,20,67,9,11,20
46,8483468,Jiri Kulich,C,BUF,20,57,7,13,20
46,8479353,Brett Howden,C,VGK,26,74,7,13,20
46,8479368,Max Jones,L,BOS,26,67,7,13,20
46,8481522,Peyton Krebs,C,BUF,23,61,6,14,20
46,8478463,Anthony Beauvillier,L,PIT,27,64,5,15,20
46,8477435,Ryan Graves,D,PIT,29,76,5,15,20
46,8482655,Janis Moser,D,TBL,24,79,4,16,20
46,8476879,Cody Ceci,D,EDM,31,69,2,18,20
46,8480860,Kevin Bahl,D,CGY,24,57,2,18,20
46,8476822,Luke Glendening,C,TBL,35,75,14,5,19
46,8479344,Jesse Puljujarvi,R,PIT,26,57,9,10,19
46,8478013,Jake Walman,D,SJS,28,72,8,11,19
46,8478043,Sam Lafferty,C,BUF,29,58,8,11,19
46,8476925,Colton Sissons,C,NSH,31,64,7,12,19
46,8476988,Matt Benning,D,SJS,30,69,7,12,19
46,8483491,Ivan Miroshnichenko,L,WSH,20,56,6,13,19
46,8476960,Andreas Athanasiou,C,CHI,30,54,6,13,19
46,8482803,Olen Zellweger,D,ANA,21,71,6,13,19
46,8478434,Keegan Kolesar,R,VGK,27,74,6,13,19
46,8482451,Mikael Pyyhtia,L,CBJ,23,46,6,13,19
46,8477478,William Carrier,L,CAR,30,48,5,14,19
46,8476931,Jake McCabe,D,TOR,31,64,5,14,19
46,8477369,Carson Soucy,D,VAN,30,67,5,14,19
46,8481521,Ronnie Attard,D,PHI,25,55,5,14,19
46,8476429,Scott Mayfield,D,NYI,32,76,4,15,19
46,8478136,Jake Middleton,D,MIN,28,72,3,16,19
46,8475790,Erik Gudbranson,D,CBJ,32,78,2,17,19
46,8481178,Egor Zamula,D,PHI,24,54,2,17,19
46,8478416,Erik Cernak,D,TBL,27,71,1,18,19
46,8475324,Nick Jensen,D,OTT,34,66,0,19,19
46,8476467,Jamie Oleksiak,D,SEA,32,67,6,12,18
46,8480807,Mattias Samuelsson,D,BUF,24,49,6,12,18
46,8483490,Pavel Mintyukov,D,ANA,21,69,5,13,18
46,8477919,Frederick Gaudreau,C,MIN,31,62,5,13,18
46,8477979,Nicolas Aube-Kubel,R,BUF,28,54,5,13,18
46,8476874,Olli Maatta,D,DET,30,58,5,13,18
46,8481059,Scott Perunovich,D,STL,26,61,4,14,18
46,8480058,Pierre-Olivier Joseph,D,STL,25,58,4,14,18
46,8484203,Bradly Nadeau,L,CAR,19,57,3,15,18
46,8482809,Jackson Blake,R,CAR,21,56,3,15,18
46,8475279,Ben Chiarot,D,DET,33,69,2,16,18
46,8480035,Henri Jokiharju,D,BUF,25,61,1,17,18
46,8480995,Pontus Holmberg,R,TOR,25,58,11,6,17
46,8478508,Yakov Trenin,C,MIN,27,61,10,7,17
46,8482157,Will Cuylle,L,NYR,22,49,8,9,17
46,8481704,Juuso Parssinen,C,NSH,23,56,8,9,17
46,8477903,Garnet Hathaway,R,PHI,33,63,7,10,17
46,8483482,Tristan Luneau,D,ANA,20,62,7,10,17
46,8476624,Barclay Goodrow,C,SJS,31,51,7,10,17
46,8481477,Nico Sturm,C,SJS,29,57,6,11,17
46,8480806,Isac Lundestrom,C,ANA,25,61,5,12,17
46,8482101,Danil Gushchin,L,SJS,22,58,4,13,17
46,8478178,Darren Raddysh,D,TBL,28,72,3,14,17
46,8474574,Tyler Myers,D,VAN,34,70,2,15,17
46,8480887,Jordan Harris,D,MTL,24,56,2,15,17
46,8480289,Morgan Barron,C,WPG,26,53,11,5,16
46,8479944,Zach Aston-Reese,C,VGK,30,50,11,5,16
46,8480281,Alexey Toropchenko,R,STL,25,66,10,6,16
46,8483493,Frank Nazar,C,CHI,20,47,10,6,16
46,8478432,Christian Fischer,R,DET,27,71,9,7,16
46,8470621,Corey Perry,R,EDM,39,69,8,8,16
46,8480796,Martin Fehervary,D,WSH,25,57,8,8,16
46,8477018,Ben Hutton,D,VGK,31,51,7,9,16
46,8480021,Jack Studnicka,C,LAK,25,65,7,9,16
46,8481013,Jonatan Berggren,R,DET,24,63,7,9,16
46,8480025,MacKenzie Entwistle,R,FLA,25,59,7,9,16
46,8477446,Michael McCarron,R,NSH,29,61,7,9,16
46,8481601,Simon Holmstrom,R,NYI,23,58,6,10,16
46,8480845,Rasmus Kupari,C,WPG,24,46,6,10,16
46,8477406,Mattias Janmark,C,EDM,32,64,5,11,16
46,8483499,Liam Ohgren,L,MIN,20,59,5,11,16
46,8474034,Patrick Maroon,L,CHI,36,51,5,11,16
46,8479291,Kevin Rooney,C,CGY,31,51,4,12,16
46,8481527,Kaedan Korczak,D,VGK,23,44,3,13,16
46,8470600,Ryan Suter,D,STL,39,61,2,14,16
46,8479983,Mario Ferraro,D,SJS,26,67,2,14,16
46,8473507,Jeff Petry,D,DET,37,70,1,15,16
46,8479249,Andrew Poturalski,C,SJS,30,33,1,15,16
46,8479414,Nathan Bastian,R,NJD,27,59,9,6,15
46,8477573,Nathan Walker,L,STL,30,50,8,7,15
46,8476374,Sean Kuraly,C,CBJ,31,55,8,7,15
46,8480192,Johnathan Kovacevic,D,NJD,27,60,6,9,15
46,8482730,Brandt Clarke,D,LAK,21,51,6,9,15
46,8476994,Vinnie Hinostroza,C,NSH,30,47,5,10,15
46,8480748,Kiefer Sherwood,L,VAN,29,62,5,10,15
46,8480222,Sebastian Aho,D,PIT,28,68,5,10,15
46,8478421,A.J. Greer,L,FLA,28,56,5,10,15
46,8482073,Braden Schneider,D,NYR,23,71,4,11,15
46,8479671,Mathieu Olivier,R,CBJ,27,37,4,11,15
46,8475233,David Savard,D,MTL,34,58,2,13,15
46,8475188,Brayden McNabb,D,VGK,33,48,2,13,15
46,8478399,Jonas Siegenthaler,D,NJD,27,63,2,13,15
46,8480049,Dylan Samberg,D,WPG,25,70,0,15,15
46,8479336,Carl Grundstrom,R,SJS,27,50,9,5,14
46,8480448,Parker Kelly,L,COL,25,72,7,7,14
46,8478569,Noel Acciari,C,PIT,33,51,7,7,14
46,8481617,Vasily Podkolzin,R,VAN,23,43,7,7,14
46,8476934,Brock McGinn,L,ANA,30,53,6,8,14
46,8477070,Liam O'Brien,C,UTA,30,58,6,8,14
46,8479315,Joey Anderson,R,CHI,26,49,5,9,14
46,8476525,Colin Miller,D,WPG,32,64,5,9,14
46,8473453,Trevor Lewis,C,LAK,37,69,5,9,14
46,8481019,David Gustafsson,C,WPG,24,51,5,9,14
46,8477220,Nate Schmidt,D,FLA,33,59,4,10,14
46,8479026,Philippe Myers,D,TOR,27,53,4,10,14
46,8483549,Lucas Condotta,L,MTL,27,40,4,10,14
46,8483619,Filip Roos,D,OTT,25,45,4,10,14
46,8475179,Dmitry Kulikov,D,FLA,34,64,2,12,14
46,8474673,TJ Brodie,D,CHI,34,56,1,13,14
46,8482245,Artem Zub,D,OTT,29,62,1,13,14
46,8477845,Trevor van Riemsdyk,D,WSH,33,54,0,14,14
46,8477450,Jason Dickinson,C,CHI,29,54,8,5,13
46,8482659,Josh Doan,R,UTA,22,58,8,5,13
46,8479968,Vinni Lettieri,C,BOS,29,50,8,5,13
46,8482077,Dylan Holloway,L,EDM,23,53,7,6,13
46,8482145,Mavrik Bourque,C,DAL,22,54,7,6,13
46,8478585,Derek Ryan,C,EDM,38,59,6,7,13
46,8480848,Ty Dellandrea,C,SJS,24,37,6,7,13
46,8481641,Joel Kiviranta,L,COL,28,71,6,7,13
46,8482744,James Malatesta,L,CBJ,21,44,6,7,13
46,8482964,Arber Xhekaj,D,MTL,23,43,5,8,13
46,8481708,Zac Jones,D,NYR,24,42,5,8,13
46,8484149,Gavin Brindley,C,CBJ,20,53,4,9,13
46,8474612,Travis Hamonic,D,OTT,34,56,3,10,13
46,8480891,Michael Kesselring,D,UTA,24,61,1,12,13
46,8480070,Ian Mitchell,D,BOS,25,53,1,12,13
46,8477034,Jaycob Megna,D,FLA,32,51,0,13,13
46,8482762,Simon Edvinsson,D,DET,21,55,9,3,12
46,8481716,Dmitri Voronkov,L,CBJ,24,43,9,3,12
46,8476858,Phillip Di Giuseppe,L,VAN,31,42,7,5,12
46,8477508,Curtis Lazar,C,NJD,29,62,6,6,12
46,8479718,Alex Barré-Boulet,C,MTL,27,45,6,6,12
46,8476457,Adam Larsson,D,SEA,32,60,6,6,12
46,8482496,Nils Aman,C,VAN,24,36,6,6,12
46,8481147,Reese Johnson,C,MIN,26,43,6,6,12
46,8477931,Tomas Nosek,L,FLA,32,59,5,7,12
46,8478831,Kevin Stenlund,C,UTA,28,54,5,7,12
46,8482652,Walker Duehr,R,CGY,27,45,5,7,12
46,8476967,Brett Kulak,D,EDM,30,63,4,8,12
46,8481517,Brett Leason,R,ANA,25,58,4,8,12
46,8479998,Mikey Anderson,D,LAK,25,57,4,8,12
46,8481600,Tobias Bjornfot,D,FLA,23,45,3,9,12
46,8478874,Adam Gaudette,R,OTT,28,36,2,10,12
46,8477365,Connor Clifton,D,BUF,29,60,1,11,12
46,8482095,Tyler Kleven,D,OTT,22,42,1,11,12
46,8475225,Craig Smith,C,CHI,35,45,6,5,11
46,8482148,Hendrix Lapierre,C,WSH,22,48,5,6,11
46,8479543,Michael Pezzetta,L,MTL,26,47,5,6,11
46,8480355,Mark Kastelic,C,BOS,25,62,5,6,11
46,8476442,Matt Nieto,L,PIT,32,46,5,6,11
46,8482166,Shakir Mukhamadullin,D,SJS,22,59,4,7,11
46,8479324,Ryan Lindgren,D,NYR,26,60,3,8,11
46,8482062,Cole Smith,L,NSH,29,55,3,8,11
46,8478452,Caleb Jones,D,LAK,27,59,3,8,11
46,8475208,Brian Dumoulin,D,ANA,33,64,3,8,11
46,8482634,Alex Steeves,C,TOR,25,50,2,9,11
46,8482747,Brennan Othmann,L,NYR,21,48,2,9,11
46,8477851,Jordan Oesterle,D,BOS,32,38,2,9,11
46,8475455,Brenden Dillon,D,NJD,34,55,1,10,11
46,8474090,Brendan Smith,D,DAL,35,54,1,10,11
46,8480172,Jan Rutta,D,SJS,34,64,1,10,11
46,8481598,Philip Broberg,D,EDM,23,46,1,10,11
46,8478450,Parker Wotherspoon,D,BOS,27,37,1,10,11
46,8478840,Will Borgen,D,SEA,28,66,0,11,11
46,8475690,Chris Tanev,D,TOR,35,55,0,11,11
46,8480011,Klim Kostin,C,SJS,25,55,6,4,10
46,8478211,Dryden Hunt,L,CGY,29,55,6,4,10
46,8480245,Olle Lycksell,R,PHI,25,33,6,4,10
46,8479439,Jacob MacDonald,D,COL,31,47,5,5,10
46,8478409,Anthony Richard,C,PHI,28,33,5,5,10
46,8481532,Alex Turcotte,C,LAK,23,37,5,5,10
46,8478443,Brandon Carlo,D,BOS,28,62,4,6,10
46,8480252,Cole Guttman,C,CHI,25,33,4,6,10
46,8479536,Axel Jonsson-Fjallby,L,WPG,26,37,4,6,10
46,8482666,Scott Morrow,D,CAR,22,58,4,6,10
46,8481167,Brayden Pachal,D,CGY,25,41,4,6,10
46,8479369,Andrew Peeke,D,BOS,26,54,4,6,10
46,8482192,Isaak Phillips,D,CHI,23,51,3,7,10
46,8478424,Jansen Harkins,C,ANA,27,46,3,7,10
46,8481161,Jake Christiansen,D,CBJ,25,58,3,7,10
46,8479359,Beck Malenstyn,L,BUF,26,45,2,8,10
46,8481537,Nikita Okhotiuk,D,CGY,24,51,2,8,10
46,8473446,Erik Johnson,D,PHI,36,61,2,8,10
46,8474013,Ian Cole,D,UTA,35,47,2,8,10
46,8483460,David Jiricek,D,CBJ,21,56,1,9,10
46,8479982,Conor Timmins,D,TOR,26,47,1,9,10
46,8480727,Zach Whitecloud,D,VGK,28,53,0,10,10
46,8476372,Nick Seeler,D,PHI,31,47,0,10,10
46,8481518,Nolan Foote,L,NJD,24,39,5,4,9
46,8481592,Jakob Pelletier,L,CGY,23,39,4,5,9
46,8483012,Logan Morrison,C,SEA,22,39,4,5,9
46,8479772,Zack MacEwen,R,OTT,28,50,4,5,9
46,8479587,Rhett Gardner,C,PHI,28,18,4,5,9
46,8480157,Calle Rosen,D,COL,30,48,3,6,9
46,8481609,Vladislav Kolyachonok,D,UTA,23,37,3,6,9
46,8480196,Jacob Bryson,D,BUF,27,40,3,6,9
46,8479328,Julien Gauthier,R,NYI,27,57,2,7,9
46,8482765,Isak Rosen,R,BUF,21,37,2,7,9
46,8474567,Zach Bogosian,D,MIN,34,57,2,7,9
46,8481701,Santeri Hatakka,D,NJD,23,36,1,8,9
46,8477887,Patrick Brown,C,BOS,32,46,1,8,9
46,8479638,Justin Brazeau,R,BOS,26,41,5,3,8
46,8480844,Grigori Denisenko,L,VGK,24,25,4,4,8
46,8478017,Mark Friedman,D,VAN,29,42,4,4,8
46,8482141,Lukas Cormier,D,VGK,22,31,3,5,8
46,8475235,Nicolas Deslauriers,L,PHI,33,49,3,5,8
46,8476867,Brendan Gaunce,C,MIN,30,36,3,5,8
46,8479994,Jaret Anderson-Dolan,C,WPG,25,40,3,5,8
46,8479972,Mason Shaw,C,WPG,26,45,2,6,8
46,8481567,Henry Thrun,D,SJS,23,46,2,6,8
46,8481605,Jackson LaCombe,D,ANA,23,33,2,6,8
46,8477962,Brendan Lemieux,L,CAR,28,34,2,6,8
46,8476441,Joel Edmundson,D,LAK,31,45,2,6,8
46,8479379,Givani Smith,R,SJS,26,28,2,6,8
46,8478502,Dennis Gilbert,D,BUF,28,23,2,6,8
46,8478468,Jeremy Lauzon,D,NSH,27,48,1,7,8
46,8479442,Troy Stecher,D,EDM,30,54,1,7,8
46,8481568,Alex Vlasic,D,CHI,23,54,0,8,8
46,8475718,Justin Holl,D,DET,32,56,0,8,8
46,8480007,Jonas Rondbjerg,R,VGK,25,42,0,8,8
46,8476889,Radek Faksa,C,STL,30,49,4,3,7
46,8482807,Ethan Del Mastro,D,CHI,21,40,4,3,7
46,8480441,Trey Fix-Wolansky,R,CBJ,25,41,4,3,7
46,8481599,Victor Soderstrom,D,UTA,23,37,3,4,7
46,8477482,Zachary Sanford,L,CHI,30,48,3,4,7
46,8479348,Kale Clague,D,BUF,26,41,3,4,7
46,8482070,Mitchell Chaffee,R,TBL,26,54,3,4,7
46,8471709,Marc-Edouard Vlasic,D,SJS,37,52,3,4,7
46,8477335,Kyle Burroughs,D,LAK,29,48,3,4,7
46,8483763,Maksymilian Szuber,D,UTA,22,42,3,4,7
46,8478859,Niko Mikkola,D,FLA,28,56,2,5,7
46,8477938,Haydn Fleury,D,WPG,28,42,2,5,7
46,8480950,Ilya Lyubushkin,D,DAL,30,66,2,5,7
46,8482176,Wyatt Kaiser,D,CHI,22,58,1,6,7
46,8474166,Alec Martinez,D,CHI,37,52,1,6,7
46,8477971,Andreas Englund,D,LAK,28,24,1,6,7
46,8480879,Jacob Bernard-Docker,D,OTT,24,40,1,6,7
46,8477384,Joshua Brown,D,EDM,30,43,1,6,7
46,8480001,Urho Vaakanainen,D,ANA,25,52,0,7,7
46,8482858,Ryker Evans,D,SEA,23,19,0,7,7
46,8482511,Mason Lohrei,D,BOS,23,31,5,1,6
46,8476856,Mathew Dumba,D,DAL,30,70,4,2,6
46,8484911,Collin Graf,R,SJS,22,40,3,3,6
46,8481789,Tye Kartye,L,SEA,23,44,3,3,6
46,8482733,Logan Mailloux,D,MTL,31,34,3,3,6
46,8479981,Jonah Gadjovich,L,FLA,26,52,3,3,6
46,8483630,Pavol Regenda,L,ANA,25,25,3,3,6
46,8480292,Carson Meyer,R,ANA,27,32,3,3,6
46,8479986,Kole Lind,R,DAL,26,45,3,3,6
46,8478021,William Lagesson,D,DET,28,38,3,3,6
46,8482177,Marat Khusnutdinov,C,MIN,22,30,3,3,6
46,8481751,Lukas Rousek,R,BUF,25,28,2,4,6
46,8477527,Ross Johnston,L,ANA,30,29,2,4,6
46,8477380,Jonny Brodzinski,C,NYR,31,51,1,5,6
46,8482859,Zack Ostapchuk,C,OTT,21,48,1,5,6
46,8481122,Simon Benoit,D,TOR,26,45,1,5,6
46,8481056,Spencer Stastney,D,NSH,24,31,1,5,6
46,8477073,Kurtis MacDermid,L,NJD,30,32,1,5,6
46,8480990,Declan Chisholm,D,MIN,24,40,0,6,6
46,8480870,Bo Groulx,C,NYR,24,29,4,1,5
46,8483570,Ben Meyers,C,SEA,26,32,3,2,5
46,8479378,Logan Stanley,D,WPG,26,34,3,2,5
46,8482784,Zach Dean,C,STL,21,31,3,2,5
46,8482751,Ryan Winterton,C,SEA,21,33,3,2,5
46,8480890,Jan Jenik,C,OTT,24,33,3,2,5
46,8482470,Ilya Solovyov,D,CGY,24,24,3,2,5
46,8478011,Louie Belpedio,D,PHI,28,12,3,2,5
46,8475762,Derek Forbort,D,VAN,32,38,2,3,5
46,8481462,Mason Morelli,L,VGK,28,18,2,3,5
46,8482516,Matthew Kessel,D,STL,24,19,2,3,5
46,8481550,Adam Beckman,L,NJD,23,39,1,4,5
46,8483495,Simon Nemec,D,NJD,20,54,1,4,5
46,8478146,Matthew Highmore,C,OTT,28,36,1,4,5
46,8479576,Vincent Desharnais,D,VAN,28,32,1,4,5
46,8478477,Mitchell Stephens,C,SEA,27,22,1,4,5
46,8475177,Calvin de Haan,D,COL,33,52,0,5,5
46,8482861,Vincent Iorio,D,WSH,22,31,0,5,5
46,8480834,Ty Emberson,D,SJS,24,33,0,5,5
46,8477244,Chad Ruhwedel,D,NYR,34,39,0,5,5
46,8481743,Marc Del Gaizo,D,NSH,25,18,0,5,5
46,8481065,Angus Crookshank,L,OTT,25,15,4,0,4
46,8481754,Nikita Nesterenko,C,ANA,23,31,3,1,4
46,8481556,John Beecher,C,BOS,23,34,3,1,4
46,8477473,Justin Bailey,R,SJS,29,30,3,1,4
46,8480880,Jakub Lauko,C,MIN,24,37,3,1,4
46,8482094,Daemon Hunt,D,MIN,22,17,3,1,4
46,8482172,Landon Slaggert,L,CHI,22,30,3,1,4
46,8481543,Nikita Alexandrov,C,STL,24,31,2,2,4
46,8479362,Riley Tufte,L,BOS,26,24,2,2,4
46,8474568,Luke Schenn,D,NSH,35,37,1,3,4
46,8471817,Ryan Reaves,R,TOR,37,49,1,3,4
46,8471677,Jack Johnson,D,CBJ,37,59,1,3,4
46,8476473,Connor Murphy,D,CHI,31,36,1,3,4
46,8476913,Devin Shore,C,MIN,30,36,1,3,4
46,8482162,Roby Jarventie,L,EDM,22,17,1,3,4
46,8477810,Joel Hanley,D,CGY,33,19,1,3,4
46,8482147,Jean-Luc Foudy,C,COL,22,25,1,3,4
46,8479320,Maxime Lajoie,D,SEA,27,24,1,3,4
46,8475958,Michael Sgarbossa,C,WSH,32,27,0,4,4
46,8484258,Sam Malinski,D,COL,26,23,0,4,4
46,8482144,Jack Thompson,D,SJS,22,30,0,4,4
46,8480874,Adam Ginning,D,PHI,24,14,0,4,4
46,8476952,Dominic Toninato,C,WPG,30,35,2,1,3
46,8477401,John Hayden,C,SEA,29,31,2,1,3
46,8479367,William Lockwood,R,FLA,26,27,2,1,3
46,8480084,Nick DeSimone,D,NJD,30,11,2,1,3
46,8480267,Sammy Walker,C,MIN,25,12,2,1,3
46,8483397,Marc McLaughlin,C,BOS,25,23,2,1,3
46,8481585,Egor Afanasyev,L,SJS,23,10,2,1,3
46,8482460,Matt Rempe,C,NYR,22,12,2,1,3
46,8481030,Jack St. Ivany,D,PIT,25,22,2,1,3
46,8478446,Glenn Gawdin,C,LAK,27,10,2,1,3
46,8475750,Jon Merrill,D,MIN,32,61,1,2,3
46,8481679,Maxence Guenette,D,OTT,23,30,1,2,3
46,8481541,Samuel Bolduc,D,NYI,24,29,1,2,3
46,8484254,Akito Hirose,D,VAN,25,33,0,3,3
46,8478454,Noah Juulsen,D,VAN,27,32,0,3,3
46,8479985,Cale Fleury,D,SEA,26,28,0,3,3
46,8477320,Anton Blidh,L,NYR,29,19,0,3,3
46,8475795,Dylan McIlrath,D,WSH,32,19,0,3,3
46,8482250,Callahan Burke,C,VGK,27,24,0,3,3
46,8482165,Yan Kuznetsov,D,CGY,22,21,0,3,3
46,8479991,Jake Leschyshyn,C,NYR,25,26,2,0,2
46,8479419,Brett Murray,L,BUF,26,15,2,0,2
46,8481237,Kyle MacLean,C,NYI,25,23,2,0,2
46,8482118,Sam Colangelo,R,ANA,23,15,2,0,2
46,8484325,Waltteri Merela,C,TBL,26,24,2,0,2
46,8480823,Alexander Alexeyev,D,WSH,25,17,2,0,2
46,8482153,Brendan Brisson,C,VGK,23,26,1,1,2
46,8482102,Vasily Ponomarev,C,PIT,22,13,1,1,2
46,8481578,Graeme Clarke,R,MIN,23,10,1,1,2
46,8481006,Tyler Tucker,D,STL,24,14,1,1,2
46,8481422,Jake Lucchini,C,NSH,29,19,1,1,2
46,8482197,Adam Raska,R,MIN,23,8,1,1,2
46,8483512,Matthew Savoie,C,EDM,20,21,1,1,2
46,8477149,Scott Sabourin,R,SJS,32,15,0,2,2
46,8481564,Ryan Johnson,D,BUF,23,11,0,2,2
46,8477462,Robert Hagg,D,VGK,29,26,0,2,2
46,8482088,Justin Sourdif,R,FLA,22,14,0,2,2
46,8481593,Jayden Struble,D,MTL,23,26,0,2,2
46,8480075,Cameron Crotty,D,MIN,25,13,0,2,2
46,8481806,Louis Crevier,D,CHI,23,12,0,2,2
46,8474062,Riley Nash,C,NYR,35,20,0,2,2
46,8480468,James Hamblin,L,EDM,25,22,0,2,2
46,8482713,Mackie Samoskevich,R,FLA,22,22,1,0,1
46,8480032,Shane Bowers,C,NJD,25,19,1,0,1
46,8482201,Gage Goncalves,C,TBL,23,23,1,0,1
46,8481699,Aku Raty,R,UTA,23,12,1,0,1
46,8482929,Emil Lilleberg,D,TBL,23,21,1,0,1
46,8480851,Akil Thomas,C,LAK,24,19,1,0,1
46,8483398,Declan Carlile,D,TBL,31,6,1,0,1
46,8476323,Max McCormick,L,SEA,32,5,1,0,1
46,8475780,Chris Wagner,R,COL,33,10,1,0,1
46,8484255,Jason Polin,R,COL,25,5,1,0,1
46,8481719,Maxwell Crozier,D,TBL,24,14,0,1,1
46,8481043,Cole Koepke,L,BOS,26,11,0,1,1
46,8483407,Brandon Scanlin,D,NYR,25,8,0,1,1
46,8475413,Justin Dowling,C,NJD,34,12,0,1,1
46,8483395,Arshdeep Bains,L,VAN,23,14,0,1,1
46,8482061,Brandon Biro,L,SEA,26,7,0,1,1
46,8483546,Marshall Rifai,D,TOR,26,3,0,1,1
46,8480306,Grant Hutton,D,NYI,29,6,0,1,1
46,8481024,Linus Karlsson,C,VAN,25,9,0,1,1
46,8478147,Bokondji Imama,L,PIT,28,8,0,1,1
46,8481206,John Ludvig,D,PIT,24,6,0,0,0
46,8477467,Gustav Olofsson,D,SEA,30,15,0,0,0
46,8481726,Adam Edstrom,C,NYR,24,5,0,0,0
46,8483489,Fraser Minten,C,TOR,31,14,0,0,0
46,8479421,Jacob Moverare,D,LAK,26,4,0,0,0
46,8478881,Brett Seney,L,CHI,28,12,0,0,0
46,8484287,Cole McWard,D,VAN,23,24,0,0,0
46,8482787,Nikita Chibrikov,R,WPG,31,6,0,0,0
46,8478051,Max Willman,C,NJD,29,21,0,0,0
46,8483432,Luca Del Bel Belluz,C,CBJ,31,1,0,0,0
46,8483920,Pierrick Dube,R,WSH,23,5,0,0,0
46,8484259,Ondrej Pavel,C,COL,31,4,0,0,0
46,8483567,Georgii Merkulov,C,BOS,24,10,0,0,0
46,8484304,Uvis Balinskis,D,FLA,28,6,0,0,0
46,8483597,Milos Kelemen,L,UTA,25,9,0,0,0
46,8479330,Brandon Gignac,C,MTL,27,10,0,0,0
46,8477993,Justin Kirkland,C,CGY,28,3,0,0,0
46,8483471,Brad Lambert,C,WPG,31,8,0,0,0
46,8475755,Alexander Petrovic,D,DAL,32,5,0,0,0
46,8478854,Ryan Shea,D,PIT,27,9,0,0,0
46,8477541,Dakota Mermis,D,TOR,30,15,0,0,0
46,8484321,Nikolas Matinpalo,D,OTT,26,1,0,0,0
46,8482476,Emil Heineman,L,MTL,23,3,0,0,0
46,8482126,Emil Andrae,D,PHI,31,3,0,0,0
46,8484326,Patrik Koch,D,UTA,28,7,0,0,0
46,8479522,Hardy Haman Aktell,D,WSH,26,3,0,0,0
46,8483531,Brian Halonen,L,NJD,25,3,0,0,0
46,8481655,Cole Schwindt,R,CGY,23,4,0,0,0
46,8481534,Raphael Lavoie,C,EDM,24,2,0,0,0
46,8483609,Adam Klapka,R,CGY,24,3,0,0,0
46,8480274,Philip Kemp,D,EDM,25,1,0,0,0
46,8483401,Marc Johnstone,R,PIT,28,0,0,0,0
46,8470794,Joe Pavelski,C,,40,0,0,0,0
46,8479321,Lucas Johansen,D,,27,0,0,0,0
46,8477950,Tony DeAngelo,D,,29,0,0,0,0
46,8471218,Blake Wheeler,R,,38,0,0,0,0
46,8475197,Tyson Barrie,D,,33,0,0,0,0
46,8474157,Max Pacioretty,L,,36,0,0,0,0
46,8475744,Evgeny Kuznetsov,C,,32,0,0,0,0
46,8474037,James van Riemsdyk,L,,35,0,0,0,0
46,8476907,Mackenzie MacEachern,L,,30,0,0,0,0
46,8480216,Jacob Peterson,C,,25,0,0,0,0
46,8474602,Justin Schultz,D,,34,0,0,0,0
46,8482222,Alexander Barabanov,L,,30,0,0,0,0
46,8474031,Kevin Shattenkirk,D,,35,0,0,0,0
46,8477330,Dominik Kubalik,L,,29,0,0,0,0
46,8480884,Calen Addison,D,,24,0,0,0,0
46,8475906,John Klingberg,D,,32,0,0,0,0
46,8480008,Adam Ruzicka,C,,25,0,0,0,0
46,8476884,Derrick Pouliot,D,,30,0,0,0,0
46,8476919,Chris Tierney,C,,30,0,0,0,0
46,8479415,Michael McLeod,C,,26,0,0,0,0
46,8474870,Tyler Johnson,C,,34,0,0,0,0
46,8470604,Jeff Carter,C,,39,0,0,0,0
46,8478104,Sammy Blais,L,,28,0,0,0,0
46,8474884,Mike Hoffman,C,,35,0,0,0,0
46,8481591,Sam Poulin,R,,23,0,0,0,0
46,8471274,Alex Goligoski,D,,39,0,0,0,0
46,8476871,Tanner Pearson,L,,32,0,0,0,0
46,8476393,Nick Cousins,C,,31,0,0,0,0
46,8479977,Kailer Yamamoto,R,,26,0,0,0,0
46,8479346,Dillon Dube,C,,26,0,0,0,0
46,8480184,Gustav Lindstrom,D,,26,0,0,0,0
46,8479376,Victor Mete,D,,26,0,0,0,0
46,8473449,Kyle Okposo,R,,36,0,0,0,0
46,8481058,Jesse Ylonen,R,,25,0,0,0,0
46,8475752,Tyler Pitlick,C,,33,0,0,0,0
46,8481239,Samuel Fagemo,L,,24,0,0,0,0
46,8480821,Filip Zadina,R,,25,0,0,0,0
46,8470966,Mark Giordano,D,,41,0,0,0,0
46,8478495,Denis Gurianov,R,,27,0,0,0,0
46,8477464,Nic Petan,C,,29,0,0,0,0
46,8478099,Kevin Labanc,R,,29,0,0,0,0
46,8482241,Radim Zohorna,L,,28,0,0,0,0
46,8474040,Sam Gagner,C,,35,0,0,0,0
46,8479514,Rem Pitlick,C,,27,0,0,0,0
46,8478430,Oliver Kylington,D,,27,0,0,0,0
46,8479533,Joona Koppanen,L,,26,0,0,0,0
46,8479984,Cal Foote,D,,26,0,0,0,0
46,8477126,Jayson Megna,C,,34,0,0,0,0
46,8475164,Jakob Silfverberg,R,,34,0,0,0,0
46,8474009,Nick Bonino,C,,36,0,0,0,0
46,8479458,Nikita Zaitsev,D,,33,0,0,0,0
46,8477944,Jakub Vrana,L,,28,0,0,0,0
46,8471699,Andrew Cogliano,C,,37,0,0,0,0
46,8478067,Oskar Lindblom,L,,28,0,0,0,0
46,8471686,Marc Staal,D,,37,0,0,0,0
46,8470610,Zach Parise,L,,40,0,0,0,0
46,8478904,Steven Lorentz,C,,28,0,0,0,0
46,8473473,Milan Lucic,L,,36,0,0,0,0
46,8480031,Maxime Comtois,L,,25,0,0,0,0
46,8478512,Austin Czarnik,C,,32,0,0,0,0
46,8473504,Cal Clutterbuck,R,,37,0,0,0,0
46,8477454,Adam Erne,L,,29,0,0,0,0
46,8479383,Boris Katchouk,L,,26,0,0,0,0
46,8475825,Jani Hakanpää,D,,32,0,0,0,0
46,8477846,Ryan Carpenter,C,,33,0,0,0,0
46,8477930,Pierre-Edouard Bellemare,L,,39,0,0,0,0
46,8478400,Colin White,C,,27,0,0,0,0
46,8480226,Marián Studenic,R,,26,0,0,0,0
46,8480853,Liam Foudy,C,,24,0,0,0,0
46,8475797,Jarred Tinordi,D,,32,0,0,0,0
46,8479423,Alex Nylander,L,,26,0,0,0,0
46,8474618,Marco Scandella,D,,34,0,0,0,0
46,8478028,Fredrik Olofsson,L,,28,0,0,0,0
46,8474709,Matt Martin,L,,35,0,0,0,0
46,8481070,Hugh McGing,L,,26,0,0,0,0
46,8479546,Oskar Steen,C,,26,0,0,0,0
46,8474145,Robert Bortuzzo,D,,35,0,0,0,0
46,8476915,Jujhar Khaira,L,,30,0,0,0,0
46,8475278,Byron Froese,C,,33,0,0,0,0
46,8481812,Nikolai Knyzhov,D,,27,0,0,0,0
46,8478408,Travis Dermott,D,,28,0,0,0,0
46,8481077,John Leonard,L,,26,0,0,0,0
46,8479547,Matthew Phillips,R,,26,0,0,0,0
46,8480836,Jonathan Gruden,C,,24,0,0,0,0
46,8481690,Tyler Angle,C,,24,0,0,0,0
46,8475766,Austin Watson,L,,32,0,0,0,0
46,8481016,Ruslan Iskhakov,C,,24,0,0,0,0
46,8478078,Rourke Chartier,C,,28,0,0,0,0
46,8480776,Sheldon Rempal,R,,29,0,0,0,0
46,8478956,Samuel Laberge,L,NJD,27,0,0,0,0
46,8483045,Cameron Butler,R,CBJ,31,2,0,0,0
46,8484314,Jiri Smejkal,L,,28,0,0,0,0
47,8478402,Connor McDavid,C,EDM,27,76,55,96,151
47,8477492,Nathan MacKinnon,C,COL,29,81,54,76,130
47,8478550,Artemi Panarin,L,NYR,33,79,36,94,130
47,8476453,Nikita Kucherov,R,TBL,31,82,33,92,125
47,8478864,Kirill Kaprizov,L,MIN,27,69,57,61,118
47,8477934,Leon Draisaitl,C,EDM,29,79,44,72,116
47,8477939,William Nylander,R,TOR,28,77,53,60,113
47,8479318,Auston Matthews,C,TOR,27,80,55,56,111
47,8478483,Mitch Marner,R,TOR,27,81,31,77,108
47,8476887,Filip Forsberg,L,NSH,30,71,61,46,107
47,8479314,Matthew Tkachuk,L,FLA,27,77,29,77,106
47,8477956,David Pastrnak,R,BOS,28,81,47,58,105
47,8480069,Cale Makar,D,COL,26,74,25,78,103
47,8478403,Jack Eichel,C,VGK,28,75,45,55,100
47,8480027,Jason Robertson,L,DAL,25,81,42,58,100
47,8478010,Brayden Point,C,TBL,28,82,41,57,98
47,8481557,Matt Boldy,L,MIN,23,74,38,60,98
47,8476468,J.T. Miller,C,VAN,31,74,32,66,98
47,8476459,Mika Zibanejad,C,NYR,31,77,40,57,97
47,8479420,Tage Thompson,C,BUF,27,75,52,41,93
47,8481559,Jack Hughes,C,NJD,23,76,39,53,92
47,8477942,Kevin Fiala,L,LAK,28,81,30,62,92
47,8477933,Sam Reinhart,C,FLA,29,82,42,49,91
47,8480012,Elias Pettersson,C,VAN,26,75,33,58,91
47,8480002,Nico Hischier,C,NJD,25,76,33,58,91
47,8480800,Quinn Hughes,D,VAN,25,78,12,79,91
47,8478420,Mikko Rantanen,R,COL,28,78,38,52,90
47,8477404,Jake Guentzel,C,TBL,30,82,34,55,89
47,8471685,Anze Kopitar,C,LAK,37,82,33,55,88
47,8477501,Valeri Nichushkin,R,COL,29,82,41,45,86
47,8474564,Steven Stamkos,C,NSH,34,74,38,48,86
47,8475810,Bryan Rust,R,PIT,32,77,38,48,86
47,8471675,Sidney Crosby,C,PIT,37,72,44,41,85
47,8477493,Aleksander Barkov,C,FLA,29,80,30,54,84
47,8480023,Robert Thomas,C,STL,25,79,29,55,84
47,8480018,Nick Suzuki,C,MTL,25,80,24,60,84
47,8475166,John Tavares,C,TOR,34,78,36,47,83
47,8478427,Sebastian Aho,C,CAR,27,75,33,50,83
47,8477946,Dylan Larkin,C,DET,28,79,40,42,82
47,8478444,Brock Boeser,R,VAN,27,76,33,49,82
47,8473419,Brad Marchand,L,BOS,36,80,28,54,82
47,8480801,Brady Tkachuk,L,OTT,25,80,35,46,81
47,8482116,Tim Stützle,C,OTT,22,80,29,52,81
47,8476389,Vincent Trocheck,C,NYR,31,76,32,48,80
47,8479407,Jesper Bratt,L,NJD,26,73,29,51,80
47,8479323,Adam Fox,D,NYR,26,72,22,56,78
47,8480036,Miro Heiskanen,D,DAL,25,78,10,67,77
47,8479675,Trevor Moore,L,LAK,29,81,42,34,76
47,8479343,Clayton Keller,R,UTA,26,75,37,39,76
47,8476881,Tomas Hertl,C,VGK,31,77,34,42,76
47,8478414,Timo Meier,R,NJD,28,76,32,44,76
47,8478398,Kyle Connor,L,WPG,28,73,31,45,76
47,8477409,Carter Verhaeghe,C,FLA,29,74,33,42,75
47,8478440,Dylan Strome,C,WSH,27,76,29,46,75
47,8478445,Mathew Barzal,C,NYI,27,79,16,59,75
47,8478460,Zach Werenski,D,CBJ,27,81,15,59,74
47,8479337,Alex DeBrincat,R,DET,27,82,36,37,73
47,8478449,Roope Hintz,C,DAL,28,82,29,44,73
47,8476454,Ryan Nugent-Hopkins,C,EDM,31,81,23,49,72
47,8482740,Wyatt Johnston,C,DAL,21,79,38,33,71
47,8475692,Mats Zuccarello,R,MIN,37,67,17,54,71
47,8479385,Jordan Kyrou,C,STL,26,75,33,37,70
47,8477955,Jared McCann,L,SEA,28,76,31,39,70
47,8475158,Ryan O'Reilly,C,NSH,33,73,27,43,70
47,8478975,Mason Marchment,L,DAL,29,82,24,46,70
47,8482124,Quinton Byfield,R,LAK,22,80,24,46,70
47,8474600,Roman Josi,D,NSH,34,75,14,56,70
47,8475184,Chris Kreider,L,NYR,33,75,37,32,69
47,8475172,Nazem Kadri,C,CGY,34,78,27,42,69
47,8480830,Andrei Svechnikov,R,CAR,24,68,22,47,69
47,8477940,Nikolaj Ehlers,L,WPG,28,71,17,52,69
47,8471214,Alex Ovechkin,L,WSH,39,74,38,30,68
47,8477960,Adrian Kempe,R,LAK,28,80,31,37,68
47,8476460,Mark Scheifele,C,WPG,31,72,28,40,68
47,8477402,Pavel Buchnevich,L,STL,29,71,26,42,68
47,8477951,Nick Schmaltz,C,UTA,28,71,25,43,68
47,8475794,Tyler Seguin,C,DAL,32,82,28,39,67
47,8479999,Casey Mittelstadt,C,COL,26,79,21,46,67
47,8477500,Bo Horvat,C,NYI,29,81,33,33,66
47,8474141,Patrick Kane,R,DET,36,80,26,40,66
47,8475168,Matt Duchene,C,DAL,33,81,26,40,66
47,8478469,Thomas Chabot,D,OTT,27,76,19,46,65
47,8482078,Lucas Raymond,L,DET,22,81,24,40,64
47,8480839,Rasmus Dahlin,D,BUF,24,68,19,45,64
47,8476456,Jonathan Huberdeau,C,CGY,31,76,14,50,64
47,8477476,Artturi Lehkonen,L,COL,29,81,32,31,63
47,8482109,Alexis Lafrenière,L,NYR,23,75,29,34,63
47,8480208,Drake Batherson,R,OTT,26,73,23,40,63
47,8482665,Matty Beniers,C,SEA,22,73,23,40,63
47,8471215,Evgeni Malkin,C,PIT,38,80,19,44,63
47,8478407,Vince Dunn,D,SEA,28,74,9,54,63
47,8481540,Cole Caufield,R,MTL,23,74,28,34,62
47,8478493,Joel Eriksson Ek,C,MIN,27,72,28,34,62
47,8477494,Jonathan Drouin,L,COL,29,81,21,41,62
47,8473512,Claude Giroux,R,OTT,36,80,17,45,62
47,8475913,Mark Stone,R,VGK,32,75,16,46,62
47,8478439,Travis Konecny,R,PHI,27,77,26,35,61
47,8480039,Martin Necas,C,CAR,25,73,26,35,61
47,8475784,Jeff Skinner,C,EDM,32,75,25,36,61
47,8478873,Troy Terry,R,ANA,27,73,21,40,61
47,8475167,Victor Hedman,D,TBL,34,80,10,51,61
47,8478498,Jake DeBrusk,L,VAN,28,72,31,29,60
47,8477496,Elias Lindholm,C,BOS,30,76,26,34,60
47,8475191,Reilly Smith,R,NYR,33,74,20,40,60
47,8474679,Gustav Nyquist,C,NSH,35,71,20,40,60
47,8476539,Jonathan Marchessault,R,NSH,34,73,32,27,59
47,8477949,Alex Tuch,R,BUF,28,77,21,38,59
47,8478047,Michael Bunting,L,PIT,29,68,17,42,59
47,8476346,Johnny Gaudreau,L,CBJ,31,71,14,45,59
47,8482093,Seth Jarvis,C,CAR,22,73,31,27,58
47,8481068,Yegor Sharangovich,C,CGY,26,79,30,28,58
47,8473986,Alex Killorn,L,ANA,35,72,28,30,58
47,8480188,Fabian Zetterlund,L,SJS,25,66,19,39,58
47,8481596,Shane Pinto,C,OTT,24,74,19,39,58
47,8476462,Dougie Hamilton,D,NJD,31,74,19,39,58
47,8480865,Noah Dobson,D,NYI,24,79,6,52,58
47,8479542,Brandon Hagel,L,TBL,26,82,30,27,57
47,8477407,Anthony Duclair,L,NYI,29,77,29,28,57
47,8478519,Anthony Cirelli,C,TBL,27,82,27,30,57
47,8482113,Anton Lundell,C,FLA,23,79,27,30,57
47,8484144,Connor Bedard,C,CHI,19,65,23,34,57
47,8476479,Phillip Danault,C,LAK,31,77,17,40,57
47,8477504,Josh Morrissey,D,WPG,29,77,15,42,57
47,8475754,Brock Nelson,C,NYI,33,81,32,24,56
47,8477416,Oliver Bjorkstrand,R,SEA,29,71,23,33,56
47,8476880,Tom Wilson,R,WSH,30,72,23,33,56
47,8483515,Juraj Slafkovsky,L,MTL,20,74,22,34,56
47,8478401,Pavel Zacha,C,BOS,27,80,21,35,56
47,8473994,Jamie Benn,L,DAL,35,82,19,37,56
47,8471724,Kris Letang,D,PIT,37,79,18,38,56
47,8476448,William Karlsson,C,VGK,31,72,17,39,56
47,8474578,Erik Karlsson,D,PIT,34,76,15,41,56
47,8476875,Mike Matheson,D,MTL,30,74,9,47,56
47,8479525,Ross Colton,C,COL,28,82,24,31,55
47,8482699,Dylan Guenther,R,UTA,21,75,20,35,55
47,8475170,Brayden Schenn,C,STL,33,76,19,36,55
47,8477964,Ivan Barbashev,C,VGK,29,74,26,28,54
47,8475786,Zach Hyman,L,EDM,32,79,25,29,54
47,8477503,Max Domi,C,TOR,29,80,16,38,54
47,8478396,Noah Hanifin,D,VGK,27,61,11,43,54
47,8474590,John Carlson,D,WSH,34,70,8,46,54
47,8482684,Luke Hughes,D,NJD,21,73,8,46,54
47,8480798,Philipp Kurashev,C,CHI,25,70,20,33,53
47,8480064,Josh Norris,C,OTT,25,76,30,22,52
47,8483808,Andrei Kuzmenko,L,CGY,28,78,26,26,52
47,8481533,Trevor Zegras,C,ANA,23,72,26,26,52
47,8477932,Aaron Ekblad,D,FLA,28,68,25,27,52
47,8481542,Moritz Seider,D,DET,23,76,5,47,52
47,8478856,Conor Garland,R,VAN,28,70,24,27,51
47,8476905,Chandler Stephenson,C,SEA,30,75,17,34,51
47,8474565,Alex Pietrangelo,D,VGK,34,63,12,39,51
47,8478397,Rasmus Andersson,D,CGY,28,76,11,40,51
47,8478038,Devon Toews,D,COL,30,58,10,41,51
47,8480803,Evan Bouchard,D,EDM,25,70,2,49,51
47,8477451,Ryan Hartman,R,MIN,30,64,24,26,50
47,8482702,Logan Stankoven,C,DAL,21,81,22,28,50
47,8475151,Kyle Palmieri,C,NYI,33,80,19,31,50
47,8478462,Nicolas Roy,C,VGK,27,75,19,31,50
47,8476399,Blake Coleman,C,CGY,33,75,27,22,49
47,8475726,Tyler Toffoli,C,SJS,32,74,24,25,49
47,8474102,David Perron,L,OTT,36,77,23,26,49
47,8480015,Owen Tippett,R,PHI,25,81,23,26,49
47,8476853,Morgan Rielly,D,TOR,30,68,15,34,49
47,8482667,William Eklund,L,SJS,22,70,15,34,49
47,8476432,Boone Jenner,C,CBJ,31,71,29,19,48
47,8474641,Adam Henrique,C,EDM,34,75,24,24,48
47,8481560,Arthur Kaliyev,R,LAK,23,79,22,26,48
47,8477935,Sam Bennett,C,FLA,28,76,20,28,48
47,8478542,Evan Rodrigues,C,FLA,31,77,18,30,48
47,8476906,Shayne Gostisbehere,D,CAR,31,77,17,31,48
47,8480434,Sean Durzi,D,UTA,26,72,9,39,48
47,8476792,Torey Krug,D,STL,33,73,8,40,48
47,8478366,Frank Vatrano,R,ANA,30,71,27,20,47
47,8475765,Vladimir Tarasenko,R,DET,33,79,16,31,47
47,8483431,Logan Cooley,C,UTA,20,76,16,31,47
47,8476869,Brady Skjei,D,NSH,30,70,6,41,47
47,8478233,Andrew Mangiapane,L,WSH,28,72,23,23,46
47,8482475,Yegor Chinakhov,R,CBJ,23,67,20,26,46
47,8477479,Tyler Bertuzzi,L,CHI,29,67,19,27,46
47,8482159,Tyson Foerster,R,PHI,22,77,17,29,46
47,8477021,Alex Kerfoot,C,UTA,30,72,16,30,46
47,8481581,Thomas Harley,D,DAL,23,78,14,32,46
47,8477346,MacKenzie Weegar,D,CGY,30,70,10,36,46
47,8476923,Damon Severson,D,CBJ,30,80,10,36,46
47,8479410,Mikhail Sergachev,D,UTA,26,66,9,37,46
47,8475169,Evander Kane,L,EDM,33,72,23,22,45
47,8480849,Barrett Hayton,C,UTA,24,71,22,23,45
47,8479400,Pierre-Luc Dubois,L,WSH,26,74,18,27,45
47,8474586,Jordan Eberle,R,SEA,34,71,14,31,45
47,8479325,Charlie McAvoy,D,BOS,27,74,9,36,45
47,8480871,Adam Boqvist,D,FLA,24,71,9,36,45
47,8477444,Andre Burakovsky,L,SEA,29,73,21,23,44
47,8475745,Charlie Coyle,C,BOS,32,79,20,24,44
47,8480009,Eeli Tolvanen,R,SEA,25,68,20,24,44
47,8482110,Dawson Mercer,C,NJD,23,75,20,24,44
47,8484153,Leo Carlsson,C,ANA,20,71,15,29,44
47,8476292,Ondrej Palat,L,NJD,33,72,15,29,44
47,8482745,Mason McTavish,C,ANA,21,68,14,30,44
47,8477998,Warren Foegele,L,LAK,28,82,21,22,43
47,8476483,Rickard Rakell,R,PIT,31,73,21,22,43
47,8480113,Alex Iafallo,L,WPG,31,68,20,23,43
47,8475314,Anders Lee,L,NYI,34,80,18,25,43
47,8481528,Dylan Cozens,C,BUF,23,76,17,26,43
47,8477456,J.T. Compher,L,DET,29,79,17,26,43
47,8484145,Zach Benson,L,BUF,19,69,14,29,43
47,8479987,Morgan Geekie,C,BOS,26,76,14,29,43
47,8470613,Brent Burns,D,CAR,39,70,10,33,43
47,8476438,Brandon Saad,L,STL,32,78,26,16,42
47,8474150,Mikael Backlund,C,CGY,35,78,13,29,42
47,8475798,Mikael Granlund,C,SJS,32,64,11,31,42
47,8479425,Filip Hronek,D,VAN,27,72,9,33,42
47,8474563,Drew Doughty,D,LAK,35,73,9,33,42
47,8482712,Oskar Olausson,R,COL,22,74,8,34,42
47,8482055,Drew O'Connor,L,PIT,26,65,29,12,41
47,8476826,Yanni Gourde,C,SEA,33,76,20,21,41
47,8477497,Sean Monahan,C,CBJ,30,66,20,21,41
47,8478438,Tommy Novak,C,NSH,27,68,16,25,41
47,8479345,Jakob Chychrun,D,WSH,26,65,11,30,41
47,8476958,Jaccob Slavin,D,CAR,30,76,5,36,41
47,8470621,Corey Perry,R,EDM,39,72,23,17,40
47,8478046,Danton Heinen,L,VAN,29,67,19,21,40
47,8481604,Pavel Dorofeyev,L,VGK,24,70,19,21,40
47,8475768,Jaden Schwartz,C,SEA,32,63,17,23,40
47,8482149,Cole Perfetti,C,WPG,22,70,16,24,40
47,8478042,Viktor Arvidsson,L,EDM,31,72,16,24,40
47,8478466,Daniel Sprong,R,VAN,27,73,16,24,40
47,8481711,Matias Maccelli,L,UTA,24,77,13,27,40
47,8475287,Erik Haula,L,NJD,33,70,13,27,40
47,8482671,Owen Power,D,BUF,22,69,9,31,40
47,8484166,Adam Fantilli,C,CBJ,20,60,20,19,39
47,8475848,Brendan Gallagher,R,MTL,32,70,19,20,39
47,8477989,Christian Dvorak,C,MTL,28,69,18,21,39
47,8480797,Joel Farabee,L,PHI,24,73,17,22,39
47,8481618,Alex Newhook,C,MTL,23,67,17,22,39
47,8480028,Morgan Frost,C,PHI,25,72,15,24,39
47,8479339,Patrik Laine,L,CBJ,26,71,13,26,39
47,8476461,Sean Couturier,C,PHI,32,69,13,26,39
47,8478055,Gustav Forsling,D,FLA,28,70,12,27,39
47,8477953,Kasperi Kapanen,R,STL,28,65,12,27,39
47,8480145,Neal Pionk,D,WPG,29,74,9,30,39
47,8481703,Valtteri Puustinen,R,PIT,25,59,8,31,39
47,8480014,Gabriel Vilardi,C,WPG,25,67,21,17,38
47,8479365,Trent Frederic,C,BOS,26,74,21,17,38
47,8482133,Thomas Bordeleau,C,SJS,22,65,20,18,38
47,8478474,Lawson Crouse,L,UTA,27,74,19,19,38
47,8475793,Ryan Johansen,C,PHI,32,74,18,20,38
47,8481523,Kirby Dach,C,MTL,23,72,17,21,38
47,8476872,Scott Laughton,C,PHI,30,73,16,22,38
47,8478472,Mathieu Joseph,R,STL,27,67,14,24,38
47,8475763,Kevin Hayes,R,PIT,32,71,14,24,38
47,8480068,Ryan Poehling,C,PHI,25,74,13,25,38
47,8484203,Bradly Nadeau,L,CAR,19,67,13,25,38
47,8480817,K'Andre Miller,D,NYR,24,73,11,27,38
47,8477948,Travis Sanheim,D,PHI,28,72,10,28,38
47,8482720,Matthew Knies,L,TOR,22,76,9,29,38
47,8475764,Cam Fowler,D,ANA,33,71,6,32,38
47,8480893,Kirill Marchenko,R,CBJ,24,65,24,13,37
47,8477511,Anthony Mantha,R,CGY,30,74,20,17,37
47,8477947,Sonny Milano,L,WSH,28,59,16,21,37
47,8480185,Eetu Luostarinen,C,FLA,26,73,16,21,37
47,8476925,Colton Sissons,C,NSH,31,69,14,23,37
47,8476458,Ryan Strome,C,ANA,31,66,12,25,37
47,8482092,Ridly Greig,C,OTT,22,78,12,25,37
47,8477447,Shea Theodore,D,VGK,29,55,10,27,37
47,8480336,Sean Walker,D,CAR,30,78,8,29,37
47,8483490,Pavel Mintyukov,D,ANA,21,78,7,30,37
47,8477425,Miles Wood,L,COL,29,75,20,16,36
47,8471698,T.J. Oshie,R,WSH,38,68,18,18,36
47,8476392,Adam Lowry,C,WPG,31,68,16,20,36
47,8476480,Vladislav Namestnikov,C,WPG,32,68,16,20,36
47,8475343,Nic Dowd,C,WSH,34,63,16,20,36
47,8481524,Bowen Byram,D,BUF,23,74,13,23,36
47,8475753,Justin Faulk,D,STL,32,73,11,25,36
47,8475799,Nino Niederreiter,R,WPG,32,66,20,15,35
47,8479353,Brett Howden,C,VGK,26,72,16,19,35
47,8474149,Evgenii Dadonov,R,DAL,35,82,14,21,35
47,8479351,Sam Steel,C,DAL,26,78,14,21,35
47,8482146,Luke Evangelista,R,NSH,22,67,13,22,35
47,8479992,Michael Rasmussen,C,DET,25,81,13,22,35
47,8483445,Cutter Gauthier,L,ANA,20,69,13,22,35
47,8482660,Kent Johnson,C,CBJ,22,67,11,24,35
47,8477505,Alexander Wennberg,C,SJS,30,60,11,24,35
47,8475200,Dmitry Orlov,D,CAR,33,72,9,26,35
47,8475218,Mattias Ekholm,D,EDM,34,75,8,27,35
47,8477495,Seth Jones,D,CHI,30,69,6,29,35
47,8481186,Logan O'Connor,R,COL,28,79,23,11,34
47,8480835,Jack Drury,C,CAR,24,60,16,18,34
47,8481032,Paul Cotter,C,NJD,25,61,19,14,33
47,8482705,Cole Sillinger,C,CBJ,21,62,18,15,33
47,8480459,Pius Suter,C,VAN,28,69,18,15,33
47,8480220,Noah Cates,L,PHI,25,62,17,16,33
47,8482175,JJ Peterka,R,BUF,22,73,15,18,33
47,8479661,Tanner Jeannot,L,LAK,27,74,15,18,33
47,8478109,Victor Olofsson,L,VGK,29,71,14,19,33
47,8477986,Brandon Montour,D,SEA,30,76,13,20,33
47,8478458,John (Jack) Roslovic,C,CAR,27,68,12,21,33
47,8476474,Stefan Noesen,R,NJD,31,70,12,21,33
47,8474716,Jared Spurgeon,D,MIN,35,79,11,22,33
47,8482105,Jake Sanderson,D,OTT,22,75,7,26,33
47,8482122,Brock Faber,D,MIN,22,80,5,28,33
47,8479402,Jake Bean,D,CGY,26,71,5,28,33
47,8476854,Hampus Lindholm,D,BOS,30,74,4,29,33
47,8477426,Nicholas Paul,L,TBL,29,82,21,11,32
47,8475714,Calle Jarnkrok,C,TOR,33,71,20,12,32
47,8479619,Michael Carcone,L,UTA,28,61,19,13,32
47,8478115,Pierre Engvall,L,NYI,28,75,15,17,32
47,8478057,Dakota Joshua,C,VAN,28,67,15,17,32
47,8482125,Alexander Holtz,R,VGK,22,63,19,12,31
47,8477429,Andrew Copp,C,DET,30,81,18,13,31
47,8476981,Josh Anderson,R,MTL,30,73,14,17,31
47,8478463,Anthony Beauvillier,L,PIT,27,64,14,17,31
47,8481656,Aliaksei Protas,C,WSH,23,59,13,18,31
47,8482097,Jack Quinn,R,BUF,23,62,12,19,31
47,8482624,Daniil Miromanov,D,CGY,27,72,10,21,31
47,8476927,Teddy Blueger,C,VAN,30,63,10,21,31
47,8477506,Ryan Pulock,D,NYI,30,74,5,26,31
47,8482089,Jake Neighbours,L,STL,22,62,20,10,30
47,8481554,Kaapo Kakko,R,NYR,23,69,17,13,30
47,8480813,Joe Veleno,C,DET,24,76,16,14,30
47,8480802,Ryan McLeod,C,BUF,25,63,14,16,30
47,8480829,Jesperi Kotkaniemi,C,CAR,24,66,12,18,30
47,8477919,Frederick Gaudreau,C,MIN,31,71,11,19,30
47,8481577,Philip Tomasino,C,NSH,23,63,6,24,30
47,8481606,Jordan Spence,D,LAK,23,66,4,26,30
47,8482157,Will Cuylle,L,NYR,22,63,15,14,29
47,8479591,Michael Eyssimont,C,TBL,28,80,14,15,29
47,8476278,Colin Blackwell,C,DAL,31,78,14,15,29
47,8473533,Jordan Staal,C,CAR,36,68,13,16,29
47,8478133,Jake Evans,C,MTL,28,72,13,16,29
47,8475231,Casey Cizikas,C,NYI,33,72,13,16,29
47,8477987,Ryan Donato,C,CHI,28,59,12,17,29
47,8477952,Robby Fabbri,C,ANA,28,62,12,17,29
47,8483468,Jiri Kulich,C,BUF,20,60,11,18,29
47,8481624,Ilya Mikheyev,R,CHI,30,57,10,19,29
47,8476463,Jonas Brodin,D,MIN,31,76,7,22,29
47,8482142,Jamie Drysdale,D,PHI,22,63,6,23,29
47,8481546,Cam York,D,PHI,23,75,5,24,29
47,8476979,Erik Gustafsson,D,DET,32,75,3,26,29
47,8476897,Oskar Sundqvist,C,STL,30,71,16,12,28
47,8479390,Taylor Raddysh,R,WSH,26,59,14,14,28
47,8481535,Nils Hoglander,L,VAN,24,62,14,14,28
47,8478413,Jordan Greenway,L,BUF,27,69,14,14,28
47,8476882,Teuvo Teravainen,C,CHI,30,66,13,15,28
47,8475193,Tomas Tatar,L,NJD,34,62,13,15,28
47,8478970,Jalen Chatfield,D,CAR,28,70,11,17,28
47,8476921,Jordan Martinook,L,CAR,32,63,11,17,28
47,8477498,Darnell Nurse,D,EDM,29,74,6,22,28
47,8475149,Marcus Johansson,L,MIN,34,63,6,22,28
47,8474151,Ryan McDonagh,D,TBL,35,76,5,23,28
47,8477435,Ryan Graves,D,PIT,29,77,5,23,28
47,8480873,Rasmus Sandin,D,WSH,24,65,3,25,28
47,8475760,Nick Bjugstad,C,UTA,32,74,16,11,27
47,8478891,Mason Appleton,C,WPG,28,64,16,11,27
47,8473422,Nick Foligno,L,CHI,37,61,12,15,27
47,8480789,Oliver Wahlstrom,R,NYI,24,70,10,17,27
47,8479293,Brandon Tanev,L,SEA,33,64,10,17,27
47,8480748,Kiefer Sherwood,L,VAN,29,59,10,17,27
47,8473563,Nicklas Backstrom,C,WSH,37,56,7,20,27
47,8478851,Alexandre Carrier,D,NSH,28,68,6,21,27
47,8479398,Samuel Girard,D,COL,26,60,2,25,27
47,8479414,Nathan Bastian,R,NJD,27,59,14,12,26
47,8477903,Garnet Hathaway,R,PHI,33,65,11,15,26
47,8475791,Taylor Hall,L,CHI,33,57,9,17,26
47,8480144,David Kampf,C,TOR,29,68,8,18,26
47,8482655,Janis Moser,D,TBL,24,77,8,18,26
47,8477507,Nikita Zadorov,D,BOS,29,74,7,19,26
47,8476885,Jacob Trouba,D,NYR,30,64,6,20,26
47,8480043,Timothy Liljegren,D,TOR,25,70,4,22,26
47,8475233,David Savard,D,MTL,34,67,2,24,26
47,8482259,Bobby McMann,C,TOR,28,63,16,9,25
47,8476419,Jean-Gabriel Pageau,C,NYI,32,79,13,12,25
47,8477353,Tyler Motte,C,DET,29,74,13,12,25
47,8479941,Justin Danforth,R,CBJ,31,60,11,14,25
47,8474053,Logan Couture,C,SJS,35,67,9,16,25
47,8477446,Michael McCarron,R,NSH,29,60,9,16,25
47,8475171,Oliver Ekman-Larsson,D,TOR,33,64,5,20,25
47,8476902,Esa Lindell,D,DAL,30,77,5,20,25
47,8479982,Conor Timmins,D,TOR,26,62,3,22,25
47,8478013,Jake Walman,D,SJS,28,70,15,9,24
47,8482074,Connor Zary,C,CGY,23,61,14,10,24
47,8480078,Filip Chytil,C,NYR,25,69,10,14,24
47,8478020,Michael Amadio,R,OTT,28,71,10,14,24
47,8481481,Blake Lizotte,C,PIT,27,65,10,14,24
47,8481582,Nicholas Robertson,L,TOR,23,69,9,15,24
47,8479315,Joey Anderson,R,CHI,26,51,9,15,24
47,8478136,Jake Middleton,D,MIN,28,78,6,18,24
47,8482730,Brandt Clarke,D,LAK,21,50,6,18,24
47,8482067,Connor Mackey,D,NYR,28,62,5,19,24
47,8476917,Adam Pelech,D,NYI,30,78,5,19,24
47,8477220,Nate Schmidt,D,FLA,33,64,5,19,24
47,8476931,Jake McCabe,D,TOR,31,70,3,21,24
47,8477450,Jason Dickinson,C,CHI,29,61,15,8,23
47,8476469,Joel Armia,R,MTL,31,65,12,11,23
47,8479996,Cody Glass,C,NSH,25,53,12,11,23
47,8476422,Mike Reilly,D,NYI,31,77,11,12,23
47,8483499,Liam Ohgren,L,MIN,20,57,11,12,23
47,8476889,Radek Faksa,C,STL,30,62,11,12,23
47,8475722,Jason Zucker,L,BUF,32,64,10,13,23
47,8483505,Matthew Poitras,C,BOS,20,74,9,14,23
47,8480855,Jack McBain,C,UTA,24,69,9,14,23
47,8474189,Lars Eller,C,PIT,35,54,9,14,23
47,8480980,Connor Dewar,C,TOR,25,69,9,14,23
47,8480995,Pontus Holmberg,R,TOR,25,58,9,14,23
47,8475220,Marcus Foligno,L,MIN,33,63,7,16,23
47,8483482,Tristan Luneau,D,ANA,20,64,5,18,23
47,8478507,John Marino,D,UTA,27,62,2,21,23
47,8473507,Jeff Petry,D,DET,37,76,1,22,23
47,8478043,Sam Lafferty,C,BUF,29,58,14,8,22
47,8482079,Marco Rossi,C,MIN,23,59,13,9,22
47,8482679,Matt Coronato,R,CGY,22,62,11,11,22
47,8482737,Zack Bolduc,C,STL,21,57,10,12,22
47,8481704,Juuso Parssinen,C,NSH,23,57,10,12,22
47,8482117,Lukas Reichel,L,CHI,22,55,9,13,22
47,8479066,Ryan Lomberg,L,CGY,30,58,9,13,22
47,8483493,Frank Nazar,C,CHI,20,54,9,13,22
47,8478569,Noel Acciari,C,PIT,33,54,9,13,22
47,8483565,Nick Blankenburg,D,NSH,26,69,8,14,22
47,8477499,Rasmus Ristolainen,D,PHI,30,62,8,14,22
47,8482101,Danil Gushchin,L,SJS,22,61,6,16,22
47,8480073,Erik Brannstrom,D,COL,25,65,5,17,22
47,8482087,Kaiden Guhle,D,MTL,22,65,2,20,22
47,8481178,Egor Zamula,D,PHI,24,52,2,20,22
47,8479368,Max Jones,L,BOS,26,65,13,8,21
47,8476918,Jimmy Vesey,L,NYR,31,66,12,9,21
47,8480281,Alexey Toropchenko,R,STL,25,58,11,10,21
47,8480011,Klim Kostin,C,SJS,25,55,11,10,21
47,8482749,Joshua Roy,R,MTL,21,69,10,11,21
47,8482809,Jackson Blake,R,CAR,21,51,10,11,21
47,8481601,Simon Holmstrom,R,NYI,23,64,10,11,21
47,8477488,Brett Pesce,D,NJD,30,67,9,12,21
47,8477839,Conor Sheary,L,TBL,32,81,8,13,21
47,8476994,Vinnie Hinostroza,C,NSH,30,47,7,14,21
47,8480762,Eric Robinson,L,CAR,29,56,6,15,21
47,8482073,Braden Schneider,D,NYR,23,63,6,15,21
47,8476892,Colton Parayko,D,STL,31,62,3,18,21
47,8474673,TJ Brodie,D,CHI,34,61,3,18,21
47,8477969,Marcus Pettersson,D,PIT,28,79,2,19,21
47,8480246,Nick Perbix,D,TBL,26,76,2,19,21
47,8481568,Alex Vlasic,D,CHI,23,58,2,19,21
47,8481014,Alexander Romanov,D,NYI,24,78,1,20,21
47,8476878,Zemgus Girgensons,C,TBL,30,81,14,6,20
47,8478508,Yakov Trenin,C,MIN,27,64,10,10,20
47,8482062,Cole Smith,L,NSH,29,57,10,10,20
47,8481553,Bobby Brink,R,PHI,23,61,9,11,20
47,8480205,Emil Bemstrom,C,PIT,25,61,8,12,20
47,8478434,Keegan Kolesar,R,VGK,27,68,7,13,20
47,8480806,Isac Lundestrom,C,ANA,25,65,6,14,20
47,8476891,Matthew Grzelcyk,D,PIT,30,74,5,15,20
47,8479983,Mario Ferraro,D,SJS,26,74,5,15,20
47,8478911,Matt Roy,D,WSH,29,60,4,16,20
47,8475790,Erik Gudbranson,D,CBJ,32,75,3,17,20
47,8479976,Juuso Valimaki,D,UTA,26,70,2,18,20
47,8480049,Dylan Samberg,D,WPG,25,66,2,18,20
47,8478500,Ivan Provorov,D,CBJ,27,79,1,19,20
47,8479393,Noah Gregor,L,OTT,26,73,11,8,19
47,8483524,Shane Wright,C,SEA,20,56,11,8,19
47,8476960,Andreas Athanasiou,C,CHI,30,54,10,9,19
47,8480074,Alexandre Texier,C,STL,25,56,9,10,19
47,8483457,Lane Hutson,D,MTL,20,64,9,10,19
47,8478432,Christian Fischer,R,DET,27,75,9,10,19
47,8481580,Connor McMichael,C,WSH,23,58,6,13,19
47,8475179,Dmitry Kulikov,D,FLA,34,65,5,14,19
47,8483460,David Jiricek,D,CBJ,21,61,4,15,19
47,8475462,Radko Gudas,D,ANA,34,61,3,16,19
47,8480035,Henri Jokiharju,D,BUF,25,59,3,16,19
47,8476525,Colin Miller,D,WPG,32,59,2,17,19
47,8482245,Artem Zub,D,OTT,29,62,2,17,19
47,8470600,Ryan Suter,D,STL,39,67,0,19,19
47,8476822,Luke Glendening,C,TBL,35,76,11,7,18
47,8478421,A.J. Greer,L,FLA,28,57,10,8,18
47,8474715,Cameron Atkinson,R,TBL,35,81,8,10,18
47,8481477,Nico Sturm,C,SJS,29,58,8,10,18
47,8482111,Justin Barron,D,MTL,23,59,7,11,18
47,8476374,Sean Kuraly,C,CBJ,31,57,7,11,18
47,8480003,Jesper Boqvist,C,FLA,26,70,6,12,18
47,8475324,Nick Jensen,D,OTT,34,74,6,12,18
47,8479439,Jacob MacDonald,D,COL,31,50,6,12,18
47,8480157,Calle Rosen,D,COL,30,56,6,12,18
47,8475842,Sam Carrick,C,NYR,32,68,5,13,18
47,8481522,Peyton Krebs,C,BUF,23,58,5,13,18
47,8477369,Carson Soucy,D,VAN,30,63,5,13,18
47,8474574,Tyler Myers,D,VAN,34,73,5,13,18
47,8481441,Joe Snively,C,DET,28,56,4,14,18
47,8475188,Brayden McNabb,D,VGK,33,59,4,14,18
47,8482192,Isaak Phillips,D,CHI,23,56,4,14,18
47,8478840,Will Borgen,D,SEA,28,64,3,15,18
47,8475718,Justin Holl,D,DET,32,60,3,15,18
47,8482176,Wyatt Kaiser,D,CHI,22,48,3,15,18
47,8480878,Nils Lundkvist,D,DAL,24,71,2,16,18
47,8478416,Erik Cernak,D,TBL,27,72,2,16,18
47,8476429,Scott Mayfield,D,NYI,32,74,1,17,18
47,8475690,Chris Tanev,D,TOR,35,61,0,18,18
47,8482803,Olen Zellweger,D,ANA,21,65,11,6,17
47,8483495,Simon Nemec,D,NJD,20,59,9,8,17
47,8477478,William Carrier,L,CAR,30,57,8,9,17
47,8482148,Hendrix Lapierre,C,WSH,22,49,8,9,17
47,8479328,Julien Gauthier,R,NYI,27,57,7,10,17
47,8483491,Ivan Miroshnichenko,L,WSH,20,54,4,13,17
47,8476331,Dylan DeMelo,D,WPG,31,65,2,15,17
47,8475181,Nick Leddy,D,STL,33,71,1,16,17
47,8478178,Darren Raddysh,D,TBL,28,67,1,16,17
47,8479324,Ryan Lindgren,D,NYR,26,65,1,16,17
47,8479371,Dante Fabbro,D,NSH,26,68,0,17,17
47,8477392,Hudson Fasching,R,NYI,29,63,10,6,16
47,8481708,Zac Jones,D,NYR,24,55,9,7,16
47,8479370,Tyson Jost,C,CAR,26,49,8,8,16
47,8480289,Morgan Barron,C,WPG,26,57,8,8,16
47,8477406,Mattias Janmark,C,EDM,32,66,8,8,16
47,8479316,Luke Kunin,C,SJS,27,61,7,9,16
47,8476873,Mark Jankowski,C,NSH,30,56,7,9,16
47,8478452,Caleb Jones,D,LAK,27,58,6,10,16
47,8471709,Marc-Edouard Vlasic,D,SJS,37,66,6,10,16
47,8476467,Jamie Oleksiak,D,SEA,32,69,5,11,16
47,8474034,Patrick Maroon,L,CHI,36,53,4,12,16
47,8476867,Brendan Gaunce,C,MIN,30,37,3,13,16
47,8478882,Vladislav Gavrikov,D,LAK,29,60,0,16,16
47,8480058,Pierre-Olivier Joseph,D,STL,25,52,0,16,16
47,8482659,Josh Doan,R,UTA,22,50,10,5,15
47,8482155,Alex Laferriere,R,LAK,23,53,9,6,15
47,8479671,Mathieu Olivier,R,CBJ,27,48,9,6,15
47,8477979,Nicolas Aube-Kubel,R,BUF,28,52,8,7,15
47,8479639,Dylan Coghlan,D,WPG,26,67,7,8,15
47,8477015,Connor Brown,R,EDM,30,54,7,8,15
47,8481521,Ronnie Attard,D,PHI,25,60,7,8,15
47,8477573,Nathan Walker,L,STL,30,41,7,8,15
47,8478585,Derek Ryan,C,EDM,38,67,7,8,15
47,8480355,Mark Kastelic,C,BOS,25,61,7,8,15
47,8481093,Rafael Harvey-Pinard,L,MTL,25,59,6,9,15
47,8480007,Jonas Rondbjerg,R,VGK,25,45,6,9,15
47,8477508,Curtis Lazar,C,NJD,29,63,5,10,15
47,8480860,Kevin Bahl,D,CGY,24,51,4,11,15
47,8479944,Zach Aston-Reese,C,VGK,30,54,3,12,15
47,8477845,Trevor van Riemsdyk,D,WSH,33,55,3,12,15
47,8481598,Philip Broberg,D,EDM,23,47,3,12,15
47,8479372,Joshua Mahura,D,SEA,26,56,2,13,15
47,8479536,Axel Jonsson-Fjallby,L,WPG,26,40,6,8,14
47,8481592,Jakob Pelletier,L,CGY,23,44,6,8,14
47,8478451,Ethan Bear,D,WSH,27,52,5,9,14
47,8480448,Parker Kelly,L,COL,25,71,5,9,14
47,8481019,David Gustafsson,C,WPG,24,43,5,9,14
47,8477931,Tomas Nosek,L,FLA,32,56,5,9,14
47,8480796,Martin Fehervary,D,WSH,25,56,4,10,14
47,8480891,Michael Kesselring,D,UTA,24,56,4,10,14
47,8476856,Mathew Dumba,D,DAL,30,71,4,10,14
47,8481527,Kaedan Korczak,D,VGK,23,50,3,11,14
47,8479998,Mikey Anderson,D,LAK,25,59,3,11,14
47,8481641,Joel Kiviranta,L,COL,28,75,9,4,13
47,8476329,Travis Boyd,C,MIN,31,56,6,7,13
47,8479520,Brandon Duhaime,R,WSH,27,51,6,7,13
47,8480025,MacKenzie Entwistle,R,FLA,25,61,6,7,13
47,8480845,Rasmus Kupari,C,WPG,24,47,6,7,13
47,8480252,Cole Guttman,C,CHI,25,46,6,7,13
47,8479980,Nicolas Hague,D,VGK,26,56,5,8,13
47,8479336,Carl Grundstrom,R,SJS,27,51,5,8,13
47,8481617,Vasily Podkolzin,R,VAN,23,51,5,8,13
47,8473453,Trevor Lewis,C,LAK,37,74,5,8,13
47,8483619,Filip Roos,D,OTT,25,34,5,8,13
47,8481518,Nolan Foote,L,NJD,24,36,5,8,13
47,8480950,Ilya Lyubushkin,D,DAL,30,58,5,8,13
47,8482859,Zack Ostapchuk,C,OTT,21,56,5,8,13
47,8481550,Adam Beckman,L,NJD,23,39,5,8,13
47,8480887,Jordan Harris,D,MTL,24,60,4,9,13
47,8481751,Lukas Rousek,R,BUF,25,32,4,9,13
47,8477365,Connor Clifton,D,BUF,29,58,3,10,13
47,8480172,Jan Rutta,D,SJS,34,70,3,10,13
47,8475750,Jon Merrill,D,MIN,32,59,3,10,13
47,8484254,Akito Hirose,D,VAN,25,42,3,10,13
47,8481532,Alex Turcotte,C,LAK,23,47,8,4,12
47,8482762,Simon Edvinsson,D,DET,21,49,7,5,12
47,8476858,Phillip Di Giuseppe,L,VAN,31,43,7,5,12
47,8479718,Alex Barré-Boulet,C,MTL,27,40,7,5,12
47,8475855,Jesper Fast,R,CAR,33,58,4,8,12
47,8481013,Jonatan Berggren,R,DET,24,61,4,8,12
47,8475279,Ben Chiarot,D,DET,33,62,3,9,12
47,8474090,Brendan Smith,D,DAL,35,52,3,9,12
47,8479359,Beck Malenstyn,L,BUF,26,42,3,9,12
47,8474568,Luke Schenn,D,NSH,35,42,3,9,12
47,8477018,Ben Hutton,D,VGK,31,49,2,10,12
47,8481701,Santeri Hatakka,D,NJD,23,42,2,10,12
47,8480879,Jacob Bernard-Docker,D,OTT,24,54,2,10,12
47,8480001,Urho Vaakanainen,D,ANA,25,63,2,10,12
47,8476988,Matt Benning,D,SJS,30,61,1,11,12
47,8475455,Brenden Dillon,D,NJD,34,58,1,11,12
47,8476457,Adam Larsson,D,SEA,32,62,0,12,12
47,8482784,Zach Dean,C,STL,21,46,6,5,11
47,8476312,Josh Manson,D,COL,33,65,5,6,11
47,8479291,Kevin Rooney,C,CGY,31,53,5,6,11
47,8480848,Ty Dellandrea,C,SJS,24,36,5,6,11
47,8482166,Shakir Mukhamadullin,D,SJS,22,57,5,6,11
47,8480441,Trey Fix-Wolansky,R,CBJ,25,50,5,6,11
47,8482666,Scott Morrow,D,CAR,22,49,4,7,11
47,8478211,Dryden Hunt,L,CGY,29,54,3,8,11
47,8478443,Brandon Carlo,D,BOS,28,66,3,8,11
47,8476879,Cody Ceci,D,EDM,31,71,2,9,11
47,8480021,Jack Studnicka,C,LAK,25,62,2,9,11
47,8478468,Jeremy Lauzon,D,NSH,27,63,2,9,11
47,8479442,Troy Stecher,D,EDM,30,51,2,9,11
47,8481059,Scott Perunovich,D,STL,26,50,1,10,11
47,8480807,Mattias Samuelsson,D,BUF,24,55,0,11,11
47,8476624,Barclay Goodrow,C,SJS,31,48,8,2,10
47,8479638,Justin Brazeau,R,BOS,26,38,8,2,10
47,8482077,Dylan Holloway,L,EDM,23,55,6,4,10
47,8481517,Brett Leason,R,ANA,25,55,6,4,10
47,8475225,Craig Smith,C,CHI,35,45,6,4,10
47,8481161,Jake Christiansen,D,CBJ,25,55,6,4,10
47,8477887,Patrick Brown,C,BOS,32,45,6,4,10
47,8479344,Jesse Puljujarvi,R,PIT,26,49,5,5,10
47,8478831,Kevin Stenlund,C,UTA,28,59,5,5,10
47,8476441,Joel Edmundson,D,LAK,31,46,5,5,10
47,8481556,John Beecher,C,BOS,23,31,5,5,10
47,8474612,Travis Hamonic,D,OTT,34,45,4,6,10
47,8476967,Brett Kulak,D,EDM,30,64,4,6,10
47,8482634,Alex Steeves,C,TOR,25,45,4,6,10
47,8479972,Mason Shaw,C,WPG,26,32,4,6,10
47,8474567,Zach Bogosian,D,MIN,34,69,3,7,10
47,8480222,Sebastian Aho,D,PIT,28,69,2,8,10
47,8481537,Nikita Okhotiuk,D,CGY,24,55,2,8,10
47,8481599,Victor Soderstrom,D,UTA,23,40,2,8,10
47,8475177,Calvin de Haan,D,COL,33,45,2,8,10
47,8475208,Brian Dumoulin,D,ANA,33,61,1,9,10
47,8480192,Johnathan Kovacevic,D,NJD,27,42,0,10,10
47,8476934,Brock McGinn,L,ANA,30,49,5,4,9
47,8484149,Gavin Brindley,C,CBJ,20,43,4,5,9
47,8477938,Haydn Fleury,D,WPG,28,38,4,5,9
47,8480292,Carson Meyer,R,ANA,27,37,4,5,9
47,8478146,Matthew Highmore,C,OTT,28,29,4,5,9
47,8481422,Jake Lucchini,C,NSH,29,25,4,5,9
47,8481716,Dmitri Voronkov,L,CBJ,24,47,3,6,9
47,8482095,Tyler Kleven,D,OTT,22,43,3,6,9
47,8475235,Nicolas Deslauriers,L,PHI,33,43,3,6,9
47,8477962,Brendan Lemieux,L,CAR,28,32,3,6,9
47,8477380,Jonny Brodzinski,C,NYR,31,51,3,6,9
47,8471817,Ryan Reaves,R,TOR,37,57,3,6,9
47,8478399,Jonas Siegenthaler,D,NJD,27,54,2,7,9
47,8482858,Ryker Evans,D,SEA,23,28,2,7,9
47,8482451,Mikael Pyyhtia,L,CBJ,23,44,1,8,9
47,8480070,Ian Mitchell,D,BOS,25,50,1,8,9
47,8479348,Kale Clague,D,BUF,26,39,1,8,9
47,8481567,Henry Thrun,D,SJS,23,42,0,9,9
47,8482145,Mavrik Bourque,C,DAL,22,51,5,3,8
47,8484911,Collin Graf,R,SJS,22,35,5,3,8
47,8482751,Ryan Winterton,C,SEA,21,33,5,3,8
47,8482964,Arber Xhekaj,D,MTL,23,57,4,4,8
47,8479576,Vincent Desharnais,D,VAN,28,27,4,4,8
47,8483466,Kevin Korchinski,D,CHI,20,48,3,5,8
47,8482496,Nils Aman,C,VAN,24,48,3,5,8
47,8477851,Jordan Oesterle,D,BOS,32,34,3,5,8
47,8479369,Andrew Peeke,D,BOS,26,54,3,5,8
47,8478424,Jansen Harkins,C,ANA,27,38,3,5,8
47,8478859,Niko Mikkola,D,FLA,28,55,3,5,8
47,8479378,Logan Stanley,D,WPG,26,46,3,5,8
47,8479543,Michael Pezzetta,L,MTL,26,56,2,6,8
47,8481609,Vladislav Kolyachonok,D,UTA,23,44,2,6,8
47,8482141,Lukas Cormier,D,VGK,22,26,2,6,8
47,8482861,Vincent Iorio,D,WSH,22,34,2,6,8
47,8477070,Liam O'Brien,C,UTA,30,47,1,7,8
47,8476442,Matt Nieto,L,PIT,32,45,1,7,8
47,8476372,Nick Seeler,D,PHI,31,30,1,7,8
47,8479587,Rhett Gardner,C,PHI,28,25,1,7,8
47,8474166,Alec Martinez,D,CHI,37,48,1,7,8
47,8477384,Joshua Brown,D,EDM,30,40,1,7,8
47,8479249,Andrew Poturalski,C,SJS,30,34,0,8,8
47,8482070,Mitchell Chaffee,R,TBL,26,48,6,1,7
47,8479986,Kole Lind,R,DAL,26,45,5,2,7
47,8482807,Ethan Del Mastro,D,CHI,21,47,4,3,7
47,8481028,Martin Pospisil,C,CGY,25,53,3,4,7
47,8479968,Vinni Lettieri,C,BOS,29,52,3,4,7
47,8480990,Declan Chisholm,D,MIN,24,31,3,4,7
47,8475958,Michael Sgarbossa,C,WSH,32,33,3,4,7
47,8476874,Olli Maatta,D,DET,30,66,2,5,7
47,8482652,Walker Duehr,R,CGY,27,40,2,5,7
47,8480727,Zach Whitecloud,D,VGK,28,51,2,5,7
47,8479994,Jaret Anderson-Dolan,C,WPG,25,28,2,5,7
47,8480196,Jacob Bryson,D,BUF,27,41,1,6,7
47,8477335,Kyle Burroughs,D,LAK,29,44,1,6,7
47,8479981,Jonah Gadjovich,L,FLA,26,41,1,6,7
47,8476473,Connor Murphy,D,CHI,31,43,1,6,7
47,8484287,Cole McWard,D,VAN,23,22,1,6,7
47,8475762,Derek Forbort,D,VAN,32,50,0,7,7
47,8477482,Zachary Sanford,L,CHI,30,34,5,1,6
47,8481754,Nikita Nesterenko,C,ANA,23,32,4,2,6
47,8481679,Maxence Guenette,D,OTT,23,26,4,2,6
47,8482765,Isak Rosen,R,BUF,21,31,3,3,6
47,8479379,Givani Smith,R,SJS,26,23,3,3,6
47,8479026,Philippe Myers,D,TOR,27,47,2,4,6
47,8477034,Jaycob Megna,D,FLA,32,49,2,4,6
47,8478874,Adam Gaudette,R,OTT,28,39,2,4,6
47,8478017,Mark Friedman,D,VAN,29,33,2,4,6
47,8481789,Tye Kartye,L,SEA,23,40,2,4,6
47,8482733,Logan Mailloux,D,MTL,31,33,2,4,6
47,8481600,Tobias Bjornfot,D,FLA,23,38,1,5,6
47,8478450,Parker Wotherspoon,D,BOS,27,39,1,5,6
47,8476952,Dominic Toninato,C,WPG,30,32,1,5,6
47,8477401,John Hayden,C,SEA,29,34,1,5,6
47,8483570,Ben Meyers,C,SEA,26,36,5,0,5
47,8480245,Olle Lycksell,R,PHI,25,29,3,2,5
47,8478409,Anthony Richard,C,PHI,28,29,3,2,5
47,8484258,Sam Malinski,D,COL,26,19,3,2,5
47,8482153,Brendan Brisson,C,VGK,23,33,3,2,5
47,8481122,Simon Benoit,D,TOR,26,38,2,3,5
47,8480870,Bo Groulx,C,NYR,24,27,2,3,5
47,8480880,Jakub Lauko,C,MIN,24,34,2,3,5
47,8483397,Marc McLaughlin,C,BOS,25,23,2,3,5
47,8481806,Louis Crevier,D,CHI,23,14,2,3,5
47,8482747,Brennan Othmann,L,NYR,21,36,1,4,5
47,8474013,Ian Cole,D,UTA,35,55,1,4,5
47,8481605,Jackson LaCombe,D,ANA,23,29,1,4,5
47,8478021,William Lagesson,D,DET,28,28,1,4,5
47,8477810,Joel Hanley,D,CGY,33,26,1,4,5
47,8481167,Brayden Pachal,D,CGY,25,37,0,5,5
47,8478502,Dennis Gilbert,D,BUF,28,20,0,5,5
47,8481056,Spencer Stastney,D,NSH,24,28,0,5,5
47,8480834,Ty Emberson,D,SJS,24,26,0,5,5
47,8482118,Sam Colangelo,R,ANA,23,21,3,1,4
47,8479320,Maxime Lajoie,D,SEA,27,23,2,2,4
47,8479367,William Lockwood,R,FLA,26,23,2,2,4
47,8482201,Gage Goncalves,C,TBL,23,27,2,2,4
47,8483597,Milos Kelemen,L,UTA,25,16,2,2,4
47,8481147,Reese Johnson,C,MIN,26,35,1,3,4
47,8482511,Mason Lohrei,D,BOS,23,27,1,3,4
47,8482470,Ilya Solovyov,D,CGY,24,18,1,3,4
47,8478477,Mitchell Stephens,C,SEA,27,29,1,3,4
47,8479985,Cale Fleury,D,SEA,26,24,1,3,4
47,8477320,Anton Blidh,L,NYR,29,19,1,3,4
47,8478881,Brett Seney,L,CHI,28,10,3,0,3
47,8483549,Lucas Condotta,L,MTL,27,29,2,1,3
47,8483763,Maksymilian Szuber,D,UTA,22,26,2,1,3
47,8481543,Nikita Alexandrov,C,STL,24,20,2,1,3
47,8482147,Jean-Luc Foudy,C,COL,22,30,2,1,3
47,8480874,Adam Ginning,D,PHI,24,18,2,1,3
47,8480075,Cameron Crotty,D,MIN,25,10,2,1,3
47,8483012,Logan Morrison,C,SEA,22,31,1,2,3
47,8479772,Zack MacEwen,R,OTT,28,56,1,2,3
47,8480844,Grigori Denisenko,L,VGK,24,34,1,2,3
47,8477527,Ross Johnston,L,ANA,30,42,1,2,3
47,8482172,Landon Slaggert,L,CHI,22,19,1,2,3
47,8479362,Riley Tufte,L,BOS,26,26,1,2,3
47,8471677,Jack Johnson,D,CBJ,37,61,1,2,3
47,8478454,Noah Juulsen,D,VAN,27,32,1,2,3
47,8484325,Waltteri Merela,C,TBL,26,18,1,2,3
47,8477462,Robert Hagg,D,VGK,29,22,1,2,3
47,8475780,Chris Wagner,R,COL,33,7,1,2,3
47,8478051,Max Willman,C,NJD,29,10,1,2,3
47,8477971,Andreas Englund,D,LAK,28,29,0,3,3
47,8483630,Pavol Regenda,L,ANA,25,21,0,3,3
47,8482177,Marat Khusnutdinov,C,MIN,22,35,0,3,3
47,8482144,Jack Thompson,D,SJS,22,26,0,3,3
47,8479419,Brett Murray,L,BUF,26,23,0,3,3
47,8477149,Scott Sabourin,R,SJS,32,18,0,3,3
47,8474062,Riley Nash,C,NYR,35,17,0,3,3
47,8482929,Emil Lilleberg,D,TBL,23,26,0,3,3
47,8481065,Angus Crookshank,L,OTT,25,12,2,0,2
47,8481541,Samuel Bolduc,D,NYI,24,25,2,0,2
47,8482061,Brandon Biro,L,SEA,26,11,2,0,2
47,8480267,Sammy Walker,C,MIN,25,17,1,1,2
47,8482250,Callahan Burke,C,VGK,27,17,1,1,2
47,8482165,Yan Kuznetsov,D,CGY,22,16,1,1,2
47,8479991,Jake Leschyshyn,C,NYR,25,26,1,1,2
47,8480823,Alexander Alexeyev,D,WSH,25,17,1,1,2
47,8482102,Vasily Ponomarev,C,PIT,22,23,1,1,2
47,8482088,Justin Sourdif,R,FLA,22,19,1,1,2
47,8480851,Akil Thomas,C,LAK,24,23,1,1,2
47,8483398,Declan Carlile,D,TBL,31,8,1,1,2
47,8481719,Maxwell Crozier,D,TBL,24,10,1,1,2
47,8481043,Cole Koepke,L,BOS,26,12,1,1,2
47,8484304,Uvis Balinskis,D,FLA,28,12,1,1,2
47,8482744,James Malatesta,L,CBJ,21,33,0,2,2
47,8477073,Kurtis MacDermid,L,NJD,30,35,0,2,2
47,8477473,Justin Bailey,R,SJS,29,23,0,2,2
47,8481030,Jack St. Ivany,D,PIT,25,20,0,2,2
47,8481006,Tyler Tucker,D,STL,24,21,0,2,2
47,8480468,James Hamblin,L,EDM,25,25,0,2,2
47,8475413,Justin Dowling,C,NJD,34,18,0,2,2
47,8483471,Brad Lambert,C,WPG,31,10,0,2,2
47,8477541,Dakota Mermis,D,TOR,30,11,0,2,2
47,8481655,Cole Schwindt,R,CGY,23,8,0,2,2
47,8481462,Mason Morelli,L,VGK,28,9,1,0,1
47,8476913,Devin Shore,C,MIN,30,31,1,0,1
47,8481585,Egor Afanasyev,L,SJS,23,15,1,0,1
47,8481237,Kyle MacLean,C,NYI,25,26,1,0,1
47,8483512,Matthew Savoie,C,EDM,20,13,1,0,1
47,8484255,Jason Polin,R,COL,25,4,1,0,1
47,8477467,Gustav Olofsson,D,SEA,30,16,1,0,1
47,8483531,Brian Halonen,L,NJD,25,2,1,0,1
47,8480890,Jan Jenik,C,OTT,24,30,0,1,1
47,8478011,Louie Belpedio,D,PHI,28,15,0,1,1
47,8482516,Matthew Kessel,D,STL,24,23,0,1,1
47,8482094,Daemon Hunt,D,MIN,22,10,0,1,1
47,8480084,Nick DeSimone,D,NJD,30,23,0,1,1
47,8475795,Dylan McIlrath,D,WSH,32,14,0,1,1
47,8481564,Ryan Johnson,D,BUF,23,9,0,1,1
47,8482713,Mackie Samoskevich,R,FLA,22,39,0,1,1
47,8476323,Max McCormick,L,SEA,32,4,0,1,1
47,8483920,Pierrick Dube,R,WSH,23,7,0,1,1
47,8483567,Georgii Merkulov,C,BOS,24,11,0,1,1
47,8475755,Alexander Petrovic,D,DAL,32,7,0,1,1
47,8482476,Emil Heineman,L,MTL,23,9,0,1,1
47,8481534,Raphael Lavoie,C,EDM,24,4,0,1,1
47,8473446,Erik Johnson,D,PHI,36,44,0,0,0
47,8477244,Chad Ruhwedel,D,NYR,34,34,0,0,0
47,8481743,Marc Del Gaizo,D,NSH,25,9,0,0,0
47,8482162,Roby Jarventie,L,EDM,22,19,0,0,0
47,8482460,Matt Rempe,C,NYR,22,8,0,0,0
47,8478446,Glenn Gawdin,C,LAK,27,9,0,0,0
47,8481578,Graeme Clarke,R,MIN,23,8,0,0,0
47,8482197,Adam Raska,R,MIN,23,8,0,0,0
47,8481593,Jayden Struble,D,MTL,23,13,0,0,0
47,8480032,Shane Bowers,C,NJD,25,10,0,0,0
47,8481699,Aku Raty,R,UTA,23,17,0,0,0
47,8483407,Brandon Scanlin,D,NYR,25,4,0,0,0
47,8483395,Arshdeep Bains,L,VAN,23,8,0,0,0
47,8483546,Marshall Rifai,D,TOR,26,1,0,0,0
47,8480306,Grant Hutton,D,NYI,29,7,0,0,0
47,8481024,Linus Karlsson,C,VAN,25,7,0,0,0
47,8478147,Bokondji Imama,L,PIT,28,1,0,0,0
47,8481206,John Ludvig,D,PIT,24,9,0,0,0
47,8481726,Adam Edstrom,C,NYR,24,9,0,0,0
47,8483489,Fraser Minten,C,TOR,31,12,0,0,0
47,8479421,Jacob Moverare,D,LAK,26,7,0,0,0
47,8482787,Nikita Chibrikov,R,WPG,31,8,0,0,0
47,8483432,Luca Del Bel Belluz,C,CBJ,31,1,0,0,0
47,8484259,Ondrej Pavel,C,COL,31,5,0,0,0
47,8479330,Brandon Gignac,C,MTL,27,6,0,0,0
47,8477993,Justin Kirkland,C,CGY,28,6,0,0,0
47,8478854,Ryan Shea,D,PIT,27,9,0,0,0
47,8484321,Nikolas Matinpalo,D,OTT,26,3,0,0,0
47,8482126,Emil Andrae,D,PHI,31,1,0,0,0
47,8484326,Patrik Koch,D,UTA,28,1,0,0,0
47,8479522,Hardy Haman Aktell,D,WSH,26,4,0,0,0
47,8483609,Adam Klapka,R,CGY,24,7,0,0,0
47,8480274,Philip Kemp,D,EDM,25,0,0,0,0
47,8483401,Marc Johnstone,R,PIT,28,3,0,0,0
47,8470794,Joe Pavelski,C,,40,0,0,0,0
47,8479321,Lucas Johansen,D,,27,0,0,0,0
47,8477950,Tony DeAngelo,D,,29,0,0,0,0
47,8471218,Blake Wheeler,R,,38,0,0,0,0
47,8475197,Tyson Barrie,D,,33,0,0,0,0
47,8474157,Max Pacioretty,L,,36,0,0,0,0
47,8475744,Evgeny Kuznetsov,C,,32,0,0,0,0
47,8474037,James van Riemsdyk,L,,35,0,0,0,0
47,8476907,Mackenzie MacEachern,L,,30,0,0,0,0
47,8480216,Jacob Peterson,C,,25,0,0,0,0
47,8474602,Justin Schultz,D,,34,0,0,0,0
47,8482222,Alexander Barabanov,L,,30,0,0,0,0
47,8474031,Kevin Shattenkirk,D,,35,0,0,0,0
47,8477330,Dominik Kubalik,L,,29,0,0,0,0
47,8480884,Calen Addison,D,,24,0,0,0,0
47,8475906,John Klingberg,D,,32,0,0,0,0
47,8480008,Adam Ruzicka,C,,25,0,0,0,0
47,8476884,Derrick Pouliot,D,,30,0,0,0,0
47,8476919,Chris Tierney,C,,30,0,0,0,0
47,8479415,Michael McLeod,C,,26,0,0,0,0
47,8474870,Tyler Johnson,C,,34,0,0,0,0
47,8470604,Jeff Carter,C,,39,0,0,0,0
47,8478104,Sammy Blais,L,,28,0,0,0,0
47,8474884,Mike Hoffman,C,,35,0,0,0,0
47,8481591,Sam Poulin,R,,23,0,0,0,0
47,8471274,Alex Goligoski,D,,39,0,0,0,0
47,8476871,Tanner Pearson,L,,32,0,0,0,0
47,8476393,Nick Cousins,C,,31,0,0,0,0
47,8479977,Kailer Yamamoto,R,,26,0,0,0,0
47,8479346,Dillon Dube,C,,26,0,0,0,0
47,8480184,Gustav Lindstrom,D,,26,0,0,0,0
47,8479376,Victor Mete,D,,26,0,0,0,0
47,8473449,Kyle Okposo,R,,36,0,0,0,0
47,8481058,Jesse Ylonen,R,,25,0,0,0,0
47,8475752,Tyler Pitlick,C,,33,0,0,0,0
47,8481239,Samuel Fagemo,L,,24,0,0,0,0
47,8480821,Filip Zadina,R,,25,0,0,0,0
47,8470966,Mark Giordano,D,,41,0,0,0,0
47,8478495,Denis Gurianov,R,,27,0,0,0,0
47,8477464,Nic Petan,C,,29,0,0,0,0
47,8478099,Kevin Labanc,R,,29,0,0,0,0
47,8482241,Radim Zohorna,L,,28,0,0,0,0
47,8474040,Sam Gagner,C,,35,0,0,0,0
47,8479514,Rem Pitlick,C,,27,0,0,0,0
47,8478430,Oliver Kylington,D,,27,0,0,0,0
47,8479533,Joona Koppanen,L,,26,0,0,0,0
47,8479984,Cal Foote,D,,26,0,0,0,0
47,8477126,Jayson Megna,C,,34,0,0,0,0
47,8475164,Jakob Silfverberg,R,,34,0,0,0,0
47,8474009,Nick Bonino,C,,36,0,0,0,0
47,8479458,Nikita Zaitsev,D,,33,0,0,0,0
47,8477944,Jakub Vrana,L,,28,0,0,0,0
47,8471699,Andrew Cogliano,C,,37,0,0,0,0
47,8478067,Oskar Lindblom,L,,28,0,0,0,0
47,8471686,Marc Staal,D,,37,0,0,0,0
47,8470610,Zach Parise,L,,40,0,0,0,0
47,8478904,Steven Lorentz,C,,28,0,0,0,0
47,8473473,Milan Lucic,L,,36,0,0,0,0
47,8480031,Maxime Comtois,L,,25,0,0,0,0
47,8478512,Austin Czarnik,C,,32,0,0,0,0
47,8473504,Cal Clutterbuck,R,,37,0,0,0,0
47,8477454,Adam Erne,L,,29,0,0,0,0
47,8479383,Boris Katchouk,L,,26,0,0,0,0
47,8475825,Jani Hakanpää,D,,32,0,0,0,0
47,8477846,Ryan Carpenter,C,,33,0,0,0,0
47,8477930,Pierre-Edouard Bellemare,L,,39,0,0,0,0
47,8478400,Colin White,C,,27,0,0,0,0
47,8480226,Marián Studenic,R,,26,0,0,0,0
47,8480853,Liam Foudy,C,,24,0,0,0,0
47,8475797,Jarred Tinordi,D,,32,0,0,0,0
47,8479423,Alex Nylander,L,,26,0,0,0,0
47,8474618,Marco Scandella,D,,34,0,0,0,0
47,8478028,Fredrik Olofsson,L,,28,0,0,0,0
47,8474709,Matt Martin,L,,35,0,0,0,0
47,8481070,Hugh McGing,L,,26,0,0,0,0
47,8479546,Oskar Steen,C,,26,0,0,0,0
47,8474145,Robert Bortuzzo,D,,35,0,0,0,0
47,8476915,Jujhar Khaira,L,,30,0,0,0,0
47,8475278,Byron Froese,C,,33,0,0,0,0
47,8481812,Nikolai Knyzhov,D,,27,0,0,0,0
47,8478408,Travis Dermott,D,,28,0,0,0,0
47,8481077,John Leonard,L,,26,0,0,0,0
47,8479547,Matthew Phillips,R,,26,0,0,0,0
47,8480836,Jonathan Gruden,C,,24,0,0,0,0
47,8481690,Tyler Angle,C,,24,0,0,0,0
47,8475766,Austin Watson,L,,32,0,0,0,0
47,8481016,Ruslan Iskhakov,C,,24,0,0,0,0
47,8478078,Rourke Chartier,C,,28,0,0,0,0
47,8480776,Sheldon Rempal,R,,29,0,0,0,0
47,8478956,Samuel Laberge,L,NJD,27,1,0,0,0
47,8483045,Cameron Butler,R,CBJ,31,1,0,0,0
47,8484314,Jiri Smejkal,L,,28,0,0,0,0
48,8478402,Connor McDavid,C,EDM,27,77,44,103,147
48,8476453,Nikita Kucherov,R,TBL,31,81,35,104,139
48,8477492,Nathan MacKinnon,C,COL,29,82,53,78,131
48,8477956,David Pastrnak,R,BOS,28,79,61,68,129
48,8481559,Jack Hughes,C,NJD,23,76,50,76,126
48,8479318,Auston Matthews,C,TOR,27,80,71,54,125
48,8478420,Mikko Rantanen,R,COL,28,82,54,69,123
48,8477939,William Nylander,R,TOR,28,79,56,57,113
48,8478427,Sebastian Aho,C,CAR,27,77,51,61,112
48,8476468,J.T. Miller,C,VAN,31,78,39,70,109
48,8479314,Matthew Tkachuk,L,FLA,27,76,27,82,109
48,8478550,Artemi Panarin,L,NYR,33,79,36,70,106
48,8477934,Leon Draisaitl,C,EDM,29,79,36,69,105
48,8477946,Dylan Larkin,C,DET,28,81,47,53,100
48,8479343,Clayton Keller,R,UTA,26,78,43,57,100
48,8477493,Aleksander Barkov,C,FLA,29,79,28,72,100
48,8478483,Mitch Marner,R,TOR,27,74,26,74,100
48,8477404,Jake Guentzel,C,TBL,30,82,49,50,99
48,8477501,Valeri Nichushkin,R,COL,29,81,48,51,99
48,8478864,Kirill Kaprizov,L,MIN,27,70,43,56,99
48,8471675,Sidney Crosby,C,PIT,37,76,45,52,97
48,8479542,Brandon Hagel,L,TBL,26,82,34,62,96
48,8480027,Jason Robertson,L,DAL,25,82,40,55,95
48,8474600,Roman Josi,D,NSH,34,76,21,74,95
48,8478010,Brayden Point,C,TBL,28,82,45,49,94
48,8480012,Elias Pettersson,C,VAN,26,75,41,53,94
48,8475172,Nazem Kadri,C,CGY,34,80,33,59,92
48,8480801,Brady Tkachuk,L,OTT,25,76,37,54,91
48,8476887,Filip Forsberg,L,NSH,30,71,38,52,90
48,8477402,Pavel Buchnevich,L,STL,29,75,37,53,90
48,8480069,Cale Makar,D,COL,26,69,24,65,89
48,8478449,Roope Hintz,C,DAL,28,81,40,48,88
48,8482116,Tim Stützle,C,OTT,22,80,29,59,88
48,8475913,Mark Stone,R,VGK,32,76,30,57,87
48,8476346,Johnny Gaudreau,L,CBJ,31,71,22,65,87
48,8475184,Chris Kreider,L,NYR,33,75,42,43,85
48,8480830,Andrei Svechnikov,R,CAR,24,68,41,44,85
48,8480002,Nico Hischier,C,NJD,25,74,26,59,85
48,8479323,Adam Fox,D,NYR,26,69,18,67,85
48,8477409,Carter Verhaeghe,C,FLA,29,76,40,44,84
48,8480800,Quinn Hughes,D,VAN,25,75,11,73,84
48,8479420,Tage Thompson,C,BUF,27,73,36,47,83
48,8476389,Vincent Trocheck,C,NYR,31,81,31,50,81
48,8473419,Brad Marchand,L,BOS,36,77,28,52,80
48,8478445,Mathew Barzal,C,NYI,27,79,14,66,80
48,8478398,Kyle Connor,L,WPG,28,71,44,35,79
48,8476460,Mark Scheifele,C,WPG,31,71,30,49,79
48,8477949,Alex Tuch,R,BUF,28,72,25,54,79
48,8477933,Sam Reinhart,C,FLA,29,79,39,38,77
48,8475166,John Tavares,C,TOR,34,81,32,45,77
48,8476454,Ryan Nugent-Hopkins,C,EDM,31,77,23,54,77
48,8476539,Jonathan Marchessault,R,NSH,34,74,45,30,75
48,8476459,Mika Zibanejad,C,NYR,31,75,29,46,75
48,8475168,Matt Duchene,C,DAL,33,82,28,47,75
48,8477951,Nick Schmaltz,C,UTA,28,74,27,48,75
48,8478414,Timo Meier,R,NJD,28,69,42,32,74
48,8477960,Adrian Kempe,R,LAK,28,80,32,42,74
48,8477942,Kevin Fiala,L,LAK,28,80,31,43,74
48,8484144,Connor Bedard,C,CHI,19,67,28,46,74
48,8480036,Miro Heiskanen,D,DAL,25,76,12,62,74
48,8479407,Jesper Bratt,L,NJD,26,73,27,46,73
48,8479337,Alex DeBrincat,R,DET,27,79,32,40,72
48,8478444,Brock Boeser,R,VAN,27,71,33,38,71
48,8478460,Zach Werenski,D,CBJ,27,78,16,55,71
48,8478403,Jack Eichel,C,VGK,28,78,30,40,70
48,8476479,Phillip Danault,C,LAK,31,79,30,40,70
48,8475167,Victor Hedman,D,TBL,34,80,16,54,70
48,8482684,Luke Hughes,D,NJD,21,73,4,66,70
48,8475810,Bryan Rust,R,PIT,32,73,33,36,69
48,8481557,Matt Boldy,L,MIN,23,73,31,38,69
48,8477416,Oliver Bjorkstrand,R,SEA,29,74,27,42,69
48,8480839,Rasmus Dahlin,D,BUF,24,74,19,50,69
48,8479385,Jordan Kyrou,C,STL,26,73,30,38,68
48,8474141,Patrick Kane,R,DET,36,81,26,42,68
48,8480039,Martin Necas,C,CAR,25,69,22,46,68
48,8475692,Mats Zuccarello,R,MIN,37,75,14,54,68
48,8475786,Zach Hyman,L,EDM,32,78,33,34,67
48,8475794,Tyler Seguin,C,DAL,32,82,27,40,67
48,8477500,Bo Horvat,C,NYI,29,78,37,29,66
48,8481068,Yegor Sharangovich,C,CGY,26,73,36,30,66
48,8480023,Robert Thomas,C,STL,25,76,19,47,66
48,8480865,Noah Dobson,D,NYI,24,80,13,53,66
48,8477504,Josh Morrissey,D,WPG,29,71,8,58,66
48,8477476,Artturi Lehkonen,L,COL,29,82,27,38,65
48,8481711,Matias Maccelli,L,UTA,24,75,16,49,65
48,8480208,Drake Batherson,R,OTT,26,80,29,35,64
48,8475754,Brock Nelson,C,NYI,33,79,29,35,64
48,8477940,Nikolaj Ehlers,L,WPG,28,69,25,39,64
48,8476456,Jonathan Huberdeau,C,CGY,31,78,18,46,64
48,8482740,Wyatt Johnston,C,DAL,21,81,33,30,63
48,8471685,Anze Kopitar,C,LAK,37,79,26,37,63
48,8479999,Casey Mittelstadt,C,COL,26,81,24,39,63
48,8478975,Mason Marchment,L,DAL,29,81,23,40,63
48,8476881,Tomas Hertl,C,VGK,31,80,36,26,62
48,8477496,Elias Lindholm,C,BOS,30,78,24,38,62
48,8474590,John Carlson,D,WSH,34,65,12,50,62
48,8475784,Jeff Skinner,C,EDM,32,75,27,34,61
48,8478401,Pavel Zacha,C,BOS,27,80,26,35,61
48,8482093,Seth Jarvis,C,CAR,22,65,25,36,61
48,8482124,Quinton Byfield,R,LAK,22,81,23,38,61
48,8482745,Mason McTavish,C,ANA,21,75,14,47,61
48,8476432,Boone Jenner,C,CBJ,31,74,39,21,60
48,8471214,Alex Ovechkin,L,WSH,39,75,29,31,60
48,8476448,William Karlsson,C,VGK,31,76,25,35,60
48,8478493,Joel Eriksson Ek,C,MIN,27,74,24,36,60
48,8474564,Steven Stamkos,C,NSH,34,77,22,38,60
48,8474641,Adam Henrique,C,EDM,34,76,22,38,60
48,8476906,Shayne Gostisbehere,D,CAR,31,80,18,42,60
48,8484166,Adam Fantilli,C,CBJ,20,70,27,32,59
48,8476399,Blake Coleman,C,CGY,33,78,26,33,59
48,8471215,Evgeni Malkin,C,PIT,38,73,24,35,59
48,8480018,Nick Suzuki,C,MTL,25,76,19,40,59
48,8478038,Devon Toews,D,COL,30,70,12,47,59
48,8475745,Charlie Coyle,C,BOS,32,79,28,30,58
48,8479675,Trevor Moore,L,LAK,29,79,22,36,58
48,8474150,Mikael Backlund,C,CGY,35,78,21,37,58
48,8477964,Ivan Barbashev,C,VGK,29,77,19,39,58
48,8479425,Filip Hronek,D,VAN,27,73,11,47,58
48,8477935,Sam Bennett,C,FLA,28,74,36,21,57
48,8478498,Jake DeBrusk,L,VAN,28,76,33,24,57
48,8475765,Vladimir Tarasenko,R,DET,33,80,24,33,57
48,8477503,Max Domi,C,TOR,29,77,23,34,57
48,8475798,Mikael Granlund,C,SJS,32,66,18,39,57
48,8477426,Nicholas Paul,L,TBL,29,80,24,32,56
48,8478439,Travis Konecny,R,PHI,27,79,23,33,56
48,8473512,Claude Giroux,R,OTT,36,81,22,34,56
48,8478856,Conor Garland,R,VAN,28,74,16,40,56
48,8473994,Jamie Benn,L,DAL,35,80,15,41,56
48,8478055,Gustav Forsling,D,FLA,28,71,12,44,56
48,8482109,Alexis Lafrenière,L,NYR,23,75,33,22,55
48,8475726,Tyler Toffoli,C,SJS,32,64,30,25,55
48,8482078,Lucas Raymond,L,DET,22,79,26,29,55
48,8475158,Ryan O'Reilly,C,NSH,33,71,22,33,55
48,8478873,Troy Terry,R,ANA,27,73,16,39,55
48,8481540,Cole Caufield,R,MTL,23,74,28,26,54
48,8481604,Pavel Dorofeyev,L,VGK,24,74,24,30,54
48,8483431,Logan Cooley,C,UTA,20,72,23,31,54
48,8481524,Bowen Byram,D,BUF,23,70,22,32,54
48,8480185,Eetu Luostarinen,C,FLA,26,77,21,33,54
48,8478440,Dylan Strome,C,WSH,27,73,15,39,54
48,8480803,Evan Bouchard,D,EDM,25,76,14,40,54
48,8471724,Kris Letang,D,PIT,37,80,7,47,54
48,8480014,Gabriel Vilardi,C,WPG,25,69,32,21,53
48,8482159,Tyson Foerster,R,PHI,22,78,22,31,53
48,8478519,Anthony Cirelli,C,TBL,27,82,21,32,53
48,8478458,John (Jack) Roslovic,C,CAR,27,71,14,39,53
48,8476853,Morgan Rielly,D,TOR,30,65,4,49,53
48,8479345,Jakob Chychrun,D,WSH,26,67,21,31,52
48,8476882,Teuvo Teravainen,C,CHI,30,68,18,34,52
48,8483515,Juraj Slafkovsky,L,MTL,20,76,16,36,52
48,8482699,Dylan Guenther,R,UTA,21,77,15,37,52
48,8474578,Erik Karlsson,D,PIT,34,75,11,41,52
48,8478397,Rasmus Andersson,D,CGY,28,73,7,45,52
48,8477955,Jared McCann,L,SEA,28,79,34,17,51
48,8481528,Dylan Cozens,C,BUF,23,73,24,27,51
48,8480028,Morgan Frost,C,PHI,25,77,23,28,51
48,8476905,Chandler Stephenson,C,SEA,30,76,17,34,51
48,8477932,Aaron Ekblad,D,FLA,28,67,13,38,51
48,8477511,Anthony Mantha,R,CGY,30,77,25,25,50
48,8474679,Gustav Nyquist,C,NSH,35,77,16,34,50
48,8476826,Yanni Gourde,C,SEA,33,74,15,35,50
48,8479325,Charlie McAvoy,D,BOS,27,72,14,36,50
48,8480817,K'Andre Miller,D,NYR,24,75,11,39,50
48,8475170,Brayden Schenn,C,STL,33,75,22,27,49
48,8476292,Ondrej Palat,L,NJD,33,71,17,32,49
48,8477986,Brandon Montour,D,SEA,30,67,11,38,49
48,8482702,Logan Stankoven,C,DAL,21,81,31,17,48
48,8473986,Alex Killorn,L,ANA,35,71,28,20,48
48,8480015,Owen Tippett,R,PHI,25,74,20,28,48
48,8477494,Jonathan Drouin,L,COL,29,81,16,32,48
48,8482665,Matty Beniers,C,SEA,22,73,14,34,48
48,8478366,Frank Vatrano,R,ANA,30,75,29,18,47
48,8475169,Evander Kane,L,EDM,33,79,28,19,47
48,8477447,Shea Theodore,D,VGK,29,63,10,37,47
48,8480434,Sean Durzi,D,UTA,26,73,8,39,47
48,8480188,Fabian Zetterlund,L,SJS,25,64,24,22,46
48,8478233,Andrew Mangiapane,L,WSH,28,72,17,29,46
48,8484145,Zach Benson,L,BUF,19,69,17,29,46
48,8478462,Nicolas Roy,C,VGK,27,73,13,33,46
48,8477495,Seth Jones,D,CHI,30,68,9,37,46
48,8475151,Kyle Palmieri,C,NYI,33,80,26,19,45
48,8482113,Anton Lundell,C,FLA,23,75,24,21,45
48,8475287,Erik Haula,L,NJD,33,70,24,21,45
48,8477021,Alex Kerfoot,C,UTA,30,75,16,29,45
48,8483505,Matthew Poitras,C,BOS,20,74,16,29,45
48,8476483,Rickard Rakell,R,PIT,31,72,15,30,45
48,8470613,Brent Burns,D,CAR,39,78,11,34,45
48,8476869,Brady Skjei,D,NSH,30,80,10,35,45
48,8474563,Drew Doughty,D,LAK,35,74,7,38,45
48,8476854,Hampus Lindholm,D,BOS,30,76,6,39,45
48,8477497,Sean Monahan,C,CBJ,30,68,20,24,44
48,8481560,Arthur Kaliyev,R,LAK,23,77,18,26,44
48,8479400,Pierre-Luc Dubois,L,WSH,26,69,17,27,44
48,8474102,David Perron,L,OTT,36,80,16,28,44
48,8476458,Ryan Strome,C,ANA,31,70,12,32,44
48,8478407,Vince Dunn,D,SEA,28,73,10,34,44
48,8475714,Calle Jarnkrok,C,TOR,33,74,22,21,43
48,8478542,Evan Rodrigues,C,FLA,31,78,19,24,43
48,8482475,Yegor Chinakhov,R,CBJ,23,62,19,24,43
48,8481533,Trevor Zegras,C,ANA,23,69,14,29,43
48,8477456,J.T. Compher,L,DET,29,80,11,32,43
48,8478469,Thomas Chabot,D,OTT,27,73,5,38,43
48,8481542,Moritz Seider,D,DET,23,78,3,40,43
48,8477998,Warren Foegele,L,LAK,28,80,17,25,42
48,8484153,Leo Carlsson,C,ANA,20,76,16,26,42
48,8474053,Logan Couture,C,SJS,35,67,16,26,42
48,8482720,Matthew Knies,L,TOR,22,70,14,28,42
48,8476958,Jaccob Slavin,D,CAR,30,76,13,29,42
48,8477948,Travis Sanheim,D,PHI,28,74,10,32,42
48,8478466,Daniel Sprong,R,VAN,27,69,21,20,41
48,8482097,Jack Quinn,R,BUF,23,58,21,20,41
48,8480849,Barrett Hayton,C,UTA,24,73,20,21,41
48,8477947,Sonny Milano,L,WSH,28,66,17,24,41
48,8475191,Reilly Smith,R,NYR,33,75,16,25,41
48,8479987,Morgan Geekie,C,BOS,26,77,16,25,41
48,8476792,Torey Krug,D,STL,33,71,9,32,41
48,8479410,Mikhail Sergachev,D,UTA,26,59,9,32,41
48,8478396,Noah Hanifin,D,VGK,27,69,8,33,41
48,8480145,Neal Pionk,D,WPG,29,79,8,33,41
48,8476463,Jonas Brodin,D,MIN,31,80,6,35,41
48,8479525,Ross Colton,C,COL,28,80,20,20,40
48,8477407,Anthony Duclair,L,NYI,29,80,19,21,40
48,8482110,Dawson Mercer,C,NJD,23,77,19,21,40
48,8476880,Tom Wilson,R,WSH,30,71,18,22,40
48,8475760,Nick Bjugstad,C,UTA,32,74,18,22,40
48,8478047,Michael Bunting,L,PIT,29,68,17,23,40
48,8482092,Ridly Greig,C,OTT,22,79,17,23,40
48,8483808,Andrei Kuzmenko,L,CGY,28,74,15,25,40
48,8477479,Tyler Bertuzzi,L,CHI,29,63,14,26,40
48,8479339,Patrik Laine,L,CBJ,26,60,13,27,40
48,8476462,Dougie Hamilton,D,NJD,31,71,11,29,40
48,8480871,Adam Boqvist,D,FLA,24,65,11,29,40
48,8475722,Jason Zucker,L,BUF,32,70,21,18,39
48,8482149,Cole Perfetti,C,WPG,22,69,20,19,39
48,8475768,Jaden Schwartz,C,SEA,32,73,19,20,39
48,8478046,Danton Heinen,L,VAN,29,74,18,21,39
48,8480113,Alex Iafallo,L,WPG,31,66,17,22,39
48,8478042,Viktor Arvidsson,L,EDM,31,74,16,23,39
48,8474565,Alex Pietrangelo,D,VGK,34,66,14,25,39
48,8476480,Vladislav Namestnikov,C,WPG,32,64,10,29,39
48,8480064,Josh Norris,C,OTT,25,77,21,17,38
48,8481554,Kaapo Kakko,R,NYR,23,71,20,18,38
48,8481596,Shane Pinto,C,OTT,24,73,18,20,38
48,8482712,Oskar Olausson,R,COL,22,78,7,31,38
48,8482055,Drew O'Connor,L,PIT,26,74,23,14,37
48,8474149,Evgenii Dadonov,R,DAL,35,80,18,19,37
48,8478115,Pierre Engvall,L,NYI,28,77,17,20,37
48,8480078,Filip Chytil,C,NYR,25,67,17,20,37
48,8478413,Jordan Greenway,L,BUF,27,69,15,22,37
48,8475799,Nino Niederreiter,R,WPG,32,71,22,14,36
48,8482705,Cole Sillinger,C,CBJ,21,69,22,14,36
48,8477987,Ryan Donato,C,CHI,28,63,21,15,36
48,8478438,Tommy Novak,C,NSH,27,66,15,21,36
48,8476419,Jean-Gabriel Pageau,C,NYI,32,76,15,21,36
48,8477444,Andre Burakovsky,L,SEA,29,66,14,22,36
48,8480009,Eeli Tolvanen,R,SEA,25,73,12,24,36
48,8482105,Jake Sanderson,D,OTT,22,75,11,25,36
48,8475753,Justin Faulk,D,STL,32,78,8,28,36
48,8480043,Timothy Liljegren,D,TOR,25,66,4,32,36
48,8475314,Anders Lee,L,NYI,34,74,19,16,35
48,8481186,Logan O'Connor,R,COL,28,79,15,20,35
48,8479591,Michael Eyssimont,C,TBL,28,81,15,20,35
48,8481703,Valtteri Puustinen,R,PIT,25,62,11,24,35
48,8479365,Trent Frederic,C,BOS,26,72,11,24,35
48,8476392,Adam Lowry,C,WPG,31,67,10,25,35
48,8475218,Mattias Ekholm,D,EDM,34,72,10,25,35
48,8476875,Mike Matheson,D,MTL,30,75,9,26,35
48,8480336,Sean Walker,D,CAR,30,74,8,27,35
48,8480459,Pius Suter,C,VAN,28,64,21,13,34
48,8482146,Luke Evangelista,R,NSH,22,62,15,19,34
48,8474715,Cameron Atkinson,R,TBL,35,81,14,20,34
48,8479351,Sam Steel,C,DAL,26,80,13,21,34
48,8482660,Kent Johnson,C,CBJ,22,69,13,21,34
48,8477429,Andrew Copp,C,DET,30,79,12,22,34
48,8477451,Ryan Hartman,R,MIN,30,66,11,23,34
48,8475793,Ryan Johansen,C,PHI,32,66,11,23,34
48,8477488,Brett Pesce,D,NJD,30,65,9,25,34
48,8481577,Philip Tomasino,C,NSH,23,65,5,29,34
48,8481580,Connor McMichael,C,WSH,23,67,20,13,33
48,8471698,T.J. Oshie,R,WSH,38,67,17,16,33
48,8476889,Radek Faksa,C,STL,30,70,15,18,33
48,8482667,William Eklund,L,SJS,22,68,13,20,33
48,8478472,Mathieu Joseph,R,STL,27,68,13,20,33
48,8474586,Jordan Eberle,R,SEA,34,72,12,21,33
48,8477953,Kasperi Kapanen,R,STL,28,61,12,21,33
48,8478133,Jake Evans,C,MTL,28,75,6,27,33
48,8479390,Taylor Raddysh,R,WSH,26,63,23,9,32
48,8476438,Brandon Saad,L,STL,32,74,19,13,32
48,8476474,Stefan Noesen,R,NJD,31,68,19,13,32
48,8479293,Brandon Tanev,L,SEA,33,68,16,16,32
48,8481553,Bobby Brink,R,PHI,23,62,14,18,32
48,8482133,Thomas Bordeleau,C,SJS,22,55,10,22,32
48,8482671,Owen Power,D,BUF,22,63,9,23,32
48,8483490,Pavel Mintyukov,D,ANA,21,68,9,23,32
48,8481618,Alex Newhook,C,MTL,23,77,7,25,32
48,8480829,Jesperi Kotkaniemi,C,CAR,24,62,16,15,31
48,8480797,Joel Farabee,L,PHI,24,74,15,16,31
48,8481535,Nils Hoglander,L,VAN,24,63,13,18,31
48,8478891,Mason Appleton,C,WPG,28,64,12,19,31
48,8478057,Dakota Joshua,C,VAN,28,62,11,20,31
48,8477505,Alexander Wennberg,C,SJS,30,57,10,21,31
48,8479398,Samuel Girard,D,COL,26,69,3,28,31
48,8478500,Ivan Provorov,D,CBJ,27,79,0,31,31
48,8478463,Anthony Beauvillier,L,PIT,27,73,20,10,30
48,8479992,Michael Rasmussen,C,DET,25,81,18,12,30
48,8480220,Noah Cates,L,PHI,25,71,17,13,30
48,8481582,Nicholas Robertson,L,TOR,23,75,16,14,30
48,8482175,JJ Peterka,R,BUF,22,67,15,15,30
48,8483524,Shane Wright,C,SEA,20,64,15,15,30
48,8477952,Robby Fabbri,C,ANA,28,63,14,16,30
48,8480802,Ryan McLeod,C,BUF,25,65,13,17,30
48,8476960,Andreas Athanasiou,C,CHI,30,58,11,19,30
48,8480798,Philipp Kurashev,C,CHI,25,62,8,22,30
48,8475200,Dmitry Orlov,D,CAR,33,75,7,23,30
48,8475790,Erik Gudbranson,D,CBJ,32,79,2,28,30
48,8482089,Jake Neighbours,L,STL,22,62,17,12,29
48,8480068,Ryan Poehling,C,PHI,25,71,13,16,29
48,8476921,Jordan Martinook,L,CAR,32,62,12,17,29
48,8479353,Brett Howden,C,VGK,26,65,11,18,29
48,8475763,Kevin Hayes,R,PIT,32,60,9,20,29
48,8474716,Jared Spurgeon,D,MIN,35,73,7,22,29
48,8481581,Thomas Harley,D,DAL,23,73,6,23,29
48,8481606,Jordan Spence,D,LAK,23,70,5,24,29
48,8476885,Jacob Trouba,D,NYR,30,74,5,24,29
48,8477425,Miles Wood,L,COL,29,79,17,11,28
48,8478109,Victor Olofsson,L,VGK,29,75,14,14,28
48,8480835,Jack Drury,C,CAR,24,56,13,15,28
48,8483445,Cutter Gauthier,L,ANA,20,67,12,16,28
48,8477839,Conor Sheary,L,TBL,32,80,12,16,28
48,8478020,Michael Amadio,R,OTT,28,75,11,17,28
48,8476927,Teddy Blueger,C,VAN,30,65,9,19,28
48,8477346,MacKenzie Weegar,D,CGY,30,66,7,21,28
48,8476331,Dylan DeMelo,D,WPG,31,71,7,21,28
48,8481656,Aliaksei Protas,C,WSH,23,62,6,22,28
48,8480878,Nils Lundkvist,D,DAL,24,72,5,23,28
48,8482655,Janis Moser,D,TBL,24,77,4,24,28
48,8478474,Lawson Crouse,L,UTA,27,73,12,15,27
48,8473533,Jordan Staal,C,CAR,36,71,10,17,27
48,8475791,Taylor Hall,L,CHI,33,54,10,17,27
48,8477979,Nicolas Aube-Kubel,R,BUF,28,63,10,17,27
48,8473563,Nicklas Backstrom,C,WSH,37,52,5,22,27
48,8478507,John Marino,D,UTA,27,70,5,22,27
48,8476923,Damon Severson,D,CBJ,30,77,3,24,27
48,8482125,Alexander Holtz,R,VGK,22,71,14,12,26
48,8476461,Sean Couturier,C,PHI,32,69,13,13,26
48,8475149,Marcus Johansson,L,MIN,34,66,13,13,26
48,8473422,Nick Foligno,L,CHI,37,56,12,14,26
48,8476897,Oskar Sundqvist,C,STL,30,56,10,16,26
48,8480448,Parker Kelly,L,COL,25,77,9,17,26
48,8481546,Cam York,D,PHI,23,67,6,20,26
48,8474151,Ryan McDonagh,D,TBL,35,78,5,21,26
48,8475764,Cam Fowler,D,ANA,33,70,2,24,26
48,8476917,Adam Pelech,D,NYI,30,79,2,24,26
48,8476918,Jimmy Vesey,L,NYR,31,74,13,12,25
48,8482079,Marco Rossi,C,MIN,23,55,12,13,25
48,8476822,Luke Glendening,C,TBL,35,77,12,13,25
48,8476278,Colin Blackwell,C,DAL,31,75,10,15,25
48,8476872,Scott Laughton,C,PHI,30,74,9,16,25
48,8480003,Jesper Boqvist,C,FLA,26,67,9,16,25
48,8477220,Nate Schmidt,D,FLA,33,69,8,17,25
48,8482624,Daniil Miromanov,D,CGY,27,64,7,18,25
48,8480748,Kiefer Sherwood,L,VAN,29,67,7,18,25
48,8475171,Oliver Ekman-Larsson,D,TOR,33,62,6,19,25
48,8480035,Henri Jokiharju,D,BUF,25,64,6,19,25
48,8476979,Erik Gustafsson,D,DET,32,77,5,20,25
48,8477969,Marcus Pettersson,D,PIT,28,78,3,22,25
48,8474574,Tyler Myers,D,VAN,34,71,3,22,25
48,8481019,David Gustafsson,C,WPG,24,49,3,22,25
48,8480893,Kirill Marchenko,R,CBJ,24,61,19,5,24
48,8476878,Zemgus Girgensons,C,TBL,30,80,17,7,24
48,8481704,Juuso Parssinen,C,NSH,23,52,15,9,24
48,8481032,Paul Cotter,C,NJD,25,68,13,11,24
48,8480813,Joe Veleno,C,DET,24,72,13,11,24
48,8478432,Christian Fischer,R,DET,27,72,13,11,24
48,8482111,Justin Barron,D,MTL,23,64,13,11,24
48,8479066,Ryan Lomberg,L,CGY,30,70,12,12,24
48,8479393,Noah Gregor,L,OTT,26,72,12,12,24
48,8477015,Connor Brown,R,EDM,30,62,12,12,24
48,8481481,Blake Lizotte,C,PIT,27,64,10,14,24
48,8483493,Frank Nazar,C,CHI,20,54,10,14,24
48,8479368,Max Jones,L,BOS,26,70,8,16,24
48,8476925,Colton Sissons,C,NSH,31,64,7,17,24
48,8482245,Artem Zub,D,OTT,29,72,4,20,24
48,8481441,Joe Snively,C,DET,28,72,4,20,24
48,8482122,Brock Faber,D,MIN,22,79,3,21,24
48,8480281,Alexey Toropchenko,R,STL,25,65,16,7,23
48,8479619,Michael Carcone,L,UTA,28,61,14,9,23
48,8482259,Bobby McMann,C,TOR,28,65,14,9,23
48,8477478,William Carrier,L,CAR,30,55,13,10,23
48,8482749,Joshua Roy,R,MTL,21,63,12,11,23
48,8481624,Ilya Mikheyev,R,CHI,30,62,10,13,23
48,8480806,Isac Lundestrom,C,ANA,25,52,10,13,23
48,8475855,Jesper Fast,R,CAR,33,63,10,13,23
48,8474189,Lars Eller,C,PIT,35,65,8,15,23
48,8482809,Jackson Blake,R,CAR,21,59,8,15,23
48,8479639,Dylan Coghlan,D,WPG,26,59,7,16,23
48,8476624,Barclay Goodrow,C,SJS,31,61,7,16,23
48,8480144,David Kampf,C,TOR,29,72,6,17,23
48,8479026,Philippe Myers,D,TOR,27,55,6,17,23
48,8477506,Ryan Pulock,D,NYI,30,79,5,18,23
48,8477498,Darnell Nurse,D,EDM,29,70,4,19,23
48,8482142,Jamie Drysdale,D,PHI,22,64,3,20,23
48,8476892,Colton Parayko,D,STL,31,70,3,20,23
48,8474673,TJ Brodie,D,CHI,34,71,2,21,23
48,8480289,Morgan Barron,C,WPG,26,52,15,7,22
48,8478585,Derek Ryan,C,EDM,38,59,14,8,22
48,8476981,Josh Anderson,R,MTL,30,64,12,10,22
48,8479996,Cody Glass,C,NSH,25,62,11,11,22
48,8480762,Eric Robinson,L,CAR,29,42,11,11,22
48,8478508,Yakov Trenin,C,MIN,27,59,11,11,22
48,8483468,Jiri Kulich,C,BUF,20,56,10,12,22
48,8483565,Nick Blankenburg,D,NSH,26,62,10,12,22
48,8479520,Brandon Duhaime,R,WSH,27,61,10,12,22
48,8484203,Bradly Nadeau,L,CAR,19,66,9,13,22
48,8479315,Joey Anderson,R,CHI,26,52,9,13,22
48,8482679,Matt Coronato,R,CGY,22,66,9,13,22
48,8477931,Tomas Nosek,L,FLA,32,65,9,13,22
48,8475848,Brendan Gallagher,R,MTL,32,68,8,14,22
48,8477989,Christian Dvorak,C,MTL,28,71,8,14,22
48,8480980,Connor Dewar,C,TOR,25,62,7,15,22
48,8482101,Danil Gushchin,L,SJS,22,59,7,15,22
48,8482737,Zack Bolduc,C,STL,21,60,6,16,22
48,8478911,Matt Roy,D,WSH,29,59,3,19,22
48,8479661,Tanner Jeannot,L,LAK,27,76,12,9,21
48,8480855,Jack McBain,C,UTA,24,65,12,9,21
48,8475231,Casey Cizikas,C,NYI,33,72,9,12,21
48,8476469,Joel Armia,R,MTL,31,70,9,12,21
48,8483457,Lane Hutson,D,MTL,20,63,6,15,21
48,8475181,Nick Leddy,D,STL,33,67,5,16,21
48,8479371,Dante Fabbro,D,NSH,26,66,3,18,21
48,8475462,Radko Gudas,D,ANA,34,69,2,19,21
48,8479671,Mathieu Olivier,R,CBJ,27,44,14,6,20
48,8477406,Mattias Janmark,C,EDM,32,63,12,8,20
48,8475193,Tomas Tatar,L,NJD,34,65,11,9,20
48,8477508,Curtis Lazar,C,NJD,29,50,9,11,20
48,8478569,Noel Acciari,C,PIT,33,52,8,12,20
48,8476856,Mathew Dumba,D,DAL,30,67,7,13,20
48,8476994,Vinnie Hinostroza,C,NSH,30,50,6,14,20
48,8478451,Ethan Bear,D,WSH,27,60,6,14,20
48,8477507,Nikita Zadorov,D,BOS,29,62,5,15,20
48,8476931,Jake McCabe,D,TOR,31,65,4,16,20
48,8480860,Kevin Bahl,D,CGY,24,62,4,16,20
48,8477435,Ryan Graves,D,PIT,29,73,3,17,20
48,8478136,Jake Middleton,D,MIN,28,76,3,17,20
48,8477499,Rasmus Ristolainen,D,PHI,30,55,3,17,20
48,8476891,Matthew Grzelcyk,D,PIT,30,78,3,17,20
48,8477845,Trevor van Riemsdyk,D,WSH,33,53,3,17,20
48,8480873,Rasmus Sandin,D,WSH,24,63,2,18,20
48,8478882,Vladislav Gavrikov,D,LAK,29,59,2,18,20
48,8479983,Mario Ferraro,D,SJS,26,68,1,19,20
48,8476988,Matt Benning,D,SJS,30,64,1,19,20
48,8480049,Dylan Samberg,D,WPG,25,62,0,20,20
48,8477446,Michael McCarron,R,NSH,29,59,13,6,19
48,8481523,Kirby Dach,C,MTL,23,61,12,7,19
48,8475225,Craig Smith,C,CHI,35,50,12,7,19
48,8478043,Sam Lafferty,C,BUF,29,65,10,9,19
48,8481477,Nico Sturm,C,SJS,29,49,10,9,19
48,8479414,Nathan Bastian,R,NJD,27,62,8,11,19
48,8477450,Jason Dickinson,C,CHI,29,59,8,11,19
48,8480025,MacKenzie Entwistle,R,FLA,25,59,8,11,19
48,8470600,Ryan Suter,D,STL,39,63,7,12,19
48,8478851,Alexandre Carrier,D,NSH,28,63,6,13,19
48,8476457,Adam Larsson,D,SEA,32,72,6,13,19
48,8476467,Jamie Oleksiak,D,SEA,32,69,5,14,19
48,8479372,Joshua Mahura,D,SEA,26,54,5,14,19
48,8481013,Jonatan Berggren,R,DET,24,58,5,14,19
48,8476902,Esa Lindell,D,DAL,30,76,4,15,19
48,8476429,Scott Mayfield,D,NYI,32,72,4,15,19
48,8480891,Michael Kesselring,D,UTA,24,57,4,15,19
48,8482067,Connor Mackey,D,NYR,28,64,2,17,19
48,8475690,Chris Tanev,D,TOR,35,60,2,17,19
48,8479543,Michael Pezzetta,L,MTL,26,55,10,8,18
48,8482074,Connor Zary,C,CGY,23,62,9,9,18
48,8480205,Emil Bemstrom,C,PIT,25,58,9,9,18
48,8470621,Corey Perry,R,EDM,39,65,8,10,18
48,8478013,Jake Walman,D,SJS,28,72,8,10,18
48,8483482,Tristan Luneau,D,ANA,20,69,8,10,18
48,8482803,Olen Zellweger,D,ANA,21,65,7,11,18
48,8475343,Nic Dowd,C,WSH,34,55,6,12,18
48,8478416,Erik Cernak,D,TBL,27,70,4,14,18
48,8481521,Ronnie Attard,D,PHI,25,59,4,14,18
48,8478970,Jalen Chatfield,D,CAR,28,65,3,15,18
48,8480796,Martin Fehervary,D,WSH,25,54,2,16,18
48,8479994,Jaret Anderson-Dolan,C,WPG,25,39,10,7,17
48,8482117,Lukas Reichel,L,CHI,22,54,9,8,17
48,8478434,Keegan Kolesar,R,VGK,27,64,7,10,17
48,8476422,Mike Reilly,D,NYI,31,72,6,11,17
48,8476312,Josh Manson,D,COL,33,55,4,13,17
48,8481522,Peyton Krebs,C,BUF,23,60,3,14,17
48,8480246,Nick Perbix,D,TBL,26,73,2,15,17
48,8481059,Scott Perunovich,D,STL,26,53,2,15,17
48,8482451,Mikael Pyyhtia,L,CBJ,23,48,2,15,17
48,8479982,Conor Timmins,D,TOR,26,60,1,16,17
48,8476879,Cody Ceci,D,EDM,31,75,1,16,17
48,8476967,Brett Kulak,D,EDM,30,64,1,16,17
48,8475220,Marcus Foligno,L,MIN,33,55,10,6,16
48,8477392,Hudson Fasching,R,NYI,29,65,8,8,16
48,8477482,Zachary Sanford,L,CHI,30,40,8,8,16
48,8477903,Garnet Hathaway,R,PHI,33,67,7,9,16
48,8479316,Luke Kunin,C,SJS,27,46,7,9,16
48,8477919,Frederick Gaudreau,C,MIN,31,62,6,10,16
48,8482062,Cole Smith,L,NSH,29,60,5,11,16
48,8479324,Ryan Lindgren,D,NYR,26,65,5,11,16
48,8479370,Tyson Jost,C,CAR,26,57,5,11,16
48,8479998,Mikey Anderson,D,LAK,25,56,4,12,16
48,8477018,Ben Hutton,D,VGK,31,53,4,12,16
48,8479348,Kale Clague,D,BUF,26,37,4,12,16
48,8476525,Colin Miller,D,WPG,32,65,3,13,16
48,8480222,Sebastian Aho,D,PIT,28,70,3,13,16
48,8484149,Gavin Brindley,C,CBJ,20,46,3,13,16
48,8481014,Alexander Romanov,D,NYI,24,74,2,14,16
48,8476374,Sean Kuraly,C,CBJ,31,56,12,3,15
48,8481641,Joel Kiviranta,L,COL,28,70,9,6,15
48,8480789,Oliver Wahlstrom,R,NYI,24,72,8,7,15
48,8481601,Simon Holmstrom,R,NYI,23,60,8,7,15
48,8482762,Simon Edvinsson,D,DET,21,48,8,7,15
48,8482157,Will Cuylle,L,NYR,22,60,7,8,15
48,8478421,A.J. Greer,L,FLA,28,60,7,8,15
48,8480021,Jack Studnicka,C,LAK,25,62,7,8,15
48,8477353,Tyler Motte,C,DET,29,70,6,9,15
48,8479328,Julien Gauthier,R,NYI,27,65,6,9,15
48,8483491,Ivan Miroshnichenko,L,WSH,20,52,6,9,15
48,8479442,Troy Stecher,D,EDM,30,47,5,10,15
48,8471709,Marc-Edouard Vlasic,D,SJS,37,62,4,11,15
48,8480807,Mattias Samuelsson,D,BUF,24,54,4,11,15
48,8482087,Kaiden Guhle,D,MTL,22,67,3,12,15
48,8475279,Ben Chiarot,D,DET,33,66,3,12,15
48,8480070,Ian Mitchell,D,BOS,25,54,3,12,15
48,8480196,Jacob Bryson,D,BUF,27,33,3,12,15
48,8481167,Brayden Pachal,D,CGY,25,41,3,12,15
48,8480073,Erik Brannstrom,D,COL,25,65,2,13,15
48,8475188,Brayden McNabb,D,VGK,33,51,2,13,15
48,8475324,Nick Jensen,D,OTT,34,69,1,14,15
48,8482192,Isaak Phillips,D,CHI,23,53,1,14,15
48,8477365,Connor Clifton,D,BUF,29,56,1,14,15
48,8482155,Alex Laferriere,R,LAK,23,66,11,3,14
48,8481028,Martin Pospisil,C,CGY,25,53,10,4,14
48,8480011,Klim Kostin,C,SJS,25,49,9,5,14
48,8482148,Hendrix Lapierre,C,WSH,22,46,8,6,14
48,8481517,Brett Leason,R,ANA,25,54,8,6,14
48,8474034,Patrick Maroon,L,CHI,36,51,7,7,14
48,8480355,Mark Kastelic,C,BOS,25,67,7,7,14
48,8476329,Travis Boyd,C,MIN,31,56,7,7,14
48,8482166,Shakir Mukhamadullin,D,SJS,22,58,6,8,14
48,8482730,Brandt Clarke,D,LAK,21,56,5,9,14
48,8481093,Rafael Harvey-Pinard,L,MTL,25,63,5,9,14
48,8479536,Axel Jonsson-Fjallby,L,WPG,26,35,5,9,14
48,8481751,Lukas Rousek,R,BUF,25,37,4,10,14
48,8482073,Braden Schneider,D,NYR,23,58,3,11,14
48,8480001,Urho Vaakanainen,D,ANA,25,58,3,11,14
48,8478443,Brandon Carlo,D,BOS,28,60,3,11,14
48,8480950,Ilya Lyubushkin,D,DAL,30,59,2,12,14
48,8480058,Pierre-Olivier Joseph,D,STL,25,59,1,13,14
48,8475208,Brian Dumoulin,D,ANA,33,63,1,13,14
48,8482077,Dylan Holloway,L,EDM,23,58,10,3,13
48,8482070,Mitchell Chaffee,R,TBL,26,56,9,4,13
48,8480441,Trey Fix-Wolansky,R,CBJ,25,38,8,5,13
48,8480995,Pontus Holmberg,R,TOR,25,61,7,6,13
48,8481617,Vasily Podkolzin,R,VAN,23,47,7,6,13
48,8481161,Jake Christiansen,D,CBJ,25,56,7,6,13
48,8479439,Jacob MacDonald,D,COL,31,49,6,7,13
48,8477573,Nathan Walker,L,STL,30,51,6,7,13
48,8480252,Cole Guttman,C,CHI,25,43,6,7,13
48,8479402,Jake Bean,D,CGY,26,65,5,8,13
48,8478452,Caleb Jones,D,LAK,27,53,5,8,13
48,8481527,Kaedan Korczak,D,VGK,23,52,5,8,13
48,8478211,Dryden Hunt,L,CGY,29,61,5,8,13
48,8475718,Justin Holl,D,DET,32,69,4,9,13
48,8483619,Filip Roos,D,OTT,25,37,4,9,13
48,8482744,James Malatesta,L,CBJ,21,46,4,9,13
48,8483460,David Jiricek,D,CBJ,21,56,3,10,13
48,8478178,Darren Raddysh,D,TBL,28,63,3,10,13
48,8479359,Beck Malenstyn,L,BUF,26,42,3,10,13
48,8481178,Egor Zamula,D,PHI,24,59,2,11,13
48,8479976,Juuso Valimaki,D,UTA,26,61,2,11,13
48,8478840,Will Borgen,D,SEA,28,56,1,12,13
48,8473507,Jeff Petry,D,DET,37,75,0,13,13
48,8478399,Jonas Siegenthaler,D,NJD,27,67,0,13,13
48,8481592,Jakob Pelletier,L,CGY,23,33,7,5,12
48,8482176,Wyatt Kaiser,D,CHI,22,52,6,6,12
48,8479344,Jesse Puljujarvi,R,PIT,26,51,6,6,12
48,8480007,Jonas Rondbjerg,R,VGK,25,36,5,7,12
48,8477380,Jonny Brodzinski,C,NYR,31,50,5,7,12
48,8476952,Dominic Toninato,C,WPG,30,38,4,8,12
48,8480074,Alexandre Texier,C,STL,25,49,3,9,12
48,8480157,Calle Rosen,D,COL,30,46,3,9,12
48,8477369,Carson Soucy,D,VAN,30,64,3,9,12
48,8478859,Niko Mikkola,D,FLA,28,57,3,9,12
48,8480192,Johnathan Kovacevic,D,NJD,27,50,2,10,12
48,8479980,Nicolas Hague,D,VGK,26,47,1,11,12
48,8475455,Brenden Dillon,D,NJD,34,62,1,11,12
48,8481609,Vladislav Kolyachonok,D,UTA,23,43,8,3,11
48,8477887,Patrick Brown,C,BOS,32,41,7,4,11
48,8478831,Kevin Stenlund,C,UTA,28,56,7,4,11
48,8479941,Justin Danforth,R,CBJ,31,55,6,5,11
48,8475842,Sam Carrick,C,NYR,32,55,6,5,11
48,8476867,Brendan Gaunce,C,MIN,30,34,6,5,11
48,8476873,Mark Jankowski,C,NSH,30,48,5,6,11
48,8473453,Trevor Lewis,C,LAK,37,70,5,6,11
48,8481599,Victor Soderstrom,D,UTA,23,40,5,6,11
48,8481716,Dmitri Voronkov,L,CBJ,24,43,5,6,11
48,8480887,Jordan Harris,D,MTL,24,54,3,8,11
48,8477962,Brendan Lemieux,L,CAR,28,41,3,8,11
48,8475179,Dmitry Kulikov,D,FLA,34,64,2,9,11
48,8481708,Zac Jones,D,NYR,24,47,2,9,11
48,8477810,Joel Hanley,D,CGY,33,30,2,9,11
48,8475750,Jon Merrill,D,MIN,32,65,1,10,11
48,8480172,Jan Rutta,D,SJS,34,62,0,11,11
48,8474166,Alec Martinez,D,CHI,37,57,0,11,11
48,8476874,Olli Maatta,D,DET,30,55,0,11,11
48,8480880,Jakub Lauko,C,MIN,24,42,8,2,10
48,8479968,Vinni Lettieri,C,BOS,29,44,6,4,10
48,8481518,Nolan Foote,L,NJD,24,38,5,5,10
48,8482807,Ethan Del Mastro,D,CHI,21,47,5,5,10
48,8479291,Kevin Rooney,C,CGY,31,45,4,6,10
48,8482634,Alex Steeves,C,TOR,25,49,4,6,10
48,8474567,Zach Bogosian,D,MIN,34,64,4,6,10
48,8481537,Nikita Okhotiuk,D,CGY,24,53,4,6,10
48,8477851,Jordan Oesterle,D,BOS,32,48,4,6,10
48,8477070,Liam O'Brien,C,UTA,30,59,4,6,10
48,8477462,Robert Hagg,D,VGK,29,23,4,6,10
48,8483499,Liam Ohgren,L,MIN,20,47,3,7,10
48,8474090,Brendan Smith,D,DAL,35,62,3,7,10
48,8482861,Vincent Iorio,D,WSH,22,34,3,7,10
48,8484254,Akito Hirose,D,VAN,25,41,2,8,10
48,8481701,Santeri Hatakka,D,NJD,23,32,1,9,10
48,8473446,Erik Johnson,D,PHI,36,43,0,10,10
48,8479944,Zach Aston-Reese,C,VGK,30,47,5,4,9
48,8479336,Carl Grundstrom,R,SJS,27,47,5,4,9
48,8481532,Alex Turcotte,C,LAK,23,42,5,4,9
48,8482784,Zach Dean,C,STL,21,47,5,4,9
48,8480848,Ty Dellandrea,C,SJS,24,41,5,4,9
48,8479972,Mason Shaw,C,WPG,26,36,5,4,9
48,8480845,Rasmus Kupari,C,WPG,24,39,4,5,9
48,8481056,Spencer Stastney,D,NSH,24,32,4,5,9
48,8477527,Ross Johnston,L,ANA,30,29,4,5,9
48,8481598,Philip Broberg,D,EDM,23,43,3,6,9
48,8482859,Zack Ostapchuk,C,OTT,21,54,3,6,9
48,8482751,Ryan Winterton,C,SEA,21,37,3,6,9
48,8483466,Kevin Korchinski,D,CHI,20,46,3,6,9
48,8481600,Tobias Bjornfot,D,FLA,23,42,3,6,9
48,8483570,Ben Meyers,C,SEA,26,27,3,6,9
48,8477938,Haydn Fleury,D,WPG,28,45,2,7,9
48,8479379,Givani Smith,R,SJS,26,35,2,7,9
48,8474013,Ian Cole,D,UTA,35,54,2,7,9
48,8479369,Andrew Peeke,D,BOS,26,47,1,8,9
48,8479249,Andrew Poturalski,C,SJS,30,41,1,8,9
48,8479718,Alex Barré-Boulet,C,MTL,27,44,7,1,8
48,8479772,Zack MacEwen,R,OTT,28,47,7,1,8
48,8476934,Brock McGinn,L,ANA,30,51,5,3,8
48,8481567,Henry Thrun,D,SJS,23,46,5,3,8
48,8482145,Mavrik Bourque,C,DAL,22,53,4,4,8
48,8483630,Pavol Regenda,L,ANA,25,35,4,4,8
48,8481719,Maxwell Crozier,D,TBL,24,17,4,4,8
48,8481568,Alex Vlasic,D,CHI,23,46,3,5,8
48,8482666,Scott Morrow,D,CAR,22,44,3,5,8
48,8478424,Jansen Harkins,C,ANA,27,41,3,5,8
48,8479378,Logan Stanley,D,WPG,26,40,3,5,8
48,8481754,Nikita Nesterenko,C,ANA,23,38,3,5,8
48,8482747,Brennan Othmann,L,NYR,21,31,3,5,8
48,8476372,Nick Seeler,D,PHI,31,47,2,6,8
48,8477384,Joshua Brown,D,EDM,30,45,2,6,8
48,8479981,Jonah Gadjovich,L,FLA,26,37,2,6,8
48,8478017,Mark Friedman,D,VAN,29,39,2,6,8
48,8484258,Sam Malinski,D,COL,26,24,2,6,8
48,8480870,Bo Groulx,C,NYR,24,34,2,6,8
48,8481605,Jackson LaCombe,D,ANA,23,30,2,6,8
48,8478454,Noah Juulsen,D,VAN,27,37,1,7,8
48,8480292,Carson Meyer,R,ANA,27,33,5,2,7
48,8481550,Adam Beckman,L,NJD,23,39,4,3,7
48,8479985,Cale Fleury,D,SEA,26,30,4,3,7
48,8483012,Logan Morrison,C,SEA,22,40,4,3,7
48,8482652,Walker Duehr,R,CGY,27,39,3,4,7
48,8482733,Logan Mailloux,D,MTL,31,32,3,4,7
48,8478468,Jeremy Lauzon,D,NSH,27,56,2,5,7
48,8481122,Simon Benoit,D,TOR,26,44,2,5,7
48,8475233,David Savard,D,MTL,34,61,1,6,7
48,8476473,Connor Murphy,D,CHI,31,38,1,6,7
48,8479320,Maxime Lajoie,D,SEA,27,27,1,6,7
48,8483495,Simon Nemec,D,NJD,20,53,0,7,7
48,8475177,Calvin de Haan,D,COL,33,45,0,7,7
48,8483549,Lucas Condotta,L,MTL,27,30,0,7,7
48,8481789,Tye Kartye,L,SEA,23,37,6,0,6
48,8482964,Arber Xhekaj,D,MTL,23,46,3,3,6
48,8482496,Nils Aman,C,VAN,24,36,3,3,6
48,8476442,Matt Nieto,L,PIT,32,46,3,3,6
48,8483763,Maksymilian Szuber,D,UTA,22,31,3,3,6
48,8471817,Ryan Reaves,R,TOR,37,53,2,4,6
48,8479986,Kole Lind,R,DAL,26,46,2,4,6
48,8480990,Declan Chisholm,D,MIN,24,38,2,4,6
48,8477335,Kyle Burroughs,D,LAK,29,44,2,4,6
48,8478874,Adam Gaudette,R,OTT,28,34,2,4,6
48,8480245,Olle Lycksell,R,PHI,25,31,2,4,6
48,8480834,Ty Emberson,D,SJS,24,37,2,4,6
48,8482929,Emil Lilleberg,D,TBL,23,24,2,4,6
48,8477473,Justin Bailey,R,SJS,29,35,2,4,6
48,8476441,Joel Edmundson,D,LAK,31,40,1,5,6
48,8480727,Zach Whitecloud,D,VGK,28,44,1,5,6
48,8481743,Marc Del Gaizo,D,NSH,25,19,1,5,6
48,8474612,Travis Hamonic,D,OTT,34,50,0,6,6
48,8476858,Phillip Di Giuseppe,L,VAN,31,47,5,0,5
48,8481147,Reese Johnson,C,MIN,26,44,4,1,5
48,8484911,Collin Graf,R,SJS,22,43,3,2,5
48,8475958,Michael Sgarbossa,C,WSH,32,30,3,2,5
48,8482659,Josh Doan,R,UTA,22,46,2,3,5
48,8481679,Maxence Guenette,D,OTT,23,36,2,3,5
48,8479991,Jake Leschyshyn,C,NYR,25,41,2,3,5
48,8482516,Matthew Kessel,D,STL,24,19,2,3,5
48,8480084,Nick DeSimone,D,NJD,30,19,2,3,5
48,8481564,Ryan Johnson,D,BUF,23,18,2,3,5
48,8478450,Parker Wotherspoon,D,BOS,27,35,1,4,5
48,8482511,Mason Lohrei,D,BOS,23,38,1,4,5
48,8471677,Jack Johnson,D,CBJ,37,67,1,4,5
48,8477034,Jaycob Megna,D,FLA,32,50,0,5,5
48,8482147,Jean-Luc Foudy,C,COL,22,15,3,1,4
48,8479576,Vincent Desharnais,D,VAN,28,35,2,2,4
48,8482177,Marat Khusnutdinov,C,MIN,22,36,2,2,4
48,8480267,Sammy Walker,C,MIN,25,19,2,2,4
48,8479638,Justin Brazeau,R,BOS,26,47,1,3,4
48,8481556,John Beecher,C,BOS,23,35,1,3,4
48,8478146,Matthew Highmore,C,OTT,28,34,1,3,4
48,8482095,Tyler Kleven,D,OTT,22,32,1,3,4
48,8482470,Ilya Solovyov,D,CGY,24,16,1,3,4
48,8477971,Andreas Englund,D,LAK,28,32,1,3,4
48,8480032,Shane Bowers,C,NJD,25,16,3,0,3
48,8478409,Anthony Richard,C,PHI,28,28,2,1,3
48,8482153,Brendan Brisson,C,VGK,23,36,2,1,3
48,8483597,Milos Kelemen,L,UTA,25,9,2,1,3
48,8478477,Mitchell Stephens,C,SEA,27,18,2,1,3
48,8481543,Nikita Alexandrov,C,STL,24,22,2,1,3
48,8479362,Riley Tufte,L,BOS,26,16,2,1,3
48,8481006,Tyler Tucker,D,STL,24,12,2,1,3
48,8480890,Jan Jenik,C,OTT,24,20,2,1,3
48,8482713,Mackie Samoskevich,R,FLA,22,36,2,1,3
48,8475762,Derek Forbort,D,VAN,32,39,1,2,3
48,8478051,Max Willman,C,NJD,29,20,1,2,3
48,8481065,Angus Crookshank,L,OTT,25,22,1,2,3
48,8481541,Samuel Bolduc,D,NYI,24,28,1,2,3
48,8477467,Gustav Olofsson,D,SEA,30,22,1,2,3
48,8480879,Jacob Bernard-Docker,D,OTT,24,48,0,3,3
48,8478021,William Lagesson,D,DET,28,24,0,3,3
48,8478502,Dennis Gilbert,D,BUF,28,23,0,3,3
48,8484325,Waltteri Merela,C,TBL,26,20,0,3,3
48,8479419,Brett Murray,L,BUF,26,17,0,3,3
48,8477149,Scott Sabourin,R,SJS,32,20,0,3,3
48,8482165,Yan Kuznetsov,D,CGY,22,22,0,3,3
48,8477244,Chad Ruhwedel,D,NYR,34,33,0,3,3
48,8480844,Grigori Denisenko,L,VGK,24,30,2,0,2
48,8482061,Brandon Biro,L,SEA,26,13,2,0,2
48,8480851,Akil Thomas,C,LAK,24,14,2,0,2
48,8481237,Kyle MacLean,C,NYI,25,27,2,0,2
48,8474568,Luke Schenn,D,NSH,35,38,1,1,2
48,8483397,Marc McLaughlin,C,BOS,25,28,1,1,2
48,8481806,Louis Crevier,D,CHI,23,14,1,1,2
48,8482118,Sam Colangelo,R,ANA,23,12,1,1,2
48,8479367,William Lockwood,R,FLA,26,31,1,1,2
48,8482201,Gage Goncalves,C,TBL,23,20,1,1,2
48,8478881,Brett Seney,L,CHI,28,9,1,1,2
48,8482172,Landon Slaggert,L,CHI,22,19,1,1,2
48,8482144,Jack Thompson,D,SJS,22,23,1,1,2
48,8477073,Kurtis MacDermid,L,NJD,30,30,1,1,2
48,8481030,Jack St. Ivany,D,PIT,25,14,1,1,2
48,8480468,James Hamblin,L,EDM,25,21,1,1,2
48,8476913,Devin Shore,C,MIN,30,33,1,1,2
48,8483512,Matthew Savoie,C,EDM,20,27,1,1,2
48,8475795,Dylan McIlrath,D,WSH,32,21,1,1,2
48,8481593,Jayden Struble,D,MTL,23,30,1,1,2
48,8481206,John Ludvig,D,PIT,24,16,1,1,2
48,8479421,Jacob Moverare,D,LAK,26,8,1,1,2
48,8481422,Jake Lucchini,C,NSH,29,26,0,2,2
48,8482765,Isak Rosen,R,BUF,21,28,0,2,2
48,8475780,Chris Wagner,R,COL,33,11,0,2,2
48,8482250,Callahan Burke,C,VGK,27,17,0,2,2
48,8478011,Louie Belpedio,D,PHI,28,13,0,2,2
48,8478446,Glenn Gawdin,C,LAK,27,19,0,2,2
48,8483546,Marshall Rifai,D,TOR,26,9,0,2,2
48,8478854,Ryan Shea,D,PIT,27,8,0,2,2
48,8482126,Emil Andrae,D,PHI,31,3,0,2,2
48,8484287,Cole McWard,D,VAN,23,18,1,0,1
48,8477541,Dakota Mermis,D,TOR,30,6,1,0,1
48,8475755,Alexander Petrovic,D,DAL,32,7,1,0,1
48,8482476,Emil Heineman,L,MTL,23,10,1,0,1
48,8481534,Raphael Lavoie,C,EDM,24,3,1,0,1
48,8482197,Adam Raska,R,MIN,23,4,1,0,1
48,8475235,Nicolas Deslauriers,L,PHI,33,47,0,1,1
48,8482858,Ryker Evans,D,SEA,23,22,0,1,1
48,8477320,Anton Blidh,L,NYR,29,17,0,1,1
48,8480874,Adam Ginning,D,PHI,24,8,0,1,1
48,8474062,Riley Nash,C,NYR,35,13,0,1,1
48,8480823,Alexander Alexeyev,D,WSH,25,13,0,1,1
48,8484304,Uvis Balinskis,D,FLA,28,7,0,1,1
48,8475413,Justin Dowling,C,NJD,34,16,0,1,1
48,8483471,Brad Lambert,C,WPG,31,9,0,1,1
48,8481655,Cole Schwindt,R,CGY,23,9,0,1,1
48,8481585,Egor Afanasyev,L,SJS,23,17,0,1,1
48,8481699,Aku Raty,R,UTA,23,17,0,1,1
48,8483407,Brandon Scanlin,D,NYR,25,7,0,1,1
48,8484326,Patrik Koch,D,UTA,28,4,0,1,1
48,8482141,Lukas Cormier,D,VGK,22,24,0,0,0
48,8479587,Rhett Gardner,C,PHI,28,16,0,0,0
48,8477401,John Hayden,C,SEA,29,19,0,0,0
48,8480075,Cameron Crotty,D,MIN,25,6,0,0,0
48,8482102,Vasily Ponomarev,C,PIT,22,11,0,0,0
48,8482088,Justin Sourdif,R,FLA,22,15,0,0,0
48,8483398,Declan Carlile,D,TBL,31,10,0,0,0
48,8481043,Cole Koepke,L,BOS,26,9,0,0,0
48,8481462,Mason Morelli,L,VGK,28,9,0,0,0
48,8484255,Jason Polin,R,COL,25,4,0,0,0
48,8483531,Brian Halonen,L,NJD,25,2,0,0,0
48,8482094,Daemon Hunt,D,MIN,22,11,0,0,0
48,8476323,Max McCormick,L,SEA,32,1,0,0,0
48,8483920,Pierrick Dube,R,WSH,23,3,0,0,0
48,8483567,Georgii Merkulov,C,BOS,24,11,0,0,0
48,8482162,Roby Jarventie,L,EDM,22,11,0,0,0
48,8482460,Matt Rempe,C,NYR,22,7,0,0,0
48,8481578,Graeme Clarke,R,MIN,23,14,0,0,0
48,8483395,Arshdeep Bains,L,VAN,23,11,0,0,0
48,8480306,Grant Hutton,D,NYI,29,8,0,0,0
48,8481024,Linus Karlsson,C,VAN,25,5,0,0,0
48,8478147,Bokondji Imama,L,PIT,28,4,0,0,0
48,8481726,Adam Edstrom,C,NYR,24,4,0,0,0
48,8483489,Fraser Minten,C,TOR,31,12,0,0,0
48,8482787,Nikita Chibrikov,R,WPG,31,6,0,0,0
48,8483432,Luca Del Bel Belluz,C,CBJ,31,2,0,0,0
48,8484259,Ondrej Pavel,C,COL,31,2,0,0,0
48,8479330,Brandon Gignac,C,MTL,27,7,0,0,0
48,8477993,Justin Kirkland,C,CGY,28,5,0,0,0
48,8484321,Nikolas Matinpalo,D,OTT,26,0,0,0,0
48,8479522,Hardy Haman Aktell,D,WSH,26,3,0,0,0
48,8483609,Adam Klapka,R,CGY,24,3,0,0,0
48,8480274,Philip Kemp,D,EDM,25,0,0,0,0
48,8483401,Marc Johnstone,R,PIT,28,2,0,0,0
48,8470794,Joe Pavelski,C,,40,0,0,0,0
48,8479321,Lucas Johansen,D,,27,0,0,0,0
48,8477950,Tony DeAngelo,D,,29,0,0,0,0
48,8471218,Blake Wheeler,R,,38,0,0,0,0
48,8475197,Tyson Barrie,D,,33,0,0,0,0
48,8474157,Max Pacioretty,L,,36,0,0,0,0
48,8475744,Evgeny Kuznetsov,C,,32,0,0,0,0
48,8474037,James van Riemsdyk,L,,35,0,0,0,0
48,8476907,Mackenzie MacEachern,L,,30,0,0,0,0
48,8480216,Jacob Peterson,C,,25,0,0,0,0
48,8474602,Justin Schultz,D,,34,0,0,0,0
48,8482222,Alexander Barabanov,L,,30,0,0,0,0
48,8474031,Kevin Shattenkirk,D,,35,0,0,0,0
48,8477330,Dominik Kubalik,L,,29,0,0,0,0
48,8480884,Calen Addison,D,,24,0,0,0,0
48,8475906,John Klingberg,D,,32,0,0,0,0
48,8480008,Adam Ruzicka,C,,25,0,0,0,0
48,8476884,Derrick Pouliot,D,,30,0,0,0,0
48,8476919,Chris Tierney,C,,30,0,0,0,0
48,8479415,Michael McLeod,C,,26,0,0,0,0
48,8474870,Tyler Johnson,C,,34,0,0,0,0
48,8470604,Jeff Carter,C,,39,0,0,0,0
48,8478104,Sammy Blais,L,,28,0,0,0,0
48,8474884,Mike Hoffman,C,,35,0,0,0,0
48,8481591,Sam Poulin,R,,23,0,0,0,0
48,8471274,Alex Goligoski,D,,39,0,0,0,0
48,8476871,Tanner Pearson,L,,32,0,0,0,0
48,8476393,Nick Cousins,C,,31,0,0,0,0
48,8479977,Kailer Yamamoto,R,,26,0,0,0,0
48,8479346,Dillon Dube,C,,26,0,0,0,0
48,8480184,Gustav Lindstrom,D,,26,0,0,0,0
48,8479376,Victor Mete,D,,26,0,0,0,0
48,8473449,Kyle Okposo,R,,36,0,0,0,0
48,8481058,Jesse Ylonen,R,,25,0,0,0,0
48,8475752,Tyler Pitlick,C,,33,0,0,0,0
48,8481239,Samuel Fagemo,L,,24,0,0,0,0
48,8480821,Filip Zadina,R,,25,0,0,0,0
48,8470966,Mark Giordano,D,,41,0,0,0,0
48,8478495,Denis Gurianov,R,,27,0,0,0,0
48,8477464,Nic Petan,C,,29,0,0,0,0
48,8478099,Kevin Labanc,R,,29,0,0,0,0
48,8482241,Radim Zohorna,L,,28,0,0,0,0
48,8474040,Sam Gagner,C,,35,0,0,0,0
48,8479514,Rem Pitlick,C,,27,0,0,0,0
48,8478430,Oliver Kylington,D,,27,0,0,0,0
48,8479533,Joona Koppanen,L,,26,0,0,0,0
48,8479984,Cal Foote,D,,26,0,0,0,0
48,8477126,Jayson Megna,C,,34,0,0,0,0
48,8475164,Jakob Silfverberg,R,,34,0,0,0,0
48,8474009,Nick Bonino,C,,36,0,0,0,0
48,8479458,Nikita Zaitsev,D,,33,0,0,0,0
48,8477944,Jakub Vrana,L,,28,0,0,0,0
48,8471699,Andrew Cogliano,C,,37,0,0,0,0
48,8478067,Oskar Lindblom,L,,28,0,0,0,0
48,8471686,Marc Staal,D,,37,0,0,0,0
48,8470610,Zach Parise,L,,40,0,0,0,0
48,8478904,Steven Lorentz,C,,28,0,0,0,0
48,8473473,Milan Lucic,L,,36,0,0,0,0
48,8480031,Maxime Comtois,L,,25,0,0,0,0
48,8478512,Austin Czarnik,C,,32,0,0,0,0
48,8473504,Cal Clutterbuck,R,,37,0,0,0,0
48,8477454,Adam Erne,L,,29,0,0,0,0
48,8479383,Boris Katchouk,L,,26,0,0,0,0
48,8475825,Jani Hakanpää,D,,32,0,0,0,0
48,8477846,Ryan Carpenter,C,,33,0,0,0,0
48,8477930,Pierre-Edouard Bellemare,L,,39,0,0,0,0
48,8478400,Colin White,C,,27,0,0,0,0
48,8480226,Marián Studenic,R,,26,0,0,0,0
48,8480853,Liam Foudy,C,,24,0,0,0,0
48,8475797,Jarred Tinordi,D,,32,0,0,0,0
48,8479423,Alex Nylander,L,,26,0,0,0,0
48,8474618,Marco Scandella,D,,34,0,0,0,0
48,8478028,Fredrik Olofsson,L,,28,0,0,0,0
48,8474709,Matt Martin,L,,35,0,0,0,0
48,8481070,Hugh McGing,L,,26,0,0,0,0
48,8479546,Oskar Steen,C,,26,0,0,0,0
48,8474145,Robert Bortuzzo,D,,35,0,0,0,0
48,8476915,Jujhar Khaira,L,,30,0,0,0,0
48,8475278,Byron Froese,C,,33,0,0,0,0
48,8481812,Nikolai Knyzhov,D,,27,0,0,0,0
48,8478408,Travis Dermott,D,,28,0,0,0,0
48,8481077,John Leonard,L,,26,0,0,0,0
48,8479547,Matthew Phillips,R,,26,0,0,0,0
48,8480836,Jonathan Gruden,C,,24,0,0,0,0
48,8481690,Tyler Angle,C,,24,0,0,0,0
48,8475766,Austin Watson,L,,32,0,0,0,0
48,8481016,Ruslan Iskhakov,C,,24,0,0,0,0
48,8478078,Rourke Chartier,C,,28,0,0,0,0
48,8480776,Sheldon Rempal,R,,29,0,0,0,0
48,8478956,Samuel Laberge,L,NJD,27,0,0,0,0
48,8483045,Cameron Butler,R,CBJ,31,2,0,0,0
48,8484314,Jiri Smejkal,L,,28,0,0,0,0
49,8478402,Connor McDavid,C,EDM,27,77,54,104,158
49,8476453,Nikita Kucherov,R,TBL,31,82,39,97,136
49,8477956,David Pastrnak,R,BOS,28,81,64,56,120
49,8479314,Matthew Tkachuk,L,FLA,27,82,34,86,120
49,8477492,Nathan MacKinnon,C,COL,29,82,48,68,116
49,8477493,Aleksander Barkov,C,FLA,29,79,33,83,116
49,8477934,Leon Draisaitl,C,EDM,29,78,45,70,115
49,8479318,Auston Matthews,C,TOR,27,78,59,52,111
49,8478420,Mikko Rantanen,R,COL,28,82,39,70,109
49,8478550,Artemi Panarin,L,NYR,33,80,31,77,108
49,8476887,Filip Forsberg,L,NSH,30,78,51,56,107
49,8474600,Roman Josi,D,NSH,34,77,25,82,107
49,8478483,Mitch Marner,R,TOR,27,81,25,81,106
49,8481559,Jack Hughes,C,NJD,23,68,41,64,105
49,8479407,Jesper Bratt,L,NJD,26,80,41,58,99
49,8477933,Sam Reinhart,C,FLA,29,76,43,55,98
49,8478010,Brayden Point,C,TBL,28,82,44,53,97
49,8476468,J.T. Miller,C,VAN,31,79,38,57,95
49,8480027,Jason Robertson,L,DAL,25,81,35,60,95
49,8479385,Jordan Kyrou,C,STL,26,82,47,47,94
49,8480801,Brady Tkachuk,L,OTT,25,81,39,54,93
49,8477404,Jake Guentzel,C,TBL,30,82,36,56,92
49,8478864,Kirill Kaprizov,L,MIN,27,69,40,51,91
49,8480012,Elias Pettersson,C,VAN,26,79,38,53,91
49,8480036,Miro Heiskanen,D,DAL,25,79,20,69,89
49,8478427,Sebastian Aho,C,CAR,27,73,41,47,88
49,8477942,Kevin Fiala,L,LAK,28,80,35,53,88
49,8480069,Cale Makar,D,COL,26,77,25,63,88
49,8478440,Dylan Strome,C,WSH,27,76,30,57,87
49,8479343,Clayton Keller,R,UTA,26,79,38,47,85
49,8480002,Nico Hischier,C,NJD,25,77,33,51,84
49,8480800,Quinn Hughes,D,VAN,25,75,13,71,84
49,8477946,Dylan Larkin,C,DET,28,80,41,42,83
49,8479542,Brandon Hagel,L,TBL,26,82,39,44,83
49,8476460,Mark Scheifele,C,WPG,31,76,34,49,83
49,8481557,Matt Boldy,L,MIN,23,74,34,49,83
49,8478414,Timo Meier,R,NJD,28,77,31,52,83
49,8478398,Kyle Connor,L,WPG,28,72,42,40,82
49,8478445,Mathew Barzal,C,NYI,27,79,21,60,81
49,8477939,William Nylander,R,TOR,28,79,44,36,80
49,8475166,John Tavares,C,TOR,34,81,37,43,80
49,8477949,Alex Tuch,R,BUF,28,76,25,54,79
49,8476346,Johnny Gaudreau,L,CBJ,31,70,23,56,79
49,8479323,Adam Fox,D,NYR,26,73,11,68,79
49,8474564,Steven Stamkos,C,NSH,34,78,34,44,78
49,8475172,Nazem Kadri,C,CGY,34,77,31,47,78
49,8471685,Anze Kopitar,C,LAK,37,80,29,49,78
49,8476454,Ryan Nugent-Hopkins,C,EDM,31,80,28,50,78
49,8476905,Chandler Stephenson,C,SEA,30,73,23,55,78
49,8475168,Matt Duchene,C,DAL,33,81,37,40,77
49,8482116,Tim Stützle,C,OTT,22,82,33,44,77
49,8471675,Sidney Crosby,C,PIT,37,75,31,46,77
49,8480208,Drake Batherson,R,OTT,26,82,29,48,77
49,8484144,Connor Bedard,C,CHI,19,68,26,51,77
49,8478439,Travis Konecny,R,PHI,27,78,28,48,76
49,8477960,Adrian Kempe,R,LAK,28,82,32,43,75
49,8477402,Pavel Buchnevich,L,STL,29,79,28,47,75
49,8475184,Chris Kreider,L,NYR,33,77,38,36,74
49,8481540,Cole Caufield,R,MTL,23,79,33,41,74
49,8471214,Alex Ovechkin,L,WSH,39,72,32,42,74
49,8478403,Jack Eichel,C,VGK,28,77,30,44,74
49,8480803,Evan Bouchard,D,EDM,25,77,19,54,73
49,8476456,Jonathan Huberdeau,C,CGY,31,81,17,56,73
49,8477409,Carter Verhaeghe,C,FLA,29,77,40,32,72
49,8477951,Nick Schmaltz,C,UTA,28,79,27,45,72
49,8480830,Andrei Svechnikov,R,CAR,24,70,28,43,71
49,8471215,Evgeni Malkin,C,PIT,38,78,24,47,71
49,8480023,Robert Thomas,C,STL,25,73,22,49,71
49,8473419,Brad Marchand,L,BOS,36,80,19,52,71
49,8476389,Vincent Trocheck,C,NYR,31,74,32,38,70
49,8481528,Dylan Cozens,C,BUF,23,70,29,41,70
49,8475692,Mats Zuccarello,R,MIN,37,67,13,57,70
49,8477496,Elias Lindholm,C,BOS,30,79,32,37,69
49,8475784,Jeff Skinner,C,EDM,32,75,28,41,69
49,8480018,Nick Suzuki,C,MTL,25,77,14,55,69
49,8475786,Zach Hyman,L,EDM,32,80,32,35,67
49,8476539,Jonathan Marchessault,R,NSH,34,75,39,27,66
49,8478047,Michael Bunting,L,PIT,29,76,29,37,66
49,8476882,Teuvo Teravainen,C,CHI,30,69,20,46,66
49,8475798,Mikael Granlund,C,SJS,32,70,16,50,66
49,8477501,Valeri Nichushkin,R,COL,29,81,29,36,65
49,8482078,Lucas Raymond,L,DET,22,82,29,36,65
49,8475810,Bryan Rust,R,PIT,32,74,26,39,65
49,8476881,Tomas Hertl,C,VGK,31,79,26,39,65
49,8478401,Pavel Zacha,C,BOS,27,79,23,42,65
49,8478449,Roope Hintz,C,DAL,28,82,32,32,64
49,8473994,Jamie Benn,L,DAL,35,81,26,38,64
49,8474141,Patrick Kane,R,DET,36,78,23,41,64
49,8473512,Claude Giroux,R,OTT,36,80,18,46,64
49,8477494,Jonathan Drouin,L,COL,29,79,28,35,63
49,8476459,Mika Zibanejad,C,NYR,31,71,25,38,63
49,8478460,Zach Werenski,D,CBJ,27,80,19,44,63
49,8475167,Victor Hedman,D,TBL,34,75,10,53,63
49,8475754,Brock Nelson,C,NYI,33,77,29,33,62
49,8482109,Alexis Lafrenière,L,NYR,23,74,25,37,62
49,8479339,Patrik Laine,L,CBJ,26,65,24,38,62
49,8475765,Vladimir Tarasenko,R,DET,33,78,23,39,62
49,8474590,John Carlson,D,WSH,34,72,11,51,62
49,8479675,Trevor Moore,L,LAK,29,80,25,36,61
49,8482665,Matty Beniers,C,SEA,22,77,24,37,61
49,8481068,Yegor Sharangovich,C,CGY,26,78,34,26,60
49,8477940,Nikolaj Ehlers,L,WPG,28,74,26,34,60
49,8479337,Alex DeBrincat,R,DET,27,80,23,37,60
49,8475913,Mark Stone,R,VGK,32,77,21,39,60
49,8477504,Josh Morrissey,D,WPG,29,71,13,47,60
49,8478444,Brock Boeser,R,VAN,27,73,34,25,59
49,8482740,Wyatt Johnston,C,DAL,21,82,29,30,59
49,8477500,Bo Horvat,C,NYI,29,79,27,32,59
49,8478042,Viktor Arvidsson,L,EDM,31,75,27,32,59
49,8482699,Dylan Guenther,R,UTA,21,77,26,33,59
49,8477503,Max Domi,C,TOR,29,77,17,42,59
49,8476906,Shayne Gostisbehere,D,CAR,31,75,16,43,59
49,8477479,Tyler Bertuzzi,L,CHI,29,70,25,33,58
49,8478873,Troy Terry,R,ANA,27,74,23,35,58
49,8476483,Rickard Rakell,R,PIT,31,67,21,37,58
49,8482124,Quinton Byfield,R,LAK,22,79,18,40,58
49,8478493,Joel Eriksson Ek,C,MIN,27,79,29,28,57
49,8479420,Tage Thompson,C,BUF,27,74,26,31,57
49,8474102,David Perron,L,OTT,36,76,19,38,57
49,8478458,John (Jack) Roslovic,C,CAR,27,63,15,42,57
49,8476923,Damon Severson,D,CBJ,30,76,14,43,57
49,8480839,Rasmus Dahlin,D,BUF,24,68,11,46,57
49,8480185,Eetu Luostarinen,C,FLA,26,72,27,29,56
49,8484153,Leo Carlsson,C,ANA,20,76,26,30,56
49,8482671,Owen Power,D,BUF,22,74,21,35,56
49,8477021,Alex Kerfoot,C,UTA,30,76,17,39,56
49,8477476,Artturi Lehkonen,L,COL,29,82,34,21,55
49,8475726,Tyler Toffoli,C,SJS,32,71,28,27,55
49,8481711,Matias Maccelli,L,UTA,24,74,23,32,55
49,8475745,Charlie Coyle,C,BOS,32,80,22,33,55
49,8475158,Ryan O'Reilly,C,NSH,33,76,20,35,55
49,8474578,Erik Karlsson,D,PIT,34,79,20,35,55
49,8474150,Mikael Backlund,C,CGY,35,76,19,36,55
49,8477986,Brandon Montour,D,SEA,30,76,16,39,55
49,8471724,Kris Letang,D,PIT,37,81,12,43,55
49,8477955,Jared McCann,L,SEA,28,70,25,29,54
49,8476448,William Karlsson,C,VGK,31,74,23,31,54
49,8482684,Luke Hughes,D,NJD,21,75,12,42,54
49,8476432,Boone Jenner,C,CBJ,31,65,30,23,53
49,8480188,Fabian Zetterlund,L,SJS,25,71,26,27,53
49,8482110,Dawson Mercer,C,NJD,23,73,24,29,53
49,8480028,Morgan Frost,C,PHI,25,74,20,33,53
49,8476853,Morgan Rielly,D,TOR,30,67,8,45,53
49,8475169,Evander Kane,L,EDM,33,75,27,25,52
49,8479992,Michael Rasmussen,C,DET,25,81,24,28,52
49,8477998,Warren Foegele,L,LAK,28,76,18,34,52
49,8480865,Noah Dobson,D,NYI,24,80,14,38,52
49,8476958,Jaccob Slavin,D,CAR,30,78,9,43,52
49,8478498,Jake DeBrusk,L,VAN,28,77,24,27,51
49,8482113,Anton Lundell,C,FLA,23,79,22,29,51
49,8479999,Casey Mittelstadt,C,COL,26,80,20,31,51
49,8482093,Seth Jarvis,C,CAR,22,67,18,33,51
49,8474679,Gustav Nyquist,C,NSH,35,75,16,35,51
49,8477495,Seth Jones,D,CHI,30,76,16,35,51
49,8479410,Mikhail Sergachev,D,UTA,26,73,9,42,51
49,8477407,Anthony Duclair,L,NYI,29,77,28,22,50
49,8480849,Barrett Hayton,C,UTA,24,74,22,28,50
49,8482745,Mason McTavish,C,ANA,21,74,21,29,50
49,8484166,Adam Fantilli,C,CBJ,20,67,21,29,50
49,8478856,Conor Garland,R,VAN,28,74,21,29,50
49,8475170,Brayden Schenn,C,STL,33,79,20,30,50
49,8477935,Sam Bennett,C,FLA,28,79,19,31,50
49,8474586,Jordan Eberle,R,SEA,34,75,18,32,50
49,8476875,Mike Matheson,D,MTL,30,71,15,35,50
49,8476399,Blake Coleman,C,CGY,33,81,25,24,49
49,8480014,Gabriel Vilardi,C,WPG,25,68,25,24,49
49,8476880,Tom Wilson,R,WSH,30,69,22,27,49
49,8478233,Andrew Mangiapane,L,WSH,28,77,20,29,49
49,8478542,Evan Rodrigues,C,FLA,31,76,16,33,49
49,8482149,Cole Perfetti,C,WPG,22,66,16,33,49
49,8478469,Thomas Chabot,D,OTT,27,74,13,36,49
49,8482159,Tyson Foerster,R,PHI,22,72,20,28,48
49,8483515,Juraj Slafkovsky,L,MTL,20,78,20,28,48
49,8478519,Anthony Cirelli,C,TBL,27,81,19,29,48
49,8479525,Ross Colton,C,COL,28,81,27,20,47
49,8482097,Jack Quinn,R,BUF,23,69,20,27,47
49,8477456,J.T. Compher,L,DET,29,80,17,30,47
49,8476462,Dougie Hamilton,D,NJD,31,68,13,34,47
49,8478038,Devon Toews,D,COL,30,68,4,43,47
49,8483808,Andrei Kuzmenko,L,CGY,28,74,24,22,46
49,8477497,Sean Monahan,C,CBJ,30,70,23,23,46
49,8475191,Reilly Smith,R,NYR,33,72,19,27,46
49,8484145,Zach Benson,L,BUF,19,70,17,29,46
49,8481533,Trevor Zegras,C,ANA,23,69,17,29,46
49,8475314,Anders Lee,L,NYI,34,77,25,20,45
49,8478366,Frank Vatrano,R,ANA,30,68,23,22,45
49,8480039,Martin Necas,C,CAR,25,69,21,24,45
49,8476479,Phillip Danault,C,LAK,31,79,19,26,45
49,8473986,Alex Killorn,L,ANA,35,76,18,27,45
49,8478055,Gustav Forsling,D,FLA,28,76,10,35,45
49,8478407,Vince Dunn,D,SEA,28,74,10,35,45
49,8481524,Bowen Byram,D,BUF,23,68,7,38,45
49,8475151,Kyle Palmieri,C,NYI,33,82,23,21,44
49,8477964,Ivan Barbashev,C,VGK,29,79,22,22,44
49,8477416,Oliver Bjorkstrand,R,SEA,29,75,21,23,44
49,8480015,Owen Tippett,R,PHI,25,72,21,23,44
49,8479365,Trent Frederic,C,BOS,26,78,21,23,44
49,8476826,Yanni Gourde,C,SEA,33,75,16,28,44
49,8482475,Yegor Chinakhov,R,CBJ,23,68,16,28,44
49,8481186,Logan O'Connor,R,COL,28,78,16,28,44
49,8476854,Hampus Lindholm,D,BOS,30,74,8,36,44
49,8477447,Shea Theodore,D,VGK,29,58,7,37,44
49,8481560,Arthur Kaliyev,R,LAK,23,81,22,21,43
49,8477444,Andre Burakovsky,L,SEA,29,75,20,23,43
49,8480078,Filip Chytil,C,NYR,25,69,17,26,43
49,8478438,Tommy Novak,C,NSH,27,71,16,27,43
49,8476927,Teddy Blueger,C,VAN,30,68,16,27,43
49,8474563,Drew Doughty,D,LAK,35,70,7,36,43
49,8475794,Tyler Seguin,C,DAL,32,82,20,22,42
49,8477932,Aaron Ekblad,D,FLA,28,69,14,28,42
49,8470613,Brent Burns,D,CAR,39,77,13,29,42
49,8482720,Matthew Knies,L,TOR,22,76,12,30,42
49,8479325,Charlie McAvoy,D,BOS,27,75,5,37,42
49,8474149,Evgenii Dadonov,R,DAL,35,82,21,20,41
49,8476438,Brandon Saad,L,STL,32,73,21,20,41
49,8478975,Mason Marchment,L,DAL,29,81,17,24,41
49,8476458,Ryan Strome,C,ANA,31,71,17,24,41
49,8475793,Ryan Johansen,C,PHI,32,68,17,24,41
49,8481618,Alex Newhook,C,MTL,23,75,15,26,41
49,8479345,Jakob Chychrun,D,WSH,26,63,14,27,41
49,8474565,Alex Pietrangelo,D,VGK,34,63,11,30,41
49,8477498,Darnell Nurse,D,EDM,29,77,11,30,41
49,8480434,Sean Durzi,D,UTA,26,66,9,32,41
49,8476292,Ondrej Palat,L,NJD,33,68,19,21,40
49,8477987,Ryan Donato,C,CHI,28,60,18,22,40
49,8477511,Anthony Mantha,R,CGY,30,74,17,23,40
49,8480797,Joel Farabee,L,PHI,24,75,17,23,40
49,8479987,Morgan Geekie,C,BOS,26,77,16,24,40
49,8483505,Matthew Poitras,C,BOS,20,78,15,25,40
49,8478115,Pierre Engvall,L,NYI,28,79,12,28,40
49,8475753,Justin Faulk,D,STL,32,77,12,28,40
49,8481542,Moritz Seider,D,DET,23,77,6,34,40
49,8475760,Nick Bjugstad,C,UTA,32,72,19,20,39
49,8483431,Logan Cooley,C,UTA,20,72,18,21,39
49,8478474,Lawson Crouse,L,UTA,27,72,23,15,38
49,8478046,Danton Heinen,L,VAN,29,75,22,16,38
49,8481554,Kaapo Kakko,R,NYR,23,75,21,17,38
49,8480893,Kirill Marchenko,R,CBJ,24,64,21,17,38
49,8478057,Dakota Joshua,C,VAN,28,62,19,19,38
49,8481596,Shane Pinto,C,OTT,24,72,15,23,38
49,8477429,Andrew Copp,C,DET,30,79,14,24,38
49,8482705,Cole Sillinger,C,CBJ,21,67,13,25,38
49,8482105,Jake Sanderson,D,OTT,22,72,13,25,38
49,8477451,Ryan Hartman,R,MIN,30,70,13,25,38
49,8478133,Jake Evans,C,MTL,28,74,12,26,38
49,8477953,Kasperi Kapanen,R,STL,28,74,10,28,38
49,8478397,Rasmus Andersson,D,CGY,28,70,7,31,38
49,8480817,K'Andre Miller,D,NYR,24,63,7,31,38
49,8475714,Calle Jarnkrok,C,TOR,33,72,22,15,37
49,8478462,Nicolas Roy,C,VGK,27,72,19,18,37
49,8480064,Josh Norris,C,OTT,25,74,15,22,37
49,8475218,Mattias Ekholm,D,EDM,34,72,15,22,37
49,8476419,Jean-Gabriel Pageau,C,NYI,32,76,12,25,37
49,8478472,Mathieu Joseph,R,STL,27,75,12,25,37
49,8475193,Tomas Tatar,L,NJD,34,70,11,26,37
49,8475200,Dmitry Orlov,D,CAR,33,75,9,28,37
49,8476979,Erik Gustafsson,D,DET,32,73,7,30,37
49,8479425,Filip Hronek,D,VAN,27,72,5,32,37
49,8474641,Adam Henrique,C,EDM,34,75,20,16,36
49,8477426,Nicholas Paul,L,TBL,29,81,20,16,36
49,8476474,Stefan Noesen,R,NJD,31,68,18,18,36
49,8475768,Jaden Schwartz,C,SEA,32,66,15,21,36
49,8481656,Aliaksei Protas,C,WSH,23,68,14,22,36
49,8476869,Brady Skjei,D,NSH,30,75,9,27,36
49,8481703,Valtteri Puustinen,R,PIT,25,64,9,27,36
49,8482667,William Eklund,L,SJS,22,67,8,28,36
49,8481582,Nicholas Robertson,L,TOR,23,76,21,14,35
49,8471698,T.J. Oshie,R,WSH,38,61,20,15,35
49,8470621,Corey Perry,R,EDM,39,68,19,16,35
49,8477952,Robby Fabbri,C,ANA,28,66,18,17,35
49,8478466,Daniel Sprong,R,VAN,27,74,16,19,35
49,8476872,Scott Laughton,C,PHI,30,73,14,21,35
49,8481523,Kirby Dach,C,MTL,23,66,13,22,35
49,8474716,Jared Spurgeon,D,MIN,35,77,11,24,35
49,8476792,Torey Krug,D,STL,33,74,10,25,35
49,8477346,MacKenzie Weegar,D,CGY,30,70,5,30,35
49,8475764,Cam Fowler,D,ANA,33,74,4,31,35
49,8473422,Nick Foligno,L,CHI,37,61,20,14,34
49,8475799,Nino Niederreiter,R,WPG,32,66,17,17,34
49,8479400,Pierre-Luc Dubois,L,WSH,26,76,16,18,34
49,8482702,Logan Stankoven,C,DAL,21,76,15,19,34
49,8476392,Adam Lowry,C,WPG,31,62,15,19,34
49,8480459,Pius Suter,C,VAN,28,70,14,20,34
49,8475848,Brendan Gallagher,R,MTL,32,71,13,21,34
49,8480855,Jack McBain,C,UTA,24,65,13,21,34
49,8477505,Alexander Wennberg,C,SJS,30,60,12,22,34
49,8480220,Noah Cates,L,PHI,25,72,12,22,34
49,8478396,Noah Hanifin,D,VGK,27,64,9,25,34
49,8480145,Neal Pionk,D,WPG,29,73,8,26,34
49,8481606,Jordan Spence,D,LAK,23,69,7,27,34
49,8482175,JJ Peterka,R,BUF,22,63,21,12,33
49,8480009,Eeli Tolvanen,R,SEA,25,72,19,14,33
49,8481580,Connor McMichael,C,WSH,23,64,17,16,33
49,8482749,Joshua Roy,R,MTL,21,60,17,16,33
49,8482089,Jake Neighbours,L,STL,22,66,16,17,33
49,8478109,Victor Olofsson,L,VGK,29,68,16,17,33
49,8478891,Mason Appleton,C,WPG,28,66,15,18,33
49,8478413,Jordan Greenway,L,BUF,27,71,10,23,33
49,8480798,Philipp Kurashev,C,CHI,25,66,10,23,33
49,8484203,Bradly Nadeau,L,CAR,19,60,10,23,33
49,8483445,Cutter Gauthier,L,ANA,20,61,8,25,33
49,8482101,Danil Gushchin,L,SJS,22,59,8,25,33
49,8483490,Pavel Mintyukov,D,ANA,21,71,7,26,33
49,8482122,Brock Faber,D,MIN,22,79,5,28,33
49,8479336,Carl Grundstrom,R,SJS,27,54,21,11,32
49,8482055,Drew O'Connor,L,PIT,26,59,18,14,32
49,8480113,Alex Iafallo,L,WPG,31,67,16,16,32
49,8480829,Jesperi Kotkaniemi,C,CAR,24,66,16,16,32
49,8482092,Ridly Greig,C,OTT,22,77,14,18,32
49,8481577,Philip Tomasino,C,NSH,23,65,11,21,32
49,8476461,Sean Couturier,C,PHI,32,69,11,21,32
49,8482712,Oskar Olausson,R,COL,22,77,5,27,32
49,8481581,Thomas Harley,D,DAL,23,77,5,27,32
49,8476878,Zemgus Girgensons,C,TBL,30,78,20,11,31
49,8476480,Vladislav Namestnikov,C,WPG,32,62,15,16,31
49,8481093,Rafael Harvey-Pinard,L,MTL,25,66,15,16,31
49,8480871,Adam Boqvist,D,FLA,24,63,12,19,31
49,8480068,Ryan Poehling,C,PHI,25,68,11,20,31
49,8476921,Jordan Martinook,L,CAR,32,66,10,21,31
49,8479996,Cody Glass,C,NSH,25,63,10,21,31
49,8476463,Jonas Brodin,D,MIN,31,73,6,25,31
49,8481604,Pavel Dorofeyev,L,VGK,24,68,21,9,30
49,8482146,Luke Evangelista,R,NSH,22,63,14,16,30
49,8475763,Kevin Hayes,R,PIT,32,70,11,19,30
49,8475231,Casey Cizikas,C,NYI,33,76,11,19,30
49,8482660,Kent Johnson,C,CBJ,22,67,9,21,30
49,8481546,Cam York,D,PHI,23,72,8,22,30
49,8478043,Sam Lafferty,C,BUF,29,60,16,13,29
49,8481535,Nils Hoglander,L,VAN,24,64,15,14,29
49,8477989,Christian Dvorak,C,MTL,28,66,15,14,29
49,8481704,Juuso Parssinen,C,NSH,23,57,14,15,29
49,8481624,Ilya Mikheyev,R,CHI,30,64,14,15,29
49,8480144,David Kampf,C,TOR,29,71,10,19,29
49,8482133,Thomas Bordeleau,C,SJS,22,63,9,20,29
49,8479983,Mario Ferraro,D,SJS,26,71,5,24,29
49,8482067,Connor Mackey,D,NYR,28,63,5,24,29
49,8475722,Jason Zucker,L,BUF,32,58,16,12,28
49,8480995,Pontus Holmberg,R,TOR,25,62,15,13,28
49,8476925,Colton Sissons,C,NSH,31,63,14,14,28
49,8482111,Justin Barron,D,MTL,23,69,12,16,28
49,8478013,Jake Walman,D,SJS,28,72,12,16,28
49,8479591,Michael Eyssimont,C,TBL,28,82,11,17,28
49,8482245,Artem Zub,D,OTT,29,67,8,20,28
49,8476892,Colton Parayko,D,STL,31,72,6,22,28
49,8477488,Brett Pesce,D,NJD,30,69,2,26,28
49,8475149,Marcus Johansson,L,MIN,34,63,20,7,27
49,8481032,Paul Cotter,C,NJD,25,55,15,12,27
49,8480802,Ryan McLeod,C,BUF,25,64,14,13,27
49,8476278,Colin Blackwell,C,DAL,31,76,14,13,27
49,8475287,Erik Haula,L,NJD,33,70,13,14,27
49,8480748,Kiefer Sherwood,L,VAN,29,50,9,18,27
49,8479976,Juuso Valimaki,D,UTA,26,64,6,21,27
49,8477969,Marcus Pettersson,D,PIT,28,79,3,24,27
49,8476879,Cody Ceci,D,EDM,31,68,1,26,27
49,8480762,Eric Robinson,L,CAR,29,61,15,11,26
49,8477508,Curtis Lazar,C,NJD,29,62,12,14,26
49,8479351,Sam Steel,C,DAL,26,77,11,15,26
49,8477947,Sonny Milano,L,WSH,28,64,8,18,26
49,8479398,Samuel Girard,D,COL,26,76,2,24,26
49,8482655,Janis Moser,D,TBL,24,78,2,24,26
49,8480049,Dylan Samberg,D,WPG,25,62,2,24,26
49,8479393,Noah Gregor,L,OTT,26,71,20,5,25
49,8478463,Anthony Beauvillier,L,PIT,27,69,17,8,25
49,8474715,Cameron Atkinson,R,TBL,35,79,16,9,25
49,8476918,Jimmy Vesey,L,NYR,31,70,16,9,25
49,8474189,Lars Eller,C,PIT,35,63,12,13,25
49,8480789,Oliver Wahlstrom,R,NYI,24,71,11,14,25
49,8476873,Mark Jankowski,C,NSH,30,51,11,14,25
49,8479293,Brandon Tanev,L,SEA,33,65,9,16,25
49,8482125,Alexander Holtz,R,VGK,22,71,9,16,25
49,8475791,Taylor Hall,L,CHI,33,54,8,17,25
49,8477948,Travis Sanheim,D,PHI,28,70,6,19,25
49,8478882,Vladislav Gavrikov,D,LAK,29,69,5,20,25
49,8473507,Jeff Petry,D,DET,37,75,4,21,25
49,8478432,Christian Fischer,R,DET,27,75,14,10,24
49,8475855,Jesper Fast,R,CAR,33,61,13,11,24
49,8473533,Jordan Staal,C,CAR,36,57,12,12,24
49,8482259,Bobby McMann,C,TOR,28,63,10,14,24
49,8479661,Tanner Jeannot,L,LAK,27,79,10,14,24
49,8477839,Conor Sheary,L,TBL,32,76,9,15,24
49,8478911,Matt Roy,D,WSH,29,60,7,17,24
49,8480835,Jack Drury,C,CAR,24,61,6,18,24
49,8477015,Connor Brown,R,EDM,30,62,6,18,24
49,8476891,Matthew Grzelcyk,D,PIT,30,76,6,18,24
49,8477220,Nate Schmidt,D,FLA,33,62,4,20,24
49,8476917,Adam Pelech,D,NYI,30,79,2,22,24
49,8479619,Michael Carcone,L,UTA,28,58,12,11,23
49,8477478,William Carrier,L,CAR,30,61,10,13,23
49,8475343,Nic Dowd,C,WSH,34,57,10,13,23
49,8479390,Taylor Raddysh,R,WSH,26,63,8,15,23
49,8476422,Mike Reilly,D,NYI,31,75,8,15,23
49,8477392,Hudson Fasching,R,NYI,29,64,8,15,23
49,8480878,Nils Lundkvist,D,DAL,24,75,5,18,23
49,8478507,John Marino,D,UTA,27,64,5,18,23
49,8481014,Alexander Romanov,D,NYI,24,76,4,19,23
49,8476331,Dylan DeMelo,D,WPG,31,72,3,20,23
49,8479998,Mikey Anderson,D,LAK,25,67,2,21,23
49,8481477,Nico Sturm,C,SJS,29,47,14,8,22
49,8476981,Josh Anderson,R,MTL,30,65,13,9,22
49,8475220,Marcus Foligno,L,MIN,33,61,13,9,22
49,8473453,Trevor Lewis,C,LAK,37,73,13,9,22
49,8477353,Tyler Motte,C,DET,29,70,10,12,22
49,8476897,Oskar Sundqvist,C,STL,30,66,9,13,22
49,8480813,Joe Veleno,C,DET,24,78,9,13,22
49,8475171,Oliver Ekman-Larsson,D,TOR,33,70,8,14,22
49,8480336,Sean Walker,D,CAR,30,71,7,15,22
49,8479639,Dylan Coghlan,D,WPG,26,60,6,16,22
49,8479370,Tyson Jost,C,CAR,26,59,6,16,22
49,8476931,Jake McCabe,D,TOR,31,63,5,17,22
49,8476885,Jacob Trouba,D,NYR,30,66,4,18,22
49,8478500,Ivan Provorov,D,CBJ,27,80,3,19,22
49,8480011,Klim Kostin,C,SJS,25,48,14,7,21
49,8482737,Zack Bolduc,C,STL,21,56,12,9,21
49,8482077,Dylan Holloway,L,EDM,23,56,11,10,21
49,8479941,Justin Danforth,R,CBJ,31,61,11,10,21
49,8480806,Isac Lundestrom,C,ANA,25,61,10,11,21
49,8478434,Keegan Kolesar,R,VGK,27,65,10,11,21
49,8483491,Ivan Miroshnichenko,L,WSH,20,60,10,11,21
49,8478020,Michael Amadio,R,OTT,28,75,9,12,21
49,8480980,Connor Dewar,C,TOR,25,66,9,12,21
49,8482157,Will Cuylle,L,NYR,22,66,9,12,21
49,8479671,Mathieu Olivier,R,CBJ,27,45,8,13,21
49,8482117,Lukas Reichel,L,CHI,22,59,7,14,21
49,8479353,Brett Howden,C,VGK,26,70,6,15,21
49,8481521,Ronnie Attard,D,PHI,25,58,5,16,21
49,8479026,Philippe Myers,D,TOR,27,53,4,17,21
49,8475181,Nick Leddy,D,STL,33,72,3,18,21
49,8477499,Rasmus Ristolainen,D,PHI,30,63,3,18,21
49,8477506,Ryan Pulock,D,NYI,30,76,2,19,21
49,8478840,Will Borgen,D,SEA,28,63,2,19,21
49,8475233,David Savard,D,MTL,34,66,1,20,21
49,8476889,Radek Faksa,C,STL,30,59,11,9,20
49,8483468,Jiri Kulich,C,BUF,20,55,11,9,20
49,8483457,Lane Hutson,D,MTL,20,61,10,10,20
49,8480205,Emil Bemstrom,C,PIT,25,56,10,10,20
49,8482807,Ethan Del Mastro,D,CHI,21,49,10,10,20
49,8483524,Shane Wright,C,SEA,20,52,9,11,20
49,8479316,Luke Kunin,C,SJS,27,53,9,11,20
49,8481517,Brett Leason,R,ANA,25,59,9,11,20
49,8474053,Logan Couture,C,SJS,35,60,8,12,20
49,8480003,Jesper Boqvist,C,FLA,26,66,8,12,20
49,8479324,Ryan Lindgren,D,NYR,26,64,8,12,20
49,8482142,Jamie Drysdale,D,PHI,22,62,7,13,20
49,8477507,Nikita Zadorov,D,BOS,29,64,5,15,20
49,8478970,Jalen Chatfield,D,CAR,28,68,5,15,20
49,8476312,Josh Manson,D,COL,33,64,5,15,20
49,8476329,Travis Boyd,C,MIN,31,57,3,17,20
49,8478178,Darren Raddysh,D,TBL,28,71,3,17,20
49,8480043,Timothy Liljegren,D,TOR,25,64,2,18,20
49,8474673,TJ Brodie,D,CHI,34,66,2,18,20
49,8480891,Michael Kesselring,D,UTA,24,61,2,18,20
49,8471709,Marc-Edouard Vlasic,D,SJS,37,58,2,18,20
49,8480073,Erik Brannstrom,D,COL,25,57,2,18,20
49,8477425,Miles Wood,L,COL,29,76,13,6,19
49,8481028,Martin Pospisil,C,CGY,25,50,10,9,19
49,8483493,Frank Nazar,C,CHI,20,57,9,10,19
49,8481553,Bobby Brink,R,PHI,23,63,8,11,19
49,8482803,Olen Zellweger,D,ANA,21,65,8,11,19
49,8477919,Frederick Gaudreau,C,MIN,31,61,8,11,19
49,8476994,Vinnie Hinostroza,C,NSH,30,48,7,12,19
49,8482176,Wyatt Kaiser,D,CHI,22,50,6,13,19
49,8473563,Nicklas Backstrom,C,WSH,37,51,5,14,19
49,8480035,Henri Jokiharju,D,BUF,25,64,4,15,19
49,8475690,Chris Tanev,D,TOR,35,63,4,15,19
49,8476988,Matt Benning,D,SJS,30,65,3,16,19
49,8478416,Erik Cernak,D,TBL,27,73,3,16,19
49,8479982,Conor Timmins,D,TOR,26,60,3,16,19
49,8476525,Colin Miller,D,WPG,32,65,3,16,19
49,8479402,Jake Bean,D,CGY,26,72,2,17,19
49,8482079,Marco Rossi,C,MIN,23,61,10,8,18
49,8476934,Brock McGinn,L,ANA,30,47,10,8,18
49,8482074,Connor Zary,C,CGY,23,68,9,9,18
49,8477435,Ryan Graves,D,PIT,29,74,5,13,18
49,8476467,Jamie Oleksiak,D,SEA,32,62,4,14,18
49,8483482,Tristan Luneau,D,ANA,20,67,4,14,18
49,8483499,Liam Ohgren,L,MIN,20,61,4,14,18
49,8480246,Nick Perbix,D,TBL,26,71,3,15,18
49,8474166,Alec Martinez,D,CHI,37,52,3,15,18
49,8474574,Tyler Myers,D,VAN,34,69,2,16,18
49,8482087,Kaiden Guhle,D,MTL,22,68,2,16,18
49,8478508,Yakov Trenin,C,MIN,27,64,12,5,17
49,8475225,Craig Smith,C,CHI,35,56,11,6,17
49,8483495,Simon Nemec,D,NJD,20,62,8,9,17
49,8479414,Nathan Bastian,R,NJD,27,52,6,11,17
49,8483466,Kevin Korchinski,D,CHI,20,44,6,11,17
49,8476960,Andreas Athanasiou,C,CHI,30,49,5,12,17
49,8475790,Erik Gudbranson,D,CBJ,32,71,5,12,17
49,8481522,Peyton Krebs,C,BUF,23,58,4,13,17
49,8480222,Sebastian Aho,D,PIT,28,72,4,13,17
49,8480070,Ian Mitchell,D,BOS,25,49,4,13,17
49,8477365,Connor Clifton,D,BUF,29,56,3,14,17
49,8480950,Ilya Lyubushkin,D,DAL,30,66,3,14,17
49,8477369,Carson Soucy,D,VAN,30,67,3,14,17
49,8474151,Ryan McDonagh,D,TBL,35,75,2,15,17
49,8476902,Esa Lindell,D,DAL,30,75,2,15,17
49,8476429,Scott Mayfield,D,NYI,32,75,0,17,17
49,8481716,Dmitri Voronkov,L,CBJ,24,44,12,4,16
49,8477903,Garnet Hathaway,R,PHI,33,61,11,5,16
49,8482679,Matt Coronato,R,CGY,22,65,10,6,16
49,8478569,Noel Acciari,C,PIT,33,46,9,7,16
49,8482155,Alex Laferriere,R,LAK,23,67,9,7,16
49,8479359,Beck Malenstyn,L,BUF,26,51,9,7,16
49,8477450,Jason Dickinson,C,CHI,29,55,7,9,16
49,8482730,Brandt Clarke,D,LAK,21,47,7,9,16
49,8482659,Josh Doan,R,UTA,22,49,7,9,16
49,8481481,Blake Lizotte,C,PIT,27,60,6,10,16
49,8479368,Max Jones,L,BOS,26,69,6,10,16
49,8481019,David Gustafsson,C,WPG,24,59,5,11,16
49,8478859,Niko Mikkola,D,FLA,28,58,5,11,16
49,8480873,Rasmus Sandin,D,WSH,24,59,3,13,16
49,8481708,Zac Jones,D,NYR,24,61,3,13,16
49,8482634,Alex Steeves,C,TOR,25,45,3,13,16
49,8478831,Kevin Stenlund,C,UTA,28,60,12,3,15
49,8479520,Brandon Duhaime,R,WSH,27,53,11,4,15
49,8477446,Michael McCarron,R,NSH,29,54,10,5,15
49,8475842,Sam Carrick,C,NYR,32,60,9,6,15
49,8480281,Alexey Toropchenko,R,STL,25,60,8,7,15
49,8480157,Calle Rosen,D,COL,30,43,8,7,15
49,8479066,Ryan Lomberg,L,CGY,30,66,7,8,15
49,8479315,Joey Anderson,R,CHI,26,41,7,8,15
49,8482062,Cole Smith,L,NSH,29,53,7,8,15
49,8474034,Patrick Maroon,L,CHI,36,53,6,9,15
49,8480074,Alexandre Texier,C,STL,25,46,6,9,15
49,8477979,Nicolas Aube-Kubel,R,BUF,28,61,5,10,15
49,8480289,Morgan Barron,C,WPG,26,60,5,10,15
49,8483565,Nick Blankenburg,D,NSH,26,56,5,10,15
49,8481013,Jonatan Berggren,R,DET,24,59,5,10,15
49,8481059,Scott Perunovich,D,STL,26,48,5,10,15
49,8482148,Hendrix Lapierre,C,WSH,22,46,5,10,15
49,8477380,Jonny Brodzinski,C,NYR,31,45,5,10,15
49,8478585,Derek Ryan,C,EDM,38,56,4,11,15
49,8478451,Ethan Bear,D,WSH,27,48,4,11,15
49,8479328,Julien Gauthier,R,NYI,27,62,4,11,15
49,8479369,Andrew Peeke,D,BOS,26,67,4,11,15
49,8480860,Kevin Bahl,D,CGY,24,59,3,12,15
49,8477034,Jaycob Megna,D,FLA,32,47,3,12,15
49,8481441,Joe Snively,C,DET,28,64,2,13,15
49,8482192,Isaak Phillips,D,CHI,23,50,2,13,15
49,8480001,Urho Vaakanainen,D,ANA,25,52,2,13,15
49,8477845,Trevor van Riemsdyk,D,WSH,33,70,1,14,15
49,8476967,Brett Kulak,D,EDM,30,62,1,14,15
49,8480448,Parker Kelly,L,COL,25,74,10,4,14
49,8476469,Joel Armia,R,MTL,31,66,10,4,14
49,8481601,Simon Holmstrom,R,NYI,23,62,9,5,14
49,8482762,Simon Edvinsson,D,DET,21,55,8,6,14
49,8480021,Jack Studnicka,C,LAK,25,61,7,7,14
49,8481527,Kaedan Korczak,D,VGK,23,54,7,7,14
49,8479372,Joshua Mahura,D,SEA,26,60,6,8,14
49,8480025,MacKenzie Entwistle,R,FLA,25,62,5,9,14
49,8482073,Braden Schneider,D,NYR,23,65,5,9,14
49,8478211,Dryden Hunt,L,CGY,29,51,5,9,14
49,8484149,Gavin Brindley,C,CBJ,20,44,3,11,14
49,8475324,Nick Jensen,D,OTT,34,74,3,11,14
49,8475179,Dmitry Kulikov,D,FLA,34,63,3,11,14
49,8476856,Mathew Dumba,D,DAL,30,67,2,12,14
49,8478136,Jake Middleton,D,MIN,28,68,2,12,14
49,8475718,Justin Holl,D,DET,32,58,2,12,14
49,8479371,Dante Fabbro,D,NSH,26,54,1,13,14
49,8476457,Adam Larsson,D,SEA,32,65,1,13,14
49,8480807,Mattias Samuelsson,D,BUF,24,53,1,13,14
49,8478399,Jonas Siegenthaler,D,NJD,27,63,1,13,14
49,8475188,Brayden McNabb,D,VGK,33,56,0,14,14
49,8480252,Cole Guttman,C,CHI,25,37,9,4,13
49,8479344,Jesse Puljujarvi,R,PIT,26,48,9,4,13
49,8482809,Jackson Blake,R,CAR,21,53,8,5,13
49,8476822,Luke Glendening,C,TBL,35,80,7,6,13
49,8482666,Scott Morrow,D,CAR,22,48,7,6,13
49,8476624,Barclay Goodrow,C,SJS,31,54,6,7,13
49,8480727,Zach Whitecloud,D,VGK,28,48,5,8,13
49,8483460,David Jiricek,D,CBJ,21,60,4,9,13
49,8477887,Patrick Brown,C,BOS,32,47,4,9,13
49,8480848,Ty Dellandrea,C,SJS,24,44,4,9,13
49,8482859,Zack Ostapchuk,C,OTT,21,54,4,9,13
49,8482624,Daniil Miromanov,D,CGY,27,65,3,10,13
49,8479249,Andrew Poturalski,C,SJS,30,30,3,10,13
49,8475279,Ben Chiarot,D,DET,33,69,2,11,13
49,8478468,Jeremy Lauzon,D,NSH,27,52,2,11,13
49,8478851,Alexandre Carrier,D,NSH,28,63,0,13,13
49,8481518,Nolan Foote,L,NJD,24,47,10,2,12
49,8475235,Nicolas Deslauriers,L,PHI,33,58,10,2,12
49,8482652,Walker Duehr,R,CGY,27,47,7,5,12
49,8476374,Sean Kuraly,C,CBJ,31,53,6,6,12
49,8481600,Tobias Bjornfot,D,FLA,23,44,6,6,12
49,8477406,Mattias Janmark,C,EDM,32,63,5,7,12
49,8478452,Caleb Jones,D,LAK,27,55,5,7,12
49,8480796,Martin Fehervary,D,WSH,25,59,4,8,12
49,8479994,Jaret Anderson-Dolan,C,WPG,25,37,4,8,12
49,8477384,Joshua Brown,D,EDM,30,46,4,8,12
49,8479543,Michael Pezzetta,L,MTL,26,50,3,9,12
49,8479348,Kale Clague,D,BUF,26,41,3,9,12
49,8475750,Jon Merrill,D,MIN,32,61,3,9,12
49,8476874,Olli Maatta,D,DET,30,62,3,9,12
49,8475455,Brenden Dillon,D,NJD,34,56,2,10,12
49,8478454,Noah Juulsen,D,VAN,27,42,2,10,12
49,8475208,Brian Dumoulin,D,ANA,33,62,1,11,12
49,8481178,Egor Zamula,D,PHI,24,50,1,11,12
49,8479378,Logan Stanley,D,WPG,26,47,1,11,12
49,8479536,Axel Jonsson-Fjallby,L,WPG,26,26,6,5,11
49,8479981,Jonah Gadjovich,L,FLA,26,47,6,5,11
49,8480355,Mark Kastelic,C,BOS,25,62,5,6,11
49,8482747,Brennan Othmann,L,NYR,21,42,5,6,11
49,8481641,Joel Kiviranta,L,COL,28,71,4,7,11
49,8478443,Brandon Carlo,D,BOS,28,60,4,7,11
49,8477573,Nathan Walker,L,STL,30,46,4,7,11
49,8479980,Nicolas Hague,D,VGK,26,49,4,7,11
49,8476867,Brendan Gaunce,C,MIN,30,29,4,7,11
49,8479291,Kevin Rooney,C,CGY,31,47,4,7,11
49,8473446,Erik Johnson,D,PHI,36,47,3,8,11
49,8482451,Mikael Pyyhtia,L,CBJ,23,43,2,9,11
49,8476952,Dominic Toninato,C,WPG,30,34,1,10,11
49,8481056,Spencer Stastney,D,NSH,24,43,1,10,11
49,8474568,Luke Schenn,D,NSH,35,58,1,10,11
49,8484254,Akito Hirose,D,VAN,25,40,0,11,11
49,8479638,Justin Brazeau,R,BOS,26,34,7,3,10
49,8480845,Rasmus Kupari,C,WPG,24,42,6,4,10
49,8482166,Shakir Mukhamadullin,D,SJS,22,58,5,5,10
49,8481537,Nikita Okhotiuk,D,CGY,24,49,5,5,10
49,8482751,Ryan Winterton,C,SEA,21,39,5,5,10
49,8477070,Liam O'Brien,C,UTA,30,52,4,6,10
49,8477401,John Hayden,C,SEA,29,29,4,6,10
49,8481617,Vasily Podkolzin,R,VAN,23,50,3,7,10
49,8482153,Brendan Brisson,C,VGK,23,29,3,7,10
49,8481167,Brayden Pachal,D,CGY,25,40,2,8,10
49,8480887,Jordan Harris,D,MTL,24,56,2,8,10
49,8481550,Adam Beckman,L,NJD,23,36,2,8,10
49,8480058,Pierre-Olivier Joseph,D,STL,25,57,1,9,10
49,8480172,Jan Rutta,D,SJS,34,59,0,10,10
49,8477962,Brendan Lemieux,L,CAR,28,37,5,4,9
49,8478424,Jansen Harkins,C,ANA,27,47,5,4,9
49,8476858,Phillip Di Giuseppe,L,VAN,31,43,5,4,9
49,8481161,Jake Christiansen,D,CBJ,25,65,4,5,9
49,8482744,James Malatesta,L,CBJ,21,45,4,5,9
49,8480441,Trey Fix-Wolansky,R,CBJ,25,42,3,6,9
49,8476442,Matt Nieto,L,PIT,32,48,3,6,9
49,8475958,Michael Sgarbossa,C,WSH,32,21,3,6,9
49,8479379,Givani Smith,R,SJS,26,30,2,7,9
49,8479718,Alex Barré-Boulet,C,MTL,27,43,2,7,9
49,8475462,Radko Gudas,D,ANA,34,67,1,8,9
49,8481751,Lukas Rousek,R,BUF,25,32,1,8,9
49,8480192,Johnathan Kovacevic,D,NJD,27,49,1,8,9
49,8479972,Mason Shaw,C,WPG,26,32,1,8,9
49,8474090,Brendan Smith,D,DAL,35,45,0,9,9
49,8474013,Ian Cole,D,UTA,35,58,0,9,9
49,8480844,Grigori Denisenko,L,VGK,24,34,0,9,9
49,8481789,Tye Kartye,L,SEA,23,36,5,3,8
49,8478421,A.J. Greer,L,FLA,28,54,4,4,8
49,8481592,Jakob Pelletier,L,CGY,23,38,4,4,8
49,8481609,Vladislav Kolyachonok,D,UTA,23,30,3,5,8
49,8482733,Logan Mailloux,D,MTL,31,44,3,5,8
49,8481679,Maxence Guenette,D,OTT,23,30,3,5,8
49,8477931,Tomas Nosek,L,FLA,32,58,2,6,8
49,8477018,Ben Hutton,D,VGK,31,41,2,6,8
49,8483619,Filip Roos,D,OTT,25,39,2,6,8
49,8481567,Henry Thrun,D,SJS,23,45,2,6,8
49,8470600,Ryan Suter,D,STL,39,61,1,7,8
49,8474567,Zach Bogosian,D,MIN,34,60,1,7,8
49,8481568,Alex Vlasic,D,CHI,23,49,1,7,8
49,8481122,Simon Benoit,D,TOR,26,46,0,8,8
49,8476473,Connor Murphy,D,CHI,31,38,0,8,8
49,8477462,Robert Hagg,D,VGK,29,27,3,4,7
49,8481532,Alex Turcotte,C,LAK,23,42,3,4,7
49,8482145,Mavrik Bourque,C,DAL,22,63,3,4,7
49,8481147,Reese Johnson,C,MIN,26,31,3,4,7
49,8481701,Santeri Hatakka,D,NJD,23,37,2,5,7
49,8481605,Jackson LaCombe,D,ANA,23,34,2,5,7
49,8482095,Tyler Kleven,D,OTT,22,47,2,5,7
49,8477938,Haydn Fleury,D,WPG,28,42,1,6,7
49,8476372,Nick Seeler,D,PHI,31,39,1,6,7
49,8484911,Collin Graf,R,SJS,22,37,1,6,7
49,8475762,Derek Forbort,D,VAN,32,41,1,6,7
49,8479442,Troy Stecher,D,EDM,30,50,0,7,7
49,8481599,Victor Soderstrom,D,UTA,23,47,0,7,7
49,8476441,Joel Edmundson,D,LAK,31,34,0,7,7
49,8481754,Nikita Nesterenko,C,ANA,23,28,5,1,6
49,8482177,Marat Khusnutdinov,C,MIN,22,39,4,2,6
49,8477467,Gustav Olofsson,D,SEA,30,24,4,2,6
49,8479439,Jacob MacDonald,D,COL,31,43,3,3,6
49,8480007,Jonas Rondbjerg,R,VGK,25,40,3,3,6
49,8475177,Calvin de Haan,D,COL,33,46,3,3,6
49,8483549,Lucas Condotta,L,MTL,27,32,3,3,6
49,8483763,Maksymilian Szuber,D,UTA,22,27,3,3,6
49,8471817,Ryan Reaves,R,TOR,37,47,3,3,6
49,8481541,Samuel Bolduc,D,NYI,24,26,3,3,6
49,8481598,Philip Broberg,D,EDM,23,37,2,4,6
49,8477335,Kyle Burroughs,D,LAK,29,45,2,4,6
49,8482964,Arber Xhekaj,D,MTL,23,38,1,5,6
49,8471677,Jack Johnson,D,CBJ,37,60,1,5,6
49,8476913,Devin Shore,C,MIN,30,38,1,5,6
49,8478874,Adam Gaudette,R,OTT,28,39,0,6,6
49,8479576,Vincent Desharnais,D,VAN,28,30,0,6,6
49,8482070,Mitchell Chaffee,R,TBL,26,42,3,2,5
49,8479944,Zach Aston-Reese,C,VGK,30,46,3,2,5
49,8482511,Mason Lohrei,D,BOS,23,28,3,2,5
49,8480196,Jacob Bryson,D,BUF,27,43,2,3,5
49,8480880,Jakub Lauko,C,MIN,24,28,2,3,5
49,8479968,Vinni Lettieri,C,BOS,29,49,2,3,5
49,8480245,Olle Lycksell,R,PHI,25,23,2,3,5
49,8481422,Jake Lucchini,C,NSH,29,14,2,3,5
49,8484287,Cole McWard,D,VAN,23,26,2,3,5
49,8482858,Ryker Evans,D,SEA,23,23,2,3,5
49,8477482,Zachary Sanford,L,CHI,30,34,1,4,5
49,8477851,Jordan Oesterle,D,BOS,32,39,1,4,5
49,8482861,Vincent Iorio,D,WSH,22,35,1,4,5
49,8479772,Zack MacEwen,R,OTT,28,48,1,4,5
49,8478409,Anthony Richard,C,PHI,28,40,1,4,5
49,8480890,Jan Jenik,C,OTT,24,18,1,4,5
49,8478450,Parker Wotherspoon,D,BOS,27,36,0,5,5
49,8482141,Lukas Cormier,D,VGK,22,32,0,5,5
49,8481585,Egor Afanasyev,L,SJS,23,15,4,0,4
49,8480292,Carson Meyer,R,ANA,27,34,3,1,4
49,8482496,Nils Aman,C,VAN,24,32,3,1,4
49,8474612,Travis Hamonic,D,OTT,34,42,3,1,4
49,8477320,Anton Blidh,L,NYR,29,19,3,1,4
49,8483630,Pavol Regenda,L,ANA,25,30,2,2,4
49,8480990,Declan Chisholm,D,MIN,24,45,2,2,4
49,8479419,Brett Murray,L,BUF,26,19,2,2,4
49,8482088,Justin Sourdif,R,FLA,22,18,2,2,4
49,8479986,Kole Lind,R,DAL,26,40,1,3,4
49,8480834,Ty Emberson,D,SJS,24,36,1,3,4
49,8481543,Nikita Alexandrov,C,STL,24,18,1,3,4
49,8480879,Jacob Bernard-Docker,D,OTT,24,44,1,3,4
49,8477244,Chad Ruhwedel,D,NYR,34,33,1,3,4
49,8482201,Gage Goncalves,C,TBL,23,27,1,3,4
49,8477073,Kurtis MacDermid,L,NJD,30,29,1,3,4
49,8481593,Jayden Struble,D,MTL,23,19,0,4,4
49,8480032,Shane Bowers,C,NJD,25,18,3,0,3
49,8482713,Mackie Samoskevich,R,FLA,22,38,3,0,3
49,8484325,Waltteri Merela,C,TBL,26,30,2,1,3
49,8483397,Marc McLaughlin,C,BOS,25,26,2,1,3
49,8482144,Jack Thompson,D,SJS,22,28,2,1,3
49,8481030,Jack St. Ivany,D,PIT,25,14,2,1,3
49,8480468,James Hamblin,L,EDM,25,26,2,1,3
49,8482765,Isak Rosen,R,BUF,21,33,2,1,3
49,8480075,Cameron Crotty,D,MIN,25,8,2,1,3
49,8482162,Roby Jarventie,L,EDM,22,18,2,1,3
49,8482784,Zach Dean,C,STL,21,32,1,2,3
49,8478017,Mark Friedman,D,VAN,29,30,1,2,3
49,8480870,Bo Groulx,C,NYR,24,27,1,2,3
49,8477473,Justin Bailey,R,SJS,29,34,1,2,3
49,8479991,Jake Leschyshyn,C,NYR,25,34,1,2,3
49,8482516,Matthew Kessel,D,STL,24,18,1,2,3
49,8474062,Riley Nash,C,NYR,35,11,1,2,3
49,8484304,Uvis Balinskis,D,FLA,28,10,1,2,3
49,8482094,Daemon Hunt,D,MIN,22,21,1,2,3
49,8477527,Ross Johnston,L,ANA,30,29,0,3,3
49,8478021,William Lagesson,D,DET,28,23,0,3,3
49,8482165,Yan Kuznetsov,D,CGY,22,20,0,3,3
49,8481699,Aku Raty,R,UTA,23,13,0,3,3
49,8481043,Cole Koepke,L,BOS,26,14,0,3,3
49,8480267,Sammy Walker,C,MIN,25,20,2,0,2
49,8481237,Kyle MacLean,C,NYI,25,23,2,0,2
49,8477810,Joel Hanley,D,CGY,33,26,1,1,2
49,8482147,Jean-Luc Foudy,C,COL,22,27,1,1,2
49,8479362,Riley Tufte,L,BOS,26,15,1,1,2
49,8475755,Alexander Petrovic,D,DAL,32,8,1,1,2
49,8475413,Justin Dowling,C,NJD,34,12,1,1,2
49,8481726,Adam Edstrom,C,NYR,24,7,1,1,2
49,8479320,Maxime Lajoie,D,SEA,27,22,0,2,2
49,8482929,Emil Lilleberg,D,TBL,23,26,0,2,2
49,8481564,Ryan Johnson,D,BUF,23,8,0,2,2
49,8478146,Matthew Highmore,C,OTT,28,41,0,2,2
49,8478051,Max Willman,C,NJD,29,18,0,2,2
49,8480823,Alexander Alexeyev,D,WSH,25,12,0,2,2
49,8479587,Rhett Gardner,C,PHI,28,18,0,2,2
49,8482102,Vasily Ponomarev,C,PIT,22,19,0,2,2
49,8483570,Ben Meyers,C,SEA,26,31,1,0,1
49,8483012,Logan Morrison,C,SEA,22,39,1,0,1
49,8482470,Ilya Solovyov,D,CGY,24,21,1,0,1
49,8482061,Brandon Biro,L,SEA,26,14,1,0,1
49,8480851,Akil Thomas,C,LAK,24,13,1,0,1
49,8482172,Landon Slaggert,L,CHI,22,23,1,0,1
49,8482126,Emil Andrae,D,PHI,31,3,1,0,1
49,8483471,Brad Lambert,C,WPG,31,9,1,0,1
49,8483398,Declan Carlile,D,TBL,31,7,1,0,1
49,8481462,Mason Morelli,L,VGK,28,12,1,0,1
49,8484255,Jason Polin,R,COL,25,5,1,0,1
49,8482460,Matt Rempe,C,NYR,22,11,1,0,1
49,8481024,Linus Karlsson,C,VAN,25,10,1,0,1
49,8482787,Nikita Chibrikov,R,WPG,31,6,1,0,1
49,8484321,Nikolas Matinpalo,D,OTT,26,3,1,0,1
49,8481719,Maxwell Crozier,D,TBL,24,16,0,1,1
49,8484258,Sam Malinski,D,COL,26,18,0,1,1
49,8479985,Cale Fleury,D,SEA,26,23,0,1,1
49,8481743,Marc Del Gaizo,D,NSH,25,14,0,1,1
49,8480084,Nick DeSimone,D,NJD,30,13,0,1,1
49,8477971,Andreas Englund,D,LAK,28,27,0,1,1
49,8483597,Milos Kelemen,L,UTA,25,12,0,1,1
49,8481006,Tyler Tucker,D,STL,24,13,0,1,1
49,8477149,Scott Sabourin,R,SJS,32,17,0,1,1
49,8481806,Louis Crevier,D,CHI,23,18,0,1,1
49,8483512,Matthew Savoie,C,EDM,20,18,0,1,1
49,8475795,Dylan McIlrath,D,WSH,32,12,0,1,1
49,8479421,Jacob Moverare,D,LAK,26,9,0,1,1
49,8482250,Callahan Burke,C,VGK,27,23,0,1,1
49,8483567,Georgii Merkulov,C,BOS,24,11,0,1,1
49,8481578,Graeme Clarke,R,MIN,23,7,0,1,1
49,8480306,Grant Hutton,D,NYI,29,5,0,1,1
49,8479330,Brandon Gignac,C,MTL,27,11,0,1,1
49,8479522,Hardy Haman Aktell,D,WSH,26,2,0,1,1
49,8481556,John Beecher,C,BOS,23,25,0,0,0
49,8478477,Mitchell Stephens,C,SEA,27,20,0,0,0
49,8481065,Angus Crookshank,L,OTT,25,14,0,0,0
49,8478502,Dennis Gilbert,D,BUF,28,17,0,0,0
49,8482118,Sam Colangelo,R,ANA,23,14,0,0,0
49,8479367,William Lockwood,R,FLA,26,21,0,0,0
49,8478881,Brett Seney,L,CHI,28,8,0,0,0
49,8481206,John Ludvig,D,PIT,24,10,0,0,0
49,8475780,Chris Wagner,R,COL,33,5,0,0,0
49,8478011,Louie Belpedio,D,PHI,28,14,0,0,0
49,8478446,Glenn Gawdin,C,LAK,27,12,0,0,0
49,8483546,Marshall Rifai,D,TOR,26,0,0,0,0
49,8478854,Ryan Shea,D,PIT,27,7,0,0,0
49,8477541,Dakota Mermis,D,TOR,30,6,0,0,0
49,8482476,Emil Heineman,L,MTL,23,5,0,0,0
49,8481534,Raphael Lavoie,C,EDM,24,2,0,0,0
49,8482197,Adam Raska,R,MIN,23,5,0,0,0
49,8480874,Adam Ginning,D,PHI,24,14,0,0,0
49,8481655,Cole Schwindt,R,CGY,23,3,0,0,0
49,8483407,Brandon Scanlin,D,NYR,25,4,0,0,0
49,8484326,Patrik Koch,D,UTA,28,2,0,0,0
49,8483531,Brian Halonen,L,NJD,25,4,0,0,0
49,8476323,Max McCormick,L,SEA,32,1,0,0,0
49,8483920,Pierrick Dube,R,WSH,23,6,0,0,0
49,8483395,Arshdeep Bains,L,VAN,23,4,0,0,0
49,8478147,Bokondji Imama,L,PIT,28,7,0,0,0
49,8483489,Fraser Minten,C,TOR,31,10,0,0,0
49,8483432,Luca Del Bel Belluz,C,CBJ,31,4,0,0,0
49,8484259,Ondrej Pavel,C,COL,31,4,0,0,0
49,8477993,Justin Kirkland,C,CGY,28,5,0,0,0
49,8483609,Adam Klapka,R,CGY,24,3,0,0,0
49,8480274,Philip Kemp,D,EDM,25,3,0,0,0
49,8483401,Marc Johnstone,R,PIT,28,5,0,0,0
49,8470794,Joe Pavelski,C,,40,0,0,0,0
49,8479321,Lucas Johansen,D,,27,0,0,0,0
49,8477950,Tony DeAngelo,D,,29,0,0,0,0
49,8471218,Blake Wheeler,R,,38,0,0,0,0
49,8475197,Tyson Barrie,D,,33,0,0,0,0
49,8474157,Max Pacioretty,L,,36,0,0,0,0
49,8475744,Evgeny Kuznetsov,C,,32,0,0,0,0
49,8474037,James van Riemsdyk,L,,35,0,0,0,0
49,8476907,Mackenzie MacEachern,L,,30,0,0,0,0
49,8480216,Jacob Peterson,C,,25,0,0,0,0
49,8474602,Justin Schultz,D,,34,0,0,0,0
49,8482222,Alexander Barabanov,L,,30,0,0,0,0
49,8474031,Kevin Shattenkirk,D,,35,0,0,0,0
49,8477330,Dominik Kubalik,L,,29,0,0,0,0
49,8480884,Calen Addison,D,,24,0,0,0,0
49,8475906,John Klingberg,D,,32,0,0,0,0
49,8480008,Adam Ruzicka,C,,25,0,0,0,0
49,8476884,Derrick Pouliot,D,,30,0,0,0,0
49,8476919,Chris Tierney,C,,30,0,0,0,0
49,8479415,Michael McLeod,C,,26,0,0,0,0
49,8474870,Tyler Johnson,C,,34,0,0,0,0
49,8470604,Jeff Carter,C,,39,0,0,0,0
49,8478104,Sammy Blais,L,,28,0,0,0,0
49,8474884,Mike Hoffman,C,,35,0,0,0,0
49,8481591,Sam Poulin,R,,23,0,0,0,0
49,8471274,Alex Goligoski,D,,39,0,0,0,0
49,8476871,Tanner Pearson,L,,32,0,0,0,0
49,8476393,Nick Cousins,C,,31,0,0,0,0
49,8479977,Kailer Yamamoto,R,,26,0,0,0,0
49,8479346,Dillon Dube,C,,26,0,0,0,0
49,8480184,Gustav Lindstrom,D,,26,0,0,0,0
49,8479376,Victor Mete,D,,26,0,0,0,0
49,8473449,Kyle Okposo,R,,36,0,0,0,0
49,8481058,Jesse Ylonen,R,,25,0,0,0,0
49,8475752,Tyler Pitlick,C,,33,0,0,0,0
49,8481239,Samuel Fagemo,L,,24,0,0,0,0
49,8480821,Filip Zadina,R,,25,0,0,0,0
49,8470966,Mark Giordano,D,,41,0,0,0,0
49,8478495,Denis Gurianov,R,,27,0,0,0,0
49,8477464,Nic Petan,C,,29,0,0,0,0
49,8478099,Kevin Labanc,R,,29,0,0,0,0
49,8482241,Radim Zohorna,L,,28,0,0,0,0
49,8474040,Sam Gagner,C,,35,0,0,0,0
49,8479514,Rem Pitlick,C,,27,0,0,0,0
49,8478430,Oliver Kylington,D,,27,0,0,0,0
49,8479533,Joona Koppanen,L,,26,0,0,0,0
49,8479984,Cal Foote,D,,26,0,0,0,0
49,8477126,Jayson Megna,C,,34,0,0,0,0
49,8475164,Jakob Silfverberg,R,,34,0,0,0,0
49,8474009,Nick Bonino,C,,36,0,0,0,0
49,8479458,Nikita Zaitsev,D,,33,0,0,0,0
49,8477944,Jakub Vrana,L,,28,0,0,0,0
49,8471699,Andrew Cogliano,C,,37,0,0,0,0
49,8478067,Oskar Lindblom,L,,28,0,0,0,0
49,8471686,Marc Staal,D,,37,0,0,0,0
49,8470610,Zach Parise,L,,40,0,0,0,0
49,8478904,Steven Lorentz,C,,28,0,0,0,0
49,8473473,Milan Lucic,L,,36,0,0,0,0
49,8480031,Maxime Comtois,L,,25,0,0,0,0
49,8478512,Austin Czarnik,C,,32,0,0,0,0
49,8473504,Cal Clutterbuck,R,,37,0,0,0,0
49,8477454,Adam Erne,L,,29,0,0,0,0
49,8479383,Boris Katchouk,L,,26,0,0,0,0
49,8475825,Jani Hakanpää,D,,32,0,0,0,0
49,8477846,Ryan Carpenter,C,,33,0,0,0,0
49,8477930,Pierre-Edouard Bellemare,L,,39,0,0,0,0
49,8478400,Colin White,C,,27,0,0,0,0
49,8480226,Marián Studenic,R,,26,0,0,0,0
49,8480853,Liam Foudy,C,,24,0,0,0,0
49,8475797,Jarred Tinordi,D,,32,0,0,0,0
49,8479423,Alex Nylander,L,,26,0,0,0,0
49,8474618,Marco Scandella,D,,34,0,0,0,0
49,8478028,Fredrik Olofsson,L,,28,0,0,0,0
49,8474709,Matt Martin,L,,35,0,0,0,0
49,8481070,Hugh McGing,L,,26,0,0,0,0
49,8479546,Oskar Steen,C,,26,0,0,0,0
49,8474145,Robert Bortuzzo,D,,35,0,0,0,0
49,8476915,Jujhar Khaira,L,,30,0,0,0,0
49,8475278,Byron Froese,C,,33,0,0,0,0
49,8481812,Nikolai Knyzhov,D,,27,0,0,0,0
49,8478408,Travis Dermott,D,,28,0,0,0,0
49,8481077,John Leonard,L,,26,0,0,0,0
49,8479547,Matthew Phillips,R,,26,0,0,0,0
49,8480836,Jonathan Gruden,C,,24,0,0,0,0
49,8481690,Tyler Angle,C,,24,0,0,0,0
49,8475766,Austin Watson,L,,32,0,0,0,0
49,8481016,Ruslan Iskhakov,C,,24,0,0,0,0
49,8478078,Rourke Chartier,C,,28,0,0,0,0
49,8480776,Sheldon Rempal,R,,29,0,0,0,0
49,8478956,Samuel Laberge,L,NJD,27,0,0,0,0
49,8483045,Cameron Butler,R,CBJ,31,0,0,0,0
49,8484314,Jiri Smejkal,L,,28,0,0,0,0
50,8478402,Connor McDavid,C,EDM,27,78,37,112,149
50,8477956,David Pastrnak,R,BOS,28,80,55,72,127
50,8476453,Nikita Kucherov,R,TBL,31,82,41,82,123
50,8479318,Auston Matthews,C,TOR,27,81,65,55,120
50,8477492,Nathan MacKinnon,C,COL,29,82,42,74,116
50,8477934,Leon Draisaitl,C,EDM,29,79,47,68,115
50,8478550,Artemi Panarin,L,NYR,33,75,29,85,114
50,8478420,Mikko Rantanen,R,COL,28,81,53,60,113
50,8481559,Jack Hughes,C,NJD,23,75,32,79,111
50,8477939,William Nylander,R,TOR,28,79,48,58,106
50,8479314,Matthew Tkachuk,L,FLA,27,79,34,70,104
50,8478864,Kirill Kaprizov,L,MIN,27,73,50,53,103
50,8476468,J.T. Miller,C,VAN,31,78,32,71,103
50,8478398,Kyle Connor,L,WPG,28,72,59,41,100
50,8480800,Quinn Hughes,D,VAN,25,76,14,84,98
50,8480801,Brady Tkachuk,L,OTT,25,81,48,49,97
50,8478483,Mitch Marner,R,TOR,27,78,26,70,96
50,8476454,Ryan Nugent-Hopkins,C,EDM,31,79,33,60,93
50,8477404,Jake Guentzel,C,TBL,30,82,34,58,92
50,8477409,Carter Verhaeghe,C,FLA,29,78,47,43,90
50,8478010,Brayden Point,C,TBL,28,81,42,48,90
50,8484144,Connor Bedard,C,CHI,19,78,38,52,90
50,8480012,Elias Pettersson,C,VAN,26,73,44,45,89
50,8478403,Jack Eichel,C,VGK,28,80,36,52,88
50,8479420,Tage Thompson,C,BUF,27,77,37,50,87
50,8477493,Aleksander Barkov,C,FLA,29,78,26,61,87
50,8478445,Mathew Barzal,C,NYI,27,79,23,63,86
50,8480027,Jason Robertson,L,DAL,25,82,30,55,85
50,8480069,Cale Makar,D,COL,26,67,28,57,85
50,8482116,Tim Stützle,C,OTT,22,79,28,57,85
50,8479343,Clayton Keller,R,UTA,26,79,38,45,83
50,8480023,Robert Thomas,C,STL,25,74,26,57,83
50,8477942,Kevin Fiala,L,LAK,28,82,33,49,82
50,8476456,Jonathan Huberdeau,C,CGY,31,76,17,65,82
50,8476887,Filip Forsberg,L,NSH,30,70,41,40,81
50,8474564,Steven Stamkos,C,NSH,34,73,40,41,81
50,8478414,Timo Meier,R,NJD,28,78,36,45,81
50,8474141,Patrick Kane,R,DET,36,82,22,59,81
50,8474600,Roman Josi,D,NSH,34,78,18,63,81
50,8477402,Pavel Buchnevich,L,STL,29,77,42,38,80
50,8477955,Jared McCann,L,SEA,28,75,35,45,80
50,8478444,Brock Boeser,R,VAN,27,74,38,41,79
50,8477496,Elias Lindholm,C,BOS,30,77,34,45,79
50,8475810,Bryan Rust,R,PIT,32,76,34,45,79
50,8475172,Nazem Kadri,C,CGY,34,80,27,52,79
50,8479323,Adam Fox,D,NYR,26,71,18,61,79
50,8477501,Valeri Nichushkin,R,COL,29,79,39,39,78
50,8477933,Sam Reinhart,C,FLA,29,79,37,40,77
50,8479385,Jordan Kyrou,C,STL,26,74,32,45,77
50,8476459,Mika Zibanejad,C,NYR,31,74,32,45,77
50,8480208,Drake Batherson,R,OTT,26,80,24,53,77
50,8478493,Joel Eriksson Ek,C,MIN,27,76,32,43,75
50,8479542,Brandon Hagel,L,TBL,26,82,31,44,75
50,8478439,Travis Konecny,R,PHI,27,77,29,46,75
50,8475765,Vladimir Tarasenko,R,DET,33,79,29,46,75
50,8479407,Jesper Bratt,L,NJD,26,76,28,47,75
50,8477500,Bo Horvat,C,NYI,29,80,42,32,74
50,8475170,Brayden Schenn,C,STL,33,73,24,50,74
50,8477946,Dylan Larkin,C,DET,28,82,40,33,73
50,8475786,Zach Hyman,L,EDM,32,74,38,35,73
50,8475913,Mark Stone,R,VGK,32,77,31,42,73
50,8480002,Nico Hischier,C,NJD,25,75,33,39,72
50,8480830,Andrei Svechnikov,R,CAR,24,74,26,46,72
50,8482740,Wyatt Johnston,C,DAL,21,82,35,35,70
50,8480018,Nick Suzuki,C,MTL,25,80,32,38,70
50,8475754,Brock Nelson,C,NYI,33,78,31,39,70
50,8475692,Mats Zuccarello,R,MIN,37,73,25,45,70
50,8480803,Evan Bouchard,D,EDM,25,80,17,53,70
50,8481557,Matt Boldy,L,MIN,23,69,36,33,69
50,8471675,Sidney Crosby,C,PIT,37,68,26,43,69
50,8475167,Victor Hedman,D,TBL,34,80,17,52,69
50,8480865,Noah Dobson,D,NYI,24,79,10,59,69
50,8471215,Evgeni Malkin,C,PIT,38,73,26,42,68
50,8476460,Mark Scheifele,C,WPG,31,65,24,44,68
50,8476853,Morgan Rielly,D,TOR,30,70,13,55,68
50,8476539,Jonathan Marchessault,R,NSH,34,71,31,36,67
50,8476881,Tomas Hertl,C,VGK,31,79,29,38,67
50,8479337,Alex DeBrincat,R,DET,27,80,24,43,67
50,8481540,Cole Caufield,R,MTL,23,80,30,36,66
50,8482078,Lucas Raymond,L,DET,22,79,28,38,66
50,8476389,Vincent Trocheck,C,NYR,31,73,26,40,66
50,8477960,Adrian Kempe,R,LAK,28,79,25,41,66
50,8476399,Blake Coleman,C,CGY,33,76,25,41,66
50,8473994,Jamie Benn,L,DAL,35,80,22,44,66
50,8477504,Josh Morrissey,D,WPG,29,71,9,57,66
50,8481068,Yegor Sharangovich,C,CGY,26,79,31,33,64
50,8480015,Owen Tippett,R,PHI,25,76,30,34,64
50,8473419,Brad Marchand,L,BOS,36,79,25,39,64
50,8475784,Jeff Skinner,C,EDM,32,75,25,39,64
50,8477951,Nick Schmaltz,C,UTA,28,76,24,40,64
50,8480036,Miro Heiskanen,D,DAL,25,78,13,51,64
50,8479400,Pierre-Luc Dubois,L,WSH,26,74,31,32,63
50,8475168,Matt Duchene,C,DAL,33,80,28,35,63
50,8475166,John Tavares,C,TOR,34,76,27,36,63
50,8481542,Moritz Seider,D,DET,23,76,15,48,63
50,8482093,Seth Jarvis,C,CAR,22,68,27,35,62
50,8476905,Chandler Stephenson,C,SEA,30,74,13,49,62
50,8478498,Jake DeBrusk,L,VAN,28,73,27,34,61
50,8477476,Artturi Lehkonen,L,COL,29,82,32,28,60
50,8474586,Jordan Eberle,R,SEA,34,73,30,30,60
50,8483808,Andrei Kuzmenko,L,CGY,28,75,26,34,60
50,8478047,Michael Bunting,L,PIT,29,70,25,35,60
50,8476479,Phillip Danault,C,LAK,31,81,23,37,60
50,8475184,Chris Kreider,L,NYR,33,74,34,25,59
50,8482159,Tyson Foerster,R,PHI,22,71,32,27,59
50,8481533,Trevor Zegras,C,ANA,23,70,24,35,59
50,8473512,Claude Giroux,R,OTT,36,81,18,41,59
50,8475151,Kyle Palmieri,C,NYI,33,77,28,30,58
50,8477940,Nikolaj Ehlers,L,WPG,28,69,26,32,58
50,8475726,Tyler Toffoli,C,SJS,32,71,24,34,58
50,8473986,Alex Killorn,L,ANA,35,78,23,35,58
50,8482124,Quinton Byfield,R,LAK,22,79,20,38,58
50,8476419,Jean-Gabriel Pageau,C,NYI,32,78,20,38,58
50,8474590,John Carlson,D,WSH,34,68,19,39,58
50,8475158,Ryan O'Reilly,C,NSH,33,73,19,39,58
50,8476462,Dougie Hamilton,D,NJD,31,76,16,42,58
50,8475798,Mikael Granlund,C,SJS,32,69,14,44,58
50,8479325,Charlie McAvoy,D,BOS,27,77,13,45,58
50,8471724,Kris Letang,D,PIT,37,80,12,46,58
50,8478427,Sebastian Aho,C,CAR,27,73,29,28,57
50,8479675,Trevor Moore,L,LAK,29,82,24,33,57
50,8478401,Pavel Zacha,C,BOS,27,78,22,35,57
50,8478440,Dylan Strome,C,WSH,27,66,19,38,57
50,8478460,Zach Werenski,D,CBJ,27,79,16,41,57
50,8474578,Erik Karlsson,D,PIT,34,81,15,42,57
50,8477494,Jonathan Drouin,L,COL,29,79,13,44,57
50,8478449,Roope Hintz,C,DAL,28,81,27,29,56
50,8471214,Alex Ovechkin,L,WSH,39,65,25,31,56
50,8478975,Mason Marchment,L,DAL,29,82,22,34,56
50,8478856,Conor Garland,R,VAN,28,74,18,38,56
50,8481711,Matias Maccelli,L,UTA,24,75,14,42,56
50,8471685,Anze Kopitar,C,LAK,37,80,24,31,55
50,8477456,J.T. Compher,L,DET,29,80,22,32,54
50,8477949,Alex Tuch,R,BUF,28,73,19,35,54
50,8477346,MacKenzie Weegar,D,CGY,30,79,13,41,54
50,8475169,Evander Kane,L,EDM,33,79,25,28,53
50,8482699,Dylan Guenther,R,UTA,21,76,22,31,53
50,8477479,Tyler Bertuzzi,L,CHI,29,66,24,28,52
50,8478046,Danton Heinen,L,VAN,29,74,23,29,52
50,8478873,Troy Terry,R,ANA,27,74,18,34,52
50,8476346,Johnny Gaudreau,L,CBJ,31,63,12,40,52
50,8482684,Luke Hughes,D,NJD,21,72,8,44,52
50,8477447,Shea Theodore,D,VGK,29,61,6,46,52
50,8477426,Nicholas Paul,L,TBL,29,80,34,17,51
50,8475794,Tyler Seguin,C,DAL,32,81,30,21,51
50,8480188,Fabian Zetterlund,L,SJS,25,70,27,24,51
50,8480014,Gabriel Vilardi,C,WPG,25,65,27,24,51
50,8478466,Daniel Sprong,R,VAN,27,69,19,32,51
50,8478462,Nicolas Roy,C,VGK,27,74,18,33,51
50,8478469,Thomas Chabot,D,OTT,27,76,16,35,51
50,8480839,Rasmus Dahlin,D,BUF,24,74,15,36,51
50,8479999,Casey Mittelstadt,C,COL,26,80,12,39,51
50,8478397,Rasmus Andersson,D,CGY,28,69,12,39,51
50,8481618,Alex Newhook,C,MTL,23,72,23,27,50
50,8474150,Mikael Backlund,C,CGY,35,77,22,28,50
50,8477511,Anthony Mantha,R,CGY,30,74,20,30,50
50,8480028,Morgan Frost,C,PHI,25,76,19,31,50
50,8479345,Jakob Chychrun,D,WSH,26,70,9,41,50
50,8476432,Boone Jenner,C,CBJ,31,64,29,20,49
50,8481528,Dylan Cozens,C,BUF,23,70,20,29,49
50,8478472,Mathieu Joseph,R,STL,27,67,20,29,49
50,8477416,Oliver Bjorkstrand,R,SEA,29,75,19,30,49
50,8471698,T.J. Oshie,R,WSH,38,68,19,30,49
50,8475745,Charlie Coyle,C,BOS,32,77,14,35,49
50,8478366,Frank Vatrano,R,ANA,30,73,21,27,48
50,8477986,Brandon Montour,D,SEA,30,72,15,33,48
50,8478055,Gustav Forsling,D,FLA,28,70,13,35,48
50,8474563,Drew Doughty,D,LAK,35,74,12,36,48
50,8476792,Torey Krug,D,STL,33,73,11,37,48
50,8475191,Reilly Smith,R,NYR,33,73,21,26,47
50,8477429,Andrew Copp,C,DET,30,79,19,28,47
50,8477998,Warren Foegele,L,LAK,28,78,18,29,47
50,8474053,Logan Couture,C,SJS,35,67,14,33,47
50,8480797,Joel Farabee,L,PHI,24,70,13,34,47
50,8476906,Shayne Gostisbehere,D,CAR,31,77,11,36,47
50,8476448,William Karlsson,C,VGK,31,73,22,24,46
50,8476483,Rickard Rakell,R,PIT,31,77,21,25,46
50,8474679,Gustav Nyquist,C,NSH,35,74,21,25,46
50,8478233,Andrew Mangiapane,L,WSH,28,70,21,25,46
50,8482097,Jack Quinn,R,BUF,23,66,21,25,46
50,8477021,Alex Kerfoot,C,UTA,30,77,15,31,46
50,8476875,Mike Matheson,D,MTL,30,70,7,39,46
50,8482109,Alexis Lafrenière,L,NYR,23,73,26,19,45
50,8478474,Lawson Crouse,L,UTA,27,76,25,20,45
50,8475768,Jaden Schwartz,C,SEA,32,68,23,22,45
50,8483431,Logan Cooley,C,UTA,20,77,22,23,45
50,8479992,Michael Rasmussen,C,DET,25,79,21,24,45
50,8474102,David Perron,L,OTT,36,79,20,25,45
50,8482475,Yegor Chinakhov,R,CBJ,23,64,19,26,45
50,8478042,Viktor Arvidsson,L,EDM,31,76,18,27,45
50,8470613,Brent Burns,D,CAR,39,72,16,29,45
50,8480798,Philipp Kurashev,C,CHI,25,71,14,31,45
50,8479339,Patrik Laine,L,CBJ,26,67,13,32,45
50,8477503,Max Domi,C,TOR,29,80,7,38,45
50,8477495,Seth Jones,D,CHI,30,64,7,38,45
50,8475218,Mattias Ekholm,D,EDM,34,73,15,29,44
50,8477935,Sam Bennett,C,FLA,28,80,22,21,43
50,8476438,Brandon Saad,L,STL,32,73,22,21,43
50,8477407,Anthony Duclair,L,NYI,29,76,17,26,43
50,8480336,Sean Walker,D,CAR,30,74,13,30,43
50,8483515,Juraj Slafkovsky,L,MTL,20,73,12,31,43
50,8481546,Cam York,D,PHI,23,64,11,32,43
50,8476854,Hampus Lindholm,D,BOS,30,78,7,36,43
50,8482110,Dawson Mercer,C,NJD,23,72,19,23,42
50,8484145,Zach Benson,L,BUF,19,64,14,28,42
50,8476463,Jonas Brodin,D,MIN,31,76,10,32,42
50,8480145,Neal Pionk,D,WPG,29,73,9,33,42
50,8478407,Vince Dunn,D,SEA,28,75,8,34,42
50,8481581,Thomas Harley,D,DAL,23,74,8,34,42
50,8475193,Tomas Tatar,L,NJD,34,71,20,21,41
50,8479390,Taylor Raddysh,R,WSH,26,71,20,21,41
50,8476882,Teuvo Teravainen,C,CHI,30,66,19,22,41
50,8476292,Ondrej Palat,L,NJD,33,67,19,22,41
50,8475287,Erik Haula,L,NJD,33,70,19,22,41
50,8477964,Ivan Barbashev,C,VGK,29,74,17,24,41
50,8481560,Arthur Kaliyev,R,LAK,23,80,14,27,41
50,8481577,Philip Tomasino,C,NSH,23,71,14,27,41
50,8475764,Cam Fowler,D,ANA,33,76,7,34,41
50,8480068,Ryan Poehling,C,PHI,25,72,22,18,40
50,8477444,Andre Burakovsky,L,SEA,29,65,21,19,40
50,8474641,Adam Henrique,C,EDM,34,73,20,20,40
50,8475799,Nino Niederreiter,R,WPG,32,66,19,21,40
50,8480039,Martin Necas,C,CAR,25,67,16,24,40
50,8484153,Leo Carlsson,C,ANA,20,68,15,25,40
50,8482665,Matty Beniers,C,SEA,22,75,13,27,40
50,8479425,Filip Hronek,D,VAN,27,74,8,32,40
50,8483490,Pavel Mintyukov,D,ANA,21,73,5,35,40
50,8479525,Ross Colton,C,COL,28,82,19,20,39
50,8474715,Cameron Atkinson,R,TBL,35,80,19,20,39
50,8476880,Tom Wilson,R,WSH,30,64,18,21,39
50,8475722,Jason Zucker,L,BUF,32,71,17,22,39
50,8484166,Adam Fantilli,C,CBJ,20,71,16,23,39
50,8480829,Jesperi Kotkaniemi,C,CAR,24,68,16,23,39
50,8482720,Matthew Knies,L,TOR,22,76,13,26,39
50,8477948,Travis Sanheim,D,PHI,28,72,11,28,39
50,8474565,Alex Pietrangelo,D,VGK,34,68,9,30,39
50,8482122,Brock Faber,D,MIN,22,77,9,30,39
50,8478057,Dakota Joshua,C,VAN,28,68,22,16,38
50,8477952,Robby Fabbri,C,ANA,28,74,20,18,38
50,8482092,Ridly Greig,C,OTT,22,79,18,20,38
50,8479987,Morgan Geekie,C,BOS,26,76,17,21,38
50,8479365,Trent Frederic,C,BOS,26,76,14,24,38
50,8478542,Evan Rodrigues,C,FLA,31,74,13,25,38
50,8481596,Shane Pinto,C,OTT,24,79,13,25,38
50,8478458,John (Jack) Roslovic,C,CAR,27,65,10,28,38
50,8481656,Aliaksei Protas,C,WSH,23,66,9,29,38
50,8482175,JJ Peterka,R,BUF,22,69,27,10,37
50,8482149,Cole Perfetti,C,WPG,22,70,17,20,37
50,8478438,Tommy Novak,C,NSH,27,68,12,25,37
50,8474149,Evgenii Dadonov,R,DAL,35,79,11,26,37
50,8482712,Oskar Olausson,R,COL,22,76,7,30,37
50,8480064,Josh Norris,C,OTT,25,75,19,17,36
50,8481604,Pavel Dorofeyev,L,VGK,24,67,19,17,36
50,8475793,Ryan Johansen,C,PHI,32,75,17,19,36
50,8478109,Victor Olofsson,L,VGK,29,70,16,20,36
50,8481186,Logan O'Connor,R,COL,28,80,15,21,36
50,8477505,Alexander Wennberg,C,SJS,30,61,15,21,36
50,8477451,Ryan Hartman,R,MIN,30,70,14,22,36
50,8476461,Sean Couturier,C,PHI,32,67,11,25,36
50,8476958,Jaccob Slavin,D,CAR,30,79,10,26,36
50,8473422,Nick Foligno,L,CHI,37,64,10,26,36
50,8478396,Noah Hanifin,D,VGK,27,62,10,26,36
50,8475314,Anders Lee,L,NYI,34,77,21,14,35
50,8477497,Sean Monahan,C,CBJ,30,73,17,18,35
50,8482702,Logan Stankoven,C,DAL,21,79,16,19,35
50,8477932,Aaron Ekblad,D,FLA,28,67,15,20,35
50,8477425,Miles Wood,L,COL,29,77,15,20,35
50,8477498,Darnell Nurse,D,EDM,29,74,12,23,35
50,8476826,Yanni Gourde,C,SEA,33,75,11,24,35
50,8476923,Damon Severson,D,CBJ,30,81,8,27,35
50,8475753,Justin Faulk,D,STL,32,71,6,29,35
50,8479368,Max Jones,L,BOS,26,73,22,12,34
50,8482745,Mason McTavish,C,ANA,21,73,16,18,34
50,8480113,Alex Iafallo,L,WPG,31,61,16,18,34
50,8476458,Ryan Strome,C,ANA,31,69,15,19,34
50,8476925,Colton Sissons,C,NSH,31,70,15,19,34
50,8479661,Tanner Jeannot,L,LAK,27,74,14,20,34
50,8473563,Nicklas Backstrom,C,WSH,37,65,14,20,34
50,8476869,Brady Skjei,D,NSH,30,76,7,27,34
50,8482074,Connor Zary,C,CGY,23,67,19,14,33
50,8480459,Pius Suter,C,VAN,28,65,15,18,33
50,8479351,Sam Steel,C,DAL,26,80,14,19,33
50,8481524,Bowen Byram,D,BUF,23,64,10,23,33
50,8482113,Anton Lundell,C,FLA,23,77,9,24,33
50,8476872,Scott Laughton,C,PHI,30,71,9,24,33
50,8470621,Corey Perry,R,EDM,39,74,17,15,32
50,8478891,Mason Appleton,C,WPG,28,58,12,20,32
50,8478413,Jordan Greenway,L,BUF,27,69,11,21,32
50,8480849,Barrett Hayton,C,UTA,24,69,9,23,32
50,8482105,Jake Sanderson,D,OTT,22,75,8,24,32
50,8478038,Devon Toews,D,COL,30,63,4,28,32
50,8475714,Calle Jarnkrok,C,TOR,33,77,19,12,31
50,8476981,Josh Anderson,R,MTL,30,72,18,13,31
50,8483505,Matthew Poitras,C,BOS,20,72,17,14,31
50,8475760,Nick Bjugstad,C,UTA,32,64,16,15,31
50,8481535,Nils Hoglander,L,VAN,24,61,16,15,31
50,8477353,Tyler Motte,C,DET,29,74,12,19,31
50,8475848,Brendan Gallagher,R,MTL,32,72,11,20,31
50,8484203,Bradly Nadeau,L,CAR,19,68,11,20,31
50,8480434,Sean Durzi,D,UTA,26,71,7,24,31
50,8474716,Jared Spurgeon,D,MIN,35,72,7,24,31
50,8480817,K'Andre Miller,D,NYR,24,71,5,26,31
50,8482655,Janis Moser,D,TBL,24,75,5,26,31
50,8481606,Jordan Spence,D,LAK,23,64,4,27,31
50,8482089,Jake Neighbours,L,STL,22,64,19,11,30
50,8478463,Anthony Beauvillier,L,PIT,27,62,16,14,30
50,8482146,Luke Evangelista,R,NSH,22,70,13,17,30
50,8476474,Stefan Noesen,R,NJD,31,67,12,18,30
50,8476885,Jacob Trouba,D,NYR,30,71,5,25,30
50,8475233,David Savard,D,MTL,34,70,3,27,30
50,8480873,Rasmus Sandin,D,WSH,24,69,3,27,30
50,8475791,Taylor Hall,L,CHI,33,52,16,13,29
50,8476278,Colin Blackwell,C,DAL,31,79,14,15,29
50,8480748,Kiefer Sherwood,L,VAN,29,58,13,16,29
50,8479293,Brandon Tanev,L,SEA,33,71,13,16,29
50,8475763,Kevin Hayes,R,PIT,32,69,12,17,29
50,8477839,Conor Sheary,L,TBL,32,80,11,18,29
50,8482660,Kent Johnson,C,CBJ,22,65,8,21,29
50,8476931,Jake McCabe,D,TOR,31,67,6,23,29
50,8477969,Marcus Pettersson,D,PIT,28,78,2,27,29
50,8479410,Mikhail Sergachev,D,UTA,26,71,1,28,29
50,8480220,Noah Cates,L,PHI,25,71,20,8,28
50,8480813,Joe Veleno,C,DET,24,76,14,14,28
50,8482055,Drew O'Connor,L,PIT,26,67,12,16,28
50,8482133,Thomas Bordeleau,C,SJS,22,63,10,18,28
50,8482176,Wyatt Kaiser,D,CHI,22,57,10,18,28
50,8478115,Pierre Engvall,L,NYI,28,81,9,19,28
50,8477987,Ryan Donato,C,CHI,28,65,7,21,28
50,8480802,Ryan McLeod,C,BUF,25,59,7,21,28
50,8480871,Adam Boqvist,D,FLA,24,68,6,22,28
50,8482624,Daniil Miromanov,D,CGY,27,71,6,22,28
50,8478133,Jake Evans,C,MTL,28,65,5,23,28
50,8475690,Chris Tanev,D,TOR,35,68,4,24,28
50,8478020,Michael Amadio,R,OTT,28,76,14,13,27
50,8480835,Jack Drury,C,CAR,24,56,12,15,27
50,8476392,Adam Lowry,C,WPG,31,63,11,16,27
50,8478519,Anthony Cirelli,C,TBL,27,81,10,17,27
50,8475149,Marcus Johansson,L,MIN,34,63,10,17,27
50,8483445,Cutter Gauthier,L,ANA,20,64,8,19,27
50,8476897,Oskar Sundqvist,C,STL,30,63,8,19,27
50,8481704,Juuso Parssinen,C,NSH,23,51,7,20,27
50,8474151,Ryan McDonagh,D,TBL,35,79,7,20,27
50,8480796,Martin Fehervary,D,WSH,25,58,7,20,27
50,8480893,Kirill Marchenko,R,CBJ,24,64,19,7,26
50,8482705,Cole Sillinger,C,CBJ,21,67,17,9,26
50,8476918,Jimmy Vesey,L,NYR,31,68,16,10,26
50,8482079,Marco Rossi,C,MIN,23,52,14,12,26
50,8480009,Eeli Tolvanen,R,SEA,25,74,13,13,26
50,8482679,Matt Coronato,R,CGY,22,65,13,13,26
50,8480855,Jack McBain,C,UTA,24,64,11,15,26
50,8476878,Zemgus Girgensons,C,TBL,30,80,10,16,26
50,8482125,Alexander Holtz,R,VGK,22,64,10,16,26
50,8476921,Jordan Martinook,L,CAR,32,61,8,18,26
50,8479591,Michael Eyssimont,C,TBL,28,81,8,18,26
50,8476988,Matt Benning,D,SJS,30,65,8,18,26
50,8480078,Filip Chytil,C,NYR,25,63,7,19,26
50,8476979,Erik Gustafsson,D,DET,32,75,7,19,26
50,8476480,Vladislav Namestnikov,C,WPG,32,64,7,19,26
50,8477989,Christian Dvorak,C,MTL,28,67,7,19,26
50,8475171,Oliver Ekman-Larsson,D,TOR,33,66,7,19,26
50,8482245,Artem Zub,D,OTT,29,76,5,21,26
50,8477506,Ryan Pulock,D,NYI,30,80,5,21,26
50,8480043,Timothy Liljegren,D,TOR,25,65,5,21,26
50,8481554,Kaapo Kakko,R,NYR,23,71,14,11,25
50,8481582,Nicholas Robertson,L,TOR,23,60,14,11,25
50,8473453,Trevor Lewis,C,LAK,37,74,11,14,25
50,8480185,Eetu Luostarinen,C,FLA,26,74,10,15,25
50,8482667,William Eklund,L,SJS,22,65,10,15,25
50,8483524,Shane Wright,C,SEA,20,65,10,15,25
50,8477903,Garnet Hathaway,R,PHI,33,65,10,15,25
50,8477947,Sonny Milano,L,WSH,28,62,8,17,25
50,8478911,Matt Roy,D,WSH,29,61,8,17,25
50,8482671,Owen Power,D,BUF,22,67,7,18,25
50,8480246,Nick Perbix,D,TBL,26,73,7,18,25
50,8481703,Valtteri Puustinen,R,PIT,25,62,6,19,25
50,8482067,Connor Mackey,D,NYR,28,60,6,19,25
50,8481014,Alexander Romanov,D,NYI,24,76,5,20,25
50,8475324,Nick Jensen,D,OTT,34,70,3,22,25
50,8482259,Bobby McMann,C,TOR,28,61,17,7,24
50,8481580,Connor McMichael,C,WSH,23,58,14,10,24
50,8475343,Nic Dowd,C,WSH,34,55,13,11,24
50,8481093,Rafael Harvey-Pinard,L,MTL,25,54,11,13,24
50,8477478,William Carrier,L,CAR,30,64,11,13,24
50,8483468,Jiri Kulich,C,BUF,20,54,11,13,24
50,8477953,Kasperi Kapanen,R,STL,28,65,10,14,24
50,8481028,Martin Pospisil,C,CGY,25,59,10,14,24
50,8479996,Cody Glass,C,NSH,25,57,7,17,24
50,8477499,Rasmus Ristolainen,D,PHI,30,62,7,17,24
50,8480070,Ian Mitchell,D,BOS,25,50,6,18,24
50,8476917,Adam Pelech,D,NYI,30,79,5,19,24
50,8476902,Esa Lindell,D,DAL,30,73,5,19,24
50,8475790,Erik Gudbranson,D,CBJ,32,73,3,21,24
50,8478500,Ivan Provorov,D,CBJ,27,78,2,22,24
50,8480049,Dylan Samberg,D,WPG,25,67,0,24,24
50,8483457,Lane Hutson,D,MTL,20,65,15,8,23
50,8478013,Jake Walman,D,SJS,28,73,12,11,23
50,8476927,Teddy Blueger,C,VAN,30,64,11,12,23
50,8482101,Danil Gushchin,L,SJS,22,58,7,16,23
50,8481019,David Gustafsson,C,WPG,24,55,7,16,23
50,8478451,Ethan Bear,D,WSH,27,48,7,16,23
50,8476457,Adam Larsson,D,SEA,32,73,6,17,23
50,8479639,Dylan Coghlan,D,WPG,26,68,5,18,23
50,8477919,Frederick Gaudreau,C,MIN,31,61,5,18,23
50,8477979,Nicolas Aube-Kubel,R,BUF,28,52,5,18,23
50,8476312,Josh Manson,D,COL,33,62,4,19,23
50,8480073,Erik Brannstrom,D,COL,25,68,4,19,23
50,8478882,Vladislav Gavrikov,D,LAK,29,63,2,21,23
50,8476331,Dylan DeMelo,D,WPG,31,64,2,21,23
50,8475188,Brayden McNabb,D,VGK,33,61,1,22,23
50,8477392,Hudson Fasching,R,NYI,29,67,14,8,22
50,8479941,Justin Danforth,R,CBJ,31,65,13,9,22
50,8476469,Joel Armia,R,MTL,31,73,13,9,22
50,8478421,A.J. Greer,L,FLA,28,60,12,10,22
50,8479393,Noah Gregor,L,OTT,26,69,11,11,22
50,8481624,Ilya Mikheyev,R,CHI,30,61,10,12,22
50,8478508,Yakov Trenin,C,MIN,27,60,10,12,22
50,8478043,Sam Lafferty,C,BUF,29,60,9,13,22
50,8480144,David Kampf,C,TOR,29,67,9,13,22
50,8480011,Klim Kostin,C,SJS,25,50,9,13,22
50,8483491,Ivan Miroshnichenko,L,WSH,20,57,8,14,22
50,8477450,Jason Dickinson,C,CHI,29,55,8,14,22
50,8475855,Jesper Fast,R,CAR,33,62,7,15,22
50,8473507,Jeff Petry,D,DET,37,68,6,16,22
50,8482111,Justin Barron,D,MTL,23,63,5,17,22
50,8479671,Mathieu Olivier,R,CBJ,27,48,5,17,22
50,8478851,Alexandre Carrier,D,NSH,28,65,5,17,22
50,8482087,Kaiden Guhle,D,MTL,22,66,2,20,22
50,8480074,Alexandre Texier,C,STL,25,56,13,8,21
50,8482148,Hendrix Lapierre,C,WSH,22,59,13,8,21
50,8480980,Connor Dewar,C,TOR,25,68,12,9,21
50,8479316,Luke Kunin,C,SJS,27,58,12,9,21
50,8477446,Michael McCarron,R,NSH,29,62,12,9,21
50,8473533,Jordan Staal,C,CAR,36,63,11,10,21
50,8476960,Andreas Athanasiou,C,CHI,30,47,9,12,21
50,8479520,Brandon Duhaime,R,WSH,27,51,9,12,21
50,8481523,Kirby Dach,C,MTL,23,68,7,14,21
50,8483495,Simon Nemec,D,NJD,20,54,6,15,21
50,8482749,Joshua Roy,R,MTL,21,60,5,16,21
50,8478432,Christian Fischer,R,DET,27,76,5,16,21
50,8478416,Erik Cernak,D,TBL,27,77,5,16,21
50,8477435,Ryan Graves,D,PIT,29,77,5,16,21
50,8481522,Peyton Krebs,C,BUF,23,56,5,16,21
50,8482073,Braden Schneider,D,NYR,23,70,5,16,21
50,8475181,Nick Leddy,D,STL,33,71,4,17,21
50,8480035,Henri Jokiharju,D,BUF,25,63,3,18,21
50,8478136,Jake Middleton,D,MIN,28,72,3,18,21
50,8481517,Brett Leason,R,ANA,25,61,14,6,20
50,8475842,Sam Carrick,C,NYR,32,67,14,6,20
50,8479066,Ryan Lomberg,L,CGY,30,65,11,9,20
50,8479344,Jesse Puljujarvi,R,PIT,26,54,10,10,20
50,8480003,Jesper Boqvist,C,FLA,26,71,9,11,20
50,8483493,Frank Nazar,C,CHI,20,46,9,11,20
50,8474189,Lars Eller,C,PIT,35,62,8,12,20
50,8481553,Bobby Brink,R,PHI,23,58,7,13,20
50,8475225,Craig Smith,C,CHI,35,48,6,14,20
50,8484149,Gavin Brindley,C,CBJ,20,52,6,14,20
50,8480878,Nils Lundkvist,D,DAL,24,75,5,15,20
50,8476892,Colton Parayko,D,STL,31,69,3,17,20
50,8478507,John Marino,D,UTA,27,64,3,17,20
50,8476525,Colin Miller,D,WPG,32,66,3,17,20
50,8479371,Dante Fabbro,D,NSH,26,67,3,17,20
50,8479398,Samuel Girard,D,COL,26,69,2,18,20
50,8475279,Ben Chiarot,D,DET,33,71,2,18,20
50,8481178,Egor Zamula,D,PHI,24,49,1,19,20
50,8479336,Carl Grundstrom,R,SJS,27,57,11,8,19
50,8479619,Michael Carcone,L,UTA,28,62,11,8,19
50,8480806,Isac Lundestrom,C,ANA,25,54,9,10,19
50,8480448,Parker Kelly,L,COL,25,74,9,10,19
50,8480789,Oliver Wahlstrom,R,NYI,24,68,8,11,19
50,8479353,Brett Howden,C,VGK,26,73,8,11,19
50,8482809,Jackson Blake,R,CAR,21,53,7,12,19
50,8478970,Jalen Chatfield,D,CAR,28,74,6,13,19
50,8480222,Sebastian Aho,D,PIT,28,76,6,13,19
50,8476994,Vinnie Hinostroza,C,NSH,30,50,5,14,19
50,8477220,Nate Schmidt,D,FLA,33,67,3,16,19
50,8482142,Jamie Drysdale,D,PHI,22,62,3,16,19
50,8479982,Conor Timmins,D,TOR,26,55,3,16,19
50,8476429,Scott Mayfield,D,NYI,32,74,3,16,19
50,8482157,Will Cuylle,L,NYR,22,64,12,6,18
50,8478569,Noel Acciari,C,PIT,33,48,12,6,18
50,8482077,Dylan Holloway,L,EDM,23,51,11,7,18
50,8482117,Lukas Reichel,L,CHI,22,57,10,8,18
50,8480252,Cole Guttman,C,CHI,25,43,10,8,18
50,8482730,Brandt Clarke,D,LAK,21,46,9,9,18
50,8482192,Isaak Phillips,D,CHI,23,55,4,14,18
50,8479980,Nicolas Hague,D,VGK,26,50,3,15,18
50,8481568,Alex Vlasic,D,CHI,23,57,3,15,18
50,8475455,Brenden Dillon,D,NJD,34,62,1,17,18
50,8481013,Jonatan Berggren,R,DET,24,61,12,5,17
50,8479414,Nathan Bastian,R,NJD,27,52,10,7,17
50,8474034,Patrick Maroon,L,CHI,36,45,10,7,17
50,8479291,Kevin Rooney,C,CGY,31,46,10,7,17
50,8480995,Pontus Holmberg,R,TOR,25,60,9,8,17
50,8479370,Tyson Jost,C,CAR,26,46,9,8,17
50,8483565,Nick Blankenburg,D,NSH,26,56,9,8,17
50,8479536,Axel Jonsson-Fjallby,L,WPG,26,43,9,8,17
50,8479968,Vinni Lettieri,C,BOS,29,54,9,8,17
50,8478434,Keegan Kolesar,R,VGK,27,63,8,9,17
50,8480355,Mark Kastelic,C,BOS,25,55,7,10,17
50,8479994,Jaret Anderson-Dolan,C,WPG,25,40,6,11,17
50,8477488,Brett Pesce,D,NJD,30,61,5,12,17
50,8480860,Kevin Bahl,D,CGY,24,60,5,12,17
50,8475200,Dmitry Orlov,D,CAR,33,73,4,13,17
50,8477507,Nikita Zadorov,D,BOS,29,69,4,13,17
50,8476856,Mathew Dumba,D,DAL,30,66,4,13,17
50,8474673,TJ Brodie,D,CHI,34,66,3,14,17
50,8480762,Eric Robinson,L,CAR,29,56,10,6,16
50,8479543,Michael Pezzetta,L,MTL,26,49,10,6,16
50,8482155,Alex Laferriere,R,LAK,23,65,9,7,16
50,8481032,Paul Cotter,C,NJD,25,61,8,8,16
50,8477406,Mattias Janmark,C,EDM,32,62,6,10,16
50,8482733,Logan Mailloux,D,MTL,31,40,6,10,16
50,8476329,Travis Boyd,C,MIN,31,51,5,11,16
50,8481527,Kaedan Korczak,D,VGK,23,43,5,11,16
50,8482062,Cole Smith,L,NSH,29,52,4,12,16
50,8476879,Cody Ceci,D,EDM,31,68,3,13,16
50,8476891,Matthew Grzelcyk,D,PIT,30,73,3,13,16
50,8479324,Ryan Lindgren,D,NYR,26,66,2,14,16
50,8475462,Radko Gudas,D,ANA,34,64,2,14,16
50,8480172,Jan Rutta,D,SJS,34,57,1,15,16
50,8480289,Morgan Barron,C,WPG,26,60,10,5,15
50,8479359,Beck Malenstyn,L,BUF,26,48,8,7,15
50,8481147,Reese Johnson,C,MIN,26,42,8,7,15
50,8480205,Emil Bemstrom,C,PIT,25,58,7,8,15
50,8477070,Liam O'Brien,C,UTA,30,56,7,8,15
50,8476889,Radek Faksa,C,STL,30,66,6,9,15
50,8483499,Liam Ohgren,L,MIN,20,52,5,10,15
50,8481617,Vasily Podkolzin,R,VAN,23,46,5,10,15
50,8481441,Joe Snively,C,DET,28,57,4,11,15
50,8478443,Brandon Carlo,D,BOS,28,65,4,11,15
50,8474574,Tyler Myers,D,VAN,34,75,2,13,15
50,8475718,Justin Holl,D,DET,32,62,2,13,15
50,8481641,Joel Kiviranta,L,COL,28,69,9,5,14
50,8480441,Trey Fix-Wolansky,R,CBJ,25,37,9,5,14
50,8481716,Dmitri Voronkov,L,CBJ,24,35,7,7,14
50,8476952,Dominic Toninato,C,WPG,30,38,7,7,14
50,8475231,Casey Cizikas,C,NYI,33,67,6,8,14
50,8479315,Joey Anderson,R,CHI,26,45,6,8,14
50,8480848,Ty Dellandrea,C,SJS,24,41,6,8,14
50,8476422,Mike Reilly,D,NYI,31,73,5,9,14
50,8483482,Tristan Luneau,D,ANA,20,60,4,10,14
50,8480021,Jack Studnicka,C,LAK,25,55,4,10,14
50,8477931,Tomas Nosek,L,FLA,32,58,4,10,14
50,8483466,Kevin Korchinski,D,CHI,20,54,3,11,14
50,8478468,Jeremy Lauzon,D,NSH,27,48,3,11,14
50,8480887,Jordan Harris,D,MTL,24,57,3,11,14
50,8471709,Marc-Edouard Vlasic,D,SJS,37,62,2,12,14
50,8481059,Scott Perunovich,D,STL,26,68,2,12,14
50,8475208,Brian Dumoulin,D,ANA,33,69,2,12,14
50,8479976,Juuso Valimaki,D,UTA,26,63,1,13,14
50,8478840,Will Borgen,D,SEA,28,61,1,13,14
50,8479402,Jake Bean,D,CGY,26,68,1,13,14
50,8480001,Urho Vaakanainen,D,ANA,25,52,1,13,14
50,8481477,Nico Sturm,C,SJS,29,56,9,4,13
50,8476624,Barclay Goodrow,C,SJS,31,53,7,6,13
50,8475220,Marcus Foligno,L,MIN,33,65,6,7,13
50,8477369,Carson Soucy,D,VAN,30,59,6,7,13
50,8481537,Nikita Okhotiuk,D,CGY,24,44,5,8,13
50,8477015,Connor Brown,R,EDM,30,62,4,9,13
50,8476822,Luke Glendening,C,TBL,35,73,4,9,13
50,8476374,Sean Kuraly,C,CBJ,31,55,4,9,13
50,8480845,Rasmus Kupari,C,WPG,24,45,4,9,13
50,8481550,Adam Beckman,L,NJD,23,37,4,9,13
50,8480891,Michael Kesselring,D,UTA,24,61,3,10,13
50,8476874,Olli Maatta,D,DET,30,63,3,10,13
50,8476467,Jamie Oleksiak,D,SEA,32,67,2,11,13
50,8480950,Ilya Lyubushkin,D,DAL,30,64,2,11,13
50,8479369,Andrew Peeke,D,BOS,26,53,2,11,13
50,8477845,Trevor van Riemsdyk,D,WSH,33,55,2,11,13
50,8476967,Brett Kulak,D,EDM,30,60,2,11,13
50,8474166,Alec Martinez,D,CHI,37,46,1,12,13
50,8482634,Alex Steeves,C,TOR,25,59,1,12,13
50,8479372,Joshua Mahura,D,SEA,26,49,0,13,13
50,8475750,Jon Merrill,D,MIN,32,59,0,13,13
50,8480192,Johnathan Kovacevic,D,NJD,27,47,8,4,12
50,8482659,Josh Doan,R,UTA,22,48,7,5,12
50,8479439,Jacob MacDonald,D,COL,31,53,7,5,12
50,8480281,Alexey Toropchenko,R,STL,25,61,6,6,12
50,8481481,Blake Lizotte,C,PIT,27,59,5,7,12
50,8477508,Curtis Lazar,C,NJD,29,61,4,8,12
50,8479026,Philippe Myers,D,TOR,27,47,4,8,12
50,8477573,Nathan Walker,L,STL,30,48,4,8,12
50,8481708,Zac Jones,D,NYR,24,52,3,9,12
50,8478178,Darren Raddysh,D,TBL,28,68,2,10,12
50,8481167,Brayden Pachal,D,CGY,25,48,2,10,12
50,8475762,Derek Forbort,D,VAN,32,48,2,10,12
50,8479986,Kole Lind,R,DAL,26,51,2,10,12
50,8479998,Mikey Anderson,D,LAK,25,62,1,11,12
50,8478859,Niko Mikkola,D,FLA,28,58,1,11,12
50,8480807,Mattias Samuelsson,D,BUF,24,55,1,11,12
50,8476441,Joel Edmundson,D,LAK,31,46,1,11,12
50,8481754,Nikita Nesterenko,C,ANA,23,33,7,4,11
50,8479378,Logan Stanley,D,WPG,26,40,6,5,11
50,8478585,Derek Ryan,C,EDM,38,63,5,6,11
50,8481601,Simon Holmstrom,R,NYI,23,71,5,6,11
50,8479718,Alex Barré-Boulet,C,MTL,27,52,5,6,11
50,8482737,Zack Bolduc,C,STL,21,59,4,7,11
50,8482803,Olen Zellweger,D,ANA,21,66,4,7,11
50,8480834,Ty Emberson,D,SJS,24,40,4,7,11
50,8478399,Jonas Siegenthaler,D,NJD,27,63,3,8,11
50,8481701,Santeri Hatakka,D,NJD,23,38,3,8,11
50,8481599,Victor Soderstrom,D,UTA,23,42,3,8,11
50,8477365,Connor Clifton,D,BUF,29,50,2,9,11
50,8481567,Henry Thrun,D,SJS,23,53,2,9,11
50,8470600,Ryan Suter,D,STL,39,57,2,9,11
50,8480879,Jacob Bernard-Docker,D,OTT,24,47,2,9,11
50,8475179,Dmitry Kulikov,D,FLA,34,58,1,10,11
50,8479249,Andrew Poturalski,C,SJS,30,31,0,11,11
50,8481532,Alex Turcotte,C,LAK,23,45,7,3,10
50,8480025,MacKenzie Entwistle,R,FLA,25,59,6,4,10
50,8482807,Ethan Del Mastro,D,CHI,21,47,5,5,10
50,8477335,Kyle Burroughs,D,LAK,29,46,5,5,10
50,8483619,Filip Roos,D,OTT,25,34,4,6,10
50,8483460,David Jiricek,D,CBJ,21,53,3,7,10
50,8482744,James Malatesta,L,CBJ,21,41,3,7,10
50,8481679,Maxence Guenette,D,OTT,23,31,3,7,10
50,8479348,Kale Clague,D,BUF,26,44,2,8,10
50,8476858,Phillip Di Giuseppe,L,VAN,31,51,2,8,10
50,8481592,Jakob Pelletier,L,CGY,23,39,2,8,10
50,8476473,Connor Murphy,D,CHI,31,40,2,8,10
50,8477034,Jaycob Megna,D,FLA,32,56,1,9,10
50,8482762,Simon Edvinsson,D,DET,21,50,7,2,9
50,8482145,Mavrik Bourque,C,DAL,22,48,6,3,9
50,8482652,Walker Duehr,R,CGY,27,38,5,4,9
50,8480870,Bo Groulx,C,NYR,24,34,5,4,9
50,8484258,Sam Malinski,D,COL,26,25,5,4,9
50,8476873,Mark Jankowski,C,NSH,30,53,4,5,9
50,8477380,Jonny Brodzinski,C,NYR,31,62,4,5,9
50,8479328,Julien Gauthier,R,NYI,27,60,4,5,9
50,8481518,Nolan Foote,L,NJD,24,40,4,5,9
50,8479981,Jonah Gadjovich,L,FLA,26,37,4,5,9
50,8479983,Mario Ferraro,D,SJS,26,67,3,6,9
50,8481521,Ronnie Attard,D,PHI,25,61,3,6,9
50,8475235,Nicolas Deslauriers,L,PHI,33,53,3,6,9
50,8483012,Logan Morrison,C,SEA,22,40,3,6,9
50,8480727,Zach Whitecloud,D,VGK,28,55,2,7,9
50,8476867,Brendan Gaunce,C,MIN,30,40,2,7,9
50,8482095,Tyler Kleven,D,OTT,22,42,2,7,9
50,8477938,Haydn Fleury,D,WPG,28,43,2,7,9
50,8479576,Vincent Desharnais,D,VAN,28,36,2,7,9
50,8476934,Brock McGinn,L,ANA,30,46,6,2,8
50,8476442,Matt Nieto,L,PIT,32,44,6,2,8
50,8482859,Zack Ostapchuk,C,OTT,21,51,5,3,8
50,8479442,Troy Stecher,D,EDM,30,56,5,3,8
50,8479772,Zack MacEwen,R,OTT,28,41,5,3,8
50,8481161,Jake Christiansen,D,CBJ,25,60,4,4,8
50,8471817,Ryan Reaves,R,TOR,37,54,4,4,8
50,8478452,Caleb Jones,D,LAK,27,55,3,5,8
50,8480292,Carson Meyer,R,ANA,27,28,3,5,8
50,8473446,Erik Johnson,D,PHI,36,43,1,7,8
50,8481609,Vladislav Kolyachonok,D,UTA,23,31,0,8,8
50,8476372,Nick Seeler,D,PHI,31,50,0,8,8
50,8474612,Travis Hamonic,D,OTT,34,38,0,8,8
50,8480990,Declan Chisholm,D,MIN,24,49,0,8,8
50,8482166,Shakir Mukhamadullin,D,SJS,22,50,4,3,7
50,8481789,Tye Kartye,L,SEA,23,40,4,3,7
50,8478446,Glenn Gawdin,C,LAK,27,18,4,3,7
50,8482451,Mikael Pyyhtia,L,CBJ,23,46,3,4,7
50,8482153,Brendan Brisson,C,VGK,23,43,3,4,7
50,8483549,Lucas Condotta,L,MTL,27,32,3,4,7
50,8481541,Samuel Bolduc,D,NYI,24,25,3,4,7
50,8476913,Devin Shore,C,MIN,30,33,3,4,7
50,8482765,Isak Rosen,R,BUF,21,32,3,4,7
50,8474090,Brendan Smith,D,DAL,35,50,2,5,7
50,8477018,Ben Hutton,D,VGK,31,45,2,5,7
50,8479944,Zach Aston-Reese,C,VGK,30,51,2,5,7
50,8481122,Simon Benoit,D,TOR,26,37,1,6,7
50,8471677,Jack Johnson,D,CBJ,37,68,0,7,7
50,8478211,Dryden Hunt,L,CGY,29,52,4,2,6
50,8482666,Scott Morrow,D,CAR,22,43,4,2,6
50,8478424,Jansen Harkins,C,ANA,27,47,4,2,6
50,8474568,Luke Schenn,D,NSH,35,47,3,3,6
50,8480844,Grigori Denisenko,L,VGK,24,30,3,3,6
50,8480007,Jonas Rondbjerg,R,VGK,25,29,3,3,6
50,8478874,Adam Gaudette,R,OTT,28,34,3,3,6
50,8478409,Anthony Richard,C,PHI,28,27,3,3,6
50,8482713,Mackie Samoskevich,R,FLA,22,38,3,3,6
50,8482784,Zach Dean,C,STL,21,40,3,3,6
50,8477473,Justin Bailey,R,SJS,29,24,3,3,6
50,8478146,Matthew Highmore,C,OTT,28,34,3,3,6
50,8483512,Matthew Savoie,C,EDM,20,21,3,3,6
50,8481598,Philip Broberg,D,EDM,23,39,2,4,6
50,8482511,Mason Lohrei,D,BOS,23,35,2,4,6
50,8482496,Nils Aman,C,VAN,24,37,2,4,6
50,8479419,Brett Murray,L,BUF,26,25,2,4,6
50,8477810,Joel Hanley,D,CGY,33,21,2,4,6
50,8479985,Cale Fleury,D,SEA,26,27,2,4,6
50,8474013,Ian Cole,D,UTA,35,47,1,5,6
50,8480245,Olle Lycksell,R,PHI,25,30,1,5,6
50,8482861,Vincent Iorio,D,WSH,22,34,1,5,6
50,8484304,Uvis Balinskis,D,FLA,28,10,1,5,6
50,8477851,Jordan Oesterle,D,BOS,32,33,0,6,6
50,8478450,Parker Wotherspoon,D,BOS,27,32,0,6,6
50,8483630,Pavol Regenda,L,ANA,25,33,0,6,6
50,8479638,Justin Brazeau,R,BOS,26,37,4,1,5
50,8478831,Kevin Stenlund,C,UTA,28,59,3,2,5
50,8482070,Mitchell Chaffee,R,TBL,26,51,3,2,5
50,8482201,Gage Goncalves,C,TBL,23,22,3,2,5
50,8481600,Tobias Bjornfot,D,FLA,23,38,2,3,5
50,8478454,Noah Juulsen,D,VAN,27,35,2,3,5
50,8482747,Brennan Othmann,L,NYR,21,35,2,3,5
50,8477462,Robert Hagg,D,VGK,29,28,2,3,5
50,8484254,Akito Hirose,D,VAN,25,37,1,4,5
50,8480058,Pierre-Olivier Joseph,D,STL,25,46,1,4,5
50,8474567,Zach Bogosian,D,MIN,34,59,1,4,5
50,8480196,Jacob Bryson,D,BUF,27,40,1,4,5
50,8478017,Mark Friedman,D,VAN,29,35,1,4,5
50,8477971,Andreas Englund,D,LAK,28,27,1,4,5
50,8475177,Calvin de Haan,D,COL,33,42,0,5,5
50,8477244,Chad Ruhwedel,D,NYR,34,27,0,5,5
50,8479587,Rhett Gardner,C,PHI,28,25,0,5,5
50,8480880,Jakub Lauko,C,MIN,24,25,4,0,4
50,8474062,Riley Nash,C,NYR,35,16,3,1,4
50,8481556,John Beecher,C,BOS,23,35,3,1,4
50,8479367,William Lockwood,R,FLA,26,27,3,1,4
50,8477401,John Hayden,C,SEA,29,28,2,2,4
50,8477467,Gustav Olofsson,D,SEA,30,20,2,2,4
50,8480890,Jan Jenik,C,OTT,24,28,2,2,4
50,8481543,Nikita Alexandrov,C,STL,24,24,2,2,4
50,8481593,Jayden Struble,D,MTL,23,17,2,2,4
50,8483397,Marc McLaughlin,C,BOS,25,25,2,2,4
50,8478051,Max Willman,C,NJD,29,22,2,2,4
50,8482172,Landon Slaggert,L,CHI,22,20,2,2,4
50,8480157,Calle Rosen,D,COL,30,43,1,3,4
50,8481056,Spencer Stastney,D,NSH,24,31,1,3,4
50,8477962,Brendan Lemieux,L,CAR,28,40,1,3,4
50,8483763,Maksymilian Szuber,D,UTA,22,41,1,3,4
50,8482141,Lukas Cormier,D,VGK,22,19,1,3,4
50,8482094,Daemon Hunt,D,MIN,22,16,1,3,4
50,8480267,Sammy Walker,C,MIN,25,22,1,3,4
50,8478477,Mitchell Stephens,C,SEA,27,23,1,3,4
50,8477384,Joshua Brown,D,EDM,30,42,0,4,4
50,8482516,Matthew Kessel,D,STL,24,18,0,4,4
50,8478502,Dennis Gilbert,D,BUF,28,17,0,4,4
50,8481605,Jackson LaCombe,D,ANA,23,32,3,0,3
50,8480851,Akil Thomas,C,LAK,24,12,3,0,3
50,8482964,Arber Xhekaj,D,MTL,23,44,2,1,3
50,8482858,Ryker Evans,D,SEA,23,25,2,1,3
50,8482102,Vasily Ponomarev,C,PIT,22,27,2,1,3
50,8482751,Ryan Winterton,C,SEA,21,28,1,2,3
50,8479972,Mason Shaw,C,WPG,26,36,1,2,3
50,8482177,Marat Khusnutdinov,C,MIN,22,27,1,2,3
50,8481585,Egor Afanasyev,L,SJS,23,10,1,2,3
50,8482144,Jack Thompson,D,SJS,22,25,1,2,3
50,8481237,Kyle MacLean,C,NYI,25,25,1,2,3
50,8479362,Riley Tufte,L,BOS,26,18,1,2,3
50,8480874,Adam Ginning,D,PHI,24,16,1,2,3
50,8484911,Collin Graf,R,SJS,22,45,0,3,3
50,8477482,Zachary Sanford,L,CHI,30,43,0,3,3
50,8483471,Brad Lambert,C,WPG,31,5,0,3,3
50,8480084,Nick DeSimone,D,NJD,30,19,0,3,3
50,8480468,James Hamblin,L,EDM,25,19,2,0,2
50,8481462,Mason Morelli,L,VGK,28,11,2,0,2
50,8483597,Milos Kelemen,L,UTA,25,17,2,0,2
50,8483395,Arshdeep Bains,L,VAN,23,12,2,0,2
50,8477887,Patrick Brown,C,BOS,32,42,1,1,2
50,8475958,Michael Sgarbossa,C,WSH,32,29,1,1,2
50,8479379,Givani Smith,R,SJS,26,25,1,1,2
50,8481751,Lukas Rousek,R,BUF,25,39,1,1,2
50,8482147,Jean-Luc Foudy,C,COL,22,23,1,1,2
50,8482460,Matt Rempe,C,NYR,22,12,1,1,2
50,8479421,Jacob Moverare,D,LAK,26,9,1,1,2
50,8481422,Jake Lucchini,C,NSH,29,19,0,2,2
50,8482088,Justin Sourdif,R,FLA,22,15,0,2,2
50,8477073,Kurtis MacDermid,L,NJD,30,27,0,2,2
50,8478021,William Lagesson,D,DET,28,27,0,2,2
50,8481699,Aku Raty,R,UTA,23,9,0,2,2
50,8479320,Maxime Lajoie,D,SEA,27,23,0,2,2
50,8481564,Ryan Johnson,D,BUF,23,18,0,2,2
50,8481006,Tyler Tucker,D,STL,24,19,0,2,2
50,8475795,Dylan McIlrath,D,WSH,32,18,0,2,2
50,8477541,Dakota Mermis,D,TOR,30,14,0,2,2
50,8480075,Cameron Crotty,D,MIN,25,12,1,0,1
50,8479991,Jake Leschyshyn,C,NYR,25,24,1,0,1
50,8483570,Ben Meyers,C,SEA,26,20,1,0,1
50,8482470,Ilya Solovyov,D,CGY,24,14,1,0,1
50,8482061,Brandon Biro,L,SEA,26,13,1,0,1
50,8482787,Nikita Chibrikov,R,WPG,31,9,1,0,1
50,8481719,Maxwell Crozier,D,TBL,24,16,1,0,1
50,8481743,Marc Del Gaizo,D,NSH,25,24,1,0,1
50,8475780,Chris Wagner,R,COL,33,11,1,0,1
50,8478011,Louie Belpedio,D,PHI,28,11,1,0,1
50,8482197,Adam Raska,R,MIN,23,14,1,0,1
50,8481655,Cole Schwindt,R,CGY,23,7,1,0,1
50,8477320,Anton Blidh,L,NYR,29,18,0,1,1
50,8484325,Waltteri Merela,C,TBL,26,29,0,1,1
50,8482162,Roby Jarventie,L,EDM,22,17,0,1,1
50,8477527,Ross Johnston,L,ANA,30,25,0,1,1
50,8475755,Alexander Petrovic,D,DAL,32,12,0,1,1
50,8475413,Justin Dowling,C,NJD,34,13,0,1,1
50,8480823,Alexander Alexeyev,D,WSH,25,9,0,1,1
50,8483398,Declan Carlile,D,TBL,31,9,0,1,1
50,8477149,Scott Sabourin,R,SJS,32,10,0,1,1
50,8482250,Callahan Burke,C,VGK,27,26,0,1,1
50,8483567,Georgii Merkulov,C,BOS,24,10,0,1,1
50,8481578,Graeme Clarke,R,MIN,23,16,0,1,1
50,8479330,Brandon Gignac,C,MTL,27,9,0,1,1
50,8481065,Angus Crookshank,L,OTT,25,18,0,1,1
50,8482118,Sam Colangelo,R,ANA,23,14,0,1,1
50,8478147,Bokondji Imama,L,PIT,28,8,0,1,1
50,8484287,Cole McWard,D,VAN,23,17,0,0,0
50,8480032,Shane Bowers,C,NJD,25,15,0,0,0
50,8481030,Jack St. Ivany,D,PIT,25,11,0,0,0
50,8482165,Yan Kuznetsov,D,CGY,22,18,0,0,0
50,8481043,Cole Koepke,L,BOS,26,20,0,0,0
50,8481726,Adam Edstrom,C,NYR,24,8,0,0,0
50,8482929,Emil Lilleberg,D,TBL,23,15,0,0,0
50,8482126,Emil Andrae,D,PHI,31,2,0,0,0
50,8484255,Jason Polin,R,COL,25,6,0,0,0
50,8481024,Linus Karlsson,C,VAN,25,7,0,0,0
50,8484321,Nikolas Matinpalo,D,OTT,26,3,0,0,0
50,8481806,Louis Crevier,D,CHI,23,6,0,0,0
50,8480306,Grant Hutton,D,NYI,29,6,0,0,0
50,8479522,Hardy Haman Aktell,D,WSH,26,2,0,0,0
50,8478881,Brett Seney,L,CHI,28,12,0,0,0
50,8481206,John Ludvig,D,PIT,24,14,0,0,0
50,8483546,Marshall Rifai,D,TOR,26,3,0,0,0
50,8478854,Ryan Shea,D,PIT,27,2,0,0,0
50,8482476,Emil Heineman,L,MTL,23,6,0,0,0
50,8481534,Raphael Lavoie,C,EDM,24,2,0,0,0
50,8483407,Brandon Scanlin,D,NYR,25,4,0,0,0
50,8484326,Patrik Koch,D,UTA,28,1,0,0,0
50,8483531,Brian Halonen,L,NJD,25,3,0,0,0
50,8476323,Max McCormick,L,SEA,32,2,0,0,0
50,8483920,Pierrick Dube,R,WSH,23,4,0,0,0
50,8483489,Fraser Minten,C,TOR,31,8,0,0,0
50,8483432,Luca Del Bel Belluz,C,CBJ,31,7,0,0,0
50,8484259,Ondrej Pavel,C,COL,31,3,0,0,0
50,8477993,Justin Kirkland,C,CGY,28,5,0,0,0
50,8483609,Adam Klapka,R,CGY,24,4,0,0,0
50,8480274,Philip Kemp,D,EDM,25,0,0,0,0
50,8483401,Marc Johnstone,R,PIT,28,0,0,0,0
50,8470794,Joe Pavelski,C,,40,0,0,0,0
50,8479321,Lucas Johansen,D,,27,0,0,0,0
50,8477950,Tony DeAngelo,D,,29,0,0,0,0
50,8471218,Blake Wheeler,R,,38,0,0,0,0
50,8475197,Tyson Barrie,D,,33,0,0,0,0
50,8474157,Max Pacioretty,L,,36,0,0,0,0
50,8475744,Evgeny Kuznetsov,C,,32,0,0,0,0
50,8474037,James van Riemsdyk,L,,35,0,0,0,0
50,8476907,Mackenzie MacEachern,L,,30,0,0,0,0
50,8480216,Jacob Peterson,C,,25,0,0,0,0
50,8474602,Justin Schultz,D,,34,0,0,0,0
50,8482222,Alexander Barabanov,L,,30,0,0,0,0
50,8474031,Kevin Shattenkirk,D,,35,0,0,0,0
50,8477330,Dominik Kubalik,L,,29,0,0,0,0
50,8480884,Calen Addison,D,,24,0,0,0,0
50,8475906,John Klingberg,D,,32,0,0,0,0
50,8480008,Adam Ruzicka,C,,25,0,0,0,0
50,8476884,Derrick Pouliot,D,,30,0,0,0,0
50,8476919,Chris Tierney,C,,30,0,0,0,0
50,8479415,Michael McLeod,C,,26,0,0,0,0
50,8474870,Tyler Johnson,C,,34,0,0,0,0
50,8470604,Jeff Carter,C,,39,0,0,0,0
50,8478104,Sammy Blais,L,,28,0,0,0,0
50,8474884,Mike Hoffman,C,,35,0,0,0,0
50,8481591,Sam Poulin,R,,23,0,0,0,0
50,8471274,Alex Goligoski,D,,39,0,0,0,0
50,8476871,Tanner Pearson,L,,32,0,0,0,0
50,8476393,Nick Cousins,C,,31,0,0,0,0
50,8479977,Kailer Yamamoto,R,,26,0,0,0,0
50,8479346,Dillon Dube,C,,26,0,0,0,0
50,8480184,Gustav Lindstrom,D,,26,0,0,0,0
50,8479376,Victor Mete,D,,26,0,0,0,0
50,8473449,Kyle Okposo,R,,36,0,0,0,0
50,8481058,Jesse Ylonen,R,,25,0,0,0,0
50,8475752,Tyler Pitlick,C,,33,0,0,0,0
50,8481239,Samuel Fagemo,L,,24,0,0,0,0
50,8480821,Filip Zadina,R,,25,0,0,0,0
50,8470966,Mark Giordano,D,,41,0,0,0,0
50,8478495,Denis Gurianov,R,,27,0,0,0,0
50,8477464,Nic Petan,C,,29,0,0,0,0
50,8478099,Kevin Labanc,R,,29,0,0,0,0
50,8482241,Radim Zohorna,L,,28,0,0,0,0
50,8474040,Sam Gagner,C,,35,0,0,0,0
50,8479514,Rem Pitlick,C,,27,0,0,0,0
50,8478430,Oliver Kylington,D,,27,0,0,0,0
50,8479533,Joona Koppanen,L,,26,0,0,0,0
50,8479984,Cal Foote,D,,26,0,0,0,0
50,8477126,Jayson Megna,C,,34,0,0,0,0
50,8475164,Jakob Silfverberg,R,,34,0,0,0,0
50,8474009,Nick Bonino,C,,36,0,0,0,0
50,8479458,Nikita Zaitsev,D,,33,0,0,0,0
50,8477944,Jakub Vrana,L,,28,0,0,0,0
50,8471699,Andrew Cogliano,C,,37,0,0,0,0
50,8478067,Oskar Lindblom,L,,28,0,0,0,0
50,8471686,Marc Staal,D,,37,0,0,0,0
50,8470610,Zach Parise,L,,40,0,0,0,0
50,8478904,Steven Lorentz,C,,28,0,0,0,0
50,8473473,Milan Lucic,L,,36,0,0,0,0
50,8480031,Maxime Comtois,L,,25,0,0,0,0
50,8478512,Austin Czarnik,C,,32,0,0,0,0
50,8473504,Cal Clutterbuck,R,,37,0,0,0,0
50,8477454,Adam Erne,L,,29,0,0,0,0
50,8479383,Boris Katchouk,L,,26,0,0,0,0
50,8475825,Jani Hakanpää,D,,32,0,0,0,0
50,8477846,Ryan Carpenter,C,,33,0,0,0,0
50,8477930,Pierre-Edouard Bellemare,L,,39,0,0,0,0
50,8478400,Colin White,C,,27,0,0,0,0
50,8480226,Marián Studenic,R,,26,0,0,0,0
50,8480853,Liam Foudy,C,,24,0,0,0,0
50,8475797,Jarred Tinordi,D,,32,0,0,0,0
50,8479423,Alex Nylander,L,,26,0,0,0,0
50,8474618,Marco Scandella,D,,34,0,0,0,0
50,8478028,Fredrik Olofsson,L,,28,0,0,0,0
50,8474709,Matt Martin,L,,35,0,0,0,0
50,8481070,Hugh McGing,L,,26,0,0,0,0
50,8479546,Oskar Steen,C,,26,0,0,0,0
50,8474145,Robert Bortuzzo,D,,35,0,0,0,0
50,8476915,Jujhar Khaira,L,,30,0,0,0,0
50,8475278,Byron Froese,C,,33,0,0,0,0
50,8481812,Nikolai Knyzhov,D,,27,0,0,0,0
50,8478408,Travis Dermott,D,,28,0,0,0,0
50,8481077,John Leonard,L,,26,0,0,0,0
50,8479547,Matthew Phillips,R,,26,0,0,0,0
50,8480836,Jonathan Gruden,C,,24,0,0,0,0
50,8481690,Tyler Angle,C,,24,0,0,0,0
50,8475766,Austin Watson,L,,32,0,0,0,0
50,8481016,Ruslan Iskhakov,C,,24,0,0,0,0
50,8478078,Rourke Chartier,C,,28,0,0,0,0
50,8480776,Sheldon Rempal,R,,29,0,0,0,0
50,8478956,Samuel Laberge,L,NJD,27,2,0,0,0
50,8483045,Cameron Butler,R,CBJ,31,0,0,0,0
50,8484314,Jiri Smejkal,L,,28,0,0,0,0
51,8477492,Nathan MacKinnon,C,COL,29,80,58,92,150
51,8478402,Connor McDavid,C,EDM,27,81,45,99,144
51,8476453,Nikita Kucherov,R,TBL,31,82,41,102,143
51,8478864,Kirill Kaprizov,L,MIN,27,77,55,70,125
51,8478420,Mikko Rantanen,R,COL,28,81,50,69,119
51,8477956,David Pastrnak,R,BOS,28,81,51,59,110
51,8479318,Auston Matthews,C,TOR,27,75,57,52,109
51,8481559,Jack Hughes,C,NJD,23,74,40,69,109
51,8479314,Matthew Tkachuk,L,FLA,27,75,31,78,109
51,8477934,Leon Draisaitl,C,EDM,29,78,37,70,107
51,8478550,Artemi Panarin,L,NYR,33,78,33,73,106
51,8477493,Aleksander Barkov,C,FLA,29,78,36,67,103
51,8478403,Jack Eichel,C,VGK,28,79,50,52,102
51,8478483,Mitch Marner,R,TOR,27,79,31,70,101
51,8477939,William Nylander,R,TOR,28,78,44,56,100
51,8480801,Brady Tkachuk,L,OTT,25,76,39,60,99
51,8480012,Elias Pettersson,C,VAN,26,80,37,61,98
51,8480069,Cale Makar,D,COL,26,75,25,73,98
51,8479343,Clayton Keller,R,UTA,26,76,31,65,96
51,8480002,Nico Hischier,C,NJD,25,75,22,72,94
51,8480800,Quinn Hughes,D,VAN,25,79,18,76,94
51,8477404,Jake Guentzel,C,TBL,30,82,43,50,93
51,8476468,J.T. Miller,C,VAN,31,73,26,67,93
51,8482116,Tim Stützle,C,OTT,22,80,29,63,92
51,8477501,Valeri Nichushkin,R,COL,29,81,51,40,91
51,8480023,Robert Thomas,C,STL,25,74,24,67,91
51,8474564,Steven Stamkos,C,NSH,34,71,29,61,90
51,8480027,Jason Robertson,L,DAL,25,81,39,50,89
51,8481557,Matt Boldy,L,MIN,23,74,38,50,88
51,8478445,Mathew Barzal,C,NYI,27,82,26,62,88
51,8475166,John Tavares,C,TOR,34,80,42,45,87
51,8471675,Sidney Crosby,C,PIT,37,70,45,41,86
51,8479385,Jordan Kyrou,C,STL,26,77,35,50,85
51,8475172,Nazem Kadri,C,CGY,34,81,34,50,84
51,8478444,Brock Boeser,R,VAN,27,76,40,43,83
51,8478427,Sebastian Aho,C,CAR,27,73,40,43,83
51,8478010,Brayden Point,C,TBL,28,82,34,49,83
51,8479323,Adam Fox,D,NYR,26,72,13,70,83
51,8476460,Mark Scheifele,C,WPG,31,75,35,46,81
51,8474600,Roman Josi,D,NSH,34,74,27,54,81
51,8477942,Kevin Fiala,L,LAK,28,82,34,45,79
51,8471214,Alex Ovechkin,L,WSH,39,72,37,40,77
51,8475913,Mark Stone,R,VGK,32,75,27,50,77
51,8478460,Zach Werenski,D,CBJ,27,80,19,58,77
51,8476887,Filip Forsberg,L,NSH,30,74,36,40,76
51,8478439,Travis Konecny,R,PHI,27,73,35,41,76
51,8471685,Anze Kopitar,C,LAK,37,80,25,51,76
51,8477504,Josh Morrissey,D,WPG,29,77,17,59,76
51,8476853,Morgan Rielly,D,TOR,30,73,11,65,76
51,8478398,Kyle Connor,L,WPG,28,73,34,41,75
51,8479999,Casey Mittelstadt,C,COL,26,81,19,56,75
51,8482740,Wyatt Johnston,C,DAL,21,82,34,40,74
51,8475692,Mats Zuccarello,R,MIN,37,70,13,61,74
51,8476459,Mika Zibanejad,C,NYR,31,81,24,49,73
51,8476454,Ryan Nugent-Hopkins,C,EDM,31,78,23,50,73
51,8476389,Vincent Trocheck,C,NYR,31,76,23,50,73
51,8480865,Noah Dobson,D,NYI,24,81,14,59,73
51,8477946,Dylan Larkin,C,DET,28,81,32,40,72
51,8477960,Adrian Kempe,R,LAK,28,81,30,42,72
51,8473512,Claude Giroux,R,OTT,36,79,25,47,72
51,8478397,Rasmus Andersson,D,CGY,28,77,16,56,72
51,8475184,Chris Kreider,L,NYR,33,78,43,28,71
51,8481533,Trevor Zegras,C,ANA,23,75,26,45,71
51,8480830,Andrei Svechnikov,R,CAR,24,73,25,46,71
51,8475167,Victor Hedman,D,TBL,34,78,14,57,71
51,8475786,Zach Hyman,L,EDM,32,80,42,28,70
51,8477933,Sam Reinhart,C,FLA,29,77,37,33,70
51,8478414,Timo Meier,R,NJD,28,75,35,35,70
51,8479407,Jesper Bratt,L,NJD,26,71,21,49,70
51,8476456,Jonathan Huberdeau,C,CGY,31,77,16,54,70
51,8477409,Carter Verhaeghe,C,FLA,29,76,38,31,69
51,8477940,Nikolaj Ehlers,L,WPG,28,70,21,48,69
51,8477476,Artturi Lehkonen,L,COL,29,79,32,36,68
51,8479675,Trevor Moore,L,LAK,29,80,26,42,68
51,8478440,Dylan Strome,C,WSH,27,68,30,37,67
51,8478493,Joel Eriksson Ek,C,MIN,27,71,27,40,67
51,8480208,Drake Batherson,R,OTT,26,80,25,42,67
51,8478401,Pavel Zacha,C,BOS,27,78,23,44,67
51,8482078,Lucas Raymond,L,DET,22,81,22,45,67
51,8480036,Miro Heiskanen,D,DAL,25,75,9,58,67
51,8479420,Tage Thompson,C,BUF,27,69,36,30,66
51,8473419,Brad Marchand,L,BOS,36,80,24,42,66
51,8478449,Roope Hintz,C,DAL,28,82,35,30,65
51,8479542,Brandon Hagel,L,TBL,26,82,28,37,65
51,8477447,Shea Theodore,D,VGK,29,65,16,48,64
51,8474578,Erik Karlsson,D,PIT,34,78,13,51,64
51,8473994,Jamie Benn,L,DAL,35,82,20,43,63
51,8475168,Matt Duchene,C,DAL,33,81,20,43,63
51,8476539,Jonathan Marchessault,R,NSH,34,72,34,28,62
51,8480015,Owen Tippett,R,PHI,25,77,31,31,62
51,8482124,Quinton Byfield,R,LAK,22,78,28,34,62
51,8478873,Troy Terry,R,ANA,27,74,22,40,62
51,8478407,Vince Dunn,D,SEA,28,72,11,51,62
51,8477500,Bo Horvat,C,NYI,29,79,34,27,61
51,8477496,Elias Lindholm,C,BOS,30,79,31,30,61
51,8475810,Bryan Rust,R,PIT,32,70,26,35,61
51,8471215,Evgeni Malkin,C,PIT,38,72,26,35,61
51,8475745,Charlie Coyle,C,BOS,32,81,26,35,61
51,8477494,Jonathan Drouin,L,COL,29,80,20,41,61
51,8477416,Oliver Bjorkstrand,R,SEA,29,77,20,41,61
51,8477949,Alex Tuch,R,BUF,28,71,17,44,61
51,8476346,Johnny Gaudreau,L,CBJ,31,72,11,50,61
51,8475799,Nino Niederreiter,R,WPG,32,67,34,26,60
51,8477402,Pavel Buchnevich,L,STL,29,68,26,34,60
51,8477951,Nick Schmaltz,C,UTA,28,80,22,38,60
51,8480839,Rasmus Dahlin,D,BUF,24,67,17,42,59
51,8476905,Chandler Stephenson,C,SEA,30,70,25,33,58
51,8475754,Brock Nelson,C,NYI,33,78,24,34,58
51,8482745,Mason McTavish,C,ANA,21,72,24,34,58
51,8482665,Matty Beniers,C,SEA,22,76,22,36,58
51,8476479,Phillip Danault,C,LAK,31,79,16,42,58
51,8482684,Luke Hughes,D,NJD,21,79,11,47,58
51,8475784,Jeff Skinner,C,EDM,32,76,30,27,57
51,8479337,Alex DeBrincat,R,DET,27,80,20,37,57
51,8482149,Cole Perfetti,C,WPG,22,72,20,37,57
51,8480803,Evan Bouchard,D,EDM,25,75,12,45,57
51,8476432,Boone Jenner,C,CBJ,31,70,37,19,56
51,8475794,Tyler Seguin,C,DAL,32,82,35,21,56
51,8482699,Dylan Guenther,R,UTA,21,74,28,28,56
51,8482109,Alexis Lafrenière,L,NYR,23,74,27,29,56
51,8474141,Patrick Kane,R,DET,36,82,25,31,56
51,8482093,Seth Jarvis,C,CAR,22,70,23,33,56
51,8479400,Pierre-Luc Dubois,L,WSH,26,74,18,38,56
51,8478038,Devon Toews,D,COL,30,75,16,40,56
51,8471724,Kris Letang,D,PIT,37,81,10,46,56
51,8479325,Charlie McAvoy,D,BOS,27,76,5,51,56
51,8471698,T.J. Oshie,R,WSH,38,71,29,26,55
51,8475726,Tyler Toffoli,C,SJS,32,75,24,31,55
51,8484153,Leo Carlsson,C,ANA,20,72,22,33,55
51,8477451,Ryan Hartman,R,MIN,30,63,20,35,55
51,8477456,J.T. Compher,L,DET,29,80,19,36,55
51,8470613,Brent Burns,D,CAR,39,77,14,41,55
51,8478366,Frank Vatrano,R,ANA,30,72,33,21,54
51,8476399,Blake Coleman,C,CGY,33,78,29,25,54
51,8476448,William Karlsson,C,VGK,31,74,27,27,54
51,8474102,David Perron,L,OTT,36,77,26,28,54
51,8478856,Conor Garland,R,VAN,28,73,25,29,54
51,8484144,Connor Bedard,C,CHI,19,68,24,30,54
51,8480018,Nick Suzuki,C,MTL,25,77,22,32,54
51,8477021,Alex Kerfoot,C,UTA,30,78,21,33,54
51,8480039,Martin Necas,C,CAR,25,70,21,33,54
51,8473986,Alex Killorn,L,ANA,35,74,18,35,53
51,8477346,MacKenzie Weegar,D,CGY,30,72,10,43,53
51,8474590,John Carlson,D,WSH,34,67,8,45,53
51,8475170,Brayden Schenn,C,STL,33,72,27,25,52
51,8478975,Mason Marchment,L,DAL,29,79,20,32,52
51,8482097,Jack Quinn,R,BUF,23,72,18,34,52
51,8477935,Sam Bennett,C,FLA,28,78,18,34,52
51,8477426,Nicholas Paul,L,TBL,29,82,31,20,51
51,8480014,Gabriel Vilardi,C,WPG,25,67,31,20,51
51,8481540,Cole Caufield,R,MTL,23,75,30,21,51
51,8483808,Andrei Kuzmenko,L,CGY,28,76,30,21,51
51,8475151,Kyle Palmieri,C,NYI,33,77,28,23,51
51,8475765,Vladimir Tarasenko,R,DET,33,81,20,31,51
51,8475714,Calle Jarnkrok,C,TOR,33,75,23,27,50
51,8475158,Ryan O'Reilly,C,NSH,33,70,22,28,50
51,8474150,Mikael Backlund,C,CGY,35,76,22,28,50
51,8478462,Nicolas Roy,C,VGK,27,77,21,29,50
51,8483431,Logan Cooley,C,UTA,20,79,20,30,50
51,8477503,Max Domi,C,TOR,29,77,14,36,50
51,8482159,Tyson Foerster,R,PHI,22,75,13,37,50
51,8476792,Torey Krug,D,STL,33,72,9,41,50
51,8481528,Dylan Cozens,C,BUF,23,70,26,23,49
51,8478396,Noah Hanifin,D,VGK,27,62,12,37,49
51,8481068,Yegor Sharangovich,C,CGY,26,75,31,17,48
51,8481604,Pavel Dorofeyev,L,VGK,24,70,29,19,48
51,8475169,Evander Kane,L,EDM,33,71,25,23,48
51,8480797,Joel Farabee,L,PHI,24,73,23,25,48
51,8474586,Jordan Eberle,R,SEA,34,75,18,30,48
51,8479425,Filip Hronek,D,VAN,27,76,11,37,48
51,8480064,Josh Norris,C,OTT,25,74,28,19,47
51,8478233,Andrew Mangiapane,L,WSH,28,69,23,24,47
51,8480829,Jesperi Kotkaniemi,C,CAR,24,68,23,24,47
51,8482720,Matthew Knies,L,TOR,22,76,20,27,47
51,8482705,Cole Sillinger,C,CBJ,21,68,19,28,47
51,8481711,Matias Maccelli,L,UTA,24,72,14,33,47
51,8475798,Mikael Granlund,C,SJS,32,66,13,34,47
51,8478469,Thomas Chabot,D,OTT,27,73,13,34,47
51,8476880,Tom Wilson,R,WSH,30,67,21,25,46
51,8474679,Gustav Nyquist,C,NSH,35,72,14,32,46
51,8477498,Darnell Nurse,D,EDM,29,74,12,34,46
51,8478055,Gustav Forsling,D,FLA,28,72,11,35,46
51,8476462,Dougie Hamilton,D,NJD,31,68,10,36,46
51,8476854,Hampus Lindholm,D,BOS,30,74,10,36,46
51,8483490,Pavel Mintyukov,D,ANA,21,77,9,37,46
51,8477998,Warren Foegele,L,LAK,28,79,22,23,45
51,8478042,Viktor Arvidsson,L,EDM,31,76,19,26,45
51,8484166,Adam Fantilli,C,CBJ,20,64,19,26,45
51,8478466,Daniel Sprong,R,VAN,27,74,18,27,45
51,8480188,Fabian Zetterlund,L,SJS,25,70,17,28,45
51,8476483,Rickard Rakell,R,PIT,31,73,16,29,45
51,8477955,Jared McCann,L,SEA,28,69,23,21,44
51,8478046,Danton Heinen,L,VAN,29,68,20,24,44
51,8482092,Ridly Greig,C,OTT,22,78,19,25,44
51,8476881,Tomas Hertl,C,VGK,31,76,16,28,44
51,8477511,Anthony Mantha,R,CGY,30,81,16,28,44
51,8481581,Thomas Harley,D,DAL,23,75,9,35,44
51,8475760,Nick Bjugstad,C,UTA,32,74,21,22,43
51,8480220,Noah Cates,L,PHI,25,73,21,22,43
51,8478498,Jake DeBrusk,L,VAN,28,71,19,24,43
51,8475793,Ryan Johansen,C,PHI,32,70,17,26,43
51,8476480,Vladislav Namestnikov,C,WPG,32,69,14,29,43
51,8480028,Morgan Frost,C,PHI,25,73,11,32,43
51,8480798,Philipp Kurashev,C,CHI,25,64,19,23,42
51,8479987,Morgan Geekie,C,BOS,26,77,16,26,42
51,8477964,Ivan Barbashev,C,VGK,29,77,15,27,42
51,8478458,John (Jack) Roslovic,C,CAR,27,65,15,27,42
51,8477986,Brandon Montour,D,SEA,30,74,14,28,42
51,8476875,Mike Matheson,D,MTL,30,72,11,31,42
51,8482146,Luke Evangelista,R,NSH,22,74,20,21,41
51,8478438,Tommy Novak,C,NSH,27,73,18,23,41
51,8478115,Pierre Engvall,L,NYI,28,75,18,23,41
51,8481596,Shane Pinto,C,OTT,24,74,17,24,41
51,8481656,Aliaksei Protas,C,WSH,23,68,17,24,41
51,8481618,Alex Newhook,C,MTL,23,68,15,26,41
51,8476292,Ondrej Palat,L,NJD,33,71,15,26,41
51,8476869,Brady Skjei,D,NSH,30,64,11,30,41
51,8479410,Mikhail Sergachev,D,UTA,26,71,8,33,41
51,8474563,Drew Doughty,D,LAK,35,68,7,34,41
51,8476906,Shayne Gostisbehere,D,CAR,31,72,6,35,41
51,8480849,Barrett Hayton,C,UTA,24,73,18,22,40
51,8477932,Aaron Ekblad,D,FLA,28,70,12,28,40
51,8479345,Jakob Chychrun,D,WSH,26,69,8,32,40
51,8477495,Seth Jones,D,CHI,30,71,8,32,40
51,8478474,Lawson Crouse,L,UTA,27,79,27,12,39
51,8481560,Arthur Kaliyev,R,LAK,23,77,21,18,39
51,8482110,Dawson Mercer,C,NJD,23,74,16,23,39
51,8482113,Anton Lundell,C,FLA,23,73,16,23,39
51,8479339,Patrik Laine,L,CBJ,26,70,14,25,39
51,8475753,Justin Faulk,D,STL,32,73,11,28,39
51,8476438,Brandon Saad,L,STL,32,70,22,16,38
51,8479365,Trent Frederic,C,BOS,26,73,19,19,38
51,8478047,Michael Bunting,L,PIT,29,69,17,21,38
51,8474641,Adam Henrique,C,EDM,34,74,17,21,38
51,8478519,Anthony Cirelli,C,TBL,27,82,17,21,38
51,8475287,Erik Haula,L,NJD,33,67,16,22,38
51,8482475,Yegor Chinakhov,R,CBJ,23,64,20,17,37
51,8477407,Anthony Duclair,L,NYI,29,80,17,20,37
51,8474715,Cameron Atkinson,R,TBL,35,82,17,20,37
51,8480113,Alex Iafallo,L,WPG,31,62,17,20,37
51,8480185,Eetu Luostarinen,C,FLA,26,74,15,22,37
51,8481577,Philip Tomasino,C,NSH,23,69,12,25,37
51,8479591,Michael Eyssimont,C,TBL,28,79,12,25,37
51,8474565,Alex Pietrangelo,D,VGK,34,61,9,28,37
51,8480145,Neal Pionk,D,WPG,29,70,7,30,37
51,8481542,Moritz Seider,D,DET,23,75,5,32,37
51,8474149,Evgenii Dadonov,R,DAL,35,80,20,16,36
51,8474716,Jared Spurgeon,D,MIN,35,78,17,19,36
51,8479393,Noah Gregor,L,OTT,26,75,17,19,36
51,8479525,Ross Colton,C,COL,28,79,15,21,36
51,8478109,Victor Olofsson,L,VGK,29,66,12,24,36
51,8482660,Kent Johnson,C,CBJ,22,64,12,24,36
51,8475768,Jaden Schwartz,C,SEA,32,75,11,25,36
51,8482175,JJ Peterka,R,BUF,22,65,11,25,36
51,8476979,Erik Gustafsson,D,DET,32,72,8,28,36
51,8482712,Oskar Olausson,R,COL,22,73,7,29,36
51,8475764,Cam Fowler,D,ANA,33,73,5,31,36
51,8476958,Jaccob Slavin,D,CAR,30,78,5,31,36
51,8478057,Dakota Joshua,C,VAN,28,66,18,17,35
51,8475191,Reilly Smith,R,NYR,33,73,17,18,35
51,8475763,Kevin Hayes,R,PIT,32,69,16,19,35
51,8478542,Evan Rodrigues,C,FLA,31,72,13,22,35
51,8476458,Ryan Strome,C,ANA,31,69,12,23,35
51,8476872,Scott Laughton,C,PHI,30,71,12,23,35
51,8481553,Bobby Brink,R,PHI,23,63,12,23,35
51,8477479,Tyler Bertuzzi,L,CHI,29,69,10,25,35
51,8477969,Marcus Pettersson,D,PIT,28,76,7,28,35
51,8480878,Nils Lundkvist,D,DAL,24,73,6,29,35
51,8476923,Damon Severson,D,CBJ,30,78,5,30,35
51,8477425,Miles Wood,L,COL,29,77,17,17,34
51,8482702,Logan Stankoven,C,DAL,21,78,14,20,34
51,8478472,Mathieu Joseph,R,STL,27,68,13,21,34
51,8483515,Juraj Slafkovsky,L,MTL,20,71,13,21,34
51,8477444,Andre Burakovsky,L,SEA,29,72,12,22,34
51,8475218,Mattias Ekholm,D,EDM,34,72,10,24,34
51,8478507,John Marino,D,UTA,27,63,8,26,34
51,8482122,Brock Faber,D,MIN,22,76,7,27,34
51,8478413,Jordan Greenway,L,BUF,27,67,18,15,33
51,8480835,Jack Drury,C,CAR,24,61,18,15,33
51,8473533,Jordan Staal,C,CAR,36,64,18,15,33
51,8481535,Nils Hoglander,L,VAN,24,63,17,16,33
51,8476826,Yanni Gourde,C,SEA,33,74,16,17,33
51,8476461,Sean Couturier,C,PHI,32,70,13,20,33
51,8475314,Anders Lee,L,NYI,34,75,13,20,33
51,8475848,Brendan Gallagher,R,MTL,32,70,12,21,33
51,8474574,Tyler Myers,D,VAN,34,75,8,25,33
51,8474151,Ryan McDonagh,D,TBL,35,78,7,26,33
51,8480434,Sean Durzi,D,UTA,26,70,6,27,33
51,8481624,Ilya Mikheyev,R,CHI,30,54,20,12,32
51,8480009,Eeli Tolvanen,R,SEA,25,65,18,14,32
51,8479353,Brett Howden,C,VGK,26,67,16,16,32
51,8482667,William Eklund,L,SJS,22,63,15,17,32
51,8475200,Dmitry Orlov,D,CAR,33,71,14,18,32
51,8483505,Matthew Poitras,C,BOS,20,67,12,20,32
51,8480068,Ryan Poehling,C,PHI,25,68,11,21,32
51,8482133,Thomas Bordeleau,C,SJS,22,62,10,22,32
51,8478970,Jalen Chatfield,D,CAR,28,73,8,24,32
51,8482671,Owen Power,D,BUF,22,73,6,26,32
51,8476879,Cody Ceci,D,EDM,31,71,4,28,32
51,8477919,Frederick Gaudreau,C,MIN,31,62,17,14,31
51,8479992,Michael Rasmussen,C,DET,25,74,16,15,31
51,8482079,Marco Rossi,C,MIN,23,56,16,15,31
51,8479390,Taylor Raddysh,R,WSH,26,59,14,17,31
51,8484203,Bradly Nadeau,L,CAR,19,63,12,19,31
51,8480789,Oliver Wahlstrom,R,NYI,24,74,12,19,31
51,8480817,K'Andre Miller,D,NYR,24,70,8,23,31
51,8478020,Michael Amadio,R,OTT,28,76,18,12,30
51,8474053,Logan Couture,C,SJS,35,65,17,13,30
51,8481186,Logan O'Connor,R,COL,28,78,16,14,30
51,8477478,William Carrier,L,CAR,30,53,16,14,30
51,8478463,Anthony Beauvillier,L,PIT,27,72,15,15,30
51,8474189,Lars Eller,C,PIT,35,59,13,17,30
51,8484145,Zach Benson,L,BUF,19,69,12,18,30
51,8482737,Zack Bolduc,C,STL,21,64,12,18,30
51,8477505,Alexander Wennberg,C,SJS,30,62,11,19,30
51,8476392,Adam Lowry,C,WPG,31,61,10,20,30
51,8481703,Valtteri Puustinen,R,PIT,25,67,8,22,30
51,8480855,Jack McBain,C,UTA,24,69,7,23,30
51,8480246,Nick Perbix,D,TBL,26,72,6,24,30
51,8482624,Daniil Miromanov,D,CGY,27,58,5,25,30
51,8482105,Jake Sanderson,D,OTT,22,72,3,27,30
51,8480459,Pius Suter,C,VAN,28,67,18,11,29
51,8478891,Mason Appleton,C,WPG,28,66,15,14,29
51,8478911,Matt Roy,D,WSH,29,66,13,16,29
51,8476897,Oskar Sundqvist,C,STL,30,72,11,18,29
51,8476892,Colton Parayko,D,STL,31,73,9,20,29
51,8480873,Rasmus Sandin,D,WSH,24,65,1,28,29
51,8480762,Eric Robinson,L,CAR,29,56,18,10,28
51,8476419,Jean-Gabriel Pageau,C,NYI,32,77,13,15,28
51,8483445,Cutter Gauthier,L,ANA,20,61,13,15,28
51,8476918,Jimmy Vesey,L,NYR,31,62,13,15,28
51,8476882,Teuvo Teravainen,C,CHI,30,64,12,16,28
51,8481522,Peyton Krebs,C,BUF,23,57,12,16,28
51,8477497,Sean Monahan,C,CBJ,30,75,11,17,28
51,8476927,Teddy Blueger,C,VAN,30,71,11,17,28
51,8477488,Brett Pesce,D,NJD,30,69,11,17,28
51,8479351,Sam Steel,C,DAL,26,80,10,18,28
51,8476463,Jonas Brodin,D,MIN,31,79,9,19,28
51,8476921,Jordan Martinook,L,CAR,32,57,9,19,28
51,8482101,Danil Gushchin,L,SJS,22,56,7,21,28
51,8477948,Travis Sanheim,D,PHI,28,62,6,22,28
51,8480073,Erik Brannstrom,D,COL,25,66,5,23,28
51,8477952,Robby Fabbri,C,ANA,28,68,11,16,27
51,8476981,Josh Anderson,R,MTL,30,69,11,16,27
51,8479293,Brandon Tanev,L,SEA,33,65,11,16,27
51,8475722,Jason Zucker,L,BUF,32,68,10,17,27
51,8481582,Nicholas Robertson,L,TOR,23,69,10,17,27
51,8477953,Kasperi Kapanen,R,STL,28,66,10,17,27
51,8481524,Bowen Byram,D,BUF,23,63,9,18,27
51,8480871,Adam Boqvist,D,FLA,24,64,9,18,27
51,8477429,Andrew Copp,C,DET,30,78,8,19,27
51,8475855,Jesper Fast,R,CAR,33,60,7,20,27
51,8478133,Jake Evans,C,MTL,28,71,6,21,27
51,8482245,Artem Zub,D,OTT,29,74,5,22,27
51,8475181,Nick Leddy,D,STL,33,71,4,23,27
51,8480748,Kiefer Sherwood,L,VAN,29,53,14,12,26
51,8480078,Filip Chytil,C,NYR,25,66,13,13,26
51,8473422,Nick Foligno,L,CHI,37,61,12,14,26
51,8480813,Joe Veleno,C,DET,24,73,12,14,26
51,8482111,Justin Barron,D,MTL,23,69,12,14,26
51,8479316,Luke Kunin,C,SJS,27,58,11,15,26
51,8482809,Jackson Blake,R,CAR,21,65,11,15,26
51,8477947,Sonny Milano,L,WSH,28,64,10,16,26
51,8479996,Cody Glass,C,NSH,25,65,10,16,26
51,8480336,Sean Walker,D,CAR,30,72,8,18,26
51,8481546,Cam York,D,PHI,23,73,8,18,26
51,8482067,Connor Mackey,D,NYR,28,68,8,18,26
51,8481606,Jordan Spence,D,LAK,23,61,4,22,26
51,8479402,Jake Bean,D,CGY,26,66,4,22,26
51,8475208,Brian Dumoulin,D,ANA,33,59,2,24,26
51,8481641,Joel Kiviranta,L,COL,28,73,19,6,25
51,8481554,Kaapo Kakko,R,NYR,23,71,16,9,25
51,8478013,Jake Walman,D,SJS,28,72,15,10,25
51,8476474,Stefan Noesen,R,NJD,31,68,14,11,25
51,8482055,Drew O'Connor,L,PIT,26,60,13,12,25
51,8477989,Christian Dvorak,C,MTL,28,72,13,12,25
51,8479336,Carl Grundstrom,R,SJS,27,51,13,12,25
51,8482074,Connor Zary,C,CGY,23,59,12,13,25
51,8477839,Conor Sheary,L,TBL,32,82,11,14,25
51,8482125,Alexander Holtz,R,VGK,22,69,8,17,25
51,8481523,Kirby Dach,C,MTL,23,67,6,19,25
51,8481059,Scott Perunovich,D,STL,26,53,6,19,25
51,8476902,Esa Lindell,D,DAL,30,74,5,20,25
51,8483491,Ivan Miroshnichenko,L,WSH,20,55,5,20,25
51,8478851,Alexandre Carrier,D,NSH,28,72,3,22,25
51,8475179,Dmitry Kulikov,D,FLA,34,68,3,22,25
51,8476917,Adam Pelech,D,NYI,30,78,2,23,25
51,8479398,Samuel Girard,D,COL,26,64,2,23,25
51,8480003,Jesper Boqvist,C,FLA,26,71,14,10,24
51,8479368,Max Jones,L,BOS,26,67,10,14,24
51,8480802,Ryan McLeod,C,BUF,25,65,10,14,24
51,8475149,Marcus Johansson,L,MIN,34,67,8,16,24
51,8478500,Ivan Provorov,D,CBJ,27,80,6,18,24
51,8481014,Alexander Romanov,D,NYI,24,74,4,20,24
51,8477220,Nate Schmidt,D,FLA,33,68,4,20,24
51,8481032,Paul Cotter,C,NJD,25,61,13,10,23
51,8481477,Nico Sturm,C,SJS,29,59,13,10,23
51,8470621,Corey Perry,R,EDM,39,72,12,11,23
51,8482089,Jake Neighbours,L,STL,22,65,12,11,23
51,8482679,Matt Coronato,R,CGY,22,69,10,13,23
51,8483457,Lane Hutson,D,MTL,20,71,10,13,23
51,8478432,Christian Fischer,R,DET,27,72,10,13,23
51,8480893,Kirill Marchenko,R,CBJ,24,62,9,14,23
51,8482803,Olen Zellweger,D,ANA,21,62,9,14,23
51,8477507,Nikita Zadorov,D,BOS,29,70,6,17,23
51,8476467,Jamie Oleksiak,D,SEA,32,66,6,17,23
51,8482655,Janis Moser,D,TBL,24,79,5,18,23
51,8477506,Ryan Pulock,D,NYI,30,80,3,20,23
51,8476312,Josh Manson,D,COL,33,62,3,20,23
51,8479324,Ryan Lindgren,D,NYR,26,69,2,21,23
51,8480891,Michael Kesselring,D,UTA,24,60,2,21,23
51,8483524,Shane Wright,C,SEA,20,60,11,11,22
51,8479941,Justin Danforth,R,CBJ,31,56,11,11,22
51,8477392,Hudson Fasching,R,NYI,29,68,10,12,22
51,8482749,Joshua Roy,R,MTL,21,61,10,12,22
51,8482142,Jamie Drysdale,D,PHI,22,63,10,12,22
51,8481601,Simon Holmstrom,R,NYI,23,63,10,12,22
51,8475193,Tomas Tatar,L,NJD,34,71,9,13,22
51,8479639,Dylan Coghlan,D,WPG,26,54,9,13,22
51,8480995,Pontus Holmberg,R,TOR,25,62,9,13,22
51,8476885,Jacob Trouba,D,NYR,30,65,7,15,22
51,8479026,Philippe Myers,D,TOR,27,55,7,15,22
51,8481704,Juuso Parssinen,C,NSH,23,53,5,17,22
51,8481019,David Gustafsson,C,WPG,24,53,5,17,22
51,8476331,Dylan DeMelo,D,WPG,31,70,5,17,22
51,8480796,Martin Fehervary,D,WSH,25,55,4,18,22
51,8476856,Mathew Dumba,D,DAL,30,68,3,19,22
51,8480144,David Kampf,C,TOR,29,67,2,20,22
51,8476878,Zemgus Girgensons,C,TBL,30,81,16,5,21
51,8477903,Garnet Hathaway,R,PHI,33,71,11,10,21
51,8482157,Will Cuylle,L,NYR,22,68,10,11,21
51,8479661,Tanner Jeannot,L,LAK,27,78,9,12,21
51,8480448,Parker Kelly,L,COL,25,73,8,13,21
51,8476329,Travis Boyd,C,MIN,31,51,8,13,21
51,8481441,Joe Snively,C,DET,28,71,8,13,21
51,8483482,Tristan Luneau,D,ANA,20,54,8,13,21
51,8477987,Ryan Donato,C,CHI,28,60,7,14,21
51,8475171,Oliver Ekman-Larsson,D,TOR,33,67,6,15,21
51,8482087,Kaiden Guhle,D,MTL,22,66,6,15,21
51,8474034,Patrick Maroon,L,CHI,36,55,5,16,21
51,8483499,Liam Ohgren,L,MIN,20,58,5,16,21
51,8475462,Radko Gudas,D,ANA,34,68,4,17,21
51,8480172,Jan Rutta,D,SJS,34,62,4,17,21
51,8479718,Alex Barré-Boulet,C,MTL,27,51,3,18,21
51,8474673,TJ Brodie,D,CHI,34,63,2,19,21
51,8476889,Radek Faksa,C,STL,30,63,10,10,20
51,8481481,Blake Lizotte,C,PIT,27,69,9,11,20
51,8481093,Rafael Harvey-Pinard,L,MTL,25,62,8,12,20
51,8481527,Kaedan Korczak,D,VGK,23,49,6,14,20
51,8478840,Will Borgen,D,SEA,28,70,6,14,20
51,8475790,Erik Gudbranson,D,CBJ,32,78,4,16,20
51,8480035,Henri Jokiharju,D,BUF,25,63,4,16,20
51,8479982,Conor Timmins,D,TOR,26,59,3,17,20
51,8475324,Nick Jensen,D,OTT,34,66,2,18,20
51,8476891,Matthew Grzelcyk,D,PIT,30,74,2,18,20
51,8482259,Bobby McMann,C,TOR,28,63,14,5,19
51,8475343,Nic Dowd,C,WSH,34,57,10,9,19
51,8482062,Cole Smith,L,NSH,29,58,9,10,19
51,8481161,Jake Christiansen,D,CBJ,25,50,8,11,19
51,8481599,Victor Soderstrom,D,UTA,23,50,6,13,19
51,8475791,Taylor Hall,L,CHI,33,55,5,14,19
51,8473563,Nicklas Backstrom,C,WSH,37,55,4,15,19
51,8478416,Erik Cernak,D,TBL,27,75,4,15,19
51,8481521,Ronnie Attard,D,PHI,25,56,4,15,19
51,8476429,Scott Mayfield,D,NYI,32,70,3,16,19
51,8478452,Caleb Jones,D,LAK,27,53,3,16,19
51,8475188,Brayden McNabb,D,VGK,33,52,2,17,19
51,8479414,Nathan Bastian,R,NJD,27,55,11,7,18
51,8476873,Mark Jankowski,C,NSH,30,50,11,7,18
51,8475231,Casey Cizikas,C,NYI,33,70,9,9,18
51,8477015,Connor Brown,R,EDM,30,61,8,10,18
51,8481580,Connor McMichael,C,WSH,23,62,7,11,18
51,8479439,Jacob MacDonald,D,COL,31,45,7,11,18
51,8479998,Mikey Anderson,D,LAK,25,65,5,13,18
51,8480043,Timothy Liljegren,D,TOR,25,67,3,15,18
51,8476525,Colin Miller,D,WPG,32,60,3,15,18
51,8478043,Sam Lafferty,C,BUF,29,56,11,6,17
51,8481518,Nolan Foote,L,NJD,24,44,11,6,17
51,8477353,Tyler Motte,C,DET,29,68,10,7,17
51,8480980,Connor Dewar,C,TOR,25,66,10,7,17
51,8473453,Trevor Lewis,C,LAK,37,74,8,9,17
51,8476457,Adam Larsson,D,SEA,32,58,8,9,17
51,8477369,Carson Soucy,D,VAN,30,62,8,9,17
51,8477508,Curtis Lazar,C,NJD,29,66,8,9,17
51,8476469,Joel Armia,R,MTL,31,69,6,11,17
51,8480205,Emil Bemstrom,C,PIT,25,59,6,11,17
51,8477931,Tomas Nosek,L,FLA,32,62,6,11,17
51,8481167,Brayden Pachal,D,CGY,25,52,6,11,17
51,8483493,Frank Nazar,C,CHI,20,55,5,12,17
51,8483565,Nick Blankenburg,D,NSH,26,66,5,12,17
51,8479976,Juuso Valimaki,D,UTA,26,59,5,12,17
51,8478399,Jonas Siegenthaler,D,NJD,27,66,4,13,17
51,8478882,Vladislav Gavrikov,D,LAK,29,70,3,14,17
51,8478136,Jake Middleton,D,MIN,28,74,3,14,17
51,8478178,Darren Raddysh,D,TBL,28,72,3,14,17
51,8477499,Rasmus Ristolainen,D,PHI,30,63,2,15,17
51,8480049,Dylan Samberg,D,WPG,25,64,2,15,17
51,8482073,Braden Schneider,D,NYR,23,63,1,16,17
51,8482192,Isaak Phillips,D,CHI,23,52,1,16,17
51,8477450,Jason Dickinson,C,CHI,29,55,11,5,16
51,8476278,Colin Blackwell,C,DAL,31,78,10,6,16
51,8482117,Lukas Reichel,L,CHI,22,62,8,8,16
51,8482155,Alex Laferriere,R,LAK,23,62,8,8,16
51,8481568,Alex Vlasic,D,CHI,23,50,7,9,16
51,8477406,Mattias Janmark,C,EDM,32,63,7,9,16
51,8480021,Jack Studnicka,C,LAK,25,56,6,10,16
51,8481708,Zac Jones,D,NYR,24,51,6,10,16
51,8482451,Mikael Pyyhtia,L,CBJ,23,54,6,10,16
51,8480950,Ilya Lyubushkin,D,DAL,30,59,4,12,16
51,8478508,Yakov Trenin,C,MIN,27,63,9,6,15
51,8475225,Craig Smith,C,CHI,35,50,9,6,15
51,8479619,Michael Carcone,L,UTA,28,63,8,7,15
51,8480355,Mark Kastelic,C,BOS,25,55,8,7,15
51,8480289,Morgan Barron,C,WPG,26,47,8,7,15
51,8481028,Martin Pospisil,C,CGY,25,59,7,8,15
51,8479944,Zach Aston-Reese,C,VGK,30,59,7,8,15
51,8477446,Michael McCarron,R,NSH,29,62,5,10,15
51,8470600,Ryan Suter,D,STL,39,58,5,10,15
51,8479371,Dante Fabbro,D,NSH,26,60,4,11,15
51,8480848,Ty Dellandrea,C,SJS,24,40,4,11,15
51,8476374,Sean Kuraly,C,CBJ,31,48,4,11,15
51,8476967,Brett Kulak,D,EDM,30,65,4,11,15
51,8477365,Connor Clifton,D,BUF,29,54,4,11,15
51,8482166,Shakir Mukhamadullin,D,SJS,22,63,4,11,15
51,8476931,Jake McCabe,D,TOR,31,65,3,12,15
51,8476422,Mike Reilly,D,NYI,31,79,3,12,15
51,8477034,Jaycob Megna,D,FLA,32,52,3,12,15
51,8475690,Chris Tanev,D,TOR,35,56,2,13,15
51,8480281,Alexey Toropchenko,R,STL,25,61,11,3,14
51,8479520,Brandon Duhaime,R,WSH,27,59,9,5,14
51,8479344,Jesse Puljujarvi,R,PIT,26,52,9,5,14
51,8478421,A.J. Greer,L,FLA,28,54,8,6,14
51,8482730,Brandt Clarke,D,LAK,21,47,8,6,14
51,8483468,Jiri Kulich,C,BUF,20,58,7,7,14
51,8476925,Colton Sissons,C,NSH,31,64,6,8,14
51,8479066,Ryan Lomberg,L,CGY,30,72,6,8,14
51,8476822,Luke Glendening,C,TBL,35,76,6,8,14
51,8479315,Joey Anderson,R,CHI,26,40,5,9,14
51,8481592,Jakob Pelletier,L,CGY,23,42,5,9,14
51,8477380,Jonny Brodzinski,C,NYR,31,51,4,10,14
51,8474567,Zach Bogosian,D,MIN,34,62,4,10,14
51,8477482,Zachary Sanford,L,CHI,30,41,4,10,14
51,8475455,Brenden Dillon,D,NJD,34,57,3,11,14
51,8482176,Wyatt Kaiser,D,CHI,22,59,2,12,14
51,8480222,Sebastian Aho,D,PIT,28,66,2,12,14
51,8475718,Justin Holl,D,DET,32,61,2,12,14
51,8478859,Niko Mikkola,D,FLA,28,54,2,12,14
51,8482659,Josh Doan,R,UTA,22,45,9,4,13
51,8476867,Brendan Gaunce,C,MIN,30,37,9,4,13
51,8478831,Kevin Stenlund,C,UTA,28,46,8,5,13
51,8479328,Julien Gauthier,R,NYI,27,59,7,6,13
51,8479981,Jonah Gadjovich,L,FLA,26,49,7,6,13
51,8481617,Vasily Podkolzin,R,VAN,23,47,6,7,13
51,8482744,James Malatesta,L,CBJ,21,41,6,7,13
51,8471817,Ryan Reaves,R,TOR,37,58,6,7,13
51,8474166,Alec Martinez,D,CHI,37,47,5,8,13
51,8478017,Mark Friedman,D,VAN,29,38,5,8,13
51,8477979,Nicolas Aube-Kubel,R,BUF,28,69,4,9,13
51,8482634,Alex Steeves,C,TOR,25,49,4,9,13
51,8478874,Adam Gaudette,R,OTT,28,33,4,9,13
51,8473507,Jeff Petry,D,DET,37,70,3,10,13
51,8475233,David Savard,D,MTL,34,65,2,11,13
51,8479980,Nicolas Hague,D,VGK,26,57,1,12,13
51,8481600,Tobias Bjornfot,D,FLA,23,33,1,12,13
51,8480025,MacKenzie Entwistle,R,FLA,25,61,7,5,12
51,8478569,Noel Acciari,C,PIT,33,50,6,6,12
51,8479968,Vinni Lettieri,C,BOS,29,45,6,6,12
51,8478434,Keegan Kolesar,R,VGK,27,63,5,7,12
51,8475220,Marcus Foligno,L,MIN,33,51,5,7,12
51,8476988,Matt Benning,D,SJS,30,61,4,8,12
51,8480441,Trey Fix-Wolansky,R,CBJ,25,36,4,8,12
51,8480074,Alexandre Texier,C,STL,25,54,3,9,12
51,8481550,Adam Beckman,L,NJD,23,45,3,9,12
51,8480879,Jacob Bernard-Docker,D,OTT,24,50,2,10,12
51,8477435,Ryan Graves,D,PIT,29,78,1,11,12
51,8478443,Brandon Carlo,D,BOS,28,60,1,11,12
51,8477845,Trevor van Riemsdyk,D,WSH,33,54,0,12,12
51,8479671,Mathieu Olivier,R,CBJ,27,45,8,3,11
51,8481013,Jonatan Berggren,R,DET,24,63,8,3,11
51,8483495,Simon Nemec,D,NJD,20,54,6,5,11
51,8480806,Isac Lundestrom,C,ANA,25,52,6,5,11
51,8479543,Michael Pezzetta,L,MTL,26,49,6,5,11
51,8476960,Andreas Athanasiou,C,CHI,30,46,5,6,11
51,8481517,Brett Leason,R,ANA,25,53,5,6,11
51,8480192,Johnathan Kovacevic,D,NJD,27,53,5,6,11
51,8475235,Nicolas Deslauriers,L,PHI,33,52,5,6,11
51,8482859,Zack Ostapchuk,C,OTT,21,51,5,6,11
51,8482784,Zach Dean,C,STL,21,41,5,6,11
51,8476994,Vinnie Hinostroza,C,NSH,30,44,3,8,11
51,8480860,Kevin Bahl,D,CGY,24,56,2,9,11
51,8477070,Liam O'Brien,C,UTA,30,50,2,9,11
51,8483460,David Jiricek,D,CBJ,21,65,2,9,11
51,8479983,Mario Ferraro,D,SJS,26,66,2,9,11
51,8480727,Zach Whitecloud,D,VGK,28,52,2,9,11
51,8482095,Tyler Kleven,D,OTT,22,37,2,9,11
51,8480887,Jordan Harris,D,MTL,24,50,1,10,11
51,8480001,Urho Vaakanainen,D,ANA,25,70,1,10,11
51,8481178,Egor Zamula,D,PHI,24,55,0,11,11
51,8480807,Mattias Samuelsson,D,BUF,24,52,0,11,11
51,8482762,Simon Edvinsson,D,DET,21,59,9,1,10
51,8476934,Brock McGinn,L,ANA,30,53,5,5,10
51,8478409,Anthony Richard,C,PHI,28,27,5,5,10
51,8479291,Kevin Rooney,C,CGY,31,47,4,6,10
51,8476624,Barclay Goodrow,C,SJS,31,52,4,6,10
51,8477018,Ben Hutton,D,VGK,31,38,3,7,10
51,8480157,Calle Rosen,D,COL,30,43,3,7,10
51,8480252,Cole Guttman,C,CHI,25,45,2,8,10
51,8479378,Logan Stanley,D,WPG,26,46,2,8,10
51,8478585,Derek Ryan,C,EDM,38,61,2,8,10
51,8474090,Brendan Smith,D,DAL,35,54,2,8,10
51,8471677,Jack Johnson,D,CBJ,37,61,2,8,10
51,8475279,Ben Chiarot,D,DET,33,67,1,9,10
51,8478468,Jeremy Lauzon,D,NSH,27,57,1,9,10
51,8481537,Nikita Okhotiuk,D,CGY,24,53,1,9,10
51,8475842,Sam Carrick,C,NYR,32,61,6,3,9
51,8481716,Dmitri Voronkov,L,CBJ,24,47,6,3,9
51,8478211,Dryden Hunt,L,CGY,29,49,6,3,9
51,8481122,Simon Benoit,D,TOR,26,38,5,4,9
51,8481556,John Beecher,C,BOS,23,42,5,4,9
51,8484149,Gavin Brindley,C,CBJ,20,42,4,5,9
51,8482077,Dylan Holloway,L,EDM,23,52,4,5,9
51,8480845,Rasmus Kupari,C,WPG,24,47,4,5,9
51,8482652,Walker Duehr,R,CGY,27,32,4,5,9
51,8479772,Zack MacEwen,R,OTT,28,57,4,5,9
51,8471709,Marc-Edouard Vlasic,D,SJS,37,66,3,6,9
51,8476442,Matt Nieto,L,PIT,32,48,3,6,9
51,8479442,Troy Stecher,D,EDM,30,51,2,7,9
51,8473446,Erik Johnson,D,PHI,36,49,2,7,9
51,8477473,Justin Bailey,R,SJS,29,23,2,7,9
51,8480058,Pierre-Olivier Joseph,D,STL,25,55,2,7,9
51,8477573,Nathan Walker,L,STL,30,46,1,8,9
51,8483549,Lucas Condotta,L,MTL,27,37,1,8,9
51,8474013,Ian Cole,D,UTA,35,51,1,8,9
51,8475177,Calvin de Haan,D,COL,33,42,1,8,9
51,8479369,Andrew Peeke,D,BOS,26,59,0,9,9
51,8481679,Maxence Guenette,D,OTT,23,31,6,2,8
51,8479359,Beck Malenstyn,L,BUF,26,40,4,4,8
51,8482751,Ryan Winterton,C,SEA,21,30,4,4,8
51,8478451,Ethan Bear,D,WSH,27,52,3,5,8
51,8479994,Jaret Anderson-Dolan,C,WPG,25,34,3,5,8
51,8476874,Olli Maatta,D,DET,30,61,3,5,8
51,8480990,Declan Chisholm,D,MIN,24,40,3,5,8
51,8481605,Jackson LaCombe,D,ANA,23,29,3,5,8
51,8481751,Lukas Rousek,R,BUF,25,34,3,5,8
51,8479348,Kale Clague,D,BUF,26,43,2,6,8
51,8481147,Reese Johnson,C,MIN,26,49,1,7,8
51,8481567,Henry Thrun,D,SJS,23,46,1,7,8
51,8480196,Jacob Bryson,D,BUF,27,38,1,7,8
51,8479372,Joshua Mahura,D,SEA,26,54,0,8,8
51,8476372,Nick Seeler,D,PHI,31,44,0,8,8
51,8478502,Dennis Gilbert,D,BUF,28,23,0,8,8
51,8482807,Ethan Del Mastro,D,CHI,21,45,4,3,7
51,8482145,Mavrik Bourque,C,DAL,22,49,4,3,7
51,8479638,Justin Brazeau,R,BOS,26,36,4,3,7
51,8482070,Mitchell Chaffee,R,TBL,26,44,4,3,7
51,8482148,Hendrix Lapierre,C,WSH,22,51,3,4,7
51,8483466,Kevin Korchinski,D,CHI,20,51,3,4,7
51,8480844,Grigori Denisenko,L,VGK,24,31,3,4,7
51,8481598,Philip Broberg,D,EDM,23,39,3,4,7
51,8482747,Brennan Othmann,L,NYR,21,46,3,4,7
51,8479972,Mason Shaw,C,WPG,26,32,3,4,7
51,8477938,Haydn Fleury,D,WPG,28,51,2,5,7
51,8474612,Travis Hamonic,D,OTT,34,52,2,5,7
51,8478454,Noah Juulsen,D,VAN,27,33,2,5,7
51,8477887,Patrick Brown,C,BOS,32,49,2,5,7
51,8479370,Tyson Jost,C,CAR,26,45,1,6,7
51,8475762,Derek Forbort,D,VAN,32,42,1,6,7
51,8479536,Axel Jonsson-Fjallby,L,WPG,26,38,0,7,7
51,8481754,Nikita Nesterenko,C,ANA,23,39,4,2,6
51,8477962,Brendan Lemieux,L,CAR,28,41,4,2,6
51,8483570,Ben Meyers,C,SEA,26,31,4,2,6
51,8477527,Ross Johnston,L,ANA,30,35,4,2,6
51,8482733,Logan Mailloux,D,MTL,31,34,3,3,6
51,8481532,Alex Turcotte,C,LAK,23,44,3,3,6
51,8476473,Connor Murphy,D,CHI,31,41,3,3,6
51,8482765,Isak Rosen,R,BUF,21,34,3,3,6
51,8480007,Jonas Rondbjerg,R,VGK,25,43,3,3,6
51,8482861,Vincent Iorio,D,WSH,22,33,3,3,6
51,8483397,Marc McLaughlin,C,BOS,25,25,3,3,6
51,8482964,Arber Xhekaj,D,MTL,23,46,3,3,6
51,8482147,Jean-Luc Foudy,C,COL,22,27,3,3,6
51,8480011,Klim Kostin,C,SJS,25,43,2,4,6
51,8476441,Joel Edmundson,D,LAK,31,49,2,4,6
51,8480890,Jan Jenik,C,OTT,24,23,2,4,6
51,8481543,Nikita Alexandrov,C,STL,24,23,2,4,6
51,8481006,Tyler Tucker,D,STL,24,22,2,4,6
51,8479986,Kole Lind,R,DAL,26,50,1,5,6
51,8480834,Ty Emberson,D,SJS,24,32,1,5,6
51,8481701,Santeri Hatakka,D,NJD,23,35,1,5,6
51,8477384,Joshua Brown,D,EDM,30,44,1,5,6
51,8477335,Kyle Burroughs,D,LAK,29,48,0,6,6
51,8482496,Nils Aman,C,VAN,24,39,0,6,6
51,8479320,Maxime Lajoie,D,SEA,27,31,0,6,6
51,8482250,Callahan Burke,C,VGK,27,22,0,6,6
51,8483763,Maksymilian Szuber,D,UTA,22,30,4,1,5
51,8484911,Collin Graf,R,SJS,22,39,4,1,5
51,8476858,Phillip Di Giuseppe,L,VAN,31,42,3,2,5
51,8482511,Mason Lohrei,D,BOS,23,35,3,2,5
51,8480870,Bo Groulx,C,NYR,24,27,2,3,5
51,8483012,Logan Morrison,C,SEA,22,38,2,3,5
51,8478424,Jansen Harkins,C,ANA,27,33,2,3,5
51,8480245,Olle Lycksell,R,PHI,25,33,2,3,5
51,8483630,Pavol Regenda,L,ANA,25,35,2,3,5
51,8477462,Robert Hagg,D,VGK,29,26,2,3,5
51,8480070,Ian Mitchell,D,BOS,25,45,1,4,5
51,8483619,Filip Roos,D,OTT,25,34,1,4,5
51,8481609,Vladislav Kolyachonok,D,UTA,23,38,1,4,5
51,8477810,Joel Hanley,D,CGY,33,23,1,4,5
51,8477401,John Hayden,C,SEA,29,36,1,4,5
51,8482165,Yan Kuznetsov,D,CGY,22,17,1,4,5
51,8476952,Dominic Toninato,C,WPG,30,39,0,5,5
51,8475750,Jon Merrill,D,MIN,32,58,0,5,5
51,8474568,Luke Schenn,D,NSH,35,46,0,5,5
51,8480851,Akil Thomas,C,LAK,24,23,4,0,4
51,8482201,Gage Goncalves,C,TBL,23,21,3,1,4
51,8480880,Jakub Lauko,C,MIN,24,29,3,1,4
51,8477467,Gustav Olofsson,D,SEA,30,19,3,1,4
51,8481541,Samuel Bolduc,D,NYI,24,25,2,2,4
51,8477244,Chad Ruhwedel,D,NYR,34,27,2,2,4
51,8482144,Jack Thompson,D,SJS,22,24,2,2,4
51,8482666,Scott Morrow,D,CAR,22,49,1,3,4
51,8481056,Spencer Stastney,D,NSH,24,35,1,3,4
51,8478477,Mitchell Stephens,C,SEA,27,21,1,3,4
51,8479249,Andrew Poturalski,C,SJS,30,39,0,4,4
51,8479576,Vincent Desharnais,D,VAN,28,30,0,4,4
51,8477851,Jordan Oesterle,D,BOS,32,38,0,4,4
51,8484254,Akito Hirose,D,VAN,25,36,0,4,4
51,8479379,Givani Smith,R,SJS,26,34,0,4,4
51,8480292,Carson Meyer,R,ANA,27,32,3,0,3
51,8479991,Jake Leschyshyn,C,NYR,25,17,3,0,3
51,8482713,Mackie Samoskevich,R,FLA,22,40,2,1,3
51,8482141,Lukas Cormier,D,VGK,22,30,2,1,3
51,8478011,Louie Belpedio,D,PHI,28,20,2,1,3
51,8484304,Uvis Balinskis,D,FLA,28,11,1,2,3
51,8478450,Parker Wotherspoon,D,BOS,27,35,1,2,3
51,8479587,Rhett Gardner,C,PHI,28,15,1,2,3
51,8481593,Jayden Struble,D,MTL,23,19,1,2,3
51,8482094,Daemon Hunt,D,MIN,22,18,1,2,3
51,8482516,Matthew Kessel,D,STL,24,15,1,2,3
51,8482177,Marat Khusnutdinov,C,MIN,22,33,1,2,3
51,8475795,Dylan McIlrath,D,WSH,32,13,1,2,3
51,8484287,Cole McWard,D,VAN,23,21,1,2,3
51,8481030,Jack St. Ivany,D,PIT,25,18,1,2,3
51,8477971,Andreas Englund,D,LAK,28,24,0,3,3
51,8483395,Arshdeep Bains,L,VAN,23,10,0,3,3
51,8480823,Alexander Alexeyev,D,WSH,25,14,0,3,3
51,8482929,Emil Lilleberg,D,TBL,23,23,0,3,3
51,8482102,Vasily Ponomarev,C,PIT,22,20,2,0,2
51,8481237,Kyle MacLean,C,NYI,25,27,2,0,2
51,8480468,James Hamblin,L,EDM,25,22,2,0,2
51,8481564,Ryan Johnson,D,BUF,23,16,2,0,2
51,8484325,Waltteri Merela,C,TBL,26,27,2,0,2
51,8480032,Shane Bowers,C,NJD,25,8,2,0,2
51,8482153,Brendan Brisson,C,VGK,23,21,1,1,2
51,8482172,Landon Slaggert,L,CHI,22,30,1,1,2
51,8480267,Sammy Walker,C,MIN,25,19,1,1,2
51,8482088,Justin Sourdif,R,FLA,22,21,1,1,2
51,8477073,Kurtis MacDermid,L,NJD,30,30,1,1,2
51,8481699,Aku Raty,R,UTA,23,13,1,1,2
51,8477541,Dakota Mermis,D,TOR,30,9,1,1,2
51,8475780,Chris Wagner,R,COL,33,12,1,1,2
51,8481655,Cole Schwindt,R,CGY,23,4,1,1,2
51,8477320,Anton Blidh,L,NYR,29,18,1,1,2
51,8481024,Linus Karlsson,C,VAN,25,11,1,1,2
51,8478854,Ryan Shea,D,PIT,27,12,1,1,2
51,8484258,Sam Malinski,D,COL,26,20,0,2,2
51,8478146,Matthew Highmore,C,OTT,28,32,0,2,2
51,8479367,William Lockwood,R,FLA,26,23,0,2,2
51,8475958,Michael Sgarbossa,C,WSH,32,28,0,2,2
51,8478021,William Lagesson,D,DET,28,27,0,2,2
51,8481743,Marc Del Gaizo,D,NSH,25,18,0,2,2
51,8482126,Emil Andrae,D,PHI,31,3,0,2,2
51,8479522,Hardy Haman Aktell,D,WSH,26,4,0,2,2
51,8481789,Tye Kartye,L,SEA,23,39,1,0,1
51,8478446,Glenn Gawdin,C,LAK,27,11,1,0,1
51,8480084,Nick DeSimone,D,NJD,30,11,1,0,1
51,8483597,Milos Kelemen,L,UTA,25,13,1,0,1
51,8482460,Matt Rempe,C,NYR,22,16,1,0,1
51,8481422,Jake Lucchini,C,NSH,29,13,1,0,1
51,8483567,Georgii Merkulov,C,BOS,24,10,1,0,1
51,8482118,Sam Colangelo,R,ANA,23,15,1,0,1
51,8478147,Bokondji Imama,L,PIT,28,4,1,0,1
51,8481726,Adam Edstrom,C,NYR,24,5,1,0,1
51,8478881,Brett Seney,L,CHI,28,10,1,0,1
51,8482476,Emil Heineman,L,MTL,23,6,1,0,1
51,8483920,Pierrick Dube,R,WSH,23,5,1,0,1
51,8476913,Devin Shore,C,MIN,30,36,0,1,1
51,8483512,Matthew Savoie,C,EDM,20,22,0,1,1
51,8479419,Brett Murray,L,BUF,26,20,0,1,1
51,8479985,Cale Fleury,D,SEA,26,27,0,1,1
51,8474062,Riley Nash,C,NYR,35,16,0,1,1
51,8482858,Ryker Evans,D,SEA,23,21,0,1,1
51,8479362,Riley Tufte,L,BOS,26,23,0,1,1
51,8480874,Adam Ginning,D,PHI,24,4,0,1,1
51,8483471,Brad Lambert,C,WPG,31,8,0,1,1
51,8479421,Jacob Moverare,D,LAK,26,7,0,1,1
51,8482470,Ilya Solovyov,D,CGY,24,18,0,1,1
51,8481719,Maxwell Crozier,D,TBL,24,7,0,1,1
51,8482197,Adam Raska,R,MIN,23,10,0,1,1
51,8475755,Alexander Petrovic,D,DAL,32,14,0,1,1
51,8475413,Justin Dowling,C,NJD,34,10,0,1,1
51,8483398,Declan Carlile,D,TBL,31,8,0,1,1
51,8481806,Louis Crevier,D,CHI,23,13,0,1,1
51,8480306,Grant Hutton,D,NYI,29,5,0,1,1
51,8483546,Marshall Rifai,D,TOR,26,3,0,1,1
51,8483401,Marc Johnstone,R,PIT,28,1,0,1,1
51,8478051,Max Willman,C,NJD,29,15,0,0,0
51,8481585,Egor Afanasyev,L,SJS,23,9,0,0,0
51,8481462,Mason Morelli,L,VGK,28,15,0,0,0
51,8480075,Cameron Crotty,D,MIN,25,7,0,0,0
51,8482061,Brandon Biro,L,SEA,26,9,0,0,0
51,8482787,Nikita Chibrikov,R,WPG,31,4,0,0,0
51,8482162,Roby Jarventie,L,EDM,22,14,0,0,0
51,8477149,Scott Sabourin,R,SJS,32,18,0,0,0
51,8481578,Graeme Clarke,R,MIN,23,8,0,0,0
51,8479330,Brandon Gignac,C,MTL,27,9,0,0,0
51,8481065,Angus Crookshank,L,OTT,25,19,0,0,0
51,8481043,Cole Koepke,L,BOS,26,16,0,0,0
51,8484255,Jason Polin,R,COL,25,7,0,0,0
51,8484321,Nikolas Matinpalo,D,OTT,26,3,0,0,0
51,8481206,John Ludvig,D,PIT,24,9,0,0,0
51,8481534,Raphael Lavoie,C,EDM,24,3,0,0,0
51,8483407,Brandon Scanlin,D,NYR,25,7,0,0,0
51,8484326,Patrik Koch,D,UTA,28,0,0,0,0
51,8483531,Brian Halonen,L,NJD,25,4,0,0,0
51,8476323,Max McCormick,L,SEA,32,2,0,0,0
51,8483489,Fraser Minten,C,TOR,31,10,0,0,0
51,8483432,Luca Del Bel Belluz,C,CBJ,31,5,0,0,0
51,8484259,Ondrej Pavel,C,COL,31,3,0,0,0
51,8477993,Justin Kirkland,C,CGY,28,3,0,0,0
51,8483609,Adam Klapka,R,CGY,24,4,0,0,0
51,8480274,Philip Kemp,D,EDM,25,1,0,0,0
51,8470794,Joe Pavelski,C,,40,0,0,0,0
51,8479321,Lucas Johansen,D,,27,0,0,0,0
51,8477950,Tony DeAngelo,D,,29,0,0,0,0
51,8471218,Blake Wheeler,R,,38,0,0,0,0
51,8475197,Tyson Barrie,D,,33,0,0,0,0
51,8474157,Max Pacioretty,L,,36,0,0,0,0
51,8475744,Evgeny Kuznetsov,C,,32,0,0,0,0
51,8474037,James van Riemsdyk,L,,35,0,0,0,0
51,8476907,Mackenzie MacEachern,L,,30,0,0,0,0
51,8480216,Jacob Peterson,C,,25,0,0,0,0
51,8474602,Justin Schultz,D,,34,0,0,0,0
51,8482222,Alexander Barabanov,L,,30,0,0,0,0
51,8474031,Kevin Shattenkirk,D,,35,0,0,0,0
51,8477330,Dominik Kubalik,L,,29,0,0,0,0
51,8480884,Calen Addison,D,,24,0,0,0,0
51,8475906,John Klingberg,D,,32,0,0,0,0
51,8480008,Adam Ruzicka,C,,25,0,0,0,0
51,8476884,Derrick Pouliot,D,,30,0,0,0,0
51,8476919,Chris Tierney,C,,30,0,0,0,0
51,8479415,Michael McLeod,C,,26,0,0,0,0
51,8474870,Tyler Johnson,C,,34,0,0,0,0
51,8470604,Jeff Carter,C,,39,0,0,0,0
51,8478104,Sammy Blais,L,,28,0,0,0,0
51,8474884,Mike Hoffman,C,,35,0,0,0,0
51,8481591,Sam Poulin,R,,23,0,0,0,0
51,8471274,Alex Goligoski,D,,39,0,0,0,0
51,8476871,Tanner Pearson,L,,32,0,0,0,0
51,8476393,Nick Cousins,C,,31,0,0,0,0
51,8479977,Kailer Yamamoto,R,,26,0,0,0,0
51,8479346,Dillon Dube,C,,26,0,0,0,0
51,8480184,Gustav Lindstrom,D,,26,0,0,0,0
51,8479376,Victor Mete,D,,26,0,0,0,0
51,8473449,Kyle Okposo,R,,36,0,0,0,0
51,8481058,Jesse Ylonen,R,,25,0,0,0,0
51,8475752,Tyler Pitlick,C,,33,0,0,0,0
51,8481239,Samuel Fagemo,L,,24,0,0,0,0
51,8480821,Filip Zadina,R,,25,0,0,0,0
51,8470966,Mark Giordano,D,,41,0,0,0,0
51,8478495,Denis Gurianov,R,,27,0,0,0,0
51,8477464,Nic Petan,C,,29,0,0,0,0
51,8478099,Kevin Labanc,R,,29,0,0,0,0
51,8482241,Radim Zohorna,L,,28,0,0,0,0
51,8474040,Sam Gagner,C,,35,0,0,0,0
51,8479514,Rem Pitlick,C,,27,0,0,0,0
51,8478430,Oliver Kylington,D,,27,0,0,0,0
51,8479533,Joona Koppanen,L,,26,0,0,0,0
51,8479984,Cal Foote,D,,26,0,0,0,0
51,8477126,Jayson Megna,C,,34,0,0,0,0
51,8475164,Jakob Silfverberg,R,,34,0,0,0,0
51,8474009,Nick Bonino,C,,36,0,0,0,0
51,8479458,Nikita Zaitsev,D,,33,0,0,0,0
51,8477944,Jakub Vrana,L,,28,0,0,0,0
51,8471699,Andrew Cogliano,C,,37,0,0,0,0
51,8478067,Oskar Lindblom,L,,28,0,0,0,0
51,8471686,Marc Staal,D,,37,0,0,0,0
51,8470610,Zach Parise,L,,40,0,0,0,0
51,8478904,Steven Lorentz,C,,28,0,0,0,0
51,8473473,Milan Lucic,L,,36,0,0,0,0
51,8480031,Maxime Comtois,L,,25,0,0,0,0
51,8478512,Austin Czarnik,C,,32,0,0,0,0
51,8473504,Cal Clutterbuck,R,,37,0,0,0,0
51,8477454,Adam Erne,L,,29,0,0,0,0
51,8479383,Boris Katchouk,L,,26,0,0,0,0
51,8475825,Jani Hakanpää,D,,32,0,0,0,0
51,8477846,Ryan Carpenter,C,,33,0,0,0,0
51,8477930,Pierre-Edouard Bellemare,L,,39,0,0,0,0
51,8478400,Colin White,C,,27,0,0,0,0
51,8480226,Marián Studenic,R,,26,0,0,0,0
51,8480853,Liam Foudy,C,,24,0,0,0,0
51,8475797,Jarred Tinordi,D,,32,0,0,0,0
51,8479423,Alex Nylander,L,,26,0,0,0,0
51,8474618,Marco Scandella,D,,34,0,0,0,0
51,8478028,Fredrik Olofsson,L,,28,0,0,0,0
51,8474709,Matt Martin,L,,35,0,0,0,0
51,8481070,Hugh McGing,L,,26,0,0,0,0
51,8479546,Oskar Steen,C,,26,0,0,0,0
51,8474145,Robert Bortuzzo,D,,35,0,0,0,0
51,8476915,Jujhar Khaira,L,,30,0,0,0,0
51,8475278,Byron Froese,C,,33,0,0,0,0
51,8481812,Nikolai Knyzhov,D,,27,0,0,0,0
51,8478408,Travis Dermott,D,,28,0,0,0,0
51,8481077,John Leonard,L,,26,0,0,0,0
51,8479547,Matthew Phillips,R,,26,0,0,0,0
51,8480836,Jonathan Gruden,C,,24,0,0,0,0
51,8481690,Tyler Angle,C,,24,0,0,0,0
51,8475766,Austin Watson,L,,32,0,0,0,0
51,8481016,Ruslan Iskhakov,C,,24,0,0,0,0
51,8478078,Rourke Chartier,C,,28,0,0,0,0
51,8480776,Sheldon Rempal,R,,29,0,0,0,0
51,8478956,Samuel Laberge,L,NJD,27,0,0,0,0
51,8483045,Cameron Butler,R,CBJ,31,1,0,0,0
51,8484314,Jiri Smejkal,L,,28,0,0,0,0
52,8478402,Connor McDavid,C,EDM,27,81,39,95,134
52,8478483,Mitch Marner,R,TOR,27,79,34,100,134
52,8481559,Jack Hughes,C,NJD,23,82,49,84,133
52,8479318,Auston Matthews,C,TOR,27,81,74,55,129
52,8477492,Nathan MacKinnon,C,COL,29,80,42,79,121
52,8477939,William Nylander,R,TOR,28,80,45,67,112
52,8477956,David Pastrnak,R,BOS,28,79,56,55,111
52,8476453,Nikita Kucherov,R,TBL,31,82,40,68,108
52,8478420,Mikko Rantanen,R,COL,28,80,55,52,107
52,8477934,Leon Draisaitl,C,EDM,29,78,38,64,102
52,8476468,J.T. Miller,C,VAN,31,73,38,64,102
52,8476887,Filip Forsberg,L,NSH,30,79,48,53,101
52,8477404,Jake Guentzel,C,TBL,30,82,41,60,101
52,8480027,Jason Robertson,L,DAL,25,82,40,61,101
52,8479314,Matthew Tkachuk,L,FLA,27,80,29,70,99
52,8480012,Elias Pettersson,C,VAN,26,78,33,65,98
52,8479407,Jesper Bratt,L,NJD,26,78,32,62,94
52,8478550,Artemi Panarin,L,NYR,33,79,25,69,94
52,8480800,Quinn Hughes,D,VAN,25,72,13,80,93
52,8478864,Kirill Kaprizov,L,MIN,27,76,44,48,92
52,8477946,Dylan Larkin,C,DET,28,82,40,52,92
52,8477933,Sam Reinhart,C,FLA,29,79,47,44,91
52,8471675,Sidney Crosby,C,PIT,37,77,36,54,90
52,8476459,Mika Zibanejad,C,NYR,31,75,36,53,89
52,8477409,Carter Verhaeghe,C,FLA,29,79,51,37,88
52,8476346,Johnny Gaudreau,L,CBJ,31,69,21,66,87
52,8478010,Brayden Point,C,TBL,28,81,48,37,85
52,8477942,Kevin Fiala,L,LAK,28,79,31,54,85
52,8477493,Aleksander Barkov,C,FLA,29,76,19,66,85
52,8481557,Matt Boldy,L,MIN,23,71,40,44,84
52,8475166,John Tavares,C,TOR,34,79,35,49,84
52,8478439,Travis Konecny,R,PHI,27,75,33,51,84
52,8480801,Brady Tkachuk,L,OTT,25,79,39,44,83
52,8479343,Clayton Keller,R,UTA,26,77,37,45,82
52,8475172,Nazem Kadri,C,CGY,34,81,33,47,80
52,8476454,Ryan Nugent-Hopkins,C,EDM,31,79,25,55,80
52,8476460,Mark Scheifele,C,WPG,31,75,31,48,79
52,8471685,Anze Kopitar,C,LAK,37,80,29,49,78
52,8482116,Tim Stützle,C,OTT,22,77,28,50,78
52,8475167,Victor Hedman,D,TBL,34,81,9,69,78
52,8477501,Valeri Nichushkin,R,COL,29,82,40,37,77
52,8475184,Chris Kreider,L,NYR,33,78,39,38,77
52,8480002,Nico Hischier,C,NJD,25,73,36,41,77
52,8479337,Alex DeBrincat,R,DET,27,80,25,52,77
52,8478444,Brock Boeser,R,VAN,27,73,28,48,76
52,8480069,Cale Makar,D,COL,26,68,24,52,76
52,8480036,Miro Heiskanen,D,DAL,25,77,14,62,76
52,8476539,Jonathan Marchessault,R,NSH,34,68,36,39,75
52,8477955,Jared McCann,L,SEA,28,76,41,33,74
52,8479420,Tage Thompson,C,BUF,27,72,37,37,74
52,8480208,Drake Batherson,R,OTT,26,80,34,40,74
52,8484144,Connor Bedard,C,CHI,19,64,33,41,74
52,8478427,Sebastian Aho,C,CAR,27,66,32,42,74
52,8474564,Steven Stamkos,C,NSH,34,76,30,44,74
52,8478414,Timo Meier,R,NJD,28,77,32,41,73
52,8478401,Pavel Zacha,C,BOS,27,81,31,42,73
52,8474600,Roman Josi,D,NSH,34,77,18,55,73
52,8478398,Kyle Connor,L,WPG,28,73,31,41,72
52,8478445,Mathew Barzal,C,NYI,27,81,18,54,72
52,8478449,Roope Hintz,C,DAL,28,80,36,35,71
52,8481528,Dylan Cozens,C,BUF,23,69,24,47,71
52,8480023,Robert Thomas,C,STL,25,78,20,51,71
52,8478403,Jack Eichel,C,VGK,28,78,40,30,70
52,8480018,Nick Suzuki,C,MTL,25,81,27,43,70
52,8477497,Sean Monahan,C,CBJ,30,68,26,42,68
52,8477986,Brandon Montour,D,SEA,30,77,22,46,68
52,8480865,Noah Dobson,D,NYI,24,78,9,59,68
52,8477476,Artturi Lehkonen,L,COL,29,81,31,36,67
52,8474141,Patrick Kane,R,DET,36,79,29,38,67
52,8473419,Brad Marchand,L,BOS,36,80,24,43,67
52,8477496,Elias Lindholm,C,BOS,30,81,21,46,67
52,8477402,Pavel Buchnevich,L,STL,29,72,25,41,66
52,8477951,Nick Schmaltz,C,UTA,28,77,23,43,66
52,8474679,Gustav Nyquist,C,NSH,35,73,22,44,66
52,8479323,Adam Fox,D,NYR,26,75,13,53,66
52,8477940,Nikolaj Ehlers,L,WPG,28,73,26,39,65
52,8471215,Evgeni Malkin,C,PIT,38,72,24,41,65
52,8482720,Matthew Knies,L,TOR,22,79,22,43,65
52,8471214,Alex Ovechkin,L,WSH,39,73,29,35,64
52,8476448,William Karlsson,C,VGK,31,79,24,40,64
52,8477960,Adrian Kempe,R,LAK,28,78,23,41,64
52,8475913,Mark Stone,R,VGK,32,79,21,43,64
52,8476456,Jonathan Huberdeau,C,CGY,31,79,18,46,64
52,8475692,Mats Zuccarello,R,MIN,37,74,17,47,64
52,8479325,Charlie McAvoy,D,BOS,27,72,12,52,64
52,8479542,Brandon Hagel,L,TBL,26,81,26,37,63
52,8478407,Vince Dunn,D,SEA,28,74,16,47,63
52,8480803,Evan Bouchard,D,EDM,25,67,14,49,63
52,8479675,Trevor Moore,L,LAK,29,81,33,29,62
52,8476881,Tomas Hertl,C,VGK,31,78,17,45,62
52,8475158,Ryan O'Reilly,C,NSH,33,73,17,44,61
52,8475798,Mikael Granlund,C,SJS,32,73,17,44,61
52,8478047,Michael Bunting,L,PIT,29,71,17,44,61
52,8480839,Rasmus Dahlin,D,BUF,24,68,11,50,61
52,8476389,Vincent Trocheck,C,NYR,31,76,31,29,60
52,8478519,Anthony Cirelli,C,TBL,27,81,24,36,60
52,8479999,Casey Mittelstadt,C,COL,26,79,20,40,60
52,8475745,Charlie Coyle,C,BOS,32,78,19,41,60
52,8480830,Andrei Svechnikov,R,CAR,24,68,22,37,59
52,8473512,Claude Giroux,R,OTT,36,77,20,39,59
52,8475784,Jeff Skinner,C,EDM,32,76,33,25,58
52,8479385,Jordan Kyrou,C,STL,26,71,26,32,58
52,8473994,Jamie Benn,L,DAL,35,81,23,35,58
52,8482113,Anton Lundell,C,FLA,23,77,17,41,58
52,8475754,Brock Nelson,C,NYI,33,79,29,28,57
52,8482093,Seth Jarvis,C,CAR,22,64,28,29,57
52,8477500,Bo Horvat,C,NYI,29,81,24,33,57
52,8477416,Oliver Bjorkstrand,R,SEA,29,67,24,33,57
52,8475168,Matt Duchene,C,DAL,33,81,22,35,57
52,8475786,Zach Hyman,L,EDM,32,78,32,24,56
52,8482740,Wyatt Johnston,C,DAL,21,80,31,25,56
52,8478493,Joel Eriksson Ek,C,MIN,27,71,29,27,56
52,8475810,Bryan Rust,R,PIT,32,75,29,27,56
52,8481540,Cole Caufield,R,MTL,23,78,27,29,56
52,8474641,Adam Henrique,C,EDM,34,77,26,30,56
52,8483808,Andrei Kuzmenko,L,CGY,28,77,22,34,56
52,8474586,Jordan Eberle,R,SEA,34,72,18,38,56
52,8478460,Zach Werenski,D,CBJ,27,81,10,46,56
52,8475768,Jaden Schwartz,C,SEA,32,69,26,29,55
52,8480015,Owen Tippett,R,PHI,25,73,24,31,55
52,8482124,Quinton Byfield,R,LAK,22,81,22,33,55
52,8479400,Pierre-Luc Dubois,L,WSH,26,71,21,34,55
52,8476872,Scott Laughton,C,PHI,30,78,21,34,55
52,8477494,Jonathan Drouin,L,COL,29,82,20,35,55
52,8478873,Troy Terry,R,ANA,27,72,16,39,55
52,8477447,Shea Theodore,D,VGK,29,61,14,41,55
52,8476853,Morgan Rielly,D,TOR,30,75,9,46,55
52,8477504,Josh Morrissey,D,WPG,29,77,5,50,55
52,8477949,Alex Tuch,R,BUF,28,71,21,33,54
52,8482110,Dawson Mercer,C,NJD,23,73,21,33,54
52,8482745,Mason McTavish,C,ANA,21,71,17,37,54
52,8482078,Lucas Raymond,L,DET,22,81,23,30,53
52,8475765,Vladimir Tarasenko,R,DET,33,80,23,30,53
52,8484145,Zach Benson,L,BUF,19,75,22,31,53
52,8478397,Rasmus Andersson,D,CGY,28,73,9,44,53
52,8476906,Shayne Gostisbehere,D,CAR,31,74,9,44,53
52,8476875,Mike Matheson,D,MTL,30,75,8,45,53
52,8474102,David Perron,L,OTT,36,79,19,33,52
52,8478440,Dylan Strome,C,WSH,27,69,17,35,52
52,8476869,Brady Skjei,D,NSH,30,75,14,38,52
52,8476462,Dougie Hamilton,D,NJD,31,72,13,39,52
52,8480014,Gabriel Vilardi,C,WPG,25,68,31,20,51
52,8476399,Blake Coleman,C,CGY,33,78,29,22,51
52,8484153,Leo Carlsson,C,ANA,20,74,18,33,51
52,8476905,Chandler Stephenson,C,SEA,30,75,14,37,51
52,8483431,Logan Cooley,C,UTA,20,74,26,24,50
52,8482149,Cole Perfetti,C,WPG,22,68,22,28,50
52,8483515,Juraj Slafkovsky,L,MTL,20,69,21,29,50
52,8479591,Michael Eyssimont,C,TBL,28,80,20,30,50
52,8477426,Nicholas Paul,L,TBL,29,82,30,19,49
52,8476921,Jordan Martinook,L,CAR,32,73,24,25,49
52,8476483,Rickard Rakell,R,PIT,31,71,23,26,49
52,8482665,Matty Beniers,C,SEA,22,77,20,29,49
52,8480039,Martin Necas,C,CAR,25,67,17,32,49
52,8477503,Max Domi,C,TOR,29,78,17,32,49
52,8478038,Devon Toews,D,COL,30,73,5,44,49
52,8478466,Daniel Sprong,R,VAN,27,69,26,22,48
52,8478975,Mason Marchment,L,DAL,29,80,17,31,48
52,8478115,Pierre Engvall,L,NYI,28,72,17,31,48
52,8477932,Aaron Ekblad,D,FLA,28,72,10,38,48
52,8482684,Luke Hughes,D,NJD,21,72,6,42,48
52,8475170,Brayden Schenn,C,STL,33,74,25,22,47
52,8482702,Logan Stankoven,C,DAL,21,78,24,23,47
52,8475794,Tyler Seguin,C,DAL,32,80,23,24,47
52,8476479,Phillip Danault,C,LAK,31,80,18,29,47
52,8480220,Noah Cates,L,PHI,25,74,17,30,47
52,8474578,Erik Karlsson,D,PIT,34,80,12,35,47
52,8481581,Thomas Harley,D,DAL,23,76,10,37,47
52,8482712,Oskar Olausson,R,COL,22,75,9,38,47
52,8474150,Mikael Backlund,C,CGY,35,79,24,22,46
52,8473986,Alex Killorn,L,ANA,35,76,18,28,46
52,8476432,Boone Jenner,C,CBJ,31,71,27,18,45
52,8475726,Tyler Toffoli,C,SJS,32,62,24,21,45
52,8477998,Warren Foegele,L,LAK,28,82,22,23,45
52,8477429,Andrew Copp,C,DET,30,78,16,29,45
52,8478042,Viktor Arvidsson,L,EDM,31,75,15,30,45
52,8475218,Mattias Ekholm,D,EDM,34,77,15,30,45
52,8476792,Torey Krug,D,STL,33,75,10,35,45
52,8475169,Evander Kane,L,EDM,33,70,27,17,44
52,8481068,Yegor Sharangovich,C,CGY,26,78,25,19,44
52,8482109,Alexis Lafrenière,L,NYR,23,74,21,23,44
52,8478542,Evan Rodrigues,C,FLA,31,76,15,29,44
52,8477511,Anthony Mantha,R,CGY,30,76,14,30,44
52,8480893,Kirill Marchenko,R,CBJ,24,61,26,17,43
52,8481618,Alex Newhook,C,MTL,23,72,23,20,43
52,8477407,Anthony Duclair,L,NYI,29,76,21,22,43
52,8475151,Kyle Palmieri,C,NYI,33,78,20,23,43
52,8482159,Tyson Foerster,R,PHI,22,70,20,23,43
52,8481596,Shane Pinto,C,OTT,24,79,19,24,43
52,8477456,J.T. Compher,L,DET,29,79,18,25,43
52,8480185,Eetu Luostarinen,C,FLA,26,77,18,25,43
52,8476882,Teuvo Teravainen,C,CHI,30,66,18,25,43
52,8478498,Jake DeBrusk,L,VAN,28,76,16,27,43
52,8480798,Philipp Kurashev,C,CHI,25,71,16,27,43
52,8475287,Erik Haula,L,NJD,33,75,16,27,43
52,8477948,Travis Sanheim,D,PHI,28,74,11,32,43
52,8470613,Brent Burns,D,CAR,39,72,10,33,43
52,8478469,Thomas Chabot,D,OTT,27,76,9,34,43
52,8477346,MacKenzie Weegar,D,CGY,30,71,8,35,43
52,8474563,Drew Doughty,D,LAK,35,74,8,35,43
52,8481542,Moritz Seider,D,DET,23,76,8,35,43
52,8482105,Jake Sanderson,D,OTT,22,75,8,35,43
52,8482667,William Eklund,L,SJS,22,67,24,18,42
52,8476880,Tom Wilson,R,WSH,30,74,23,19,42
52,8482146,Luke Evangelista,R,NSH,22,68,23,19,42
52,8482699,Dylan Guenther,R,UTA,21,77,20,22,42
52,8477935,Sam Bennett,C,FLA,28,80,19,23,42
52,8480028,Morgan Frost,C,PHI,25,78,16,26,42
52,8480871,Adam Boqvist,D,FLA,24,69,16,26,42
52,8476927,Teddy Blueger,C,VAN,30,74,14,28,42
52,8480336,Sean Walker,D,CAR,30,77,14,28,42
52,8471724,Kris Letang,D,PIT,37,79,10,32,42
52,8476923,Damon Severson,D,CBJ,30,80,5,37,42
52,8478366,Frank Vatrano,R,ANA,30,76,24,17,41
52,8475763,Kevin Hayes,R,PIT,32,68,19,22,41
52,8471698,T.J. Oshie,R,WSH,38,66,18,23,41
52,8478233,Andrew Mangiapane,L,WSH,28,69,17,24,41
52,8481560,Arthur Kaliyev,R,LAK,23,78,15,26,41
52,8474565,Alex Pietrangelo,D,VGK,34,65,14,27,41
52,8477495,Seth Jones,D,CHI,30,68,8,33,41
52,8479365,Trent Frederic,C,BOS,26,77,19,21,40
52,8479987,Morgan Geekie,C,BOS,26,78,18,22,40
52,8480064,Josh Norris,C,OTT,25,79,14,26,40
52,8482097,Jack Quinn,R,BUF,23,73,13,27,40
52,8476826,Yanni Gourde,C,SEA,33,71,13,27,40
52,8476458,Ryan Strome,C,ANA,31,72,10,30,40
52,8480434,Sean Durzi,D,UTA,26,67,10,30,40
52,8481711,Matias Maccelli,L,UTA,24,72,9,31,40
52,8475764,Cam Fowler,D,ANA,33,73,7,33,40
52,8481533,Trevor Zegras,C,ANA,23,73,22,17,39
52,8475722,Jason Zucker,L,BUF,32,68,21,18,39
52,8479525,Ross Colton,C,COL,28,79,19,20,39
52,8482705,Cole Sillinger,C,CBJ,21,68,18,21,39
52,8480188,Fabian Zetterlund,L,SJS,25,67,18,21,39
52,8477444,Andre Burakovsky,L,SEA,29,65,12,27,39
52,8476463,Jonas Brodin,D,MIN,31,77,4,35,39
52,8477479,Tyler Bertuzzi,L,CHI,29,62,21,17,38
52,8475314,Anders Lee,L,NYI,34,75,19,19,38
52,8475848,Brendan Gallagher,R,MTL,32,74,14,24,38
52,8475753,Justin Faulk,D,STL,32,72,8,30,38
52,8482133,Thomas Bordeleau,C,SJS,22,62,5,33,38
52,8475714,Calle Jarnkrok,C,TOR,33,74,16,21,37
52,8481524,Bowen Byram,D,BUF,23,65,16,21,37
52,8478462,Nicolas Roy,C,VGK,27,74,14,23,37
52,8482660,Kent Johnson,C,CBJ,22,65,12,25,37
52,8477952,Robby Fabbri,C,ANA,28,67,23,13,36
52,8480849,Barrett Hayton,C,UTA,24,73,19,17,36
52,8482475,Yegor Chinakhov,R,CBJ,23,61,19,17,36
52,8477964,Ivan Barbashev,C,VGK,29,75,16,20,36
52,8479992,Michael Rasmussen,C,DET,25,81,15,21,36
52,8475793,Ryan Johansen,C,PHI,32,73,14,22,36
52,8479345,Jakob Chychrun,D,WSH,26,63,14,22,36
52,8475191,Reilly Smith,R,NYR,33,71,13,23,36
52,8477450,Jason Dickinson,C,CHI,29,63,11,25,36
52,8482101,Danil Gushchin,L,SJS,22,61,10,26,36
52,8481523,Kirby Dach,C,MTL,23,64,9,27,36
52,8476854,Hampus Lindholm,D,BOS,30,73,7,29,36
52,8476958,Jaccob Slavin,D,CAR,30,74,5,31,36
52,8482122,Brock Faber,D,MIN,22,76,4,32,36
52,8474053,Logan Couture,C,SJS,35,65,16,19,35
52,8478458,John (Jack) Roslovic,C,CAR,27,62,15,20,35
52,8479339,Patrik Laine,L,CBJ,26,62,13,22,35
52,8478438,Tommy Novak,C,NSH,27,67,12,23,35
52,8479390,Taylor Raddysh,R,WSH,26,64,11,24,35
52,8477498,Darnell Nurse,D,EDM,29,73,9,26,35
52,8474590,John Carlson,D,WSH,34,62,8,27,35
52,8477451,Ryan Hartman,R,MIN,30,75,6,29,35
52,8474149,Evgenii Dadonov,R,DAL,35,78,21,13,34
52,8482175,JJ Peterka,R,BUF,22,67,18,16,34
52,8480113,Alex Iafallo,L,WPG,31,69,17,17,34
52,8476981,Josh Anderson,R,MTL,30,74,17,17,34
52,8478474,Lawson Crouse,L,UTA,27,75,14,20,34
52,8481546,Cam York,D,PHI,23,70,13,21,34
52,8477021,Alex Kerfoot,C,UTA,30,74,2,32,34
52,8470621,Corey Perry,R,EDM,39,71,20,13,33
52,8484166,Adam Fantilli,C,CBJ,20,63,17,16,33
52,8481186,Logan O'Connor,R,COL,28,80,16,17,33
52,8480009,Eeli Tolvanen,R,SEA,25,69,13,20,33
52,8477919,Frederick Gaudreau,C,MIN,31,60,13,20,33
52,8483505,Matthew Poitras,C,BOS,20,74,12,21,33
52,8478396,Noah Hanifin,D,VGK,27,66,10,23,33
52,8479353,Brett Howden,C,VGK,26,68,9,24,33
52,8481577,Philip Tomasino,C,NSH,23,69,7,26,33
52,8477506,Ryan Pulock,D,NYI,30,77,4,29,33
52,8475799,Nino Niederreiter,R,WPG,32,67,21,11,32
52,8475760,Nick Bjugstad,C,UTA,32,72,19,13,32
52,8482125,Alexander Holtz,R,VGK,22,72,19,13,32
52,8481580,Connor McMichael,C,WSH,23,65,18,14,32
52,8478472,Mathieu Joseph,R,STL,27,66,13,19,32
52,8478055,Gustav Forsling,D,FLA,28,69,12,20,32
52,8476979,Erik Gustafsson,D,DET,32,74,7,25,32
52,8482671,Owen Power,D,BUF,22,66,6,26,32
52,8480817,K'Andre Miller,D,NYR,24,62,6,26,32
52,8478057,Dakota Joshua,C,VAN,28,67,21,10,31
52,8480748,Kiefer Sherwood,L,VAN,29,61,18,13,31
52,8480813,Joe Veleno,C,DET,24,79,16,15,31
52,8477989,Christian Dvorak,C,MTL,28,62,16,15,31
52,8475149,Marcus Johansson,L,MIN,34,66,13,18,31
52,8478856,Conor Garland,R,VAN,28,66,12,19,31
52,8477839,Conor Sheary,L,TBL,32,80,12,19,31
52,8479661,Tanner Jeannot,L,LAK,27,75,11,20,31
52,8477505,Alexander Wennberg,C,SJS,30,63,10,21,31
52,8476885,Jacob Trouba,D,NYR,30,73,9,22,31
52,8480802,Ryan McLeod,C,BUF,25,64,8,23,31
52,8479402,Jake Bean,D,CGY,26,71,5,26,31
52,8476438,Brandon Saad,L,STL,32,68,18,12,30
52,8476419,Jean-Gabriel Pageau,C,NYI,32,76,14,16,30
52,8482092,Ridly Greig,C,OTT,22,77,13,17,30
52,8476292,Ondrej Palat,L,NJD,33,64,13,17,30
52,8480835,Jack Drury,C,CAR,24,62,13,17,30
52,8476461,Sean Couturier,C,PHI,32,67,13,17,30
52,8484203,Bradly Nadeau,L,CAR,19,63,12,18,30
52,8476392,Adam Lowry,C,WPG,31,64,11,19,30
52,8480797,Joel Farabee,L,PHI,24,70,10,20,30
52,8475200,Dmitry Orlov,D,CAR,33,76,10,20,30
52,8479315,Joey Anderson,R,CHI,26,62,9,21,30
52,8478046,Danton Heinen,L,VAN,29,69,17,12,29
52,8477987,Ryan Donato,C,CHI,28,67,17,12,29
52,8476918,Jimmy Vesey,L,NYR,31,62,16,13,29
52,8483445,Cutter Gauthier,L,ANA,20,57,12,17,29
52,8477478,William Carrier,L,CAR,30,56,11,18,29
52,8482749,Joshua Roy,R,MTL,21,61,10,19,29
52,8476457,Adam Larsson,D,SEA,32,63,8,21,29
52,8480145,Neal Pionk,D,WPG,29,74,7,22,29
52,8481521,Ronnie Attard,D,PHI,25,60,6,23,29
52,8482192,Isaak Phillips,D,CHI,23,59,6,23,29
52,8479425,Filip Hronek,D,VAN,27,69,4,25,29
52,8475171,Oliver Ekman-Larsson,D,TOR,33,68,3,26,29
52,8481656,Aliaksei Protas,C,WSH,23,62,14,14,28
52,8480762,Eric Robinson,L,CAR,29,62,14,14,28
52,8478413,Jordan Greenway,L,BUF,27,58,13,15,28
52,8478463,Anthony Beauvillier,L,PIT,27,65,13,15,28
52,8478891,Mason Appleton,C,WPG,28,61,13,15,28
52,8477953,Kasperi Kapanen,R,STL,28,67,13,15,28
52,8481553,Bobby Brink,R,PHI,23,64,12,16,28
52,8480789,Oliver Wahlstrom,R,NYI,24,73,12,16,28
52,8476897,Oskar Sundqvist,C,STL,30,61,12,16,28
52,8481604,Pavel Dorofeyev,L,VGK,24,71,11,17,28
52,8473422,Nick Foligno,L,CHI,37,60,10,18,28
52,8480043,Timothy Liljegren,D,TOR,25,67,5,23,28
52,8477969,Marcus Pettersson,D,PIT,28,77,3,25,28
52,8477947,Sonny Milano,L,WSH,28,64,16,11,27
52,8474715,Cameron Atkinson,R,TBL,35,79,15,12,27
52,8477425,Miles Wood,L,COL,29,82,14,13,27
52,8480068,Ryan Poehling,C,PHI,25,66,14,13,27
52,8481093,Rafael Harvey-Pinard,L,MTL,25,63,14,13,27
52,8478109,Victor Olofsson,L,VGK,29,67,13,14,27
52,8476480,Vladislav Namestnikov,C,WPG,32,70,9,18,27
52,8473533,Jordan Staal,C,CAR,36,64,9,18,27
52,8482809,Jackson Blake,R,CAR,21,63,6,21,27
52,8480829,Jesperi Kotkaniemi,C,CAR,24,66,14,12,26
52,8476278,Colin Blackwell,C,DAL,31,75,14,12,26
52,8480995,Pontus Holmberg,R,TOR,25,58,13,13,26
52,8475220,Marcus Foligno,L,MIN,33,62,13,13,26
52,8480855,Jack McBain,C,UTA,24,70,10,16,26
52,8476960,Andreas Athanasiou,C,CHI,30,51,10,16,26
52,8476925,Colton Sissons,C,NSH,31,63,9,17,26
52,8480459,Pius Suter,C,VAN,28,69,8,18,26
52,8480073,Erik Brannstrom,D,COL,25,67,5,21,26
52,8478840,Will Borgen,D,SEA,28,70,5,21,26
52,8478500,Ivan Provorov,D,CBJ,27,79,4,22,26
52,8481582,Nicholas Robertson,L,TOR,23,69,14,11,25
52,8479393,Noah Gregor,L,OTT,26,74,12,13,25
52,8481704,Juuso Parssinen,C,NSH,23,57,10,15,25
52,8474034,Patrick Maroon,L,CHI,36,52,10,15,25
52,8473453,Trevor Lewis,C,LAK,37,71,9,16,25
52,8476474,Stefan Noesen,R,NJD,31,68,8,17,25
52,8479410,Mikhail Sergachev,D,UTA,26,69,2,23,25
52,8479976,Juuso Valimaki,D,UTA,26,64,2,23,25
52,8475791,Taylor Hall,L,CHI,33,51,15,9,24
52,8481535,Nils Hoglander,L,VAN,24,64,14,10,24
52,8474189,Lars Eller,C,PIT,35,65,14,10,24
52,8479293,Brandon Tanev,L,SEA,33,65,12,12,24
52,8483491,Ivan Miroshnichenko,L,WSH,20,57,10,14,24
52,8483482,Tristan Luneau,D,ANA,20,61,9,15,24
52,8482624,Daniil Miromanov,D,CGY,27,62,8,16,24
52,8477488,Brett Pesce,D,NJD,30,72,7,17,24
52,8474574,Tyler Myers,D,VAN,34,68,3,21,24
52,8476892,Colton Parayko,D,STL,31,70,3,21,24
52,8479982,Conor Timmins,D,TOR,26,58,3,21,24
52,8481014,Alexander Romanov,D,NYI,24,79,1,23,24
52,8482062,Cole Smith,L,NSH,29,57,15,8,23
52,8483468,Jiri Kulich,C,BUF,20,67,13,10,23
52,8479368,Max Jones,L,BOS,26,68,12,11,23
52,8482079,Marco Rossi,C,MIN,23,52,11,12,23
52,8475193,Tomas Tatar,L,NJD,34,63,9,14,23
52,8483565,Nick Blankenburg,D,NSH,26,60,9,14,23
52,8483524,Shane Wright,C,SEA,20,63,8,15,23
52,8478970,Jalen Chatfield,D,CAR,28,71,7,16,23
52,8481703,Valtteri Puustinen,R,PIT,25,67,7,16,23
52,8476467,Jamie Oleksiak,D,SEA,32,70,7,16,23
52,8482087,Kaiden Guhle,D,MTL,22,69,7,16,23
52,8479351,Sam Steel,C,DAL,26,82,6,17,23
52,8476422,Mike Reilly,D,NYI,31,75,4,19,23
52,8480246,Nick Perbix,D,TBL,26,75,3,20,23
52,8482655,Janis Moser,D,TBL,24,75,3,20,23
52,8481606,Jordan Spence,D,LAK,23,60,2,21,23
52,8483490,Pavel Mintyukov,D,ANA,21,64,0,23,23
52,8477392,Hudson Fasching,R,NYI,29,65,15,7,22
52,8482055,Drew O'Connor,L,PIT,26,61,14,8,22
52,8475343,Nic Dowd,C,WSH,34,60,13,9,22
52,8475855,Jesper Fast,R,CAR,33,62,11,11,22
52,8480448,Parker Kelly,L,COL,25,73,11,11,22
52,8479316,Luke Kunin,C,SJS,27,55,10,12,22
52,8480003,Jesper Boqvist,C,FLA,26,63,9,13,22
52,8477015,Connor Brown,R,EDM,30,61,9,13,22
52,8480074,Alexandre Texier,C,STL,25,55,9,13,22
52,8481481,Blake Lizotte,C,PIT,27,63,6,16,22
52,8480001,Urho Vaakanainen,D,ANA,25,64,6,16,22
52,8477507,Nikita Zadorov,D,BOS,29,64,5,17,22
52,8475233,David Savard,D,MTL,34,64,5,17,22
52,8478507,John Marino,D,UTA,27,65,4,18,22
52,8476902,Esa Lindell,D,DAL,30,71,4,18,22
52,8482245,Artem Zub,D,OTT,29,69,3,19,22
52,8478882,Vladislav Gavrikov,D,LAK,29,68,3,19,22
52,8474151,Ryan McDonagh,D,TBL,35,76,2,20,22
52,8480873,Rasmus Sandin,D,WSH,24,64,2,20,22
52,8476469,Joel Armia,R,MTL,31,65,15,6,21
52,8482259,Bobby McMann,C,TOR,28,63,13,8,21
52,8478020,Michael Amadio,R,OTT,28,75,12,9,21
52,8478508,Yakov Trenin,C,MIN,27,49,12,9,21
52,8480078,Filip Chytil,C,NYR,25,66,11,10,21
52,8481624,Ilya Mikheyev,R,CHI,30,62,9,12,21
52,8483493,Frank Nazar,C,CHI,20,47,8,13,21
52,8479066,Ryan Lomberg,L,CGY,30,64,8,13,21
52,8483457,Lane Hutson,D,MTL,20,64,7,14,21
52,8482157,Will Cuylle,L,NYR,22,61,7,14,21
52,8473507,Jeff Petry,D,DET,37,67,7,14,21
52,8482142,Jamie Drysdale,D,PHI,22,62,6,15,21
52,8477220,Nate Schmidt,D,FLA,33,73,5,16,21
52,8479639,Dylan Coghlan,D,WPG,26,58,5,16,21
52,8474673,TJ Brodie,D,CHI,34,60,5,16,21
52,8476856,Mathew Dumba,D,DAL,30,70,4,17,21
52,8476967,Brett Kulak,D,EDM,30,62,3,18,21
52,8475279,Ben Chiarot,D,DET,33,71,2,19,21
52,8477845,Trevor van Riemsdyk,D,WSH,33,61,1,20,21
52,8476822,Luke Glendening,C,TBL,35,76,11,9,20
52,8482679,Matt Coronato,R,CGY,22,67,10,10,20
52,8482074,Connor Zary,C,CGY,23,61,9,11,20
52,8480144,David Kampf,C,TOR,29,69,9,11,20
52,8480878,Nils Lundkvist,D,DAL,24,74,5,15,20
52,8482111,Justin Barron,D,MTL,23,63,5,15,20
52,8478178,Darren Raddysh,D,TBL,28,71,4,16,20
52,8476988,Matt Benning,D,SJS,30,67,4,16,20
52,8476879,Cody Ceci,D,EDM,31,70,3,17,20
52,8480222,Sebastian Aho,D,PIT,28,68,3,17,20
52,8477353,Tyler Motte,C,DET,29,73,14,5,19
52,8481477,Nico Sturm,C,SJS,29,54,11,8,19
52,8482089,Jake Neighbours,L,STL,22,66,11,8,19
52,8482803,Olen Zellweger,D,ANA,21,65,10,9,19
52,8476878,Zemgus Girgensons,C,TBL,30,82,10,9,19
52,8481554,Kaapo Kakko,R,NYR,23,69,9,10,19
52,8478013,Jake Walman,D,SJS,28,74,9,10,19
52,8478432,Christian Fischer,R,DET,27,79,9,10,19
52,8480806,Isac Lundestrom,C,ANA,25,57,9,10,19
52,8482744,James Malatesta,L,CBJ,21,51,8,11,19
52,8474716,Jared Spurgeon,D,MIN,35,75,7,12,19
52,8476329,Travis Boyd,C,MIN,31,55,7,12,19
52,8479983,Mario Ferraro,D,SJS,26,72,7,12,19
52,8476374,Sean Kuraly,C,CBJ,31,55,6,13,19
52,8477435,Ryan Graves,D,PIT,29,76,6,13,19
52,8473563,Nicklas Backstrom,C,WSH,37,50,5,14,19
52,8480860,Kevin Bahl,D,CGY,24,62,4,15,19
52,8475181,Nick Leddy,D,STL,33,65,2,17,19
52,8479398,Samuel Girard,D,COL,26,67,0,19,19
52,8480980,Connor Dewar,C,TOR,25,67,13,5,18
52,8481032,Paul Cotter,C,NJD,25,56,12,6,18
52,8477369,Carson Soucy,D,VAN,30,70,10,8,18
52,8479619,Michael Carcone,L,UTA,28,57,10,8,18
52,8475842,Sam Carrick,C,NYR,32,62,9,9,18
52,8478043,Sam Lafferty,C,BUF,29,49,8,10,18
52,8475225,Craig Smith,C,CHI,35,48,8,10,18
52,8480355,Mark Kastelic,C,BOS,25,63,8,10,18
52,8479543,Michael Pezzetta,L,MTL,26,63,7,11,18
52,8483495,Simon Nemec,D,NJD,20,54,6,12,18
52,8478911,Matt Roy,D,WSH,29,65,5,13,18
52,8480172,Jan Rutta,D,SJS,34,63,5,13,18
52,8475231,Casey Cizikas,C,NYI,33,75,5,13,18
52,8479369,Andrew Peeke,D,BOS,26,62,5,13,18
52,8480011,Klim Kostin,C,SJS,25,55,4,14,18
52,8482073,Braden Schneider,D,NYR,23,66,3,15,18
52,8478851,Alexandre Carrier,D,NSH,28,62,2,16,18
52,8479998,Mikey Anderson,D,LAK,25,63,2,16,18
52,8481522,Peyton Krebs,C,BUF,23,64,1,17,18
52,8476858,Phillip Di Giuseppe,L,VAN,31,47,13,4,17
52,8482155,Alex Laferriere,R,LAK,23,70,12,5,17
52,8482659,Josh Doan,R,UTA,22,54,10,7,17
52,8477446,Michael McCarron,R,NSH,29,65,8,9,17
52,8481028,Martin Pospisil,C,CGY,25,52,7,10,17
52,8471817,Ryan Reaves,R,TOR,37,58,7,10,17
52,8480205,Emil Bemstrom,C,PIT,25,55,6,11,17
52,8478434,Keegan Kolesar,R,VGK,27,62,6,11,17
52,8480879,Jacob Bernard-Docker,D,OTT,24,45,6,11,17
52,8479980,Nicolas Hague,D,VGK,26,59,5,12,17
52,8477070,Liam O'Brien,C,UTA,30,60,4,13,17
52,8483460,David Jiricek,D,CBJ,21,58,4,13,17
52,8481178,Egor Zamula,D,PHI,24,55,3,14,17
52,8476331,Dylan DeMelo,D,WPG,31,64,2,15,17
52,8478416,Erik Cernak,D,TBL,27,70,2,15,17
52,8480950,Ilya Lyubushkin,D,DAL,30,64,0,17,17
52,8479941,Justin Danforth,R,CBJ,31,58,11,5,16
52,8482077,Dylan Holloway,L,EDM,23,54,10,6,16
52,8478585,Derek Ryan,C,EDM,38,57,9,7,16
52,8484149,Gavin Brindley,C,CBJ,20,50,8,8,16
52,8477903,Garnet Hathaway,R,PHI,33,58,6,10,16
52,8477508,Curtis Lazar,C,NJD,29,59,6,10,16
52,8477979,Nicolas Aube-Kubel,R,BUF,28,52,6,10,16
52,8481527,Kaedan Korczak,D,VGK,23,49,5,11,16
52,8481161,Jake Christiansen,D,CBJ,25,54,5,11,16
52,8479026,Philippe Myers,D,TOR,27,52,3,13,16
52,8481568,Alex Vlasic,D,CHI,23,60,3,13,16
52,8478859,Niko Mikkola,D,FLA,28,54,2,14,16
52,8476917,Adam Pelech,D,NYI,30,79,1,15,16
52,8479324,Ryan Lindgren,D,NYR,26,65,0,16,16
52,8480796,Martin Fehervary,D,WSH,25,55,0,16,16
52,8475690,Chris Tanev,D,TOR,35,55,0,16,16
52,8481601,Simon Holmstrom,R,NYI,23,68,12,3,15
52,8479328,Julien Gauthier,R,NYI,27,60,10,5,15
52,8479671,Mathieu Olivier,R,CBJ,27,51,10,5,15
52,8479336,Carl Grundstrom,R,SJS,27,51,8,7,15
52,8480281,Alexey Toropchenko,R,STL,25,60,7,8,15
52,8482737,Zack Bolduc,C,STL,21,65,6,9,15
52,8480192,Johnathan Kovacevic,D,NJD,27,58,6,9,15
52,8476624,Barclay Goodrow,C,SJS,31,49,6,9,15
52,8482807,Ethan Del Mastro,D,CHI,21,50,6,9,15
52,8479996,Cody Glass,C,NSH,25,59,5,10,15
52,8476889,Radek Faksa,C,STL,30,60,5,10,15
52,8477406,Mattias Janmark,C,EDM,32,64,5,10,15
52,8480289,Morgan Barron,C,WPG,26,56,5,10,15
52,8479348,Kale Clague,D,BUF,26,49,5,10,15
52,8481567,Henry Thrun,D,SJS,23,48,5,10,15
52,8475179,Dmitry Kulikov,D,FLA,34,65,4,11,15
52,8480035,Henri Jokiharju,D,BUF,25,62,4,11,15
52,8481059,Scott Perunovich,D,STL,26,64,3,12,15
52,8476312,Josh Manson,D,COL,33,59,3,12,15
52,8481441,Joe Snively,C,DET,28,60,3,12,15
52,8480049,Dylan Samberg,D,WPG,25,69,3,12,15
52,8480848,Ty Dellandrea,C,SJS,24,47,3,12,15
52,8470600,Ryan Suter,D,STL,39,62,2,13,15
52,8481598,Philip Broberg,D,EDM,23,44,2,13,15
52,8478133,Jake Evans,C,MTL,28,64,1,14,15
52,8480807,Mattias Samuelsson,D,BUF,24,53,1,14,15
52,8482451,Mikael Pyyhtia,L,CBJ,23,46,0,15,15
52,8479439,Jacob MacDonald,D,COL,31,48,8,6,14
52,8476994,Vinnie Hinostroza,C,NSH,30,41,6,8,14
52,8480252,Cole Guttman,C,CHI,25,41,6,8,14
52,8477962,Brendan Lemieux,L,CAR,28,36,6,8,14
52,8479520,Brandon Duhaime,R,WSH,27,60,5,9,14
52,8476525,Colin Miller,D,WPG,32,67,4,10,14
52,8477365,Connor Clifton,D,BUF,29,51,4,10,14
52,8479372,Joshua Mahura,D,SEA,26,58,4,10,14
52,8482067,Connor Mackey,D,NYR,28,60,3,11,14
52,8476931,Jake McCabe,D,TOR,31,59,3,11,14
52,8475324,Nick Jensen,D,OTT,34,65,2,12,14
52,8474567,Zach Bogosian,D,MIN,34,65,2,12,14
52,8482176,Wyatt Kaiser,D,CHI,22,51,0,14,14
52,8479414,Nathan Bastian,R,NJD,27,57,8,5,13
52,8478421,A.J. Greer,L,FLA,28,52,7,6,13
52,8477380,Jonny Brodzinski,C,NYR,31,52,7,6,13
52,8483466,Kevin Korchinski,D,CHI,20,53,7,6,13
52,8480891,Michael Kesselring,D,UTA,24,68,6,7,13
52,8481599,Victor Soderstrom,D,UTA,23,42,5,8,13
52,8478452,Caleb Jones,D,LAK,27,56,5,8,13
52,8474166,Alec Martinez,D,CHI,37,42,5,8,13
52,8482634,Alex Steeves,C,TOR,25,42,5,8,13
52,8481517,Brett Leason,R,ANA,25,51,5,8,13
52,8479359,Beck Malenstyn,L,BUF,26,49,5,8,13
52,8482095,Tyler Kleven,D,OTT,22,42,4,9,13
52,8479370,Tyson Jost,C,CAR,26,50,4,9,13
52,8481701,Santeri Hatakka,D,NJD,23,35,4,9,13
52,8473446,Erik Johnson,D,PHI,36,45,3,10,13
52,8480880,Jakub Lauko,C,MIN,24,41,3,10,13
52,8475208,Brian Dumoulin,D,ANA,33,65,2,11,13
52,8478468,Jeremy Lauzon,D,NSH,27,50,2,11,13
52,8478451,Ethan Bear,D,WSH,27,50,2,11,13
52,8476874,Olli Maatta,D,DET,30,63,2,11,13
52,8477018,Ben Hutton,D,VGK,31,42,1,12,13
52,8479986,Kole Lind,R,DAL,26,59,1,12,13
52,8482762,Simon Edvinsson,D,DET,21,60,9,3,12
52,8477573,Nathan Walker,L,STL,30,55,9,3,12
52,8482166,Shakir Mukhamadullin,D,SJS,22,52,8,4,12
52,8481716,Dmitri Voronkov,L,CBJ,24,46,8,4,12
52,8481789,Tye Kartye,L,SEA,23,41,8,4,12
52,8479344,Jesse Puljujarvi,R,PIT,26,54,7,5,12
52,8476867,Brendan Gaunce,C,MIN,30,36,7,5,12
52,8480025,MacKenzie Entwistle,R,FLA,25,65,5,7,12
52,8476934,Brock McGinn,L,ANA,30,58,5,7,12
52,8478136,Jake Middleton,D,MIN,28,76,4,8,12
52,8476873,Mark Jankowski,C,NSH,30,50,3,9,12
52,8478399,Jonas Siegenthaler,D,NJD,27,52,3,9,12
52,8477499,Rasmus Ristolainen,D,PHI,30,53,3,9,12
52,8475455,Brenden Dillon,D,NJD,34,62,3,9,12
52,8481019,David Gustafsson,C,WPG,24,47,2,10,12
52,8476891,Matthew Grzelcyk,D,PIT,30,78,2,10,12
52,8480070,Ian Mitchell,D,BOS,25,52,2,10,12
52,8480058,Pierre-Olivier Joseph,D,STL,25,51,1,11,12
52,8475790,Erik Gudbranson,D,CBJ,32,76,0,12,12
52,8479944,Zach Aston-Reese,C,VGK,30,44,6,5,11
52,8478569,Noel Acciari,C,PIT,33,41,6,5,11
52,8482652,Walker Duehr,R,CGY,27,35,6,5,11
52,8481751,Lukas Rousek,R,BUF,25,38,6,5,11
52,8483499,Liam Ohgren,L,MIN,20,54,5,6,11
52,8477931,Tomas Nosek,L,FLA,32,60,4,7,11
52,8481537,Nikita Okhotiuk,D,CGY,24,57,4,7,11
52,8481708,Zac Jones,D,NYR,24,53,3,8,11
52,8481617,Vasily Podkolzin,R,VAN,23,43,3,8,11
52,8478211,Dryden Hunt,L,CGY,29,51,3,8,11
52,8476441,Joel Edmundson,D,LAK,31,40,3,8,11
52,8475462,Radko Gudas,D,ANA,34,65,2,9,11
52,8482730,Brandt Clarke,D,LAK,21,51,2,9,11
52,8480727,Zach Whitecloud,D,VGK,28,49,2,9,11
52,8474568,Luke Schenn,D,NSH,35,51,2,9,11
52,8475188,Brayden McNabb,D,VGK,33,49,1,10,11
52,8480887,Jordan Harris,D,MTL,24,52,0,11,11
52,8481550,Adam Beckman,L,NJD,23,44,6,4,10
52,8479291,Kevin Rooney,C,CGY,31,54,5,5,10
52,8481600,Tobias Bjornfot,D,FLA,23,41,3,7,10
52,8480990,Declan Chisholm,D,MIN,24,40,3,7,10
52,8479718,Alex Barré-Boulet,C,MTL,27,50,2,8,10
52,8480845,Rasmus Kupari,C,WPG,24,37,2,8,10
52,8476952,Dominic Toninato,C,WPG,30,38,2,8,10
52,8475958,Michael Sgarbossa,C,WSH,32,27,1,9,10
52,8471709,Marc-Edouard Vlasic,D,SJS,37,65,0,10,10
52,8478831,Kevin Stenlund,C,UTA,28,47,7,2,9
52,8481679,Maxence Guenette,D,OTT,23,34,7,2,9
52,8477887,Patrick Brown,C,BOS,32,46,6,3,9
52,8479772,Zack MacEwen,R,OTT,28,58,4,5,9
52,8479994,Jaret Anderson-Dolan,C,WPG,25,43,4,5,9
52,8477938,Haydn Fleury,D,WPG,28,39,4,5,9
52,8482496,Nils Aman,C,VAN,24,41,4,5,9
52,8477851,Jordan Oesterle,D,BOS,32,42,4,5,9
52,8479379,Givani Smith,R,SJS,26,28,4,5,9
52,8476429,Scott Mayfield,D,NYI,32,68,3,6,9
52,8477482,Zachary Sanford,L,CHI,30,35,3,6,9
52,8478502,Dennis Gilbert,D,BUF,28,23,3,6,9
52,8482148,Hendrix Lapierre,C,WSH,22,50,3,6,9
52,8478443,Brandon Carlo,D,BOS,28,61,2,7,9
52,8481013,Jonatan Berggren,R,DET,24,53,2,7,9
52,8477073,Kurtis MacDermid,L,NJD,30,40,2,7,9
52,8474090,Brendan Smith,D,DAL,35,50,1,8,9
52,8482666,Scott Morrow,D,CAR,22,48,6,2,8
52,8481532,Alex Turcotte,C,LAK,23,45,5,3,8
52,8478424,Jansen Harkins,C,ANA,27,39,5,3,8
52,8479576,Vincent Desharnais,D,VAN,28,39,5,3,8
52,8482141,Lukas Cormier,D,VGK,22,27,5,3,8
52,8482117,Lukas Reichel,L,CHI,22,47,4,4,8
52,8480441,Trey Fix-Wolansky,R,CBJ,25,35,4,4,8
52,8475235,Nicolas Deslauriers,L,PHI,33,50,4,4,8
52,8477335,Kyle Burroughs,D,LAK,29,45,3,5,8
52,8477462,Robert Hagg,D,VGK,29,25,3,5,8
52,8479371,Dante Fabbro,D,NSH,26,58,2,6,8
52,8479442,Troy Stecher,D,EDM,30,54,2,6,8
52,8475177,Calvin de Haan,D,COL,33,47,2,6,8
52,8481147,Reese Johnson,C,MIN,26,39,2,6,8
52,8478017,Mark Friedman,D,VAN,29,40,1,7,8
52,8481122,Simon Benoit,D,TOR,26,45,1,7,8
52,8476372,Nick Seeler,D,PHI,31,45,1,7,8
52,8479536,Axel Jonsson-Fjallby,L,WPG,26,30,1,7,8
52,8482861,Vincent Iorio,D,WSH,22,34,1,7,8
52,8483619,Filip Roos,D,OTT,25,36,1,7,8
52,8484254,Akito Hirose,D,VAN,25,39,1,7,8
52,8478450,Parker Wotherspoon,D,BOS,27,32,0,8,8
52,8482784,Zach Dean,C,STL,21,37,7,0,7
52,8481641,Joel Kiviranta,L,COL,28,71,5,2,7
52,8481167,Brayden Pachal,D,CGY,25,36,5,2,7
52,8479638,Justin Brazeau,R,BOS,26,30,5,2,7
52,8471677,Jack Johnson,D,CBJ,37,64,4,3,7
52,8480007,Jonas Rondbjerg,R,VGK,25,43,4,3,7
52,8479981,Jonah Gadjovich,L,FLA,26,37,3,4,7
52,8481592,Jakob Pelletier,L,CGY,23,37,2,5,7
52,8474013,Ian Cole,D,UTA,35,50,2,5,7
52,8479972,Mason Shaw,C,WPG,26,33,2,5,7
52,8475762,Derek Forbort,D,VAN,32,44,2,5,7
52,8483630,Pavol Regenda,L,ANA,25,29,2,5,7
52,8481518,Nolan Foote,L,NJD,24,33,1,6,7
52,8479320,Maxime Lajoie,D,SEA,27,18,1,6,7
52,8482511,Mason Lohrei,D,BOS,23,34,1,6,7
52,8481543,Nikita Alexandrov,C,STL,24,29,5,1,6
52,8481556,John Beecher,C,BOS,23,35,4,2,6
52,8482070,Mitchell Chaffee,R,TBL,26,51,4,2,6
52,8483397,Marc McLaughlin,C,BOS,25,32,4,2,6
52,8482153,Brendan Brisson,C,VGK,23,30,4,2,6
52,8482859,Zack Ostapchuk,C,OTT,21,45,3,3,6
52,8479378,Logan Stanley,D,WPG,26,44,3,3,6
52,8475795,Dylan McIlrath,D,WSH,32,22,3,3,6
52,8483512,Matthew Savoie,C,EDM,20,23,2,4,6
52,8480196,Jacob Bryson,D,BUF,27,40,1,5,6
52,8476473,Connor Murphy,D,CHI,31,39,1,5,6
52,8475750,Jon Merrill,D,MIN,32,61,1,5,6
52,8477384,Joshua Brown,D,EDM,30,42,0,6,6
52,8482733,Logan Mailloux,D,MTL,31,38,4,1,5
52,8480021,Jack Studnicka,C,LAK,25,52,3,2,5
52,8480844,Grigori Denisenko,L,VGK,24,26,3,2,5
52,8482765,Isak Rosen,R,BUF,21,26,3,2,5
52,8482964,Arber Xhekaj,D,MTL,23,45,3,2,5
52,8484287,Cole McWard,D,VAN,23,21,3,2,5
52,8476442,Matt Nieto,L,PIT,32,53,2,3,5
52,8482747,Brennan Othmann,L,NYR,21,38,2,3,5
52,8482147,Jean-Luc Foudy,C,COL,22,23,2,3,5
52,8483763,Maksymilian Szuber,D,UTA,22,30,2,3,5
52,8477401,John Hayden,C,SEA,29,30,2,3,5
52,8482145,Mavrik Bourque,C,DAL,22,48,1,4,5
52,8478454,Noah Juulsen,D,VAN,27,30,1,4,5
52,8481030,Jack St. Ivany,D,PIT,25,15,1,4,5
52,8476913,Devin Shore,C,MIN,30,30,1,4,5
52,8480157,Calle Rosen,D,COL,30,42,0,5,5
52,8481237,Kyle MacLean,C,NYI,25,25,0,5,5
52,8481754,Nikita Nesterenko,C,ANA,23,36,3,1,4
52,8480851,Akil Thomas,C,LAK,24,21,3,1,4
52,8482177,Marat Khusnutdinov,C,MIN,22,34,3,1,4
52,8477473,Justin Bailey,R,SJS,29,15,2,2,4
52,8477527,Ross Johnston,L,ANA,30,28,2,2,4
52,8480890,Jan Jenik,C,OTT,24,27,2,2,4
52,8481609,Vladislav Kolyachonok,D,UTA,23,36,2,2,4
52,8479991,Jake Leschyshyn,C,NYR,25,26,2,2,4
52,8479419,Brett Murray,L,BUF,26,22,2,2,4
52,8481065,Angus Crookshank,L,OTT,25,14,2,2,4
52,8479968,Vinni Lettieri,C,BOS,29,46,1,3,4
52,8481605,Jackson LaCombe,D,ANA,23,35,1,3,4
52,8480834,Ty Emberson,D,SJS,24,27,1,3,4
52,8484911,Collin Graf,R,SJS,22,43,1,3,4
52,8477467,Gustav Olofsson,D,SEA,30,20,1,3,4
52,8482118,Sam Colangelo,R,ANA,23,17,1,3,4
52,8479985,Cale Fleury,D,SEA,26,25,1,3,4
52,8475718,Justin Holl,D,DET,32,58,0,4,4
52,8478874,Adam Gaudette,R,OTT,28,29,0,4,4
52,8480870,Bo Groulx,C,NYR,24,38,0,4,4
52,8481056,Spencer Stastney,D,NSH,24,32,0,4,4
52,8478021,William Lagesson,D,DET,28,23,0,4,4
52,8482751,Ryan Winterton,C,SEA,21,41,2,1,3
52,8482713,Mackie Samoskevich,R,FLA,22,38,2,1,3
52,8482172,Landon Slaggert,L,CHI,22,20,2,1,3
52,8481655,Cole Schwindt,R,CGY,23,8,2,1,3
52,8478409,Anthony Richard,C,PHI,28,41,1,2,3
52,8474612,Travis Hamonic,D,OTT,34,45,1,2,3
52,8481541,Samuel Bolduc,D,NYI,24,28,1,2,3
52,8481593,Jayden Struble,D,MTL,23,22,1,2,3
52,8477971,Andreas Englund,D,LAK,28,27,1,2,3
52,8484258,Sam Malinski,D,COL,26,21,1,2,3
52,8478146,Matthew Highmore,C,OTT,28,35,1,2,3
52,8479367,William Lockwood,R,FLA,26,31,1,2,3
52,8481743,Marc Del Gaizo,D,NSH,25,27,1,2,3
52,8480084,Nick DeSimone,D,NJD,30,15,1,2,3
52,8481422,Jake Lucchini,C,NSH,29,19,1,2,3
52,8479362,Riley Tufte,L,BOS,26,16,1,2,3
52,8480874,Adam Ginning,D,PHI,24,10,1,2,3
52,8477034,Jaycob Megna,D,FLA,32,39,0,3,3
52,8483012,Logan Morrison,C,SEA,22,37,0,3,3
52,8482201,Gage Goncalves,C,TBL,23,22,0,3,3
52,8479587,Rhett Gardner,C,PHI,28,21,0,3,3
52,8477320,Anton Blidh,L,NYR,29,17,0,3,3
52,8481462,Mason Morelli,L,VGK,28,15,0,3,3
52,8482470,Ilya Solovyov,D,CGY,24,16,2,0,2
52,8481043,Cole Koepke,L,BOS,26,14,2,0,2
52,8477244,Chad Ruhwedel,D,NYR,34,34,1,1,2
52,8480823,Alexander Alexeyev,D,WSH,25,10,1,1,2
52,8482102,Vasily Ponomarev,C,PIT,22,17,1,1,2
52,8480468,James Hamblin,L,EDM,25,24,1,1,2
52,8484325,Waltteri Merela,C,TBL,26,25,1,1,2
52,8477541,Dakota Mermis,D,TOR,30,9,1,1,2
52,8481719,Maxwell Crozier,D,TBL,24,15,1,1,2
52,8478051,Max Willman,C,NJD,29,14,1,1,2
52,8482787,Nikita Chibrikov,R,WPG,31,5,1,1,2
52,8483549,Lucas Condotta,L,MTL,27,34,0,2,2
52,8482250,Callahan Burke,C,VGK,27,23,0,2,2
52,8477810,Joel Hanley,D,CGY,33,29,0,2,2
52,8479249,Andrew Poturalski,C,SJS,30,38,0,2,2
52,8480292,Carson Meyer,R,ANA,27,31,0,2,2
52,8484304,Uvis Balinskis,D,FLA,28,10,0,2,2
52,8481564,Ryan Johnson,D,BUF,23,15,0,2,2
52,8480267,Sammy Walker,C,MIN,25,13,0,2,2
52,8474062,Riley Nash,C,NYR,35,15,0,2,2
52,8479421,Jacob Moverare,D,LAK,26,8,0,2,2
52,8483546,Marshall Rifai,D,TOR,26,4,0,2,2
52,8481585,Egor Afanasyev,L,SJS,23,14,0,2,2
52,8482162,Roby Jarventie,L,EDM,22,14,0,2,2
52,8482165,Yan Kuznetsov,D,CGY,22,15,1,0,1
52,8482516,Matthew Kessel,D,STL,24,20,1,0,1
52,8480032,Shane Bowers,C,NJD,25,13,1,0,1
52,8482088,Justin Sourdif,R,FLA,22,14,1,0,1
52,8481699,Aku Raty,R,UTA,23,14,1,0,1
52,8475780,Chris Wagner,R,COL,33,7,1,0,1
52,8483597,Milos Kelemen,L,UTA,25,11,1,0,1
52,8482460,Matt Rempe,C,NYR,22,16,1,0,1
52,8478147,Bokondji Imama,L,PIT,28,8,1,0,1
52,8480306,Grant Hutton,D,NYI,29,8,1,0,1
52,8479330,Brandon Gignac,C,MTL,27,6,1,0,1
52,8481006,Tyler Tucker,D,STL,24,13,0,1,1
52,8480245,Olle Lycksell,R,PHI,25,26,0,1,1
52,8478477,Mitchell Stephens,C,SEA,27,22,0,1,1
52,8478446,Glenn Gawdin,C,LAK,27,11,0,1,1
52,8483567,Georgii Merkulov,C,BOS,24,6,0,1,1
52,8478881,Brett Seney,L,CHI,28,15,0,1,1
52,8483920,Pierrick Dube,R,WSH,23,3,0,1,1
52,8482858,Ryker Evans,D,SEA,23,17,0,1,1
52,8483398,Declan Carlile,D,TBL,31,6,0,1,1
52,8481806,Louis Crevier,D,CHI,23,10,0,1,1
52,8477149,Scott Sabourin,R,SJS,32,15,0,1,1
52,8481578,Graeme Clarke,R,MIN,23,17,0,1,1
52,8484321,Nikolas Matinpalo,D,OTT,26,5,0,1,1
52,8481206,John Ludvig,D,PIT,24,16,0,1,1
52,8483570,Ben Meyers,C,SEA,26,27,0,0,0
52,8482144,Jack Thompson,D,SJS,22,24,0,0,0
52,8478011,Louie Belpedio,D,PHI,28,15,0,0,0
52,8482094,Daemon Hunt,D,MIN,22,14,0,0,0
52,8483395,Arshdeep Bains,L,VAN,23,8,0,0,0
52,8482929,Emil Lilleberg,D,TBL,23,23,0,0,0
52,8481024,Linus Karlsson,C,VAN,25,6,0,0,0
52,8478854,Ryan Shea,D,PIT,27,3,0,0,0
52,8482126,Emil Andrae,D,PHI,31,3,0,0,0
52,8479522,Hardy Haman Aktell,D,WSH,26,6,0,0,0
52,8481726,Adam Edstrom,C,NYR,24,9,0,0,0
52,8482476,Emil Heineman,L,MTL,23,4,0,0,0
52,8483471,Brad Lambert,C,WPG,31,7,0,0,0
52,8482197,Adam Raska,R,MIN,23,9,0,0,0
52,8475755,Alexander Petrovic,D,DAL,32,10,0,0,0
52,8475413,Justin Dowling,C,NJD,34,9,0,0,0
52,8483401,Marc Johnstone,R,PIT,28,1,0,0,0
52,8480075,Cameron Crotty,D,MIN,25,8,0,0,0
52,8482061,Brandon Biro,L,SEA,26,11,0,0,0
52,8484255,Jason Polin,R,COL,25,7,0,0,0
52,8481534,Raphael Lavoie,C,EDM,24,2,0,0,0
52,8483407,Brandon Scanlin,D,NYR,25,4,0,0,0
52,8484326,Patrik Koch,D,UTA,28,1,0,0,0
52,8483531,Brian Halonen,L,NJD,25,5,0,0,0
52,8476323,Max McCormick,L,SEA,32,6,0,0,0
52,8483489,Fraser Minten,C,TOR,31,8,0,0,0
52,8483432,Luca Del Bel Belluz,C,CBJ,31,3,0,0,0
52,8484259,Ondrej Pavel,C,COL,31,3,0,0,0
52,8477993,Justin Kirkland,C,CGY,28,4,0,0,0
52,8483609,Adam Klapka,R,CGY,24,3,0,0,0
52,8480274,Philip Kemp,D,EDM,25,3,0,0,0
52,8470794,Joe Pavelski,C,,40,0,0,0,0
52,8479321,Lucas Johansen,D,,27,0,0,0,0
52,8477950,Tony DeAngelo,D,,29,0,0,0,0
52,8471218,Blake Wheeler,R,,38,0,0,0,0
52,8475197,Tyson Barrie,D,,33,0,0,0,0
52,8474157,Max Pacioretty,L,,36,0,0,0,0
52,8475744,Evgeny Kuznetsov,C,,32,0,0,0,0
52,8474037,James van Riemsdyk,L,,35,0,0,0,0
52,8476907,Mackenzie MacEachern,L,,30,0,0,0,0
52,8480216,Jacob Peterson,C,,25,0,0,0,0
52,8474602,Justin Schultz,D,,34,0,0,0,0
52,8482222,Alexander Barabanov,L,,30,0,0,0,0
52,8474031,Kevin Shattenkirk,D,,35,0,0,0,0
52,8477330,Dominik Kubalik,L,,29,0,0,0,0
52,8480884,Calen Addison,D,,24,0,0,0,0
52,8475906,John Klingberg,D,,32,0,0,0,0
52,8480008,Adam Ruzicka,C,,25,0,0,0,0
52,8476884,Derrick Pouliot,D,,30,0,0,0,0
52,8476919,Chris Tierney,C,,30,0,0,0,0
52,8479415,Michael McLeod,C,,26,0,0,0,0
52,8474870,Tyler Johnson,C,,34,0,0,0,0
52,8470604,Jeff Carter,C,,39,0,0,0,0
52,8478104,Sammy Blais,L,,28,0,0,0,0
52,8474884,Mike Hoffman,C,,35,0,0,0,0
52,8481591,Sam Poulin,R,,23,0,0,0,0
52,8471274,Alex Goligoski,D,,39,0,0,0,0
52,8476871,Tanner Pearson,L,,32,0,0,0,0
52,8476393,Nick Cousins,C,,31,0,0,0,0
52,8479977,Kailer Yamamoto,R,,26,0,0,0,0
52,8479346,Dillon Dube,C,,26,0,0,0,0
52,8480184,Gustav Lindstrom,D,,26,0,0,0,0
52,8479376,Victor Mete,D,,26,0,0,0,0
52,8473449,Kyle Okposo,R,,36,0,0,0,0
52,8481058,Jesse Ylonen,R,,25,0,0,0,0
52,8475752,Tyler Pitlick,C,,33,0,0,0,0
52,8481239,Samuel Fagemo,L,,24,0,0,0,0
52,8480821,Filip Zadina,R,,25,0,0,0,0
52,8470966,Mark Giordano,D,,41,0,0,0,0
52,8478495,Denis Gurianov,R,,27,0,0,0,0
52,8477464,Nic Petan,C,,29,0,0,0,0
52,8478099,Kevin Labanc,R,,29,0,0,0,0
52,8482241,Radim Zohorna,L,,28,0,0,0,0
52,8474040,Sam Gagner,C,,35,0,0,0,0
52,8479514,Rem Pitlick,C,,27,0,0,0,0
52,8478430,Oliver Kylington,D,,27,0,0,0,0
52,8479533,Joona Koppanen,L,,26,0,0,0,0
52,8479984,Cal Foote,D,,26,0,0,0,0
52,8477126,Jayson Megna,C,,34,0,0,0,0
52,8475164,Jakob Silfverberg,R,,34,0,0,0,0
52,8474009,Nick Bonino,C,,36,0,0,0,0
52,8479458,Nikita Zaitsev,D,,33,0,0,0,0
52,8477944,Jakub Vrana,L,,28,0,0,0,0
52,8471699,Andrew Cogliano,C,,37,0,0,0,0
52,8478067,Oskar Lindblom,L,,28,0,0,0,0
52,8471686,Marc Staal,D,,37,0,0,0,0
52,8470610,Zach Parise,L,,40,0,0,0,0
52,8478904,Steven Lorentz,C,,28,0,0,0,0
52,8473473,Milan Lucic,L,,36,0,0,0,0
52,8480031,Maxime Comtois,L,,25,0,0,0,0
52,8478512,Austin Czarnik,C,,32,0,0,0,0
52,8473504,Cal Clutterbuck,R,,37,0,0,0,0
52,8477454,Adam Erne,L,,29,0,0,0,0
52,8479383,Boris Katchouk,L,,26,0,0,0,0
52,8475825,Jani Hakanpää,D,,32,0,0,0,0
52,8477846,Ryan Carpenter,C,,33,0,0,0,0
52,8477930,Pierre-Edouard Bellemare,L,,39,0,0,0,0
52,8478400,Colin White,C,,27,0,0,0,0
52,8480226,Marián Studenic,R,,26,0,0,0,0
52,8480853,Liam Foudy,C,,24,0,0,0,0
52,8475797,Jarred Tinordi,D,,32,0,0,0,0
52,8479423,Alex Nylander,L,,26,0,0,0,0
52,8474618,Marco Scandella,D,,34,0,0,0,0
52,8478028,Fredrik Olofsson,L,,28,0,0,0,0
52,8474709,Matt Martin,L,,35,0,0,0,0
52,8481070,Hugh McGing,L,,26,0,0,0,0
52,8479546,Oskar Steen,C,,26,0,0,0,0
52,8474145,Robert Bortuzzo,D,,35,0,0,0,0
52,8476915,Jujhar Khaira,L,,30,0,0,0,0
52,8475278,Byron Froese,C,,33,0,0,0,0
52,8481812,Nikolai Knyzhov,D,,27,0,0,0,0
52,8478408,Travis Dermott,D,,28,0,0,0,0
52,8481077,John Leonard,L,,26,0,0,0,0
52,8479547,Matthew Phillips,R,,26,0,0,0,0
52,8480836,Jonathan Gruden,C,,24,0,0,0,0
52,8481690,Tyler Angle,C,,24,0,0,0,0
52,8475766,Austin Watson,L,,32,0,0,0,0
52,8481016,Ruslan Iskhakov,C,,24,0,0,0,0
52,8478078,Rourke Chartier,C,,28,0,0,0,0
52,8480776,Sheldon Rempal,R,,29,0,0,0,0
52,8478956,Samuel Laberge,L,NJD,27,1,0,0,0
52,8483045,Cameron Butler,R,CBJ,31,1,0,0,0
52,8484314,Jiri Smejkal,L,,28,0,0,0,0
53,8477492,Nathan MacKinnon,C,COL,29,80,66,95,161
53,8478483,Mitch Marner,R,TOR,27,80,44,94,138
53,8478402,Connor McDavid,C,EDM,27,80,42,94,136
53,8476453,Nikita Kucherov,R,TBL,31,82,40,83,123
53,8478550,Artemi Panarin,L,NYR,33,80,31,91,122
53,8476468,J.T. Miller,C,VAN,31,76,43,78,121
53,8481559,Jack Hughes,C,NJD,23,77,45,70,115
53,8477934,Leon Draisaitl,C,EDM,29,78,36,78,114
53,8478445,Mathew Barzal,C,NYI,27,81,28,84,112
53,8477956,David Pastrnak,R,BOS,28,79,52,57,109
53,8477404,Jake Guentzel,C,TBL,30,82,42,66,108
53,8471675,Sidney Crosby,C,PIT,37,76,48,58,106
53,8479407,Jesper Bratt,L,NJD,26,81,41,65,106
53,8477942,Kevin Fiala,L,LAK,28,82,43,62,105
53,8480012,Elias Pettersson,C,VAN,26,74,43,61,104
53,8477493,Aleksander Barkov,C,FLA,29,81,43,61,104
53,8479318,Auston Matthews,C,TOR,27,78,56,45,101
53,8477939,William Nylander,R,TOR,28,80,47,54,101
53,8478864,Kirill Kaprizov,L,MIN,27,72,43,58,101
53,8479314,Matthew Tkachuk,L,FLA,27,76,26,75,101
53,8480801,Brady Tkachuk,L,OTT,25,79,42,53,95
53,8471215,Evgeni Malkin,C,PIT,38,73,32,63,95
53,8476887,Filip Forsberg,L,NSH,30,75,43,51,94
53,8480027,Jason Robertson,L,DAL,25,82,35,58,93
53,8477946,Dylan Larkin,C,DET,28,79,36,54,90
53,8475166,John Tavares,C,TOR,34,78,43,46,89
53,8479323,Adam Fox,D,NYR,26,75,17,72,89
53,8480002,Nico Hischier,C,NJD,25,76,32,54,86
53,8478398,Kyle Connor,L,WPG,28,71,47,38,85
53,8478420,Mikko Rantanen,R,COL,28,82,41,44,85
53,8475172,Nazem Kadri,C,CGY,34,79,32,53,85
53,8476454,Ryan Nugent-Hopkins,C,EDM,31,82,27,58,85
53,8476389,Vincent Trocheck,C,NYR,31,75,28,56,84
53,8478414,Timo Meier,R,NJD,28,75,41,42,83
53,8477933,Sam Reinhart,C,FLA,29,76,40,43,83
53,8476539,Jonathan Marchessault,R,NSH,34,70,42,40,82
53,8474600,Roman Josi,D,NSH,34,75,16,66,82
53,8474564,Steven Stamkos,C,NSH,34,78,38,43,81
53,8479343,Clayton Keller,R,UTA,26,75,33,48,81
53,8476460,Mark Scheifele,C,WPG,31,73,26,55,81
53,8475184,Chris Kreider,L,NYR,33,75,45,35,80
53,8478010,Brayden Point,C,TBL,28,82,45,34,79
53,8479420,Tage Thompson,C,BUF,27,73,41,38,79
53,8479337,Alex DeBrincat,R,DET,27,81,32,47,79
53,8471214,Alex Ovechkin,L,WSH,39,74,38,40,78
53,8476459,Mika Zibanejad,C,NYR,31,71,34,44,78
53,8475913,Mark Stone,R,VGK,32,72,33,45,78
53,8475765,Vladimir Tarasenko,R,DET,33,78,33,45,78
53,8477960,Adrian Kempe,R,LAK,28,80,28,50,78
53,8477949,Alex Tuch,R,BUF,28,75,26,52,78
53,8480800,Quinn Hughes,D,VAN,25,72,12,66,78
53,8479542,Brandon Hagel,L,TBL,26,82,29,48,77
53,8482116,Tim Stützle,C,OTT,22,82,27,50,77
53,8471685,Anze Kopitar,C,LAK,37,81,25,52,77
53,8480023,Robert Thomas,C,STL,25,76,15,62,77
53,8481557,Matt Boldy,L,MIN,23,72,33,43,76
53,8480208,Drake Batherson,R,OTT,26,80,29,47,76
53,8482078,Lucas Raymond,L,DET,22,81,29,47,76
53,8480069,Cale Makar,D,COL,26,70,20,56,76
53,8475786,Zach Hyman,L,EDM,32,78,42,33,75
53,8477500,Bo Horvat,C,NYI,29,80,35,40,75
53,8475158,Ryan O'Reilly,C,NSH,33,69,33,41,74
53,8475167,Victor Hedman,D,TBL,34,78,11,63,74
53,8478449,Roope Hintz,C,DAL,28,82,32,41,73
53,8484144,Connor Bedard,C,CHI,19,66,28,45,73
53,8474141,Patrick Kane,R,DET,36,80,27,46,73
53,8479675,Trevor Moore,L,LAK,29,78,37,35,72
53,8475754,Brock Nelson,C,NYI,33,78,36,36,72
53,8478439,Travis Konecny,R,PHI,27,76,33,39,72
53,8480830,Andrei Svechnikov,R,CAR,24,69,33,39,72
53,8478401,Pavel Zacha,C,BOS,27,80,30,42,72
53,8473512,Claude Giroux,R,OTT,36,80,21,51,72
53,8477409,Carter Verhaeghe,C,FLA,29,74,26,45,71
53,8476456,Jonathan Huberdeau,C,CGY,31,77,19,52,71
53,8480803,Evan Bouchard,D,EDM,25,70,16,55,71
53,8480865,Noah Dobson,D,NYI,24,76,12,59,71
53,8482740,Wyatt Johnston,C,DAL,21,79,32,38,70
53,8473419,Brad Marchand,L,BOS,36,78,22,48,70
53,8480018,Nick Suzuki,C,MTL,25,75,29,40,69
53,8476881,Tomas Hertl,C,VGK,31,80,27,42,69
53,8478403,Jack Eichel,C,VGK,28,79,25,44,69
53,8477940,Nikolaj Ehlers,L,WPG,28,72,24,45,69
53,8478460,Zach Werenski,D,CBJ,27,78,18,51,69
53,8476346,Johnny Gaudreau,L,CBJ,31,72,17,52,69
53,8479385,Jordan Kyrou,C,STL,26,75,29,39,68
53,8475692,Mats Zuccarello,R,MIN,37,70,19,48,67
53,8477501,Valeri Nichushkin,R,COL,29,81,33,33,66
53,8477935,Sam Bennett,C,FLA,28,74,34,31,65
53,8474641,Adam Henrique,C,EDM,34,77,29,36,65
53,8476448,William Karlsson,C,VGK,31,74,27,38,65
53,8478444,Brock Boeser,R,VAN,27,76,26,39,65
53,8478427,Sebastian Aho,C,CAR,27,68,24,41,65
53,8474578,Erik Karlsson,D,PIT,34,81,23,42,65
53,8477496,Elias Lindholm,C,BOS,30,79,22,43,65
53,8475168,Matt Duchene,C,DAL,33,81,19,46,65
53,8477503,Max Domi,C,TOR,29,75,18,47,65
53,8475810,Bryan Rust,R,PIT,32,70,31,33,64
53,8475784,Jeff Skinner,C,EDM,32,75,34,29,63
53,8478498,Jake DeBrusk,L,VAN,28,74,28,35,63
53,8475794,Tyler Seguin,C,DAL,32,81,26,37,63
53,8478873,Troy Terry,R,ANA,27,75,25,38,63
53,8478856,Conor Garland,R,VAN,28,72,20,43,63
53,8482665,Matty Beniers,C,SEA,22,76,25,37,62
53,8478440,Dylan Strome,C,WSH,27,71,22,40,62
53,8481540,Cole Caufield,R,MTL,23,75,29,32,61
53,8477402,Pavel Buchnevich,L,STL,29,75,25,36,61
53,8483515,Juraj Slafkovsky,L,MTL,20,78,24,36,60
53,8478047,Michael Bunting,L,PIT,29,72,23,37,60
53,8475798,Mikael Granlund,C,SJS,32,70,13,47,60
53,8477955,Jared McCann,L,SEA,28,75,21,38,59
53,8482745,Mason McTavish,C,ANA,21,74,21,38,59
53,8482699,Dylan Guenther,R,UTA,21,73,21,38,59
53,8482093,Seth Jarvis,C,CAR,22,63,28,30,58
53,8477964,Ivan Barbashev,C,VGK,29,74,22,36,58
53,8476479,Phillip Danault,C,LAK,31,80,14,44,58
53,8478438,Tommy Novak,C,NSH,27,74,19,38,57
53,8481528,Dylan Cozens,C,BUF,23,74,14,43,57
53,8478407,Vince Dunn,D,SEA,28,76,13,44,57
53,8482684,Luke Hughes,D,NJD,21,69,8,49,57
53,8475726,Tyler Toffoli,C,SJS,32,68,28,28,56
53,8479345,Jakob Chychrun,D,WSH,26,66,25,31,56
53,8478975,Mason Marchment,L,DAL,29,82,24,32,56
53,8477444,Andre Burakovsky,L,SEA,29,68,22,34,56
53,8477476,Artturi Lehkonen,L,COL,29,81,21,35,56
53,8477951,Nick Schmaltz,C,UTA,28,75,20,36,56
53,8477494,Jonathan Drouin,L,COL,29,80,15,41,56
53,8479325,Charlie McAvoy,D,BOS,27,76,7,49,56
53,8475768,Jaden Schwartz,C,SEA,32,73,25,30,55
53,8473994,Jamie Benn,L,DAL,35,81,22,33,55
53,8477498,Darnell Nurse,D,EDM,29,73,19,36,55
53,8477986,Brandon Montour,D,SEA,30,73,16,39,55
53,8477504,Josh Morrissey,D,WPG,29,75,15,40,55
53,8482113,Anton Lundell,C,FLA,23,77,14,41,55
53,8481596,Shane Pinto,C,OTT,24,76,24,30,54
53,8474102,David Perron,L,OTT,36,77,17,37,54
53,8474679,Gustav Nyquist,C,NSH,35,69,16,38,54
53,8480036,Miro Heiskanen,D,DAL,25,76,8,46,54
53,8478519,Anthony Cirelli,C,TBL,27,81,24,29,53
53,8475169,Evander Kane,L,EDM,33,75,24,29,53
53,8478366,Frank Vatrano,R,ANA,30,72,24,29,53
53,8482110,Dawson Mercer,C,NJD,23,73,22,31,53
53,8476905,Chandler Stephenson,C,SEA,30,73,18,35,53
53,8482124,Quinton Byfield,R,LAK,22,80,17,36,53
53,8477426,Nicholas Paul,L,TBL,29,82,28,24,52
53,8477416,Oliver Bjorkstrand,R,SEA,29,74,22,30,52
53,8480039,Martin Necas,C,CAR,25,72,20,32,52
53,8476875,Mike Matheson,D,MTL,30,77,9,43,52
53,8476399,Blake Coleman,C,CGY,33,76,25,26,51
53,8479525,Ross Colton,C,COL,28,80,25,26,51
53,8475287,Erik Haula,L,NJD,33,69,23,28,51
53,8480015,Owen Tippett,R,PHI,25,76,19,32,51
53,8475191,Reilly Smith,R,NYR,33,76,17,34,51
53,8476927,Teddy Blueger,C,VAN,30,71,12,39,51
53,8479425,Filip Hronek,D,VAN,27,78,12,39,51
53,8476432,Boone Jenner,C,CBJ,31,69,30,20,50
53,8475799,Nino Niederreiter,R,WPG,32,73,29,21,50
53,8477998,Warren Foegele,L,LAK,28,79,24,26,50
53,8482097,Jack Quinn,R,BUF,23,64,23,27,50
53,8478462,Nicolas Roy,C,VGK,27,77,23,27,50
53,8482092,Ridly Greig,C,OTT,22,77,21,29,50
53,8478542,Evan Rodrigues,C,FLA,31,76,18,32,50
53,8476906,Shayne Gostisbehere,D,CAR,31,77,13,37,50
53,8478038,Devon Toews,D,COL,30,70,9,41,50
53,8476853,Morgan Rielly,D,TOR,30,73,7,43,50
53,8478046,Danton Heinen,L,VAN,29,72,26,23,49
53,8471698,T.J. Oshie,R,WSH,38,62,20,29,49
53,8477447,Shea Theodore,D,VGK,29,60,19,30,49
53,8478042,Viktor Arvidsson,L,EDM,31,76,16,33,49
53,8484166,Adam Fantilli,C,CBJ,20,67,23,25,48
53,8476483,Rickard Rakell,R,PIT,31,67,21,27,48
53,8470613,Brent Burns,D,CAR,39,78,16,32,48
53,8478396,Noah Hanifin,D,VGK,27,65,10,38,48
53,8478055,Gustav Forsling,D,FLA,28,70,10,38,48
53,8475170,Brayden Schenn,C,STL,33,66,21,26,47
53,8483431,Logan Cooley,C,UTA,20,77,17,30,47
53,8482149,Cole Perfetti,C,WPG,22,64,16,31,47
53,8480064,Josh Norris,C,OTT,25,75,25,21,46
53,8483808,Andrei Kuzmenko,L,CGY,28,72,22,24,46
53,8474150,Mikael Backlund,C,CGY,35,75,19,27,46
53,8483505,Matthew Poitras,C,BOS,20,78,19,27,46
53,8482720,Matthew Knies,L,TOR,22,75,15,31,46
53,8476462,Dougie Hamilton,D,NJD,31,71,15,31,46
53,8482105,Jake Sanderson,D,OTT,22,72,12,34,46
53,8474590,John Carlson,D,WSH,34,74,12,34,46
53,8480817,K'Andre Miller,D,NYR,24,71,10,36,46
53,8475151,Kyle Palmieri,C,NYI,33,79,26,19,45
53,8474586,Jordan Eberle,R,SEA,34,75,23,22,45
53,8477407,Anthony Duclair,L,NYI,29,77,23,22,45
53,8480014,Gabriel Vilardi,C,WPG,25,68,22,23,45
53,8475745,Charlie Coyle,C,BOS,32,76,21,24,45
53,8481533,Trevor Zegras,C,ANA,23,69,19,26,45
53,8480078,Filip Chytil,C,NYR,25,65,19,26,45
53,8477932,Aaron Ekblad,D,FLA,28,71,17,28,45
53,8476419,Jean-Gabriel Pageau,C,NYI,32,80,17,28,45
53,8477456,J.T. Compher,L,DET,29,82,12,33,45
53,8481560,Arthur Kaliyev,R,LAK,23,81,25,19,44
53,8477429,Andrew Copp,C,DET,30,79,20,24,44
53,8481068,Yegor Sharangovich,C,CGY,26,81,20,24,44
53,8478493,Joel Eriksson Ek,C,MIN,27,67,19,25,44
53,8476882,Teuvo Teravainen,C,CHI,30,69,18,26,44
53,8477021,Alex Kerfoot,C,UTA,30,73,18,26,44
53,8480839,Rasmus Dahlin,D,BUF,24,68,12,32,44
53,8474565,Alex Pietrangelo,D,VGK,34,60,11,33,44
53,8481577,Philip Tomasino,C,NSH,23,66,11,33,44
53,8476885,Jacob Trouba,D,NYR,30,68,10,34,44
53,8479410,Mikhail Sergachev,D,UTA,26,69,8,36,44
53,8475764,Cam Fowler,D,ANA,33,70,6,38,44
53,8482159,Tyson Foerster,R,PHI,22,75,25,18,43
53,8475760,Nick Bjugstad,C,UTA,32,71,22,21,43
53,8479365,Trent Frederic,C,BOS,26,74,20,23,43
53,8484153,Leo Carlsson,C,ANA,20,72,19,24,43
53,8479661,Tanner Jeannot,L,LAK,27,78,16,27,43
53,8478397,Rasmus Andersson,D,CGY,28,72,10,33,43
53,8480188,Fabian Zetterlund,L,SJS,25,62,19,23,42
53,8479987,Morgan Geekie,C,BOS,26,78,16,26,42
53,8481604,Pavel Dorofeyev,L,VGK,24,66,15,27,42
53,8476826,Yanni Gourde,C,SEA,33,75,11,31,42
53,8477346,MacKenzie Weegar,D,CGY,30,75,9,33,42
53,8476438,Brandon Saad,L,STL,32,75,21,20,41
53,8482109,Alexis Lafrenière,L,NYR,23,77,20,21,41
53,8474149,Evgenii Dadonov,R,DAL,35,76,19,22,41
53,8481618,Alex Newhook,C,MTL,23,70,18,23,41
53,8477511,Anthony Mantha,R,CGY,30,74,17,24,41
53,8480798,Philipp Kurashev,C,CHI,25,68,14,27,41
53,8474053,Logan Couture,C,SJS,35,66,14,27,41
53,8477505,Alexander Wennberg,C,SJS,30,65,14,27,41
53,8481711,Matias Maccelli,L,UTA,24,75,13,28,41
53,8475753,Justin Faulk,D,STL,32,73,11,30,41
53,8474563,Drew Doughty,D,LAK,35,69,8,33,41
53,8480459,Pius Suter,C,VAN,28,68,20,20,40
53,8484145,Zach Benson,L,BUF,19,72,19,21,40
53,8477497,Sean Monahan,C,CBJ,30,71,18,22,40
53,8482660,Kent Johnson,C,CBJ,22,64,18,22,40
53,8480113,Alex Iafallo,L,WPG,31,63,18,22,40
53,8475722,Jason Zucker,L,BUF,32,70,17,23,40
53,8474189,Lars Eller,C,PIT,35,66,17,23,40
53,8478466,Daniel Sprong,R,VAN,27,75,16,24,40
53,8481186,Logan O'Connor,R,COL,28,79,14,26,40
53,8476292,Ondrej Palat,L,NJD,33,68,11,29,40
53,8473986,Alex Killorn,L,ANA,35,72,23,16,39
53,8477451,Ryan Hartman,R,MIN,30,72,19,20,39
53,8481523,Kirby Dach,C,MTL,23,67,12,27,39
53,8482712,Oskar Olausson,R,COL,22,81,9,30,39
53,8471724,Kris Letang,D,PIT,37,80,8,31,39
53,8481542,Moritz Seider,D,DET,23,70,7,32,39
53,8480434,Sean Durzi,D,UTA,26,70,7,32,39
53,8476880,Tom Wilson,R,WSH,30,68,14,24,38
53,8479999,Casey Mittelstadt,C,COL,26,78,10,28,38
53,8476869,Brady Skjei,D,NSH,30,75,9,29,38
53,8476958,Jaccob Slavin,D,CAR,30,74,7,31,38
53,8476392,Adam Lowry,C,WPG,31,66,20,17,37
53,8476981,Josh Anderson,R,MTL,30,71,18,19,37
53,8481554,Kaapo Kakko,R,NYR,23,75,18,19,37
53,8478463,Anthony Beauvillier,L,PIT,27,70,16,21,37
53,8473422,Nick Foligno,L,CHI,37,61,13,24,37
53,8478474,Lawson Crouse,L,UTA,27,74,24,12,36
53,8478109,Victor Olofsson,L,VGK,29,72,20,16,36
53,8479992,Michael Rasmussen,C,DET,25,81,16,20,36
53,8480849,Barrett Hayton,C,UTA,24,74,13,23,36
53,8478472,Mathieu Joseph,R,STL,27,67,12,24,36
53,8480028,Morgan Frost,C,PHI,25,76,8,28,36
53,8478500,Ivan Provorov,D,CBJ,27,76,4,32,36
53,8482055,Drew O'Connor,L,PIT,26,65,20,15,35
53,8480009,Eeli Tolvanen,R,SEA,25,65,18,17,35
53,8475793,Ryan Johansen,C,PHI,32,74,13,22,35
53,8481524,Bowen Byram,D,BUF,23,71,12,23,35
53,8478911,Matt Roy,D,WSH,29,65,8,27,35
53,8477969,Marcus Pettersson,D,PIT,28,77,5,30,35
53,8478882,Vladislav Gavrikov,D,LAK,29,69,4,31,35
53,8482702,Logan Stankoven,C,DAL,21,76,18,16,34
53,8482175,JJ Peterka,R,BUF,22,64,17,17,34
53,8470621,Corey Perry,R,EDM,39,67,17,17,34
53,8476474,Stefan Noesen,R,NJD,31,62,16,18,34
53,8477987,Ryan Donato,C,CHI,28,59,14,20,34
53,8479591,Michael Eyssimont,C,TBL,28,81,13,21,34
53,8476458,Ryan Strome,C,ANA,31,71,11,23,34
53,8475848,Brendan Gallagher,R,MTL,32,72,10,24,34
53,8475171,Oliver Ekman-Larsson,D,TOR,33,59,8,26,34
53,8482122,Brock Faber,D,MIN,22,78,2,32,34
53,8476918,Jimmy Vesey,L,NYR,31,63,26,7,33
53,8476925,Colton Sissons,C,NSH,31,67,13,20,33
53,8478891,Mason Appleton,C,WPG,28,61,12,21,33
53,8475218,Mattias Ekholm,D,EDM,34,79,11,22,33
53,8481581,Thomas Harley,D,DAL,23,74,7,26,33
53,8479339,Patrik Laine,L,CBJ,26,62,7,26,33
53,8476917,Adam Pelech,D,NYI,30,78,5,28,33
53,8480893,Kirill Marchenko,R,CBJ,24,60,22,10,32
53,8482475,Yegor Chinakhov,R,CBJ,23,65,19,13,32
53,8475314,Anders Lee,L,NYI,34,80,18,14,32
53,8475763,Kevin Hayes,R,PIT,32,66,11,21,32
53,8477479,Tyler Bertuzzi,L,CHI,29,58,11,21,32
53,8478434,Keegan Kolesar,R,VGK,27,71,10,22,32
53,8476921,Jordan Martinook,L,CAR,32,64,9,23,32
53,8480145,Neal Pionk,D,WPG,29,69,9,23,32
53,8476854,Hampus Lindholm,D,BOS,30,80,6,26,32
53,8477488,Brett Pesce,D,NJD,30,69,6,26,32
53,8479619,Michael Carcone,L,UTA,28,60,25,6,31
53,8480068,Ryan Poehling,C,PHI,25,71,19,12,31
53,8482667,William Eklund,L,SJS,22,62,18,13,31
53,8475714,Calle Jarnkrok,C,TOR,33,75,17,14,31
53,8480813,Joe Veleno,C,DET,24,78,16,15,31
53,8480835,Jack Drury,C,CAR,24,60,13,18,31
53,8481553,Bobby Brink,R,PHI,23,70,11,20,31
53,8476480,Vladislav Namestnikov,C,WPG,32,73,11,20,31
53,8478469,Thomas Chabot,D,OTT,27,66,9,22,31
53,8479976,Juuso Valimaki,D,UTA,26,64,9,22,31
53,8476422,Mike Reilly,D,NYI,31,69,9,22,31
53,8476923,Damon Severson,D,CBJ,30,77,3,28,31
53,8481703,Valtteri Puustinen,R,PIT,25,65,3,28,31
53,8480797,Joel Farabee,L,PHI,24,77,15,15,30
53,8478115,Pierre Engvall,L,NYI,28,79,13,17,30
53,8476461,Sean Couturier,C,PHI,32,70,12,18,30
53,8479400,Pierre-Luc Dubois,L,WSH,26,65,11,19,30
53,8480220,Noah Cates,L,PHI,25,71,11,19,30
53,8482133,Thomas Bordeleau,C,SJS,22,65,11,19,30
53,8480003,Jesper Boqvist,C,FLA,26,64,10,20,30
53,8477948,Travis Sanheim,D,PHI,28,69,3,27,30
53,8481535,Nils Hoglander,L,VAN,24,62,20,9,29
53,8482259,Bobby McMann,C,TOR,28,63,17,12,29
53,8478020,Michael Amadio,R,OTT,28,76,16,13,29
53,8479390,Taylor Raddysh,R,WSH,26,70,15,14,29
53,8480144,David Kampf,C,TOR,29,72,12,17,29
53,8475231,Casey Cizikas,C,NYI,33,71,12,17,29
53,8482117,Lukas Reichel,L,CHI,22,57,12,17,29
53,8478233,Andrew Mangiapane,L,WSH,28,68,11,18,29
53,8479293,Brandon Tanev,L,SEA,33,63,11,18,29
53,8481656,Aliaksei Protas,C,WSH,23,64,6,23,29
53,8478057,Dakota Joshua,C,VAN,28,61,16,12,28
53,8476278,Colin Blackwell,C,DAL,31,78,15,13,28
53,8479996,Cody Glass,C,NSH,25,65,13,15,28
53,8476792,Torey Krug,D,STL,33,72,11,17,28
53,8480829,Jesperi Kotkaniemi,C,CAR,24,65,10,18,28
53,8481582,Nicholas Robertson,L,TOR,23,69,9,19,28
53,8477989,Christian Dvorak,C,MTL,28,66,6,22,28
53,8483490,Pavel Mintyukov,D,ANA,21,76,6,22,28
53,8482655,Janis Moser,D,TBL,24,78,5,23,28
53,8480873,Rasmus Sandin,D,WSH,24,71,2,26,28
53,8482089,Jake Neighbours,L,STL,22,68,15,12,27
53,8479353,Brett Howden,C,VGK,26,68,14,13,27
53,8480789,Oliver Wahlstrom,R,NYI,24,70,14,13,27
53,8477947,Sonny Milano,L,WSH,28,64,13,14,27
53,8476469,Joel Armia,R,MTL,31,60,12,15,27
53,8478458,John (Jack) Roslovic,C,CAR,27,73,10,17,27
53,8480871,Adam Boqvist,D,FLA,24,65,9,18,27
53,8479351,Sam Steel,C,DAL,26,82,9,18,27
53,8473507,Jeff Petry,D,DET,37,69,2,25,27
53,8477952,Robby Fabbri,C,ANA,28,63,15,11,26
53,8480289,Morgan Barron,C,WPG,26,57,15,11,26
53,8479414,Nathan Bastian,R,NJD,27,62,14,12,26
53,8482125,Alexander Holtz,R,VGK,22,70,13,13,26
53,8484203,Bradly Nadeau,L,CAR,19,69,13,13,26
53,8482737,Zack Bolduc,C,STL,21,54,13,13,26
53,8480185,Eetu Luostarinen,C,FLA,26,74,11,15,26
53,8476873,Mark Jankowski,C,NSH,30,51,11,15,26
53,8477495,Seth Jones,D,CHI,30,64,9,17,26
53,8477839,Conor Sheary,L,TBL,32,81,9,17,26
53,8481704,Juuso Parssinen,C,NSH,23,65,9,17,26
53,8475149,Marcus Johansson,L,MIN,34,66,6,20,26
53,8483499,Liam Ohgren,L,MIN,20,53,6,20,26
53,8475690,Chris Tanev,D,TOR,35,60,4,22,26
53,8476891,Matthew Grzelcyk,D,PIT,30,75,4,22,26
53,8481014,Alexander Romanov,D,NYI,24,74,3,23,26
53,8477425,Miles Wood,L,COL,29,74,16,9,25
53,8482146,Luke Evangelista,R,NSH,22,62,15,10,25
53,8483524,Shane Wright,C,SEA,20,62,14,11,25
53,8480762,Eric Robinson,L,CAR,29,58,13,12,25
53,8482705,Cole Sillinger,C,CBJ,21,67,12,13,25
53,8474716,Jared Spurgeon,D,MIN,35,76,10,15,25
53,8475200,Dmitry Orlov,D,CAR,33,74,8,17,25
53,8477953,Kasperi Kapanen,R,STL,28,66,7,18,25
53,8479402,Jake Bean,D,CGY,26,62,6,19,25
53,8482451,Mikael Pyyhtia,L,CBJ,23,43,5,20,25
53,8478851,Alexandre Carrier,D,NSH,28,63,4,21,25
53,8477506,Ryan Pulock,D,NYI,30,76,3,22,25
53,8474574,Tyler Myers,D,VAN,34,71,2,23,25
53,8476879,Cody Ceci,D,EDM,31,69,2,23,25
53,8477919,Frederick Gaudreau,C,MIN,31,60,16,8,24
53,8475343,Nic Dowd,C,WSH,34,63,12,12,24
53,8475193,Tomas Tatar,L,NJD,34,64,11,13,24
53,8480802,Ryan McLeod,C,BUF,25,68,10,14,24
53,8483445,Cutter Gauthier,L,ANA,20,61,10,14,24
53,8481093,Rafael Harvey-Pinard,L,MTL,25,59,10,14,24
53,8482671,Owen Power,D,BUF,22,69,9,15,24
53,8479393,Noah Gregor,L,OTT,26,68,9,15,24
53,8481624,Ilya Mikheyev,R,CHI,30,55,9,15,24
53,8475233,David Savard,D,MTL,34,71,8,16,24
53,8477979,Nicolas Aube-Kubel,R,BUF,28,54,8,16,24
53,8482634,Alex Steeves,C,TOR,25,52,8,16,24
53,8480748,Kiefer Sherwood,L,VAN,29,62,7,17,24
53,8476872,Scott Laughton,C,PHI,30,68,6,18,24
53,8474151,Ryan McDonagh,D,TBL,35,81,6,18,24
53,8480878,Nils Lundkvist,D,DAL,24,73,4,20,24
53,8476525,Colin Miller,D,WPG,32,66,3,21,24
53,8477507,Nikita Zadorov,D,BOS,29,67,2,22,24
53,8475181,Nick Leddy,D,STL,33,69,2,22,24
53,8480043,Timothy Liljegren,D,TOR,25,70,1,23,24
53,8479315,Joey Anderson,R,CHI,26,55,12,11,23
53,8481481,Blake Lizotte,C,PIT,27,60,11,12,23
53,8482074,Connor Zary,C,CGY,23,59,11,12,23
53,8473533,Jordan Staal,C,CAR,36,57,10,13,23
53,8480855,Jack McBain,C,UTA,24,69,7,16,23
53,8476892,Colton Parayko,D,STL,31,70,4,19,23
53,8476457,Adam Larsson,D,SEA,32,66,3,20,23
53,8482155,Alex Laferriere,R,LAK,23,63,14,8,22
53,8478211,Dryden Hunt,L,CGY,29,61,14,8,22
53,8478413,Jordan Greenway,L,BUF,27,67,12,10,22
53,8482079,Marco Rossi,C,MIN,23,57,11,11,22
53,8474034,Patrick Maroon,L,CHI,36,55,8,14,22
53,8475791,Taylor Hall,L,CHI,33,59,8,14,22
53,8481606,Jordan Spence,D,LAK,23,58,8,14,22
53,8476902,Esa Lindell,D,DAL,30,76,8,14,22
53,8478133,Jake Evans,C,MTL,28,67,7,15,22
53,8482101,Danil Gushchin,L,SJS,22,56,6,16,22
53,8483468,Jiri Kulich,C,BUF,20,58,5,17,22
53,8479982,Conor Timmins,D,TOR,26,59,4,18,22
53,8482073,Braden Schneider,D,NYR,23,68,4,18,22
53,8481441,Joe Snively,C,DET,28,67,4,18,22
53,8480073,Erik Brannstrom,D,COL,25,58,3,19,22
53,8478970,Jalen Chatfield,D,CAR,28,71,2,20,22
53,8482157,Will Cuylle,L,NYR,22,54,11,10,21
53,8477353,Tyler Motte,C,DET,29,70,11,10,21
53,8481032,Paul Cotter,C,NJD,25,66,10,11,21
53,8481751,Lukas Rousek,R,BUF,25,43,10,11,21
53,8477931,Tomas Nosek,L,FLA,32,65,10,11,21
53,8483457,Lane Hutson,D,MTL,20,68,9,12,21
53,8475220,Marcus Foligno,L,MIN,33,60,8,13,21
53,8476960,Andreas Athanasiou,C,CHI,30,48,8,13,21
53,8483565,Nick Blankenburg,D,NSH,26,61,8,13,21
53,8476988,Matt Benning,D,SJS,30,63,8,13,21
53,8476312,Josh Manson,D,COL,33,64,8,13,21
53,8480246,Nick Perbix,D,TBL,26,76,5,16,21
53,8475279,Ben Chiarot,D,DET,33,65,5,16,21
53,8481527,Kaedan Korczak,D,VGK,23,47,5,16,21
53,8479026,Philippe Myers,D,TOR,27,60,5,16,21
53,8482067,Connor Mackey,D,NYR,28,59,5,16,21
53,8480001,Urho Vaakanainen,D,ANA,25,59,4,17,21
53,8479369,Andrew Peeke,D,BOS,26,65,3,18,21
53,8482730,Brandt Clarke,D,LAK,21,49,3,18,21
53,8476979,Erik Gustafsson,D,DET,32,73,2,19,21
53,8475324,Nick Jensen,D,OTT,34,62,2,19,21
53,8479368,Max Jones,L,BOS,26,67,13,7,20
53,8481601,Simon Holmstrom,R,NYI,23,68,13,7,20
53,8479439,Jacob MacDonald,D,COL,31,51,12,8,20
53,8481580,Connor McMichael,C,WSH,23,62,11,9,20
53,8476897,Oskar Sundqvist,C,STL,30,66,9,11,20
53,8474715,Cameron Atkinson,R,TBL,35,79,9,11,20
53,8477015,Connor Brown,R,EDM,30,62,9,11,20
53,8478178,Darren Raddysh,D,TBL,28,70,9,11,20
53,8473563,Nicklas Backstrom,C,WSH,37,58,9,11,20
53,8481517,Brett Leason,R,ANA,25,60,9,11,20
53,8482749,Joshua Roy,R,MTL,21,66,8,12,20
53,8482803,Olen Zellweger,D,ANA,21,64,6,14,20
53,8476329,Travis Boyd,C,MIN,31,57,6,14,20
53,8479983,Mario Ferraro,D,SJS,26,70,6,14,20
53,8480336,Sean Walker,D,CAR,30,66,5,15,20
53,8480172,Jan Rutta,D,SJS,34,67,2,18,20
53,8477478,William Carrier,L,CAR,30,58,11,8,19
53,8479941,Justin Danforth,R,CBJ,31,56,10,9,19
53,8477392,Hudson Fasching,R,NYI,29,63,9,10,19
53,8477406,Mattias Janmark,C,EDM,32,69,9,10,19
53,8481028,Martin Pospisil,C,CGY,25,65,8,11,19
53,8476878,Zemgus Girgensons,C,TBL,30,80,7,12,19
53,8480806,Isac Lundestrom,C,ANA,25,58,7,12,19
53,8482809,Jackson Blake,R,CAR,21,57,5,14,19
53,8482111,Justin Barron,D,MTL,23,60,5,14,19
53,8475188,Brayden McNabb,D,VGK,33,57,5,14,19
53,8478416,Erik Cernak,D,TBL,27,74,4,15,19
53,8477845,Trevor van Riemsdyk,D,WSH,33,59,3,16,19
53,8475790,Erik Gudbranson,D,CBJ,32,78,3,16,19
53,8482087,Kaiden Guhle,D,MTL,22,64,2,17,19
53,8479398,Samuel Girard,D,COL,26,68,2,17,19
53,8476931,Jake McCabe,D,TOR,31,64,2,17,19
53,8481477,Nico Sturm,C,SJS,29,57,12,6,18
53,8482062,Cole Smith,L,NSH,29,57,10,8,18
53,8479066,Ryan Lomberg,L,CGY,30,63,9,9,18
53,8478432,Christian Fischer,R,DET,27,74,9,9,18
53,8476624,Barclay Goodrow,C,SJS,31,54,9,9,18
53,8480025,MacKenzie Entwistle,R,FLA,25,60,8,10,18
53,8482624,Daniil Miromanov,D,CGY,27,69,7,11,18
53,8480021,Jack Studnicka,C,LAK,25,65,7,11,18
53,8477018,Ben Hutton,D,VGK,31,52,6,12,18
53,8482142,Jamie Drysdale,D,PHI,22,65,4,14,18
53,8479998,Mikey Anderson,D,LAK,25,71,3,15,18
53,8473446,Erik Johnson,D,PHI,36,49,3,15,18
53,8476463,Jonas Brodin,D,MIN,31,77,2,16,18
53,8480049,Dylan Samberg,D,WPG,25,68,0,18,18
53,8477450,Jason Dickinson,C,CHI,29,54,13,4,17
53,8478452,Caleb Jones,D,LAK,27,56,10,7,17
53,8476934,Brock McGinn,L,ANA,30,45,10,7,17
53,8479718,Alex Barré-Boulet,C,MTL,27,50,8,9,17
53,8481754,Nikita Nesterenko,C,ANA,23,44,8,9,17
53,8478136,Jake Middleton,D,MIN,28,76,5,12,17
53,8478443,Brandon Carlo,D,BOS,28,55,5,12,17
53,8477365,Connor Clifton,D,BUF,29,55,3,14,17
53,8476429,Scott Mayfield,D,NYI,32,75,3,14,17
53,8476374,Sean Kuraly,C,CBJ,31,61,2,15,17
53,8476467,Jamie Oleksiak,D,SEA,32,70,1,16,17
53,8480222,Sebastian Aho,D,PIT,28,68,1,16,17
53,8475179,Dmitry Kulikov,D,FLA,34,60,1,16,17
53,8479371,Dante Fabbro,D,NSH,26,61,1,16,17
53,8480281,Alexey Toropchenko,R,STL,25,56,14,2,16
53,8480448,Parker Kelly,L,COL,25,73,9,7,16
53,8479671,Mathieu Olivier,R,CBJ,27,47,9,7,16
53,8480995,Pontus Holmberg,R,TOR,25,55,8,8,16
53,8482807,Ethan Del Mastro,D,CHI,21,52,8,8,16
53,8476889,Radek Faksa,C,STL,30,61,8,8,16
53,8479370,Tyson Jost,C,CAR,26,50,8,8,16
53,8477482,Zachary Sanford,L,CHI,30,36,8,8,16
53,8475842,Sam Carrick,C,NYR,32,60,7,9,16
53,8481161,Jake Christiansen,D,CBJ,25,64,7,9,16
53,8480252,Cole Guttman,C,CHI,25,39,7,9,16
53,8473453,Trevor Lewis,C,LAK,37,71,6,10,16
53,8483491,Ivan Miroshnichenko,L,WSH,20,53,6,10,16
53,8480980,Connor Dewar,C,TOR,25,66,6,10,16
53,8477220,Nate Schmidt,D,FLA,33,61,5,11,16
53,8481546,Cam York,D,PHI,23,65,4,12,16
53,8477435,Ryan Graves,D,PIT,29,78,4,12,16
53,8482245,Artem Zub,D,OTT,29,71,2,14,16
53,8474673,TJ Brodie,D,CHI,34,55,2,14,16
53,8480891,Michael Kesselring,D,UTA,24,55,2,14,16
53,8478399,Jonas Siegenthaler,D,NJD,27,58,2,14,16
53,8478507,John Marino,D,UTA,27,61,1,15,16
53,8480807,Mattias Samuelsson,D,BUF,24,63,1,15,16
53,8471817,Ryan Reaves,R,TOR,37,55,13,2,15
53,8483482,Tristan Luneau,D,ANA,20,64,10,5,15
53,8478421,A.J. Greer,L,FLA,28,56,9,6,15
53,8480205,Emil Bemstrom,C,PIT,25,59,7,8,15
53,8484149,Gavin Brindley,C,CBJ,20,46,7,8,15
53,8480074,Alexandre Texier,C,STL,25,58,6,9,15
53,8479344,Jesse Puljujarvi,R,PIT,26,47,6,9,15
53,8477903,Garnet Hathaway,R,PHI,33,64,5,10,15
53,8480796,Martin Fehervary,D,WSH,25,53,5,10,15
53,8476442,Matt Nieto,L,PIT,32,46,5,10,15
53,8480860,Kevin Bahl,D,CGY,24,54,3,12,15
53,8480035,Henri Jokiharju,D,BUF,25,62,2,13,15
53,8475208,Brian Dumoulin,D,ANA,33,62,2,13,15
53,8481567,Henry Thrun,D,SJS,23,50,1,14,15
53,8476331,Dylan DeMelo,D,WPG,31,71,0,15,15
53,8482077,Dylan Holloway,L,EDM,23,55,11,3,14
53,8480848,Ty Dellandrea,C,SJS,24,45,8,6,14
53,8477380,Jonny Brodzinski,C,NYR,31,51,8,6,14
53,8482148,Hendrix Lapierre,C,WSH,22,52,8,6,14
53,8475855,Jesper Fast,R,CAR,33,58,7,7,14
53,8476952,Dominic Toninato,C,WPG,30,38,6,8,14
53,8478013,Jake Walman,D,SJS,28,69,5,9,14
53,8477369,Carson Soucy,D,VAN,30,60,5,9,14
53,8479336,Carl Grundstrom,R,SJS,27,57,5,9,14
53,8479359,Beck Malenstyn,L,BUF,26,51,5,9,14
53,8481641,Joel Kiviranta,L,COL,28,73,5,9,14
53,8478840,Will Borgen,D,SEA,28,57,4,10,14
53,8477508,Curtis Lazar,C,NJD,29,58,4,10,14
53,8477573,Nathan Walker,L,STL,30,48,4,10,14
53,8476874,Olli Maatta,D,DET,30,59,3,11,14
53,8476967,Brett Kulak,D,EDM,30,56,1,13,14
53,8479639,Dylan Coghlan,D,WPG,26,66,0,14,14
53,8478508,Yakov Trenin,C,MIN,27,58,8,5,13
53,8482784,Zach Dean,C,STL,21,51,7,6,13
53,8481522,Peyton Krebs,C,BUF,23,50,6,7,13
53,8477070,Liam O'Brien,C,UTA,30,52,6,7,13
53,8479986,Kole Lind,R,DAL,26,48,6,7,13
53,8476856,Mathew Dumba,D,DAL,30,72,5,8,13
53,8478043,Sam Lafferty,C,BUF,29,55,5,8,13
53,8482659,Josh Doan,R,UTA,22,52,5,8,13
53,8474567,Zach Bogosian,D,MIN,34,65,5,8,13
53,8476994,Vinnie Hinostroza,C,NSH,30,45,4,9,13
53,8482176,Wyatt Kaiser,D,CHI,22,51,4,9,13
53,8483466,Kevin Korchinski,D,CHI,20,53,4,9,13
53,8480441,Trey Fix-Wolansky,R,CBJ,25,42,4,9,13
53,8483493,Frank Nazar,C,CHI,20,49,2,11,13
53,8480011,Klim Kostin,C,SJS,25,47,2,11,13
53,8481178,Egor Zamula,D,PHI,24,55,2,11,13
53,8481599,Victor Soderstrom,D,UTA,23,45,2,11,13
53,8481708,Zac Jones,D,NYR,24,56,1,12,13
53,8479328,Julien Gauthier,R,NYI,27,60,7,5,12
53,8482679,Matt Coronato,R,CGY,22,60,6,6,12
53,8478569,Noel Acciari,C,PIT,33,55,6,6,12
53,8479994,Jaret Anderson-Dolan,C,WPG,25,42,6,6,12
53,8481147,Reese Johnson,C,MIN,26,46,6,6,12
53,8480727,Zach Whitecloud,D,VGK,28,50,5,7,12
53,8479316,Luke Kunin,C,SJS,27,51,4,8,12
53,8482166,Shakir Mukhamadullin,D,SJS,22,59,4,8,12
53,8477499,Rasmus Ristolainen,D,PHI,30,53,4,8,12
53,8477335,Kyle Burroughs,D,LAK,29,46,3,9,12
53,8475718,Justin Holl,D,DET,32,63,3,9,12
53,8475462,Radko Gudas,D,ANA,34,64,2,10,12
53,8482192,Isaak Phillips,D,CHI,23,54,1,11,12
53,8479638,Justin Brazeau,R,BOS,26,41,8,3,11
53,8481568,Alex Vlasic,D,CHI,23,49,6,5,11
53,8482496,Nils Aman,C,VAN,24,44,6,5,11
53,8479543,Michael Pezzetta,L,MTL,26,59,5,6,11
53,8481617,Vasily Podkolzin,R,VAN,23,45,5,6,11
53,8476822,Luke Glendening,C,TBL,35,79,4,7,11
53,8477446,Michael McCarron,R,NSH,29,52,4,7,11
53,8479324,Ryan Lindgren,D,NYR,26,61,4,7,11
53,8477962,Brendan Lemieux,L,CAR,28,43,4,7,11
53,8480157,Calle Rosen,D,COL,30,43,4,7,11
53,8481701,Santeri Hatakka,D,NJD,23,46,3,8,11
53,8482964,Arber Xhekaj,D,MTL,23,46,3,8,11
53,8480950,Ilya Lyubushkin,D,DAL,30,61,2,9,11
53,8470600,Ryan Suter,D,STL,39,58,2,9,11
53,8480058,Pierre-Olivier Joseph,D,STL,25,52,2,9,11
53,8481167,Brayden Pachal,D,CGY,25,41,2,9,11
53,8481059,Scott Perunovich,D,STL,26,56,1,10,11
53,8479378,Logan Stanley,D,WPG,26,42,1,10,11
53,8481556,John Beecher,C,BOS,23,36,7,3,10
53,8481716,Dmitri Voronkov,L,CBJ,24,40,6,4,10
53,8482652,Walker Duehr,R,CGY,27,41,6,4,10
53,8482751,Ryan Winterton,C,SEA,21,40,6,4,10
53,8479520,Brandon Duhaime,R,WSH,27,56,5,5,10
53,8481550,Adam Beckman,L,NJD,23,42,5,5,10
53,8479536,Axel Jonsson-Fjallby,L,WPG,26,35,4,6,10
53,8482744,James Malatesta,L,CBJ,21,44,3,7,10
53,8483495,Simon Nemec,D,NJD,20,52,3,7,10
53,8482747,Brennan Othmann,L,NYR,21,42,3,7,10
53,8479249,Andrew Poturalski,C,SJS,30,40,3,7,10
53,8478468,Jeremy Lauzon,D,NSH,27,51,2,8,10
53,8478451,Ethan Bear,D,WSH,27,42,2,8,10
53,8474013,Ian Cole,D,UTA,35,50,2,8,10
53,8475455,Brenden Dillon,D,NJD,34,66,1,9,10
53,8479442,Troy Stecher,D,EDM,30,54,1,9,10
53,8475750,Jon Merrill,D,MIN,32,61,1,9,10
53,8476858,Phillip Di Giuseppe,L,VAN,31,36,7,2,9
53,8478585,Derek Ryan,C,EDM,38,61,6,3,9
53,8481532,Alex Turcotte,C,LAK,23,43,5,4,9
53,8482713,Mackie Samoskevich,R,FLA,22,39,5,4,9
53,8478859,Niko Mikkola,D,FLA,28,58,4,5,9
53,8480192,Johnathan Kovacevic,D,NJD,27,48,4,5,9
53,8479367,William Lockwood,R,FLA,26,28,4,5,9
53,8481521,Ronnie Attard,D,PHI,25,55,3,6,9
53,8479972,Mason Shaw,C,WPG,26,36,3,6,9
53,8479372,Joshua Mahura,D,SEA,26,60,2,7,9
53,8480845,Rasmus Kupari,C,WPG,24,31,2,7,9
53,8477851,Jordan Oesterle,D,BOS,32,37,2,7,9
53,8482666,Scott Morrow,D,CAR,22,52,2,7,9
53,8484254,Akito Hirose,D,VAN,25,35,2,7,9
53,8481056,Spencer Stastney,D,NSH,24,39,2,7,9
53,8474612,Travis Hamonic,D,OTT,34,48,2,7,9
53,8474062,Riley Nash,C,NYR,35,25,2,7,9
53,8480070,Ian Mitchell,D,BOS,25,45,1,8,9
53,8474090,Brendan Smith,D,DAL,35,48,1,8,9
53,8477384,Joshua Brown,D,EDM,30,44,1,8,9
53,8478454,Noah Juulsen,D,VAN,27,29,1,8,9
53,8479980,Nicolas Hague,D,VGK,26,48,0,9,9
53,8482762,Simon Edvinsson,D,DET,21,56,6,2,8
53,8477887,Patrick Brown,C,BOS,32,52,6,2,8
53,8481789,Tye Kartye,L,SEA,23,42,5,3,8
53,8475235,Nicolas Deslauriers,L,PHI,33,52,5,3,8
53,8483619,Filip Roos,D,OTT,25,40,5,3,8
53,8479772,Zack MacEwen,R,OTT,28,52,4,4,8
53,8477938,Haydn Fleury,D,WPG,28,35,4,4,8
53,8478424,Jansen Harkins,C,ANA,27,39,4,4,8
53,8475762,Derek Forbort,D,VAN,32,51,4,4,8
53,8479291,Kevin Rooney,C,CGY,31,51,3,5,8
53,8481013,Jonatan Berggren,R,DET,24,54,3,5,8
53,8476913,Devin Shore,C,MIN,30,32,3,5,8
53,8481605,Jackson LaCombe,D,ANA,23,33,3,5,8
53,8475225,Craig Smith,C,CHI,35,46,2,6,8
53,8474166,Alec Martinez,D,CHI,37,59,2,6,8
53,8478017,Mark Friedman,D,VAN,29,43,2,6,8
53,8478450,Parker Wotherspoon,D,BOS,27,34,2,6,8
53,8481592,Jakob Pelletier,L,CGY,23,34,2,6,8
53,8477527,Ross Johnston,L,ANA,30,33,2,6,8
53,8483012,Logan Morrison,C,SEA,22,35,2,6,8
53,8483460,David Jiricek,D,CBJ,21,58,1,7,8
53,8480844,Grigori Denisenko,L,VGK,24,28,1,7,8
53,8474568,Luke Schenn,D,NSH,35,51,0,8,8
53,8484911,Collin Graf,R,SJS,22,37,6,1,7
53,8479968,Vinni Lettieri,C,BOS,29,54,5,2,7
53,8479944,Zach Aston-Reese,C,VGK,30,53,4,3,7
53,8480990,Declan Chisholm,D,MIN,24,34,4,3,7
53,8481609,Vladislav Kolyachonok,D,UTA,23,35,4,3,7
53,8477244,Chad Ruhwedel,D,NYR,34,28,4,3,7
53,8471709,Marc-Edouard Vlasic,D,SJS,37,58,3,4,7
53,8478831,Kevin Stenlund,C,UTA,28,57,3,4,7
53,8482177,Marat Khusnutdinov,C,MIN,22,35,2,5,7
53,8480292,Carson Meyer,R,ANA,27,35,2,5,7
53,8479348,Kale Clague,D,BUF,26,30,1,6,7
53,8476372,Nick Seeler,D,PHI,31,49,1,6,7
53,8480007,Jonas Rondbjerg,R,VGK,25,35,1,6,7
53,8476473,Connor Murphy,D,CHI,31,38,1,6,7
53,8480880,Jakub Lauko,C,MIN,24,30,4,2,6
53,8481518,Nolan Foote,L,NJD,24,36,4,2,6
53,8482172,Landon Slaggert,L,CHI,22,33,4,2,6
53,8475958,Michael Sgarbossa,C,WSH,32,27,3,3,6
53,8482859,Zack Ostapchuk,C,OTT,21,56,3,3,6
53,8482765,Isak Rosen,R,BUF,21,28,3,3,6
53,8481019,David Gustafsson,C,WPG,24,45,2,4,6
53,8477462,Robert Hagg,D,VGK,29,29,2,4,6
53,8482861,Vincent Iorio,D,WSH,22,30,2,4,6
53,8480870,Bo Groulx,C,NYR,24,35,2,4,6
53,8478021,William Lagesson,D,DET,28,37,2,4,6
53,8481537,Nikita Okhotiuk,D,CGY,24,51,1,5,6
53,8481600,Tobias Bjornfot,D,FLA,23,46,1,5,6
53,8479576,Vincent Desharnais,D,VAN,28,32,1,5,6
53,8482733,Logan Mailloux,D,MTL,31,41,1,5,6
53,8475177,Calvin de Haan,D,COL,33,44,0,6,6
53,8481679,Maxence Guenette,D,OTT,23,35,4,1,5
53,8483763,Maksymilian Szuber,D,UTA,22,42,4,1,5
53,8478409,Anthony Richard,C,PHI,28,24,4,1,5
53,8477401,John Hayden,C,SEA,29,33,3,2,5
53,8482145,Mavrik Bourque,C,DAL,22,56,3,2,5
53,8484258,Sam Malinski,D,COL,26,24,3,2,5
53,8482144,Jack Thompson,D,SJS,22,27,3,2,5
53,8480355,Mark Kastelic,C,BOS,25,54,2,3,5
53,8480887,Jordan Harris,D,MTL,24,49,2,3,5
53,8478502,Dennis Gilbert,D,BUF,28,18,2,3,5
53,8482070,Mitchell Chaffee,R,TBL,26,50,2,3,5
53,8482118,Sam Colangelo,R,ANA,23,12,2,3,5
53,8482470,Ilya Solovyov,D,CGY,24,22,2,3,5
53,8480245,Olle Lycksell,R,PHI,25,28,2,3,5
53,8480879,Jacob Bernard-Docker,D,OTT,24,50,1,4,5
53,8481598,Philip Broberg,D,EDM,23,46,1,4,5
53,8471677,Jack Johnson,D,CBJ,37,61,1,4,5
53,8480196,Jacob Bryson,D,BUF,27,48,1,4,5
53,8476441,Joel Edmundson,D,LAK,31,37,0,5,5
53,8481543,Nikita Alexandrov,C,STL,24,22,3,1,4
53,8482141,Lukas Cormier,D,VGK,22,24,2,2,4
53,8481030,Jack St. Ivany,D,PIT,25,17,2,2,4
53,8481237,Kyle MacLean,C,NYI,25,18,2,2,4
53,8483549,Lucas Condotta,L,MTL,27,34,2,2,4
53,8477149,Scott Sabourin,R,SJS,32,16,2,2,4
53,8483512,Matthew Savoie,C,EDM,20,15,1,3,4
53,8478874,Adam Gaudette,R,OTT,28,30,1,3,4
53,8482095,Tyler Kleven,D,OTT,22,48,0,4,4
53,8476867,Brendan Gaunce,C,MIN,30,39,0,4,4
53,8480834,Ty Emberson,D,SJS,24,29,0,4,4
53,8477810,Joel Hanley,D,CGY,33,24,0,4,4
53,8481699,Aku Raty,R,UTA,23,16,0,4,4
53,8482147,Jean-Luc Foudy,C,COL,22,29,3,0,3
53,8483570,Ben Meyers,C,SEA,26,20,3,0,3
53,8483432,Luca Del Bel Belluz,C,CBJ,31,7,3,0,3
53,8477467,Gustav Olofsson,D,SEA,30,26,2,1,3
53,8481593,Jayden Struble,D,MTL,23,16,2,1,3
53,8481462,Mason Morelli,L,VGK,28,15,2,1,3
53,8481043,Cole Koepke,L,BOS,26,16,2,1,3
53,8482102,Vasily Ponomarev,C,PIT,22,18,2,1,3
53,8480032,Shane Bowers,C,NJD,25,12,2,1,3
53,8475413,Justin Dowling,C,NJD,34,17,2,1,3
53,8479981,Jonah Gadjovich,L,FLA,26,45,1,2,3
53,8479320,Maxime Lajoie,D,SEA,27,23,1,2,3
53,8475795,Dylan McIlrath,D,WSH,32,16,1,2,3
53,8481743,Marc Del Gaizo,D,NSH,25,16,1,2,3
53,8481422,Jake Lucchini,C,NSH,29,19,1,2,3
53,8478051,Max Willman,C,NJD,29,18,1,2,3
53,8480267,Sammy Walker,C,MIN,25,13,1,2,3
53,8482165,Yan Kuznetsov,D,CGY,22,22,1,2,3
53,8481006,Tyler Tucker,D,STL,24,18,1,2,3
53,8483398,Declan Carlile,D,TBL,31,6,1,2,3
53,8483489,Fraser Minten,C,TOR,31,11,1,2,3
53,8479379,Givani Smith,R,SJS,26,29,0,3,3
53,8483630,Pavol Regenda,L,ANA,25,29,0,3,3
53,8479985,Cale Fleury,D,SEA,26,25,0,3,3
53,8480084,Nick DeSimone,D,NJD,30,13,0,3,3
53,8479587,Rhett Gardner,C,PHI,28,12,0,3,3
53,8482929,Emil Lilleberg,D,TBL,23,18,0,3,3
53,8477034,Jaycob Megna,D,FLA,32,43,2,0,2
53,8478011,Louie Belpedio,D,PHI,28,17,2,0,2
53,8482511,Mason Lohrei,D,BOS,23,33,1,1,2
53,8477473,Justin Bailey,R,SJS,29,27,1,1,2
53,8480890,Jan Jenik,C,OTT,24,25,1,1,2
53,8479991,Jake Leschyshyn,C,NYR,25,26,1,1,2
53,8479419,Brett Murray,L,BUF,26,18,1,1,2
53,8477971,Andreas Englund,D,LAK,28,31,1,1,2
53,8478146,Matthew Highmore,C,OTT,28,35,1,1,2
53,8482250,Callahan Burke,C,VGK,27,20,1,1,2
53,8484304,Uvis Balinskis,D,FLA,28,18,1,1,2
53,8482162,Roby Jarventie,L,EDM,22,13,1,1,2
53,8482516,Matthew Kessel,D,STL,24,24,1,1,2
53,8482088,Justin Sourdif,R,FLA,22,19,1,1,2
53,8481206,John Ludvig,D,PIT,24,11,1,1,2
53,8482094,Daemon Hunt,D,MIN,22,17,1,1,2
53,8481024,Linus Karlsson,C,VAN,25,11,1,1,2
53,8484259,Ondrej Pavel,C,COL,31,3,1,1,2
53,8481541,Samuel Bolduc,D,NYI,24,33,0,2,2
53,8480874,Adam Ginning,D,PHI,24,11,0,2,2
53,8483546,Marshall Rifai,D,TOR,26,5,0,2,2
53,8481806,Louis Crevier,D,CHI,23,17,0,2,2
53,8483397,Marc McLaughlin,C,BOS,25,20,1,0,1
53,8482153,Brendan Brisson,C,VGK,23,30,1,0,1
53,8484287,Cole McWard,D,VAN,23,21,1,0,1
53,8482201,Gage Goncalves,C,TBL,23,27,1,0,1
53,8484325,Waltteri Merela,C,TBL,26,16,1,0,1
53,8483597,Milos Kelemen,L,UTA,25,11,1,0,1
53,8483395,Arshdeep Bains,L,VAN,23,5,1,0,1
53,8481726,Adam Edstrom,C,NYR,24,5,1,0,1
53,8483471,Brad Lambert,C,WPG,31,11,1,0,1
53,8484255,Jason Polin,R,COL,25,6,1,0,1
53,8477993,Justin Kirkland,C,CGY,28,6,1,0,1
53,8477073,Kurtis MacDermid,L,NJD,30,24,0,1,1
53,8481065,Angus Crookshank,L,OTT,25,16,0,1,1
53,8477320,Anton Blidh,L,NYR,29,18,0,1,1
53,8481585,Egor Afanasyev,L,SJS,23,10,0,1,1
53,8475780,Chris Wagner,R,COL,33,4,0,1,1
53,8478477,Mitchell Stephens,C,SEA,27,13,0,1,1
53,8483920,Pierrick Dube,R,WSH,23,7,0,1,1
53,8481578,Graeme Clarke,R,MIN,23,14,0,1,1
53,8482061,Brandon Biro,L,SEA,26,17,0,1,1
53,8481122,Simon Benoit,D,TOR,26,35,0,0,0
53,8480851,Akil Thomas,C,LAK,24,14,0,0,0
53,8481655,Cole Schwindt,R,CGY,23,4,0,0,0
53,8479362,Riley Tufte,L,BOS,26,16,0,0,0
53,8480823,Alexander Alexeyev,D,WSH,25,12,0,0,0
53,8480468,James Hamblin,L,EDM,25,18,0,0,0
53,8477541,Dakota Mermis,D,TOR,30,7,0,0,0
53,8481719,Maxwell Crozier,D,TBL,24,11,0,0,0
53,8482787,Nikita Chibrikov,R,WPG,31,5,0,0,0
53,8481564,Ryan Johnson,D,BUF,23,8,0,0,0
53,8479421,Jacob Moverare,D,LAK,26,6,0,0,0
53,8482460,Matt Rempe,C,NYR,22,11,0,0,0
53,8478147,Bokondji Imama,L,PIT,28,8,0,0,0
53,8480306,Grant Hutton,D,NYI,29,11,0,0,0
53,8479330,Brandon Gignac,C,MTL,27,12,0,0,0
53,8478446,Glenn Gawdin,C,LAK,27,9,0,0,0
53,8483567,Georgii Merkulov,C,BOS,24,6,0,0,0
53,8478881,Brett Seney,L,CHI,28,17,0,0,0
53,8482858,Ryker Evans,D,SEA,23,16,0,0,0
53,8484321,Nikolas Matinpalo,D,OTT,26,0,0,0,0
53,8478854,Ryan Shea,D,PIT,27,5,0,0,0
53,8482126,Emil Andrae,D,PHI,31,4,0,0,0
53,8479522,Hardy Haman Aktell,D,WSH,26,4,0,0,0
53,8482476,Emil Heineman,L,MTL,23,3,0,0,0
53,8482197,Adam Raska,R,MIN,23,11,0,0,0
53,8475755,Alexander Petrovic,D,DAL,32,12,0,0,0
53,8483401,Marc Johnstone,R,PIT,28,1,0,0,0
53,8480075,Cameron Crotty,D,MIN,25,8,0,0,0
53,8481534,Raphael Lavoie,C,EDM,24,3,0,0,0
53,8483407,Brandon Scanlin,D,NYR,25,6,0,0,0
53,8484326,Patrik Koch,D,UTA,28,1,0,0,0
53,8483531,Brian Halonen,L,NJD,25,2,0,0,0
53,8476323,Max McCormick,L,SEA,32,5,0,0,0
53,8483609,Adam Klapka,R,CGY,24,6,0,0,0
53,8480274,Philip Kemp,D,EDM,25,1,0,0,0
53,8470794,Joe Pavelski,C,,40,0,0,0,0
53,8479321,Lucas Johansen,D,,27,0,0,0,0
53,8477950,Tony DeAngelo,D,,29,0,0,0,0
53,8471218,Blake Wheeler,R,,38,0,0,0,0
53,8475197,Tyson Barrie,D,,33,0,0,0,0
53,8474157,Max Pacioretty,L,,36,0,0,0,0
53,8475744,Evgeny Kuznetsov,C,,32,0,0,0,0
53,8474037,James van Riemsdyk,L,,35,0,0,0,0
53,8476907,Mackenzie MacEachern,L,,30,0,0,0,0
53,8480216,Jacob Peterson,C,,25,0,0,0,0
53,8474602,Justin Schultz,D,,34,0,0,0,0
53,8482222,Alexander Barabanov,L,,30,0,0,0,0
53,8474031,Kevin Shattenkirk,D,,35,0,0,0,0
53,8477330,Dominik Kubalik,L,,29,0,0,0,0
53,8480884,Calen Addison,D,,24,0,0,0,0
53,8475906,John Klingberg,D,,32,0,0,0,0
53,8480008,Adam Ruzicka,C,,25,0,0,0,0
53,8476884,Derrick Pouliot,D,,30,0,0,0,0
53,8476919,Chris Tierney,C,,30,0,0,0,0
53,8479415,Michael McLeod,C,,26,0,0,0,0
53,8474870,Tyler Johnson,C,,34,0,0,0,0
53,8470604,Jeff Carter,C,,39,0,0,0,0
53,8478104,Sammy Blais,L,,28,0,0,0,0
53,8474884,Mike Hoffman,C,,35,0,0,0,0
53,8481591,Sam Poulin,R,,23,0,0,0,0
53,8471274,Alex Goligoski,D,,39,0,0,0,0
53,8476871,Tanner Pearson,L,,32,0,0,0,0
53,8476393,Nick Cousins,C,,31,0,0,0,0
53,8479977,Kailer Yamamoto,R,,26,0,0,0,0
53,8479346,Dillon Dube,C,,26,0,0,0,0
53,8480184,Gustav Lindstrom,D,,26,0,0,0,0
53,8479376,Victor Mete,D,,26,0,0,0,0
53,8473449,Kyle Okposo,R,,36,0,0,0,0
53,8481058,Jesse Ylonen,R,,25,0,0,0,0
53,8475752,Tyler Pitlick,C,,33,0,0,0,0
53,8481239,Samuel Fagemo,L,,24,0,0,0,0
53,8480821,Filip Zadina,R,,25,0,0,0,0
53,8470966,Mark Giordano,D,,41,0,0,0,0
53,8478495,Denis Gurianov,R,,27,0,0,0,0
53,8477464,Nic Petan,C,,29,0,0,0,0
53,8478099,Kevin Labanc,R,,29,0,0,0,0
53,8482241,Radim Zohorna,L,,28,0,0,0,0
53,8474040,Sam Gagner,C,,35,0,0,0,0
53,8479514,Rem Pitlick,C,,27,0,0,0,0
53,8478430,Oliver Kylington,D,,27,0,0,0,0
53,8479533,Joona Koppanen,L,,26,0,0,0,0
53,8479984,Cal Foote,D,,26,0,0,0,0
53,8477126,Jayson Megna,C,,34,0,0,0,0
53,8475164,Jakob Silfverberg,R,,34,0,0,0,0
53,8474009,Nick Bonino,C,,36,0,0,0,0
53,8479458,Nikita Zaitsev,D,,33,0,0,0,0
53,8477944,Jakub Vrana,L,,28,0,0,0,0
53,8471699,Andrew Cogliano,C,,37,0,0,0,0
53,8478067,Oskar Lindblom,L,,28,0,0,0,0
53,8471686,Marc Staal,D,,37,0,0,0,0
53,8470610,Zach Parise,L,,40,0,0,0,0
53,8478904,Steven Lorentz,C,,28,0,0,0,0
53,8473473,Milan Lucic,L,,36,0,0,0,0
53,8480031,Maxime Comtois,L,,25,0,0,0,0
53,8478512,Austin Czarnik,C,,32,0,0,0,0
53,8473504,Cal Clutterbuck,R,,37,0,0,0,0
53,8477454,Adam Erne,L,,29,0,0,0,0
53,8479383,Boris Katchouk,L,,26,0,0,0,0
53,8475825,Jani Hakanpää,D,,32,0,0,0,0
53,8477846,Ryan Carpenter,C,,33,0,0,0,0
53,8477930,Pierre-Edouard Bellemare,L,,39,0,0,0,0
53,8478400,Colin White,C,,27,0,0,0,0
53,8480226,Marián Studenic,R,,26,0,0,0,0
53,8480853,Liam Foudy,C,,24,0,0,0,0
53,8475797,Jarred Tinordi,D,,32,0,0,0,0
53,8479423,Alex Nylander,L,,26,0,0,0,0
53,8474618,Marco Scandella,D,,34,0,0,0,0
53,8478028,Fredrik Olofsson,L,,28,0,0,0,0
53,8474709,Matt Martin,L,,35,0,0,0,0
53,8481070,Hugh McGing,L,,26,0,0,0,0
53,8479546,Oskar Steen,C,,26,0,0,0,0
53,8474145,Robert Bortuzzo,D,,35,0,0,0,0
53,8476915,Jujhar Khaira,L,,30,0,0,0,0
53,8475278,Byron Froese,C,,33,0,0,0,0
53,8481812,Nikolai Knyzhov,D,,27,0,0,0,0
53,8478408,Travis Dermott,D,,28,0,0,0,0
53,8481077,John Leonard,L,,26,0,0,0,0
53,8479547,Matthew Phillips,R,,26,0,0,0,0
53,8480836,Jonathan Gruden,C,,24,0,0,0,0
53,8481690,Tyler Angle,C,,24,0,0,0,0
53,8475766,Austin Watson,L,,32,0,0,0,0
53,8481016,Ruslan Iskhakov,C,,24,0,0,0,0
53,8478078,Rourke Chartier,C,,28,0,0,0,0
53,8480776,Sheldon Rempal,R,,29,0,0,0,0
53,8478956,Samuel Laberge,L,NJD,27,2,0,0,0
53,8483045,Cameron Butler,R,CBJ,31,1,0,0,0
53,8484314,Jiri Smejkal,L,,28,0,0,0,0
54,8478402,Connor McDavid,C,EDM,27,81,39,107,146
54,8477956,David Pastrnak,R,BOS,28,78,69,60,129
54,8481559,Jack Hughes,C,NJD,23,76,44,84,128
54,8476453,Nikita Kucherov,R,TBL,31,82,36,90,126
54,8477492,Nathan MacKinnon,C,COL,29,81,39,84,123
54,8479314,Matthew Tkachuk,L,FLA,27,82,27,87,114
54,8477493,Aleksander Barkov,C,FLA,29,77,28,84,112
54,8479318,Auston Matthews,C,TOR,27,75,60,49,109
54,8471675,Sidney Crosby,C,PIT,37,77,46,60,106
54,8478420,Mikko Rantanen,R,COL,28,81,43,62,105
54,8477404,Jake Guentzel,C,TBL,30,82,49,55,104
54,8478864,Kirill Kaprizov,L,MIN,27,75,41,61,102
54,8476468,J.T. Miller,C,VAN,31,76,34,68,102
54,8478445,Mathew Barzal,C,NYI,27,78,21,77,98
54,8480800,Quinn Hughes,D,VAN,25,75,22,75,97
54,8478550,Artemi Panarin,L,NYR,33,77,31,65,96
54,8477946,Dylan Larkin,C,DET,28,80,47,48,95
54,8478483,Mitch Marner,R,TOR,27,77,34,61,95
54,8480012,Elias Pettersson,C,VAN,26,75,28,65,93
54,8481557,Matt Boldy,L,MIN,23,72,41,51,92
54,8477942,Kevin Fiala,L,LAK,28,80,32,59,91
54,8480023,Robert Thomas,C,STL,25,79,28,63,91
54,8479343,Clayton Keller,R,UTA,26,79,45,45,90
54,8478427,Sebastian Aho,C,CAR,27,70,38,52,90
54,8480027,Jason Robertson,L,DAL,25,82,43,44,87
54,8477402,Pavel Buchnevich,L,STL,29,75,35,52,87
54,8477949,Alex Tuch,R,BUF,28,73,29,58,87
54,8478010,Brayden Point,C,TBL,28,82,46,40,86
54,8475166,John Tavares,C,TOR,34,82,39,47,86
54,8477934,Leon Draisaitl,C,EDM,29,78,39,46,85
54,8476887,Filip Forsberg,L,NSH,30,80,35,50,85
54,8474600,Roman Josi,D,NSH,34,75,23,62,85
54,8479407,Jesper Bratt,L,NJD,26,72,28,56,84
54,8480801,Brady Tkachuk,L,OTT,25,78,37,45,82
54,8475913,Mark Stone,R,VGK,32,80,35,47,82
54,8480830,Andrei Svechnikov,R,CAR,24,72,32,49,81
54,8476346,Johnny Gaudreau,L,CBJ,31,73,26,55,81
54,8479420,Tage Thompson,C,BUF,27,73,44,34,78
54,8480002,Nico Hischier,C,NJD,25,72,26,52,78
54,8477933,Sam Reinhart,C,FLA,29,78,36,41,77
54,8477939,William Nylander,R,TOR,28,76,30,47,77
54,8475172,Nazem Kadri,C,CGY,34,78,29,48,77
54,8482116,Tim Stützle,C,OTT,22,78,26,51,77
54,8477504,Josh Morrissey,D,WPG,29,74,21,56,77
54,8480865,Noah Dobson,D,NYI,24,81,11,66,77
54,8477500,Bo Horvat,C,NYI,29,78,40,36,76
54,8475786,Zach Hyman,L,EDM,32,80,38,38,76
54,8474564,Steven Stamkos,C,NSH,34,73,34,42,76
54,8478493,Joel Eriksson Ek,C,MIN,27,74,34,42,76
54,8476454,Ryan Nugent-Hopkins,C,EDM,31,77,20,56,76
54,8480036,Miro Heiskanen,D,DAL,25,76,14,62,76
54,8484144,Connor Bedard,C,CHI,19,67,30,45,75
54,8471215,Evgeni Malkin,C,PIT,38,71,29,46,75
54,8479337,Alex DeBrincat,R,DET,27,80,21,54,75
54,8478439,Travis Konecny,R,PHI,27,74,31,43,74
54,8479385,Jordan Kyrou,C,STL,26,74,30,44,74
54,8482078,Lucas Raymond,L,DET,22,80,28,45,73
54,8480018,Nick Suzuki,C,MTL,25,79,23,50,73
54,8476539,Jonathan Marchessault,R,NSH,34,74,37,35,72
54,8478444,Brock Boeser,R,VAN,27,75,35,37,72
54,8474141,Patrick Kane,R,DET,36,79,30,42,72
54,8480208,Drake Batherson,R,OTT,26,81,27,45,72
54,8480069,Cale Makar,D,COL,26,70,21,51,72
54,8476456,Jonathan Huberdeau,C,CGY,31,82,16,56,72
54,8478449,Roope Hintz,C,DAL,28,79,33,38,71
54,8482740,Wyatt Johnston,C,DAL,21,82,33,38,71
54,8478403,Jack Eichel,C,VGK,28,76,30,41,71
54,8478398,Kyle Connor,L,WPG,28,74,29,42,71
54,8478460,Zach Werenski,D,CBJ,27,81,17,54,71
54,8475184,Chris Kreider,L,NYR,33,78,41,29,70
54,8476460,Mark Scheifele,C,WPG,31,74,39,31,70
54,8471685,Anze Kopitar,C,LAK,37,80,26,44,70
54,8474578,Erik Karlsson,D,PIT,34,79,18,52,70
54,8477501,Valeri Nichushkin,R,COL,29,80,42,27,69
54,8476881,Tomas Hertl,C,VGK,31,75,32,37,69
54,8477409,Carter Verhaeghe,C,FLA,29,80,34,34,68
54,8476448,William Karlsson,C,VGK,31,76,30,38,68
54,8477951,Nick Schmaltz,C,UTA,28,76,24,43,67
54,8476459,Mika Zibanejad,C,NYR,31,80,23,44,67
54,8473512,Claude Giroux,R,OTT,36,78,22,45,67
54,8473419,Brad Marchand,L,BOS,36,80,20,47,67
54,8475167,Victor Hedman,D,TBL,34,82,11,56,67
54,8475794,Tyler Seguin,C,DAL,32,81,34,32,66
54,8478975,Mason Marchment,L,DAL,29,82,28,38,66
54,8482745,Mason McTavish,C,ANA,21,73,27,39,66
54,8480803,Evan Bouchard,D,EDM,25,71,10,56,66
54,8475168,Matt Duchene,C,DAL,33,82,20,44,64
54,8482699,Dylan Guenther,R,UTA,21,73,22,41,63
54,8475765,Vladimir Tarasenko,R,DET,33,82,20,43,63
54,8478873,Troy Terry,R,ANA,27,71,20,43,63
54,8475798,Mikael Granlund,C,SJS,32,72,16,47,63
54,8476399,Blake Coleman,C,CGY,33,79,34,28,62
54,8475151,Kyle Palmieri,C,NYI,33,77,31,31,62
54,8477955,Jared McCann,L,SEA,28,73,30,32,62
54,8471214,Alex Ovechkin,L,WSH,39,75,29,33,62
54,8476389,Vincent Trocheck,C,NYR,31,76,26,36,62
54,8477960,Adrian Kempe,R,LAK,28,79,25,37,62
54,8475754,Brock Nelson,C,NYI,33,80,33,28,61
54,8481540,Cole Caufield,R,MTL,23,78,30,31,61
54,8477494,Jonathan Drouin,L,COL,29,81,23,38,61
54,8479999,Casey Mittelstadt,C,COL,26,81,18,43,61
54,8479325,Charlie McAvoy,D,BOS,27,73,13,48,61
54,8477496,Elias Lindholm,C,BOS,30,79,27,33,60
54,8478519,Anthony Cirelli,C,TBL,27,82,24,36,60
54,8477940,Nikolaj Ehlers,L,WPG,28,73,19,41,60
54,8478414,Timo Meier,R,NJD,28,72,37,21,58
54,8479542,Brandon Hagel,L,TBL,26,82,31,27,58
54,8482124,Quinton Byfield,R,LAK,22,81,19,39,58
54,8479323,Adam Fox,D,NYR,26,74,11,47,58
54,8480014,Gabriel Vilardi,C,WPG,25,72,34,23,57
54,8474102,David Perron,L,OTT,36,81,30,27,57
54,8482110,Dawson Mercer,C,NJD,23,73,30,27,57
54,8482159,Tyson Foerster,R,PHI,22,76,30,27,57
54,8481068,Yegor Sharangovich,C,CGY,26,76,27,30,57
54,8476875,Mike Matheson,D,MTL,30,73,14,43,57
54,8478047,Michael Bunting,L,PIT,29,66,29,27,56
54,8479400,Pierre-Luc Dubois,L,WSH,26,70,27,29,56
54,8478440,Dylan Strome,C,WSH,27,67,24,32,56
54,8482149,Cole Perfetti,C,WPG,22,69,23,33,56
54,8481711,Matias Maccelli,L,UTA,24,76,21,35,56
54,8480039,Martin Necas,C,CAR,25,74,16,40,56
54,8480839,Rasmus Dahlin,D,BUF,24,66,12,44,56
54,8475169,Evander Kane,L,EDM,33,75,29,26,55
54,8477456,J.T. Compher,L,DET,29,78,27,28,55
54,8478407,Vince Dunn,D,SEA,28,77,18,37,55
54,8476292,Ondrej Palat,L,NJD,33,68,15,40,55
54,8480015,Owen Tippett,R,PHI,25,79,29,25,54
54,8480188,Fabian Zetterlund,L,SJS,25,69,28,26,54
54,8474586,Jordan Eberle,R,SEA,34,70,21,33,54
54,8478401,Pavel Zacha,C,BOS,27,81,19,35,54
54,8476906,Shayne Gostisbehere,D,CAR,31,80,14,40,54
54,8477416,Oliver Bjorkstrand,R,SEA,29,77,25,28,53
54,8483431,Logan Cooley,C,UTA,20,74,25,28,53
54,8475784,Jeff Skinner,C,EDM,32,76,30,22,52
54,8476483,Rickard Rakell,R,PIT,31,70,29,23,52
54,8477479,Tyler Bertuzzi,L,CHI,29,71,27,25,52
54,8477511,Anthony Mantha,R,CGY,30,76,24,28,52
54,8477021,Alex Kerfoot,C,UTA,30,74,19,33,52
54,8474150,Mikael Backlund,C,CGY,35,76,15,37,52
54,8474563,Drew Doughty,D,LAK,35,75,10,42,52
54,8475810,Bryan Rust,R,PIT,32,66,24,27,51
54,8481596,Shane Pinto,C,OTT,24,79,21,30,51
54,8470613,Brent Burns,D,CAR,39,78,13,38,51
54,8476792,Torey Krug,D,STL,33,73,13,38,51
54,8471724,Kris Letang,D,PIT,37,77,8,43,51
54,8475692,Mats Zuccarello,R,MIN,37,67,6,45,51
54,8475799,Nino Niederreiter,R,WPG,32,71,26,24,50
54,8482109,Alexis Lafrenière,L,NYR,23,79,24,26,50
54,8477476,Artturi Lehkonen,L,COL,29,80,23,27,50
54,8478542,Evan Rodrigues,C,FLA,31,78,22,28,50
54,8475158,Ryan O'Reilly,C,NSH,33,73,21,29,50
54,8479675,Trevor Moore,L,LAK,29,79,19,31,50
54,8478366,Frank Vatrano,R,ANA,30,68,29,20,49
54,8479525,Ross Colton,C,COL,28,82,26,23,49
54,8478466,Daniel Sprong,R,VAN,27,73,20,29,49
54,8482665,Matty Beniers,C,SEA,22,75,18,31,49
54,8477964,Ivan Barbashev,C,VGK,29,75,18,31,49
54,8474590,John Carlson,D,WSH,34,67,10,39,49
54,8478498,Jake DeBrusk,L,VAN,28,71,30,18,48
54,8475745,Charlie Coyle,C,BOS,32,78,26,22,48
54,8477407,Anthony Duclair,L,NYI,29,80,22,26,48
54,8475170,Brayden Schenn,C,STL,33,70,21,27,48
54,8481528,Dylan Cozens,C,BUF,23,74,20,28,48
54,8478856,Conor Garland,R,VAN,28,70,18,30,48
54,8479425,Filip Hronek,D,VAN,27,79,9,39,48
54,8475726,Tyler Toffoli,C,SJS,32,66,26,21,47
54,8476432,Boone Jenner,C,CBJ,31,70,26,21,47
54,8474149,Evgenii Dadonov,R,DAL,35,81,19,28,47
54,8477503,Max Domi,C,TOR,29,80,16,31,47
54,8478396,Noah Hanifin,D,VGK,27,67,12,35,47
54,8482684,Luke Hughes,D,NJD,21,72,10,37,47
54,8483515,Juraj Slafkovsky,L,MTL,20,77,18,28,46
54,8476462,Dougie Hamilton,D,NJD,31,69,18,28,46
54,8477429,Andrew Copp,C,DET,30,79,16,30,46
54,8480185,Eetu Luostarinen,C,FLA,26,74,12,34,46
54,8477495,Seth Jones,D,CHI,30,73,11,35,46
54,8481542,Moritz Seider,D,DET,23,76,9,37,46
54,8480797,Joel Farabee,L,PHI,24,72,9,37,46
54,8477935,Sam Bennett,C,FLA,28,78,27,18,45
54,8484153,Leo Carlsson,C,ANA,20,76,24,21,45
54,8482093,Seth Jarvis,C,CAR,22,70,22,23,45
54,8481604,Pavel Dorofeyev,L,VGK,24,70,22,23,45
54,8482113,Anton Lundell,C,FLA,23,77,19,26,45
54,8478472,Mathieu Joseph,R,STL,27,69,19,26,45
54,8482667,William Eklund,L,SJS,22,70,18,27,45
54,8477451,Ryan Hartman,R,MIN,30,64,17,28,45
54,8473994,Jamie Benn,L,DAL,35,80,16,29,45
54,8476479,Phillip Danault,C,LAK,31,80,12,33,45
54,8478438,Tommy Novak,C,NSH,27,69,12,33,45
54,8482712,Oskar Olausson,R,COL,22,77,10,35,45
54,8480064,Josh Norris,C,OTT,25,73,26,18,44
54,8474641,Adam Henrique,C,EDM,34,80,18,26,44
54,8482097,Jack Quinn,R,BUF,23,68,18,26,44
54,8482705,Cole Sillinger,C,CBJ,21,72,18,26,44
54,8477986,Brandon Montour,D,SEA,30,69,12,32,44
54,8484145,Zach Benson,L,BUF,19,65,9,35,44
54,8481560,Arthur Kaliyev,R,LAK,23,81,22,21,43
54,8476880,Tom Wilson,R,WSH,30,67,19,24,43
54,8479365,Trent Frederic,C,BOS,26,76,18,25,43
54,8483505,Matthew Poitras,C,BOS,20,74,15,28,43
54,8478397,Rasmus Andersson,D,CGY,28,75,13,30,43
54,8476458,Ryan Strome,C,ANA,31,72,13,30,43
54,8475314,Anders Lee,L,NYI,34,77,24,18,42
54,8478057,Dakota Joshua,C,VAN,28,63,23,19,42
54,8478042,Viktor Arvidsson,L,EDM,31,75,21,21,42
54,8477426,Nicholas Paul,L,TBL,29,81,17,25,42
54,8475793,Ryan Johansen,C,PHI,32,73,17,25,42
54,8479345,Jakob Chychrun,D,WSH,26,65,14,28,42
54,8475191,Reilly Smith,R,NYR,33,74,14,28,42
54,8477948,Travis Sanheim,D,PHI,28,71,12,30,42
54,8476853,Morgan Rielly,D,TOR,30,72,5,37,42
54,8477998,Warren Foegele,L,LAK,28,80,19,22,41
54,8476826,Yanni Gourde,C,SEA,33,70,18,23,41
54,8476882,Teuvo Teravainen,C,CHI,30,62,17,24,41
54,8481618,Alex Newhook,C,MTL,23,76,15,26,41
54,8477947,Sonny Milano,L,WSH,28,61,11,30,41
54,8476979,Erik Gustafsson,D,DET,32,74,11,30,41
54,8474716,Jared Spurgeon,D,MIN,35,76,10,31,41
54,8471698,T.J. Oshie,R,WSH,38,64,21,19,40
54,8483808,Andrei Kuzmenko,L,CGY,28,73,21,19,40
54,8479992,Michael Rasmussen,C,DET,25,81,20,20,40
54,8480113,Alex Iafallo,L,WPG,31,64,19,21,40
54,8482720,Matthew Knies,L,TOR,22,75,18,22,40
54,8481533,Trevor Zegras,C,ANA,23,71,18,22,40
54,8479339,Patrik Laine,L,CBJ,26,58,18,22,40
54,8475763,Kevin Hayes,R,PIT,32,68,17,23,40
54,8478046,Danton Heinen,L,VAN,29,71,15,25,40
54,8475753,Justin Faulk,D,STL,32,77,10,30,40
54,8476905,Chandler Stephenson,C,SEA,30,77,9,31,40
54,8477447,Shea Theodore,D,VGK,29,57,3,37,40
54,8475193,Tomas Tatar,L,NJD,34,69,18,21,39
54,8480871,Adam Boqvist,D,FLA,24,74,13,26,39
54,8475218,Mattias Ekholm,D,EDM,34,79,12,27,39
54,8479410,Mikhail Sergachev,D,UTA,26,61,8,31,39
54,8480145,Neal Pionk,D,WPG,29,64,8,31,39
54,8478038,Devon Toews,D,COL,30,71,6,33,39
54,8482175,JJ Peterka,R,BUF,22,65,27,11,38
54,8479390,Taylor Raddysh,R,WSH,26,63,18,20,38
54,8473986,Alex Killorn,L,ANA,35,71,15,23,38
54,8482105,Jake Sanderson,D,OTT,22,72,14,24,38
54,8477497,Sean Monahan,C,CBJ,30,70,14,24,38
54,8476461,Sean Couturier,C,PHI,32,67,13,25,38
54,8481523,Kirby Dach,C,MTL,23,71,12,26,38
54,8480835,Jack Drury,C,CAR,24,58,10,28,38
54,8474679,Gustav Nyquist,C,NSH,35,72,8,30,38
54,8475764,Cam Fowler,D,ANA,33,71,2,36,38
54,8478463,Anthony Beauvillier,L,PIT,27,65,23,14,37
54,8476438,Brandon Saad,L,STL,32,67,20,17,37
54,8476872,Scott Laughton,C,PHI,30,76,15,22,37
54,8478462,Nicolas Roy,C,VGK,27,75,14,23,37
54,8478458,John (Jack) Roslovic,C,CAR,27,70,13,24,37
54,8475768,Jaden Schwartz,C,SEA,32,72,12,25,37
54,8480748,Kiefer Sherwood,L,VAN,29,61,12,25,37
54,8482092,Ridly Greig,C,OTT,22,77,11,26,37
54,8481577,Philip Tomasino,C,NSH,23,66,10,27,37
54,8481546,Cam York,D,PHI,23,74,9,28,37
54,8481703,Valtteri Puustinen,R,PIT,25,67,7,30,37
54,8482660,Kent Johnson,C,CBJ,22,68,4,33,37
54,8476885,Jacob Trouba,D,NYR,30,70,3,34,37
54,8477425,Miles Wood,L,COL,29,77,19,17,36
54,8481186,Logan O'Connor,R,COL,28,79,18,18,36
54,8482055,Drew O'Connor,L,PIT,26,68,18,18,36
54,8484166,Adam Fantilli,C,CBJ,20,67,17,19,36
54,8477932,Aaron Ekblad,D,FLA,28,74,14,22,36
54,8480078,Filip Chytil,C,NYR,25,69,13,23,36
54,8478469,Thomas Chabot,D,OTT,27,73,9,27,36
54,8476927,Teddy Blueger,C,VAN,30,70,8,28,36
54,8480817,K'Andre Miller,D,NYR,24,73,8,28,36
54,8483490,Pavel Mintyukov,D,ANA,21,75,7,29,36
54,8482111,Justin Barron,D,MTL,23,72,7,29,36
54,8476917,Adam Pelech,D,NYI,30,77,5,31,36
54,8476469,Joel Armia,R,MTL,31,65,20,15,35
54,8480220,Noah Cates,L,PHI,25,68,19,16,35
54,8475722,Jason Zucker,L,BUF,32,67,17,18,35
54,8481580,Connor McMichael,C,WSH,23,60,17,18,35
54,8480009,Eeli Tolvanen,R,SEA,25,73,15,20,35
54,8476958,Jaccob Slavin,D,CAR,30,71,11,24,35
54,8478413,Jordan Greenway,L,BUF,27,67,20,14,34
54,8482702,Logan Stankoven,C,DAL,21,82,15,19,34
54,8477444,Andre Burakovsky,L,SEA,29,72,13,21,34
54,8482133,Thomas Bordeleau,C,SJS,22,66,12,22,34
54,8474053,Logan Couture,C,SJS,35,61,10,24,34
54,8476463,Jonas Brodin,D,MIN,31,78,9,25,34
54,8480434,Sean Durzi,D,UTA,26,66,7,27,34
54,8477488,Brett Pesce,D,NJD,30,77,7,27,34
54,8482146,Luke Evangelista,R,NSH,22,72,19,14,33
54,8482125,Alexander Holtz,R,VGK,22,72,18,15,33
54,8478109,Victor Olofsson,L,VGK,29,66,16,17,33
54,8482079,Marco Rossi,C,MIN,23,58,16,17,33
54,8475848,Brendan Gallagher,R,MTL,32,63,15,18,33
54,8480829,Jesperi Kotkaniemi,C,CAR,24,66,15,18,33
54,8470621,Corey Perry,R,EDM,39,70,14,19,33
54,8479987,Morgan Geekie,C,BOS,26,75,13,20,33
54,8478020,Michael Amadio,R,OTT,28,75,13,20,33
54,8478055,Gustav Forsling,D,FLA,28,71,11,22,33
54,8480798,Philipp Kurashev,C,CHI,25,63,10,23,33
54,8481656,Aliaksei Protas,C,WSH,23,67,8,25,33
54,8481581,Thomas Harley,D,DAL,23,76,7,26,33
54,8479661,Tanner Jeannot,L,LAK,27,74,20,12,32
54,8482475,Yegor Chinakhov,R,CBJ,23,67,20,12,32
54,8483524,Shane Wright,C,SEA,20,68,17,15,32
54,8480459,Pius Suter,C,VAN,28,67,16,16,32
54,8478474,Lawson Crouse,L,UTA,27,74,16,16,32
54,8477478,William Carrier,L,CAR,30,60,16,16,32
54,8478233,Andrew Mangiapane,L,WSH,28,73,13,19,32
54,8474189,Lars Eller,C,PIT,35,72,12,20,32
54,8476925,Colton Sissons,C,NSH,31,58,11,21,32
54,8476923,Damon Severson,D,CBJ,30,80,10,22,32
54,8479353,Brett Howden,C,VGK,26,64,10,22,32
54,8476419,Jean-Gabriel Pageau,C,NYI,32,79,9,23,32
54,8476869,Brady Skjei,D,NSH,30,71,8,24,32
54,8480028,Morgan Frost,C,PHI,25,71,7,25,32
54,8473533,Jordan Staal,C,CAR,36,63,17,14,31
54,8475220,Marcus Foligno,L,MIN,33,62,15,16,31
54,8474715,Cameron Atkinson,R,TBL,35,81,15,16,31
54,8475760,Nick Bjugstad,C,UTA,32,70,13,18,31
54,8473563,Nicklas Backstrom,C,WSH,37,58,10,21,31
54,8482122,Brock Faber,D,MIN,22,80,8,23,31
54,8477346,MacKenzie Weegar,D,CGY,30,67,7,24,31
54,8477435,Ryan Graves,D,PIT,29,76,6,25,31
54,8477969,Marcus Pettersson,D,PIT,28,75,5,26,31
54,8479976,Juuso Valimaki,D,UTA,26,72,4,27,31
54,8474151,Ryan McDonagh,D,TBL,35,76,4,27,31
54,8478115,Pierre Engvall,L,NYI,28,79,16,14,30
54,8479941,Justin Danforth,R,CBJ,31,57,16,14,30
54,8475149,Marcus Johansson,L,MIN,34,66,15,15,30
54,8481535,Nils Hoglander,L,VAN,24,66,14,16,30
54,8483491,Ivan Miroshnichenko,L,WSH,20,57,14,16,30
54,8473422,Nick Foligno,L,CHI,37,59,13,17,30
54,8477498,Darnell Nurse,D,EDM,29,67,12,18,30
54,8482117,Lukas Reichel,L,CHI,22,59,10,20,30
54,8482101,Danil Gushchin,L,SJS,22,59,8,22,30
54,8479351,Sam Steel,C,DAL,26,81,7,23,30
54,8474565,Alex Pietrangelo,D,VGK,34,57,5,25,30
54,8476331,Dylan DeMelo,D,WPG,31,69,3,27,30
54,8477506,Ryan Pulock,D,NYI,30,75,2,28,30
54,8484203,Bradly Nadeau,L,CAR,19,61,17,12,29
54,8476981,Josh Anderson,R,MTL,30,68,13,16,29
54,8477015,Connor Brown,R,EDM,30,67,9,20,29
54,8482671,Owen Power,D,BUF,22,68,8,21,29
54,8475287,Erik Haula,L,NJD,33,67,6,23,29
54,8480035,Henri Jokiharju,D,BUF,25,64,3,26,29
54,8480893,Kirill Marchenko,R,CBJ,24,61,17,11,28
54,8480855,Jack McBain,C,UTA,24,70,17,11,28
54,8477953,Kasperi Kapanen,R,STL,28,64,16,12,28
54,8477505,Alexander Wennberg,C,SJS,30,63,14,14,28
54,8477987,Ryan Donato,C,CHI,28,60,13,15,28
54,8476392,Adam Lowry,C,WPG,31,63,12,16,28
54,8479996,Cody Glass,C,NSH,25,61,12,16,28
54,8482749,Joshua Roy,R,MTL,21,64,12,16,28
54,8483493,Frank Nazar,C,CHI,20,54,11,17,28
54,8478911,Matt Roy,D,WSH,29,63,10,18,28
54,8480336,Sean Walker,D,CAR,30,75,10,18,28
54,8481524,Bowen Byram,D,BUF,23,62,9,19,28
54,8480802,Ryan McLeod,C,BUF,25,65,9,19,28
54,8478133,Jake Evans,C,MTL,28,73,8,20,28
54,8478851,Alexandre Carrier,D,NSH,28,66,5,23,28
54,8480873,Rasmus Sandin,D,WSH,24,65,4,24,28
54,8479402,Jake Bean,D,CGY,26,74,3,25,28
54,8482074,Connor Zary,C,CGY,23,64,15,12,27
54,8477839,Conor Sheary,L,TBL,32,81,13,14,27
54,8477392,Hudson Fasching,R,NYI,29,70,13,14,27
54,8477952,Robby Fabbri,C,ANA,28,67,12,15,27
54,8478891,Mason Appleton,C,WPG,28,65,9,18,27
54,8477989,Christian Dvorak,C,MTL,28,61,9,18,27
54,8480849,Barrett Hayton,C,UTA,24,72,8,19,27
54,8480073,Erik Brannstrom,D,COL,25,69,8,19,27
54,8478507,John Marino,D,UTA,27,69,8,19,27
54,8480043,Timothy Liljegren,D,TOR,25,62,5,22,27
54,8475171,Oliver Ekman-Larsson,D,TOR,33,62,4,23,27
54,8476854,Hampus Lindholm,D,BOS,30,70,4,23,27
54,8475200,Dmitry Orlov,D,CAR,33,69,4,23,27
54,8480813,Joe Veleno,C,DET,24,79,14,12,26
54,8476897,Oskar Sundqvist,C,STL,30,61,14,12,26
54,8480789,Oliver Wahlstrom,R,NYI,24,67,12,14,26
54,8480068,Ryan Poehling,C,PHI,25,77,11,15,26
54,8476480,Vladislav Namestnikov,C,WPG,32,65,11,15,26
54,8482089,Jake Neighbours,L,STL,22,70,10,16,26
54,8478508,Yakov Trenin,C,MIN,27,66,10,16,26
54,8476921,Jordan Martinook,L,CAR,32,53,8,18,26
54,8476624,Barclay Goodrow,C,SJS,31,54,8,18,26
54,8482624,Daniil Miromanov,D,CGY,27,70,6,20,26
54,8481606,Jordan Spence,D,LAK,23,68,3,23,26
54,8481032,Paul Cotter,C,NJD,25,66,18,7,25
54,8482259,Bobby McMann,C,TOR,28,68,16,9,25
54,8481554,Kaapo Kakko,R,NYR,23,63,13,12,25
54,8473453,Trevor Lewis,C,LAK,37,76,13,12,25
54,8481553,Bobby Brink,R,PHI,23,55,10,15,25
54,8483457,Lane Hutson,D,MTL,20,68,10,15,25
54,8478013,Jake Walman,D,SJS,28,70,9,16,25
54,8479591,Michael Eyssimont,C,TBL,28,81,7,18,25
54,8476902,Esa Lindell,D,DAL,30,78,6,19,25
54,8478970,Jalen Chatfield,D,CAR,28,69,6,19,25
54,8482142,Jamie Drysdale,D,PHI,22,65,5,20,25
54,8478500,Ivan Provorov,D,CBJ,27,79,2,23,25
54,8477507,Nikita Zadorov,D,BOS,29,71,2,23,25
54,8481601,Simon Holmstrom,R,NYI,23,64,13,11,24
54,8482809,Jackson Blake,R,CAR,21,63,12,12,24
54,8477919,Frederick Gaudreau,C,MIN,31,61,11,13,24
54,8477979,Nicolas Aube-Kubel,R,BUF,28,58,11,13,24
54,8475231,Casey Cizikas,C,NYI,33,71,10,14,24
54,8476873,Mark Jankowski,C,NSH,30,54,9,15,24
54,8479393,Noah Gregor,L,OTT,26,72,9,15,24
54,8476329,Travis Boyd,C,MIN,31,59,9,15,24
54,8478434,Keegan Kolesar,R,VGK,27,64,8,16,24
54,8475343,Nic Dowd,C,WSH,34,63,7,17,24
54,8483565,Nick Blankenburg,D,NSH,26,68,7,17,24
54,8475791,Taylor Hall,L,CHI,33,56,6,18,24
54,8473507,Jeff Petry,D,DET,37,72,5,19,24
54,8476931,Jake McCabe,D,TOR,31,66,5,19,24
54,8482655,Janis Moser,D,TBL,24,76,4,20,24
54,8479371,Dante Fabbro,D,NSH,26,64,4,20,24
54,8479368,Max Jones,L,BOS,26,68,12,11,23
54,8481481,Blake Lizotte,C,PIT,27,62,11,12,23
54,8483445,Cutter Gauthier,L,ANA,20,67,7,16,23
54,8482073,Braden Schneider,D,NYR,23,70,6,17,23
54,8479315,Joey Anderson,R,CHI,26,51,5,18,23
54,8482803,Olen Zellweger,D,ANA,21,63,5,18,23
54,8476467,Jamie Oleksiak,D,SEA,32,67,5,18,23
54,8479398,Samuel Girard,D,COL,26,66,0,23,23
54,8478840,Will Borgen,D,SEA,28,59,0,23,23
54,8482062,Cole Smith,L,NSH,29,57,12,10,22
54,8479328,Julien Gauthier,R,NYI,27,60,12,10,22
54,8480806,Isac Lundestrom,C,ANA,25,57,10,12,22
54,8476457,Adam Larsson,D,SEA,32,72,4,18,22
54,8476525,Colin Miller,D,WPG,32,63,2,20,22
54,8476429,Scott Mayfield,D,NYI,32,74,1,21,22
54,8480281,Alexey Toropchenko,R,STL,25,64,14,7,21
54,8477446,Michael McCarron,R,NSH,29,54,14,7,21
54,8480762,Eric Robinson,L,CAR,29,55,12,9,21
54,8476878,Zemgus Girgensons,C,TBL,30,80,12,9,21
54,8475714,Calle Jarnkrok,C,TOR,33,74,11,10,21
54,8477903,Garnet Hathaway,R,PHI,33,61,10,11,21
54,8476918,Jimmy Vesey,L,NYR,31,65,8,13,21
54,8483468,Jiri Kulich,C,BUF,20,55,7,14,21
54,8478882,Vladislav Gavrikov,D,LAK,29,70,5,16,21
54,8477220,Nate Schmidt,D,FLA,33,72,5,16,21
54,8475233,David Savard,D,MTL,34,58,4,17,21
54,8477845,Trevor van Riemsdyk,D,WSH,33,57,4,17,21
54,8482245,Artem Zub,D,OTT,29,66,4,17,21
54,8481167,Brayden Pachal,D,CGY,25,46,4,17,21
54,8476891,Matthew Grzelcyk,D,PIT,30,77,3,18,21
54,8480222,Sebastian Aho,D,PIT,28,71,2,19,21
54,8481093,Rafael Harvey-Pinard,L,MTL,25,57,12,8,20
54,8474034,Patrick Maroon,L,CHI,36,54,11,9,20
54,8481641,Joel Kiviranta,L,COL,28,69,11,9,20
54,8475225,Craig Smith,C,CHI,35,50,11,9,20
54,8480995,Pontus Holmberg,R,TOR,25,58,10,10,20
54,8476278,Colin Blackwell,C,DAL,31,80,8,12,20
54,8476474,Stefan Noesen,R,NJD,31,64,7,13,20
54,8481624,Ilya Mikheyev,R,CHI,30,61,7,13,20
54,8475855,Jesper Fast,R,CAR,33,55,6,14,20
54,8480144,David Kampf,C,TOR,29,72,5,15,20
54,8480878,Nils Lundkvist,D,DAL,24,75,4,16,20
54,8474673,TJ Brodie,D,CHI,34,61,1,19,20
54,8482155,Alex Laferriere,R,LAK,23,63,12,7,19
54,8482737,Zack Bolduc,C,STL,21,61,11,8,19
54,8479414,Nathan Bastian,R,NJD,27,62,9,10,19
54,8476934,Brock McGinn,L,ANA,30,51,9,10,19
54,8482679,Matt Coronato,R,CGY,22,68,9,10,19
54,8480003,Jesper Boqvist,C,FLA,26,64,8,11,19
54,8476988,Matt Benning,D,SJS,30,68,8,11,19
54,8477450,Jason Dickinson,C,CHI,29,56,8,11,19
54,8482176,Wyatt Kaiser,D,CHI,22,57,7,12,19
54,8477353,Tyler Motte,C,DET,29,68,6,13,19
54,8481019,David Gustafsson,C,WPG,24,45,6,13,19
54,8475462,Radko Gudas,D,ANA,34,65,5,14,19
54,8481521,Ronnie Attard,D,PHI,25,54,5,14,19
54,8478416,Erik Cernak,D,TBL,27,74,4,15,19
54,8475324,Nick Jensen,D,OTT,34,69,2,17,19
54,8482087,Kaiden Guhle,D,MTL,22,67,1,18,19
54,8483499,Liam Ohgren,L,MIN,20,52,10,8,18
54,8482762,Simon Edvinsson,D,DET,21,61,10,8,18
54,8476374,Sean Kuraly,C,CBJ,31,54,9,9,18
54,8481704,Juuso Parssinen,C,NSH,23,52,8,10,18
54,8479344,Jesse Puljujarvi,R,PIT,26,55,8,10,18
54,8476856,Mathew Dumba,D,DAL,30,68,8,10,18
54,8481582,Nicholas Robertson,L,TOR,23,69,7,11,18
54,8477018,Ben Hutton,D,VGK,31,50,7,11,18
54,8479370,Tyson Jost,C,CAR,26,54,7,11,18
54,8477499,Rasmus Ristolainen,D,PHI,30,63,7,11,18
54,8482192,Isaak Phillips,D,CHI,23,47,7,11,18
54,8481441,Joe Snively,C,DET,28,67,6,12,18
54,8479543,Michael Pezzetta,L,MTL,26,58,6,12,18
54,8477406,Mattias Janmark,C,EDM,32,65,5,13,18
54,8482451,Mikael Pyyhtia,L,CBJ,23,45,4,14,18
54,8474574,Tyler Myers,D,VAN,34,61,3,15,18
54,8480246,Nick Perbix,D,TBL,26,70,3,15,18
54,8481014,Alexander Romanov,D,NYI,24,76,2,16,18
54,8476892,Colton Parayko,D,STL,31,69,1,17,18
54,8480049,Dylan Samberg,D,WPG,25,67,0,18,18
54,8477380,Jonny Brodzinski,C,NYR,31,52,12,5,17
54,8476960,Andreas Athanasiou,C,CHI,30,52,10,7,17
54,8481028,Martin Pospisil,C,CGY,25,64,10,7,17
54,8479316,Luke Kunin,C,SJS,27,59,9,8,17
54,8480289,Morgan Barron,C,WPG,26,56,8,9,17
54,8482077,Dylan Holloway,L,EDM,23,53,8,9,17
54,8479520,Brandon Duhaime,R,WSH,27,52,8,9,17
54,8479293,Brandon Tanev,L,SEA,33,62,7,10,17
54,8478399,Jonas Siegenthaler,D,NJD,27,59,7,10,17
54,8483482,Tristan Luneau,D,ANA,20,65,7,10,17
54,8480355,Mark Kastelic,C,BOS,25,63,6,11,17
54,8481527,Kaedan Korczak,D,VGK,23,42,5,12,17
54,8482807,Ethan Del Mastro,D,CHI,21,56,4,13,17
54,8477508,Curtis Lazar,C,NJD,29,56,4,13,17
54,8475177,Calvin de Haan,D,COL,33,40,4,13,17
54,8481178,Egor Zamula,D,PHI,24,56,3,14,17
54,8474013,Ian Cole,D,UTA,35,57,2,15,17
54,8475188,Brayden McNabb,D,VGK,33,66,1,16,17
54,8478136,Jake Middleton,D,MIN,28,70,1,16,17
54,8475208,Brian Dumoulin,D,ANA,33,63,1,16,17
54,8475750,Jon Merrill,D,MIN,32,64,1,16,17
54,8478178,Darren Raddysh,D,TBL,28,71,0,17,17
54,8479619,Michael Carcone,L,UTA,28,57,9,7,16
54,8481477,Nico Sturm,C,SJS,29,52,8,8,16
54,8482157,Will Cuylle,L,NYR,22,62,7,9,16
54,8484149,Gavin Brindley,C,CBJ,20,53,7,9,16
54,8478043,Sam Lafferty,C,BUF,29,62,7,9,16
54,8476994,Vinnie Hinostroza,C,NSH,30,52,7,9,16
54,8481599,Victor Soderstrom,D,UTA,23,40,7,9,16
54,8476422,Mike Reilly,D,NYI,31,73,6,10,16
54,8480205,Emil Bemstrom,C,PIT,25,54,6,10,16
54,8476822,Luke Glendening,C,TBL,35,79,6,10,16
54,8479968,Vinni Lettieri,C,BOS,29,44,6,10,16
54,8481013,Jonatan Berggren,R,DET,24,63,5,11,16
54,8482067,Connor Mackey,D,NYR,28,60,4,12,16
54,8479998,Mikey Anderson,D,LAK,25,60,4,12,16
54,8477369,Carson Soucy,D,VAN,30,67,4,12,16
54,8475790,Erik Gudbranson,D,CBJ,32,79,2,14,16
54,8475179,Dmitry Kulikov,D,FLA,34,58,2,14,16
54,8480891,Michael Kesselring,D,UTA,24,60,2,14,16
54,8480070,Ian Mitchell,D,BOS,25,48,2,14,16
54,8480011,Klim Kostin,C,SJS,25,51,11,4,15
54,8482784,Zach Dean,C,STL,21,39,9,6,15
54,8479336,Carl Grundstrom,R,SJS,27,58,8,7,15
54,8481716,Dmitri Voronkov,L,CBJ,24,41,8,7,15
54,8479718,Alex Barré-Boulet,C,MTL,27,48,7,8,15
54,8480980,Connor Dewar,C,TOR,25,74,7,8,15
54,8475181,Nick Leddy,D,STL,33,70,3,12,15
54,8481568,Alex Vlasic,D,CHI,23,48,3,12,15
54,8470600,Ryan Suter,D,STL,39,60,3,12,15
54,8478451,Ethan Bear,D,WSH,27,47,3,12,15
54,8482095,Tyler Kleven,D,OTT,22,43,3,12,15
54,8480860,Kevin Bahl,D,CGY,24,51,2,13,15
54,8482964,Arber Xhekaj,D,MTL,23,44,2,13,15
54,8481059,Scott Perunovich,D,STL,26,62,2,13,15
54,8480074,Alexandre Texier,C,STL,25,57,1,14,15
54,8477573,Nathan Walker,L,STL,30,53,8,6,14
54,8476889,Radek Faksa,C,STL,30,59,7,7,14
54,8482659,Josh Doan,R,UTA,22,53,6,8,14
54,8483466,Kevin Korchinski,D,CHI,20,49,4,10,14
54,8482730,Brandt Clarke,D,LAK,21,43,3,11,14
54,8479066,Ryan Lomberg,L,CGY,30,62,3,11,14
54,8477365,Connor Clifton,D,BUF,29,57,2,12,14
54,8474567,Zach Bogosian,D,MIN,34,71,2,12,14
54,8480441,Trey Fix-Wolansky,R,CBJ,25,37,2,12,14
54,8481517,Brett Leason,R,ANA,25,58,10,3,13
54,8478421,A.J. Greer,L,FLA,28,60,9,4,13
54,8482666,Scott Morrow,D,CAR,22,50,8,5,13
54,8476867,Brendan Gaunce,C,MIN,30,38,6,7,13
54,8479982,Conor Timmins,D,TOR,26,51,5,8,13
54,8480021,Jack Studnicka,C,LAK,25,61,5,8,13
54,8480448,Parker Kelly,L,COL,25,76,5,8,13
54,8479324,Ryan Lindgren,D,NYR,26,65,5,8,13
54,8478585,Derek Ryan,C,EDM,38,61,5,8,13
54,8480007,Jonas Rondbjerg,R,VGK,25,39,5,8,13
54,8478432,Christian Fischer,R,DET,27,68,4,9,13
54,8480252,Cole Guttman,C,CHI,25,34,4,9,13
54,8476312,Josh Manson,D,COL,33,65,3,10,13
54,8479983,Mario Ferraro,D,SJS,26,64,3,10,13
54,8480807,Mattias Samuelsson,D,BUF,24,52,3,10,13
54,8482148,Hendrix Lapierre,C,WSH,22,52,3,10,13
54,8482166,Shakir Mukhamadullin,D,SJS,22,53,3,10,13
54,8481522,Peyton Krebs,C,BUF,23,59,2,11,13
54,8480058,Pierre-Olivier Joseph,D,STL,25,53,2,11,13
54,8476879,Cody Ceci,D,EDM,31,67,0,13,13
54,8480172,Jan Rutta,D,SJS,34,59,0,13,13
54,8480025,MacKenzie Entwistle,R,FLA,25,60,9,3,12
54,8479671,Mathieu Olivier,R,CBJ,27,41,7,5,12
54,8475235,Nicolas Deslauriers,L,PHI,33,48,7,5,12
54,8478831,Kevin Stenlund,C,UTA,28,47,6,6,12
54,8480796,Martin Fehervary,D,WSH,25,54,5,7,12
54,8480192,Johnathan Kovacevic,D,NJD,27,53,5,7,12
54,8481537,Nikita Okhotiuk,D,CGY,24,46,5,7,12
54,8479639,Dylan Coghlan,D,WPG,26,59,4,8,12
54,8482634,Alex Steeves,C,TOR,25,45,3,9,12
54,8478452,Caleb Jones,D,LAK,27,57,3,9,12
54,8479442,Troy Stecher,D,EDM,30,53,3,9,12
54,8479944,Zach Aston-Reese,C,VGK,30,52,3,9,12
54,8471709,Marc-Edouard Vlasic,D,SJS,37,67,3,9,12
54,8475279,Ben Chiarot,D,DET,33,65,2,10,12
54,8477938,Haydn Fleury,D,WPG,28,52,2,10,12
54,8481518,Nolan Foote,L,NJD,24,43,10,1,11
54,8476442,Matt Nieto,L,PIT,32,44,5,6,11
54,8480848,Ty Dellandrea,C,SJS,24,49,5,6,11
54,8479369,Andrew Peeke,D,BOS,26,57,4,7,11
54,8478443,Brandon Carlo,D,BOS,28,51,4,7,11
54,8480727,Zach Whitecloud,D,VGK,28,51,4,7,11
54,8476874,Olli Maatta,D,DET,30,58,3,8,11
54,8483495,Simon Nemec,D,NJD,20,54,3,8,11
54,8479291,Kevin Rooney,C,CGY,31,51,3,8,11
54,8482861,Vincent Iorio,D,WSH,22,39,3,8,11
54,8476967,Brett Kulak,D,EDM,30,67,2,9,11
54,8481550,Adam Beckman,L,NJD,23,35,2,9,11
54,8482744,James Malatesta,L,CBJ,21,44,2,9,11
54,8480196,Jacob Bryson,D,BUF,27,44,2,9,11
54,8479026,Philippe Myers,D,TOR,27,61,1,10,11
54,8479986,Kole Lind,R,DAL,26,54,1,10,11
54,8478211,Dryden Hunt,L,CGY,29,48,5,5,10
54,8477931,Tomas Nosek,L,FLA,32,53,5,5,10
54,8479439,Jacob MacDonald,D,COL,31,52,5,5,10
54,8475842,Sam Carrick,C,NYR,32,58,5,5,10
54,8481617,Vasily Podkolzin,R,VAN,23,50,5,5,10
54,8480887,Jordan Harris,D,MTL,24,59,4,6,10
54,8479359,Beck Malenstyn,L,BUF,26,42,3,7,10
54,8482747,Brennan Othmann,L,NYR,21,40,3,7,10
54,8479372,Joshua Mahura,D,SEA,26,56,3,7,10
54,8474090,Brendan Smith,D,DAL,35,50,3,7,10
54,8477851,Jordan Oesterle,D,BOS,32,45,2,8,10
54,8475718,Justin Holl,D,DET,32,63,1,9,10
54,8480879,Jacob Bernard-Docker,D,OTT,24,45,1,9,10
54,8479249,Andrew Poturalski,C,SJS,30,33,0,10,10
54,8481679,Maxence Guenette,D,OTT,23,39,7,2,9
54,8476858,Phillip Di Giuseppe,L,VAN,31,42,6,3,9
54,8477070,Liam O'Brien,C,UTA,30,53,5,4,9
54,8479994,Jaret Anderson-Dolan,C,WPG,25,31,5,4,9
54,8481754,Nikita Nesterenko,C,ANA,23,36,4,5,9
54,8478569,Noel Acciari,C,PIT,33,56,4,5,9
54,8479772,Zack MacEwen,R,OTT,28,55,4,5,9
54,8475795,Dylan McIlrath,D,WSH,32,19,4,5,9
54,8482153,Brendan Brisson,C,VGK,23,41,4,5,9
54,8481701,Santeri Hatakka,D,NJD,23,34,2,7,9
54,8477384,Joshua Brown,D,EDM,30,44,2,7,9
54,8471677,Jack Johnson,D,CBJ,37,66,2,7,9
54,8474568,Luke Schenn,D,NSH,35,45,1,8,9
54,8475455,Brenden Dillon,D,NJD,34,55,0,9,9
54,8477482,Zachary Sanford,L,CHI,30,35,6,2,8
54,8479536,Axel Jonsson-Fjallby,L,WPG,26,38,6,2,8
54,8482496,Nils Aman,C,VAN,24,39,5,3,8
54,8483549,Lucas Condotta,L,MTL,27,37,5,3,8
54,8480845,Rasmus Kupari,C,WPG,24,44,4,4,8
54,8484911,Collin Graf,R,SJS,22,27,4,4,8
54,8482733,Logan Mailloux,D,MTL,31,30,4,4,8
54,8481567,Henry Thrun,D,SJS,23,48,3,5,8
54,8479638,Justin Brazeau,R,BOS,26,32,3,5,8
54,8477962,Brendan Lemieux,L,CAR,28,40,3,5,8
54,8476441,Joel Edmundson,D,LAK,31,39,3,5,8
54,8479378,Logan Stanley,D,WPG,26,44,2,6,8
54,8482751,Ryan Winterton,C,SEA,21,33,2,6,8
54,8478468,Jeremy Lauzon,D,NSH,27,51,2,6,8
54,8477034,Jaycob Megna,D,FLA,32,36,2,6,8
54,8476952,Dominic Toninato,C,WPG,30,37,1,7,8
54,8479576,Vincent Desharnais,D,VAN,28,41,1,7,8
54,8480001,Urho Vaakanainen,D,ANA,25,61,0,8,8
54,8480950,Ilya Lyubushkin,D,DAL,30,62,0,8,8
54,8483619,Filip Roos,D,OTT,25,38,0,8,8
54,8483570,Ben Meyers,C,SEA,26,31,5,2,7
54,8477887,Patrick Brown,C,BOS,32,50,4,3,7
54,8480880,Jakub Lauko,C,MIN,24,37,4,3,7
54,8478409,Anthony Richard,C,PHI,28,31,4,3,7
54,8481543,Nikita Alexandrov,C,STL,24,22,4,3,7
54,8479981,Jonah Gadjovich,L,FLA,26,38,4,3,7
54,8483630,Pavol Regenda,L,ANA,25,32,4,3,7
54,8481161,Jake Christiansen,D,CBJ,25,52,3,4,7
54,8481532,Alex Turcotte,C,LAK,23,40,3,4,7
54,8479972,Mason Shaw,C,WPG,26,28,3,4,7
54,8481789,Tye Kartye,L,SEA,23,36,3,4,7
54,8483460,David Jiricek,D,CBJ,21,55,3,4,7
54,8475690,Chris Tanev,D,TOR,35,70,2,5,7
54,8473446,Erik Johnson,D,PHI,36,49,2,5,7
54,8474166,Alec Martinez,D,CHI,37,50,2,5,7
54,8482765,Isak Rosen,R,BUF,21,33,2,5,7
54,8481600,Tobias Bjornfot,D,FLA,23,40,2,5,7
54,8480245,Olle Lycksell,R,PHI,25,31,2,5,7
54,8478146,Matthew Highmore,C,OTT,28,36,2,5,7
54,8481708,Zac Jones,D,NYR,24,43,1,6,7
54,8478859,Niko Mikkola,D,FLA,28,55,1,6,7
54,8475958,Michael Sgarbossa,C,WSH,32,30,1,6,7
54,8480870,Bo Groulx,C,NYR,24,32,1,6,7
54,8482141,Lukas Cormier,D,VGK,22,27,1,6,7
54,8476372,Nick Seeler,D,PHI,31,36,0,7,7
54,8482652,Walker Duehr,R,CGY,27,37,5,1,6
54,8481592,Jakob Pelletier,L,CGY,23,35,5,1,6
54,8483397,Marc McLaughlin,C,BOS,25,33,4,2,6
54,8481556,John Beecher,C,BOS,23,35,3,3,6
54,8474612,Travis Hamonic,D,OTT,34,46,3,3,6
54,8478017,Mark Friedman,D,VAN,29,45,3,3,6
54,8483763,Maksymilian Szuber,D,UTA,22,25,3,3,6
54,8477335,Kyle Burroughs,D,LAK,29,43,2,4,6
54,8480157,Calle Rosen,D,COL,30,40,2,4,6
54,8479348,Kale Clague,D,BUF,26,40,2,4,6
54,8481699,Aku Raty,R,UTA,23,28,2,4,6
54,8482511,Mason Lohrei,D,BOS,23,38,2,4,6
54,8481541,Samuel Bolduc,D,NYI,24,30,2,4,6
54,8478454,Noah Juulsen,D,VAN,27,34,1,5,6
54,8479980,Nicolas Hague,D,VGK,26,52,0,6,6
54,8478450,Parker Wotherspoon,D,BOS,27,39,0,6,6
54,8481609,Vladislav Kolyachonok,D,UTA,23,39,0,6,6
54,8479587,Rhett Gardner,C,PHI,28,25,0,6,6
54,8481122,Simon Benoit,D,TOR,26,28,0,6,6
54,8476913,Devin Shore,C,MIN,30,26,3,2,5
54,8481598,Philip Broberg,D,EDM,23,43,3,2,5
54,8471817,Ryan Reaves,R,TOR,37,48,2,3,5
54,8481056,Spencer Stastney,D,NSH,24,32,2,3,5
54,8476473,Connor Murphy,D,CHI,31,38,2,3,5
54,8482144,Jack Thompson,D,SJS,22,33,2,3,5
54,8482088,Justin Sourdif,R,FLA,22,16,2,3,5
54,8481147,Reese Johnson,C,MIN,26,33,1,4,5
54,8482713,Mackie Samoskevich,R,FLA,22,42,1,4,5
54,8484254,Akito Hirose,D,VAN,25,31,1,4,5
54,8482858,Ryker Evans,D,SEA,23,31,0,5,5
54,8484287,Cole McWard,D,VAN,23,18,4,0,4
54,8482177,Marat Khusnutdinov,C,MIN,22,36,3,1,4
54,8481751,Lukas Rousek,R,BUF,25,36,2,2,4
54,8478424,Jansen Harkins,C,ANA,27,43,2,2,4
54,8482070,Mitchell Chaffee,R,TBL,26,39,2,2,4
54,8481237,Kyle MacLean,C,NYI,25,24,2,2,4
54,8479320,Maxime Lajoie,D,SEA,27,19,2,2,4
54,8477971,Andreas Englund,D,LAK,28,31,2,2,4
54,8481719,Maxwell Crozier,D,TBL,24,16,2,2,4
54,8475762,Derek Forbort,D,VAN,32,41,1,3,4
54,8483012,Logan Morrison,C,SEA,22,39,1,3,4
54,8482147,Jean-Luc Foudy,C,COL,22,26,1,3,4
54,8480990,Declan Chisholm,D,MIN,24,34,0,4,4
54,8477462,Robert Hagg,D,VGK,29,23,0,4,4
54,8480834,Ty Emberson,D,SJS,24,30,0,4,4
54,8480890,Jan Jenik,C,OTT,24,30,0,4,4
54,8477244,Chad Ruhwedel,D,NYR,34,32,2,1,3
54,8481422,Jake Lucchini,C,NSH,29,17,2,1,3
54,8478051,Max Willman,C,NJD,29,18,2,1,3
54,8477320,Anton Blidh,L,NYR,29,22,2,1,3
54,8482172,Landon Slaggert,L,CHI,22,27,1,2,3
54,8482859,Zack Ostapchuk,C,OTT,21,41,1,2,3
54,8482470,Ilya Solovyov,D,CGY,24,21,1,2,3
54,8478874,Adam Gaudette,R,OTT,28,38,1,2,3
54,8480267,Sammy Walker,C,MIN,25,23,1,2,3
54,8482165,Yan Kuznetsov,D,CGY,22,18,1,2,3
54,8477473,Justin Bailey,R,SJS,29,19,1,2,3
54,8483471,Brad Lambert,C,WPG,31,9,1,2,3
54,8479362,Riley Tufte,L,BOS,26,14,1,2,3
54,8478021,William Lagesson,D,DET,28,23,0,3,3
54,8482145,Mavrik Bourque,C,DAL,22,38,0,3,3
54,8475413,Justin Dowling,C,NJD,34,18,0,3,3
54,8479379,Givani Smith,R,SJS,26,34,0,3,3
54,8480084,Nick DeSimone,D,NJD,30,19,0,3,3
54,8477401,John Hayden,C,SEA,29,29,2,0,2
54,8481462,Mason Morelli,L,VGK,28,17,2,0,2
54,8477527,Ross Johnston,L,ANA,30,24,1,1,2
54,8480844,Grigori Denisenko,L,VGK,24,23,1,1,2
54,8477810,Joel Hanley,D,CGY,33,24,1,1,2
54,8479985,Cale Fleury,D,SEA,26,29,1,1,2
54,8482250,Callahan Burke,C,VGK,27,19,1,1,2
54,8481065,Angus Crookshank,L,OTT,25,12,1,1,2
54,8481578,Graeme Clarke,R,MIN,23,8,1,1,2
54,8481030,Jack St. Ivany,D,PIT,25,17,0,2,2
54,8477149,Scott Sabourin,R,SJS,32,7,0,2,2
54,8477467,Gustav Olofsson,D,SEA,30,13,0,2,2
54,8481593,Jayden Struble,D,MTL,23,21,0,2,2
54,8479991,Jake Leschyshyn,C,NYR,25,28,0,2,2
54,8479419,Brett Murray,L,BUF,26,22,0,2,2
54,8482061,Brandon Biro,L,SEA,26,8,0,2,2
54,8481605,Jackson LaCombe,D,ANA,23,29,1,0,1
54,8478502,Dennis Gilbert,D,BUF,28,20,1,0,1
54,8483512,Matthew Savoie,C,EDM,20,12,1,0,1
54,8482162,Roby Jarventie,L,EDM,22,12,1,0,1
54,8482516,Matthew Kessel,D,STL,24,18,1,0,1
54,8484325,Waltteri Merela,C,TBL,26,19,1,0,1
54,8477073,Kurtis MacDermid,L,NJD,30,32,1,0,1
54,8481585,Egor Afanasyev,L,SJS,23,15,1,0,1
54,8475780,Chris Wagner,R,COL,33,6,1,0,1
54,8477541,Dakota Mermis,D,TOR,30,10,1,0,1
54,8478881,Brett Seney,L,CHI,28,13,1,0,1
54,8480075,Cameron Crotty,D,MIN,25,5,1,0,1
54,8483531,Brian Halonen,L,NJD,25,5,1,0,1
54,8480292,Carson Meyer,R,ANA,27,33,0,1,1
54,8484258,Sam Malinski,D,COL,26,19,0,1,1
54,8483432,Luca Del Bel Belluz,C,CBJ,31,6,0,1,1
54,8481043,Cole Koepke,L,BOS,26,16,0,1,1
54,8482102,Vasily Ponomarev,C,PIT,22,17,0,1,1
54,8480032,Shane Bowers,C,NJD,25,15,0,1,1
54,8481743,Marc Del Gaizo,D,NSH,25,20,0,1,1
54,8481006,Tyler Tucker,D,STL,24,10,0,1,1
54,8483398,Declan Carlile,D,TBL,31,7,0,1,1
54,8482929,Emil Lilleberg,D,TBL,23,20,0,1,1
54,8484304,Uvis Balinskis,D,FLA,28,12,0,1,1
54,8481206,John Ludvig,D,PIT,24,11,0,1,1
54,8482094,Daemon Hunt,D,MIN,22,14,0,1,1
54,8480874,Adam Ginning,D,PHI,24,14,0,1,1
54,8483546,Marshall Rifai,D,TOR,26,10,0,1,1
54,8481806,Louis Crevier,D,CHI,23,13,0,1,1
54,8482201,Gage Goncalves,C,TBL,23,33,0,1,1
54,8483395,Arshdeep Bains,L,VAN,23,8,0,1,1
54,8478477,Mitchell Stephens,C,SEA,27,14,0,1,1
54,8481655,Cole Schwindt,R,CGY,23,8,0,1,1
54,8480468,James Hamblin,L,EDM,25,22,0,1,1
54,8480306,Grant Hutton,D,NYI,29,6,0,1,1
54,8479330,Brandon Gignac,C,MTL,27,6,0,1,1
54,8483407,Brandon Scanlin,D,NYR,25,5,0,1,1
54,8479367,William Lockwood,R,FLA,26,27,0,0,0
54,8474062,Riley Nash,C,NYR,35,11,0,0,0
54,8482118,Sam Colangelo,R,ANA,23,14,0,0,0
54,8483489,Fraser Minten,C,TOR,31,11,0,0,0
54,8478011,Louie Belpedio,D,PHI,28,9,0,0,0
54,8481024,Linus Karlsson,C,VAN,25,7,0,0,0
54,8484259,Ondrej Pavel,C,COL,31,2,0,0,0
54,8483597,Milos Kelemen,L,UTA,25,8,0,0,0
54,8481726,Adam Edstrom,C,NYR,24,7,0,0,0
54,8484255,Jason Polin,R,COL,25,6,0,0,0
54,8477993,Justin Kirkland,C,CGY,28,5,0,0,0
54,8483920,Pierrick Dube,R,WSH,23,5,0,0,0
54,8480851,Akil Thomas,C,LAK,24,18,0,0,0
54,8480823,Alexander Alexeyev,D,WSH,25,13,0,0,0
54,8482787,Nikita Chibrikov,R,WPG,31,6,0,0,0
54,8481564,Ryan Johnson,D,BUF,23,19,0,0,0
54,8479421,Jacob Moverare,D,LAK,26,6,0,0,0
54,8482460,Matt Rempe,C,NYR,22,11,0,0,0
54,8478147,Bokondji Imama,L,PIT,28,5,0,0,0
54,8478446,Glenn Gawdin,C,LAK,27,12,0,0,0
54,8483567,Georgii Merkulov,C,BOS,24,8,0,0,0
54,8484321,Nikolas Matinpalo,D,OTT,26,1,0,0,0
54,8478854,Ryan Shea,D,PIT,27,9,0,0,0
54,8482126,Emil Andrae,D,PHI,31,1,0,0,0
54,8479522,Hardy Haman Aktell,D,WSH,26,3,0,0,0
54,8482476,Emil Heineman,L,MTL,23,3,0,0,0
54,8482197,Adam Raska,R,MIN,23,7,0,0,0
54,8475755,Alexander Petrovic,D,DAL,32,7,0,0,0
54,8483401,Marc Johnstone,R,PIT,28,1,0,0,0
54,8481534,Raphael Lavoie,C,EDM,24,0,0,0,0
54,8484326,Patrik Koch,D,UTA,28,3,0,0,0
54,8476323,Max McCormick,L,SEA,32,5,0,0,0
54,8483609,Adam Klapka,R,CGY,24,2,0,0,0
54,8480274,Philip Kemp,D,EDM,25,1,0,0,0
54,8470794,Joe Pavelski,C,,40,0,0,0,0
54,8479321,Lucas Johansen,D,,27,0,0,0,0
54,8477950,Tony DeAngelo,D,,29,0,0,0,0
54,8471218,Blake Wheeler,R,,38,0,0,0,0
54,8475197,Tyson Barrie,D,,33,0,0,0,0
54,8474157,Max Pacioretty,L,,36,0,0,0,0
54,8475744,Evgeny Kuznetsov,C,,32,0,0,0,0
54,8474037,James van Riemsdyk,L,,35,0,0,0,0
54,8476907,Mackenzie MacEachern,L,,30,0,0,0,0
54,8480216,Jacob Peterson,C,,25,0,0,0,0
54,8474602,Justin Schultz,D,,34,0,0,0,0
54,8482222,Alexander Barabanov,L,,30,0,0,0,0
54,8474031,Kevin Shattenkirk,D,,35,0,0,0,0
54,8477330,Dominik Kubalik,L,,29,0,0,0,0
54,8480884,Calen Addison,D,,24,0,0,0,0
54,8475906,John Klingberg,D,,32,0,0,0,0
54,8480008,Adam Ruzicka,C,,25,0,0,0,0
54,8476884,Derrick Pouliot,D,,30,0,0,0,0
54,8476919,Chris Tierney,C,,30,0,0,0,0
54,8479415,Michael McLeod,C,,26,0,0,0,0
54,8474870,Tyler Johnson,C,,34,0,0,0,0
54,8470604,Jeff Carter,C,,39,0,0,0,0
54,8478104,Sammy Blais,L,,28,0,0,0,0
54,8474884,Mike Hoffman,C,,35,0,0,0,0
54,8481591,Sam Poulin,R,,23,0,0,0,0
54,8471274,Alex Goligoski,D,,39,0,0,0,0
54,8476871,Tanner Pearson,L,,32,0,0,0,0
54,8476393,Nick Cousins,C,,31,0,0,0,0
54,8479977,Kailer Yamamoto,R,,26,0,0,0,0
54,8479346,Dillon Dube,C,,26,0,0,0,0
54,8480184,Gustav Lindstrom,D,,26,0,0,0,0
54,8479376,Victor Mete,D,,26,0,0,0,0
54,8473449,Kyle Okposo,R,,36,0,0,0,0
54,8481058,Jesse Ylonen,R,,25,0,0,0,0
54,8475752,Tyler Pitlick,C,,33,0,0,0,0
54,8481239,Samuel Fagemo,L,,24,0,0,0,0
54,8480821,Filip Zadina,R,,25,0,0,0,0
54,8470966,Mark Giordano,D,,41,0,0,0,0
54,8478495,Denis Gurianov,R,,27,0,0,0,0
54,8477464,Nic Petan,C,,29,0,0,0,0
54,8478099,Kevin Labanc,R,,29,0,0,0,0
54,8482241,Radim Zohorna,L,,28,0,0,0,0
54,8474040,Sam Gagner,C,,35,0,0,0,0
54,8479514,Rem Pitlick,C,,27,0,0,0,0
54,8478430,Oliver Kylington,D,,27,0,0,0,0
54,8479533,Joona Koppanen,L,,26,0,0,0,0
54,8479984,Cal Foote,D,,26,0,0,0,0
54,8477126,Jayson Megna,C,,34,0,0,0,0
54,8475164,Jakob Silfverberg,R,,34,0,0,0,0
54,8474009,Nick Bonino,C,,36,0,0,0,0
54,8479458,Nikita Zaitsev,D,,33,0,0,0,0
54,8477944,Jakub Vrana,L,,28,0,0,0,0
54,8471699,Andrew Cogliano,C,,37,0,0,0,0
54,8478067,Oskar Lindblom,L,,28,0,0,0,0
54,8471686,Marc Staal,D,,37,0,0,0,0
54,8470610,Zach Parise,L,,40,0,0,0,0
54,8478904,Steven Lorentz,C,,28,0,0,0,0
54,8473473,Milan Lucic,L,,36,0,0,0,0
54,8480031,Maxime Comtois,L,,25,0,0,0,0
54,8478512,Austin Czarnik,C,,32,0,0,0,0
54,8473504,Cal Clutterbuck,R,,37,0,0,0,0
54,8477454,Adam Erne,L,,29,0,0,0,0
54,8479383,Boris Katchouk,L,,26,0,0,0,0
54,8475825,Jani Hakanpää,D,,32,0,0,0,0
54,8477846,Ryan Carpenter,C,,33,0,0,0,0
54,8477930,Pierre-Edouard Bellemare,L,,39,0,0,0,0
54,8478400,Colin White,C,,27,0,0,0,0
54,8480226,Marián Studenic,R,,26,0,0,0,0
54,8480853,Liam Foudy,C,,24,0,0,0,0
54,8475797,Jarred Tinordi,D,,32,0,0,0,0
54,8479423,Alex Nylander,L,,26,0,0,0,0
54,8474618,Marco Scandella,D,,34,0,0,0,0
54,8478028,Fredrik Olofsson,L,,28,0,0,0,0
54,8474709,Matt Martin,L,,35,0,0,0,0
54,8481070,Hugh McGing,L,,26,0,0,0,0
54,8479546,Oskar Steen,C,,26,0,0,0,0
54,8474145,Robert Bortuzzo,D,,35,0,0,0,0
54,8476915,Jujhar Khaira,L,,30,0,0,0,0
54,8475278,Byron Froese,C,,33,0,0,0,0
54,8481812,Nikolai Knyzhov,D,,27,0,0,0,0
54,8478408,Travis Dermott,D,,28,0,0,0,0
54,8481077,John Leonard,L,,26,0,0,0,0
54,8479547,Matthew Phillips,R,,26,0,0,0,0
54,8480836,Jonathan Gruden,C,,24,0,0,0,0
54,8481690,Tyler Angle,C,,24,0,0,0,0
54,8475766,Austin Watson,L,,32,0,0,0,0
54,8481016,Ruslan Iskhakov,C,,24,0,0,0,0
54,8478078,Rourke Chartier,C,,28,0,0,0,0
54,8480776,Sheldon Rempal,R,,29,0,0,0,0
54,8478956,Samuel Laberge,L,NJD,27,1,0,0,0
54,8483045,Cameron Butler,R,CBJ,31,0,0,0,0
54,8484314,Jiri Smejkal,L,,28,0,0,0,0
55,8476453,Nikita Kucherov,R,TBL,31,82,49,113,162
55,8478402,Connor McDavid,C,EDM,27,80,29,101,130
55,8481559,Jack Hughes,C,NJD,23,77,52,76,128
55,8479314,Matthew Tkachuk,L,FLA,27,78,44,82,126
55,8477956,David Pastrnak,R,BOS,28,82,52,72,124
55,8476468,J.T. Miller,C,VAN,31,76,47,74,121
55,8477492,Nathan MacKinnon,C,COL,29,81,52,68,120
55,8477934,Leon Draisaitl,C,EDM,29,78,48,67,115
55,8478420,Mikko Rantanen,R,COL,28,81,50,60,110
55,8479318,Auston Matthews,C,TOR,27,80,52,55,107
55,8478483,Mitch Marner,R,TOR,27,80,39,66,105
55,8477933,Sam Reinhart,C,FLA,29,79,45,59,104
55,8477939,William Nylander,R,TOR,28,80,53,50,103
55,8478550,Artemi Panarin,L,NYR,33,77,29,74,103
55,8477404,Jake Guentzel,C,TBL,30,82,43,58,101
55,8474600,Roman Josi,D,NSH,34,76,20,81,101
55,8480800,Quinn Hughes,D,VAN,25,79,12,88,100
55,8476887,Filip Forsberg,L,NSH,30,72,49,49,98
55,8480012,Elias Pettersson,C,VAN,26,75,35,61,96
55,8480069,Cale Makar,D,COL,26,73,21,74,95
55,8475172,Nazem Kadri,C,CGY,34,78,39,53,92
55,8471675,Sidney Crosby,C,PIT,37,75,35,57,92
55,8482116,Tim Stützle,C,OTT,22,78,31,61,92
55,8477942,Kevin Fiala,L,LAK,28,82,36,55,91
55,8474564,Steven Stamkos,C,NSH,34,73,45,45,90
55,8478864,Kirill Kaprizov,L,MIN,27,72,32,58,90
55,8476456,Jonathan Huberdeau,C,CGY,31,79,24,66,90
55,8477946,Dylan Larkin,C,DET,28,81,45,44,89
55,8479542,Brandon Hagel,L,TBL,26,82,36,53,89
55,8484144,Connor Bedard,C,CHI,19,75,31,58,89
55,8479343,Clayton Keller,R,UTA,26,80,31,57,88
55,8480023,Robert Thomas,C,STL,25,78,22,66,88
55,8476460,Mark Scheifele,C,WPG,31,73,34,50,84
55,8480002,Nico Hischier,C,NJD,25,79,31,52,83
55,8479407,Jesper Bratt,L,NJD,26,75,30,53,83
55,8478427,Sebastian Aho,C,CAR,27,72,31,51,82
55,8477493,Aleksander Barkov,C,FLA,29,76,28,54,82
55,8475166,John Tavares,C,TOR,34,76,37,44,81
55,8478403,Jack Eichel,C,VGK,28,79,31,50,81
55,8478010,Brayden Point,C,TBL,28,82,42,38,80
55,8477409,Carter Verhaeghe,C,FLA,29,78,42,37,79
55,8480801,Brady Tkachuk,L,OTT,25,76,31,46,77
55,8475167,Victor Hedman,D,TBL,34,79,18,59,77
55,8478414,Timo Meier,R,NJD,28,78,38,38,76
55,8471685,Anze Kopitar,C,LAK,37,81,23,53,76
55,8471214,Alex Ovechkin,L,WSH,39,77,40,35,75
55,8480208,Drake Batherson,R,OTT,26,81,28,47,75
55,8477501,Valeri Nichushkin,R,COL,29,81,37,37,74
55,8479385,Jordan Kyrou,C,STL,26,74,33,41,74
55,8477960,Adrian Kempe,R,LAK,28,80,29,45,74
55,8478439,Travis Konecny,R,PHI,27,80,28,46,74
55,8480027,Jason Robertson,L,DAL,25,82,26,48,74
55,8475913,Mark Stone,R,VGK,32,77,24,50,74
55,8471215,Evgeni Malkin,C,PIT,38,76,35,38,73
55,8482740,Wyatt Johnston,C,DAL,21,81,35,38,73
55,8476389,Vincent Trocheck,C,NYR,31,76,28,45,73
55,8476459,Mika Zibanejad,C,NYR,31,77,22,51,73
55,8479420,Tage Thompson,C,BUF,27,75,39,33,72
55,8475786,Zach Hyman,L,EDM,32,80,39,33,72
55,8481557,Matt Boldy,L,MIN,23,71,25,47,72
55,8478449,Roope Hintz,C,DAL,28,81,29,42,71
55,8480830,Andrei Svechnikov,R,CAR,24,68,27,44,71
55,8473994,Jamie Benn,L,DAL,35,82,23,48,71
55,8479323,Adam Fox,D,NYR,26,78,11,60,71
55,8476454,Ryan Nugent-Hopkins,C,EDM,31,78,24,46,70
55,8477500,Bo Horvat,C,NYI,29,79,40,28,68
55,8473419,Brad Marchand,L,BOS,36,76,24,44,68
55,8482699,Dylan Guenther,R,UTA,21,74,24,44,68
55,8477949,Alex Tuch,R,BUF,28,73,23,45,68
55,8474141,Patrick Kane,R,DET,36,77,23,45,68
55,8477402,Pavel Buchnevich,L,STL,29,74,31,36,67
55,8478440,Dylan Strome,C,WSH,27,72,23,44,67
55,8476905,Chandler Stephenson,C,SEA,30,74,20,47,67
55,8480018,Nick Suzuki,C,MTL,25,78,28,38,66
55,8478493,Joel Eriksson Ek,C,MIN,27,75,26,40,66
55,8478444,Brock Boeser,R,VAN,27,73,37,28,65
55,8478047,Michael Bunting,L,PIT,29,73,30,35,65
55,8473512,Claude Giroux,R,OTT,36,77,28,37,65
55,8482665,Matty Beniers,C,SEA,22,74,19,46,65
55,8474578,Erik Karlsson,D,PIT,34,80,11,54,65
55,8476881,Tomas Hertl,C,VGK,31,74,30,34,64
55,8475794,Tyler Seguin,C,DAL,32,81,28,36,64
55,8480039,Martin Necas,C,CAR,25,70,25,39,64
55,8476346,Johnny Gaudreau,L,CBJ,31,73,18,46,64
55,8475692,Mats Zuccarello,R,MIN,37,74,17,47,64
55,8480839,Rasmus Dahlin,D,BUF,24,69,19,44,63
55,8480865,Noah Dobson,D,NYI,24,79,10,53,63
55,8476875,Mike Matheson,D,MTL,30,70,9,54,63
55,8477955,Jared McCann,L,SEA,28,74,36,26,62
55,8477416,Oliver Bjorkstrand,R,SEA,29,76,29,33,62
55,8478398,Kyle Connor,L,WPG,28,67,28,34,62
55,8475784,Jeff Skinner,C,EDM,32,79,28,34,62
55,8479337,Alex DeBrincat,R,DET,27,81,26,36,62
55,8477951,Nick Schmaltz,C,UTA,28,80,26,36,62
55,8475184,Chris Kreider,L,NYR,33,74,36,25,61
55,8476539,Jonathan Marchessault,R,NSH,34,75,30,31,61
55,8477496,Elias Lindholm,C,BOS,30,80,18,43,61
55,8475158,Ryan O'Reilly,C,NSH,33,71,32,28,60
55,8474102,David Perron,L,OTT,36,80,27,33,60
55,8476448,William Karlsson,C,VGK,31,79,24,36,60
55,8478445,Mathew Barzal,C,NYI,27,78,20,40,60
55,8470613,Brent Burns,D,CAR,39,81,15,45,60
55,8477504,Josh Morrissey,D,WPG,29,75,10,50,60
55,8483515,Juraj Slafkovsky,L,MTL,20,76,20,39,59
55,8478460,Zach Werenski,D,CBJ,27,81,17,42,59
55,8482149,Cole Perfetti,C,WPG,22,68,34,24,58
55,8478975,Mason Marchment,L,DAL,29,81,20,38,58
55,8481068,Yegor Sharangovich,C,CGY,26,80,24,33,57
55,8480015,Owen Tippett,R,PHI,25,74,24,33,57
55,8479999,Casey Mittelstadt,C,COL,26,81,14,43,57
55,8480803,Evan Bouchard,D,EDM,25,79,13,44,57
55,8475168,Matt Duchene,C,DAL,33,79,21,35,56
55,8477494,Jonathan Drouin,L,COL,29,78,21,35,56
55,8475798,Mikael Granlund,C,SJS,32,66,18,38,56
55,8478397,Rasmus Andersson,D,CGY,28,70,7,49,56
55,8482159,Tyson Foerster,R,PHI,22,76,21,34,55
55,8476292,Ondrej Palat,L,NJD,33,71,15,40,55
55,8477503,Max Domi,C,TOR,29,77,14,41,55
55,8477935,Sam Bennett,C,FLA,28,75,21,33,54
55,8475191,Reilly Smith,R,NYR,33,72,21,33,54
55,8478469,Thomas Chabot,D,OTT,27,78,14,40,54
55,8480036,Miro Heiskanen,D,DAL,25,80,12,42,54
55,8480188,Fabian Zetterlund,L,SJS,25,71,23,30,53
55,8475765,Vladimir Tarasenko,R,DET,33,81,19,34,53
55,8478462,Nicolas Roy,C,VGK,27,78,18,35,53
55,8481711,Matias Maccelli,L,UTA,24,75,14,39,53
55,8482093,Seth Jarvis,C,CAR,22,68,34,18,52
55,8483808,Andrei Kuzmenko,L,CGY,28,74,29,23,52
55,8478055,Gustav Forsling,D,FLA,28,74,12,40,52
55,8482745,Mason McTavish,C,ANA,21,70,25,26,51
55,8481540,Cole Caufield,R,MTL,23,76,24,27,51
55,8475745,Charlie Coyle,C,BOS,32,81,23,28,51
55,8484166,Adam Fantilli,C,CBJ,20,70,23,28,51
55,8477940,Nikolaj Ehlers,L,WPG,28,73,22,29,51
55,8482078,Lucas Raymond,L,DET,22,80,19,32,51
55,8477021,Alex Kerfoot,C,UTA,30,78,18,33,51
55,8476461,Sean Couturier,C,PHI,32,72,17,34,51
55,8478542,Evan Rodrigues,C,FLA,31,77,14,37,51
55,8478396,Noah Hanifin,D,VGK,27,61,6,45,51
55,8474150,Mikael Backlund,C,CGY,35,77,20,30,50
55,8475754,Brock Nelson,C,NYI,33,81,19,31,50
55,8474565,Alex Pietrangelo,D,VGK,34,65,16,34,50
55,8482109,Alexis Lafrenière,L,NYR,23,69,29,20,49
55,8480014,Gabriel Vilardi,C,WPG,25,74,28,21,49
55,8477426,Nicholas Paul,L,TBL,29,82,26,23,49
55,8476927,Teddy Blueger,C,VAN,30,71,20,29,49
55,8481528,Dylan Cozens,C,BUF,23,71,17,32,49
55,8476869,Brady Skjei,D,NSH,30,72,14,35,49
55,8482684,Luke Hughes,D,NJD,21,68,12,37,49
55,8476792,Torey Krug,D,STL,33,74,11,38,49
55,8474679,Gustav Nyquist,C,NSH,35,73,11,38,49
55,8476853,Morgan Rielly,D,TOR,30,72,4,45,49
55,8480064,Josh Norris,C,OTT,25,74,23,25,48
55,8482667,William Eklund,L,SJS,22,67,21,27,48
55,8475170,Brayden Schenn,C,STL,33,71,19,29,48
55,8479987,Morgan Geekie,C,BOS,26,75,19,29,48
55,8480028,Morgan Frost,C,PHI,25,70,17,31,48
55,8482124,Quinton Byfield,R,LAK,22,80,15,33,48
55,8471724,Kris Letang,D,PIT,37,78,11,37,48
55,8477346,MacKenzie Weegar,D,CGY,30,76,11,37,48
55,8475793,Ryan Johansen,C,PHI,32,71,24,23,47
55,8479591,Michael Eyssimont,C,TBL,28,81,19,28,47
55,8479675,Trevor Moore,L,LAK,29,80,18,29,47
55,8476826,Yanni Gourde,C,SEA,33,69,18,29,47
55,8476483,Rickard Rakell,R,PIT,31,71,17,30,47
55,8475753,Justin Faulk,D,STL,32,79,17,30,47
55,8476462,Dougie Hamilton,D,NJD,31,63,15,32,47
55,8482720,Matthew Knies,L,TOR,22,76,13,34,47
55,8478407,Vince Dunn,D,SEA,28,73,10,37,47
55,8476906,Shayne Gostisbehere,D,CAR,31,78,9,38,47
55,8476432,Boone Jenner,C,CBJ,31,65,32,14,46
55,8477511,Anthony Mantha,R,CGY,30,70,23,23,46
55,8479400,Pierre-Luc Dubois,L,WSH,26,73,19,27,46
55,8482113,Anton Lundell,C,FLA,23,75,19,27,46
55,8476479,Phillip Danault,C,LAK,31,79,18,28,46
55,8474590,John Carlson,D,WSH,34,69,10,36,46
55,8477495,Seth Jones,D,CHI,30,68,10,36,46
55,8477447,Shea Theodore,D,VGK,29,55,8,38,46
55,8476399,Blake Coleman,C,CGY,33,72,23,22,45
55,8477497,Sean Monahan,C,CBJ,30,71,20,25,45
55,8482133,Thomas Bordeleau,C,SJS,22,66,20,25,45
55,8474586,Jordan Eberle,R,SEA,34,75,17,28,45
55,8477986,Brandon Montour,D,SEA,30,70,11,34,45
55,8475810,Bryan Rust,R,PIT,32,70,30,14,44
55,8477476,Artturi Lehkonen,L,COL,29,81,25,19,44
55,8478401,Pavel Zacha,C,BOS,27,77,20,24,44
55,8478856,Conor Garland,R,VAN,28,74,20,24,44
55,8478498,Jake DeBrusk,L,VAN,28,70,19,25,44
55,8477964,Ivan Barbashev,C,VGK,29,77,18,26,44
55,8478873,Troy Terry,R,ANA,27,71,17,27,44
55,8478519,Anthony Cirelli,C,TBL,27,80,17,27,44
55,8482660,Kent Johnson,C,CBJ,22,64,16,28,44
55,8475287,Erik Haula,L,NJD,33,73,11,33,44
55,8478038,Devon Toews,D,COL,30,68,6,38,44
55,8475151,Kyle Palmieri,C,NYI,33,80,25,18,43
55,8475799,Nino Niederreiter,R,WPG,32,70,24,19,43
55,8477407,Anthony Duclair,L,NYI,29,79,22,21,43
55,8480797,Joel Farabee,L,PHI,24,75,18,25,43
55,8480798,Philipp Kurashev,C,CHI,25,63,16,27,43
55,8484145,Zach Benson,L,BUF,19,69,13,30,43
55,8481533,Trevor Zegras,C,ANA,23,72,13,30,43
55,8477969,Marcus Pettersson,D,PIT,28,78,8,35,43
55,8473986,Alex Killorn,L,ANA,35,73,23,19,42
55,8478474,Lawson Crouse,L,UTA,27,78,20,22,42
55,8477456,J.T. Compher,L,DET,29,77,18,24,42
55,8483431,Logan Cooley,C,UTA,20,74,18,24,42
55,8478466,Daniel Sprong,R,VAN,27,69,18,24,42
55,8477479,Tyler Bertuzzi,L,CHI,29,62,17,25,42
55,8482122,Brock Faber,D,MIN,22,79,12,30,42
55,8482702,Logan Stankoven,C,DAL,21,80,17,24,41
55,8481618,Alex Newhook,C,MTL,23,75,16,25,41
55,8476474,Stefan Noesen,R,NJD,31,69,16,25,41
55,8477932,Aaron Ekblad,D,FLA,28,73,14,27,41
55,8474563,Drew Doughty,D,LAK,35,74,12,29,41
55,8475218,Mattias Ekholm,D,EDM,34,76,11,30,41
55,8479410,Mikhail Sergachev,D,UTA,26,70,11,30,41
55,8478438,Tommy Novak,C,NSH,27,66,10,31,41
55,8481581,Thomas Harley,D,DAL,23,73,10,31,41
55,8479425,Filip Hronek,D,VAN,27,72,9,32,41
55,8477998,Warren Foegele,L,LAK,28,82,23,17,40
55,8478042,Viktor Arvidsson,L,EDM,31,72,21,19,40
55,8475726,Tyler Toffoli,C,SJS,32,60,20,20,40
55,8476438,Brandon Saad,L,STL,32,68,20,20,40
55,8481524,Bowen Byram,D,BUF,23,73,20,20,40
55,8477451,Ryan Hartman,R,MIN,30,68,16,24,40
55,8478057,Dakota Joshua,C,VAN,28,72,16,24,40
55,8482097,Jack Quinn,R,BUF,23,66,15,25,40
55,8477444,Andre Burakovsky,L,SEA,29,69,13,27,40
55,8479339,Patrik Laine,L,CBJ,26,63,12,28,40
55,8483505,Matthew Poitras,C,BOS,20,76,11,29,40
55,8475768,Jaden Schwartz,C,SEA,32,69,21,18,39
55,8480849,Barrett Hayton,C,UTA,24,68,18,21,39
55,8481560,Arthur Kaliyev,R,LAK,23,81,17,22,39
55,8478046,Danton Heinen,L,VAN,29,74,17,22,39
55,8477953,Kasperi Kapanen,R,STL,28,69,17,22,39
55,8482110,Dawson Mercer,C,NJD,23,66,23,15,38
55,8477987,Ryan Donato,C,CHI,28,64,23,15,38
55,8476880,Tom Wilson,R,WSH,30,64,18,20,38
55,8479365,Trent Frederic,C,BOS,26,77,17,21,38
55,8475722,Jason Zucker,L,BUF,32,70,17,21,38
55,8479351,Sam Steel,C,DAL,26,79,15,23,38
55,8477839,Conor Sheary,L,TBL,32,79,15,23,38
55,8480113,Alex Iafallo,L,WPG,31,65,14,24,38
55,8474053,Logan Couture,C,SJS,35,62,13,25,38
55,8480220,Noah Cates,L,PHI,25,70,11,27,38
55,8484153,Leo Carlsson,C,ANA,20,72,10,28,38
55,8482705,Cole Sillinger,C,CBJ,21,66,18,19,37
55,8481582,Nicholas Robertson,L,TOR,23,66,18,19,37
55,8471698,T.J. Oshie,R,WSH,38,66,16,21,37
55,8482475,Yegor Chinakhov,R,CBJ,23,70,15,22,37
55,8477429,Andrew Copp,C,DET,30,80,14,23,37
55,8478233,Andrew Mangiapane,L,WSH,28,71,12,25,37
55,8479345,Jakob Chychrun,D,WSH,26,65,11,26,37
55,8477505,Alexander Wennberg,C,SJS,30,63,11,26,37
55,8476958,Jaccob Slavin,D,CAR,30,69,9,28,37
55,8476854,Hampus Lindholm,D,BOS,30,73,9,28,37
55,8479325,Charlie McAvoy,D,BOS,27,72,4,33,37
55,8481604,Pavel Dorofeyev,L,VGK,24,73,18,18,36
55,8476872,Scott Laughton,C,PHI,30,74,15,21,36
55,8481523,Kirby Dach,C,MTL,23,68,11,25,36
55,8478133,Jake Evans,C,MTL,28,73,11,25,36
55,8480871,Adam Boqvist,D,FLA,24,73,9,27,36
55,8473563,Nicklas Backstrom,C,WSH,37,61,9,27,36
55,8481186,Logan O'Connor,R,COL,28,81,19,16,35
55,8480185,Eetu Luostarinen,C,FLA,26,76,17,18,35
55,8482092,Ridly Greig,C,OTT,22,79,13,22,35
55,8476882,Teuvo Teravainen,C,CHI,30,64,12,23,35
55,8478115,Pierre Engvall,L,NYI,28,77,12,23,35
55,8482624,Daniil Miromanov,D,CGY,27,62,11,24,35
55,8476458,Ryan Strome,C,ANA,31,73,8,27,35
55,8477948,Travis Sanheim,D,PHI,28,68,8,27,35
55,8481703,Valtteri Puustinen,R,PIT,25,67,6,29,35
55,8476979,Erik Gustafsson,D,DET,32,76,4,31,35
55,8476981,Josh Anderson,R,MTL,30,72,19,15,34
55,8479293,Brandon Tanev,L,SEA,33,63,19,15,34
55,8474641,Adam Henrique,C,EDM,34,72,16,18,34
55,8480748,Kiefer Sherwood,L,VAN,29,66,16,18,34
55,8474716,Jared Spurgeon,D,MIN,35,78,15,19,34
55,8482671,Owen Power,D,BUF,22,75,7,27,34
55,8478366,Frank Vatrano,R,ANA,30,71,20,13,33
55,8470621,Corey Perry,R,EDM,39,76,18,15,33
55,8479661,Tanner Jeannot,L,LAK,27,75,18,15,33
55,8480459,Pius Suter,C,VAN,28,73,18,15,33
55,8480009,Eeli Tolvanen,R,SEA,25,68,16,17,33
55,8475760,Nick Bjugstad,C,UTA,32,68,16,17,33
55,8478458,John (Jack) Roslovic,C,CAR,27,65,13,20,33
55,8480078,Filip Chytil,C,NYR,25,75,13,20,33
55,8476392,Adam Lowry,C,WPG,31,63,13,20,33
55,8476925,Colton Sissons,C,NSH,31,68,11,22,33
55,8476419,Jean-Gabriel Pageau,C,NYI,32,79,10,23,33
55,8481542,Moritz Seider,D,DET,23,74,4,29,33
55,8475169,Evander Kane,L,EDM,33,71,22,10,32
55,8479992,Michael Rasmussen,C,DET,25,75,18,14,32
55,8482125,Alexander Holtz,R,VGK,22,69,14,18,32
55,8478891,Mason Appleton,C,WPG,28,62,14,18,32
55,8482679,Matt Coronato,R,CGY,22,68,12,20,32
55,8473533,Jordan Staal,C,CAR,36,60,10,22,32
55,8480434,Sean Durzi,D,UTA,26,68,7,25,32
55,8480873,Rasmus Sandin,D,WSH,24,72,7,25,32
55,8480145,Neal Pionk,D,WPG,29,73,6,26,32
55,8481178,Egor Zamula,D,PHI,24,60,6,26,32
55,8480049,Dylan Samberg,D,WPG,25,68,3,29,32
55,8475314,Anders Lee,L,NYI,34,78,16,15,31
55,8482175,JJ Peterka,R,BUF,22,70,16,15,31
55,8478020,Michael Amadio,R,OTT,28,72,14,17,31
55,8477952,Robby Fabbri,C,ANA,28,63,14,17,31
55,8481596,Shane Pinto,C,OTT,24,77,13,18,31
55,8481554,Kaapo Kakko,R,NYR,23,69,13,18,31
55,8479315,Joey Anderson,R,CHI,26,56,13,18,31
55,8481553,Bobby Brink,R,PHI,23,63,12,19,31
55,8481535,Nils Hoglander,L,VAN,24,64,11,20,31
55,8475791,Taylor Hall,L,CHI,33,61,11,20,31
55,8482067,Connor Mackey,D,NYR,28,65,8,23,31
55,8479402,Jake Bean,D,CGY,26,67,7,24,31
55,8480336,Sean Walker,D,CAR,30,74,6,25,31
55,8478463,Anthony Beauvillier,L,PIT,27,63,17,13,30
55,8479525,Ross Colton,C,COL,28,80,15,15,30
55,8477425,Miles Wood,L,COL,29,79,15,15,30
55,8476918,Jimmy Vesey,L,NYR,31,72,15,15,30
55,8476885,Jacob Trouba,D,NYR,30,65,12,18,30
55,8475763,Kevin Hayes,R,PIT,32,64,11,19,30
55,8476897,Oskar Sundqvist,C,STL,30,65,11,19,30
55,8480144,David Kampf,C,TOR,29,68,8,22,30
55,8482105,Jake Sanderson,D,OTT,22,72,7,23,30
55,8482146,Luke Evangelista,R,NSH,22,60,7,23,30
55,8476923,Damon Severson,D,CBJ,30,78,6,24,30
55,8481606,Jordan Spence,D,LAK,23,67,5,25,30
55,8484203,Bradly Nadeau,L,CAR,19,59,4,26,30
55,8474149,Evgenii Dadonov,R,DAL,35,79,16,13,29
55,8482117,Lukas Reichel,L,CHI,22,58,15,14,29
55,8482074,Connor Zary,C,CGY,23,68,14,15,29
55,8483524,Shane Wright,C,SEA,20,68,12,17,29
55,8478507,John Marino,D,UTA,27,65,4,25,29
55,8476892,Colton Parayko,D,STL,31,78,2,27,29
55,8482055,Drew O'Connor,L,PIT,26,61,16,12,28
55,8476921,Jordan Martinook,L,CAR,32,66,15,13,28
55,8477478,William Carrier,L,CAR,30,59,14,14,28
55,8475714,Calle Jarnkrok,C,TOR,33,71,14,14,28
55,8481656,Aliaksei Protas,C,WSH,23,62,11,17,28
55,8477450,Jason Dickinson,C,CHI,29,63,9,19,28
55,8478472,Mathieu Joseph,R,STL,27,65,8,20,28
55,8477488,Brett Pesce,D,NJD,30,67,8,20,28
55,8483490,Pavel Mintyukov,D,ANA,21,76,3,25,28
55,8475764,Cam Fowler,D,ANA,33,73,2,26,28
55,8480813,Joe Veleno,C,DET,24,72,17,10,27
55,8478109,Victor Olofsson,L,VGK,29,70,16,11,27
55,8479390,Taylor Raddysh,R,WSH,26,63,13,14,27
55,8479996,Cody Glass,C,NSH,25,64,12,15,27
55,8476480,Vladislav Namestnikov,C,WPG,32,62,11,16,27
55,8477947,Sonny Milano,L,WSH,28,60,9,18,27
55,8478413,Jordan Greenway,L,BUF,27,65,7,20,27
55,8477506,Ryan Pulock,D,NYI,30,75,2,25,27
55,8477989,Christian Dvorak,C,MTL,28,65,18,8,26
55,8477498,Darnell Nurse,D,EDM,29,77,12,14,26
55,8482749,Joshua Roy,R,MTL,21,64,12,14,26
55,8480068,Ryan Poehling,C,PHI,25,73,12,14,26
55,8475343,Nic Dowd,C,WSH,34,62,11,15,26
55,8482111,Justin Barron,D,MTL,23,59,10,16,26
55,8475200,Dmitry Orlov,D,CAR,33,68,9,17,26
55,8477353,Tyler Motte,C,DET,29,76,9,17,26
55,8476902,Esa Lindell,D,DAL,30,72,6,20,26
55,8476463,Jonas Brodin,D,MIN,31,79,4,22,26
55,8475233,David Savard,D,MTL,34,73,4,22,26
55,8476891,Matthew Grzelcyk,D,PIT,30,76,4,22,26
55,8482087,Kaiden Guhle,D,MTL,22,61,3,23,26
55,8479353,Brett Howden,C,VGK,26,66,12,13,25
55,8474715,Cameron Atkinson,R,TBL,35,81,11,14,25
55,8481093,Rafael Harvey-Pinard,L,MTL,25,61,11,14,25
55,8475149,Marcus Johansson,L,MIN,34,60,10,15,25
55,8480980,Connor Dewar,C,TOR,25,70,10,15,25
55,8482712,Oskar Olausson,R,COL,22,76,9,16,25
55,8476856,Mathew Dumba,D,DAL,30,73,9,16,25
55,8481546,Cam York,D,PHI,23,66,7,18,25
55,8480817,K'Andre Miller,D,NYR,24,67,6,19,25
55,8475171,Oliver Ekman-Larsson,D,TOR,33,71,5,20,25
55,8479371,Dante Fabbro,D,NSH,26,63,5,20,25
55,8482809,Jackson Blake,R,CAR,21,63,16,8,24
55,8479941,Justin Danforth,R,CBJ,31,65,11,13,24
55,8481441,Joe Snively,C,DET,28,63,11,13,24
55,8478043,Sam Lafferty,C,BUF,29,49,11,13,24
55,8481577,Philip Tomasino,C,NSH,23,67,10,14,24
55,8480829,Jesperi Kotkaniemi,C,CAR,24,66,10,14,24
55,8479976,Juuso Valimaki,D,UTA,26,62,10,14,24
55,8480789,Oliver Wahlstrom,R,NYI,24,75,10,14,24
55,8483565,Nick Blankenburg,D,NSH,26,58,8,16,24
55,8474574,Tyler Myers,D,VAN,34,67,3,21,24
55,8476878,Zemgus Girgensons,C,TBL,30,82,11,12,23
55,8480003,Jesper Boqvist,C,FLA,26,68,11,12,23
55,8481028,Martin Pospisil,C,CGY,25,56,11,12,23
55,8475848,Brendan Gallagher,R,MTL,32,68,9,14,23
55,8480043,Timothy Liljegren,D,TOR,25,69,5,18,23
55,8475181,Nick Leddy,D,STL,33,71,4,19,23
55,8482245,Artem Zub,D,OTT,29,64,2,21,23
55,8476469,Joel Armia,R,MTL,31,68,12,10,22
55,8480762,Eric Robinson,L,CAR,29,60,12,10,22
55,8480448,Parker Kelly,L,COL,25,73,12,10,22
55,8482259,Bobby McMann,C,TOR,28,68,10,12,22
55,8478013,Jake Walman,D,SJS,28,75,10,12,22
55,8478831,Kevin Stenlund,C,UTA,28,56,10,12,22
55,8477919,Frederick Gaudreau,C,MIN,31,57,9,13,22
55,8481704,Juuso Parssinen,C,NSH,23,62,9,13,22
55,8475220,Marcus Foligno,L,MIN,33,69,8,14,22
55,8483457,Lane Hutson,D,MTL,20,68,8,14,22
55,8482089,Jake Neighbours,L,STL,22,65,7,15,22
55,8481537,Nikita Okhotiuk,D,CGY,24,51,7,15,22
55,8476457,Adam Larsson,D,SEA,32,77,6,16,22
55,8474151,Ryan McDonagh,D,TBL,35,78,4,18,22
55,8482655,Janis Moser,D,TBL,24,76,4,18,22
55,8480891,Michael Kesselring,D,UTA,24,60,3,19,22
55,8480073,Erik Brannstrom,D,COL,25,61,0,22,22
55,8480074,Alexandre Texier,C,STL,25,57,12,9,21
55,8478970,Jalen Chatfield,D,CAR,28,71,10,11,21
55,8483499,Liam Ohgren,L,MIN,20,56,10,11,21
55,8480205,Emil Bemstrom,C,PIT,25,61,10,11,21
55,8477220,Nate Schmidt,D,FLA,33,65,8,13,21
55,8478432,Christian Fischer,R,DET,27,77,8,13,21
55,8480887,Jordan Harris,D,MTL,24,51,8,13,21
55,8476994,Vinnie Hinostroza,C,NSH,30,45,7,14,21
55,8478859,Niko Mikkola,D,FLA,28,59,6,15,21
55,8482101,Danil Gushchin,L,SJS,22,57,5,16,21
55,8480727,Zach Whitecloud,D,VGK,28,55,5,16,21
55,8475188,Brayden McNabb,D,VGK,33,63,4,17,21
55,8481708,Zac Jones,D,NYR,24,55,3,18,21
55,8478851,Alexandre Carrier,D,NSH,28,66,2,19,21
55,8476525,Colin Miller,D,WPG,32,58,1,20,21
55,8482737,Zack Bolduc,C,STL,21,64,13,7,20
55,8476822,Luke Glendening,C,TBL,35,76,13,7,20
55,8477015,Connor Brown,R,EDM,30,66,12,8,20
55,8480893,Kirill Marchenko,R,CBJ,24,62,12,8,20
55,8480281,Alexey Toropchenko,R,STL,25,62,12,8,20
55,8475193,Tomas Tatar,L,NJD,34,65,10,10,20
55,8476329,Travis Boyd,C,MIN,31,50,8,12,20
55,8477931,Tomas Nosek,L,FLA,32,68,8,12,20
55,8481481,Blake Lizotte,C,PIT,27,57,7,13,20
55,8475855,Jesper Fast,R,CAR,33,55,6,14,20
55,8477499,Rasmus Ristolainen,D,PHI,30,58,6,14,20
55,8476312,Josh Manson,D,COL,33,63,6,14,20
55,8478911,Matt Roy,D,WSH,29,58,5,15,20
55,8477507,Nikita Zadorov,D,BOS,29,71,5,15,20
55,8480035,Henri Jokiharju,D,BUF,25,61,4,16,20
55,8476467,Jamie Oleksiak,D,SEA,32,71,4,16,20
55,8478882,Vladislav Gavrikov,D,LAK,29,69,4,16,20
55,8480950,Ilya Lyubushkin,D,DAL,30,68,4,16,20
55,8474673,TJ Brodie,D,CHI,34,64,3,17,20
55,8481014,Alexander Romanov,D,NYI,24,76,3,17,20
55,8475179,Dmitry Kulikov,D,FLA,34,64,3,17,20
55,8480192,Johnathan Kovacevic,D,NJD,27,52,2,18,20
55,8476879,Cody Ceci,D,EDM,31,63,1,19,20
55,8479619,Michael Carcone,L,UTA,28,58,15,4,19
55,8477380,Jonny Brodzinski,C,NYR,31,54,12,7,19
55,8481032,Paul Cotter,C,NJD,25,55,11,8,19
55,8478434,Keegan Kolesar,R,VGK,27,67,11,8,19
55,8482634,Alex Steeves,C,TOR,25,45,11,8,19
55,8479393,Noah Gregor,L,OTT,26,77,10,9,19
55,8476374,Sean Kuraly,C,CBJ,31,57,10,9,19
55,8480878,Nils Lundkvist,D,DAL,24,65,9,10,19
55,8482148,Hendrix Lapierre,C,WSH,22,55,9,10,19
55,8480835,Jack Drury,C,CAR,24,61,8,11,19
55,8480855,Jack McBain,C,UTA,24,68,8,11,19
55,8482142,Jamie Drysdale,D,PHI,22,63,6,13,19
55,8481477,Nico Sturm,C,SJS,29,56,5,14,19
55,8480802,Ryan McLeod,C,BUF,25,55,4,15,19
55,8475231,Casey Cizikas,C,NYI,33,75,3,16,19
55,8476917,Adam Pelech,D,NYI,30,77,2,17,19
55,8476331,Dylan DeMelo,D,WPG,31,67,2,17,19
55,8478500,Ivan Provorov,D,CBJ,27,80,2,17,19
55,8475790,Erik Gudbranson,D,CBJ,32,75,2,17,19
55,8478399,Jonas Siegenthaler,D,NJD,27,68,1,18,19
55,8481601,Simon Holmstrom,R,NYI,23,66,13,5,18
55,8479414,Nathan Bastian,R,NJD,27,55,10,8,18
55,8483491,Ivan Miroshnichenko,L,WSH,20,53,9,9,18
55,8479066,Ryan Lomberg,L,CGY,30,59,9,9,18
55,8480355,Mark Kastelic,C,BOS,25,63,8,10,18
55,8478416,Erik Cernak,D,TBL,27,70,7,11,18
55,8480011,Klim Kostin,C,SJS,25,49,7,11,18
55,8474189,Lars Eller,C,PIT,35,64,5,13,18
55,8479372,Joshua Mahura,D,SEA,26,49,4,14,18
55,8481568,Alex Vlasic,D,CHI,23,52,3,15,18
55,8473507,Jeff Petry,D,DET,37,69,2,16,18
55,8476429,Scott Mayfield,D,NYI,32,70,2,16,18
55,8480860,Kevin Bahl,D,CGY,24,63,2,16,18
55,8479983,Mario Ferraro,D,SJS,26,70,2,16,18
55,8479398,Samuel Girard,D,COL,26,74,1,17,18
55,8478840,Will Borgen,D,SEA,28,66,1,17,18
55,8475225,Craig Smith,C,CHI,35,59,10,7,17
55,8477903,Garnet Hathaway,R,PHI,33,56,8,9,17
55,8481522,Peyton Krebs,C,BUF,23,66,8,9,17
55,8473422,Nick Foligno,L,CHI,37,51,7,10,17
55,8483493,Frank Nazar,C,CHI,20,58,7,10,17
55,8481013,Jonatan Berggren,R,DET,24,64,7,10,17
55,8483495,Simon Nemec,D,NJD,20,51,7,10,17
55,8477979,Nicolas Aube-Kubel,R,BUF,28,60,5,12,17
55,8479998,Mikey Anderson,D,LAK,25,57,3,14,17
55,8479639,Dylan Coghlan,D,WPG,26,61,3,14,17
55,8475455,Brenden Dillon,D,NJD,34,55,2,15,17
55,8480252,Cole Guttman,C,CHI,25,33,11,5,16
55,8479316,Luke Kunin,C,SJS,27,60,10,6,16
55,8482062,Cole Smith,L,NSH,29,54,9,7,16
55,8481624,Ilya Mikheyev,R,CHI,30,58,9,7,16
55,8478211,Dryden Hunt,L,CGY,29,55,8,8,16
55,8479980,Nicolas Hague,D,VGK,26,53,7,9,16
55,8476873,Mark Jankowski,C,NSH,30,52,6,10,16
55,8483468,Jiri Kulich,C,BUF,20,60,6,10,16
55,8476422,Mike Reilly,D,NYI,31,77,6,10,16
55,8479671,Mathieu Olivier,R,CBJ,27,47,6,10,16
55,8481617,Vasily Podkolzin,R,VAN,23,41,6,10,16
55,8483445,Cutter Gauthier,L,ANA,20,63,5,11,16
55,8481019,David Gustafsson,C,WPG,24,49,5,11,16
55,8477435,Ryan Graves,D,PIT,29,75,4,12,16
55,8479324,Ryan Lindgren,D,NYR,26,65,3,13,16
55,8479249,Andrew Poturalski,C,SJS,30,40,2,14,16
55,8475690,Chris Tanev,D,TOR,35,59,1,15,16
55,8476934,Brock McGinn,L,ANA,30,56,13,2,15
55,8482659,Josh Doan,R,UTA,22,42,10,5,15
55,8479368,Max Jones,L,BOS,26,71,8,7,15
55,8481517,Brett Leason,R,ANA,25,56,8,7,15
55,8482176,Wyatt Kaiser,D,CHI,22,50,6,9,15
55,8476960,Andreas Athanasiou,C,CHI,30,48,6,9,15
55,8481592,Jakob Pelletier,L,CGY,23,48,6,9,15
55,8476988,Matt Benning,D,SJS,30,65,5,10,15
55,8478421,A.J. Greer,L,FLA,28,57,5,10,15
55,8476931,Jake McCabe,D,TOR,31,60,4,11,15
55,8477369,Carson Soucy,D,VAN,30,64,4,11,15
55,8482666,Scott Morrow,D,CAR,22,51,4,11,15
55,8479359,Beck Malenstyn,L,BUF,26,53,4,11,15
55,8481521,Ronnie Attard,D,PHI,25,64,3,12,15
55,8479370,Tyson Jost,C,CAR,26,51,3,12,15
55,8480246,Nick Perbix,D,TBL,26,73,2,13,15
55,8477845,Trevor van Riemsdyk,D,WSH,33,60,1,14,15
55,8478178,Darren Raddysh,D,TBL,28,68,1,14,15
55,8482744,James Malatesta,L,CBJ,21,50,1,14,15
55,8478569,Noel Acciari,C,PIT,33,59,10,4,14
55,8473453,Trevor Lewis,C,LAK,37,74,9,5,14
55,8479336,Carl Grundstrom,R,SJS,27,46,9,5,14
55,8481580,Connor McMichael,C,WSH,23,62,7,7,14
55,8477406,Mattias Janmark,C,EDM,32,67,6,8,14
55,8482807,Ethan Del Mastro,D,CHI,21,48,6,8,14
55,8475842,Sam Carrick,C,NYR,32,57,6,8,14
55,8476858,Phillip Di Giuseppe,L,VAN,31,39,6,8,14
55,8478017,Mark Friedman,D,VAN,29,40,6,8,14
55,8482073,Braden Schneider,D,NYR,23,68,5,9,14
55,8482155,Alex Laferriere,R,LAK,23,69,5,9,14
55,8477018,Ben Hutton,D,VGK,31,44,5,9,14
55,8480025,MacKenzie Entwistle,R,FLA,25,59,5,9,14
55,8482861,Vincent Iorio,D,WSH,22,34,5,9,14
55,8475462,Radko Gudas,D,ANA,34,67,3,11,14
55,8482451,Mikael Pyyhtia,L,CBJ,23,45,3,11,14
55,8471709,Marc-Edouard Vlasic,D,SJS,37,54,3,11,14
55,8480058,Pierre-Olivier Joseph,D,STL,25,48,2,12,14
55,8480172,Jan Rutta,D,SJS,34,61,1,13,14
55,8479026,Philippe Myers,D,TOR,27,42,0,14,14
55,8480806,Isac Lundestrom,C,ANA,25,59,10,3,13
55,8478508,Yakov Trenin,C,MIN,27,58,8,5,13
55,8481518,Nolan Foote,L,NJD,24,40,7,6,13
55,8479291,Kevin Rooney,C,CGY,31,50,7,6,13
55,8479328,Julien Gauthier,R,NYI,27,55,6,7,13
55,8475324,Nick Jensen,D,OTT,34,71,6,7,13
55,8475208,Brian Dumoulin,D,ANA,33,55,5,8,13
55,8482730,Brandt Clarke,D,LAK,21,45,5,8,13
55,8480021,Jack Studnicka,C,LAK,25,60,5,8,13
55,8480245,Olle Lycksell,R,PHI,25,24,5,8,13
55,8478136,Jake Middleton,D,MIN,28,76,4,9,13
55,8474166,Alec Martinez,D,CHI,37,50,3,10,13
55,8480001,Urho Vaakanainen,D,ANA,25,54,1,12,13
55,8476889,Radek Faksa,C,STL,30,60,8,4,12
55,8471817,Ryan Reaves,R,TOR,37,60,8,4,12
55,8477392,Hudson Fasching,R,NYI,29,58,6,6,12
55,8480995,Pontus Holmberg,R,TOR,25,57,6,6,12
55,8476278,Colin Blackwell,C,DAL,31,76,5,7,12
55,8483482,Tristan Luneau,D,ANA,20,67,5,7,12
55,8480880,Jakub Lauko,C,MIN,24,35,5,7,12
55,8482859,Zack Ostapchuk,C,OTT,21,47,5,7,12
55,8474567,Zach Bogosian,D,MIN,34,62,3,9,12
55,8479982,Conor Timmins,D,TOR,26,55,3,9,12
55,8478443,Brandon Carlo,D,BOS,28,62,3,9,12
55,8479348,Kale Clague,D,BUF,26,46,3,9,12
55,8480222,Sebastian Aho,D,PIT,28,64,2,10,12
55,8477482,Zachary Sanford,L,CHI,30,32,2,10,12
55,8482192,Isaak Phillips,D,CHI,23,51,1,11,12
55,8476967,Brett Kulak,D,EDM,30,62,1,11,12
55,8481598,Philip Broberg,D,EDM,23,35,0,12,12
55,8481716,Dmitri Voronkov,L,CBJ,24,40,9,2,11
55,8477446,Michael McCarron,R,NSH,29,55,7,4,11
55,8482157,Will Cuylle,L,NYR,22,62,7,4,11
55,8482803,Olen Zellweger,D,ANA,21,69,6,5,11
55,8474034,Patrick Maroon,L,CHI,36,45,5,6,11
55,8480845,Rasmus Kupari,C,WPG,24,39,5,6,11
55,8477508,Curtis Lazar,C,NJD,29,58,4,7,11
55,8480070,Ian Mitchell,D,BOS,25,44,4,7,11
55,8480796,Martin Fehervary,D,WSH,25,50,4,7,11
55,8478452,Caleb Jones,D,LAK,27,60,3,8,11
55,8477070,Liam O'Brien,C,UTA,30,53,3,8,11
55,8480157,Calle Rosen,D,COL,30,47,3,8,11
55,8470600,Ryan Suter,D,STL,39,55,2,9,11
55,8477365,Connor Clifton,D,BUF,29,54,2,9,11
55,8481059,Scott Perunovich,D,STL,26,53,1,10,11
55,8481567,Henry Thrun,D,SJS,23,55,1,10,11
55,8480289,Morgan Barron,C,WPG,26,59,7,3,10
55,8480848,Ty Dellandrea,C,SJS,24,46,7,3,10
55,8481641,Joel Kiviranta,L,COL,28,69,5,5,10
55,8482964,Arber Xhekaj,D,MTL,23,49,5,5,10
55,8479944,Zach Aston-Reese,C,VGK,30,50,5,5,10
55,8481550,Adam Beckman,L,NJD,23,42,5,5,10
55,8481527,Kaedan Korczak,D,VGK,23,48,4,6,10
55,8482747,Brennan Othmann,L,NYR,21,42,3,7,10
55,8481701,Santeri Hatakka,D,NJD,23,45,3,7,10
55,8474568,Luke Schenn,D,NSH,35,48,3,7,10
55,8473446,Erik Johnson,D,PHI,36,44,3,7,10
55,8481167,Brayden Pachal,D,CGY,25,43,2,8,10
55,8476874,Olli Maatta,D,DET,30,61,2,8,10
55,8479439,Jacob MacDonald,D,COL,31,47,2,8,10
55,8474090,Brendan Smith,D,DAL,35,51,2,8,10
55,8471677,Jack Johnson,D,CBJ,37,65,2,8,10
55,8475177,Calvin de Haan,D,COL,33,42,1,9,10
55,8479442,Troy Stecher,D,EDM,30,43,1,9,10
55,8482077,Dylan Holloway,L,EDM,23,45,7,2,9
55,8479968,Vinni Lettieri,C,BOS,29,49,7,2,9
55,8481532,Alex Turcotte,C,LAK,23,37,7,2,9
55,8482784,Zach Dean,C,STL,21,44,6,3,9
55,8483570,Ben Meyers,C,SEA,26,29,6,3,9
55,8481789,Tye Kartye,L,SEA,23,42,6,3,9
55,8480844,Grigori Denisenko,L,VGK,24,41,5,4,9
55,8482496,Nils Aman,C,VAN,24,34,4,5,9
55,8484254,Akito Hirose,D,VAN,25,41,4,5,9
55,8475235,Nicolas Deslauriers,L,PHI,33,54,3,6,9
55,8477962,Brendan Lemieux,L,CAR,28,41,3,6,9
55,8482765,Isak Rosen,R,BUF,21,37,3,6,9
55,8476372,Nick Seeler,D,PHI,31,47,3,6,9
55,8478454,Noah Juulsen,D,VAN,27,35,3,6,9
55,8480441,Trey Fix-Wolansky,R,CBJ,25,34,2,7,9
55,8482166,Shakir Mukhamadullin,D,SJS,22,52,2,7,9
55,8477887,Patrick Brown,C,BOS,32,48,2,7,9
55,8482652,Walker Duehr,R,CGY,27,39,2,7,9
55,8475750,Jon Merrill,D,MIN,32,57,1,8,9
55,8475279,Ben Chiarot,D,DET,33,66,0,9,9
55,8477384,Joshua Brown,D,EDM,30,54,0,9,9
55,8478409,Anthony Richard,C,PHI,28,35,6,2,8
55,8481147,Reese Johnson,C,MIN,26,43,6,2,8
55,8479718,Alex Barré-Boulet,C,MTL,27,41,5,3,8
55,8481609,Vladislav Kolyachonok,D,UTA,23,36,5,3,8
55,8482079,Marco Rossi,C,MIN,23,51,4,4,8
55,8481679,Maxence Guenette,D,OTT,23,36,4,4,8
55,8477335,Kyle Burroughs,D,LAK,29,43,4,4,8
55,8480990,Declan Chisholm,D,MIN,24,37,4,4,8
55,8476624,Barclay Goodrow,C,SJS,31,55,3,5,8
55,8479543,Michael Pezzetta,L,MTL,26,49,3,5,8
55,8479520,Brandon Duhaime,R,WSH,27,55,3,5,8
55,8477573,Nathan Walker,L,STL,30,43,3,5,8
55,8483466,Kevin Korchinski,D,CHI,20,53,3,5,8
55,8476473,Connor Murphy,D,CHI,31,40,3,5,8
55,8481751,Lukas Rousek,R,BUF,25,32,3,5,8
55,8477401,John Hayden,C,SEA,29,34,3,5,8
55,8478585,Derek Ryan,C,EDM,38,61,2,6,8
55,8476913,Devin Shore,C,MIN,30,42,2,6,8
55,8482713,Mackie Samoskevich,R,FLA,22,36,2,6,8
55,8481599,Victor Soderstrom,D,UTA,23,48,1,7,8
55,8479369,Andrew Peeke,D,BOS,26,68,1,7,8
55,8481600,Tobias Bjornfot,D,FLA,23,36,0,8,8
55,8474612,Travis Hamonic,D,OTT,34,42,0,8,8
55,8480292,Carson Meyer,R,ANA,27,30,0,8,8
55,8482070,Mitchell Chaffee,R,TBL,26,46,6,1,7
55,8476442,Matt Nieto,L,PIT,32,51,4,3,7
55,8481754,Nikita Nesterenko,C,ANA,23,45,4,3,7
55,8482141,Lukas Cormier,D,VGK,22,25,4,3,7
55,8483397,Marc McLaughlin,C,BOS,25,28,4,3,7
55,8482177,Marat Khusnutdinov,C,MIN,22,36,4,3,7
55,8475958,Michael Sgarbossa,C,WSH,32,26,3,4,7
55,8482095,Tyler Kleven,D,OTT,22,38,2,5,7
55,8480807,Mattias Samuelsson,D,BUF,24,44,2,5,7
55,8477938,Haydn Fleury,D,WPG,28,45,2,5,7
55,8479972,Mason Shaw,C,WPG,26,36,2,5,7
55,8475762,Derek Forbort,D,VAN,32,43,2,5,7
55,8484149,Gavin Brindley,C,CBJ,20,37,1,6,7
55,8483549,Lucas Condotta,L,MTL,27,35,1,6,7
55,8477034,Jaycob Megna,D,FLA,32,39,1,6,7
55,8482751,Ryan Winterton,C,SEA,21,32,5,1,6
55,8479981,Jonah Gadjovich,L,FLA,26,43,4,2,6
55,8477320,Anton Blidh,L,NYR,29,30,4,2,6
55,8482172,Landon Slaggert,L,CHI,22,22,4,2,6
55,8479986,Kole Lind,R,DAL,26,54,3,3,6
55,8482153,Brendan Brisson,C,VGK,23,27,3,3,6
55,8479638,Justin Brazeau,R,BOS,26,31,3,3,6
55,8480851,Akil Thomas,C,LAK,24,15,3,3,6
55,8484911,Collin Graf,R,SJS,22,45,2,4,6
55,8479378,Logan Stanley,D,WPG,26,45,2,4,6
55,8481161,Jake Christiansen,D,CBJ,25,58,2,4,6
55,8477971,Andreas Englund,D,LAK,28,27,2,4,6
55,8474013,Ian Cole,D,UTA,35,50,1,5,6
55,8476867,Brendan Gaunce,C,MIN,30,37,1,5,6
55,8480196,Jacob Bryson,D,BUF,27,41,1,5,6
55,8479994,Jaret Anderson-Dolan,C,WPG,25,42,1,5,6
55,8478468,Jeremy Lauzon,D,NSH,27,51,1,5,6
55,8483630,Pavol Regenda,L,ANA,25,31,1,5,6
55,8483763,Maksymilian Szuber,D,UTA,22,31,1,5,6
55,8482858,Ryker Evans,D,SEA,23,15,1,5,6
55,8475718,Justin Holl,D,DET,32,54,0,6,6
55,8480834,Ty Emberson,D,SJS,24,36,0,6,6
55,8482762,Simon Edvinsson,D,DET,21,63,3,2,5
55,8479344,Jesse Puljujarvi,R,PIT,26,48,3,2,5
55,8479772,Zack MacEwen,R,OTT,28,51,3,2,5
55,8482733,Logan Mailloux,D,MTL,31,31,3,2,5
55,8480879,Jacob Bernard-Docker,D,OTT,24,45,2,3,5
55,8476441,Joel Edmundson,D,LAK,31,41,2,3,5
55,8481541,Samuel Bolduc,D,NYI,24,34,2,3,5
55,8482144,Jack Thompson,D,SJS,22,24,2,3,5
55,8477244,Chad Ruhwedel,D,NYR,34,27,2,3,5
55,8479985,Cale Fleury,D,SEA,26,28,2,3,5
55,8481605,Jackson LaCombe,D,ANA,23,31,2,3,5
55,8483619,Filip Roos,D,OTT,25,43,1,4,5
55,8478450,Parker Wotherspoon,D,BOS,27,31,1,4,5
55,8478424,Jansen Harkins,C,ANA,27,35,1,4,5
55,8478874,Adam Gaudette,R,OTT,28,37,1,4,5
55,8481593,Jayden Struble,D,MTL,23,30,1,4,5
55,8479991,Jake Leschyshyn,C,NYR,25,28,1,4,5
55,8477527,Ross Johnston,L,ANA,30,30,0,5,5
55,8481422,Jake Lucchini,C,NSH,29,27,4,0,4
55,8480874,Adam Ginning,D,PHI,24,9,4,0,4
55,8478051,Max Willman,C,NJD,29,22,2,2,4
55,8479379,Givani Smith,R,SJS,26,32,2,2,4
55,8481006,Tyler Tucker,D,STL,24,15,2,2,4
55,8481206,John Ludvig,D,PIT,24,17,2,2,4
55,8479576,Vincent Desharnais,D,VAN,28,36,1,3,4
55,8483460,David Jiricek,D,CBJ,21,55,1,3,4
55,8482511,Mason Lohrei,D,BOS,23,36,1,3,4
55,8482145,Mavrik Bourque,C,DAL,22,49,1,3,4
55,8477149,Scott Sabourin,R,SJS,32,14,1,3,4
55,8477467,Gustav Olofsson,D,SEA,30,17,1,3,4
55,8482516,Matthew Kessel,D,STL,24,19,1,3,4
55,8478021,William Lagesson,D,DET,28,29,0,4,4
55,8477810,Joel Hanley,D,CGY,33,28,0,4,4
55,8482250,Callahan Burke,C,VGK,27,17,0,4,4
55,8480007,Jonas Rondbjerg,R,VGK,25,33,3,0,3
55,8482147,Jean-Luc Foudy,C,COL,22,28,3,0,3
55,8479536,Axel Jonsson-Fjallby,L,WPG,26,30,2,1,3
55,8482201,Gage Goncalves,C,TBL,23,29,2,1,3
55,8479367,William Lockwood,R,FLA,26,26,2,1,3
55,8477851,Jordan Oesterle,D,BOS,32,35,1,2,3
55,8478146,Matthew Highmore,C,OTT,28,40,1,2,3
55,8481699,Aku Raty,R,UTA,23,12,1,2,3
55,8481122,Simon Benoit,D,TOR,26,45,1,2,3
55,8481056,Spencer Stastney,D,NSH,24,34,1,2,3
55,8484287,Cole McWard,D,VAN,23,15,1,2,3
55,8477462,Robert Hagg,D,VGK,29,23,1,2,3
55,8480890,Jan Jenik,C,OTT,24,28,1,2,3
55,8482165,Yan Kuznetsov,D,CGY,22,21,1,2,3
55,8481030,Jack St. Ivany,D,PIT,25,16,1,2,3
55,8479419,Brett Murray,L,BUF,26,13,1,2,3
55,8478477,Mitchell Stephens,C,SEA,27,21,1,2,3
55,8480823,Alexander Alexeyev,D,WSH,25,16,1,2,3
55,8478451,Ethan Bear,D,WSH,27,50,0,3,3
55,8475795,Dylan McIlrath,D,WSH,32,14,0,3,3
55,8476952,Dominic Toninato,C,WPG,30,37,0,3,3
55,8479320,Maxime Lajoie,D,SEA,27,26,0,3,3
55,8477473,Justin Bailey,R,SJS,29,17,0,3,3
55,8480075,Cameron Crotty,D,MIN,25,13,0,3,3
55,8482102,Vasily Ponomarev,C,PIT,22,22,0,3,3
55,8475755,Alexander Petrovic,D,DAL,32,10,0,3,3
55,8481556,John Beecher,C,BOS,23,33,2,0,2
55,8479330,Brandon Gignac,C,MTL,27,8,2,0,2
55,8482118,Sam Colangelo,R,ANA,23,14,2,0,2
55,8482460,Matt Rempe,C,NYR,22,9,2,0,2
55,8483567,Georgii Merkulov,C,BOS,24,8,2,0,2
55,8480870,Bo Groulx,C,NYR,24,26,1,1,2
55,8479587,Rhett Gardner,C,PHI,28,17,1,1,2
55,8482088,Justin Sourdif,R,FLA,22,13,1,1,2
55,8479362,Riley Tufte,L,BOS,26,14,1,1,2
55,8478502,Dennis Gilbert,D,BUF,28,15,1,1,2
55,8477541,Dakota Mermis,D,TOR,30,10,1,1,2
55,8483546,Marshall Rifai,D,TOR,26,9,1,1,2
55,8474062,Riley Nash,C,NYR,35,9,1,1,2
55,8483597,Milos Kelemen,L,UTA,25,20,1,1,2
55,8481726,Adam Edstrom,C,NYR,24,6,1,1,2
55,8478854,Ryan Shea,D,PIT,27,8,1,1,2
55,8481743,Marc Del Gaizo,D,NSH,25,24,0,2,2
55,8482929,Emil Lilleberg,D,TBL,23,23,0,2,2
55,8481806,Louis Crevier,D,CHI,23,16,0,2,2
55,8483489,Fraser Minten,C,TOR,31,10,0,2,2
55,8479421,Jacob Moverare,D,LAK,26,9,0,2,2
55,8481543,Nikita Alexandrov,C,STL,24,25,1,0,1
55,8481719,Maxwell Crozier,D,TBL,24,19,1,0,1
55,8482470,Ilya Solovyov,D,CGY,24,11,1,0,1
55,8480267,Sammy Walker,C,MIN,25,18,1,0,1
55,8480084,Nick DeSimone,D,NJD,30,23,1,0,1
55,8481065,Angus Crookshank,L,OTT,25,10,1,0,1
55,8481578,Graeme Clarke,R,MIN,23,7,1,0,1
55,8482061,Brandon Biro,L,SEA,26,13,1,0,1
55,8482162,Roby Jarventie,L,EDM,22,20,1,0,1
55,8481585,Egor Afanasyev,L,SJS,23,12,1,0,1
55,8475780,Chris Wagner,R,COL,33,6,1,0,1
55,8478881,Brett Seney,L,CHI,28,12,1,0,1
55,8484258,Sam Malinski,D,COL,26,17,1,0,1
55,8481043,Cole Koepke,L,BOS,26,15,1,0,1
55,8480032,Shane Bowers,C,NJD,25,15,1,0,1
55,8484304,Uvis Balinskis,D,FLA,28,9,1,0,1
55,8478011,Louie Belpedio,D,PHI,28,9,1,0,1
55,8476323,Max McCormick,L,SEA,32,5,1,0,1
55,8481237,Kyle MacLean,C,NYI,25,24,0,1,1
55,8481462,Mason Morelli,L,VGK,28,7,0,1,1
55,8483512,Matthew Savoie,C,EDM,20,20,0,1,1
55,8477073,Kurtis MacDermid,L,NJD,30,33,0,1,1
55,8482094,Daemon Hunt,D,MIN,22,11,0,1,1
55,8481655,Cole Schwindt,R,CGY,23,4,0,1,1
55,8481024,Linus Karlsson,C,VAN,25,7,0,1,1
55,8484259,Ondrej Pavel,C,COL,31,4,0,1,1
55,8484255,Jason Polin,R,COL,25,5,0,1,1
55,8483012,Logan Morrison,C,SEA,22,29,0,0,0
55,8483471,Brad Lambert,C,WPG,31,9,0,0,0
55,8475413,Justin Dowling,C,NJD,34,11,0,0,0
55,8484325,Waltteri Merela,C,TBL,26,20,0,0,0
55,8483531,Brian Halonen,L,NJD,25,0,0,0,0
55,8483432,Luca Del Bel Belluz,C,CBJ,31,4,0,0,0
55,8483398,Declan Carlile,D,TBL,31,6,0,0,0
55,8483395,Arshdeep Bains,L,VAN,23,6,0,0,0
55,8480468,James Hamblin,L,EDM,25,17,0,0,0
55,8480306,Grant Hutton,D,NYI,29,4,0,0,0
55,8483407,Brandon Scanlin,D,NYR,25,2,0,0,0
55,8477993,Justin Kirkland,C,CGY,28,6,0,0,0
55,8483920,Pierrick Dube,R,WSH,23,2,0,0,0
55,8482787,Nikita Chibrikov,R,WPG,31,6,0,0,0
55,8481564,Ryan Johnson,D,BUF,23,14,0,0,0
55,8478147,Bokondji Imama,L,PIT,28,2,0,0,0
55,8478446,Glenn Gawdin,C,LAK,27,9,0,0,0
55,8484321,Nikolas Matinpalo,D,OTT,26,3,0,0,0
55,8482126,Emil Andrae,D,PHI,31,4,0,0,0
55,8479522,Hardy Haman Aktell,D,WSH,26,4,0,0,0
55,8482476,Emil Heineman,L,MTL,23,7,0,0,0
55,8482197,Adam Raska,R,MIN,23,5,0,0,0
55,8483401,Marc Johnstone,R,PIT,28,0,0,0,0
55,8481534,Raphael Lavoie,C,EDM,24,2,0,0,0
55,8484326,Patrik Koch,D,UTA,28,2,0,0,0
55,8483609,Adam Klapka,R,CGY,24,1,0,0,0
55,8480274,Philip Kemp,D,EDM,25,3,0,0,0
55,8470794,Joe Pavelski,C,,40,0,0,0,0
55,8479321,Lucas Johansen,D,,27,0,0,0,0
55,8477950,Tony DeAngelo,D,,29,0,0,0,0
55,8471218,Blake Wheeler,R,,38,0,0,0,0
55,8475197,Tyson Barrie,D,,33,0,0,0,0
55,8474157,Max Pacioretty,L,,36,0,0,0,0
55,8475744,Evgeny Kuznetsov,C,,32,0,0,0,0
55,8474037,James van Riemsdyk,L,,35,0,0,0,0
55,8476907,Mackenzie MacEachern,L,,30,0,0,0,0
55,8480216,Jacob Peterson,C,,25,0,0,0,0
55,8474602,Justin Schultz,D,,34,0,0,0,0
55,8482222,Alexander Barabanov,L,,30,0,0,0,0
55,8474031,Kevin Shattenkirk,D,,35,0,0,0,0
55,8477330,Dominik Kubalik,L,,29,0,0,0,0
55,8480884,Calen Addison,D,,24,0,0,0,0
55,8475906,John Klingberg,D,,32,0,0,0,0
55,8480008,Adam Ruzicka,C,,25,0,0,0,0
55,8476884,Derrick Pouliot,D,,30,0,0,0,0
55,8476919,Chris Tierney,C,,30,0,0,0,0
55,8479415,Michael McLeod,C,,26,0,0,0,0
55,8474870,Tyler Johnson,C,,34,0,0,0,0
55,8470604,Jeff Carter,C,,39,0,0,0,0
55,8478104,Sammy Blais,L,,28,0,0,0,0
55,8474884,Mike Hoffman,C,,35,0,0,0,0
55,8481591,Sam Poulin,R,,23,0,0,0,0
55,8471274,Alex Goligoski,D,,39,0,0,0,0
55,8476871,Tanner Pearson,L,,32,0,0,0,0
55,8476393,Nick Cousins,C,,31,0,0,0,0
55,8479977,Kailer Yamamoto,R,,26,0,0,0,0
55,8479346,Dillon Dube,C,,26,0,0,0,0
55,8480184,Gustav Lindstrom,D,,26,0,0,0,0
55,8479376,Victor Mete,D,,26,0,0,0,0
55,8473449,Kyle Okposo,R,,36,0,0,0,0
55,8481058,Jesse Ylonen,R,,25,0,0,0,0
55,8475752,Tyler Pitlick,C,,33,0,0,0,0
55,8481239,Samuel Fagemo,L,,24,0,0,0,0
55,8480821,Filip Zadina,R,,25,0,0,0,0
55,8470966,Mark Giordano,D,,41,0,0,0,0
55,8478495,Denis Gurianov,R,,27,0,0,0,0
55,8477464,Nic Petan,C,,29,0,0,0,0
55,8478099,Kevin Labanc,R,,29,0,0,0,0
55,8482241,Radim Zohorna,L,,28,0,0,0,0
55,8474040,Sam Gagner,C,,35,0,0,0,0
55,8479514,Rem Pitlick,C,,27,0,0,0,0
55,8478430,Oliver Kylington,D,,27,0,0,0,0
55,8479533,Joona Koppanen,L,,26,0,0,0,0
55,8479984,Cal Foote,D,,26,0,0,0,0
55,8477126,Jayson Megna,C,,34,0,0,0,0
55,8475164,Jakob Silfverberg,R,,34,0,0,0,0
55,8474009,Nick Bonino,C,,36,0,0,0,0
55,8479458,Nikita Zaitsev,D,,33,0,0,0,0
55,8477944,Jakub Vrana,L,,28,0,0,0,0
55,8471699,Andrew Cogliano,C,,37,0,0,0,0
55,8478067,Oskar Lindblom,L,,28,0,0,0,0
55,8471686,Marc Staal,D,,37,0,0,0,0
55,8470610,Zach Parise,L,,40,0,0,0,0
55,8478904,Steven Lorentz,C,,28,0,0,0,0
55,8473473,Milan Lucic,L,,36,0,0,0,0
55,8480031,Maxime Comtois,L,,25,0,0,0,0
55,8478512,Austin Czarnik,C,,32,0,0,0,0
55,8473504,Cal Clutterbuck,R,,37,0,0,0,0
55,8477454,Adam Erne,L,,29,0,0,0,0
55,8479383,Boris Katchouk,L,,26,0,0,0,0
55,8475825,Jani Hakanpää,D,,32,0,0,0,0
55,8477846,Ryan Carpenter,C,,33,0,0,0,0
55,8477930,Pierre-Edouard Bellemare,L,,39,0,0,0,0
55,8478400,Colin White,C,,27,0,0,0,0
55,8480226,Marián Studenic,R,,26,0,0,0,0
55,8480853,Liam Foudy,C,,24,0,0,0,0
55,8475797,Jarred Tinordi,D,,32,0,0,0,0
55,8479423,Alex Nylander,L,,26,0,0,0,0
55,8474618,Marco Scandella,D,,34,0,0,0,0
55,8478028,Fredrik Olofsson,L,,28,0,0,0,0
55,8474709,Matt Martin,L,,35,0,0,0,0
55,8481070,Hugh McGing,L,,26,0,0,0,0
55,8479546,Oskar Steen,C,,26,0,0,0,0
55,8474145,Robert Bortuzzo,D,,35,0,0,0,0
55,8476915,Jujhar Khaira,L,,30,0,0,0,0
55,8475278,Byron Froese,C,,33,0,0,0,0
55,8481812,Nikolai Knyzhov,D,,27,0,0,0,0
55,8478408,Travis Dermott,D,,28,0,0,0,0
55,8481077,John Leonard,L,,26,0,0,0,0
55,8479547,Matthew Phillips,R,,26,0,0,0,0
55,8480836,Jonathan Gruden,C,,24,0,0,0,0
55,8481690,Tyler Angle,C,,24,0,0,0,0
55,8475766,Austin Watson,L,,32,0,0,0,0
55,8481016,Ruslan Iskhakov,C,,24,0,0,0,0
55,8478078,Rourke Chartier,C,,28,0,0,0,0
55,8480776,Sheldon Rempal,R,,29,0,0,0,0
55,8478956,Samuel Laberge,L,NJD,27,0,0,0,0
55,8483045,Cameron Butler,R,CBJ,31,1,0,0,0
55,8484314,Jiri Smejkal,L,,28,0,0,0,0
56,8478402,Connor McDavid,C,EDM,27,79,38,99,137
56,8476453,Nikita Kucherov,R,TBL,31,82,36,99,135
56,8477492,Nathan MacKinnon,C,COL,29,81,48,83,131
56,8481559,Jack Hughes,C,NJD,23,78,51,78,129
56,8477956,David Pastrnak,R,BOS,28,78,53,74,127
56,8479314,Matthew Tkachuk,L,FLA,27,79,31,92,123
56,8477934,Leon Draisaitl,C,EDM,29,78,46,69,115
56,8480027,Jason Robertson,L,DAL,25,82,41,73,114
56,8477946,Dylan Larkin,C,DET,28,82,50,55,105
56,8478420,Mikko Rantanen,R,COL,28,81,46,59,105
56,8477409,Carter Verhaeghe,C,FLA,29,77,53,49,102
56,8478483,Mitch Marner,R,TOR,27,82,34,68,102
56,8481557,Matt Boldy,L,MIN,23,78,37,63,100
56,8479318,Auston Matthews,C,TOR,27,78,60,39,99
56,8478427,Sebastian Aho,C,CAR,27,74,49,50,99
56,8478010,Brayden Point,C,TBL,28,81,52,46,98
56,8480012,Elias Pettersson,C,VAN,26,74,36,61,97
56,8478864,Kirill Kaprizov,L,MIN,27,69,45,51,96
56,8482116,Tim Stützle,C,OTT,22,78,28,66,94
56,8480208,Drake Batherson,R,OTT,26,81,32,60,92
56,8477404,Jake Guentzel,C,TBL,30,82,45,46,91
56,8477939,William Nylander,R,TOR,28,78,39,51,90
56,8477493,Aleksander Barkov,C,FLA,29,81,30,60,90
56,8476468,J.T. Miller,C,VAN,31,76,29,60,89
56,8477500,Bo Horvat,C,NYI,29,81,49,39,88
56,8477402,Pavel Buchnevich,L,STL,29,74,38,50,88
56,8477933,Sam Reinhart,C,FLA,29,77,39,48,87
56,8479385,Jordan Kyrou,C,STL,26,76,38,49,87
56,8478550,Artemi Panarin,L,NYR,33,74,34,53,87
56,8476887,Filip Forsberg,L,NSH,30,77,41,45,86
56,8480069,Cale Makar,D,COL,26,68,24,62,86
56,8471685,Anze Kopitar,C,LAK,37,82,26,58,84
56,8477960,Adrian Kempe,R,LAK,28,82,35,47,82
56,8471675,Sidney Crosby,C,PIT,37,77,32,50,82
56,8475913,Mark Stone,R,VGK,32,74,33,48,81
56,8478445,Mathew Barzal,C,NYI,27,80,26,55,81
56,8475810,Bryan Rust,R,PIT,32,77,37,43,80
56,8479420,Tage Thompson,C,BUF,27,74,34,46,80
56,8479343,Clayton Keller,R,UTA,26,76,40,39,79
56,8480801,Brady Tkachuk,L,OTT,25,79,39,40,79
56,8478449,Roope Hintz,C,DAL,28,81,33,46,79
56,8476459,Mika Zibanejad,C,NYR,31,78,27,52,79
56,8471214,Alex Ovechkin,L,WSH,39,70,40,38,78
56,8480865,Noah Dobson,D,NYI,24,78,9,69,78
56,8479337,Alex DeBrincat,R,DET,27,80,38,39,77
56,8475166,John Tavares,C,TOR,34,82,35,42,77
56,8480830,Andrei Svechnikov,R,CAR,24,67,30,47,77
56,8484144,Connor Bedard,C,CHI,19,69,31,44,75
56,8475172,Nazem Kadri,C,CGY,34,79,28,47,75
56,8482093,Seth Jarvis,C,CAR,22,72,36,37,73
56,8475754,Brock Nelson,C,NYI,33,80,33,40,73
56,8476881,Tomas Hertl,C,VGK,31,79,32,41,73
56,8478439,Travis Konecny,R,PHI,27,77,24,49,73
56,8474600,Roman Josi,D,NSH,34,72,22,51,73
56,8478460,Zach Werenski,D,CBJ,27,81,17,56,73
56,8482740,Wyatt Johnston,C,DAL,21,81,34,38,72
56,8480002,Nico Hischier,C,NJD,25,73,28,44,72
56,8475784,Jeff Skinner,C,EDM,32,78,28,44,72
56,8479407,Jesper Bratt,L,NJD,26,77,27,45,72
56,8477942,Kevin Fiala,L,LAK,28,79,24,48,72
56,8480036,Miro Heiskanen,D,DAL,25,78,13,59,72
56,8475168,Matt Duchene,C,DAL,33,82,31,40,71
56,8477949,Alex Tuch,R,BUF,28,74,21,50,71
56,8480023,Robert Thomas,C,STL,25,76,19,52,71
56,8473512,Claude Giroux,R,OTT,36,80,27,43,70
56,8476905,Chandler Stephenson,C,SEA,30,78,27,42,69
56,8477951,Nick Schmaltz,C,UTA,28,76,25,44,69
56,8473419,Brad Marchand,L,BOS,36,80,19,50,69
56,8474578,Erik Karlsson,D,PIT,34,82,11,58,69
56,8475786,Zach Hyman,L,EDM,32,79,43,25,68
56,8478403,Jack Eichel,C,VGK,28,76,26,42,68
56,8476456,Jonathan Huberdeau,C,CGY,31,78,16,52,68
56,8479675,Trevor Moore,L,LAK,29,78,33,34,67
56,8474564,Steven Stamkos,C,NSH,34,76,22,45,67
56,8476346,Johnny Gaudreau,L,CBJ,31,75,13,54,67
56,8475167,Victor Hedman,D,TBL,34,79,12,55,67
56,8478398,Kyle Connor,L,WPG,28,68,34,32,66
56,8480800,Quinn Hughes,D,VAN,25,76,13,53,66
56,8475184,Chris Kreider,L,NYR,33,78,36,29,65
56,8473986,Alex Killorn,L,ANA,35,72,24,41,65
56,8476389,Vincent Trocheck,C,NYR,31,76,23,42,65
56,8473994,Jamie Benn,L,DAL,35,81,21,44,65
56,8482684,Luke Hughes,D,NJD,21,71,16,49,65
56,8477496,Elias Lindholm,C,BOS,30,79,30,34,64
56,8471215,Evgeni Malkin,C,PIT,38,77,28,36,64
56,8478440,Dylan Strome,C,WSH,27,73,19,45,64
56,8480018,Nick Suzuki,C,MTL,25,79,19,45,64
56,8479323,Adam Fox,D,NYR,26,74,16,48,64
56,8482665,Matty Beniers,C,SEA,22,76,28,35,63
56,8474141,Patrick Kane,R,DET,36,80,24,39,63
56,8474590,John Carlson,D,WSH,34,72,20,43,63
56,8477501,Valeri Nichushkin,R,COL,29,81,30,32,62
56,8478444,Brock Boeser,R,VAN,27,73,29,33,62
56,8477935,Sam Bennett,C,FLA,28,80,26,36,62
56,8476479,Phillip Danault,C,LAK,31,82,24,38,62
56,8478047,Michael Bunting,L,PIT,29,72,22,40,62
56,8476454,Ryan Nugent-Hopkins,C,EDM,31,79,20,42,62
56,8475692,Mats Zuccarello,R,MIN,37,74,20,42,62
56,8477504,Josh Morrissey,D,WPG,29,76,19,43,62
56,8478873,Troy Terry,R,ANA,27,73,33,28,61
56,8476539,Jonathan Marchessault,R,NSH,34,71,30,31,61
56,8480064,Josh Norris,C,OTT,25,77,29,30,59
56,8475765,Vladimir Tarasenko,R,DET,33,79,25,34,59
56,8479542,Brandon Hagel,L,TBL,26,82,23,36,59
56,8482078,Lucas Raymond,L,DET,22,80,23,36,59
56,8479999,Casey Mittelstadt,C,COL,26,81,21,38,59
56,8484153,Leo Carlsson,C,ANA,20,70,20,39,59
56,8475794,Tyler Seguin,C,DAL,32,81,36,22,58
56,8480015,Owen Tippett,R,PHI,25,76,29,29,58
56,8475726,Tyler Toffoli,C,SJS,32,70,25,33,58
56,8482699,Dylan Guenther,R,UTA,21,75,24,34,58
56,8475764,Cam Fowler,D,ANA,33,78,6,52,58
56,8478519,Anthony Cirelli,C,TBL,27,81,28,29,57
56,8478414,Timo Meier,R,NJD,28,71,26,31,57
56,8480039,Martin Necas,C,CAR,25,67,23,34,57
56,8480803,Evan Bouchard,D,EDM,25,78,13,44,57
56,8482149,Cole Perfetti,C,WPG,22,66,29,27,56
56,8478493,Joel Eriksson Ek,C,MIN,27,75,26,30,56
56,8483515,Juraj Slafkovsky,L,MTL,20,76,24,32,56
56,8477416,Oliver Bjorkstrand,R,SEA,29,73,23,33,56
56,8477503,Max Domi,C,TOR,29,80,16,40,56
56,8478407,Vince Dunn,D,SEA,28,74,12,44,56
56,8477955,Jared McCann,L,SEA,28,69,28,27,55
56,8477444,Andre Burakovsky,L,SEA,29,73,25,30,55
56,8480839,Rasmus Dahlin,D,BUF,24,72,20,35,55
56,8478542,Evan Rodrigues,C,FLA,31,77,19,36,55
56,8481533,Trevor Zegras,C,ANA,23,71,16,39,55
56,8478469,Thomas Chabot,D,OTT,27,75,12,43,55
56,8474150,Mikael Backlund,C,CGY,35,75,31,23,54
56,8476448,William Karlsson,C,VGK,31,78,30,24,54
56,8483431,Logan Cooley,C,UTA,20,78,18,36,54
56,8474102,David Perron,L,OTT,36,79,17,37,54
56,8476792,Torey Krug,D,STL,33,71,9,45,54
56,8476432,Boone Jenner,C,CBJ,31,69,29,24,53
56,8474586,Jordan Eberle,R,SEA,34,74,20,33,53
56,8477986,Brandon Montour,D,SEA,30,73,15,38,53
56,8474563,Drew Doughty,D,LAK,35,76,7,46,53
56,8475745,Charlie Coyle,C,BOS,32,78,26,26,52
56,8478474,Lawson Crouse,L,UTA,27,71,26,26,52
56,8476460,Mark Scheifele,C,WPG,31,70,23,29,52
56,8478366,Frank Vatrano,R,ANA,30,70,30,21,51
56,8476438,Brandon Saad,L,STL,32,72,28,23,51
56,8477932,Aaron Ekblad,D,FLA,28,74,18,33,51
56,8478975,Mason Marchment,L,DAL,29,81,16,35,51
56,8481711,Matias Maccelli,L,UTA,24,73,10,41,51
56,8477476,Artturi Lehkonen,L,COL,29,79,24,26,50
56,8475169,Evander Kane,L,EDM,33,77,24,26,50
56,8481068,Yegor Sharangovich,C,CGY,26,76,18,32,50
56,8479345,Jakob Chychrun,D,WSH,26,71,15,35,50
56,8477497,Sean Monahan,C,CBJ,30,67,25,24,49
56,8477407,Anthony Duclair,L,NYI,29,78,24,25,49
56,8480797,Joel Farabee,L,PHI,24,78,24,25,49
56,8478856,Conor Garland,R,VAN,28,71,19,30,49
56,8477479,Tyler Bertuzzi,L,CHI,29,62,19,30,49
56,8476880,Tom Wilson,R,WSH,30,66,18,31,49
56,8475191,Reilly Smith,R,NYR,33,77,17,32,49
56,8477940,Nikolaj Ehlers,L,WPG,28,67,14,35,49
56,8481596,Shane Pinto,C,OTT,24,76,14,35,49
56,8476853,Morgan Rielly,D,TOR,30,68,8,41,49
56,8476958,Jaccob Slavin,D,CAR,30,78,6,43,49
56,8481540,Cole Caufield,R,MTL,23,72,27,21,48
56,8482055,Drew O'Connor,L,PIT,26,67,28,19,47
56,8482110,Dawson Mercer,C,NJD,23,77,27,20,47
56,8477426,Nicholas Paul,L,TBL,29,81,26,21,47
56,8475151,Kyle Palmieri,C,NYI,33,78,22,25,47
56,8477021,Alex Kerfoot,C,UTA,30,73,21,26,47
56,8475158,Ryan O'Reilly,C,NSH,33,74,19,28,47
56,8480028,Morgan Frost,C,PHI,25,73,14,33,47
56,8471724,Kris Letang,D,PIT,37,81,14,33,47
56,8477447,Shea Theodore,D,VGK,29,56,9,38,47
56,8481542,Moritz Seider,D,DET,23,78,4,43,47
56,8480014,Gabriel Vilardi,C,WPG,25,65,27,19,46
56,8475314,Anders Lee,L,NYI,34,80,27,19,46
56,8478498,Jake DeBrusk,L,VAN,28,65,26,20,46
56,8482745,Mason McTavish,C,ANA,21,75,21,25,46
56,8484166,Adam Fantilli,C,CBJ,20,68,17,29,46
56,8478401,Pavel Zacha,C,BOS,27,81,16,30,46
56,8477495,Seth Jones,D,CHI,30,66,15,31,46
56,8476882,Teuvo Teravainen,C,CHI,30,68,15,31,46
56,8476462,Dougie Hamilton,D,NJD,31,67,14,32,46
56,8479410,Mikhail Sergachev,D,UTA,26,70,4,42,46
56,8478115,Pierre Engvall,L,NYI,28,76,21,24,45
56,8477964,Ivan Barbashev,C,VGK,29,72,20,25,45
56,8477456,J.T. Compher,L,DET,29,80,19,26,45
56,8474641,Adam Henrique,C,EDM,34,76,18,27,45
56,8476458,Ryan Strome,C,ANA,31,72,16,29,45
56,8482124,Quinton Byfield,R,LAK,22,80,15,30,45
56,8476979,Erik Gustafsson,D,DET,32,74,7,38,45
56,8480802,Ryan McLeod,C,BUF,25,62,23,21,44
56,8481524,Bowen Byram,D,BUF,23,67,18,26,44
56,8481618,Alex Newhook,C,MTL,23,76,17,27,44
56,8481604,Pavel Dorofeyev,L,VGK,24,69,16,28,44
56,8476461,Sean Couturier,C,PHI,32,72,15,29,44
56,8474679,Gustav Nyquist,C,NSH,35,69,13,31,44
56,8476906,Shayne Gostisbehere,D,CAR,31,78,12,32,44
56,8475798,Mikael Granlund,C,SJS,32,68,10,34,44
56,8476875,Mike Matheson,D,MTL,30,74,9,35,44
56,8482159,Tyson Foerster,R,PHI,22,77,19,24,43
56,8475763,Kevin Hayes,R,PIT,32,63,17,26,43
56,8482702,Logan Stankoven,C,DAL,21,79,15,28,43
56,8482109,Alexis Lafrenière,L,NYR,23,75,26,16,42
56,8478462,Nicolas Roy,C,VGK,27,72,21,21,42
56,8479987,Morgan Geekie,C,BOS,26,78,19,23,42
56,8482092,Ridly Greig,C,OTT,22,77,17,25,42
56,8482720,Matthew Knies,L,TOR,22,77,14,28,42
56,8475768,Jaden Schwartz,C,SEA,32,74,13,29,42
56,8474565,Alex Pietrangelo,D,VGK,34,59,12,30,42
56,8477494,Jonathan Drouin,L,COL,29,82,10,32,42
56,8478396,Noah Hanifin,D,VGK,27,61,9,33,42
56,8478397,Rasmus Andersson,D,CGY,28,68,8,34,42
56,8475799,Nino Niederreiter,R,WPG,32,71,21,20,41
56,8477998,Warren Foegele,L,LAK,28,77,21,20,41
56,8481624,Ilya Mikheyev,R,CHI,30,63,21,20,41
56,8476399,Blake Coleman,C,CGY,33,78,18,23,41
56,8481528,Dylan Cozens,C,BUF,23,74,17,24,41
56,8477953,Kasperi Kapanen,R,STL,28,74,16,25,41
56,8475218,Mattias Ekholm,D,EDM,34,71,14,27,41
56,8478438,Tommy Novak,C,NSH,27,65,12,29,41
56,8479425,Filip Hronek,D,VAN,27,80,9,32,41
56,8470613,Brent Burns,D,CAR,39,76,7,34,41
56,8475170,Brayden Schenn,C,STL,33,72,20,20,40
56,8481560,Arthur Kaliyev,R,LAK,23,80,20,20,40
56,8479400,Pierre-Luc Dubois,L,WSH,26,69,19,21,40
56,8481535,Nils Hoglander,L,VAN,24,75,19,21,40
56,8480188,Fabian Zetterlund,L,SJS,25,67,17,23,40
56,8477451,Ryan Hartman,R,MIN,30,73,17,23,40
56,8477987,Ryan Donato,C,CHI,28,59,17,23,40
56,8476872,Scott Laughton,C,PHI,30,70,16,24,40
56,8471698,T.J. Oshie,R,WSH,38,69,15,25,40
56,8479992,Michael Rasmussen,C,DET,25,76,15,25,40
56,8478472,Mathieu Joseph,R,STL,27,68,15,25,40
56,8483505,Matthew Poitras,C,BOS,20,78,12,28,40
56,8482671,Owen Power,D,BUF,22,70,9,31,40
56,8475793,Ryan Johansen,C,PHI,32,76,22,17,39
56,8479525,Ross Colton,C,COL,28,76,19,20,39
56,8482175,JJ Peterka,R,BUF,22,66,18,21,39
56,8478046,Danton Heinen,L,VAN,29,74,15,24,39
56,8478458,John (Jack) Roslovic,C,CAR,27,74,14,25,39
56,8478891,Mason Appleton,C,WPG,28,65,13,26,39
56,8476826,Yanni Gourde,C,SEA,33,75,11,28,39
56,8477346,MacKenzie Weegar,D,CGY,30,72,10,29,39
56,8480817,K'Andre Miller,D,NYR,24,68,10,29,39
56,8478911,Matt Roy,D,WSH,29,72,10,29,39
56,8482122,Brock Faber,D,MIN,22,80,5,34,39
56,8481186,Logan O'Connor,R,COL,28,81,22,16,38
56,8475760,Nick Bjugstad,C,UTA,32,71,19,19,38
56,8470621,Corey Perry,R,EDM,39,72,18,20,38
56,8482113,Anton Lundell,C,FLA,23,76,17,21,38
56,8477429,Andrew Copp,C,DET,30,80,11,27,38
56,8478233,Andrew Mangiapane,L,WSH,28,70,18,19,37
56,8480068,Ryan Poehling,C,PHI,25,70,16,21,37
56,8479325,Charlie McAvoy,D,BOS,27,75,9,28,37
56,8480185,Eetu Luostarinen,C,FLA,26,75,21,15,36
56,8482125,Alexander Holtz,R,VGK,22,75,21,15,36
56,8481582,Nicholas Robertson,L,TOR,23,73,17,19,36
56,8480009,Eeli Tolvanen,R,SEA,25,68,16,20,36
56,8477839,Conor Sheary,L,TBL,32,82,14,22,36
56,8480434,Sean Durzi,D,UTA,26,64,14,22,36
56,8475287,Erik Haula,L,NJD,33,70,13,23,36
56,8480871,Adam Boqvist,D,FLA,24,70,13,23,36
56,8482146,Luke Evangelista,R,NSH,22,69,13,23,36
56,8474149,Evgenii Dadonov,R,DAL,35,82,11,25,36
56,8481703,Valtteri Puustinen,R,PIT,25,68,4,32,36
56,8476927,Teddy Blueger,C,VAN,30,74,16,19,35
56,8476483,Rickard Rakell,R,PIT,31,69,15,20,35
56,8479339,Patrik Laine,L,CBJ,26,68,13,22,35
56,8481546,Cam York,D,PHI,23,72,8,27,35
56,8479324,Ryan Lindgren,D,NYR,26,64,6,29,35
56,8482660,Kent Johnson,C,CBJ,22,69,5,30,35
56,8480336,Sean Walker,D,CAR,30,69,4,31,35
56,8478466,Daniel Sprong,R,VAN,27,71,17,17,34
56,8484145,Zach Benson,L,BUF,19,74,15,19,34
56,8480798,Philipp Kurashev,C,CHI,25,63,9,25,34
56,8476885,Jacob Trouba,D,NYR,30,73,8,26,34
56,8476419,Jean-Gabriel Pageau,C,NYI,32,77,7,27,34
56,8477488,Brett Pesce,D,NJD,30,69,7,27,34
56,8478057,Dakota Joshua,C,VAN,28,62,17,16,33
56,8473422,Nick Foligno,L,CHI,37,62,14,19,33
56,8477498,Darnell Nurse,D,EDM,29,74,13,20,33
56,8481656,Aliaksei Protas,C,WSH,23,65,12,21,33
56,8475753,Justin Faulk,D,STL,32,68,11,22,33
56,8475193,Tomas Tatar,L,NJD,34,67,11,22,33
56,8478133,Jake Evans,C,MTL,28,74,9,24,33
56,8481606,Jordan Spence,D,LAK,23,72,7,26,33
56,8478038,Devon Toews,D,COL,30,67,3,30,33
56,8484203,Bradly Nadeau,L,CAR,19,61,14,18,32
56,8479316,Luke Kunin,C,SJS,27,62,14,18,32
56,8481523,Kirby Dach,C,MTL,23,66,13,19,32
56,8482624,Daniil Miromanov,D,CGY,27,60,13,19,32
56,8478109,Victor Olofsson,L,VGK,29,72,13,19,32
56,8482667,William Eklund,L,SJS,22,65,11,21,32
56,8480220,Noah Cates,L,PHI,25,67,11,21,32
56,8482133,Thomas Bordeleau,C,SJS,22,69,9,23,32
56,8477948,Travis Sanheim,D,PHI,28,69,7,25,32
56,8476923,Damon Severson,D,CBJ,30,81,7,25,32
56,8477969,Marcus Pettersson,D,PIT,28,80,4,28,32
56,8479393,Noah Gregor,L,OTT,26,76,17,14,31
56,8482475,Yegor Chinakhov,R,CBJ,23,58,16,15,31
56,8477952,Robby Fabbri,C,ANA,28,63,15,16,31
56,8481554,Kaapo Kakko,R,NYR,23,67,15,16,31
56,8483808,Andrei Kuzmenko,L,CGY,28,77,11,20,31
56,8478055,Gustav Forsling,D,FLA,28,72,11,20,31
56,8483490,Pavel Mintyukov,D,ANA,21,72,7,24,31
56,8476917,Adam Pelech,D,NYI,30,76,5,26,31
56,8480043,Timothy Liljegren,D,TOR,25,64,3,28,31
56,8478042,Viktor Arvidsson,L,EDM,31,71,15,15,30
56,8475714,Calle Jarnkrok,C,TOR,33,71,15,15,30
56,8480849,Barrett Hayton,C,UTA,24,73,14,16,30
56,8482097,Jack Quinn,R,BUF,23,62,12,18,30
56,8480113,Alex Iafallo,L,WPG,31,66,12,18,30
56,8475848,Brendan Gallagher,R,MTL,32,70,11,19,30
56,8481580,Connor McMichael,C,WSH,23,62,11,19,30
56,8474053,Logan Couture,C,SJS,35,57,10,20,30
56,8476392,Adam Lowry,C,WPG,31,66,10,20,30
56,8482655,Janis Moser,D,TBL,24,78,6,24,30
56,8480873,Rasmus Sandin,D,WSH,24,69,5,25,30
56,8477989,Christian Dvorak,C,MTL,28,59,19,10,29
56,8480813,Joe Veleno,C,DET,24,79,17,12,29
56,8480980,Connor Dewar,C,TOR,25,68,17,12,29
56,8479941,Justin Danforth,R,CBJ,31,60,17,12,29
56,8476981,Josh Anderson,R,MTL,30,73,16,13,29
56,8477511,Anthony Mantha,R,CGY,30,71,15,14,29
56,8474716,Jared Spurgeon,D,MIN,35,79,11,18,29
56,8480078,Filip Chytil,C,NYR,25,67,10,19,29
56,8475791,Taylor Hall,L,CHI,33,61,10,19,29
56,8476480,Vladislav Namestnikov,C,WPG,32,67,10,19,29
56,8482111,Justin Barron,D,MTL,23,69,9,20,29
56,8477507,Nikita Zadorov,D,BOS,29,62,7,22,29
56,8476854,Hampus Lindholm,D,BOS,30,73,6,23,29
56,8477506,Ryan Pulock,D,NYI,30,77,5,24,29
56,8480829,Jesperi Kotkaniemi,C,CAR,24,63,18,10,28
56,8478020,Michael Amadio,R,OTT,28,72,13,15,28
56,8477425,Miles Wood,L,COL,29,78,13,15,28
56,8476474,Stefan Noesen,R,NJD,31,61,12,16,28
56,8483499,Liam Ohgren,L,MIN,20,57,12,16,28
56,8481481,Blake Lizotte,C,PIT,27,61,12,16,28
56,8475855,Jesper Fast,R,CAR,33,62,12,16,28
56,8479351,Sam Steel,C,DAL,26,79,9,19,28
56,8481581,Thomas Harley,D,DAL,23,70,8,20,28
56,8479353,Brett Howden,C,VGK,26,70,8,20,28
56,8478882,Vladislav Gavrikov,D,LAK,29,70,8,20,28
56,8480145,Neal Pionk,D,WPG,29,68,7,21,28
56,8475200,Dmitry Orlov,D,CAR,33,74,7,21,28
56,8476457,Adam Larsson,D,SEA,32,69,6,22,28
56,8476869,Brady Skjei,D,NSH,30,71,5,23,28
56,8474151,Ryan McDonagh,D,TBL,35,77,4,24,28
56,8476892,Colton Parayko,D,STL,31,74,3,25,28
56,8474673,TJ Brodie,D,CHI,34,65,2,26,28
56,8476918,Jimmy Vesey,L,NYR,31,70,16,11,27
56,8475722,Jason Zucker,L,BUF,32,66,14,13,27
56,8483468,Jiri Kulich,C,BUF,20,58,14,13,27
56,8475343,Nic Dowd,C,WSH,34,65,12,15,27
56,8477919,Frederick Gaudreau,C,MIN,31,64,10,17,27
56,8479328,Julien Gauthier,R,NYI,27,64,10,17,27
56,8481577,Philip Tomasino,C,NSH,23,63,9,18,27
56,8476463,Jonas Brodin,D,MIN,31,74,7,20,27
56,8476467,Jamie Oleksiak,D,SEA,32,68,6,21,27
56,8475149,Marcus Johansson,L,MIN,34,63,5,22,27
56,8480878,Nils Lundkvist,D,DAL,24,74,4,23,27
56,8475171,Oliver Ekman-Larsson,D,TOR,33,67,3,24,27
56,8482259,Bobby McMann,C,TOR,28,60,14,12,26
56,8474189,Lars Eller,C,PIT,35,68,14,12,26
56,8476374,Sean Kuraly,C,CBJ,31,55,11,15,26
56,8479365,Trent Frederic,C,BOS,26,76,10,16,26
56,8479661,Tanner Jeannot,L,LAK,27,74,10,16,26
56,8480855,Jack McBain,C,UTA,24,72,9,17,26
56,8482117,Lukas Reichel,L,CHI,22,62,8,18,26
56,8479293,Brandon Tanev,L,SEA,33,64,6,20,26
56,8477435,Ryan Graves,D,PIT,29,77,5,21,26
56,8477450,Jason Dickinson,C,CHI,29,54,16,9,25
56,8474715,Cameron Atkinson,R,TBL,35,81,16,9,25
56,8476292,Ondrej Palat,L,NJD,33,67,13,12,25
56,8482737,Zack Bolduc,C,STL,21,52,10,15,25
56,8482074,Connor Zary,C,CGY,23,67,9,16,25
56,8482105,Jake Sanderson,D,OTT,22,70,6,19,25
56,8482245,Artem Zub,D,OTT,29,71,5,20,25
56,8482089,Jake Neighbours,L,STL,22,66,18,6,24
56,8480205,Emil Bemstrom,C,PIT,25,52,13,11,24
56,8477947,Sonny Milano,L,WSH,28,59,12,12,24
56,8479368,Max Jones,L,BOS,26,65,10,14,24
56,8476960,Andreas Athanasiou,C,CHI,30,56,8,16,24
56,8479639,Dylan Coghlan,D,WPG,26,62,6,18,24
56,8477220,Nate Schmidt,D,FLA,33,60,5,19,24
56,8480049,Dylan Samberg,D,WPG,25,69,2,22,24
56,8473507,Jeff Petry,D,DET,37,72,2,22,24
56,8483445,Cutter Gauthier,L,ANA,20,63,2,22,24
56,8483524,Shane Wright,C,SEA,20,64,14,9,23
56,8481032,Paul Cotter,C,NJD,25,55,14,9,23
56,8479996,Cody Glass,C,NSH,25,60,13,10,23
56,8481553,Bobby Brink,R,PHI,23,58,12,11,23
56,8476921,Jordan Martinook,L,CAR,32,61,12,11,23
56,8476278,Colin Blackwell,C,DAL,31,77,12,11,23
56,8482705,Cole Sillinger,C,CBJ,21,62,11,12,23
56,8481704,Juuso Parssinen,C,NSH,23,56,11,12,23
56,8476897,Oskar Sundqvist,C,STL,30,63,10,13,23
56,8477406,Mattias Janmark,C,EDM,32,63,10,13,23
56,8480835,Jack Drury,C,CAR,24,62,9,14,23
56,8477478,William Carrier,L,CAR,30,52,8,15,23
56,8478136,Jake Middleton,D,MIN,28,75,8,15,23
56,8480789,Oliver Wahlstrom,R,NYI,24,75,7,16,23
56,8475220,Marcus Foligno,L,MIN,33,52,7,16,23
56,8475462,Radko Gudas,D,ANA,34,66,7,16,23
56,8482803,Olen Zellweger,D,ANA,21,66,7,16,23
56,8481522,Peyton Krebs,C,BUF,23,56,6,17,23
56,8480035,Henri Jokiharju,D,BUF,25,62,5,18,23
56,8476331,Dylan DeMelo,D,WPG,31,67,2,21,23
56,8476934,Brock McGinn,L,ANA,30,54,12,10,22
56,8482079,Marco Rossi,C,MIN,23,59,11,11,22
56,8478432,Christian Fischer,R,DET,27,77,10,12,22
56,8477505,Alexander Wennberg,C,SJS,30,62,9,13,22
56,8478013,Jake Walman,D,SJS,28,69,9,13,22
56,8483491,Ivan Miroshnichenko,L,WSH,20,61,9,13,22
56,8476925,Colton Sissons,C,NSH,31,67,7,15,22
56,8482101,Danil Gushchin,L,SJS,22,57,7,15,22
56,8476988,Matt Benning,D,SJS,30,66,6,16,22
56,8482142,Jamie Drysdale,D,PHI,22,63,4,18,22
56,8478399,Jonas Siegenthaler,D,NJD,27,57,4,18,22
56,8482712,Oskar Olausson,R,COL,22,76,3,19,22
56,8482067,Connor Mackey,D,NYR,28,59,2,20,22
56,8478500,Ivan Provorov,D,CBJ,27,77,2,20,22
56,8478463,Anthony Beauvillier,L,PIT,27,61,13,8,21
56,8479390,Taylor Raddysh,R,WSH,26,59,13,8,21
56,8480893,Kirill Marchenko,R,CBJ,24,52,12,9,21
56,8479619,Michael Carcone,L,UTA,28,58,12,9,21
56,8480459,Pius Suter,C,VAN,28,64,11,10,21
56,8473533,Jordan Staal,C,CAR,36,63,11,10,21
56,8473453,Trevor Lewis,C,LAK,37,76,10,11,21
56,8477508,Curtis Lazar,C,NJD,29,60,10,11,21
56,8478569,Noel Acciari,C,PIT,33,54,9,12,21
56,8480074,Alexandre Texier,C,STL,25,53,8,13,21
56,8477979,Nicolas Aube-Kubel,R,BUF,28,61,8,13,21
56,8482679,Matt Coronato,R,CGY,22,74,7,14,21
56,8477499,Rasmus Ristolainen,D,PHI,30,61,7,14,21
56,8482087,Kaiden Guhle,D,MTL,22,66,4,17,21
56,8479980,Nicolas Hague,D,VGK,26,56,4,17,21
56,8480246,Nick Perbix,D,TBL,26,72,3,18,21
56,8483457,Lane Hutson,D,MTL,20,67,11,9,20
56,8479344,Jesse Puljujarvi,R,PIT,26,48,11,9,20
56,8477903,Garnet Hathaway,R,PHI,33,69,10,10,20
56,8476878,Zemgus Girgensons,C,TBL,30,77,9,11,20
56,8475842,Sam Carrick,C,NYR,32,55,9,11,20
56,8478434,Keegan Kolesar,R,VGK,27,67,8,12,20
56,8480144,David Kampf,C,TOR,29,73,6,14,20
56,8478970,Jalen Chatfield,D,CAR,28,66,6,14,20
56,8479998,Mikey Anderson,D,LAK,25,62,6,14,20
56,8474574,Tyler Myers,D,VAN,34,71,5,15,20
56,8480073,Erik Brannstrom,D,COL,25,57,5,15,20
56,8481617,Vasily Podkolzin,R,VAN,23,47,4,16,20
56,8479982,Conor Timmins,D,TOR,26,62,4,16,20
56,8475233,David Savard,D,MTL,34,67,3,17,20
56,8479976,Juuso Valimaki,D,UTA,26,59,3,17,20
56,8479983,Mario Ferraro,D,SJS,26,73,3,17,20
56,8481059,Scott Perunovich,D,STL,26,56,3,17,20
56,8475455,Brenden Dillon,D,NJD,34,63,2,18,20
56,8476525,Colin Miller,D,WPG,32,70,1,19,20
56,8475179,Dmitry Kulikov,D,FLA,34,66,1,19,20
56,8483493,Frank Nazar,C,CHI,20,53,10,9,19
56,8478413,Jordan Greenway,L,BUF,27,63,8,11,19
56,8476856,Mathew Dumba,D,DAL,30,73,8,11,19
56,8479591,Michael Eyssimont,C,TBL,28,79,7,12,19
56,8483565,Nick Blankenburg,D,NSH,26,64,7,12,19
56,8484149,Gavin Brindley,C,CBJ,20,51,7,12,19
56,8473563,Nicklas Backstrom,C,WSH,37,61,6,13,19
56,8480448,Parker Kelly,L,COL,25,75,6,13,19
56,8476312,Josh Manson,D,COL,33,56,6,13,19
56,8478178,Darren Raddysh,D,TBL,28,67,5,14,19
56,8478507,John Marino,D,UTA,27,68,4,15,19
56,8475181,Nick Leddy,D,STL,33,69,4,15,19
56,8476429,Scott Mayfield,D,NYI,32,73,4,15,19
56,8478421,A.J. Greer,L,FLA,28,48,4,15,19
56,8477369,Carson Soucy,D,VAN,30,67,4,15,19
56,8480172,Jan Rutta,D,SJS,34,67,4,15,19
56,8482192,Isaak Phillips,D,CHI,23,59,4,15,19
56,8476931,Jake McCabe,D,TOR,31,68,2,17,19
56,8476873,Mark Jankowski,C,NSH,30,55,11,7,18
56,8477353,Tyler Motte,C,DET,29,76,9,9,18
56,8479315,Joey Anderson,R,CHI,26,52,8,10,18
56,8482809,Jackson Blake,R,CAR,21,55,8,10,18
56,8478452,Caleb Jones,D,LAK,27,56,7,11,18
56,8481013,Jonatan Berggren,R,DET,24,60,6,12,18
56,8480806,Isac Lundestrom,C,ANA,25,64,6,12,18
56,8479414,Nathan Bastian,R,NJD,27,62,5,13,18
56,8478416,Erik Cernak,D,TBL,27,76,4,14,18
56,8474013,Ian Cole,D,UTA,35,47,3,15,18
56,8475790,Erik Gudbranson,D,CBJ,32,78,1,17,18
56,8475188,Brayden McNabb,D,VGK,33,50,0,18,18
56,8479439,Jacob MacDonald,D,COL,31,57,13,4,17
56,8482659,Josh Doan,R,UTA,22,48,12,5,17
56,8482155,Alex Laferriere,R,LAK,23,67,12,5,17
56,8480281,Alexey Toropchenko,R,STL,25,55,11,6,17
56,8481527,Kaedan Korczak,D,VGK,23,54,10,7,17
56,8481093,Rafael Harvey-Pinard,L,MTL,25,60,7,10,17
56,8479026,Philippe Myers,D,TOR,27,58,6,11,17
56,8482730,Brandt Clarke,D,LAK,21,49,5,12,17
56,8477392,Hudson Fasching,R,NYI,29,60,5,12,17
56,8479543,Michael Pezzetta,L,MTL,26,57,5,12,17
56,8477931,Tomas Nosek,L,FLA,32,63,4,13,17
56,8480157,Calle Rosen,D,COL,30,52,3,14,17
56,8470600,Ryan Suter,D,STL,39,67,2,15,17
56,8481716,Dmitri Voronkov,L,CBJ,24,42,15,1,16
56,8476902,Esa Lindell,D,DAL,30,71,10,6,16
56,8481517,Brett Leason,R,ANA,25,60,10,6,16
56,8480021,Jack Studnicka,C,LAK,25,60,10,6,16
56,8481601,Simon Holmstrom,R,NYI,23,62,9,7,16
56,8482157,Will Cuylle,L,NYR,22,62,9,7,16
56,8480995,Pontus Holmberg,R,TOR,25,60,8,8,16
56,8482166,Shakir Mukhamadullin,D,SJS,22,64,8,8,16
56,8478043,Sam Lafferty,C,BUF,29,54,6,10,16
56,8479066,Ryan Lomberg,L,CGY,30,67,6,10,16
56,8475324,Nick Jensen,D,OTT,34,67,6,10,16
56,8479944,Zach Aston-Reese,C,VGK,30,49,6,10,16
56,8481014,Alexander Romanov,D,NYI,24,76,5,11,16
56,8479718,Alex Barré-Boulet,C,MTL,27,50,5,11,16
56,8481441,Joe Snively,C,DET,28,55,4,12,16
56,8476422,Mike Reilly,D,NYI,31,76,4,12,16
56,8482073,Braden Schneider,D,NYR,23,61,4,12,16
56,8476879,Cody Ceci,D,EDM,31,62,3,13,16
56,8479398,Samuel Girard,D,COL,26,68,3,13,16
56,8480727,Zach Whitecloud,D,VGK,28,47,2,14,16
56,8479369,Andrew Peeke,D,BOS,26,61,2,14,16
56,8480891,Michael Kesselring,D,UTA,24,63,1,15,16
56,8480011,Klim Kostin,C,SJS,25,49,10,5,15
56,8482744,James Malatesta,L,CBJ,21,46,10,5,15
56,8478508,Yakov Trenin,C,MIN,27,47,8,7,15
56,8482749,Joshua Roy,R,MTL,21,58,7,8,15
56,8480003,Jesper Boqvist,C,FLA,26,70,6,9,15
56,8477938,Haydn Fleury,D,WPG,28,43,6,9,15
56,8482148,Hendrix Lapierre,C,WSH,22,47,5,10,15
56,8481521,Ronnie Attard,D,PHI,25,56,4,11,15
56,8482634,Alex Steeves,C,TOR,25,42,2,13,15
56,8481568,Alex Vlasic,D,CHI,23,53,2,13,15
56,8480796,Martin Fehervary,D,WSH,25,52,2,13,15
56,8476891,Matthew Grzelcyk,D,PIT,30,74,1,14,15
56,8480025,MacKenzie Entwistle,R,FLA,25,56,9,5,14
56,8481641,Joel Kiviranta,L,COL,28,78,9,5,14
56,8476469,Joel Armia,R,MTL,31,62,8,6,14
56,8479981,Jonah Gadjovich,L,FLA,26,49,8,6,14
56,8476329,Travis Boyd,C,MIN,31,62,7,7,14
56,8482176,Wyatt Kaiser,D,CHI,22,50,7,7,14
56,8481599,Victor Soderstrom,D,UTA,23,40,7,7,14
56,8471817,Ryan Reaves,R,TOR,37,55,6,8,14
56,8483482,Tristan Luneau,D,ANA,20,62,6,8,14
56,8477018,Ben Hutton,D,VGK,31,53,5,9,14
56,8481550,Adam Beckman,L,NJD,23,47,5,9,14
56,8479402,Jake Bean,D,CGY,26,69,4,10,14
56,8481537,Nikita Okhotiuk,D,CGY,24,52,4,10,14
56,8477845,Trevor van Riemsdyk,D,WSH,33,53,4,10,14
56,8475208,Brian Dumoulin,D,ANA,33,71,4,10,14
56,8477015,Connor Brown,R,EDM,30,56,3,11,14
56,8481708,Zac Jones,D,NYR,24,55,2,12,14
56,8478840,Will Borgen,D,SEA,28,65,1,13,14
56,8478468,Jeremy Lauzon,D,NSH,27,55,1,13,14
56,8477446,Michael McCarron,R,NSH,29,63,10,3,13
56,8479336,Carl Grundstrom,R,SJS,27,46,9,4,13
56,8482077,Dylan Holloway,L,EDM,23,56,7,6,13
56,8483495,Simon Nemec,D,NJD,20,54,6,7,13
56,8476822,Luke Glendening,C,TBL,35,78,5,8,13
56,8478211,Dryden Hunt,L,CGY,29,54,5,8,13
56,8480950,Ilya Lyubushkin,D,DAL,30,61,4,9,13
56,8481701,Santeri Hatakka,D,NJD,23,38,4,9,13
56,8478859,Niko Mikkola,D,FLA,28,53,3,10,13
56,8480222,Sebastian Aho,D,PIT,28,71,3,10,13
56,8475279,Ben Chiarot,D,DET,33,69,3,10,13
56,8475718,Justin Holl,D,DET,32,54,2,11,13
56,8477365,Connor Clifton,D,BUF,29,62,1,12,13
56,8479371,Dante Fabbro,D,NSH,26,62,0,13,13
56,8480807,Mattias Samuelsson,D,BUF,24,55,0,13,13
56,8482062,Cole Smith,L,NSH,29,55,10,2,12
56,8481028,Martin Pospisil,C,CGY,25,52,8,4,12
56,8482713,Mackie Samoskevich,R,FLA,22,44,6,6,12
56,8481122,Simon Benoit,D,TOR,26,31,6,6,12
56,8475231,Casey Cizikas,C,NYI,33,68,5,7,12
56,8477482,Zachary Sanford,L,CHI,30,39,5,7,12
56,8481161,Jake Christiansen,D,CBJ,25,56,5,7,12
56,8480762,Eric Robinson,L,CAR,29,56,4,8,12
56,8480192,Johnathan Kovacevic,D,NJD,27,54,4,8,12
56,8474034,Patrick Maroon,L,CHI,36,41,4,8,12
56,8478424,Jansen Harkins,C,ANA,27,41,4,8,12
56,8479370,Tyson Jost,C,CAR,26,54,3,9,12
56,8480070,Ian Mitchell,D,BOS,25,45,3,9,12
56,8481178,Egor Zamula,D,PHI,24,57,2,10,12
56,8474090,Brendan Smith,D,DAL,35,58,2,10,12
56,8476967,Brett Kulak,D,EDM,30,61,1,11,12
56,8481751,Lukas Rousek,R,BUF,25,46,1,11,12
56,8479536,Axel Jonsson-Fjallby,L,WPG,26,37,8,3,11
56,8480848,Ty Dellandrea,C,SJS,24,41,7,4,11
56,8477887,Patrick Brown,C,BOS,32,43,6,5,11
56,8480355,Mark Kastelic,C,BOS,25,63,5,6,11
56,8482666,Scott Morrow,D,CAR,22,51,5,6,11
56,8482747,Brennan Othmann,L,NYR,21,38,5,6,11
56,8479968,Vinni Lettieri,C,BOS,29,41,5,6,11
56,8479520,Brandon Duhaime,R,WSH,27,50,5,6,11
56,8480748,Kiefer Sherwood,L,VAN,29,54,4,7,11
56,8478831,Kevin Stenlund,C,UTA,28,64,4,7,11
56,8477380,Jonny Brodzinski,C,NYR,31,48,4,7,11
56,8478851,Alexandre Carrier,D,NSH,28,64,3,8,11
56,8481019,David Gustafsson,C,WPG,24,49,3,8,11
56,8471709,Marc-Edouard Vlasic,D,SJS,37,59,3,8,11
56,8479442,Troy Stecher,D,EDM,30,59,3,8,11
56,8477070,Liam O'Brien,C,UTA,30,55,2,9,11
56,8481567,Henry Thrun,D,SJS,23,46,2,9,11
56,8475177,Calvin de Haan,D,COL,33,47,2,9,11
56,8477962,Brendan Lemieux,L,CAR,28,41,2,9,11
56,8476442,Matt Nieto,L,PIT,32,45,2,9,11
56,8480879,Jacob Bernard-Docker,D,OTT,24,43,2,9,11
56,8474166,Alec Martinez,D,CHI,37,48,1,10,11
56,8477384,Joshua Brown,D,EDM,30,43,0,11,11
56,8482762,Simon Edvinsson,D,DET,21,54,8,2,10
56,8483466,Kevin Korchinski,D,CHI,20,53,6,4,10
56,8482784,Zach Dean,C,STL,21,49,5,5,10
56,8479772,Zack MacEwen,R,OTT,28,44,5,5,10
56,8478874,Adam Gaudette,R,OTT,28,36,5,5,10
56,8481477,Nico Sturm,C,SJS,29,51,4,6,10
56,8482807,Ethan Del Mastro,D,CHI,21,46,4,6,10
56,8481532,Alex Turcotte,C,LAK,23,41,4,6,10
56,8480860,Kevin Bahl,D,CGY,24,58,3,7,10
56,8481518,Nolan Foote,L,NJD,24,38,3,7,10
56,8481167,Brayden Pachal,D,CGY,25,52,3,7,10
56,8481600,Tobias Bjornfot,D,FLA,23,37,3,7,10
56,8480441,Trey Fix-Wolansky,R,CBJ,25,42,2,8,10
56,8480887,Jordan Harris,D,MTL,24,47,1,9,10
56,8479372,Joshua Mahura,D,SEA,26,49,1,9,10
56,8479249,Andrew Poturalski,C,SJS,30,33,1,9,10
56,8482451,Mikael Pyyhtia,L,CBJ,23,46,1,9,10
56,8478443,Brandon Carlo,D,BOS,28,65,1,9,10
56,8483549,Lucas Condotta,L,MTL,27,42,1,9,10
56,8479986,Kole Lind,R,DAL,26,51,1,9,10
56,8482765,Isak Rosen,R,BUF,21,32,6,3,9
56,8481679,Maxence Guenette,D,OTT,23,44,6,3,9
56,8482652,Walker Duehr,R,CGY,27,39,5,4,9
56,8476858,Phillip Di Giuseppe,L,VAN,31,42,4,5,9
56,8482751,Ryan Winterton,C,SEA,21,39,4,5,9
56,8480058,Pierre-Olivier Joseph,D,STL,25,52,3,6,9
56,8476889,Radek Faksa,C,STL,30,58,3,6,9
56,8480845,Rasmus Kupari,C,WPG,24,40,3,6,9
56,8480289,Morgan Barron,C,WPG,26,58,3,6,9
56,8480001,Urho Vaakanainen,D,ANA,25,50,2,7,9
56,8474567,Zach Bogosian,D,MIN,34,64,2,7,9
56,8481598,Philip Broberg,D,EDM,23,44,2,7,9
56,8476874,Olli Maatta,D,DET,30,65,2,7,9
56,8481147,Reese Johnson,C,MIN,26,43,2,7,9
56,8475762,Derek Forbort,D,VAN,32,44,2,7,9
56,8479991,Jake Leschyshyn,C,NYR,25,31,2,7,9
56,8478450,Parker Wotherspoon,D,BOS,27,36,1,8,9
56,8478454,Noah Juulsen,D,VAN,27,36,0,9,9
56,8482496,Nils Aman,C,VAN,24,40,6,2,8
56,8477573,Nathan Walker,L,STL,30,43,5,3,8
56,8481609,Vladislav Kolyachonok,D,UTA,23,40,4,4,8
56,8482145,Mavrik Bourque,C,DAL,22,47,4,4,8
56,8477851,Jordan Oesterle,D,BOS,32,40,4,4,8
56,8478017,Mark Friedman,D,VAN,29,30,3,5,8
56,8478585,Derek Ryan,C,EDM,38,61,3,5,8
56,8484911,Collin Graf,R,SJS,22,42,3,5,8
56,8474568,Luke Schenn,D,NSH,35,55,2,6,8
56,8476441,Joel Edmundson,D,LAK,31,42,2,6,8
56,8471677,Jack Johnson,D,CBJ,37,62,1,7,8
56,8483763,Maksymilian Szuber,D,UTA,22,37,1,7,8
56,8477034,Jaycob Megna,D,FLA,32,46,0,8,8
56,8475225,Craig Smith,C,CHI,35,50,4,3,7
56,8479671,Mathieu Olivier,R,CBJ,27,52,4,3,7
56,8480880,Jakub Lauko,C,MIN,24,30,4,3,7
56,8482511,Mason Lohrei,D,BOS,23,35,4,3,7
56,8484287,Cole McWard,D,VAN,23,23,4,3,7
56,8480252,Cole Guttman,C,CHI,25,32,3,4,7
56,8479359,Beck Malenstyn,L,BUF,26,46,3,4,7
56,8477401,John Hayden,C,SEA,29,34,3,4,7
56,8481754,Nikita Nesterenko,C,ANA,23,29,3,4,7
56,8479994,Jaret Anderson-Dolan,C,WPG,25,31,3,4,7
56,8479348,Kale Clague,D,BUF,26,38,2,5,7
56,8475690,Chris Tanev,D,TOR,35,60,1,6,7
56,8479972,Mason Shaw,C,WPG,26,34,1,6,7
56,8481056,Spencer Stastney,D,NSH,24,31,1,6,7
56,8478451,Ethan Bear,D,WSH,27,40,1,6,7
56,8475750,Jon Merrill,D,MIN,32,65,0,7,7
56,8482733,Logan Mailloux,D,MTL,31,35,0,7,7
56,8481789,Tye Kartye,L,SEA,23,37,5,1,6
56,8483397,Marc McLaughlin,C,BOS,25,29,5,1,6
56,8480990,Declan Chisholm,D,MIN,24,36,4,2,6
56,8476624,Barclay Goodrow,C,SJS,31,53,4,2,6
56,8480890,Jan Jenik,C,OTT,24,35,3,3,6
56,8476952,Dominic Toninato,C,WPG,30,45,3,3,6
56,8479291,Kevin Rooney,C,CGY,31,48,2,4,6
56,8479378,Logan Stanley,D,WPG,26,37,2,4,6
56,8480267,Sammy Walker,C,MIN,25,20,2,4,6
56,8476994,Vinnie Hinostroza,C,NSH,30,37,1,5,6
56,8473446,Erik Johnson,D,PHI,36,40,1,5,6
56,8476473,Connor Murphy,D,CHI,31,36,1,5,6
56,8474612,Travis Hamonic,D,OTT,34,46,1,5,6
56,8477527,Ross Johnston,L,ANA,30,39,1,5,6
56,8482929,Emil Lilleberg,D,TBL,23,15,1,5,6
56,8476372,Nick Seeler,D,PHI,31,47,0,6,6
56,8477335,Kyle Burroughs,D,LAK,29,33,0,6,6
56,8476867,Brendan Gaunce,C,MIN,30,38,0,6,6
56,8483619,Filip Roos,D,OTT,25,31,0,6,6
56,8481556,John Beecher,C,BOS,23,33,4,1,5
56,8480245,Olle Lycksell,R,PHI,25,29,3,2,5
56,8479638,Justin Brazeau,R,BOS,26,33,3,2,5
56,8481422,Jake Lucchini,C,NSH,29,27,3,2,5
56,8475780,Chris Wagner,R,COL,33,9,3,2,5
56,8477073,Kurtis MacDermid,L,NJD,30,30,3,2,5
56,8475235,Nicolas Deslauriers,L,PHI,33,43,2,3,5
56,8480007,Jonas Rondbjerg,R,VGK,25,38,2,3,5
56,8475795,Dylan McIlrath,D,WSH,32,14,2,3,5
56,8480870,Bo Groulx,C,NYR,24,32,2,3,5
56,8483012,Logan Morrison,C,SEA,22,27,2,3,5
56,8482095,Tyler Kleven,D,OTT,22,43,1,4,5
56,8479419,Brett Murray,L,BUF,26,16,1,4,5
56,8482859,Zack Ostapchuk,C,OTT,21,50,0,5,5
56,8480844,Grigori Denisenko,L,VGK,24,29,0,5,5
56,8484254,Akito Hirose,D,VAN,25,41,0,5,5
56,8478409,Anthony Richard,C,PHI,28,29,0,5,5
56,8481605,Jackson LaCombe,D,ANA,23,27,0,5,5
56,8483460,David Jiricek,D,CBJ,21,57,0,5,5
56,8484258,Sam Malinski,D,COL,26,20,0,5,5
56,8482070,Mitchell Chaffee,R,TBL,26,57,3,1,4
56,8479985,Cale Fleury,D,SEA,26,33,3,1,4
56,8481592,Jakob Pelletier,L,CGY,23,34,2,2,4
56,8480292,Carson Meyer,R,ANA,27,29,2,2,4
56,8482172,Landon Slaggert,L,CHI,22,24,2,2,4
56,8477467,Gustav Olofsson,D,SEA,30,16,2,2,4
56,8481030,Jack St. Ivany,D,PIT,25,13,2,2,4
56,8474062,Riley Nash,C,NYR,35,19,2,2,4
56,8483395,Arshdeep Bains,L,VAN,23,14,2,2,4
56,8483570,Ben Meyers,C,SEA,26,30,1,3,4
56,8476913,Devin Shore,C,MIN,30,25,1,3,4
56,8479379,Givani Smith,R,SJS,26,37,1,3,4
56,8481543,Nikita Alexandrov,C,STL,24,33,1,3,4
56,8478881,Brett Seney,L,CHI,28,14,1,3,4
56,8482141,Lukas Cormier,D,VGK,22,27,0,4,4
56,8477244,Chad Ruhwedel,D,NYR,34,31,0,4,4
56,8479587,Rhett Gardner,C,PHI,28,20,0,4,4
56,8475958,Michael Sgarbossa,C,WSH,32,34,2,1,3
56,8483630,Pavol Regenda,L,ANA,25,27,2,1,3
56,8482858,Ryker Evans,D,SEA,23,25,2,1,3
56,8479320,Maxime Lajoie,D,SEA,27,20,2,1,3
56,8478011,Louie Belpedio,D,PHI,28,13,2,1,3
56,8483512,Matthew Savoie,C,EDM,20,24,2,1,3
56,8481655,Cole Schwindt,R,CGY,23,10,2,1,3
56,8484325,Waltteri Merela,C,TBL,26,18,2,1,3
56,8482153,Brendan Brisson,C,VGK,23,32,1,2,3
56,8481006,Tyler Tucker,D,STL,24,14,1,2,3
56,8478477,Mitchell Stephens,C,SEA,27,14,1,2,3
56,8480823,Alexander Alexeyev,D,WSH,25,14,1,2,3
56,8482861,Vincent Iorio,D,WSH,22,32,0,3,3
56,8482964,Arber Xhekaj,D,MTL,23,45,0,3,3
56,8482177,Marat Khusnutdinov,C,MIN,22,35,0,3,3
56,8480834,Ty Emberson,D,SJS,24,26,0,3,3
56,8481541,Samuel Bolduc,D,NYI,24,33,0,3,3
56,8482201,Gage Goncalves,C,TBL,23,23,0,3,3
56,8477462,Robert Hagg,D,VGK,29,29,0,3,3
56,8478502,Dennis Gilbert,D,BUF,28,11,0,3,3
56,8475413,Justin Dowling,C,NJD,34,13,0,3,3
56,8482147,Jean-Luc Foudy,C,COL,22,24,2,0,2
56,8477473,Justin Bailey,R,SJS,29,27,2,0,2
56,8480084,Nick DeSimone,D,NJD,30,19,2,0,2
56,8482144,Jack Thompson,D,SJS,22,22,1,1,2
56,8478051,Max Willman,C,NJD,29,17,1,1,2
56,8477149,Scott Sabourin,R,SJS,32,11,1,1,2
56,8482250,Callahan Burke,C,VGK,27,16,1,1,2
56,8479367,William Lockwood,R,FLA,26,15,1,1,2
56,8478146,Matthew Highmore,C,OTT,28,29,1,1,2
56,8482460,Matt Rempe,C,NYR,22,12,1,1,2
56,8481743,Marc Del Gaizo,D,NSH,25,18,1,1,2
56,8482470,Ilya Solovyov,D,CGY,24,22,1,1,2
56,8481585,Egor Afanasyev,L,SJS,23,17,1,1,2
56,8477320,Anton Blidh,L,NYR,29,19,0,2,2
56,8477971,Andreas Englund,D,LAK,28,25,0,2,2
56,8481593,Jayden Struble,D,MTL,23,22,0,2,2
56,8482516,Matthew Kessel,D,STL,24,21,0,2,2
56,8477810,Joel Hanley,D,CGY,33,16,0,2,2
56,8481806,Louis Crevier,D,CHI,23,16,0,2,2
56,8484304,Uvis Balinskis,D,FLA,28,14,0,2,2
56,8481564,Ryan Johnson,D,BUF,23,16,0,2,2
56,8480851,Akil Thomas,C,LAK,24,10,1,0,1
56,8481699,Aku Raty,R,UTA,23,12,1,0,1
56,8482165,Yan Kuznetsov,D,CGY,22,23,1,0,1
56,8475755,Alexander Petrovic,D,DAL,32,7,1,0,1
56,8482118,Sam Colangelo,R,ANA,23,12,1,0,1
56,8481065,Angus Crookshank,L,OTT,25,15,1,0,1
56,8481043,Cole Koepke,L,BOS,26,19,1,0,1
56,8483398,Declan Carlile,D,TBL,31,7,1,0,1
56,8480306,Grant Hutton,D,NYI,29,3,1,0,1
56,8483920,Pierrick Dube,R,WSH,23,4,1,0,1
56,8478147,Bokondji Imama,L,PIT,28,5,1,0,1
56,8478446,Glenn Gawdin,C,LAK,27,16,1,0,1
56,8482476,Emil Heineman,L,MTL,23,5,1,0,1
56,8480196,Jacob Bryson,D,BUF,27,39,0,1,1
56,8478021,William Lagesson,D,DET,28,26,0,1,1
56,8480075,Cameron Crotty,D,MIN,25,10,0,1,1
56,8482102,Vasily Ponomarev,C,PIT,22,18,0,1,1
56,8479330,Brandon Gignac,C,MTL,27,5,0,1,1
56,8482088,Justin Sourdif,R,FLA,22,17,0,1,1
56,8483597,Milos Kelemen,L,UTA,25,9,0,1,1
56,8481726,Adam Edstrom,C,NYR,24,6,0,1,1
56,8483489,Fraser Minten,C,TOR,31,5,0,1,1
56,8480032,Shane Bowers,C,NJD,25,17,0,1,1
56,8481237,Kyle MacLean,C,NYI,25,25,0,1,1
56,8481462,Mason Morelli,L,VGK,28,16,0,1,1
56,8481024,Linus Karlsson,C,VAN,25,8,0,1,1
56,8480468,James Hamblin,L,EDM,25,18,0,1,1
56,8477993,Justin Kirkland,C,CGY,28,4,0,1,1
56,8480874,Adam Ginning,D,PHI,24,11,0,0,0
56,8481206,John Ludvig,D,PIT,24,11,0,0,0
56,8479576,Vincent Desharnais,D,VAN,28,24,0,0,0
56,8483567,Georgii Merkulov,C,BOS,24,5,0,0,0
56,8479362,Riley Tufte,L,BOS,26,25,0,0,0
56,8477541,Dakota Mermis,D,TOR,30,10,0,0,0
56,8483546,Marshall Rifai,D,TOR,26,4,0,0,0
56,8478854,Ryan Shea,D,PIT,27,3,0,0,0
56,8479421,Jacob Moverare,D,LAK,26,7,0,0,0
56,8481719,Maxwell Crozier,D,TBL,24,21,0,0,0
56,8481578,Graeme Clarke,R,MIN,23,14,0,0,0
56,8482061,Brandon Biro,L,SEA,26,10,0,0,0
56,8482162,Roby Jarventie,L,EDM,22,15,0,0,0
56,8476323,Max McCormick,L,SEA,32,5,0,0,0
56,8482094,Daemon Hunt,D,MIN,22,9,0,0,0
56,8484259,Ondrej Pavel,C,COL,31,1,0,0,0
56,8484255,Jason Polin,R,COL,25,1,0,0,0
56,8483471,Brad Lambert,C,WPG,31,7,0,0,0
56,8483531,Brian Halonen,L,NJD,25,3,0,0,0
56,8483432,Luca Del Bel Belluz,C,CBJ,31,2,0,0,0
56,8483407,Brandon Scanlin,D,NYR,25,7,0,0,0
56,8482787,Nikita Chibrikov,R,WPG,31,12,0,0,0
56,8484321,Nikolas Matinpalo,D,OTT,26,2,0,0,0
56,8482126,Emil Andrae,D,PHI,31,3,0,0,0
56,8479522,Hardy Haman Aktell,D,WSH,26,3,0,0,0
56,8482197,Adam Raska,R,MIN,23,6,0,0,0
56,8483401,Marc Johnstone,R,PIT,28,2,0,0,0
56,8481534,Raphael Lavoie,C,EDM,24,2,0,0,0
56,8484326,Patrik Koch,D,UTA,28,4,0,0,0
56,8483609,Adam Klapka,R,CGY,24,1,0,0,0
56,8480274,Philip Kemp,D,EDM,25,0,0,0,0
56,8470794,Joe Pavelski,C,,40,0,0,0,0
56,8479321,Lucas Johansen,D,,27,0,0,0,0
56,8477950,Tony DeAngelo,D,,29,0,0,0,0
56,8471218,Blake Wheeler,R,,38,0,0,0,0
56,8475197,Tyson Barrie,D,,33,0,0,0,0
56,8474157,Max Pacioretty,L,,36,0,0,0,0
56,8475744,Evgeny Kuznetsov,C,,32,0,0,0,0
56,8474037,James van Riemsdyk,L,,35,0,0,0,0
56,8476907,Mackenzie MacEachern,L,,30,0,0,0,0
56,8480216,Jacob Peterson,C,,25,0,0,0,0
56,8474602,Justin Schultz,D,,34,0,0,0,0
56,8482222,Alexander Barabanov,L,,30,0,0,0,0
56,8474031,Kevin Shattenkirk,D,,35,0,0,0,0
56,8477330,Dominik Kubalik,L,,29,0,0,0,0
56,8480884,Calen Addison,D,,24,0,0,0,0
56,8475906,John Klingberg,D,,32,0,0,0,0
56,8480008,Adam Ruzicka,C,,25,0,0,0,0
56,8476884,Derrick Pouliot,D,,30,0,0,0,0
56,8476919,Chris Tierney,C,,30,0,0,0,0
56,8479415,Michael McLeod,C,,26,0,0,0,0
56,8474870,Tyler Johnson,C,,34,0,0,0,0
56,8470604,Jeff Carter,C,,39,0,0,0,0
56,8478104,Sammy Blais,L,,28,0,0,0,0
56,8474884,Mike Hoffman,C,,35,0,0,0,0
56,8481591,Sam Poulin,R,,23,0,0,0,0
56,8471274,Alex Goligoski,D,,39,0,0,0,0
56,8476871,Tanner Pearson,L,,32,0,0,0,0
56,8476393,Nick Cousins,C,,31,0,0,0,0
56,8479977,Kailer Yamamoto,R,,26,0,0,0,0
56,8479346,Dillon Dube,C,,26,0,0,0,0
56,8480184,Gustav Lindstrom,D,,26,0,0,0,0
56,8479376,Victor Mete,D,,26,0,0,0,0
56,8473449,Kyle Okposo,R,,36,0,0,0,0
56,8481058,Jesse Ylonen,R,,25,0,0,0,0
56,8475752,Tyler Pitlick,C,,33,0,0,0,0
56,8481239,Samuel Fagemo,L,,24,0,0,0,0
56,8480821,Filip Zadina,R,,25,0,0,0,0
56,8470966,Mark Giordano,D,,41,0,0,0,0
56,8478495,Denis Gurianov,R,,27,0,0,0,0
56,8477464,Nic Petan,C,,29,0,0,0,0
56,8478099,Kevin Labanc,R,,29,0,0,0,0
56,8482241,Radim Zohorna,L,,28,0,0,0,0
56,8474040,Sam Gagner,C,,35,0,0,0,0
56,8479514,Rem Pitlick,C,,27,0,0,0,0
56,8478430,Oliver Kylington,D,,27,0,0,0,0
56,8479533,Joona Koppanen,L,,26,0,0,0,0
56,8479984,Cal Foote,D,,26,0,0,0,0
56,8477126,Jayson Megna,C,,34,0,0,0,0
56,8475164,Jakob Silfverberg,R,,34,0,0,0,0
56,8474009,Nick Bonino,C,,36,0,0,0,0
56,8479458,Nikita Zaitsev,D,,33,0,0,0,0
56,8477944,Jakub Vrana,L,,28,0,0,0,0
56,8471699,Andrew Cogliano,C,,37,0,0,0,0
56,8478067,Oskar Lindblom,L,,28,0,0,0,0
56,8471686,Marc Staal,D,,37,0,0,0,0
56,8470610,Zach Parise,L,,40,0,0,0,0
56,8478904,Steven Lorentz,C,,28,0,0,0,0
56,8473473,Milan Lucic,L,,36,0,0,0,0
56,8480031,Maxime Comtois,L,,25,0,0,0,0
56,8478512,Austin Czarnik,C,,32,0,0,0,0
56,8473504,Cal Clutterbuck,R,,37,0,0,0,0
56,8477454,Adam Erne,L,,29,0,0,0,0
56,8479383,Boris Katchouk,L,,26,0,0,0,0
56,8475825,Jani Hakanpää,D,,32,0,0,0,0
56,8477846,Ryan Carpenter,C,,33,0,0,0,0
56,8477930,Pierre-Edouard Bellemare,L,,39,0,0,0,0
56,8478400,Colin White,C,,27,0,0,0,0
56,8480226,Marián Studenic,R,,26,0,0,0,0
56,8480853,Liam Foudy,C,,24,0,0,0,0
56,8475797,Jarred Tinordi,D,,32,0,0,0,0
56,8479423,Alex Nylander,L,,26,0,0,0,0
56,8474618,Marco Scandella,D,,34,0,0,0,0
56,8478028,Fredrik Olofsson,L,,28,0,0,0,0
56,8474709,Matt Martin,L,,35,0,0,0,0
56,8481070,Hugh McGing,L,,26,0,0,0,0
56,8479546,Oskar Steen,C,,26,0,0,0,0
56,8474145,Robert Bortuzzo,D,,35,0,0,0,0
56,8476915,Jujhar Khaira,L,,30,0,0,0,0
56,8475278,Byron Froese,C,,33,0,0,0,0
56,8481812,Nikolai Knyzhov,D,,27,0,0,0,0
56,8478408,Travis Dermott,D,,28,0,0,0,0
56,8481077,John Leonard,L,,26,0,0,0,0
56,8479547,Matthew Phillips,R,,26,0,0,0,0
56,8480836,Jonathan Gruden,C,,24,0,0,0,0
56,8481690,Tyler Angle,C,,24,0,0,0,0
56,8475766,Austin Watson,L,,32,0,0,0,0
56,8481016,Ruslan Iskhakov,C,,24,0,0,0,0
56,8478078,Rourke Chartier,C,,28,0,0,0,0
56,8480776,Sheldon Rempal,R,,29,0,0,0,0
56,8478956,Samuel Laberge,L,NJD,27,1,0,0,0
56,8483045,Cameron Butler,R,CBJ,31,0,0,0,0
56,8484314,Jiri Smejkal,L,,28,0,0,0,0
57,8478402,Connor McDavid,C,EDM,27,74,45,96,141
57,8477956,David Pastrnak,R,BOS,28,79,72,62,134
57,8476453,Nikita Kucherov,R,TBL,31,82,38,95,133
57,8477934,Leon Draisaitl,C,EDM,29,79,42,85,127
57,8477492,Nathan MacKinnon,C,COL,29,81,44,82,126
57,8481559,Jack Hughes,C,NJD,23,74,53,68,121
57,8477404,Jake Guentzel,C,TBL,30,82,46,73,119
57,8478483,Mitch Marner,R,TOR,27,81,34,78,112
57,8479318,Auston Matthews,C,TOR,27,78,61,48,109
57,8478420,Mikko Rantanen,R,COL,28,81,44,65,109
57,8477939,William Nylander,R,TOR,28,77,52,56,108
57,8480023,Robert Thomas,C,STL,25,70,38,69,107
57,8476468,J.T. Miller,C,VAN,31,77,32,74,106
57,8478550,Artemi Panarin,L,NYR,33,77,34,69,103
57,8477933,Sam Reinhart,C,FLA,29,76,47,52,99
57,8477942,Kevin Fiala,L,LAK,28,82,33,66,99
57,8477493,Aleksander Barkov,C,FLA,29,79,29,70,99
57,8478010,Brayden Point,C,TBL,28,82,47,50,97
57,8479343,Clayton Keller,R,UTA,26,74,47,49,96
57,8479314,Matthew Tkachuk,L,FLA,27,75,25,70,95
57,8477946,Dylan Larkin,C,DET,28,79,44,50,94
57,8480027,Jason Robertson,L,DAL,25,80,35,58,93
57,8478864,Kirill Kaprizov,L,MIN,27,68,40,52,92
57,8476460,Mark Scheifele,C,WPG,31,75,36,56,92
57,8474564,Steven Stamkos,C,NSH,34,70,37,54,91
57,8477409,Carter Verhaeghe,C,FLA,29,79,50,40,90
57,8479675,Trevor Moore,L,LAK,29,80,38,52,90
57,8475172,Nazem Kadri,C,CGY,34,78,36,54,90
57,8479407,Jesper Bratt,L,NJD,26,74,27,63,90
57,8480801,Brady Tkachuk,L,OTT,25,81,39,50,89
57,8471675,Sidney Crosby,C,PIT,37,75,41,47,88
57,8477402,Pavel Buchnevich,L,STL,29,77,34,54,88
57,8476454,Ryan Nugent-Hopkins,C,EDM,31,80,33,55,88
57,8476459,Mika Zibanejad,C,NYR,31,79,26,62,88
57,8481557,Matt Boldy,L,MIN,23,75,34,53,87
57,8477960,Adrian Kempe,R,LAK,28,81,32,55,87
57,8480800,Quinn Hughes,D,VAN,25,69,14,73,87
57,8480002,Nico Hischier,C,NJD,25,72,32,54,86
57,8478398,Kyle Connor,L,WPG,28,72,40,45,85
57,8478427,Sebastian Aho,C,CAR,27,73,36,49,85
57,8482116,Tim Stützle,C,OTT,22,81,22,63,85
57,8477501,Valeri Nichushkin,R,COL,29,81,46,38,84
57,8478414,Timo Meier,R,NJD,28,76,43,41,84
57,8479337,Alex DeBrincat,R,DET,27,81,36,48,84
57,8479542,Brandon Hagel,L,TBL,26,81,36,48,84
57,8478445,Mathew Barzal,C,NYI,27,81,21,63,84
57,8474600,Roman Josi,D,NSH,34,73,19,65,84
57,8478460,Zach Werenski,D,CBJ,27,81,24,59,83
57,8471685,Anze Kopitar,C,LAK,37,78,29,52,81
57,8476456,Jonathan Huberdeau,C,CGY,31,77,29,52,81
57,8479420,Tage Thompson,C,BUF,27,76,36,44,80
57,8475786,Zach Hyman,L,EDM,32,77,45,33,78
57,8476887,Filip Forsberg,L,NSH,30,69,36,42,78
57,8475166,John Tavares,C,TOR,34,78,33,45,78
57,8478493,Joel Eriksson Ek,C,MIN,27,76,38,38,76
57,8475765,Vladimir Tarasenko,R,DET,33,76,33,43,76
57,8480012,Elias Pettersson,C,VAN,26,73,32,44,76
57,8477940,Nikolaj Ehlers,L,WPG,28,72,32,44,76
57,8480069,Cale Makar,D,COL,26,69,26,50,76
57,8480830,Andrei Svechnikov,R,CAR,24,67,23,53,76
57,8476389,Vincent Trocheck,C,NYR,31,78,31,44,75
57,8480036,Miro Heiskanen,D,DAL,25,78,18,57,75
57,8480865,Noah Dobson,D,NYI,24,79,13,62,75
57,8475184,Chris Kreider,L,NYR,33,79,45,29,74
57,8475168,Matt Duchene,C,DAL,33,82,30,44,74
57,8475913,Mark Stone,R,VGK,32,77,23,51,74
57,8477500,Bo Horvat,C,NYI,29,80,36,36,72
57,8478439,Travis Konecny,R,PHI,27,77,30,42,72
57,8473419,Brad Marchand,L,BOS,36,81,24,48,72
57,8475754,Brock Nelson,C,NYI,33,80,37,34,71
57,8478403,Jack Eichel,C,VGK,28,74,27,44,71
57,8482078,Lucas Raymond,L,DET,22,78,23,48,71
57,8480018,Nick Suzuki,C,MTL,25,76,29,41,70
57,8480839,Rasmus Dahlin,D,BUF,24,72,18,52,70
57,8475169,Evander Kane,L,EDM,33,74,37,32,69
57,8480015,Owen Tippett,R,PHI,25,77,30,39,69
57,8471214,Alex Ovechkin,L,WSH,39,74,29,40,69
57,8484144,Connor Bedard,C,CHI,19,69,25,44,69
57,8476346,Johnny Gaudreau,L,CBJ,31,70,22,46,68
57,8478444,Brock Boeser,R,VAN,27,76,39,28,67
57,8476881,Tomas Hertl,C,VGK,31,74,37,30,67
57,8477496,Elias Lindholm,C,BOS,30,79,29,38,67
57,8473994,Jamie Benn,L,DAL,35,79,24,43,67
57,8479999,Casey Mittelstadt,C,COL,26,79,21,45,66
57,8480803,Evan Bouchard,D,EDM,25,72,14,52,66
57,8479325,Charlie McAvoy,D,BOS,27,80,5,61,66
57,8482740,Wyatt Johnston,C,DAL,21,82,30,35,65
57,8478047,Michael Bunting,L,PIT,29,76,27,38,65
57,8477951,Nick Schmaltz,C,UTA,28,78,24,41,65
57,8478401,Pavel Zacha,C,BOS,27,79,24,41,65
57,8477986,Brandon Montour,D,SEA,30,74,22,43,65
57,8478975,Mason Marchment,L,DAL,29,81,20,45,65
57,8476448,William Karlsson,C,VGK,31,78,34,30,64
57,8474141,Patrick Kane,R,DET,36,80,26,38,64
57,8475798,Mikael Granlund,C,SJS,32,68,18,46,64
57,8481540,Cole Caufield,R,MTL,23,78,28,35,63
57,8475784,Jeff Skinner,C,EDM,32,75,26,37,63
57,8479385,Jordan Kyrou,C,STL,26,70,25,38,63
57,8473512,Claude Giroux,R,OTT,36,77,25,38,63
57,8475745,Charlie Coyle,C,BOS,32,78,22,41,63
57,8477949,Alex Tuch,R,BUF,28,70,18,45,63
57,8476539,Jonathan Marchessault,R,NSH,34,74,32,30,62
57,8471215,Evgeni Malkin,C,PIT,38,69,28,34,62
57,8481596,Shane Pinto,C,OTT,24,77,23,39,62
57,8475167,Victor Hedman,D,TBL,34,77,15,47,62
57,8478873,Troy Terry,R,ANA,27,71,23,38,61
57,8477955,Jared McCann,L,SEA,28,74,21,40,61
57,8480208,Drake Batherson,R,OTT,26,80,20,41,61
57,8477504,Josh Morrissey,D,WPG,29,75,17,44,61
57,8481528,Dylan Cozens,C,BUF,23,74,28,32,60
57,8474150,Mikael Backlund,C,CGY,35,77,26,34,60
57,8476853,Morgan Rielly,D,TOR,30,69,4,56,60
57,8474565,Alex Pietrangelo,D,VGK,34,67,15,44,59
57,8479323,Adam Fox,D,NYR,26,74,13,46,59
57,8475692,Mats Zuccarello,R,MIN,37,73,15,43,58
57,8476432,Boone Jenner,C,CBJ,31,67,39,18,57
57,8477497,Sean Monahan,C,CBJ,30,68,20,37,57
57,8474590,John Carlson,D,WSH,34,64,11,46,57
57,8478407,Vince Dunn,D,SEA,28,74,11,46,57
57,8482684,Luke Hughes,D,NJD,21,72,7,50,57
57,8478449,Roope Hintz,C,DAL,28,81,34,22,56
57,8475810,Bryan Rust,R,PIT,32,67,27,29,56
57,8474578,Erik Karlsson,D,PIT,34,74,15,41,56
57,8476399,Blake Coleman,C,CGY,33,74,30,25,55
57,8482665,Matty Beniers,C,SEA,22,72,26,29,55
57,8481068,Yegor Sharangovich,C,CGY,26,77,25,30,55
57,8478519,Anthony Cirelli,C,TBL,27,82,24,31,55
57,8478440,Dylan Strome,C,WSH,27,73,20,35,55
57,8482475,Yegor Chinakhov,R,CBJ,23,66,12,43,55
57,8478397,Rasmus Andersson,D,CGY,28,71,11,44,55
57,8478474,Lawson Crouse,L,UTA,27,78,28,26,54
57,8477407,Anthony Duclair,L,NYI,29,80,28,26,54
57,8482699,Dylan Guenther,R,UTA,21,77,26,28,54
57,8482109,Alexis Lafrenière,L,NYR,23,75,26,28,54
57,8480188,Fabian Zetterlund,L,SJS,25,63,24,30,54
57,8480039,Martin Necas,C,CAR,25,72,22,32,54
57,8477416,Oliver Bjorkstrand,R,SEA,29,77,22,32,54
57,8477511,Anthony Mantha,R,CGY,30,79,22,32,54
57,8477998,Warren Foegele,L,LAK,28,81,21,33,54
57,8477346,MacKenzie Weegar,D,CGY,30,77,10,44,54
57,8480064,Josh Norris,C,OTT,25,78,33,20,53
57,8479425,Filip Hronek,D,VAN,27,73,12,41,53
57,8476479,Phillip Danault,C,LAK,31,80,20,32,52
57,8479339,Patrik Laine,L,CBJ,26,71,18,34,52
57,8476882,Teuvo Teravainen,C,CHI,30,71,15,37,52
57,8476875,Mike Matheson,D,MTL,30,77,13,39,52
57,8479410,Mikhail Sergachev,D,UTA,26,67,9,43,52
57,8474102,David Perron,L,OTT,36,80,22,29,51
57,8484166,Adam Fantilli,C,CBJ,20,68,22,29,51
57,8471724,Kris Letang,D,PIT,37,81,16,35,51
57,8476906,Shayne Gostisbehere,D,CAR,31,78,13,38,51
57,8481542,Moritz Seider,D,DET,23,78,7,44,51
57,8481533,Trevor Zegras,C,ANA,23,70,25,25,50
57,8483808,Andrei Kuzmenko,L,CGY,28,75,23,27,50
57,8475151,Kyle Palmieri,C,NYI,33,78,22,28,50
57,8478462,Nicolas Roy,C,VGK,27,77,19,31,50
57,8478366,Frank Vatrano,R,ANA,30,72,28,21,49
57,8479365,Trent Frederic,C,BOS,26,79,21,28,49
57,8484153,Leo Carlsson,C,ANA,20,70,18,31,49
57,8478042,Viktor Arvidsson,L,EDM,31,76,18,31,49
57,8477456,J.T. Compher,L,DET,29,82,16,33,49
57,8480145,Neal Pionk,D,WPG,29,78,9,40,49
57,8475726,Tyler Toffoli,C,SJS,32,68,28,20,48
57,8482093,Seth Jarvis,C,CAR,22,70,26,22,48
57,8482113,Anton Lundell,C,FLA,23,74,23,25,48
57,8483431,Logan Cooley,C,UTA,20,75,20,28,48
57,8474679,Gustav Nyquist,C,NSH,35,74,20,28,48
57,8475760,Nick Bjugstad,C,UTA,32,67,19,29,48
57,8477964,Ivan Barbashev,C,VGK,29,75,18,30,48
57,8475158,Ryan O'Reilly,C,NSH,33,73,16,32,48
57,8477503,Max Domi,C,TOR,29,79,12,36,48
57,8478038,Devon Toews,D,COL,30,66,8,40,48
57,8481560,Arthur Kaliyev,R,LAK,23,79,25,22,47
57,8479525,Ross Colton,C,COL,28,81,24,23,47
57,8471698,T.J. Oshie,R,WSH,38,65,23,24,47
57,8482149,Cole Perfetti,C,WPG,22,71,22,25,47
57,8482110,Dawson Mercer,C,NJD,23,73,22,25,47
57,8475170,Brayden Schenn,C,STL,33,73,19,28,47
57,8478542,Evan Rodrigues,C,FLA,31,77,17,30,47
57,8475200,Dmitry Orlov,D,CAR,33,74,14,33,47
57,8480028,Morgan Frost,C,PHI,25,72,12,35,47
57,8476854,Hampus Lindholm,D,BOS,30,71,10,37,47
57,8478469,Thomas Chabot,D,OTT,27,76,8,39,47
57,8480014,Gabriel Vilardi,C,WPG,25,66,30,16,46
57,8478498,Jake DeBrusk,L,VAN,28,67,27,19,46
57,8475191,Reilly Smith,R,NYR,33,73,23,23,46
57,8474586,Jordan Eberle,R,SEA,34,70,19,27,46
57,8480009,Eeli Tolvanen,R,SEA,25,74,19,27,46
57,8477444,Andre Burakovsky,L,SEA,29,70,15,31,46
57,8478396,Noah Hanifin,D,VGK,27,66,11,35,46
57,8476792,Torey Krug,D,STL,33,72,8,38,46
57,8476438,Brandon Saad,L,STL,32,72,24,21,45
57,8480798,Philipp Kurashev,C,CHI,25,63,14,31,45
57,8482660,Kent Johnson,C,CBJ,22,63,12,33,45
57,8476905,Chandler Stephenson,C,SEA,30,69,11,34,45
57,8477495,Seth Jones,D,CHI,30,72,8,37,45
57,8470613,Brent Burns,D,CAR,39,79,3,42,45
57,8476880,Tom Wilson,R,WSH,30,72,23,21,44
57,8482159,Tyson Foerster,R,PHI,22,79,22,22,44
57,8475768,Jaden Schwartz,C,SEA,32,72,20,24,44
57,8476826,Yanni Gourde,C,SEA,33,75,20,24,44
57,8475149,Marcus Johansson,L,MIN,34,70,20,24,44
57,8482097,Jack Quinn,R,BUF,23,66,19,25,44
57,8473986,Alex Killorn,L,ANA,35,75,18,26,44
57,8475794,Tyler Seguin,C,DAL,32,81,18,26,44
57,8476292,Ondrej Palat,L,NJD,33,71,14,30,44
57,8476462,Dougie Hamilton,D,NJD,31,71,12,32,44
57,8475799,Nino Niederreiter,R,WPG,32,75,27,16,43
57,8477476,Artturi Lehkonen,L,COL,29,76,22,21,43
57,8479992,Michael Rasmussen,C,DET,25,79,18,25,43
57,8477932,Aaron Ekblad,D,FLA,28,74,15,28,43
57,8476869,Brady Skjei,D,NSH,30,79,11,32,43
57,8477426,Nicholas Paul,L,TBL,29,81,24,18,42
57,8478046,Danton Heinen,L,VAN,29,69,20,22,42
57,8473422,Nick Foligno,L,CHI,37,63,19,23,42
57,8480113,Alex Iafallo,L,WPG,31,67,19,23,42
57,8480185,Eetu Luostarinen,C,FLA,26,76,17,25,42
57,8483515,Juraj Slafkovsky,L,MTL,20,76,14,28,42
57,8475287,Erik Haula,L,NJD,33,73,13,29,42
57,8477498,Darnell Nurse,D,EDM,29,72,9,33,42
57,8482702,Logan Stankoven,C,DAL,21,79,21,20,41
57,8482705,Cole Sillinger,C,CBJ,21,73,21,20,41
57,8477451,Ryan Hartman,R,MIN,30,70,18,23,41
57,8480797,Joel Farabee,L,PHI,24,74,17,24,41
57,8481711,Matias Maccelli,L,UTA,24,79,15,26,41
57,8482745,Mason McTavish,C,ANA,21,77,13,28,41
57,8477494,Jonathan Drouin,L,COL,29,81,13,28,41
57,8480220,Noah Cates,L,PHI,25,74,21,19,40
57,8477429,Andrew Copp,C,DET,30,82,18,22,40
57,8479591,Michael Eyssimont,C,TBL,28,82,17,23,40
57,8479400,Pierre-Luc Dubois,L,WSH,26,70,14,26,40
57,8481581,Thomas Harley,D,DAL,23,75,14,26,40
57,8475753,Justin Faulk,D,STL,32,67,9,31,40
57,8478057,Dakota Joshua,C,VAN,28,73,18,21,39
57,8476872,Scott Laughton,C,PHI,30,73,13,26,39
57,8476483,Rickard Rakell,R,PIT,31,70,12,27,39
57,8477021,Alex Kerfoot,C,UTA,30,75,10,29,39
57,8474563,Drew Doughty,D,LAK,35,68,8,31,39
57,8476958,Jaccob Slavin,D,CAR,30,73,3,36,39
57,8478472,Mathieu Joseph,R,STL,27,70,18,20,38
57,8470621,Corey Perry,R,EDM,39,70,18,20,38
57,8477935,Sam Bennett,C,FLA,28,74,15,23,38
57,8474149,Evgenii Dadonov,R,DAL,35,82,15,23,38
57,8478055,Gustav Forsling,D,FLA,28,75,11,27,38
57,8476925,Colton Sissons,C,NSH,31,66,19,18,37
57,8478020,Michael Amadio,R,OTT,28,73,17,20,37
57,8478432,Christian Fischer,R,DET,27,73,17,20,37
57,8475793,Ryan Johansen,C,PHI,32,74,16,21,37
57,8482667,William Eklund,L,SJS,22,64,16,21,37
57,8478466,Daniel Sprong,R,VAN,27,71,15,22,37
57,8481618,Alex Newhook,C,MTL,23,75,14,23,37
57,8476392,Adam Lowry,C,WPG,31,63,14,23,37
57,8482124,Quinton Byfield,R,LAK,22,80,13,24,37
57,8481703,Valtteri Puustinen,R,PIT,25,59,9,28,37
57,8482655,Janis Moser,D,TBL,24,74,9,28,37
57,8475714,Calle Jarnkrok,C,TOR,33,76,20,16,36
57,8481604,Pavel Dorofeyev,L,VGK,24,76,19,17,36
57,8482092,Ridly Greig,C,OTT,22,71,17,19,36
57,8482720,Matthew Knies,L,TOR,22,76,16,20,36
57,8481524,Bowen Byram,D,BUF,23,70,13,23,36
57,8478970,Jalen Chatfield,D,CAR,28,73,13,23,36
57,8482133,Thomas Bordeleau,C,SJS,22,71,12,24,36
57,8474053,Logan Couture,C,SJS,35,68,11,25,36
57,8478438,Tommy Novak,C,NSH,27,68,10,26,36
57,8476923,Damon Severson,D,CBJ,30,78,9,27,36
57,8475764,Cam Fowler,D,ANA,33,71,6,30,36
57,8482055,Drew O'Connor,L,PIT,26,65,25,10,35
57,8479987,Morgan Geekie,C,BOS,26,77,18,17,35
57,8477839,Conor Sheary,L,TBL,32,81,17,18,35
57,8475193,Tomas Tatar,L,NJD,34,70,17,18,35
57,8481577,Philip Tomasino,C,NSH,23,65,14,21,35
57,8476458,Ryan Strome,C,ANA,31,73,13,22,35
57,8474716,Jared Spurgeon,D,MIN,35,73,10,25,35
57,8479345,Jakob Chychrun,D,WSH,26,69,8,27,35
57,8482125,Alexander Holtz,R,VGK,22,71,19,15,34
57,8481624,Ilya Mikheyev,R,CHI,30,60,18,16,34
57,8476981,Josh Anderson,R,MTL,30,69,18,16,34
57,8474715,Cameron Atkinson,R,TBL,35,82,18,16,34
57,8478233,Andrew Mangiapane,L,WSH,28,71,15,19,34
57,8478856,Conor Garland,R,VAN,28,68,14,20,34
57,8477479,Tyler Bertuzzi,L,CHI,29,62,14,20,34
57,8478458,John (Jack) Roslovic,C,CAR,27,62,14,20,34
57,8476419,Jean-Gabriel Pageau,C,NYI,32,80,14,20,34
57,8477947,Sonny Milano,L,WSH,28,63,14,20,34
57,8483505,Matthew Poitras,C,BOS,20,79,10,24,34
57,8480817,K'Andre Miller,D,NYR,24,72,8,26,34
57,8477447,Shea Theodore,D,VGK,29,66,7,27,34
57,8479351,Sam Steel,C,DAL,26,76,7,27,34
57,8480246,Nick Perbix,D,TBL,26,76,7,27,34
57,8482122,Brock Faber,D,MIN,22,78,4,30,34
57,8480434,Sean Durzi,D,UTA,26,69,4,30,34
57,8477969,Marcus Pettersson,D,PIT,28,80,4,30,34
57,8482089,Jake Neighbours,L,STL,22,63,19,14,33
57,8484203,Bradly Nadeau,L,CAR,19,58,13,20,33
57,8482111,Justin Barron,D,MTL,23,65,12,21,33
57,8480871,Adam Boqvist,D,FLA,24,70,11,22,33
57,8475171,Oliver Ekman-Larsson,D,TOR,33,64,10,23,33
57,8475218,Mattias Ekholm,D,EDM,34,78,9,24,33
57,8479293,Brandon Tanev,L,SEA,33,62,14,18,32
57,8476927,Teddy Blueger,C,VAN,30,68,12,20,32
57,8484145,Zach Benson,L,BUF,19,69,11,21,32
57,8482105,Jake Sanderson,D,OTT,22,72,11,21,32
57,8480813,Joe Veleno,C,DET,24,77,10,22,32
57,8478882,Vladislav Gavrikov,D,LAK,29,69,7,25,32
57,8478500,Ivan Provorov,D,CBJ,27,80,2,30,32
57,8478115,Pierre Engvall,L,NYI,28,79,15,16,31
57,8481553,Bobby Brink,R,PHI,23,66,14,17,31
57,8481523,Kirby Dach,C,MTL,23,65,13,18,31
57,8480855,Jack McBain,C,UTA,24,68,13,18,31
57,8480802,Ryan McLeod,C,BUF,25,60,12,19,31
57,8480336,Sean Walker,D,CAR,30,70,11,20,31
57,8478133,Jake Evans,C,MTL,28,73,9,22,31
57,8475763,Kevin Hayes,R,PIT,32,62,8,23,31
57,8481546,Cam York,D,PHI,23,70,7,24,31
57,8479661,Tanner Jeannot,L,LAK,27,77,17,13,30
57,8481582,Nicholas Robertson,L,TOR,23,61,14,16,30
57,8481704,Juuso Parssinen,C,NSH,23,54,14,16,30
57,8482146,Luke Evangelista,R,NSH,22,68,13,17,30
57,8480829,Jesperi Kotkaniemi,C,CAR,24,61,9,21,30
57,8476979,Erik Gustafsson,D,DET,32,70,7,23,30
57,8476902,Esa Lindell,D,DAL,30,75,5,25,30
57,8478507,John Marino,D,UTA,27,64,4,26,30
57,8476892,Colton Parayko,D,STL,31,70,3,27,30
57,8480893,Kirill Marchenko,R,CBJ,24,62,22,7,29
57,8477425,Miles Wood,L,COL,29,74,18,11,29
57,8477953,Kasperi Kapanen,R,STL,28,70,16,13,29
57,8481186,Logan O'Connor,R,COL,28,79,16,13,29
57,8478508,Yakov Trenin,C,MIN,27,56,16,13,29
57,8475722,Jason Zucker,L,BUF,32,66,15,14,29
57,8480144,David Kampf,C,TOR,29,70,15,14,29
57,8479368,Max Jones,L,BOS,26,67,13,16,29
57,8477987,Ryan Donato,C,CHI,28,62,12,17,29
57,8477989,Christian Dvorak,C,MTL,28,63,8,21,29
57,8476463,Jonas Brodin,D,MIN,31,77,8,21,29
57,8477505,Alexander Wennberg,C,SJS,30,61,8,21,29
57,8477948,Travis Sanheim,D,PHI,28,68,5,24,29
57,8480891,Michael Kesselring,D,UTA,24,58,4,25,29
57,8474151,Ryan McDonagh,D,TBL,35,74,3,26,29
57,8475314,Anders Lee,L,NYI,34,75,16,12,28
57,8474641,Adam Henrique,C,EDM,34,75,15,13,28
57,8477353,Tyler Motte,C,DET,29,76,13,15,28
57,8482671,Owen Power,D,BUF,22,57,9,19,28
57,8483490,Pavel Mintyukov,D,ANA,21,72,9,19,28
57,8475848,Brendan Gallagher,R,MTL,32,68,9,19,28
57,8482712,Oskar Olausson,R,COL,22,79,8,20,28
57,8477506,Ryan Pulock,D,NYI,30,77,7,21,28
57,8480878,Nils Lundkvist,D,DAL,24,68,5,23,28
57,8476461,Sean Couturier,C,PHI,32,69,4,24,28
57,8480873,Rasmus Sandin,D,WSH,24,64,4,24,28
57,8474574,Tyler Myers,D,VAN,34,66,4,24,28
57,8475181,Nick Leddy,D,STL,33,66,3,25,28
57,8482175,JJ Peterka,R,BUF,22,68,16,11,27
57,8478109,Victor Olofsson,L,VGK,29,67,15,12,27
57,8480459,Pius Suter,C,VAN,28,69,14,13,27
57,8473533,Jordan Staal,C,CAR,36,68,14,13,27
57,8482809,Jackson Blake,R,CAR,21,63,13,14,27
57,8482101,Danil Gushchin,L,SJS,22,54,12,15,27
57,8481535,Nils Hoglander,L,VAN,24,68,11,16,27
57,8480078,Filip Chytil,C,NYR,25,69,11,16,27
57,8482157,Will Cuylle,L,NYR,22,60,11,16,27
57,8479315,Joey Anderson,R,CHI,26,52,10,17,27
57,8479996,Cody Glass,C,NSH,25,54,7,20,27
57,8477488,Brett Pesce,D,NJD,30,72,4,23,27
57,8481606,Jordan Spence,D,LAK,23,69,4,23,27
57,8476331,Dylan DeMelo,D,WPG,31,65,3,24,27
57,8476917,Adam Pelech,D,NYI,30,78,2,25,27
57,8480849,Barrett Hayton,C,UTA,24,70,14,12,26
57,8476374,Sean Kuraly,C,CBJ,31,54,14,12,26
57,8483524,Shane Wright,C,SEA,20,59,14,12,26
57,8476921,Jordan Martinook,L,CAR,32,58,14,12,26
57,8475343,Nic Dowd,C,WSH,34,59,13,13,26
57,8476878,Zemgus Girgensons,C,TBL,30,81,13,13,26
57,8475855,Jesper Fast,R,CAR,33,62,12,14,26
57,8474189,Lars Eller,C,PIT,35,74,10,16,26
57,8482117,Lukas Reichel,L,CHI,22,53,10,16,26
57,8478891,Mason Appleton,C,WPG,28,67,9,17,26
57,8479353,Brett Howden,C,VGK,26,61,7,19,26
57,8479398,Samuel Girard,D,COL,26,72,4,22,26
57,8479619,Michael Carcone,L,UTA,28,58,15,10,25
57,8476897,Oskar Sundqvist,C,STL,30,67,11,14,25
57,8480003,Jesper Boqvist,C,FLA,26,68,11,14,25
57,8480172,Jan Rutta,D,SJS,34,63,7,18,25
57,8476480,Vladislav Namestnikov,C,WPG,32,71,6,19,25
57,8478136,Jake Middleton,D,MIN,28,80,3,22,25
57,8479336,Carl Grundstrom,R,SJS,27,56,13,11,24
57,8476474,Stefan Noesen,R,NJD,31,68,12,12,24
57,8481656,Aliaksei Protas,C,WSH,23,65,10,14,24
57,8481093,Rafael Harvey-Pinard,L,MTL,25,66,10,14,24
57,8480068,Ryan Poehling,C,PHI,25,63,9,15,24
57,8475220,Marcus Foligno,L,MIN,33,54,5,19,24
57,8482087,Kaiden Guhle,D,MTL,22,70,4,20,24
57,8473453,Trevor Lewis,C,LAK,37,76,14,9,23
57,8479393,Noah Gregor,L,OTT,26,76,13,10,23
57,8477952,Robby Fabbri,C,ANA,28,60,12,11,23
57,8480835,Jack Drury,C,CAR,24,58,11,12,23
57,8475231,Casey Cizikas,C,NYI,33,74,11,12,23
57,8476278,Colin Blackwell,C,DAL,31,79,10,13,23
57,8482624,Daniil Miromanov,D,CGY,27,64,7,16,23
57,8478413,Jordan Greenway,L,BUF,27,70,7,16,23
57,8480043,Timothy Liljegren,D,TOR,25,68,6,17,23
57,8477507,Nikita Zadorov,D,BOS,29,70,6,17,23
57,8479982,Conor Timmins,D,TOR,26,58,6,17,23
57,8478211,Dryden Hunt,L,CGY,29,60,6,17,23
57,8479983,Mario Ferraro,D,SJS,26,71,5,18,23
57,8473507,Jeff Petry,D,DET,37,72,2,21,23
57,8476931,Jake McCabe,D,TOR,31,73,2,21,23
57,8479941,Justin Danforth,R,CBJ,31,54,13,9,22
57,8476960,Andreas Athanasiou,C,CHI,30,52,12,10,22
57,8477450,Jason Dickinson,C,CHI,29,59,10,12,22
57,8481032,Paul Cotter,C,NJD,25,60,10,12,22
57,8477979,Nicolas Aube-Kubel,R,BUF,28,60,9,13,22
57,8478434,Keegan Kolesar,R,VGK,27,68,9,13,22
57,8476422,Mike Reilly,D,NYI,31,76,9,13,22
57,8480748,Kiefer Sherwood,L,VAN,29,60,9,13,22
57,8482803,Olen Zellweger,D,ANA,21,69,8,14,22
57,8480980,Connor Dewar,C,TOR,25,65,7,15,22
57,8480762,Eric Robinson,L,CAR,29,61,7,15,22
57,8476885,Jacob Trouba,D,NYR,30,71,5,17,22
57,8482245,Artem Zub,D,OTT,29,66,5,17,22
57,8475188,Brayden McNabb,D,VGK,33,56,2,20,22
57,8483460,David Jiricek,D,CBJ,21,62,2,20,22
57,8477478,William Carrier,L,CAR,30,59,13,8,21
57,8475225,Craig Smith,C,CHI,35,59,13,8,21
57,8482749,Joshua Roy,R,MTL,21,58,12,9,21
57,8482074,Connor Zary,C,CGY,23,60,11,10,21
57,8478569,Noel Acciari,C,PIT,33,56,11,10,21
57,8484149,Gavin Brindley,C,CBJ,20,54,9,12,21
57,8475791,Taylor Hall,L,CHI,33,48,8,13,21
57,8476467,Jamie Oleksiak,D,SEA,32,66,7,14,21
57,8483445,Cutter Gauthier,L,ANA,20,57,6,15,21
57,8482067,Connor Mackey,D,NYR,28,62,6,15,21
57,8480222,Sebastian Aho,D,PIT,28,76,4,17,21
57,8483565,Nick Blankenburg,D,NSH,26,59,3,18,21
57,8476879,Cody Ceci,D,EDM,31,74,3,18,21
57,8479402,Jake Bean,D,CGY,26,69,3,18,21
57,8476312,Josh Manson,D,COL,33,60,2,19,21
57,8475690,Chris Tanev,D,TOR,35,61,1,20,21
57,8481580,Connor McMichael,C,WSH,23,64,13,7,20
57,8480021,Jack Studnicka,C,LAK,25,61,12,8,20
57,8482062,Cole Smith,L,NSH,29,64,9,11,20
57,8478463,Anthony Beauvillier,L,PIT,27,61,8,12,20
57,8473563,Nicklas Backstrom,C,WSH,37,57,7,13,20
57,8477015,Connor Brown,R,EDM,30,72,7,13,20
57,8481554,Kaapo Kakko,R,NYR,23,73,6,14,20
57,8482142,Jamie Drysdale,D,PHI,22,67,6,14,20
57,8476873,Mark Jankowski,C,NSH,30,54,6,14,20
57,8477220,Nate Schmidt,D,FLA,33,66,4,16,20
57,8476429,Scott Mayfield,D,NYI,32,76,2,18,20
57,8477845,Trevor van Riemsdyk,D,WSH,33,56,1,19,20
57,8479316,Luke Kunin,C,SJS,27,55,9,10,19
57,8477406,Mattias Janmark,C,EDM,32,64,9,10,19
57,8483468,Jiri Kulich,C,BUF,20,54,8,11,19
57,8479390,Taylor Raddysh,R,WSH,26,67,8,11,19
57,8482679,Matt Coronato,R,CGY,22,72,8,11,19
57,8479671,Mathieu Olivier,R,CBJ,27,50,8,11,19
57,8476918,Jimmy Vesey,L,NYR,31,69,7,12,19
57,8478452,Caleb Jones,D,LAK,27,58,5,14,19
57,8481441,Joe Snively,C,DET,28,66,4,15,19
57,8475790,Erik Gudbranson,D,CBJ,32,73,1,18,19
57,8476891,Matthew Grzelcyk,D,PIT,30,76,1,18,19
57,8481059,Scott Perunovich,D,STL,26,58,0,19,19
57,8476469,Joel Armia,R,MTL,31,63,14,4,18
57,8482155,Alex Laferriere,R,LAK,23,60,12,6,18
57,8479066,Ryan Lomberg,L,CGY,30,64,10,8,18
57,8479370,Tyson Jost,C,CAR,26,51,8,10,18
57,8481641,Joel Kiviranta,L,COL,28,70,7,11,18
57,8481481,Blake Lizotte,C,PIT,27,66,6,12,18
57,8477919,Frederick Gaudreau,C,MIN,31,58,6,12,18
57,8477508,Curtis Lazar,C,NJD,29,60,6,12,18
57,8477392,Hudson Fasching,R,NYI,29,64,6,12,18
57,8479980,Nicolas Hague,D,VGK,26,50,4,14,18
57,8479976,Juuso Valimaki,D,UTA,26,65,4,14,18
57,8477369,Carson Soucy,D,VAN,30,58,4,14,18
57,8475279,Ben Chiarot,D,DET,33,66,4,14,18
57,8476525,Colin Miller,D,WPG,32,58,3,15,18
57,8477018,Ben Hutton,D,VGK,31,50,3,15,18
57,8475462,Radko Gudas,D,ANA,34,68,2,16,18
57,8476967,Brett Kulak,D,EDM,30,62,1,17,18
57,8478416,Erik Cernak,D,TBL,27,73,0,18,18
57,8482784,Zach Dean,C,STL,21,39,12,5,17
57,8476329,Travis Boyd,C,MIN,31,58,11,6,17
57,8481716,Dmitri Voronkov,L,CBJ,24,49,10,7,17
57,8478013,Jake Walman,D,SJS,28,70,9,8,17
57,8480448,Parker Kelly,L,COL,25,78,8,9,17
57,8482148,Hendrix Lapierre,C,WSH,22,57,8,9,17
57,8482496,Nils Aman,C,VAN,24,32,8,9,17
57,8483457,Lane Hutson,D,MTL,20,61,7,10,17
57,8478043,Sam Lafferty,C,BUF,29,62,7,10,17
57,8476624,Barclay Goodrow,C,SJS,31,44,7,10,17
57,8482737,Zack Bolduc,C,STL,21,58,6,11,17
57,8481521,Ronnie Attard,D,PHI,25,56,6,11,17
57,8480289,Morgan Barron,C,WPG,26,50,6,11,17
57,8476473,Connor Murphy,D,CHI,31,39,5,12,17
57,8477435,Ryan Graves,D,PIT,29,78,4,13,17
57,8483493,Frank Nazar,C,CHI,20,52,4,13,17
57,8479439,Jacob MacDonald,D,COL,31,51,4,13,17
57,8479026,Philippe Myers,D,TOR,27,54,4,13,17
57,8480058,Pierre-Olivier Joseph,D,STL,25,56,4,13,17
57,8480887,Jordan Harris,D,MTL,24,54,1,16,17
57,8480995,Pontus Holmberg,R,TOR,25,60,11,5,16
57,8477446,Michael McCarron,R,NSH,29,57,11,5,16
57,8480789,Oliver Wahlstrom,R,NYI,24,69,8,8,16
57,8481754,Nikita Nesterenko,C,ANA,23,42,8,8,16
57,8482079,Marco Rossi,C,MIN,23,53,7,9,16
57,8477499,Rasmus Ristolainen,D,PHI,30,55,7,9,16
57,8479344,Jesse Puljujarvi,R,PIT,26,49,7,9,16
57,8481477,Nico Sturm,C,SJS,29,59,7,9,16
57,8481592,Jakob Pelletier,L,CGY,23,38,7,9,16
57,8481601,Simon Holmstrom,R,NYI,23,68,6,10,16
57,8482176,Wyatt Kaiser,D,CHI,22,58,6,10,16
57,8480848,Ty Dellandrea,C,SJS,24,50,6,10,16
57,8478178,Darren Raddysh,D,TBL,28,66,4,12,16
57,8480157,Calle Rosen,D,COL,30,45,4,12,16
57,8480001,Urho Vaakanainen,D,ANA,25,64,4,12,16
57,8478851,Alexandre Carrier,D,NSH,28,61,3,13,16
57,8481014,Alexander Romanov,D,NYI,24,73,2,14,16
57,8479371,Dante Fabbro,D,NSH,26,61,2,14,16
57,8480860,Kevin Bahl,D,CGY,24,67,1,15,16
57,8480073,Erik Brannstrom,D,COL,25,64,0,16,16
57,8481028,Martin Pospisil,C,CGY,25,45,8,7,15
57,8480205,Emil Bemstrom,C,PIT,25,66,7,8,15
57,8478831,Kevin Stenlund,C,UTA,28,50,7,8,15
57,8483482,Tristan Luneau,D,ANA,20,63,6,9,15
57,8476442,Matt Nieto,L,PIT,32,47,6,9,15
57,8478585,Derek Ryan,C,EDM,38,62,6,9,15
57,8474673,TJ Brodie,D,CHI,34,61,5,10,15
57,8481522,Peyton Krebs,C,BUF,23,59,5,10,15
57,8481708,Zac Jones,D,NYR,24,47,5,10,15
57,8475455,Brenden Dillon,D,NJD,34,51,3,12,15
57,8479639,Dylan Coghlan,D,WPG,26,62,2,13,15
57,8480049,Dylan Samberg,D,WPG,25,59,2,13,15
57,8480035,Henri Jokiharju,D,BUF,25,52,1,14,15
57,8479998,Mikey Anderson,D,LAK,25,56,1,14,15
57,8476874,Olli Maatta,D,DET,30,55,1,14,15
57,8480806,Isac Lundestrom,C,ANA,25,57,7,7,14
57,8482166,Shakir Mukhamadullin,D,SJS,22,53,7,7,14
57,8477482,Zachary Sanford,L,CHI,30,43,7,7,14
57,8480441,Trey Fix-Wolansky,R,CBJ,25,31,6,8,14
57,8477903,Garnet Hathaway,R,PHI,33,65,5,9,14
57,8476856,Mathew Dumba,D,DAL,30,73,3,11,14
57,8481019,David Gustafsson,C,WPG,24,56,3,11,14
57,8479442,Troy Stecher,D,EDM,30,50,3,11,14
57,8482634,Alex Steeves,C,TOR,25,54,2,12,14
57,8480796,Martin Fehervary,D,WSH,25,56,2,12,14
57,8480727,Zach Whitecloud,D,VGK,28,48,1,13,14
57,8477365,Connor Clifton,D,BUF,29,62,1,13,14
57,8481167,Brayden Pachal,D,CGY,25,45,1,13,14
57,8479291,Kevin Rooney,C,CGY,31,52,8,5,13
57,8482095,Tyler Kleven,D,OTT,22,38,8,5,13
57,8479543,Michael Pezzetta,L,MTL,26,58,7,6,13
57,8477573,Nathan Walker,L,STL,30,57,7,6,13
57,8482192,Isaak Phillips,D,CHI,23,55,6,7,13
57,8481517,Brett Leason,R,ANA,25,59,6,7,13
57,8481599,Victor Soderstrom,D,UTA,23,45,6,7,13
57,8480011,Klim Kostin,C,SJS,25,48,5,8,13
57,8480292,Carson Meyer,R,ANA,27,39,5,8,13
57,8483491,Ivan Miroshnichenko,L,WSH,20,54,4,9,13
57,8479369,Andrew Peeke,D,BOS,26,54,4,9,13
57,8476457,Adam Larsson,D,SEA,32,61,3,10,13
57,8474567,Zach Bogosian,D,MIN,34,67,3,10,13
57,8475324,Nick Jensen,D,OTT,34,65,2,11,13
57,8481178,Egor Zamula,D,PHI,24,51,2,11,13
57,8481567,Henry Thrun,D,SJS,23,54,1,12,13
57,8480281,Alexey Toropchenko,R,STL,25,58,8,4,12
57,8478859,Niko Mikkola,D,FLA,28,50,8,4,12
57,8479520,Brandon Duhaime,R,WSH,27,49,8,4,12
57,8476994,Vinnie Hinostroza,C,NSH,30,54,8,4,12
57,8478911,Matt Roy,D,WSH,29,66,7,5,12
57,8482659,Josh Doan,R,UTA,22,55,6,6,12
57,8480025,MacKenzie Entwistle,R,FLA,25,62,6,6,12
57,8479328,Julien Gauthier,R,NYI,27,55,5,7,12
57,8482259,Bobby McMann,C,TOR,28,60,5,7,12
57,8479944,Zach Aston-Reese,C,VGK,30,50,5,7,12
57,8477380,Jonny Brodzinski,C,NYR,31,50,5,7,12
57,8482762,Simon Edvinsson,D,DET,21,57,5,7,12
57,8483499,Liam Ohgren,L,MIN,20,57,4,8,12
57,8480074,Alexandre Texier,C,STL,25,59,4,8,12
57,8479718,Alex Barré-Boulet,C,MTL,27,42,4,8,12
57,8480070,Ian Mitchell,D,BOS,25,56,4,8,12
57,8476889,Radek Faksa,C,STL,30,54,4,8,12
57,8484254,Akito Hirose,D,VAN,25,39,4,8,12
57,8476988,Matt Benning,D,SJS,30,63,3,9,12
57,8478468,Jeremy Lauzon,D,NSH,27,57,2,10,12
57,8474166,Alec Martinez,D,CHI,37,49,2,10,12
57,8482859,Zack Ostapchuk,C,OTT,21,44,2,10,12
57,8479324,Ryan Lindgren,D,NYR,26,64,1,11,12
57,8483466,Kevin Korchinski,D,CHI,20,52,1,11,12
57,8479638,Justin Brazeau,R,BOS,26,41,9,2,11
57,8482807,Ethan Del Mastro,D,CHI,21,45,8,3,11
57,8481518,Nolan Foote,L,NJD,24,43,7,4,11
57,8481013,Jonatan Berggren,R,DET,24,55,6,5,11
57,8481537,Nikita Okhotiuk,D,CGY,24,45,6,5,11
57,8476822,Luke Glendening,C,TBL,35,79,6,5,11
57,8476867,Brendan Gaunce,C,MIN,30,32,5,6,11
57,8478421,A.J. Greer,L,FLA,28,54,4,7,11
57,8481527,Kaedan Korczak,D,VGK,23,46,4,7,11
57,8483495,Simon Nemec,D,NJD,20,58,4,7,11
57,8478840,Will Borgen,D,SEA,28,67,2,9,11
57,8482451,Mikael Pyyhtia,L,CBJ,23,42,2,9,11
57,8480807,Mattias Samuelsson,D,BUF,24,54,1,10,11
57,8478454,Noah Juulsen,D,VAN,27,35,1,10,11
57,8476372,Nick Seeler,D,PHI,31,41,1,10,11
57,8475233,David Savard,D,MTL,34,63,0,11,11
57,8481568,Alex Vlasic,D,CHI,23,49,0,11,11
57,8475718,Justin Holl,D,DET,32,61,0,11,11
57,8481147,Reese Johnson,C,MIN,26,42,8,2,10
57,8476934,Brock McGinn,L,ANA,30,44,7,3,10
57,8482153,Brendan Brisson,C,VGK,23,38,6,4,10
57,8475842,Sam Carrick,C,NYR,32,56,5,5,10
57,8481617,Vasily Podkolzin,R,VAN,23,53,5,5,10
57,8479414,Nathan Bastian,R,NJD,27,58,5,5,10
57,8471817,Ryan Reaves,R,TOR,37,55,5,5,10
57,8481598,Philip Broberg,D,EDM,23,40,4,6,10
57,8482964,Arber Xhekaj,D,MTL,23,47,4,6,10
57,8475762,Derek Forbort,D,VAN,32,50,3,7,10
57,8480007,Jonas Rondbjerg,R,VGK,25,39,3,7,10
57,8482730,Brandt Clarke,D,LAK,21,48,2,8,10
57,8474034,Patrick Maroon,L,CHI,36,45,2,8,10
57,8479372,Joshua Mahura,D,SEA,26,55,2,8,10
57,8471677,Jack Johnson,D,CBJ,37,59,2,8,10
57,8479972,Mason Shaw,C,WPG,26,39,2,8,10
57,8482073,Braden Schneider,D,NYR,23,65,1,9,10
57,8475208,Brian Dumoulin,D,ANA,33,57,1,9,10
57,8477851,Jordan Oesterle,D,BOS,32,46,1,9,10
57,8478451,Ethan Bear,D,WSH,27,52,1,9,10
57,8470600,Ryan Suter,D,STL,39,69,0,10,10
57,8475750,Jon Merrill,D,MIN,32,55,0,10,10
57,8481161,Jake Christiansen,D,CBJ,25,59,5,4,9
57,8479772,Zack MacEwen,R,OTT,28,53,5,4,9
57,8482747,Brennan Othmann,L,NYR,21,38,4,5,9
57,8480252,Cole Guttman,C,CHI,25,34,4,5,9
57,8479994,Jaret Anderson-Dolan,C,WPG,25,33,4,5,9
57,8475235,Nicolas Deslauriers,L,PHI,33,48,4,5,9
57,8478409,Anthony Richard,C,PHI,28,24,4,5,9
57,8477931,Tomas Nosek,L,FLA,32,54,3,6,9
57,8480950,Ilya Lyubushkin,D,DAL,30,62,3,6,9
57,8477070,Liam O'Brien,C,UTA,30,54,3,6,9
57,8480990,Declan Chisholm,D,MIN,24,34,3,6,9
57,8475177,Calvin de Haan,D,COL,33,42,2,7,9
57,8479249,Andrew Poturalski,C,SJS,30,34,2,7,9
57,8478017,Mark Friedman,D,VAN,29,48,1,8,9
57,8473446,Erik Johnson,D,PHI,36,51,1,8,9
57,8480879,Jacob Bernard-Docker,D,OTT,24,50,0,9,9
57,8481789,Tye Kartye,L,SEA,23,39,7,1,8
57,8482666,Scott Morrow,D,CAR,22,45,6,2,8
57,8482141,Lukas Cormier,D,VGK,22,20,6,2,8
57,8477401,John Hayden,C,SEA,29,26,5,3,8
57,8476858,Phillip Di Giuseppe,L,VAN,31,44,4,4,8
57,8479359,Beck Malenstyn,L,BUF,26,41,4,4,8
57,8483570,Ben Meyers,C,SEA,26,32,4,4,8
57,8481751,Lukas Rousek,R,BUF,25,42,3,5,8
57,8479348,Kale Clague,D,BUF,26,47,3,5,8
57,8483012,Logan Morrison,C,SEA,22,41,3,5,8
57,8480834,Ty Emberson,D,SJS,24,39,3,5,8
57,8482744,James Malatesta,L,CBJ,21,38,2,6,8
57,8474090,Brendan Smith,D,DAL,35,52,2,6,8
57,8477887,Patrick Brown,C,BOS,32,45,2,6,8
57,8480355,Mark Kastelic,C,BOS,25,53,2,6,8
57,8482652,Walker Duehr,R,CGY,27,39,2,6,8
57,8482751,Ryan Winterton,C,SEA,21,35,2,6,8
57,8481609,Vladislav Kolyachonok,D,UTA,23,35,2,6,8
57,8483619,Filip Roos,D,OTT,25,38,2,6,8
57,8475179,Dmitry Kulikov,D,FLA,34,56,1,7,8
57,8481550,Adam Beckman,L,NJD,23,38,1,7,8
57,8471709,Marc-Edouard Vlasic,D,SJS,37,50,1,7,8
57,8481679,Maxence Guenette,D,OTT,23,34,5,2,7
57,8479986,Kole Lind,R,DAL,26,54,4,3,7
57,8482144,Jack Thompson,D,SJS,22,29,4,3,7
57,8478021,William Lagesson,D,DET,28,33,4,3,7
57,8477938,Haydn Fleury,D,WPG,28,54,3,4,7
57,8481701,Santeri Hatakka,D,NJD,23,41,3,4,7
57,8478424,Jansen Harkins,C,ANA,27,42,3,4,7
57,8476441,Joel Edmundson,D,LAK,31,43,3,4,7
57,8483763,Maksymilian Szuber,D,UTA,22,35,3,4,7
57,8483630,Pavol Regenda,L,ANA,25,29,3,4,7
57,8481600,Tobias Bjornfot,D,FLA,23,48,2,5,7
57,8483549,Lucas Condotta,L,MTL,27,36,2,5,7
57,8481056,Spencer Stastney,D,NSH,24,34,2,5,7
57,8474612,Travis Hamonic,D,OTT,34,52,2,5,7
57,8477384,Joshua Brown,D,EDM,30,40,1,6,7
57,8477034,Jaycob Megna,D,FLA,32,48,1,6,7
57,8477335,Kyle Burroughs,D,LAK,29,40,1,6,7
57,8474013,Ian Cole,D,UTA,35,47,0,7,7
57,8478502,Dennis Gilbert,D,BUF,28,21,0,7,7
57,8482077,Dylan Holloway,L,EDM,23,55,4,2,6
57,8481422,Jake Lucchini,C,NSH,29,20,4,2,6
57,8477962,Brendan Lemieux,L,CAR,28,41,3,3,6
57,8482177,Marat Khusnutdinov,C,MIN,22,37,3,3,6
57,8478399,Jonas Siegenthaler,D,NJD,27,55,2,4,6
57,8476952,Dominic Toninato,C,WPG,30,35,2,4,6
57,8479367,William Lockwood,R,FLA,26,35,2,4,6
57,8481122,Simon Benoit,D,TOR,26,39,1,5,6
57,8480192,Johnathan Kovacevic,D,NJD,27,57,1,5,6
57,8478443,Brandon Carlo,D,BOS,28,47,1,5,6
57,8475958,Michael Sgarbossa,C,WSH,32,19,1,5,6
57,8484911,Collin Graf,R,SJS,22,38,0,6,6
57,8482733,Logan Mailloux,D,MTL,31,42,0,6,6
57,8479378,Logan Stanley,D,WPG,26,41,0,6,6
57,8477149,Scott Sabourin,R,SJS,32,18,0,6,6
57,8479576,Vincent Desharnais,D,VAN,28,35,0,6,6
57,8482070,Mitchell Chaffee,R,TBL,26,39,3,2,5
57,8480196,Jacob Bryson,D,BUF,27,46,3,2,5
57,8481532,Alex Turcotte,C,LAK,23,47,2,3,5
57,8483397,Marc McLaughlin,C,BOS,25,31,2,3,5
57,8482172,Landon Slaggert,L,CHI,22,21,2,3,5
57,8482713,Mackie Samoskevich,R,FLA,22,44,1,4,5
57,8478450,Parker Wotherspoon,D,BOS,27,36,1,4,5
57,8479419,Brett Murray,L,BUF,26,17,1,4,5
57,8481605,Jackson LaCombe,D,ANA,23,28,1,4,5
57,8479587,Rhett Gardner,C,PHI,28,17,1,4,5
57,8477320,Anton Blidh,L,NYR,29,20,1,4,5
57,8482765,Isak Rosen,R,BUF,21,30,0,5,5
57,8480870,Bo Groulx,C,NYR,24,31,0,5,5
57,8477462,Robert Hagg,D,VGK,29,23,0,5,5
57,8482145,Mavrik Bourque,C,DAL,22,48,3,1,4
57,8477073,Kurtis MacDermid,L,NJD,30,29,3,1,4
57,8479536,Axel Jonsson-Fjallby,L,WPG,26,31,2,2,4
57,8484287,Cole McWard,D,VAN,23,19,2,2,4
57,8479985,Cale Fleury,D,SEA,26,27,2,2,4
57,8481543,Nikita Alexandrov,C,STL,24,27,2,2,4
57,8479320,Maxime Lajoie,D,SEA,27,22,2,2,4
57,8482165,Yan Kuznetsov,D,CGY,22,11,2,2,4
57,8480845,Rasmus Kupari,C,WPG,24,30,1,3,4
57,8482511,Mason Lohrei,D,BOS,23,32,1,3,4
57,8480844,Grigori Denisenko,L,VGK,24,25,1,3,4
57,8482147,Jean-Luc Foudy,C,COL,22,27,1,3,4
57,8482516,Matthew Kessel,D,STL,24,17,1,3,4
57,8484258,Sam Malinski,D,COL,26,23,0,4,4
57,8482201,Gage Goncalves,C,TBL,23,22,0,4,4
57,8479968,Vinni Lettieri,C,BOS,29,48,3,0,3
57,8479379,Givani Smith,R,SJS,26,27,3,0,3
57,8482460,Matt Rempe,C,NYR,22,15,2,1,3
57,8479330,Brandon Gignac,C,MTL,27,12,2,1,3
57,8481237,Kyle MacLean,C,NYI,25,21,2,1,3
57,8480468,James Hamblin,L,EDM,25,21,2,1,3
57,8479981,Jonah Gadjovich,L,FLA,26,35,1,2,3
57,8478874,Adam Gaudette,R,OTT,28,42,1,2,3
57,8477244,Chad Ruhwedel,D,NYR,34,28,1,2,3
57,8481006,Tyler Tucker,D,STL,24,17,1,2,3
57,8478477,Mitchell Stephens,C,SEA,27,23,1,2,3
57,8481541,Samuel Bolduc,D,NYI,24,25,1,2,3
57,8482250,Callahan Burke,C,VGK,27,20,1,2,3
57,8478146,Matthew Highmore,C,OTT,28,33,1,2,3
57,8481743,Marc Del Gaizo,D,NSH,25,24,1,2,3
57,8477971,Andreas Englund,D,LAK,28,31,1,2,3
57,8477810,Joel Hanley,D,CGY,33,21,1,2,3
57,8483489,Fraser Minten,C,TOR,31,14,1,2,3
57,8480880,Jakub Lauko,C,MIN,24,33,0,3,3
57,8480245,Olle Lycksell,R,PHI,25,32,0,3,3
57,8476913,Devin Shore,C,MIN,30,29,0,3,3
57,8482858,Ryker Evans,D,SEA,23,29,0,3,3
57,8482861,Vincent Iorio,D,WSH,22,35,0,3,3
57,8483395,Arshdeep Bains,L,VAN,23,10,2,0,2
57,8478881,Brett Seney,L,CHI,28,16,2,0,2
57,8479991,Jake Leschyshyn,C,NYR,25,27,1,1,2
57,8481585,Egor Afanasyev,L,SJS,23,10,1,1,2
57,8481806,Louis Crevier,D,CHI,23,12,1,1,2
57,8483567,Georgii Merkulov,C,BOS,24,8,1,1,2
57,8474568,Luke Schenn,D,NSH,35,44,0,2,2
57,8477527,Ross Johnston,L,ANA,30,31,0,2,2
57,8477467,Gustav Olofsson,D,SEA,30,17,0,2,2
57,8483512,Matthew Savoie,C,EDM,20,21,0,2,2
57,8477473,Justin Bailey,R,SJS,29,28,0,2,2
57,8481206,John Ludvig,D,PIT,24,7,0,2,2
57,8483432,Luca Del Bel Belluz,C,CBJ,31,4,0,2,2
57,8480267,Sammy Walker,C,MIN,25,16,1,0,1
57,8481556,John Beecher,C,BOS,23,33,1,0,1
57,8475780,Chris Wagner,R,COL,33,8,1,0,1
57,8478011,Louie Belpedio,D,PHI,28,13,1,0,1
57,8475413,Justin Dowling,C,NJD,34,7,1,0,1
57,8480084,Nick DeSimone,D,NJD,30,15,1,0,1
57,8478051,Max Willman,C,NJD,29,19,1,0,1
57,8484304,Uvis Balinskis,D,FLA,28,5,1,0,1
57,8480075,Cameron Crotty,D,MIN,25,12,1,0,1
57,8482088,Justin Sourdif,R,FLA,22,22,1,0,1
57,8481726,Adam Edstrom,C,NYR,24,6,1,0,1
57,8479362,Riley Tufte,L,BOS,26,12,1,0,1
57,8482162,Roby Jarventie,L,EDM,22,8,1,0,1
57,8484259,Ondrej Pavel,C,COL,31,4,1,0,1
57,8479522,Hardy Haman Aktell,D,WSH,26,6,1,0,1
57,8484326,Patrik Koch,D,UTA,28,7,1,0,1
57,8481030,Jack St. Ivany,D,PIT,25,11,0,1,1
57,8474062,Riley Nash,C,NYR,35,9,0,1,1
57,8481655,Cole Schwindt,R,CGY,23,6,0,1,1
57,8484325,Waltteri Merela,C,TBL,26,28,0,1,1
57,8482470,Ilya Solovyov,D,CGY,24,22,0,1,1
57,8475755,Alexander Petrovic,D,DAL,32,9,0,1,1
57,8482118,Sam Colangelo,R,ANA,23,16,0,1,1
57,8480306,Grant Hutton,D,NYI,29,8,0,1,1
57,8482476,Emil Heineman,L,MTL,23,6,0,1,1
57,8481024,Linus Karlsson,C,VAN,25,6,0,1,1
57,8480874,Adam Ginning,D,PHI,24,16,0,1,1
57,8479421,Jacob Moverare,D,LAK,26,10,0,1,1
57,8481719,Maxwell Crozier,D,TBL,24,16,0,1,1
57,8481578,Graeme Clarke,R,MIN,23,19,0,1,1
57,8482094,Daemon Hunt,D,MIN,22,16,0,1,1
57,8483471,Brad Lambert,C,WPG,31,10,0,1,1
57,8483407,Brandon Scanlin,D,NYR,25,9,0,1,1
57,8484321,Nikolas Matinpalo,D,OTT,26,1,0,1,1
57,8482126,Emil Andrae,D,PHI,31,4,0,1,1
57,8480890,Jan Jenik,C,OTT,24,22,0,0,0
57,8482929,Emil Lilleberg,D,TBL,23,29,0,0,0
57,8475795,Dylan McIlrath,D,WSH,32,13,0,0,0
57,8480823,Alexander Alexeyev,D,WSH,25,11,0,0,0
57,8481593,Jayden Struble,D,MTL,23,13,0,0,0
57,8481564,Ryan Johnson,D,BUF,23,11,0,0,0
57,8480851,Akil Thomas,C,LAK,24,11,0,0,0
57,8481699,Aku Raty,R,UTA,23,15,0,0,0
57,8481065,Angus Crookshank,L,OTT,25,16,0,0,0
57,8481043,Cole Koepke,L,BOS,26,15,0,0,0
57,8483398,Declan Carlile,D,TBL,31,7,0,0,0
57,8483920,Pierrick Dube,R,WSH,23,5,0,0,0
57,8478147,Bokondji Imama,L,PIT,28,3,0,0,0
57,8478446,Glenn Gawdin,C,LAK,27,11,0,0,0
57,8482102,Vasily Ponomarev,C,PIT,22,18,0,0,0
57,8483597,Milos Kelemen,L,UTA,25,11,0,0,0
57,8480032,Shane Bowers,C,NJD,25,15,0,0,0
57,8481462,Mason Morelli,L,VGK,28,14,0,0,0
57,8477993,Justin Kirkland,C,CGY,28,10,0,0,0
57,8477541,Dakota Mermis,D,TOR,30,3,0,0,0
57,8483546,Marshall Rifai,D,TOR,26,3,0,0,0
57,8478854,Ryan Shea,D,PIT,27,9,0,0,0
57,8482061,Brandon Biro,L,SEA,26,11,0,0,0
57,8476323,Max McCormick,L,SEA,32,3,0,0,0
57,8484255,Jason Polin,R,COL,25,5,0,0,0
57,8483531,Brian Halonen,L,NJD,25,3,0,0,0
57,8482787,Nikita Chibrikov,R,WPG,31,1,0,0,0
57,8482197,Adam Raska,R,MIN,23,8,0,0,0
57,8483401,Marc Johnstone,R,PIT,28,1,0,0,0
57,8481534,Raphael Lavoie,C,EDM,24,1,0,0,0
57,8483609,Adam Klapka,R,CGY,24,1,0,0,0
57,8480274,Philip Kemp,D,EDM,25,4,0,0,0
57,8470794,Joe Pavelski,C,,40,0,0,0,0
57,8479321,Lucas Johansen,D,,27,0,0,0,0
57,8477950,Tony DeAngelo,D,,29,0,0,0,0
57,8471218,Blake Wheeler,R,,38,0,0,0,0
57,8475197,Tyson Barrie,D,,33,0,0,0,0
57,8474157,Max Pacioretty,L,,36,0,0,0,0
57,8475744,Evgeny Kuznetsov,C,,32,0,0,0,0
57,8474037,James van Riemsdyk,L,,35,0,0,0,0
57,8476907,Mackenzie MacEachern,L,,30,0,0,0,0
57,8480216,Jacob Peterson,C,,25,0,0,0,0
57,8474602,Justin Schultz,D,,34,0,0,0,0
57,8482222,Alexander Barabanov,L,,30,0,0,0,0
57,8474031,Kevin Shattenkirk,D,,35,0,0,0,0
57,8477330,Dominik Kubalik,L,,29,0,0,0,0
57,8480884,Calen Addison,D,,24,0,0,0,0
57,8475906,John Klingberg,D,,32,0,0,0,0
57,8480008,Adam Ruzicka,C,,25,0,0,0,0
57,8476884,Derrick Pouliot,D,,30,0,0,0,0
57,8476919,Chris Tierney,C,,30,0,0,0,0
57,8479415,Michael McLeod,C,,26,0,0,0,0
57,8474870,Tyler Johnson,C,,34,0,0,0,0
57,8470604,Jeff Carter,C,,39,0,0,0,0
57,8478104,Sammy Blais,L,,28,0,0,0,0
57,8474884,Mike Hoffman,C,,35,0,0,0,0
57,8481591,Sam Poulin,R,,23,0,0,0,0
57,8471274,Alex Goligoski,D,,39,0,0,0,0
57,8476871,Tanner Pearson,L,,32,0,0,0,0
57,8476393,Nick Cousins,C,,31,0,0,0,0
57,8479977,Kailer Yamamoto,R,,26,0,0,0,0
57,8479346,Dillon Dube,C,,26,0,0,0,0
57,8480184,Gustav Lindstrom,D,,26,0,0,0,0
57,8479376,Victor Mete,D,,26,0,0,0,0
57,8473449,Kyle Okposo,R,,36,0,0,0,0
57,8481058,Jesse Ylonen,R,,25,0,0,0,0
57,8475752,Tyler Pitlick,C,,33,0,0,0,0
57,8481239,Samuel Fagemo,L,,24,0,0,0,0
57,8480821,Filip Zadina,R,,25,0,0,0,0
57,8470966,Mark Giordano,D,,41,0,0,0,0
57,8478495,Denis Gurianov,R,,27,0,0,0,0
57,8477464,Nic Petan,C,,29,0,0,0,0
57,8478099,Kevin Labanc,R,,29,0,0,0,0
57,8482241,Radim Zohorna,L,,28,0,0,0,0
57,8474040,Sam Gagner,C,,35,0,0,0,0
57,8479514,Rem Pitlick,C,,27,0,0,0,0
57,8478430,Oliver Kylington,D,,27,0,0,0,0
57,8479533,Joona Koppanen,L,,26,0,0,0,0
57,8479984,Cal Foote,D,,26,0,0,0,0
57,8477126,Jayson Megna,C,,34,0,0,0,0
57,8475164,Jakob Silfverberg,R,,34,0,0,0,0
57,8474009,Nick Bonino,C,,36,0,0,0,0
57,8479458,Nikita Zaitsev,D,,33,0,0,0,0
57,8477944,Jakub Vrana,L,,28,0,0,0,0
57,8471699,Andrew Cogliano,C,,37,0,0,0,0
57,8478067,Oskar Lindblom,L,,28,0,0,0,0
57,8471686,Marc Staal,D,,37,0,0,0,0
57,8470610,Zach Parise,L,,40,0,0,0,0
57,8478904,Steven Lorentz,C,,28,0,0,0,0
57,8473473,Milan Lucic,L,,36,0,0,0,0
57,8480031,Maxime Comtois,L,,25,0,0,0,0
57,8478512,Austin Czarnik,C,,32,0,0,0,0
57,8473504,Cal Clutterbuck,R,,37,0,0,0,0
57,8477454,Adam Erne,L,,29,0,0,0,0
57,8479383,Boris Katchouk,L,,26,0,0,0,0
57,8475825,Jani Hakanpää,D,,32,0,0,0,0
57,8477846,Ryan Carpenter,C,,33,0,0,0,0
57,8477930,Pierre-Edouard Bellemare,L,,39,0,0,0,0
57,8478400,Colin White,C,,27,0,0,0,0
57,8480226,Marián Studenic,R,,26,0,0,0,0
57,8480853,Liam Foudy,C,,24,0,0,0,0
57,8475797,Jarred Tinordi,D,,32,0,0,0,0
57,8479423,Alex Nylander,L,,26,0,0,0,0
57,8474618,Marco Scandella,D,,34,0,0,0,0
57,8478028,Fredrik Olofsson,L,,28,0,0,0,0
57,8474709,Matt Martin,L,,35,0,0,0,0
57,8481070,Hugh McGing,L,,26,0,0,0,0
57,8479546,Oskar Steen,C,,26,0,0,0,0
57,8474145,Robert Bortuzzo,D,,35,0,0,0,0
57,8476915,Jujhar Khaira,L,,30,0,0,0,0
57,8475278,Byron Froese,C,,33,0,0,0,0
57,8481812,Nikolai Knyzhov,D,,27,0,0,0,0
57,8478408,Travis Dermott,D,,28,0,0,0,0
57,8481077,John Leonard,L,,26,0,0,0,0
57,8479547,Matthew Phillips,R,,26,0,0,0,0
57,8480836,Jonathan Gruden,C,,24,0,0,0,0
57,8481690,Tyler Angle,C,,24,0,0,0,0
57,8475766,Austin Watson,L,,32,0,0,0,0
57,8481016,Ruslan Iskhakov,C,,24,0,0,0,0
57,8478078,Rourke Chartier,C,,28,0,0,0,0
57,8480776,Sheldon Rempal,R,,29,0,0,0,0
57,8478956,Samuel Laberge,L,NJD,27,1,0,0,0
57,8483045,Cameron Butler,R,CBJ,31,0,0,0,0
57,8484314,Jiri Smejkal,L,,28,0,0,0,0
58,8478402,Connor McDavid,C,EDM,27,79,50,99,149
58,8477492,Nathan MacKinnon,C,COL,29,82,51,88,139
58,8481559,Jack Hughes,C,NJD,23,75,57,81,138
58,8476453,Nikita Kucherov,R,TBL,31,82,40,98,138
58,8479314,Matthew Tkachuk,L,FLA,27,82,35,97,132
58,8477934,Leon Draisaitl,C,EDM,29,80,56,74,130
58,8479318,Auston Matthews,C,TOR,27,79,68,57,125
58,8478420,Mikko Rantanen,R,COL,28,81,52,68,120
58,8477404,Jake Guentzel,C,TBL,30,82,50,69,119
58,8478864,Kirill Kaprizov,L,MIN,27,71,51,60,111
58,8477956,David Pastrnak,R,BOS,28,82,45,66,111
58,8477946,Dylan Larkin,C,DET,28,81,56,52,108
58,8478439,Travis Konecny,R,PHI,27,77,36,67,103
58,8477933,Sam Reinhart,C,FLA,29,79,49,52,101
58,8475913,Mark Stone,R,VGK,32,79,31,70,101
58,8476468,J.T. Miller,C,VAN,31,79,33,66,99
58,8477493,Aleksander Barkov,C,FLA,29,80,26,73,99
58,8471675,Sidney Crosby,C,PIT,37,74,43,54,97
58,8481557,Matt Boldy,L,MIN,23,74,36,61,97
58,8478550,Artemi Panarin,L,NYR,33,77,31,65,96
58,8478445,Mathew Barzal,C,NYI,27,79,25,71,96
58,8477942,Kevin Fiala,L,LAK,28,81,36,59,95
58,8480002,Nico Hischier,C,NJD,25,76,37,56,93
58,8478010,Brayden Point,C,TBL,28,82,49,43,92
58,8478427,Sebastian Aho,C,CAR,27,75,37,54,91
58,8476887,Filip Forsberg,L,NSH,30,75,49,41,90
58,8478398,Kyle Connor,L,WPG,28,75,47,42,89
58,8480830,Andrei Svechnikov,R,CAR,24,74,40,48,88
58,8480801,Brady Tkachuk,L,OTT,25,78,38,50,88
58,8478483,Mitch Marner,R,TOR,27,78,25,62,87
58,8476539,Jonathan Marchessault,R,NSH,34,75,40,45,85
58,8475754,Brock Nelson,C,NYI,33,81,41,43,84
58,8477500,Bo Horvat,C,NYI,29,80,39,45,84
58,8479343,Clayton Keller,R,UTA,26,79,34,50,84
58,8479542,Brandon Hagel,L,TBL,26,82,30,54,84
58,8477939,William Nylander,R,TOR,28,80,40,43,83
58,8480027,Jason Robertson,L,DAL,25,82,30,53,83
58,8475166,John Tavares,C,TOR,34,80,37,45,82
58,8480069,Cale Makar,D,COL,26,68,25,57,82
58,8474600,Roman Josi,D,NSH,34,73,20,62,82
58,8479337,Alex DeBrincat,R,DET,27,82,33,48,81
58,8479407,Jesper Bratt,L,NJD,26,75,30,51,81
58,8473419,Brad Marchand,L,BOS,36,80,35,45,80
58,8475745,Charlie Coyle,C,BOS,32,77,31,49,80
58,8475692,Mats Zuccarello,R,MIN,37,75,26,52,78
58,8480800,Quinn Hughes,D,VAN,25,76,11,66,77
58,8478449,Roope Hintz,C,DAL,28,82,40,36,76
58,8482116,Tim Stützle,C,OTT,22,78,27,49,76
58,8477496,Elias Lindholm,C,BOS,30,75,33,42,75
58,8476881,Tomas Hertl,C,VGK,31,76,32,43,75
58,8476448,William Karlsson,C,VGK,31,80,32,43,75
58,8475784,Jeff Skinner,C,EDM,32,79,32,43,75
58,8480803,Evan Bouchard,D,EDM,25,77,16,59,75
58,8476389,Vincent Trocheck,C,NYR,31,78,34,40,74
58,8477504,Josh Morrissey,D,WPG,29,76,15,59,74
58,8480012,Elias Pettersson,C,VAN,26,74,29,44,73
58,8477409,Carter Verhaeghe,C,FLA,29,77,36,36,72
58,8471685,Anze Kopitar,C,LAK,37,82,25,47,72
58,8479323,Adam Fox,D,NYR,26,74,15,57,72
58,8482078,Lucas Raymond,L,DET,22,81,33,38,71
58,8477960,Adrian Kempe,R,LAK,28,81,32,39,71
58,8481068,Yegor Sharangovich,C,CGY,26,80,32,39,71
58,8478047,Michael Bunting,L,PIT,29,73,29,42,71
58,8482665,Matty Beniers,C,SEA,22,76,28,43,71
58,8484144,Connor Bedard,C,CHI,19,70,23,48,71
58,8479999,Casey Mittelstadt,C,COL,26,82,23,48,71
58,8480208,Drake Batherson,R,OTT,26,78,22,49,71
58,8476454,Ryan Nugent-Hopkins,C,EDM,31,79,17,54,71
58,8480036,Miro Heiskanen,D,DAL,25,76,11,60,71
58,8476905,Chandler Stephenson,C,SEA,30,76,25,45,70
58,8480023,Robert Thomas,C,STL,25,71,17,53,70
58,8475726,Tyler Toffoli,C,SJS,32,68,40,29,69
58,8478403,Jack Eichel,C,VGK,28,79,33,36,69
58,8477501,Valeri Nichushkin,R,COL,29,81,30,39,69
58,8471215,Evgeni Malkin,C,PIT,38,73,24,45,69
58,8476853,Morgan Rielly,D,TOR,30,72,9,60,69
58,8477955,Jared McCann,L,SEA,28,73,33,35,68
58,8479420,Tage Thompson,C,BUF,27,73,32,36,68
58,8477951,Nick Schmaltz,C,UTA,28,76,28,40,68
58,8478975,Mason Marchment,L,DAL,29,82,27,41,68
58,8477949,Alex Tuch,R,BUF,28,75,25,43,68
58,8475167,Victor Hedman,D,TBL,34,79,18,50,68
58,8476346,Johnny Gaudreau,L,CBJ,31,70,10,58,68
58,8476459,Mika Zibanejad,C,NYR,31,72,30,37,67
58,8474564,Steven Stamkos,C,NSH,34,71,25,42,67
58,8481540,Cole Caufield,R,MTL,23,74,36,30,66
58,8477940,Nikolaj Ehlers,L,WPG,28,74,29,37,66
58,8484153,Leo Carlsson,C,ANA,20,74,22,44,66
58,8479385,Jordan Kyrou,C,STL,26,75,26,39,65
58,8478460,Zach Werenski,D,CBJ,27,77,14,51,65
58,8478444,Brock Boeser,R,VAN,27,75,34,30,64
58,8478440,Dylan Strome,C,WSH,27,71,26,38,64
58,8478493,Joel Eriksson Ek,C,MIN,27,67,25,39,64
58,8477964,Ivan Barbashev,C,VGK,29,75,28,35,63
58,8474141,Patrick Kane,R,DET,36,79,17,46,63
58,8477402,Pavel Buchnevich,L,STL,29,76,27,35,62
58,8480018,Nick Suzuki,C,MTL,25,72,18,44,62
58,8477447,Shea Theodore,D,VGK,29,63,15,47,62
58,8475798,Mikael Granlund,C,SJS,32,65,16,45,61
58,8476460,Mark Scheifele,C,WPG,31,70,21,39,60
58,8476456,Jonathan Huberdeau,C,CGY,31,79,18,42,60
58,8476875,Mike Matheson,D,MTL,30,76,9,51,60
58,8475168,Matt Duchene,C,DAL,33,81,35,24,59
58,8475184,Chris Kreider,L,NYR,33,81,31,28,59
58,8475810,Bryan Rust,R,PIT,32,67,28,31,59
58,8478414,Timo Meier,R,NJD,28,75,25,34,59
58,8476792,Torey Krug,D,STL,33,75,17,42,59
58,8471724,Kris Letang,D,PIT,37,76,14,45,59
58,8474578,Erik Karlsson,D,PIT,34,78,10,49,59
58,8478873,Troy Terry,R,ANA,27,78,26,32,58
58,8482093,Seth Jarvis,C,CAR,22,71,25,33,58
58,8480028,Morgan Frost,C,PHI,25,73,25,33,58
58,8473512,Claude Giroux,R,OTT,36,80,13,45,58
58,8478407,Vince Dunn,D,SEA,28,71,13,45,58
58,8471214,Alex Ovechkin,L,WSH,39,74,31,26,57
58,8479675,Trevor Moore,L,LAK,29,79,24,33,57
58,8475794,Tyler Seguin,C,DAL,32,82,22,35,57
58,8475172,Nazem Kadri,C,CGY,34,76,21,36,57
58,8474590,John Carlson,D,WSH,34,64,14,43,57
58,8482684,Luke Hughes,D,NJD,21,73,14,43,57
58,8479325,Charlie McAvoy,D,BOS,27,72,7,50,57
58,8475786,Zach Hyman,L,EDM,32,75,30,26,56
58,8480015,Owen Tippett,R,PHI,25,78,29,27,56
58,8480039,Martin Necas,C,CAR,25,73,28,28,56
58,8476880,Tom Wilson,R,WSH,30,74,28,28,56
58,8484166,Adam Fantilli,C,CBJ,20,68,23,33,56
58,8473994,Jamie Benn,L,DAL,35,82,22,34,56
58,8482124,Quinton Byfield,R,LAK,22,80,15,41,56
58,8482109,Alexis Lafrenière,L,NYR,23,72,26,29,55
58,8479400,Pierre-Luc Dubois,L,WSH,26,71,21,34,55
58,8477503,Max Domi,C,TOR,29,78,17,38,55
58,8477494,Jonathan Drouin,L,COL,29,82,15,40,55
58,8480865,Noah Dobson,D,NYI,24,77,12,43,55
58,8478038,Devon Toews,D,COL,30,70,11,44,55
58,8476432,Boone Jenner,C,CBJ,31,68,37,17,54
58,8482740,Wyatt Johnston,C,DAL,21,81,32,22,54
58,8475765,Vladimir Tarasenko,R,DET,33,80,19,35,54
58,8481711,Matias Maccelli,L,UTA,24,75,17,37,54
58,8479345,Jakob Chychrun,D,WSH,26,72,17,37,54
58,8478458,John (Jack) Roslovic,C,CAR,27,63,17,37,54
58,8478401,Pavel Zacha,C,BOS,27,79,21,32,53
58,8480839,Rasmus Dahlin,D,BUF,24,68,17,36,53
58,8479425,Filip Hronek,D,VAN,27,73,8,45,53
58,8481542,Moritz Seider,D,DET,23,77,7,46,53
58,8478856,Conor Garland,R,VAN,28,77,25,27,52
58,8477416,Oliver Bjorkstrand,R,SEA,29,73,24,28,52
58,8478519,Anthony Cirelli,C,TBL,27,82,18,34,52
58,8476479,Phillip Danault,C,LAK,31,76,18,34,52
58,8478397,Rasmus Andersson,D,CGY,28,77,10,42,52
58,8476872,Scott Laughton,C,PHI,30,77,20,31,51
58,8476462,Dougie Hamilton,D,NJD,31,68,17,34,51
58,8477986,Brandon Montour,D,SEA,30,71,13,38,51
58,8482699,Dylan Guenther,R,UTA,21,74,31,19,50
58,8477407,Anthony Duclair,L,NYI,29,80,30,20,50
58,8477476,Artturi Lehkonen,L,COL,29,82,26,24,50
58,8475768,Jaden Schwartz,C,SEA,32,68,17,33,50
58,8476906,Shayne Gostisbehere,D,CAR,31,75,12,38,50
58,8477935,Sam Bennett,C,FLA,28,75,29,20,49
58,8479525,Ross Colton,C,COL,28,79,22,27,49
58,8474586,Jordan Eberle,R,SEA,34,77,15,34,49
58,8478474,Lawson Crouse,L,UTA,27,73,26,22,48
58,8475151,Kyle Palmieri,C,NYI,33,73,26,22,48
58,8481528,Dylan Cozens,C,BUF,23,73,21,27,48
58,8478462,Nicolas Roy,C,VGK,27,72,19,29,48
58,8475287,Erik Haula,L,NJD,33,75,19,29,48
58,8475158,Ryan O'Reilly,C,NSH,33,76,15,33,48
58,8481560,Arthur Kaliyev,R,LAK,23,79,26,21,47
58,8477451,Ryan Hartman,R,MIN,30,69,24,23,47
58,8478366,Frank Vatrano,R,ANA,30,70,23,24,47
58,8483515,Juraj Slafkovsky,L,MTL,20,79,23,24,47
58,8475314,Anders Lee,L,NYI,34,80,22,25,47
58,8482097,Jack Quinn,R,BUF,23,68,20,27,47
58,8473986,Alex Killorn,L,ANA,35,73,20,27,47
58,8475191,Reilly Smith,R,NYR,33,73,18,29,47
58,8474565,Alex Pietrangelo,D,VGK,34,57,10,37,47
58,8470613,Brent Burns,D,CAR,39,75,9,38,47
58,8479410,Mikhail Sergachev,D,UTA,26,72,6,41,47
58,8478498,Jake DeBrusk,L,VAN,28,74,24,22,46
58,8481533,Trevor Zegras,C,ANA,23,73,23,23,46
58,8480459,Pius Suter,C,VAN,28,73,20,26,46
58,8476882,Teuvo Teravainen,C,CHI,30,63,19,27,46
58,8480220,Noah Cates,L,PHI,25,65,19,27,46
58,8474679,Gustav Nyquist,C,NSH,35,72,18,28,46
58,8475763,Kevin Hayes,R,PIT,32,76,14,32,46
58,8475170,Brayden Schenn,C,STL,33,73,21,24,45
58,8482159,Tyson Foerster,R,PHI,22,73,21,24,45
58,8477479,Tyler Bertuzzi,L,CHI,29,65,20,25,45
58,8483505,Matthew Poitras,C,BOS,20,75,20,25,45
58,8476923,Damon Severson,D,CBJ,30,76,14,31,45
58,8478469,Thomas Chabot,D,OTT,27,71,12,33,45
58,8481581,Thomas Harley,D,DAL,23,75,11,34,45
58,8476458,Ryan Strome,C,ANA,31,73,11,34,45
58,8477511,Anthony Mantha,R,CGY,30,76,26,18,44
58,8476399,Blake Coleman,C,CGY,33,77,22,22,44
58,8482149,Cole Perfetti,C,WPG,22,66,21,23,44
58,8482702,Logan Stankoven,C,DAL,21,80,20,24,44
58,8481618,Alex Newhook,C,MTL,23,74,20,24,44
58,8474150,Mikael Backlund,C,CGY,35,76,16,28,44
58,8477429,Andrew Copp,C,DET,30,79,14,30,44
58,8477426,Nicholas Paul,L,TBL,29,82,24,19,43
58,8477497,Sean Monahan,C,CBJ,30,71,20,23,43
58,8476483,Rickard Rakell,R,PIT,31,66,20,23,43
58,8483808,Andrei Kuzmenko,L,CGY,28,75,19,24,43
58,8481596,Shane Pinto,C,OTT,24,75,18,25,43
58,8477456,J.T. Compher,L,DET,29,80,18,25,43
58,8480009,Eeli Tolvanen,R,SEA,25,74,17,26,43
58,8482092,Ridly Greig,C,OTT,22,77,12,31,43
58,8482122,Brock Faber,D,MIN,22,77,7,36,43
58,8481624,Ilya Mikheyev,R,CHI,30,60,22,20,42
58,8474641,Adam Henrique,C,EDM,34,73,20,22,42
58,8483431,Logan Cooley,C,UTA,20,76,18,24,42
58,8474053,Logan Couture,C,SJS,35,60,15,27,42
58,8478438,Tommy Novak,C,NSH,27,70,14,28,42
58,8478042,Viktor Arvidsson,L,EDM,31,73,13,29,42
58,8481703,Valtteri Puustinen,R,PIT,25,64,11,31,42
58,8477948,Travis Sanheim,D,PHI,28,73,11,31,42
58,8479365,Trent Frederic,C,BOS,26,77,22,19,41
58,8482667,William Eklund,L,SJS,22,68,15,26,41
58,8474189,Lars Eller,C,PIT,35,62,15,26,41
58,8476869,Brady Skjei,D,NSH,30,68,13,28,41
58,8480014,Gabriel Vilardi,C,WPG,25,71,27,13,40
58,8484145,Zach Benson,L,BUF,19,71,20,20,40
58,8474102,David Perron,L,OTT,36,79,19,21,40
58,8475169,Evander Kane,L,EDM,33,72,18,22,40
58,8480802,Ryan McLeod,C,BUF,25,71,18,22,40
58,8478466,Daniel Sprong,R,VAN,27,67,17,23,40
58,8477998,Warren Foegele,L,LAK,28,80,14,26,40
58,8478396,Noah Hanifin,D,VGK,27,70,9,31,40
58,8476979,Erik Gustafsson,D,DET,32,75,8,32,40
58,8480434,Sean Durzi,D,UTA,26,68,7,33,40
58,8476958,Jaccob Slavin,D,CAR,30,69,4,36,40
58,8480829,Jesperi Kotkaniemi,C,CAR,24,67,20,19,39
58,8482055,Drew O'Connor,L,PIT,26,71,19,20,39
58,8481604,Pavel Dorofeyev,L,VGK,24,71,18,21,39
58,8481577,Philip Tomasino,C,NSH,23,62,13,26,39
58,8480798,Philipp Kurashev,C,CHI,25,64,11,28,39
58,8476854,Hampus Lindholm,D,BOS,30,70,9,30,39
58,8482712,Oskar Olausson,R,COL,22,75,9,30,39
58,8477495,Seth Jones,D,CHI,30,64,4,35,39
58,8481186,Logan O'Connor,R,COL,28,76,24,14,38
58,8475760,Nick Bjugstad,C,UTA,32,77,16,22,38
58,8482745,Mason McTavish,C,ANA,21,72,16,22,38
58,8477021,Alex Kerfoot,C,UTA,30,78,16,22,38
58,8475714,Calle Jarnkrok,C,TOR,33,75,14,24,38
58,8480797,Joel Farabee,L,PHI,24,71,12,26,38
58,8475753,Justin Faulk,D,STL,32,72,10,28,38
58,8474715,Cameron Atkinson,R,TBL,35,82,21,16,37
58,8480188,Fabian Zetterlund,L,SJS,25,64,18,19,37
58,8480064,Josh Norris,C,OTT,25,79,16,21,37
58,8482113,Anton Lundell,C,FLA,23,73,16,21,37
58,8479339,Patrik Laine,L,CBJ,26,55,15,22,37
58,8478233,Andrew Mangiapane,L,WSH,28,70,15,22,37
58,8476826,Yanni Gourde,C,SEA,33,70,14,23,37
58,8475193,Tomas Tatar,L,NJD,34,70,12,25,37
58,8476885,Jacob Trouba,D,NYR,30,72,12,25,37
58,8477932,Aaron Ekblad,D,FLA,28,74,10,27,37
58,8477346,MacKenzie Weegar,D,CGY,30,70,8,29,37
58,8480817,K'Andre Miller,D,NYR,24,73,8,29,37
58,8474563,Drew Doughty,D,LAK,35,71,7,30,37
58,8482110,Dawson Mercer,C,NJD,23,71,21,15,36
58,8477444,Andre Burakovsky,L,SEA,29,65,18,18,36
58,8475848,Brendan Gallagher,R,MTL,32,69,16,20,36
58,8478046,Danton Heinen,L,VAN,29,71,14,22,36
58,8474149,Evgenii Dadonov,R,DAL,35,80,14,22,36
58,8481553,Bobby Brink,R,PHI,23,70,13,23,36
58,8477498,Darnell Nurse,D,EDM,29,73,11,25,36
58,8475764,Cam Fowler,D,ANA,33,75,4,32,36
58,8480893,Kirill Marchenko,R,CBJ,24,63,23,12,35
58,8480185,Eetu Luostarinen,C,FLA,26,74,20,15,35
58,8479661,Tanner Jeannot,L,LAK,27,75,19,16,35
58,8482089,Jake Neighbours,L,STL,22,72,16,19,35
58,8479992,Michael Rasmussen,C,DET,25,76,14,21,35
58,8482660,Kent Johnson,C,CBJ,22,63,12,23,35
58,8478472,Mathieu Joseph,R,STL,27,62,10,25,35
58,8476461,Sean Couturier,C,PHI,32,69,9,26,35
58,8478057,Dakota Joshua,C,VAN,28,65,8,27,35
58,8484203,Bradly Nadeau,L,CAR,19,66,7,28,35
58,8479987,Morgan Geekie,C,BOS,26,74,17,17,34
58,8471698,T.J. Oshie,R,WSH,38,64,14,20,34
58,8479351,Sam Steel,C,DAL,26,79,10,24,34
58,8481523,Kirby Dach,C,MTL,23,65,7,27,34
58,8479293,Brandon Tanev,L,SEA,33,66,19,14,33
58,8482175,JJ Peterka,R,BUF,22,73,15,18,33
58,8476292,Ondrej Palat,L,NJD,33,70,13,20,33
58,8481524,Bowen Byram,D,BUF,23,69,12,21,33
58,8482142,Jamie Drysdale,D,PHI,22,60,12,21,33
58,8478542,Evan Rodrigues,C,FLA,31,74,9,24,33
58,8480145,Neal Pionk,D,WPG,29,70,7,26,33
58,8476917,Adam Pelech,D,NYI,30,80,7,26,33
58,8478109,Victor Olofsson,L,VGK,29,69,20,12,32
58,8476438,Brandon Saad,L,STL,32,77,17,15,32
58,8475799,Nino Niederreiter,R,WPG,32,71,15,17,32
58,8476480,Vladislav Namestnikov,C,WPG,32,68,15,17,32
58,8476921,Jordan Martinook,L,CAR,32,56,12,20,32
58,8475200,Dmitry Orlov,D,CAR,33,77,9,23,32
58,8478133,Jake Evans,C,MTL,28,70,8,24,32
58,8478020,Michael Amadio,R,OTT,28,71,21,10,31
58,8479316,Luke Kunin,C,SJS,27,66,19,12,31
58,8482475,Yegor Chinakhov,R,CBJ,23,58,13,18,31
58,8476392,Adam Lowry,C,WPG,31,61,13,18,31
58,8480068,Ryan Poehling,C,PHI,25,68,13,18,31
58,8480078,Filip Chytil,C,NYR,25,66,11,20,31
58,8478500,Ivan Provorov,D,CBJ,27,79,1,30,31
58,8478891,Mason Appleton,C,WPG,28,65,15,15,30
58,8476918,Jimmy Vesey,L,NYR,31,73,15,15,30
58,8482705,Cole Sillinger,C,CBJ,21,69,14,16,30
58,8478115,Pierre Engvall,L,NYI,28,76,14,16,30
58,8477987,Ryan Donato,C,CHI,28,66,11,19,30
58,8482105,Jake Sanderson,D,OTT,22,73,10,20,30
58,8481546,Cam York,D,PHI,23,67,9,21,30
58,8482133,Thomas Bordeleau,C,SJS,22,61,8,22,30
58,8478507,John Marino,D,UTA,27,69,4,26,30
58,8475793,Ryan Johansen,C,PHI,32,74,18,11,29
58,8481554,Kaapo Kakko,R,NYR,23,61,17,12,29
58,8479591,Michael Eyssimont,C,TBL,28,80,15,14,29
58,8480813,Joe Veleno,C,DET,24,76,15,14,29
58,8481656,Aliaksei Protas,C,WSH,23,61,15,14,29
58,8480448,Parker Kelly,L,COL,25,74,15,14,29
58,8482720,Matthew Knies,L,TOR,22,74,10,19,29
58,8476927,Teddy Blueger,C,VAN,30,68,10,19,29
58,8473533,Jordan Staal,C,CAR,36,70,10,19,29
58,8480336,Sean Walker,D,CAR,30,73,9,20,29
58,8478055,Gustav Forsling,D,FLA,28,68,8,21,29
58,8483490,Pavel Mintyukov,D,ANA,21,71,5,24,29
58,8480043,Timothy Liljegren,D,TOR,25,69,4,25,29
58,8480891,Michael Kesselring,D,UTA,24,57,3,26,29
58,8477506,Ryan Pulock,D,NYI,30,77,2,27,29
58,8480873,Rasmus Sandin,D,WSH,24,63,2,27,29
58,8477947,Sonny Milano,L,WSH,28,69,12,16,28
58,8477953,Kasperi Kapanen,R,STL,28,67,12,16,28
58,8479996,Cody Glass,C,NSH,25,55,12,16,28
58,8475218,Mattias Ekholm,D,EDM,34,74,8,20,28
58,8476463,Jonas Brodin,D,MIN,31,77,8,20,28
58,8477969,Marcus Pettersson,D,PIT,28,79,5,23,28
58,8482655,Janis Moser,D,TBL,24,75,4,24,28
58,8480855,Jack McBain,C,UTA,24,66,12,15,27
58,8477979,Nicolas Aube-Kubel,R,BUF,28,49,12,15,27
58,8482146,Luke Evangelista,R,NSH,22,69,11,16,27
58,8478413,Jordan Greenway,L,BUF,27,63,11,16,27
58,8474716,Jared Spurgeon,D,MIN,35,79,10,17,27
58,8475855,Jesper Fast,R,CAR,33,60,10,17,27
58,8482624,Daniil Miromanov,D,CGY,27,65,10,17,27
58,8476897,Oskar Sundqvist,C,STL,30,68,8,19,27
58,8476419,Jean-Gabriel Pageau,C,NYI,32,75,5,22,27
58,8481582,Nicholas Robertson,L,TOR,23,71,15,11,26
58,8483524,Shane Wright,C,SEA,20,65,13,13,26
58,8476878,Zemgus Girgensons,C,TBL,30,79,13,13,26
58,8481093,Rafael Harvey-Pinard,L,MTL,25,55,12,14,26
58,8480849,Barrett Hayton,C,UTA,24,69,10,16,26
58,8476960,Andreas Athanasiou,C,CHI,30,53,8,18,26
58,8482259,Bobby McMann,C,TOR,28,67,14,11,25
58,8477839,Conor Sheary,L,TBL,32,80,12,13,25
58,8482125,Alexander Holtz,R,VGK,22,59,12,13,25
58,8482079,Marco Rossi,C,MIN,23,59,12,13,25
58,8475791,Taylor Hall,L,CHI,33,57,11,14,25
58,8478013,Jake Walman,D,SJS,28,69,11,14,25
58,8478434,Keegan Kolesar,R,VGK,27,67,10,15,25
58,8482111,Justin Barron,D,MTL,23,65,8,17,25
58,8482101,Danil Gushchin,L,SJS,22,65,8,17,25
58,8476467,Jamie Oleksiak,D,SEA,32,66,7,18,25
58,8478882,Vladislav Gavrikov,D,LAK,29,72,5,20,25
58,8480073,Erik Brannstrom,D,COL,25,65,5,20,25
58,8476981,Josh Anderson,R,MTL,30,72,16,8,24
58,8477425,Miles Wood,L,COL,29,75,13,11,24
58,8479368,Max Jones,L,BOS,26,59,13,11,24
58,8480835,Jack Drury,C,CAR,24,60,13,11,24
58,8475722,Jason Zucker,L,BUF,32,60,12,12,24
58,8470621,Corey Perry,R,EDM,39,77,10,14,24
58,8476925,Colton Sissons,C,NSH,31,71,8,16,24
58,8481032,Paul Cotter,C,NJD,25,62,8,16,24
58,8482074,Connor Zary,C,CGY,23,60,7,17,24
58,8475233,David Savard,D,MTL,34,66,6,18,24
58,8480871,Adam Boqvist,D,FLA,24,62,5,19,24
58,8473563,Nicklas Backstrom,C,WSH,37,48,5,19,24
58,8476525,Colin Miller,D,WPG,32,61,3,21,24
58,8479371,Dante Fabbro,D,NSH,26,69,3,21,24
58,8477952,Robby Fabbri,C,ANA,28,66,14,9,23
58,8482737,Zack Bolduc,C,STL,21,55,13,10,23
58,8477353,Tyler Motte,C,DET,29,68,11,12,23
58,8477478,William Carrier,L,CAR,30,58,10,13,23
58,8481481,Blake Lizotte,C,PIT,27,62,10,13,23
58,8480113,Alex Iafallo,L,WPG,31,69,9,14,23
58,8477505,Alexander Wennberg,C,SJS,30,64,9,14,23
58,8481606,Jordan Spence,D,LAK,23,62,6,17,23
58,8482671,Owen Power,D,BUF,22,70,5,18,23
58,8479353,Brett Howden,C,VGK,26,66,5,18,23
58,8481014,Alexander Romanov,D,NYI,24,80,5,18,23
58,8478851,Alexandre Carrier,D,NSH,28,69,4,19,23
58,8476331,Dylan DeMelo,D,WPG,31,74,0,23,23
58,8482155,Alex Laferriere,R,LAK,23,66,16,6,22
58,8479941,Justin Danforth,R,CBJ,31,63,13,9,22
58,8478432,Christian Fischer,R,DET,27,77,12,10,22
58,8479336,Carl Grundstrom,R,SJS,27,50,12,10,22
58,8473453,Trevor Lewis,C,LAK,37,72,12,10,22
58,8480205,Emil Bemstrom,C,PIT,25,54,12,10,22
58,8475220,Marcus Foligno,L,MIN,33,66,11,11,22
58,8475231,Casey Cizikas,C,NYI,33,70,10,12,22
58,8480762,Eric Robinson,L,CAR,29,55,10,12,22
58,8478463,Anthony Beauvillier,L,PIT,27,62,10,12,22
58,8477392,Hudson Fasching,R,NYI,29,64,10,12,22
58,8479344,Jesse Puljujarvi,R,PIT,26,59,10,12,22
58,8481601,Simon Holmstrom,R,NYI,23,71,10,12,22
58,8477931,Tomas Nosek,L,FLA,32,66,10,12,22
58,8477446,Michael McCarron,R,NSH,29,62,9,13,22
58,8477015,Connor Brown,R,EDM,30,63,8,14,22
58,8483491,Ivan Miroshnichenko,L,WSH,20,51,8,14,22
58,8483457,Lane Hutson,D,MTL,20,67,7,15,22
58,8477499,Rasmus Ristolainen,D,PHI,30,58,5,17,22
58,8482176,Wyatt Kaiser,D,CHI,22,56,5,17,22
58,8479983,Mario Ferraro,D,SJS,26,75,4,18,22
58,8479402,Jake Bean,D,CGY,26,68,4,18,22
58,8474151,Ryan McDonagh,D,TBL,35,75,3,19,22
58,8476879,Cody Ceci,D,EDM,31,76,3,19,22
58,8479639,Dylan Coghlan,D,WPG,26,62,3,19,22
58,8478508,Yakov Trenin,C,MIN,27,62,12,9,21
58,8477406,Mattias Janmark,C,EDM,32,67,12,9,21
58,8483445,Cutter Gauthier,L,ANA,20,66,11,10,21
58,8482117,Lukas Reichel,L,CHI,22,53,10,11,21
58,8473422,Nick Foligno,L,CHI,37,53,9,12,21
58,8477989,Christian Dvorak,C,MTL,28,62,9,12,21
58,8476278,Colin Blackwell,C,DAL,31,76,9,12,21
58,8477450,Jason Dickinson,C,CHI,29,54,9,12,21
58,8477919,Frederick Gaudreau,C,MIN,31,57,9,12,21
58,8479520,Brandon Duhaime,R,WSH,27,63,9,12,21
58,8481441,Joe Snively,C,DET,28,65,8,13,21
58,8480878,Nils Lundkvist,D,DAL,24,73,5,16,21
58,8476422,Mike Reilly,D,NYI,31,77,5,16,21
58,8476856,Mathew Dumba,D,DAL,30,71,5,16,21
58,8476892,Colton Parayko,D,STL,31,63,4,17,21
58,8475181,Nick Leddy,D,STL,33,62,4,17,21
58,8475343,Nic Dowd,C,WSH,34,64,4,17,21
58,8478452,Caleb Jones,D,LAK,27,57,4,17,21
58,8480246,Nick Perbix,D,TBL,26,74,3,18,21
58,8476902,Esa Lindell,D,DAL,30,71,2,19,21
58,8482679,Matt Coronato,R,CGY,22,66,2,19,21
58,8479414,Nathan Bastian,R,NJD,27,61,14,6,20
58,8476474,Stefan Noesen,R,NJD,31,62,12,8,20
58,8480980,Connor Dewar,C,TOR,25,67,11,9,20
58,8479390,Taylor Raddysh,R,WSH,26,59,11,9,20
58,8482749,Joshua Roy,R,MTL,21,64,10,10,20
58,8478585,Derek Ryan,C,EDM,38,62,10,10,20
58,8480025,MacKenzie Entwistle,R,FLA,25,61,10,10,20
58,8475149,Marcus Johansson,L,MIN,34,65,9,11,20
58,8481704,Juuso Parssinen,C,NSH,23,62,7,13,20
58,8477220,Nate Schmidt,D,FLA,33,71,7,13,20
58,8477369,Carson Soucy,D,VAN,30,52,7,13,20
58,8470600,Ryan Suter,D,STL,39,65,6,14,20
58,8478970,Jalen Chatfield,D,CAR,28,72,5,15,20
58,8478911,Matt Roy,D,WSH,29,66,5,15,20
58,8477380,Jonny Brodzinski,C,NYR,31,56,5,15,20
58,8477034,Jaycob Megna,D,FLA,32,51,5,15,20
58,8480035,Henri Jokiharju,D,BUF,25,64,4,16,20
58,8477507,Nikita Zadorov,D,BOS,29,67,3,17,20
58,8474673,TJ Brodie,D,CHI,34,64,1,19,20
58,8480281,Alexey Toropchenko,R,STL,25,61,15,4,19
58,8481535,Nils Hoglander,L,VAN,24,65,13,6,19
58,8482157,Will Cuylle,L,NYR,22,61,11,8,19
58,8484149,Gavin Brindley,C,CBJ,20,49,8,11,19
58,8480995,Pontus Holmberg,R,TOR,25,58,8,11,19
58,8482192,Isaak Phillips,D,CHI,23,45,8,11,19
58,8482803,Olen Zellweger,D,ANA,21,65,7,12,19
58,8483468,Jiri Kulich,C,BUF,20,60,7,12,19
58,8481521,Ronnie Attard,D,PHI,25,57,7,12,19
58,8481477,Nico Sturm,C,SJS,29,60,7,12,19
58,8481522,Peyton Krebs,C,BUF,23,63,7,12,19
58,8480806,Isac Lundestrom,C,ANA,25,55,7,12,19
58,8480003,Jesper Boqvist,C,FLA,26,68,6,13,19
58,8479976,Juuso Valimaki,D,UTA,26,66,5,14,19
58,8482095,Tyler Kleven,D,OTT,22,52,5,14,19
58,8480222,Sebastian Aho,D,PIT,28,68,4,15,19
58,8476988,Matt Benning,D,SJS,30,64,4,15,19
58,8479998,Mikey Anderson,D,LAK,25,56,3,16,19
58,8478136,Jake Middleton,D,MIN,28,72,2,17,19
58,8476931,Jake McCabe,D,TOR,31,64,2,17,19
58,8476312,Josh Manson,D,COL,33,64,1,18,19
58,8482451,Mikael Pyyhtia,L,CBJ,23,44,8,10,18
58,8480011,Klim Kostin,C,SJS,25,49,7,11,18
58,8481580,Connor McMichael,C,WSH,23,65,5,13,18
58,8477435,Ryan Graves,D,PIT,29,73,5,13,18
58,8482067,Connor Mackey,D,NYR,28,63,4,14,18
58,8475462,Radko Gudas,D,ANA,34,62,4,14,18
58,8476891,Matthew Grzelcyk,D,PIT,30,75,3,15,18
58,8478416,Erik Cernak,D,TBL,27,70,3,15,18
58,8477488,Brett Pesce,D,NJD,30,65,2,16,18
58,8479980,Nicolas Hague,D,VGK,26,62,2,16,18
58,8482087,Kaiden Guhle,D,MTL,22,62,1,17,18
58,8482809,Jackson Blake,R,CAR,21,51,10,7,17
58,8480748,Kiefer Sherwood,L,VAN,29,56,9,8,17
58,8479066,Ryan Lomberg,L,CGY,30,72,8,9,17
58,8478043,Sam Lafferty,C,BUF,29,61,8,9,17
58,8483493,Frank Nazar,C,CHI,20,51,8,9,17
58,8479315,Joey Anderson,R,CHI,26,51,7,10,17
58,8475171,Oliver Ekman-Larsson,D,TOR,33,72,6,11,17
58,8480848,Ty Dellandrea,C,SJS,24,45,5,12,17
58,8474090,Brendan Smith,D,DAL,35,55,5,12,17
58,8476457,Adam Larsson,D,SEA,32,72,4,13,17
58,8477365,Connor Clifton,D,BUF,29,50,3,14,17
58,8478451,Ethan Bear,D,WSH,27,52,3,14,17
58,8471709,Marc-Edouard Vlasic,D,SJS,37,56,3,14,17
58,8475790,Erik Gudbranson,D,CBJ,32,77,2,15,17
58,8482073,Braden Schneider,D,NYR,23,59,2,15,17
58,8482730,Brandt Clarke,D,LAK,21,53,1,16,17
58,8478840,Will Borgen,D,SEA,28,64,0,17,17
58,8479393,Noah Gregor,L,OTT,26,73,11,5,16
58,8478421,A.J. Greer,L,FLA,28,61,11,5,16
58,8480289,Morgan Barron,C,WPG,26,49,9,7,16
58,8482166,Shakir Mukhamadullin,D,SJS,22,51,9,7,16
58,8479439,Jacob MacDonald,D,COL,31,47,8,8,16
58,8476889,Radek Faksa,C,STL,30,68,8,8,16
58,8476374,Sean Kuraly,C,CBJ,31,59,6,10,16
58,8473507,Jeff Petry,D,DET,37,70,4,12,16
58,8479026,Philippe Myers,D,TOR,27,47,4,12,16
58,8481178,Egor Zamula,D,PHI,24,56,4,12,16
58,8483565,Nick Blankenburg,D,NSH,26,61,3,13,16
58,8480058,Pierre-Olivier Joseph,D,STL,25,57,3,13,16
58,8481527,Kaedan Korczak,D,VGK,23,43,3,13,16
58,8481708,Zac Jones,D,NYR,24,48,2,14,16
58,8475455,Brenden Dillon,D,NJD,34,60,1,15,16
58,8480049,Dylan Samberg,D,WPG,25,67,0,16,16
58,8476469,Joel Armia,R,MTL,31,65,8,7,15
58,8475842,Sam Carrick,C,NYR,32,58,8,7,15
58,8480789,Oliver Wahlstrom,R,NYI,24,69,7,8,15
58,8477903,Garnet Hathaway,R,PHI,33,70,7,8,15
58,8481059,Scott Perunovich,D,STL,26,58,5,10,15
58,8477018,Ben Hutton,D,VGK,31,50,5,10,15
58,8480007,Jonas Rondbjerg,R,VGK,25,39,5,10,15
58,8479543,Michael Pezzetta,L,MTL,26,59,4,11,15
58,8481568,Alex Vlasic,D,CHI,23,59,4,11,15
58,8480192,Johnathan Kovacevic,D,NJD,27,59,3,12,15
58,8475279,Ben Chiarot,D,DET,33,72,2,13,15
58,8476329,Travis Boyd,C,MIN,31,53,2,13,15
58,8480001,Urho Vaakanainen,D,ANA,25,63,2,13,15
58,8480070,Ian Mitchell,D,BOS,25,53,2,13,15
58,8479324,Ryan Lindgren,D,NYR,26,60,2,13,15
58,8475208,Brian Dumoulin,D,ANA,33,58,2,13,15
58,8478178,Darren Raddysh,D,TBL,28,63,1,14,15
58,8480807,Mattias Samuelsson,D,BUF,24,51,1,14,15
58,8478569,Noel Acciari,C,PIT,33,46,7,7,14
58,8481517,Brett Leason,R,ANA,25,56,7,7,14
58,8482964,Arber Xhekaj,D,MTL,23,43,7,7,14
58,8480021,Jack Studnicka,C,LAK,25,61,5,9,14
58,8477508,Curtis Lazar,C,NJD,29,52,5,9,14
58,8480074,Alexandre Texier,C,STL,25,47,5,9,14
58,8480144,David Kampf,C,TOR,29,65,4,10,14
58,8480727,Zach Whitecloud,D,VGK,28,49,4,10,14
58,8479328,Julien Gauthier,R,NYI,27,61,3,11,14
58,8479398,Samuel Girard,D,COL,26,64,2,12,14
58,8477845,Trevor van Riemsdyk,D,WSH,33,51,2,12,14
58,8478443,Brandon Carlo,D,BOS,28,65,1,13,14
58,8479619,Michael Carcone,L,UTA,28,63,11,2,13
58,8478831,Kevin Stenlund,C,UTA,28,51,9,4,13
58,8483499,Liam Ohgren,L,MIN,20,49,8,5,13
58,8479671,Mathieu Olivier,R,CBJ,27,52,6,7,13
58,8475324,Nick Jensen,D,OTT,34,68,6,7,13
58,8479718,Alex Barré-Boulet,C,MTL,27,52,6,7,13
58,8481013,Jonatan Berggren,R,DET,24,60,6,7,13
58,8474567,Zach Bogosian,D,MIN,34,65,5,8,13
58,8475718,Justin Holl,D,DET,32,58,5,8,13
58,8483460,David Jiricek,D,CBJ,21,61,4,9,13
58,8483482,Tristan Luneau,D,ANA,20,64,4,9,13
58,8481161,Jake Christiansen,D,CBJ,25,54,4,9,13
58,8479982,Conor Timmins,D,TOR,26,55,3,10,13
58,8482245,Artem Zub,D,OTT,29,71,3,10,13
58,8480880,Jakub Lauko,C,MIN,24,29,3,10,13
58,8476429,Scott Mayfield,D,NYI,32,72,2,11,13
58,8481550,Adam Beckman,L,NJD,23,39,2,11,13
58,8478399,Jonas Siegenthaler,D,NJD,27,62,1,12,13
58,8474574,Tyler Myers,D,VAN,34,69,0,13,13
58,8481789,Tye Kartye,L,SEA,23,35,9,3,12
58,8478211,Dryden Hunt,L,CGY,29,56,6,6,12
58,8475225,Craig Smith,C,CHI,35,56,6,6,12
58,8477482,Zachary Sanford,L,CHI,30,43,6,6,12
58,8479291,Kevin Rooney,C,CGY,31,39,6,6,12
58,8481598,Philip Broberg,D,EDM,23,34,6,6,12
58,8476873,Mark Jankowski,C,NSH,30,49,5,7,12
58,8476624,Barclay Goodrow,C,SJS,31,52,5,7,12
58,8480252,Cole Guttman,C,CHI,25,37,5,7,12
58,8482744,James Malatesta,L,CBJ,21,42,5,7,12
58,8477887,Patrick Brown,C,BOS,32,47,5,7,12
58,8480355,Mark Kastelic,C,BOS,25,64,5,7,12
58,8480157,Calle Rosen,D,COL,30,50,4,8,12
58,8480441,Trey Fix-Wolansky,R,CBJ,25,39,4,8,12
58,8474013,Ian Cole,D,UTA,35,47,4,8,12
58,8482634,Alex Steeves,C,TOR,25,52,3,9,12
58,8480845,Rasmus Kupari,C,WPG,24,44,3,9,12
58,8476441,Joel Edmundson,D,LAK,31,46,2,10,12
58,8479369,Andrew Peeke,D,BOS,26,50,1,11,12
58,8473446,Erik Johnson,D,PHI,36,53,1,11,12
58,8482070,Mitchell Chaffee,R,TBL,26,48,9,2,11
58,8481716,Dmitri Voronkov,L,CBJ,24,46,7,4,11
58,8482807,Ethan Del Mastro,D,CHI,21,49,7,4,11
58,8479981,Jonah Gadjovich,L,FLA,26,36,6,5,11
58,8482762,Simon Edvinsson,D,DET,21,61,5,6,11
58,8481537,Nikita Okhotiuk,D,CGY,24,46,5,6,11
58,8479370,Tyson Jost,C,CAR,26,51,4,7,11
58,8477573,Nathan Walker,L,STL,30,47,4,7,11
58,8477401,John Hayden,C,SEA,29,32,4,7,11
58,8481751,Lukas Rousek,R,BUF,25,37,4,7,11
58,8480796,Martin Fehervary,D,WSH,25,56,3,8,11
58,8479968,Vinni Lettieri,C,BOS,29,51,3,8,11
58,8475188,Brayden McNabb,D,VGK,33,50,2,9,11
58,8478859,Niko Mikkola,D,FLA,28,62,2,9,11
58,8471677,Jack Johnson,D,CBJ,37,68,2,9,11
58,8479348,Kale Clague,D,BUF,26,44,2,9,11
58,8480172,Jan Rutta,D,SJS,34,65,1,10,11
58,8481567,Henry Thrun,D,SJS,23,55,1,10,11
58,8480950,Ilya Lyubushkin,D,DAL,30,63,1,10,11
58,8475690,Chris Tanev,D,TOR,35,58,0,11,11
58,8479372,Joshua Mahura,D,SEA,26,54,0,11,11
58,8476442,Matt Nieto,L,PIT,32,53,6,4,10
58,8477851,Jordan Oesterle,D,BOS,32,45,6,4,10
58,8481641,Joel Kiviranta,L,COL,28,77,5,5,10
58,8481147,Reese Johnson,C,MIN,26,37,5,5,10
58,8476934,Brock McGinn,L,ANA,30,48,5,5,10
58,8474568,Luke Schenn,D,NSH,35,50,5,5,10
58,8476994,Vinnie Hinostroza,C,NSH,30,46,4,6,10
58,8481701,Santeri Hatakka,D,NJD,23,36,4,6,10
58,8479536,Axel Jonsson-Fjallby,L,WPG,26,39,4,6,10
58,8482859,Zack Ostapchuk,C,OTT,21,54,3,7,10
58,8476967,Brett Kulak,D,EDM,30,63,1,9,10
58,8483466,Kevin Korchinski,D,CHI,20,57,1,9,10
58,8482861,Vincent Iorio,D,WSH,22,34,1,9,10
58,8480879,Jacob Bernard-Docker,D,OTT,24,45,0,10,10
58,8475179,Dmitry Kulikov,D,FLA,34,60,0,10,10
58,8481532,Alex Turcotte,C,LAK,23,44,7,2,9
58,8481754,Nikita Nesterenko,C,ANA,23,33,6,3,9
58,8481617,Vasily Podkolzin,R,VAN,23,40,6,3,9
58,8476858,Phillip Di Giuseppe,L,VAN,31,45,6,3,9
58,8482077,Dylan Holloway,L,EDM,23,44,6,3,9
58,8471817,Ryan Reaves,R,TOR,37,53,5,4,9
58,8474034,Patrick Maroon,L,CHI,36,49,5,4,9
58,8483549,Lucas Condotta,L,MTL,27,29,5,4,9
58,8477070,Liam O'Brien,C,UTA,30,53,4,5,9
58,8478017,Mark Friedman,D,VAN,29,38,4,5,9
58,8482177,Marat Khusnutdinov,C,MIN,22,49,4,5,9
58,8483495,Simon Nemec,D,NJD,20,51,3,6,9
58,8474612,Travis Hamonic,D,OTT,34,49,3,6,9
58,8481167,Brayden Pachal,D,CGY,25,48,2,7,9
58,8479249,Andrew Poturalski,C,SJS,30,28,2,7,9
58,8481019,David Gustafsson,C,WPG,24,49,1,8,9
58,8480196,Jacob Bryson,D,BUF,27,47,1,8,9
58,8482784,Zach Dean,C,STL,21,39,5,3,8
58,8479944,Zach Aston-Reese,C,VGK,30,45,5,3,8
58,8482733,Logan Mailloux,D,MTL,31,39,5,3,8
58,8477962,Brendan Lemieux,L,CAR,28,34,4,4,8
58,8481028,Martin Pospisil,C,CGY,25,58,3,5,8
58,8475177,Calvin de Haan,D,COL,33,40,3,5,8
58,8477938,Haydn Fleury,D,WPG,28,48,3,5,8
58,8480844,Grigori Denisenko,L,VGK,24,37,3,5,8
58,8478146,Matthew Highmore,C,OTT,28,34,3,5,8
58,8482747,Brennan Othmann,L,NYR,21,43,2,6,8
58,8480860,Kevin Bahl,D,CGY,24,54,1,7,8
58,8474166,Alec Martinez,D,CHI,37,48,1,7,8
58,8476874,Olli Maatta,D,DET,30,54,0,8,8
58,8479994,Jaret Anderson-Dolan,C,WPG,25,30,3,4,7
58,8482666,Scott Morrow,D,CAR,22,51,3,4,7
58,8478874,Adam Gaudette,R,OTT,28,36,3,4,7
58,8483471,Brad Lambert,C,WPG,31,11,3,4,7
58,8484254,Akito Hirose,D,VAN,25,45,2,5,7
58,8477462,Robert Hagg,D,VGK,29,27,2,5,7
58,8480887,Jordan Harris,D,MTL,24,46,1,6,7
58,8481599,Victor Soderstrom,D,UTA,23,43,1,6,7
58,8481518,Nolan Foote,L,NJD,24,40,1,6,7
58,8479378,Logan Stanley,D,WPG,26,34,1,6,7
58,8477244,Chad Ruhwedel,D,NYR,34,34,1,6,7
58,8475750,Jon Merrill,D,MIN,32,61,0,7,7
58,8482148,Hendrix Lapierre,C,WSH,22,50,5,1,6
58,8482751,Ryan Winterton,C,SEA,21,35,5,1,6
58,8479419,Brett Murray,L,BUF,26,21,4,2,6
58,8477473,Justin Bailey,R,SJS,29,27,4,2,6
58,8476473,Connor Murphy,D,CHI,31,36,3,3,6
58,8478468,Jeremy Lauzon,D,NSH,27,58,3,3,6
58,8476822,Luke Glendening,C,TBL,35,79,3,3,6
58,8478409,Anthony Richard,C,PHI,28,39,3,3,6
58,8482511,Mason Lohrei,D,BOS,23,38,3,3,6
58,8481592,Jakob Pelletier,L,CGY,23,42,2,4,6
58,8482145,Mavrik Bourque,C,DAL,22,50,2,4,6
58,8484287,Cole McWard,D,VAN,23,19,2,4,6
58,8484258,Sam Malinski,D,COL,26,24,2,4,6
58,8482250,Callahan Burke,C,VGK,27,31,2,4,6
58,8482062,Cole Smith,L,NSH,29,53,1,5,6
58,8475762,Derek Forbort,D,VAN,32,52,1,5,6
58,8479359,Beck Malenstyn,L,BUF,26,34,1,5,6
58,8479986,Kole Lind,R,DAL,26,47,1,5,6
58,8481122,Simon Benoit,D,TOR,26,41,1,5,6
58,8480870,Bo Groulx,C,NYR,24,24,1,5,6
58,8479985,Cale Fleury,D,SEA,26,28,1,5,6
58,8479379,Givani Smith,R,SJS,26,27,1,5,6
58,8476372,Nick Seeler,D,PHI,31,44,0,6,6
58,8477384,Joshua Brown,D,EDM,30,46,0,6,6
58,8478450,Parker Wotherspoon,D,BOS,27,32,0,6,6
58,8479772,Zack MacEwen,R,OTT,28,46,4,1,5
58,8481556,John Beecher,C,BOS,23,39,4,1,5
58,8482102,Vasily Ponomarev,C,PIT,22,18,4,1,5
58,8481422,Jake Lucchini,C,NSH,29,16,3,2,5
58,8477527,Ross Johnston,L,ANA,30,28,3,2,5
58,8478424,Jansen Harkins,C,ANA,27,46,2,3,5
58,8483763,Maksymilian Szuber,D,UTA,22,43,2,3,5
58,8481543,Nikita Alexandrov,C,STL,24,26,2,3,5
58,8480292,Carson Meyer,R,ANA,27,33,1,4,5
58,8476867,Brendan Gaunce,C,MIN,30,38,1,4,5
58,8477971,Andreas Englund,D,LAK,28,30,1,4,5
58,8481056,Spencer Stastney,D,NSH,24,26,0,5,5
58,8476952,Dominic Toninato,C,WPG,30,37,0,5,5
58,8480890,Jan Jenik,C,OTT,24,31,3,1,4
58,8482496,Nils Aman,C,VAN,24,37,2,2,4
58,8482659,Josh Doan,R,UTA,22,46,2,2,4
58,8482153,Brendan Brisson,C,VGK,23,29,2,2,4
58,8475235,Nicolas Deslauriers,L,PHI,33,41,2,2,4
58,8479576,Vincent Desharnais,D,VAN,28,40,2,2,4
58,8482765,Isak Rosen,R,BUF,21,32,2,2,4
58,8481699,Aku Raty,R,UTA,23,16,2,2,4
58,8479442,Troy Stecher,D,EDM,30,49,1,3,4
58,8479972,Mason Shaw,C,WPG,26,30,1,3,4
58,8483630,Pavol Regenda,L,ANA,25,24,1,3,4
58,8477467,Gustav Olofsson,D,SEA,30,20,1,3,4
58,8482470,Ilya Solovyov,D,CGY,24,19,1,3,4
58,8481719,Maxwell Crozier,D,TBL,24,23,1,3,4
58,8483407,Brandon Scanlin,D,NYR,25,9,1,3,4
58,8476913,Devin Shore,C,MIN,30,31,0,4,4
58,8481679,Maxence Guenette,D,OTT,23,28,3,0,3
58,8480032,Shane Bowers,C,NJD,25,16,3,0,3
58,8479638,Justin Brazeau,R,BOS,26,41,2,1,3
58,8483570,Ben Meyers,C,SEA,26,40,2,1,3
58,8482652,Walker Duehr,R,CGY,27,33,2,1,3
58,8481609,Vladislav Kolyachonok,D,UTA,23,26,2,1,3
58,8481600,Tobias Bjornfot,D,FLA,23,34,2,1,3
58,8481237,Kyle MacLean,C,NYI,25,25,2,1,3
58,8480084,Nick DeSimone,D,NJD,30,18,2,1,3
58,8482141,Lukas Cormier,D,VGK,22,21,1,2,3
58,8483619,Filip Roos,D,OTT,25,34,1,2,3
58,8478502,Dennis Gilbert,D,BUF,28,18,1,2,3
58,8475958,Michael Sgarbossa,C,WSH,32,29,1,2,3
58,8477149,Scott Sabourin,R,SJS,32,10,1,2,3
58,8481541,Samuel Bolduc,D,NYI,24,21,1,2,3
58,8479991,Jake Leschyshyn,C,NYR,25,28,1,2,3
58,8481585,Egor Afanasyev,L,SJS,23,17,1,2,3
58,8482929,Emil Lilleberg,D,TBL,23,25,1,2,3
58,8480990,Declan Chisholm,D,MIN,24,32,0,3,3
58,8478021,William Lagesson,D,DET,28,25,0,3,3
58,8483397,Marc McLaughlin,C,BOS,25,26,0,3,3
58,8482713,Mackie Samoskevich,R,FLA,22,42,0,3,3
58,8479587,Rhett Gardner,C,PHI,28,18,0,3,3
58,8482516,Matthew Kessel,D,STL,24,20,0,3,3
58,8480245,Olle Lycksell,R,PHI,25,21,0,3,3
58,8482858,Ryker Evans,D,SEA,23,26,0,3,3
58,8481564,Ryan Johnson,D,BUF,23,11,0,3,3
58,8483489,Fraser Minten,C,TOR,31,7,2,0,2
58,8481726,Adam Edstrom,C,NYR,24,13,2,0,2
58,8481462,Mason Morelli,L,VGK,28,10,2,0,2
58,8478454,Noah Juulsen,D,VAN,27,28,1,1,2
58,8479367,William Lockwood,R,FLA,26,22,1,1,2
58,8482147,Jean-Luc Foudy,C,COL,22,20,1,1,2
58,8480468,James Hamblin,L,EDM,25,22,1,1,2
58,8477810,Joel Hanley,D,CGY,33,28,1,1,2
58,8481806,Louis Crevier,D,CHI,23,14,1,1,2
58,8481024,Linus Karlsson,C,VAN,25,10,1,1,2
58,8480823,Alexander Alexeyev,D,WSH,25,15,1,1,2
58,8480851,Akil Thomas,C,LAK,24,16,1,1,2
58,8483597,Milos Kelemen,L,UTA,25,12,1,1,2
58,8480834,Ty Emberson,D,SJS,24,33,0,2,2
58,8477335,Kyle Burroughs,D,LAK,29,41,0,2,2
58,8484911,Collin Graf,R,SJS,22,38,0,2,2
58,8482201,Gage Goncalves,C,TBL,23,26,0,2,2
58,8483567,Georgii Merkulov,C,BOS,24,7,0,2,2
58,8484304,Uvis Balinskis,D,FLA,28,10,0,2,2
58,8484325,Waltteri Merela,C,TBL,26,18,0,2,2
58,8482118,Sam Colangelo,R,ANA,23,16,0,2,2
58,8481578,Graeme Clarke,R,MIN,23,12,0,2,2
58,8481065,Angus Crookshank,L,OTT,25,15,0,2,2
58,8482172,Landon Slaggert,L,CHI,22,22,1,0,1
58,8478051,Max Willman,C,NJD,29,19,1,0,1
58,8481655,Cole Schwindt,R,CGY,23,9,1,0,1
58,8480306,Grant Hutton,D,NYI,29,8,1,0,1
58,8482476,Emil Heineman,L,MTL,23,8,1,0,1
58,8475795,Dylan McIlrath,D,WSH,32,17,1,0,1
58,8483398,Declan Carlile,D,TBL,31,8,1,0,1
58,8484255,Jason Polin,R,COL,25,6,1,0,1
58,8482787,Nikita Chibrikov,R,WPG,31,5,1,0,1
58,8483012,Logan Morrison,C,SEA,22,30,0,1,1
58,8482144,Jack Thompson,D,SJS,22,24,0,1,1
58,8481605,Jackson LaCombe,D,ANA,23,34,0,1,1
58,8477073,Kurtis MacDermid,L,NJD,30,27,0,1,1
58,8479330,Brandon Gignac,C,MTL,27,15,0,1,1
58,8481006,Tyler Tucker,D,STL,24,20,0,1,1
58,8481743,Marc Del Gaizo,D,NSH,25,18,0,1,1
58,8481206,John Ludvig,D,PIT,24,18,0,1,1
58,8478011,Louie Belpedio,D,PHI,28,13,0,1,1
58,8475413,Justin Dowling,C,NJD,34,17,0,1,1
58,8481030,Jack St. Ivany,D,PIT,25,14,0,1,1
58,8474062,Riley Nash,C,NYR,35,17,0,1,1
58,8482126,Emil Andrae,D,PHI,31,2,0,1,1
58,8481593,Jayden Struble,D,MTL,23,28,0,1,1
58,8478147,Bokondji Imama,L,PIT,28,3,0,1,1
58,8477541,Dakota Mermis,D,TOR,30,8,0,1,1
58,8483546,Marshall Rifai,D,TOR,26,6,0,1,1
58,8478854,Ryan Shea,D,PIT,27,11,0,1,1
58,8482061,Brandon Biro,L,SEA,26,10,0,1,1
58,8482197,Adam Raska,R,MIN,23,7,0,1,1
58,8481534,Raphael Lavoie,C,EDM,24,3,0,1,1
58,8477320,Anton Blidh,L,NYR,29,19,0,0,0
58,8479320,Maxime Lajoie,D,SEA,27,20,0,0,0
58,8482165,Yan Kuznetsov,D,CGY,22,17,0,0,0
58,8482460,Matt Rempe,C,NYR,22,12,0,0,0
58,8478477,Mitchell Stephens,C,SEA,27,14,0,0,0
58,8483395,Arshdeep Bains,L,VAN,23,8,0,0,0
58,8478881,Brett Seney,L,CHI,28,17,0,0,0
58,8483512,Matthew Savoie,C,EDM,20,24,0,0,0
58,8483432,Luca Del Bel Belluz,C,CBJ,31,3,0,0,0
58,8480267,Sammy Walker,C,MIN,25,14,0,0,0
58,8475780,Chris Wagner,R,COL,33,9,0,0,0
58,8480075,Cameron Crotty,D,MIN,25,13,0,0,0
58,8482088,Justin Sourdif,R,FLA,22,14,0,0,0
58,8479362,Riley Tufte,L,BOS,26,15,0,0,0
58,8482162,Roby Jarventie,L,EDM,22,12,0,0,0
58,8484259,Ondrej Pavel,C,COL,31,3,0,0,0
58,8479522,Hardy Haman Aktell,D,WSH,26,2,0,0,0
58,8484326,Patrik Koch,D,UTA,28,1,0,0,0
58,8475755,Alexander Petrovic,D,DAL,32,8,0,0,0
58,8480874,Adam Ginning,D,PHI,24,9,0,0,0
58,8479421,Jacob Moverare,D,LAK,26,4,0,0,0
58,8482094,Daemon Hunt,D,MIN,22,16,0,0,0
58,8484321,Nikolas Matinpalo,D,OTT,26,1,0,0,0
58,8481043,Cole Koepke,L,BOS,26,16,0,0,0
58,8483920,Pierrick Dube,R,WSH,23,1,0,0,0
58,8478446,Glenn Gawdin,C,LAK,27,12,0,0,0
58,8477993,Justin Kirkland,C,CGY,28,5,0,0,0
58,8476323,Max McCormick,L,SEA,32,5,0,0,0
58,8483531,Brian Halonen,L,NJD,25,2,0,0,0
58,8483401,Marc Johnstone,R,PIT,28,1,0,0,0
58,8483609,Adam Klapka,R,CGY,24,5,0,0,0
58,8480274,Philip Kemp,D,EDM,25,0,0,0,0
58,8470794,Joe Pavelski,C,,40,0,0,0,0
58,8479321,Lucas Johansen,D,,27,0,0,0,0
58,8477950,Tony DeAngelo,D,,29,0,0,0,0
58,8471218,Blake Wheeler,R,,38,0,0,0,0
58,8475197,Tyson Barrie,D,,33,0,0,0,0
58,8474157,Max Pacioretty,L,,36,0,0,0,0
58,8475744,Evgeny Kuznetsov,C,,32,0,0,0,0
58,8474037,James van Riemsdyk,L,,35,0,0,0,0
58,8476907,Mackenzie MacEachern,L,,30,0,0,0,0
58,8480216,Jacob Peterson,C,,25,0,0,0,0
58,8474602,Justin Schultz,D,,34,0,0,0,0
58,8482222,Alexander Barabanov,L,,30,0,0,0,0
58,8474031,Kevin Shattenkirk,D,,35,0,0,0,0
58,8477330,Dominik Kubalik,L,,29,0,0,0,0
58,8480884,Calen Addison,D,,24,0,0,0,0
58,8475906,John Klingberg,D,,32,0,0,0,0
58,8480008,Adam Ruzicka,C,,25,0,0,0,0
58,8476884,Derrick Pouliot,D,,30,0,0,0,0
58,8476919,Chris Tierney,C,,30,0,0,0,0
58,8479415,Michael McLeod,C,,26,0,0,0,0
58,8474870,Tyler Johnson,C,,34,0,0,0,0
58,8470604,Jeff Carter,C,,39,0,0,0,0
58,8478104,Sammy Blais,L,,28,0,0,0,0
58,8474884,Mike Hoffman,C,,35,0,0,0,0
58,8481591,Sam Poulin,R,,23,0,0,0,0
58,8471274,Alex Goligoski,D,,39,0,0,0,0
58,8476871,Tanner Pearson,L,,32,0,0,0,0
58,8476393,Nick Cousins,C,,31,0,0,0,0
58,8479977,Kailer Yamamoto,R,,26,0,0,0,0
58,8479346,Dillon Dube,C,,26,0,0,0,0
58,8480184,Gustav Lindstrom,D,,26,0,0,0,0
58,8479376,Victor Mete,D,,26,0,0,0,0
58,8473449,Kyle Okposo,R,,36,0,0,0,0
58,8481058,Jesse Ylonen,R,,25,0,0,0,0
58,8475752,Tyler Pitlick,C,,33,0,0,0,0
58,8481239,Samuel Fagemo,L,,24,0,0,0,0
58,8480821,Filip Zadina,R,,25,0,0,0,0
58,8470966,Mark Giordano,D,,41,0,0,0,0
58,8478495,Denis Gurianov,R,,27,0,0,0,0
58,8477464,Nic Petan,C,,29,0,0,0,0
58,8478099,Kevin Labanc,R,,29,0,0,0,0
58,8482241,Radim Zohorna,L,,28,0,0,0,0
58,8474040,Sam Gagner,C,,35,0,0,0,0
58,8479514,Rem Pitlick,C,,27,0,0,0,0
58,8478430,Oliver Kylington,D,,27,0,0,0,0
58,8479533,Joona Koppanen,L,,26,0,0,0,0
58,8479984,Cal Foote,D,,26,0,0,0,0
58,8477126,Jayson Megna,C,,34,0,0,0,0
58,8475164,Jakob Silfverberg,R,,34,0,0,0,0
58,8474009,Nick Bonino,C,,36,0,0,0,0
58,8479458,Nikita Zaitsev,D,,33,0,0,0,0
58,8477944,Jakub Vrana,L,,28,0,0,0,0
58,8471699,Andrew Cogliano,C,,37,0,0,0,0
58,8478067,Oskar Lindblom,L,,28,0,0,0,0
58,8471686,Marc Staal,D,,37,0,0,0,0
58,8470610,Zach Parise,L,,40,0,0,0,0
58,8478904,Steven Lorentz,C,,28,0,0,0,0
58,8473473,Milan Lucic,L,,36,0,0,0,0
58,8480031,Maxime Comtois,L,,25,0,0,0,0
58,8478512,Austin Czarnik,C,,32,0,0,0,0
58,8473504,Cal Clutterbuck,R,,37,0,0,0,0
58,8477454,Adam Erne,L,,29,0,0,0,0
58,8479383,Boris Katchouk,L,,26,0,0,0,0
58,8475825,Jani Hakanpää,D,,32,0,0,0,0
58,8477846,Ryan Carpenter,C,,33,0,0,0,0
58,8477930,Pierre-Edouard Bellemare,L,,39,0,0,0,0
58,8478400,Colin White,C,,27,0,0,0,0
58,8480226,Marián Studenic,R,,26,0,0,0,0
58,8480853,Liam Foudy,C,,24,0,0,0,0
58,8475797,Jarred Tinordi,D,,32,0,0,0,0
58,8479423,Alex Nylander,L,,26,0,0,0,0
58,8474618,Marco Scandella,D,,34,0,0,0,0
58,8478028,Fredrik Olofsson,L,,28,0,0,0,0
58,8474709,Matt Martin,L,,35,0,0,0,0
58,8481070,Hugh McGing,L,,26,0,0,0,0
58,8479546,Oskar Steen,C,,26,0,0,0,0
58,8474145,Robert Bortuzzo,D,,35,0,0,0,0
58,8476915,Jujhar Khaira,L,,30,0,0,0,0
58,8475278,Byron Froese,C,,33,0,0,0,0
58,8481812,Nikolai Knyzhov,D,,27,0,0,0,0
58,8478408,Travis Dermott,D,,28,0,0,0,0
58,8481077,John Leonard,L,,26,0,0,0,0
58,8479547,Matthew Phillips,R,,26,0,0,0,0
58,8480836,Jonathan Gruden,C,,24,0,0,0,0
58,8481690,Tyler Angle,C,,24,0,0,0,0
58,8475766,Austin Watson,L,,32,0,0,0,0
58,8481016,Ruslan Iskhakov,C,,24,0,0,0,0
58,8478078,Rourke Chartier,C,,28,0,0,0,0
58,8480776,Sheldon Rempal,R,,29,0,0,0,0
58,8478956,Samuel Laberge,L,NJD,27,0,0,0,0
58,8483045,Cameron Butler,R,CBJ,31,2,0,0,0
58,8484314,Jiri Smejkal,L,,28,0,0,0,0
59,8476453,Nikita Kucherov,R,TBL,31,82,47,98,145
59,8477492,Nathan MacKinnon,C,COL,29,81,55,85,140
59,8478402,Connor McDavid,C,EDM,27,79,39,94,133
59,8477404,Jake Guentzel,C,TBL,30,82,53,74,127
59,8478420,Mikko Rantanen,R,COL,28,80,50,73,123
59,8477934,Leon Draisaitl,C,EDM,29,79,43,78,121
59,8478483,Mitch Marner,R,TOR,27,78,40,79,119
59,8481559,Jack Hughes,C,NJD,23,74,46,71,117
59,8479318,Auston Matthews,C,TOR,27,79,61,53,114
59,8471675,Sidney Crosby,C,PIT,37,75,44,70,114
59,8478550,Artemi Panarin,L,NYR,33,78,32,80,112
59,8480027,Jason Robertson,L,DAL,25,82,44,65,109
59,8477493,Aleksander Barkov,C,FLA,29,77,33,75,108
59,8477956,David Pastrnak,R,BOS,28,81,50,57,107
59,8482116,Tim Stützle,C,OTT,22,78,43,59,102
59,8480800,Quinn Hughes,D,VAN,25,71,12,89,101
59,8479314,Matthew Tkachuk,L,FLA,27,77,33,67,100
59,8480069,Cale Makar,D,COL,26,72,20,80,100
59,8478010,Brayden Point,C,TBL,28,82,43,53,96
59,8473419,Brad Marchand,L,BOS,36,77,34,61,95
59,8477501,Valeri Nichushkin,R,COL,29,81,44,50,94
59,8476459,Mika Zibanejad,C,NYR,31,78,39,55,94
59,8479385,Jordan Kyrou,C,STL,26,77,53,40,93
59,8478403,Jack Eichel,C,VGK,28,75,44,49,93
59,8476468,J.T. Miller,C,VAN,31,73,34,59,93
59,8477939,William Nylander,R,TOR,28,80,44,48,92
59,8480830,Andrei Svechnikov,R,CAR,24,73,39,51,90
59,8480023,Robert Thomas,C,STL,25,75,30,59,89
59,8480012,Elias Pettersson,C,VAN,26,74,32,56,88
59,8476454,Ryan Nugent-Hopkins,C,EDM,31,79,28,59,87
59,8476887,Filip Forsberg,L,NSH,30,74,38,47,85
59,8478445,Mathew Barzal,C,NYI,27,79,23,61,84
59,8480208,Drake Batherson,R,OTT,26,78,35,48,83
59,8475172,Nazem Kadri,C,CGY,34,78,32,51,83
59,8478460,Zach Werenski,D,CBJ,27,81,22,61,83
59,8477960,Adrian Kempe,R,LAK,28,81,42,40,82
59,8477500,Bo Horvat,C,NYI,29,81,37,45,82
59,8477946,Dylan Larkin,C,DET,28,77,31,51,82
59,8475692,Mats Zuccarello,R,MIN,37,77,24,58,82
59,8478864,Kirill Kaprizov,L,MIN,27,72,35,46,81
59,8484144,Connor Bedard,C,CHI,19,68,26,55,81
59,8482740,Wyatt Johnston,C,DAL,21,81,48,31,79
59,8475168,Matt Duchene,C,DAL,33,82,32,47,79
59,8475166,John Tavares,C,TOR,34,81,36,42,78
59,8474141,Patrick Kane,R,DET,36,79,28,50,78
59,8475167,Victor Hedman,D,TBL,34,77,18,60,78
59,8479420,Tage Thompson,C,BUF,27,69,40,37,77
59,8471214,Alex Ovechkin,L,WSH,39,71,40,37,77
59,8477933,Sam Reinhart,C,FLA,29,79,30,47,77
59,8476448,William Karlsson,C,VGK,31,77,30,47,77
59,8480002,Nico Hischier,C,NJD,25,77,27,50,77
59,8479337,Alex DeBrincat,R,DET,27,82,39,37,76
59,8478398,Kyle Connor,L,WPG,28,70,32,44,76
59,8479323,Adam Fox,D,NYR,26,76,19,57,76
59,8480865,Noah Dobson,D,NYI,24,80,15,61,76
59,8475786,Zach Hyman,L,EDM,32,78,40,35,75
59,8477496,Elias Lindholm,C,BOS,30,81,33,42,75
59,8479343,Clayton Keller,R,UTA,26,79,31,44,75
59,8477402,Pavel Buchnevich,L,STL,29,75,22,53,75
59,8475913,Mark Stone,R,VGK,32,79,25,49,74
59,8477942,Kevin Fiala,L,LAK,28,81,24,50,74
59,8476346,Johnny Gaudreau,L,CBJ,31,76,19,55,74
59,8481557,Matt Boldy,L,MIN,23,68,30,43,73
59,8478427,Sebastian Aho,C,CAR,27,75,31,41,72
59,8476389,Vincent Trocheck,C,NYR,31,78,30,42,72
59,8475765,Vladimir Tarasenko,R,DET,33,81,22,50,72
59,8474600,Roman Josi,D,NSH,34,76,19,53,72
59,8471215,Evgeni Malkin,C,PIT,38,70,19,53,72
59,8475810,Bryan Rust,R,PIT,32,75,37,34,71
59,8478439,Travis Konecny,R,PHI,27,76,32,39,71
59,8474564,Steven Stamkos,C,NSH,34,70,29,42,71
59,8478493,Joel Eriksson Ek,C,MIN,27,69,30,40,70
59,8478975,Mason Marchment,L,DAL,29,82,27,43,70
59,8480036,Miro Heiskanen,D,DAL,25,78,13,57,70
59,8478519,Anthony Cirelli,C,TBL,27,82,35,34,69
59,8477476,Artturi Lehkonen,L,COL,29,81,28,41,69
59,8479999,Casey Mittelstadt,C,COL,26,81,25,44,69
59,8476881,Tomas Hertl,C,VGK,31,77,33,35,68
59,8477949,Alex Tuch,R,BUF,28,72,27,41,68
59,8475745,Charlie Coyle,C,BOS,32,77,19,49,68
59,8476456,Jonathan Huberdeau,C,CGY,31,76,16,52,68
59,8478444,Brock Boeser,R,VAN,27,73,33,34,67
59,8476539,Jonathan Marchessault,R,NSH,34,71,28,39,67
59,8479542,Brandon Hagel,L,TBL,26,82,24,43,67
59,8476460,Mark Scheifele,C,WPG,31,73,23,44,67
59,8480801,Brady Tkachuk,L,OTT,25,80,22,45,67
59,8471685,Anze Kopitar,C,LAK,37,82,18,49,67
59,8479325,Charlie McAvoy,D,BOS,27,74,16,51,67
59,8475184,Chris Kreider,L,NYR,33,77,41,25,66
59,8478414,Timo Meier,R,NJD,28,75,29,37,66
59,8482078,Lucas Raymond,L,DET,22,82,25,41,66
59,8474578,Erik Karlsson,D,PIT,34,78,19,47,66
59,8478449,Roope Hintz,C,DAL,28,82,23,42,65
59,8480018,Nick Suzuki,C,MTL,25,79,23,41,64
59,8473994,Jamie Benn,L,DAL,35,81,21,43,64
59,8482745,Mason McTavish,C,ANA,21,74,33,30,63
59,8477409,Carter Verhaeghe,C,FLA,29,77,30,33,63
59,8477940,Nikolaj Ehlers,L,WPG,28,74,23,39,62
59,8477503,Max Domi,C,TOR,29,79,15,47,62
59,8477955,Jared McCann,L,SEA,28,75,34,27,61
59,8482093,Seth Jarvis,C,CAR,22,71,28,33,61
59,8475754,Brock Nelson,C,NYI,33,78,31,29,60
59,8475794,Tyler Seguin,C,DAL,32,81,30,30,60
59,8474641,Adam Henrique,C,EDM,34,75,25,35,60
59,8482124,Quinton Byfield,R,LAK,22,80,24,36,60
59,8482109,Alexis Lafrenière,L,NYR,23,77,28,31,59
59,8473512,Claude Giroux,R,OTT,36,79,16,43,59
59,8477451,Ryan Hartman,R,MIN,30,72,29,29,58
59,8479407,Jesper Bratt,L,NJD,26,77,24,34,58
59,8478047,Michael Bunting,L,PIT,29,75,19,39,58
59,8481528,Dylan Cozens,C,BUF,23,69,17,41,58
59,8481068,Yegor Sharangovich,C,CGY,26,82,32,25,57
59,8477951,Nick Schmaltz,C,UTA,28,76,29,28,57
59,8475287,Erik Haula,L,NJD,33,75,22,35,57
59,8477416,Oliver Bjorkstrand,R,SEA,29,74,21,36,57
59,8477494,Jonathan Drouin,L,COL,29,79,19,38,57
59,8475798,Mikael Granlund,C,SJS,32,73,16,41,57
59,8479675,Trevor Moore,L,LAK,29,82,28,28,56
59,8475784,Jeff Skinner,C,EDM,32,73,27,29,56
59,8482665,Matty Beniers,C,SEA,22,74,21,35,56
59,8475158,Ryan O'Reilly,C,NSH,33,73,20,36,56
59,8478233,Andrew Mangiapane,L,WSH,28,68,20,36,56
59,8477495,Seth Jones,D,CHI,30,74,11,45,56
59,8476880,Tom Wilson,R,WSH,30,74,28,27,55
59,8479525,Ross Colton,C,COL,28,82,25,29,54
59,8481533,Trevor Zegras,C,ANA,23,73,25,29,54
59,8478042,Viktor Arvidsson,L,EDM,31,72,19,35,54
59,8474586,Jordan Eberle,R,SEA,34,74,18,36,54
59,8477504,Josh Morrissey,D,WPG,29,72,10,44,54
59,8482684,Luke Hughes,D,NJD,21,74,10,44,54
59,8480039,Martin Necas,C,CAR,25,67,26,27,53
59,8481540,Cole Caufield,R,MTL,23,74,20,33,53
59,8478440,Dylan Strome,C,WSH,27,71,19,34,53
59,8475314,Anders Lee,L,NYI,34,79,24,28,52
59,8475726,Tyler Toffoli,C,SJS,32,66,23,29,52
59,8475170,Brayden Schenn,C,STL,33,71,22,30,52
59,8482113,Anton Lundell,C,FLA,23,74,18,34,52
59,8477498,Darnell Nurse,D,EDM,29,76,18,34,52
59,8477511,Anthony Mantha,R,CGY,30,76,17,35,52
59,8477447,Shea Theodore,D,VGK,29,62,8,44,52
59,8474150,Mikael Backlund,C,CGY,35,78,25,26,51
59,8474102,David Perron,L,OTT,36,76,23,28,51
59,8480064,Josh Norris,C,OTT,25,80,23,28,51
59,8474590,John Carlson,D,WSH,34,73,18,33,51
59,8482159,Tyson Foerster,R,PHI,22,77,18,33,51
59,8481711,Matias Maccelli,L,UTA,24,72,15,36,51
59,8476906,Shayne Gostisbehere,D,CAR,31,75,14,37,51
59,8476853,Morgan Rielly,D,TOR,30,73,6,45,51
59,8483808,Andrei Kuzmenko,L,CGY,28,74,27,23,50
59,8478498,Jake DeBrusk,L,VAN,28,72,26,24,50
59,8478462,Nicolas Roy,C,VGK,27,75,16,34,50
59,8478397,Rasmus Andersson,D,CGY,28,71,8,42,50
59,8475151,Kyle Palmieri,C,NYI,33,78,26,23,49
59,8479339,Patrik Laine,L,CBJ,26,66,22,27,49
59,8478401,Pavel Zacha,C,BOS,27,73,15,34,49
59,8478038,Devon Toews,D,COL,30,74,12,37,49
59,8478474,Lawson Crouse,L,UTA,27,70,25,23,48
59,8479365,Trent Frederic,C,BOS,26,78,22,26,48
59,8476479,Phillip Danault,C,LAK,31,81,19,29,48
59,8481581,Thomas Harley,D,DAL,23,75,13,35,48
59,8480803,Evan Bouchard,D,EDM,25,74,7,41,48
59,8476483,Rickard Rakell,R,PIT,31,69,29,18,47
59,8484166,Adam Fantilli,C,CBJ,20,68,20,27,47
59,8481618,Alex Newhook,C,MTL,23,74,19,28,47
59,8479345,Jakob Chychrun,D,WSH,26,63,13,34,47
59,8476432,Boone Jenner,C,CBJ,31,68,29,17,46
59,8479400,Pierre-Luc Dubois,L,WSH,26,72,21,25,46
59,8483431,Logan Cooley,C,UTA,20,77,21,25,46
59,8477346,MacKenzie Weegar,D,CGY,30,74,17,29,46
59,8473986,Alex Killorn,L,ANA,35,74,13,33,46
59,8478407,Vince Dunn,D,SEA,28,78,10,36,46
59,8470613,Brent Burns,D,CAR,39,75,10,36,46
59,8478366,Frank Vatrano,R,ANA,30,72,26,19,45
59,8477935,Sam Bennett,C,FLA,28,81,24,21,45
59,8478466,Daniel Sprong,R,VAN,27,70,24,21,45
59,8476826,Yanni Gourde,C,SEA,33,75,22,23,45
59,8478873,Troy Terry,R,ANA,27,69,18,27,45
59,8477964,Ivan Barbashev,C,VGK,29,78,16,29,45
59,8476979,Erik Gustafsson,D,DET,32,79,8,37,45
59,8476399,Blake Coleman,C,CGY,33,69,23,21,44
59,8477456,J.T. Compher,L,DET,29,81,23,21,44
59,8480015,Owen Tippett,R,PHI,25,72,22,22,44
59,8478856,Conor Garland,R,VAN,28,69,18,26,44
59,8474149,Evgenii Dadonov,R,DAL,35,80,18,26,44
59,8476792,Torey Krug,D,STL,33,73,13,31,44
59,8477021,Alex Kerfoot,C,UTA,30,71,13,31,44
59,8471698,T.J. Oshie,R,WSH,38,71,12,32,44
59,8482712,Oskar Olausson,R,COL,22,74,11,33,44
59,8479410,Mikhail Sergachev,D,UTA,26,72,7,37,44
59,8482092,Ridly Greig,C,OTT,22,80,24,19,43
59,8482175,JJ Peterka,R,BUF,22,71,22,21,43
59,8478469,Thomas Chabot,D,OTT,27,73,13,30,43
59,8471724,Kris Letang,D,PIT,37,79,9,34,43
59,8476905,Chandler Stephenson,C,SEA,30,75,8,35,43
59,8482699,Dylan Guenther,R,UTA,21,72,22,20,42
59,8480797,Joel Farabee,L,PHI,24,80,20,22,42
59,8480028,Morgan Frost,C,PHI,25,72,19,23,42
59,8475760,Nick Bjugstad,C,UTA,32,73,19,23,42
59,8482702,Logan Stankoven,C,DAL,21,81,18,24,42
59,8475768,Jaden Schwartz,C,SEA,32,72,13,29,42
59,8478463,Anthony Beauvillier,L,PIT,27,67,23,18,41
59,8477407,Anthony Duclair,L,NYI,29,78,20,21,41
59,8483505,Matthew Poitras,C,BOS,20,80,14,27,41
59,8477986,Brandon Montour,D,SEA,30,78,10,31,41
59,8474563,Drew Doughty,D,LAK,35,74,10,31,41
59,8483515,Juraj Slafkovsky,L,MTL,20,73,17,23,40
59,8481577,Philip Tomasino,C,NSH,23,71,17,23,40
59,8482720,Matthew Knies,L,TOR,22,74,14,26,40
59,8475191,Reilly Smith,R,NYR,33,76,13,27,40
59,8477488,Brett Pesce,D,NJD,30,67,13,27,40
59,8477497,Sean Monahan,C,CBJ,30,63,12,28,40
59,8480839,Rasmus Dahlin,D,BUF,24,69,10,30,40
59,8476872,Scott Laughton,C,PHI,30,72,10,30,40
59,8479425,Filip Hronek,D,VAN,27,77,8,32,40
59,8481542,Moritz Seider,D,DET,23,78,4,36,40
59,8475169,Evander Kane,L,EDM,33,72,24,15,39
59,8482149,Cole Perfetti,C,WPG,22,65,19,20,39
59,8480849,Barrett Hayton,C,UTA,24,74,17,22,39
59,8477479,Tyler Bertuzzi,L,CHI,29,56,16,23,39
59,8476419,Jean-Gabriel Pageau,C,NYI,32,78,16,23,39
59,8481524,Bowen Byram,D,BUF,23,69,15,24,39
59,8481596,Shane Pinto,C,OTT,24,69,11,28,39
59,8476462,Dougie Hamilton,D,NJD,31,71,10,29,39
59,8482122,Brock Faber,D,MIN,22,78,10,29,39
59,8478396,Noah Hanifin,D,VGK,27,60,7,32,39
59,8478472,Mathieu Joseph,R,STL,27,69,6,33,39
59,8480188,Fabian Zetterlund,L,SJS,25,67,20,18,38
59,8475722,Jason Zucker,L,BUF,32,70,20,18,38
59,8480798,Philipp Kurashev,C,CHI,25,61,14,24,38
59,8476923,Damon Severson,D,CBJ,30,80,13,25,38
59,8476927,Teddy Blueger,C,VAN,30,71,12,26,38
59,8482105,Jake Sanderson,D,OTT,22,74,11,27,38
59,8476875,Mike Matheson,D,MTL,30,77,7,31,38
59,8475799,Nino Niederreiter,R,WPG,32,70,27,10,37
59,8482667,William Eklund,L,SJS,22,69,20,17,37
59,8480014,Gabriel Vilardi,C,WPG,25,68,20,17,37
59,8477952,Robby Fabbri,C,ANA,28,57,20,17,37
59,8481535,Nils Hoglander,L,VAN,24,71,17,20,37
59,8479591,Michael Eyssimont,C,TBL,28,81,16,21,37
59,8482475,Yegor Chinakhov,R,CBJ,23,67,15,22,37
59,8484153,Leo Carlsson,C,ANA,20,68,14,23,37
59,8478046,Danton Heinen,L,VAN,29,70,14,23,37
59,8474679,Gustav Nyquist,C,NSH,35,73,13,24,37
59,8476458,Ryan Strome,C,ANA,31,69,9,28,37
59,8477948,Travis Sanheim,D,PHI,28,71,6,31,37
59,8480835,Jack Drury,C,CAR,24,58,22,14,36
59,8482110,Dawson Mercer,C,NJD,23,74,17,19,36
59,8475763,Kevin Hayes,R,PIT,32,65,14,22,36
59,8478542,Evan Rodrigues,C,FLA,31,76,14,22,36
59,8480220,Noah Cates,L,PHI,25,72,13,23,36
59,8484145,Zach Benson,L,BUF,19,69,13,23,36
59,8476292,Ondrej Palat,L,NJD,33,69,13,23,36
59,8477998,Warren Foegele,L,LAK,28,80,12,24,36
59,8480434,Sean Durzi,D,UTA,26,70,7,29,36
59,8481186,Logan O'Connor,R,COL,28,80,19,16,35
59,8479987,Morgan Geekie,C,BOS,26,73,18,17,35
59,8476981,Josh Anderson,R,MTL,30,70,18,17,35
59,8477426,Nicholas Paul,L,TBL,29,82,15,20,35
59,8476461,Sean Couturier,C,PHI,32,71,15,20,35
59,8479390,Taylor Raddysh,R,WSH,26,69,15,20,35
59,8482146,Luke Evangelista,R,NSH,22,71,14,21,35
59,8481523,Kirby Dach,C,MTL,23,65,13,22,35
59,8482660,Kent Johnson,C,CBJ,22,69,11,24,35
59,8475218,Mattias Ekholm,D,EDM,34,72,9,26,35
59,8475753,Justin Faulk,D,STL,32,73,8,27,35
59,8478055,Gustav Forsling,D,FLA,28,64,7,28,35
59,8480459,Pius Suter,C,VAN,28,69,16,18,34
59,8481604,Pavel Dorofeyev,L,VGK,24,70,15,19,34
59,8479351,Sam Steel,C,DAL,26,79,15,19,34
59,8477429,Andrew Copp,C,DET,30,78,9,25,34
59,8482671,Owen Power,D,BUF,22,61,8,26,34
59,8475343,Nic Dowd,C,WSH,34,60,18,15,33
59,8474715,Cameron Atkinson,R,TBL,35,82,16,17,33
59,8481582,Nicholas Robertson,L,TOR,23,66,16,17,33
59,8480802,Ryan McLeod,C,BUF,25,64,15,18,33
59,8477947,Sonny Milano,L,WSH,28,65,14,19,33
59,8476958,Jaccob Slavin,D,CAR,30,74,13,20,33
59,8477932,Aaron Ekblad,D,FLA,28,72,11,22,33
59,8478413,Jordan Greenway,L,BUF,27,68,11,22,33
59,8482133,Thomas Bordeleau,C,SJS,22,67,10,23,33
59,8477839,Conor Sheary,L,TBL,32,77,10,23,33
59,8479315,Joey Anderson,R,CHI,26,57,8,25,33
59,8478458,John (Jack) Roslovic,C,CAR,27,69,6,27,33
59,8476869,Brady Skjei,D,NSH,30,71,6,27,33
59,8475764,Cam Fowler,D,ANA,33,72,5,28,33
59,8476438,Brandon Saad,L,STL,32,66,21,11,32
59,8480009,Eeli Tolvanen,R,SEA,25,67,20,12,32
59,8477444,Andre Burakovsky,L,SEA,29,65,17,15,32
59,8476480,Vladislav Namestnikov,C,WPG,32,64,17,15,32
59,8477989,Christian Dvorak,C,MTL,28,68,16,16,32
59,8476882,Teuvo Teravainen,C,CHI,30,63,15,17,32
59,8482125,Alexander Holtz,R,VGK,22,70,13,19,32
59,8480855,Jack McBain,C,UTA,24,71,10,22,32
59,8481703,Valtteri Puustinen,R,PIT,25,62,8,24,32
59,8474716,Jared Spurgeon,D,MIN,35,79,7,25,32
59,8481560,Arthur Kaliyev,R,LAK,23,77,17,14,31
59,8477987,Ryan Donato,C,CHI,28,66,16,15,31
59,8482097,Jack Quinn,R,BUF,23,66,12,19,31
59,8482055,Drew O'Connor,L,PIT,26,65,12,19,31
59,8476925,Colton Sissons,C,NSH,31,72,12,19,31
59,8474565,Alex Pietrangelo,D,VGK,34,64,11,20,31
59,8476885,Jacob Trouba,D,NYR,30,69,8,23,31
59,8478416,Erik Cernak,D,TBL,27,73,5,26,31
59,8474151,Ryan McDonagh,D,TBL,35,78,3,28,31
59,8477953,Kasperi Kapanen,R,STL,28,64,18,12,30
59,8480829,Jesperi Kotkaniemi,C,CAR,24,69,17,13,30
59,8480113,Alex Iafallo,L,WPG,31,65,17,13,30
59,8478115,Pierre Engvall,L,NYI,28,77,15,15,30
59,8480185,Eetu Luostarinen,C,FLA,26,74,12,18,30
59,8476392,Adam Lowry,C,WPG,31,64,12,18,30
59,8482749,Joshua Roy,R,MTL,21,62,12,18,30
59,8480145,Neal Pionk,D,WPG,29,75,10,20,30
59,8477505,Alexander Wennberg,C,SJS,30,65,10,20,30
59,8478891,Mason Appleton,C,WPG,28,65,8,22,30
59,8480336,Sean Walker,D,CAR,30,72,7,23,30
59,8478438,Tommy Novak,C,NSH,27,68,6,24,30
59,8476854,Hampus Lindholm,D,BOS,30,78,3,27,30
59,8475181,Nick Leddy,D,STL,33,66,1,29,30
59,8476960,Andreas Athanasiou,C,CHI,30,50,16,13,29
59,8477425,Miles Wood,L,COL,29,74,16,13,29
59,8477450,Jason Dickinson,C,CHI,29,57,15,14,29
59,8475793,Ryan Johansen,C,PHI,32,72,13,16,29
59,8476897,Oskar Sundqvist,C,STL,30,73,13,16,29
59,8476469,Joel Armia,R,MTL,31,61,12,17,29
59,8480068,Ryan Poehling,C,PHI,25,66,11,18,29
59,8474053,Logan Couture,C,SJS,35,62,10,19,29
59,8475220,Marcus Foligno,L,MIN,33,62,10,19,29
59,8477919,Frederick Gaudreau,C,MIN,31,62,10,19,29
59,8475171,Oliver Ekman-Larsson,D,TOR,33,68,7,22,29
59,8480873,Rasmus Sandin,D,WSH,24,63,4,25,29
59,8477969,Marcus Pettersson,D,PIT,28,75,4,25,29
59,8476917,Adam Pelech,D,NYI,30,77,3,26,29
59,8477506,Ryan Pulock,D,NYI,30,77,3,26,29
59,8476474,Stefan Noesen,R,NJD,31,69,16,12,28
59,8480893,Kirill Marchenko,R,CBJ,24,63,15,13,28
59,8478057,Dakota Joshua,C,VAN,28,69,13,15,28
59,8478109,Victor Olofsson,L,VGK,29,73,13,15,28
59,8479393,Noah Gregor,L,OTT,26,68,13,15,28
59,8481481,Blake Lizotte,C,PIT,27,58,12,16,28
59,8479992,Michael Rasmussen,C,DET,25,78,10,18,28
59,8484203,Bradly Nadeau,L,CAR,19,58,10,18,28
59,8473533,Jordan Staal,C,CAR,36,62,10,18,28
59,8483445,Cutter Gauthier,L,ANA,20,67,10,18,28
59,8479353,Brett Howden,C,VGK,26,67,9,19,28
59,8475149,Marcus Johansson,L,MIN,34,66,9,19,28
59,8470621,Corey Perry,R,EDM,39,74,8,20,28
59,8479398,Samuel Girard,D,COL,26,67,4,24,28
59,8480035,Henri Jokiharju,D,BUF,25,65,3,25,28
59,8475848,Brendan Gallagher,R,MTL,32,61,16,11,27
59,8483565,Nick Blankenburg,D,NSH,26,59,16,11,27
59,8473422,Nick Foligno,L,CHI,37,58,15,12,27
59,8480748,Kiefer Sherwood,L,VAN,29,53,15,12,27
59,8478020,Michael Amadio,R,OTT,28,69,12,15,27
59,8481554,Kaapo Kakko,R,NYR,23,75,12,15,27
59,8482705,Cole Sillinger,C,CBJ,21,69,11,16,27
59,8483524,Shane Wright,C,SEA,20,58,11,16,27
59,8480789,Oliver Wahlstrom,R,NYI,24,68,10,17,27
59,8478013,Jake Walman,D,SJS,28,74,9,18,27
59,8481546,Cam York,D,PHI,23,67,7,20,27
59,8479402,Jake Bean,D,CGY,26,66,7,20,27
59,8478133,Jake Evans,C,MTL,28,76,3,24,27
59,8476331,Dylan DeMelo,D,WPG,31,66,2,25,27
59,8480222,Sebastian Aho,D,PIT,28,77,2,25,27
59,8478500,Ivan Provorov,D,CBJ,27,79,1,26,27
59,8482079,Marco Rossi,C,MIN,23,56,19,7,26
59,8477478,William Carrier,L,CAR,30,56,15,11,26
59,8477903,Garnet Hathaway,R,PHI,33,64,13,13,26
59,8481553,Bobby Brink,R,PHI,23,61,11,15,26
59,8480205,Emil Bemstrom,C,PIT,25,60,10,16,26
59,8478970,Jalen Chatfield,D,CAR,28,75,6,20,26
59,8483490,Pavel Mintyukov,D,ANA,21,70,5,21,26
59,8478911,Matt Roy,D,WSH,29,70,5,21,26
59,8475790,Erik Gudbranson,D,CBJ,32,76,5,21,26
59,8478507,John Marino,D,UTA,27,67,2,24,26
59,8480049,Dylan Samberg,D,WPG,25,67,2,24,26
59,8479941,Justin Danforth,R,CBJ,31,55,14,11,25
59,8481517,Brett Leason,R,ANA,25,51,13,12,25
59,8481580,Connor McMichael,C,WSH,23,61,12,13,25
59,8476889,Radek Faksa,C,STL,30,68,12,13,25
59,8481656,Aliaksei Protas,C,WSH,23,64,8,17,25
59,8482101,Danil Gushchin,L,SJS,22,64,7,18,25
59,8476312,Josh Manson,D,COL,33,69,6,19,25
59,8476463,Jonas Brodin,D,MIN,31,79,5,20,25
59,8482111,Justin Barron,D,MTL,23,70,5,20,25
59,8482073,Braden Schneider,D,NYR,23,69,5,20,25
59,8477435,Ryan Graves,D,PIT,29,78,4,21,25
59,8477353,Tyler Motte,C,DET,29,69,16,8,24
59,8476278,Colin Blackwell,C,DAL,31,78,16,8,24
59,8482089,Jake Neighbours,L,STL,22,71,15,9,24
59,8481624,Ilya Mikheyev,R,CHI,30,52,11,13,24
59,8479661,Tanner Jeannot,L,LAK,27,73,11,13,24
59,8480003,Jesper Boqvist,C,FLA,26,72,11,13,24
59,8475714,Calle Jarnkrok,C,TOR,33,77,9,15,24
59,8483493,Frank Nazar,C,CHI,20,52,9,15,24
59,8477507,Nikita Zadorov,D,BOS,29,69,8,16,24
59,8476422,Mike Reilly,D,NYI,31,74,7,17,24
59,8475279,Ben Chiarot,D,DET,33,69,6,18,24
59,8482624,Daniil Miromanov,D,CGY,27,65,5,19,24
59,8470600,Ryan Suter,D,STL,39,66,5,19,24
59,8476892,Colton Parayko,D,STL,31,71,3,21,24
59,8476878,Zemgus Girgensons,C,TBL,30,82,17,6,23
59,8482259,Bobby McMann,C,TOR,28,58,17,6,23
59,8476822,Luke Glendening,C,TBL,35,76,13,10,23
59,8476918,Jimmy Vesey,L,NYR,31,72,11,12,23
59,8479414,Nathan Bastian,R,NJD,27,63,11,12,23
59,8480078,Filip Chytil,C,NYR,25,67,9,14,23
59,8473563,Nicklas Backstrom,C,WSH,37,54,9,14,23
59,8475225,Craig Smith,C,CHI,35,58,9,14,23
59,8477979,Nicolas Aube-Kubel,R,BUF,28,64,8,15,23
59,8482679,Matt Coronato,R,CGY,22,62,8,15,23
59,8481617,Vasily Podkolzin,R,VAN,23,60,8,15,23
59,8476457,Adam Larsson,D,SEA,32,63,6,17,23
59,8474574,Tyler Myers,D,VAN,34,70,6,17,23
59,8479998,Mikey Anderson,D,LAK,25,58,4,19,23
59,8476902,Esa Lindell,D,DAL,30,79,3,20,23
59,8481014,Alexander Romanov,D,NYI,24,76,2,21,23
59,8480878,Nils Lundkvist,D,DAL,24,70,2,21,23
59,8478432,Christian Fischer,R,DET,27,75,12,10,22
59,8477406,Mattias Janmark,C,EDM,32,71,11,11,22
59,8482117,Lukas Reichel,L,CHI,22,55,11,11,22
59,8482074,Connor Zary,C,CGY,23,61,10,12,22
59,8479293,Brandon Tanev,L,SEA,33,59,9,13,22
59,8482142,Jamie Drysdale,D,PHI,22,65,8,14,22
59,8475855,Jesper Fast,R,CAR,33,59,8,14,22
59,8480871,Adam Boqvist,D,FLA,24,74,8,14,22
59,8475231,Casey Cizikas,C,NYI,33,74,7,15,22
59,8482655,Janis Moser,D,TBL,24,77,6,16,22
59,8478851,Alexandre Carrier,D,NSH,28,66,6,16,22
59,8479639,Dylan Coghlan,D,WPG,26,65,4,18,22
59,8478178,Darren Raddysh,D,TBL,28,69,3,19,22
59,8475200,Dmitry Orlov,D,CAR,33,76,2,20,22
59,8480043,Timothy Liljegren,D,TOR,25,65,2,20,22
59,8479619,Michael Carcone,L,UTA,28,63,14,7,21
59,8481601,Simon Holmstrom,R,NYI,23,71,12,9,21
59,8477392,Hudson Fasching,R,NYI,29,56,10,11,21
59,8477015,Connor Brown,R,EDM,30,67,10,11,21
59,8480817,K'Andre Miller,D,NYR,24,66,9,12,21
59,8477380,Jonny Brodzinski,C,NYR,31,56,8,13,21
59,8483491,Ivan Miroshnichenko,L,WSH,20,54,6,15,21
59,8475193,Tomas Tatar,L,NJD,34,65,5,16,21
59,8476525,Colin Miller,D,WPG,32,71,4,17,21
59,8475179,Dmitry Kulikov,D,FLA,34,61,4,17,21
59,8482067,Connor Mackey,D,NYR,28,58,3,18,21
59,8481606,Jordan Spence,D,LAK,23,64,2,19,21
59,8473507,Jeff Petry,D,DET,37,68,1,20,21
59,8480281,Alexey Toropchenko,R,STL,25,61,14,6,20
59,8474189,Lars Eller,C,PIT,35,62,13,7,20
59,8482148,Hendrix Lapierre,C,WSH,22,52,11,9,20
59,8478508,Yakov Trenin,C,MIN,27,63,9,11,20
59,8481441,Joe Snively,C,DET,28,72,9,11,20
59,8481704,Juuso Parssinen,C,NSH,23,58,9,11,20
59,8481093,Rafael Harvey-Pinard,L,MTL,25,56,8,12,20
59,8476994,Vinnie Hinostroza,C,NSH,30,42,8,12,20
59,8479066,Ryan Lomberg,L,CGY,30,70,7,13,20
59,8480448,Parker Kelly,L,COL,25,77,6,14,20
59,8479983,Mario Ferraro,D,SJS,26,65,6,14,20
59,8482807,Ethan Del Mastro,D,CHI,21,51,6,14,20
59,8475791,Taylor Hall,L,CHI,33,58,5,15,20
59,8477931,Tomas Nosek,L,FLA,32,67,5,15,20
59,8478136,Jake Middleton,D,MIN,28,77,4,16,20
59,8479980,Nicolas Hague,D,VGK,26,64,4,16,20
59,8479249,Andrew Poturalski,C,SJS,30,39,2,18,20
59,8477845,Trevor van Riemsdyk,D,WSH,33,58,1,19,20
59,8479368,Max Jones,L,BOS,26,69,10,9,19
59,8480813,Joe Veleno,C,DET,24,71,9,10,19
59,8479316,Luke Kunin,C,SJS,27,53,8,11,19
59,8479996,Cody Glass,C,NSH,25,65,8,11,19
59,8481522,Peyton Krebs,C,BUF,23,63,8,11,19
59,8483499,Liam Ohgren,L,MIN,20,52,8,11,19
59,8475462,Radko Gudas,D,ANA,34,65,6,13,19
59,8479370,Tyson Jost,C,CAR,26,54,6,13,19
59,8483468,Jiri Kulich,C,BUF,20,53,3,16,19
59,8475208,Brian Dumoulin,D,ANA,33,66,3,16,19
59,8482155,Alex Laferriere,R,LAK,23,65,11,7,18
59,8473453,Trevor Lewis,C,LAK,37,67,9,9,18
59,8480806,Isac Lundestrom,C,ANA,25,66,8,10,18
59,8479328,Julien Gauthier,R,NYI,27,63,8,10,18
59,8476921,Jordan Martinook,L,CAR,32,58,7,11,18
59,8477220,Nate Schmidt,D,FLA,33,60,7,11,18
59,8484149,Gavin Brindley,C,CBJ,20,53,6,12,18
59,8476467,Jamie Oleksiak,D,SEA,32,71,4,14,18
59,8479369,Andrew Peeke,D,BOS,26,65,4,14,18
59,8480246,Nick Perbix,D,TBL,26,68,3,15,18
59,8476891,Matthew Grzelcyk,D,PIT,30,75,3,15,18
59,8475324,Nick Jensen,D,OTT,34,65,3,15,18
59,8475690,Chris Tanev,D,TOR,35,63,3,15,18
59,8475233,David Savard,D,MTL,34,66,2,16,18
59,8479976,Juuso Valimaki,D,UTA,26,64,2,16,18
59,8476931,Jake McCabe,D,TOR,31,67,2,16,18
59,8481568,Alex Vlasic,D,CHI,23,54,2,16,18
59,8483457,Lane Hutson,D,MTL,20,63,9,8,17
59,8478043,Sam Lafferty,C,BUF,29,57,9,8,17
59,8481013,Jonatan Berggren,R,DET,24,59,9,8,17
59,8477573,Nathan Walker,L,STL,30,52,9,8,17
59,8476374,Sean Kuraly,C,CBJ,31,55,8,9,17
59,8481032,Paul Cotter,C,NJD,25,63,7,10,17
59,8483482,Tristan Luneau,D,ANA,20,64,7,10,17
59,8481751,Lukas Rousek,R,BUF,25,37,7,10,17
59,8479982,Conor Timmins,D,TOR,26,51,6,11,17
59,8476429,Scott Mayfield,D,NYI,32,72,6,11,17
59,8480807,Mattias Samuelsson,D,BUF,24,56,5,12,17
59,8477369,Carson Soucy,D,VAN,30,57,4,13,17
59,8477365,Connor Clifton,D,BUF,29,56,4,13,17
59,8477499,Rasmus Ristolainen,D,PHI,30,64,3,14,17
59,8482737,Zack Bolduc,C,STL,21,55,2,15,17
59,8475455,Brenden Dillon,D,NJD,34,58,2,15,17
59,8479324,Ryan Lindgren,D,NYR,26,60,2,15,17
59,8482245,Artem Zub,D,OTT,29,68,2,15,17
59,8478443,Brandon Carlo,D,BOS,28,58,1,16,17
59,8478452,Caleb Jones,D,LAK,27,65,8,8,16
59,8475842,Sam Carrick,C,NYR,32,61,8,8,16
59,8479543,Michael Pezzetta,L,MTL,26,67,8,8,16
59,8480995,Pontus Holmberg,R,TOR,25,59,6,10,16
59,8482192,Isaak Phillips,D,CHI,23,53,6,10,16
59,8480252,Cole Guttman,C,CHI,25,47,6,10,16
59,8482634,Alex Steeves,C,TOR,25,52,6,10,16
59,8476329,Travis Boyd,C,MIN,31,58,5,11,16
59,8476442,Matt Nieto,L,PIT,32,60,5,11,16
59,8478882,Vladislav Gavrikov,D,LAK,29,68,4,12,16
59,8479371,Dante Fabbro,D,NSH,26,58,4,12,16
59,8477508,Curtis Lazar,C,NJD,29,53,4,12,16
59,8474673,TJ Brodie,D,CHI,34,59,3,13,16
59,8480074,Alexandre Texier,C,STL,25,49,3,13,16
59,8482451,Mikael Pyyhtia,L,CBJ,23,48,2,14,16
59,8474013,Ian Cole,D,UTA,35,53,2,14,16
59,8480879,Jacob Bernard-Docker,D,OTT,24,43,0,16,16
59,8482762,Simon Edvinsson,D,DET,21,57,10,5,15
59,8480025,MacKenzie Entwistle,R,FLA,25,62,8,7,15
59,8483619,Filip Roos,D,OTT,25,40,8,7,15
59,8476873,Mark Jankowski,C,NSH,30,57,7,8,15
59,8480980,Connor Dewar,C,TOR,25,67,6,9,15
59,8480192,Johnathan Kovacevic,D,NJD,27,51,5,10,15
59,8482062,Cole Smith,L,NSH,29,52,5,10,15
59,8476856,Mathew Dumba,D,DAL,30,72,4,11,15
59,8481521,Ronnie Attard,D,PHI,25,63,4,11,15
59,8481537,Nikita Okhotiuk,D,CGY,24,48,4,11,15
59,8482176,Wyatt Kaiser,D,CHI,22,52,2,13,15
59,8480891,Michael Kesselring,D,UTA,24,58,1,14,15
59,8476967,Brett Kulak,D,EDM,30,67,1,14,15
59,8479336,Carl Grundstrom,R,SJS,27,54,9,5,14
59,8481028,Martin Pospisil,C,CGY,25,61,9,5,14
59,8477446,Michael McCarron,R,NSH,29,50,8,6,14
59,8482157,Will Cuylle,L,NYR,22,60,8,6,14
59,8482964,Arber Xhekaj,D,MTL,23,51,6,8,14
59,8482803,Olen Zellweger,D,ANA,21,65,5,9,14
59,8482809,Jackson Blake,R,CAR,21,52,5,9,14
59,8481527,Kaedan Korczak,D,VGK,23,42,5,9,14
59,8481550,Adam Beckman,L,NJD,23,37,5,9,14
59,8480157,Calle Rosen,D,COL,30,40,5,9,14
59,8480762,Eric Robinson,L,CAR,29,59,4,10,14
59,8480727,Zach Whitecloud,D,VGK,28,55,4,10,14
59,8482087,Kaiden Guhle,D,MTL,22,64,3,11,14
59,8479026,Philippe Myers,D,TOR,27,49,3,11,14
59,8471709,Marc-Edouard Vlasic,D,SJS,37,65,2,12,14
59,8480001,Urho Vaakanainen,D,ANA,25,60,0,14,14
59,8481716,Dmitri Voronkov,L,CBJ,24,44,9,4,13
59,8478569,Noel Acciari,C,PIT,33,58,8,5,13
59,8481477,Nico Sturm,C,SJS,29,52,7,6,13
59,8479968,Vinni Lettieri,C,BOS,29,48,7,6,13
59,8481641,Joel Kiviranta,L,COL,28,66,7,6,13
59,8482077,Dylan Holloway,L,EDM,23,49,7,6,13
59,8483549,Lucas Condotta,L,MTL,27,34,7,6,13
59,8475188,Brayden McNabb,D,VGK,33,47,5,8,13
59,8478859,Niko Mikkola,D,FLA,28,61,5,8,13
59,8479944,Zach Aston-Reese,C,VGK,30,53,5,8,13
59,8474166,Alec Martinez,D,CHI,37,55,5,8,13
59,8479359,Beck Malenstyn,L,BUF,26,40,5,8,13
59,8478434,Keegan Kolesar,R,VGK,27,62,4,9,13
59,8482730,Brandt Clarke,D,LAK,21,48,4,9,13
59,8480172,Jan Rutta,D,SJS,34,64,3,10,13
59,8481178,Egor Zamula,D,PHI,24,49,1,12,13
59,8471677,Jack Johnson,D,CBJ,37,64,1,12,13
59,8480860,Kevin Bahl,D,CGY,24,65,1,12,13
59,8481059,Scott Perunovich,D,STL,26,56,0,13,13
59,8480289,Morgan Barron,C,WPG,26,49,8,4,12
59,8479439,Jacob MacDonald,D,COL,31,51,7,5,12
59,8480441,Trey Fix-Wolansky,R,CBJ,25,43,6,6,12
59,8482859,Zack Ostapchuk,C,OTT,21,55,6,6,12
59,8482496,Nils Aman,C,VAN,24,38,6,6,12
59,8476988,Matt Benning,D,SJS,30,61,5,7,12
59,8477018,Ben Hutton,D,VGK,31,50,5,7,12
59,8476934,Brock McGinn,L,ANA,30,50,5,7,12
59,8479772,Zack MacEwen,R,OTT,28,50,5,7,12
59,8479372,Joshua Mahura,D,SEA,26,46,4,8,12
59,8481019,David Gustafsson,C,WPG,24,48,4,8,12
59,8481708,Zac Jones,D,NYR,24,52,3,9,12
59,8481161,Jake Christiansen,D,CBJ,25,57,3,9,12
59,8476952,Dominic Toninato,C,WPG,30,36,3,9,12
59,8480144,David Kampf,C,TOR,29,68,2,10,12
59,8474612,Travis Hamonic,D,OTT,34,49,2,10,12
59,8480196,Jacob Bryson,D,BUF,27,44,2,10,12
59,8480073,Erik Brannstrom,D,COL,25,58,1,11,12
59,8478421,A.J. Greer,L,FLA,28,57,8,3,11
59,8477482,Zachary Sanford,L,CHI,30,38,6,5,11
59,8482747,Brennan Othmann,L,NYR,21,33,4,7,11
59,8480070,Ian Mitchell,D,BOS,25,41,3,8,11
59,8480355,Mark Kastelic,C,BOS,25,59,2,9,11
59,8481599,Victor Soderstrom,D,UTA,23,49,2,9,11
59,8478468,Jeremy Lauzon,D,NSH,27,49,2,9,11
59,8482511,Mason Lohrei,D,BOS,23,29,2,9,11
59,8476874,Olli Maatta,D,DET,30,55,1,10,11
59,8475762,Derek Forbort,D,VAN,32,44,1,10,11
59,8480950,Ilya Lyubushkin,D,DAL,30,63,0,11,11
59,8480011,Klim Kostin,C,SJS,25,53,6,4,10
59,8483397,Marc McLaughlin,C,BOS,25,33,6,4,10
59,8480021,Jack Studnicka,C,LAK,25,57,5,5,10
59,8479671,Mathieu Olivier,R,CBJ,27,36,5,5,10
59,8483466,Kevin Korchinski,D,CHI,20,42,5,5,10
59,8482095,Tyler Kleven,D,OTT,22,43,4,6,10
59,8482177,Marat Khusnutdinov,C,MIN,22,39,4,6,10
59,8478409,Anthony Richard,C,PHI,28,38,4,6,10
59,8483460,David Jiricek,D,CBJ,21,55,3,7,10
59,8473446,Erik Johnson,D,PHI,36,57,3,7,10
59,8482765,Isak Rosen,R,BUF,21,27,3,7,10
59,8481600,Tobias Bjornfot,D,FLA,23,41,3,7,10
59,8474567,Zach Bogosian,D,MIN,34,62,2,8,10
59,8483495,Simon Nemec,D,NJD,20,53,2,8,10
59,8480887,Jordan Harris,D,MTL,24,55,2,8,10
59,8478451,Ethan Bear,D,WSH,27,46,1,9,10
59,8478840,Will Borgen,D,SEA,28,56,1,9,10
59,8480058,Pierre-Olivier Joseph,D,STL,25,58,1,9,10
59,8481567,Henry Thrun,D,SJS,23,53,1,9,10
59,8482744,James Malatesta,L,CBJ,21,36,7,2,9
59,8479994,Jaret Anderson-Dolan,C,WPG,25,43,6,3,9
59,8481592,Jakob Pelletier,L,CGY,23,45,4,5,9
59,8476867,Brendan Gaunce,C,MIN,30,35,4,5,9
59,8479520,Brandon Duhaime,R,WSH,27,45,3,6,9
59,8480007,Jonas Rondbjerg,R,VGK,25,40,3,6,9
59,8479442,Troy Stecher,D,EDM,30,52,3,6,9
59,8476879,Cody Ceci,D,EDM,31,70,2,7,9
59,8474090,Brendan Smith,D,DAL,35,44,2,7,9
59,8475177,Calvin de Haan,D,COL,33,42,2,7,9
59,8481605,Jackson LaCombe,D,ANA,23,30,2,7,9
59,8484254,Akito Hirose,D,VAN,25,40,1,8,9
59,8478585,Derek Ryan,C,EDM,38,60,8,0,8
59,8478831,Kevin Stenlund,C,UTA,28,59,6,2,8
59,8479638,Justin Brazeau,R,BOS,26,38,6,2,8
59,8482784,Zach Dean,C,STL,21,37,5,3,8
59,8477971,Andreas Englund,D,LAK,28,41,4,4,8
59,8483630,Pavol Regenda,L,ANA,25,33,4,4,8
59,8480848,Ty Dellandrea,C,SJS,24,40,3,5,8
59,8478211,Dryden Hunt,L,CGY,29,50,3,5,8
59,8477887,Patrick Brown,C,BOS,32,44,3,5,8
59,8482861,Vincent Iorio,D,WSH,22,36,3,5,8
59,8475718,Justin Holl,D,DET,32,56,2,6,8
59,8478399,Jonas Siegenthaler,D,NJD,27,60,2,6,8
59,8477962,Brendan Lemieux,L,CAR,28,44,2,6,8
59,8481122,Simon Benoit,D,TOR,26,48,2,6,8
59,8476913,Devin Shore,C,MIN,30,35,2,6,8
59,8481598,Philip Broberg,D,EDM,23,45,1,7,8
59,8475750,Jon Merrill,D,MIN,32,68,1,7,8
59,8482141,Lukas Cormier,D,VGK,22,27,1,7,8
59,8481167,Brayden Pachal,D,CGY,25,43,0,8,8
59,8476858,Phillip Di Giuseppe,L,VAN,31,40,6,1,7
59,8482153,Brendan Brisson,C,VGK,23,26,6,1,7
59,8482070,Mitchell Chaffee,R,TBL,26,46,5,2,7
59,8471817,Ryan Reaves,R,TOR,37,57,5,2,7
59,8482652,Walker Duehr,R,CGY,27,39,5,2,7
59,8478021,William Lagesson,D,DET,28,30,5,2,7
59,8479718,Alex Barré-Boulet,C,MTL,27,46,4,3,7
59,8476624,Barclay Goodrow,C,SJS,31,42,3,4,7
59,8476473,Connor Murphy,D,CHI,31,38,3,4,7
59,8481541,Samuel Bolduc,D,NYI,24,27,3,4,7
59,8483012,Logan Morrison,C,SEA,22,41,3,4,7
59,8481743,Marc Del Gaizo,D,NSH,25,28,3,4,7
59,8480796,Martin Fehervary,D,WSH,25,49,2,5,7
59,8474034,Patrick Maroon,L,CHI,36,46,2,5,7
59,8480844,Grigori Denisenko,L,VGK,24,34,2,5,7
59,8479986,Kole Lind,R,DAL,26,45,2,5,7
59,8479985,Cale Fleury,D,SEA,26,35,2,5,7
59,8474568,Luke Schenn,D,NSH,35,50,1,6,7
59,8481701,Santeri Hatakka,D,NJD,23,36,1,6,7
59,8478874,Adam Gaudette,R,OTT,28,43,1,6,7
59,8476372,Nick Seeler,D,PHI,31,32,1,6,7
59,8475235,Nicolas Deslauriers,L,PHI,33,49,1,6,7
59,8480245,Olle Lycksell,R,PHI,25,26,1,6,7
59,8481556,John Beecher,C,BOS,23,35,5,1,6
59,8479981,Jonah Gadjovich,L,FLA,26,40,4,2,6
59,8482145,Mavrik Bourque,C,DAL,22,50,4,2,6
59,8482659,Josh Doan,R,UTA,22,46,4,2,6
59,8481609,Vladislav Kolyachonok,D,UTA,23,28,4,2,6
59,8479344,Jesse Puljujarvi,R,PIT,26,43,3,3,6
59,8482166,Shakir Mukhamadullin,D,SJS,22,49,3,3,6
59,8482751,Ryan Winterton,C,SEA,21,40,3,3,6
59,8479972,Mason Shaw,C,WPG,26,31,3,3,6
59,8482144,Jack Thompson,D,SJS,22,24,3,3,6
59,8482666,Scott Morrow,D,CAR,22,45,2,4,6
59,8482713,Mackie Samoskevich,R,FLA,22,35,2,4,6
59,8478454,Noah Juulsen,D,VAN,27,38,2,4,6
59,8477335,Kyle Burroughs,D,LAK,29,38,2,4,6
59,8479348,Kale Clague,D,BUF,26,43,1,5,6
59,8477070,Liam O'Brien,C,UTA,30,55,1,5,6
59,8478424,Jansen Harkins,C,ANA,27,48,1,5,6
59,8480292,Carson Meyer,R,ANA,27,39,1,5,6
59,8481006,Tyler Tucker,D,STL,24,15,0,6,6
59,8482061,Brandon Biro,L,SEA,26,16,5,0,5
59,8481789,Tye Kartye,L,SEA,23,36,4,1,5
59,8484287,Cole McWard,D,VAN,23,29,3,2,5
59,8478450,Parker Wotherspoon,D,BOS,27,46,3,2,5
59,8481679,Maxence Guenette,D,OTT,23,35,3,2,5
59,8483570,Ben Meyers,C,SEA,26,33,3,2,5
59,8480880,Jakub Lauko,C,MIN,24,32,2,3,5
59,8477851,Jordan Oesterle,D,BOS,32,32,2,3,5
59,8481147,Reese Johnson,C,MIN,26,38,2,3,5
59,8475958,Michael Sgarbossa,C,WSH,32,30,2,3,5
59,8482929,Emil Lilleberg,D,TBL,23,29,2,3,5
59,8480990,Declan Chisholm,D,MIN,24,28,2,3,5
59,8484911,Collin Graf,R,SJS,22,43,2,3,5
59,8482201,Gage Goncalves,C,TBL,23,26,2,3,5
59,8474062,Riley Nash,C,NYR,35,12,2,3,5
59,8479291,Kevin Rooney,C,CGY,31,46,1,4,5
59,8480845,Rasmus Kupari,C,WPG,24,40,1,4,5
59,8478146,Matthew Highmore,C,OTT,28,37,1,4,5
59,8477462,Robert Hagg,D,VGK,29,21,1,4,5
59,8479378,Logan Stanley,D,WPG,26,39,1,4,5
59,8480084,Nick DeSimone,D,NJD,30,22,1,4,5
59,8482094,Daemon Hunt,D,MIN,22,14,1,4,5
59,8477034,Jaycob Megna,D,FLA,32,48,0,5,5
59,8481237,Kyle MacLean,C,NYI,25,24,3,1,4
59,8481585,Egor Afanasyev,L,SJS,23,15,3,1,4
59,8482147,Jean-Luc Foudy,C,COL,22,27,3,1,4
59,8481065,Angus Crookshank,L,OTT,25,18,3,1,4
59,8479536,Axel Jonsson-Fjallby,L,WPG,26,43,2,2,4
59,8481754,Nikita Nesterenko,C,ANA,23,33,2,2,4
59,8477938,Haydn Fleury,D,WPG,28,37,2,2,4
59,8477244,Chad Ruhwedel,D,NYR,34,36,2,2,4
59,8479419,Brett Murray,L,BUF,26,25,2,2,4
59,8477384,Joshua Brown,D,EDM,30,35,2,2,4
59,8478051,Max Willman,C,NJD,29,12,2,2,4
59,8477401,John Hayden,C,SEA,29,29,1,3,4
59,8482733,Logan Mailloux,D,MTL,31,26,1,3,4
59,8483471,Brad Lambert,C,WPG,31,10,1,3,4
59,8480870,Bo Groulx,C,NYR,24,27,1,3,4
59,8479379,Givani Smith,R,SJS,26,26,1,3,4
59,8483763,Maksymilian Szuber,D,UTA,22,29,1,3,4
59,8481056,Spencer Stastney,D,NSH,24,35,1,3,4
59,8479367,William Lockwood,R,FLA,26,20,1,3,4
59,8481593,Jayden Struble,D,MTL,23,20,1,3,4
59,8475795,Dylan McIlrath,D,WSH,32,16,0,4,4
59,8481518,Nolan Foote,L,NJD,24,39,3,0,3
59,8477473,Justin Bailey,R,SJS,29,19,2,1,3
59,8481543,Nikita Alexandrov,C,STL,24,21,2,1,3
59,8483567,Georgii Merkulov,C,BOS,24,10,2,1,3
59,8481043,Cole Koepke,L,BOS,26,13,2,1,3
59,8481532,Alex Turcotte,C,LAK,23,46,1,2,3
59,8479991,Jake Leschyshyn,C,NYR,25,20,1,2,3
59,8480851,Akil Thomas,C,LAK,24,18,1,2,3
59,8483512,Matthew Savoie,C,EDM,20,21,1,2,3
59,8479362,Riley Tufte,L,BOS,26,15,1,2,3
59,8476441,Joel Edmundson,D,LAK,31,31,0,3,3
59,8482516,Matthew Kessel,D,STL,24,14,0,3,3
59,8480834,Ty Emberson,D,SJS,24,37,0,3,3
59,8483407,Brandon Scanlin,D,NYR,25,6,2,0,2
59,8480032,Shane Bowers,C,NJD,25,16,2,0,2
59,8479421,Jacob Moverare,D,LAK,26,5,2,0,2
59,8478017,Mark Friedman,D,VAN,29,33,1,1,2
59,8479576,Vincent Desharnais,D,VAN,28,33,1,1,2
59,8481719,Maxwell Crozier,D,TBL,24,14,1,1,2
59,8478502,Dennis Gilbert,D,BUF,28,16,1,1,2
59,8484325,Waltteri Merela,C,TBL,26,22,1,1,2
59,8482172,Landon Slaggert,L,CHI,22,28,1,1,2
59,8477073,Kurtis MacDermid,L,NJD,30,24,1,1,2
59,8479320,Maxime Lajoie,D,SEA,27,25,1,1,2
59,8482460,Matt Rempe,C,NYR,22,11,1,1,2
59,8478446,Glenn Gawdin,C,LAK,27,14,1,1,2
59,8482470,Ilya Solovyov,D,CGY,24,19,0,2,2
59,8482858,Ryker Evans,D,SEA,23,21,0,2,2
59,8481578,Graeme Clarke,R,MIN,23,7,0,2,2
59,8480075,Cameron Crotty,D,MIN,25,7,0,2,2
59,8480874,Adam Ginning,D,PHI,24,14,0,2,2
59,8482250,Callahan Burke,C,VGK,27,21,1,0,1
59,8481422,Jake Lucchini,C,NSH,29,17,1,0,1
59,8480890,Jan Jenik,C,OTT,24,24,1,0,1
59,8481564,Ryan Johnson,D,BUF,23,13,1,0,1
59,8483597,Milos Kelemen,L,UTA,25,14,1,0,1
59,8484304,Uvis Balinskis,D,FLA,28,11,1,0,1
59,8482787,Nikita Chibrikov,R,WPG,31,6,1,0,1
59,8481206,John Ludvig,D,PIT,24,9,1,0,1
59,8478011,Louie Belpedio,D,PHI,28,8,1,0,1
59,8475413,Justin Dowling,C,NJD,34,18,1,0,1
59,8481030,Jack St. Ivany,D,PIT,25,13,1,0,1
59,8478854,Ryan Shea,D,PIT,27,8,1,0,1
59,8481534,Raphael Lavoie,C,EDM,24,5,1,0,1
59,8480267,Sammy Walker,C,MIN,25,17,1,0,1
59,8484321,Nikolas Matinpalo,D,OTT,26,2,1,0,1
59,8484258,Sam Malinski,D,COL,26,19,0,1,1
59,8477149,Scott Sabourin,R,SJS,32,15,0,1,1
59,8479587,Rhett Gardner,C,PHI,28,16,0,1,1
59,8483489,Fraser Minten,C,TOR,31,9,0,1,1
59,8481806,Louis Crevier,D,CHI,23,14,0,1,1
59,8480823,Alexander Alexeyev,D,WSH,25,13,0,1,1
59,8482118,Sam Colangelo,R,ANA,23,13,0,1,1
59,8477320,Anton Blidh,L,NYR,29,18,0,1,1
59,8482165,Yan Kuznetsov,D,CGY,22,17,0,1,1
59,8478477,Mitchell Stephens,C,SEA,27,19,0,1,1
59,8475780,Chris Wagner,R,COL,33,11,0,1,1
59,8479522,Hardy Haman Aktell,D,WSH,26,5,0,1,1
59,8483609,Adam Klapka,R,CGY,24,6,0,1,1
59,8482102,Vasily Ponomarev,C,PIT,22,16,0,0,0
59,8477527,Ross Johnston,L,ANA,30,28,0,0,0
59,8481699,Aku Raty,R,UTA,23,12,0,0,0
59,8477467,Gustav Olofsson,D,SEA,30,19,0,0,0
59,8481726,Adam Edstrom,C,NYR,24,8,0,0,0
59,8481462,Mason Morelli,L,VGK,28,7,0,0,0
59,8480468,James Hamblin,L,EDM,25,17,0,0,0
59,8477810,Joel Hanley,D,CGY,33,24,0,0,0
59,8481024,Linus Karlsson,C,VAN,25,7,0,0,0
59,8481655,Cole Schwindt,R,CGY,23,3,0,0,0
59,8480306,Grant Hutton,D,NYI,29,9,0,0,0
59,8482476,Emil Heineman,L,MTL,23,9,0,0,0
59,8483398,Declan Carlile,D,TBL,31,7,0,0,0
59,8484255,Jason Polin,R,COL,25,6,0,0,0
59,8479330,Brandon Gignac,C,MTL,27,9,0,0,0
59,8482126,Emil Andrae,D,PHI,31,2,0,0,0
59,8478147,Bokondji Imama,L,PIT,28,4,0,0,0
59,8477541,Dakota Mermis,D,TOR,30,6,0,0,0
59,8483546,Marshall Rifai,D,TOR,26,2,0,0,0
59,8482197,Adam Raska,R,MIN,23,4,0,0,0
59,8483395,Arshdeep Bains,L,VAN,23,5,0,0,0
59,8478881,Brett Seney,L,CHI,28,14,0,0,0
59,8483432,Luca Del Bel Belluz,C,CBJ,31,4,0,0,0
59,8482088,Justin Sourdif,R,FLA,22,16,0,0,0
59,8482162,Roby Jarventie,L,EDM,22,13,0,0,0
59,8484259,Ondrej Pavel,C,COL,31,4,0,0,0
59,8484326,Patrik Koch,D,UTA,28,2,0,0,0
59,8475755,Alexander Petrovic,D,DAL,32,11,0,0,0
59,8483920,Pierrick Dube,R,WSH,23,3,0,0,0
59,8477993,Justin Kirkland,C,CGY,28,8,0,0,0
59,8476323,Max McCormick,L,SEA,32,2,0,0,0
59,8483531,Brian Halonen,L,NJD,25,4,0,0,0
59,8483401,Marc Johnstone,R,PIT,28,0,0,0,0
59,8480274,Philip Kemp,D,EDM,25,1,0,0,0
59,8470794,Joe Pavelski,C,,40,0,0,0,0
59,8479321,Lucas Johansen,D,,27,0,0,0,0
59,8477950,Tony DeAngelo,D,,29,0,0,0,0
59,8471218,Blake Wheeler,R,,38,0,0,0,0
59,8475197,Tyson Barrie,D,,33,0,0,0,0
59,8474157,Max Pacioretty,L,,36,0,0,0,0
59,8475744,Evgeny Kuznetsov,C,,32,0,0,0,0
59,8474037,James van Riemsdyk,L,,35,0,0,0,0
59,8476907,Mackenzie MacEachern,L,,30,0,0,0,0
59,8480216,Jacob Peterson,C,,25,0,0,0,0
59,8474602,Justin Schultz,D,,34,0,0,0,0
59,8482222,Alexander Barabanov,L,,30,0,0,0,0
59,8474031,Kevin Shattenkirk,D,,35,0,0,0,0
59,8477330,Dominik Kubalik,L,,29,0,0,0,0
59,8480884,Calen Addison,D,,24,0,0,0,0
59,8475906,John Klingberg,D,,32,0,0,0,0
59,8480008,Adam Ruzicka,C,,25,0,0,0,0
59,8476884,Derrick Pouliot,D,,30,0,0,0,0
59,8476919,Chris Tierney,C,,30,0,0,0,0
59,8479415,Michael McLeod,C,,26,0,0,0,0
59,8474870,Tyler Johnson,C,,34,0,0,0,0
59,8470604,Jeff Carter,C,,39,0,0,0,0
59,8478104,Sammy Blais,L,,28,0,0,0,0
59,8474884,Mike Hoffman,C,,35,0,0,0,0
59,8481591,Sam Poulin,R,,23,0,0,0,0
59,8471274,Alex Goligoski,D,,39,0,0,0,0
59,8476871,Tanner Pearson,L,,32,0,0,0,0
59,8476393,Nick Cousins,C,,31,0,0,0,0
59,8479977,Kailer Yamamoto,R,,26,0,0,0,0
59,8479346,Dillon Dube,C,,26,0,0,0,0
59,8480184,Gustav Lindstrom,D,,26,0,0,0,0
59,8479376,Victor Mete,D,,26,0,0,0,0
59,8473449,Kyle Okposo,R,,36,0,0,0,0
59,8481058,Jesse Ylonen,R,,25,0,0,0,0
59,8475752,Tyler Pitlick,C,,33,0,0,0,0
59,8481239,Samuel Fagemo,L,,24,0,0,0,0
59,8480821,Filip Zadina,R,,25,0,0,0,0
59,8470966,Mark Giordano,D,,41,0,0,0,0
59,8478495,Denis Gurianov,R,,27,0,0,0,0
59,8477464,Nic Petan,C,,29,0,0,0,0
59,8478099,Kevin Labanc,R,,29,0,0,0,0
59,8482241,Radim Zohorna,L,,28,0,0,0,0
59,8474040,Sam Gagner,C,,35,0,0,0,0
59,8479514,Rem Pitlick,C,,27,0,0,0,0
59,8478430,Oliver Kylington,D,,27,0,0,0,0
59,8479533,Joona Koppanen,L,,26,0,0,0,0
59,8479984,Cal Foote,D,,26,0,0,0,0
59,8477126,Jayson Megna,C,,34,0,0,0,0
59,8475164,Jakob Silfverberg,R,,34,0,0,0,0
59,8474009,Nick Bonino,C,,36,0,0,0,0
59,8479458,Nikita Zaitsev,D,,33,0,0,0,0
59,8477944,Jakub Vrana,L,,28,0,0,0,0
59,8471699,Andrew Cogliano,C,,37,0,0,0,0
59,8478067,Oskar Lindblom,L,,28,0,0,0,0
59,8471686,Marc Staal,D,,37,0,0,0,0
59,8470610,Zach Parise,L,,40,0,0,0,0
59,8478904,Steven Lorentz,C,,28,0,0,0,0
59,8473473,Milan Lucic,L,,36,0,0,0,0
59,8480031,Maxime Comtois,L,,25,0,0,0,0
59,8478512,Austin Czarnik,C,,32,0,0,0,0
59,8473504,Cal Clutterbuck,R,,37,0,0,0,0
59,8477454,Adam Erne,L,,29,0,0,0,0
59,8479383,Boris Katchouk,L,,26,0,0,0,0
59,8475825,Jani Hakanpää,D,,32,0,0,0,0
59,8477846,Ryan Carpenter,C,,33,0,0,0,0
59,8477930,Pierre-Edouard Bellemare,L,,39,0,0,0,0
59,8478400,Colin White,C,,27,0,0,0,0
59,8480226,Marián Studenic,R,,26,0,0,0,0
59,8480853,Liam Foudy,C,,24,0,0,0,0
59,8475797,Jarred Tinordi,D,,32,0,0,0,0
59,8479423,Alex Nylander,L,,26,0,0,0,0
59,8474618,Marco Scandella,D,,34,0,0,0,0
59,8478028,Fredrik Olofsson,L,,28,0,0,0,0
59,8474709,Matt Martin,L,,35,0,0,0,0
59,8481070,Hugh McGing,L,,26,0,0,0,0
59,8479546,Oskar Steen,C,,26,0,0,0,0
59,8474145,Robert Bortuzzo,D,,35,0,0,0,0
59,8476915,Jujhar Khaira,L,,30,0,0,0,0
59,8475278,Byron Froese,C,,33,0,0,0,0
59,8481812,Nikolai Knyzhov,D,,27,0,0,0,0
59,8478408,Travis Dermott,D,,28,0,0,0,0
59,8481077,John Leonard,L,,26,0,0,0,0
59,8479547,Matthew Phillips,R,,26,0,0,0,0
59,8480836,Jonathan Gruden,C,,24,0,0,0,0
59,8481690,Tyler Angle,C,,24,0,0,0,0
59,8475766,Austin Watson,L,,32,0,0,0,0
59,8481016,Ruslan Iskhakov,C,,24,0,0,0,0
59,8478078,Rourke Chartier,C,,28,0,0,0,0
59,8480776,Sheldon Rempal,R,,29,0,0,0,0
59,8478956,Samuel Laberge,L,NJD,27,0,0,0,0
59,8483045,Cameron Butler,R,CBJ,31,1,0,0,0
59,8484314,Jiri Smejkal,L,,28,0,0,0,0
60,8477956,David Pastrnak,R,BOS,28,80,74,68,142
60,8481559,Jack Hughes,C,NJD,23,77,51,84,135
60,8476453,Nikita Kucherov,R,TBL,31,82,41,87,128
60,8479318,Auston Matthews,C,TOR,27,79,62,55,117
60,8477492,Nathan MacKinnon,C,COL,29,80,37,80,117
60,8478420,Mikko Rantanen,R,COL,28,81,47,65,112
60,8479314,Matthew Tkachuk,L,FLA,27,80,37,74,111
60,8478402,Connor McDavid,C,EDM,27,77,37,73,110
60,8477493,Aleksander Barkov,C,FLA,29,79,32,73,105
60,8480027,Jason Robertson,L,DAL,25,81,36,66,102
60,8478483,Mitch Marner,R,TOR,27,80,29,73,102
60,8478864,Kirill Kaprizov,L,MIN,27,68,41,60,101
60,8478550,Artemi Panarin,L,NYR,33,77,29,69,98
60,8478445,Mathew Barzal,C,NYI,27,80,29,69,98
60,8476887,Filip Forsberg,L,NSH,30,74,38,59,97
60,8475166,John Tavares,C,TOR,34,81,38,59,97
60,8473512,Claude Giroux,R,OTT,36,82,25,70,95
60,8471675,Sidney Crosby,C,PIT,37,75,42,52,94
60,8474564,Steven Stamkos,C,NSH,34,78,39,54,93
60,8477934,Leon Draisaitl,C,EDM,29,77,36,57,93
60,8480012,Elias Pettersson,C,VAN,26,77,34,59,93
60,8480069,Cale Makar,D,COL,26,71,28,65,93
60,8478403,Jack Eichel,C,VGK,28,76,41,51,92
60,8475172,Nazem Kadri,C,CGY,34,80,37,55,92
60,8482116,Tim Stützle,C,OTT,22,80,29,63,92
60,8476456,Jonathan Huberdeau,C,CGY,31,78,33,56,89
60,8479323,Adam Fox,D,NYR,26,74,9,80,89
60,8477939,William Nylander,R,TOR,28,76,42,46,88
60,8478427,Sebastian Aho,C,CAR,27,77,41,47,88
60,8477942,Kevin Fiala,L,LAK,28,80,35,53,88
60,8476346,Johnny Gaudreau,L,CBJ,31,73,16,71,87
60,8480801,Brady Tkachuk,L,OTT,25,81,41,45,86
60,8478449,Roope Hintz,C,DAL,28,82,40,46,86
60,8477404,Jake Guentzel,C,TBL,30,82,36,50,86
60,8476468,J.T. Miller,C,VAN,31,75,24,59,83
60,8479385,Jordan Kyrou,C,STL,26,72,31,49,80
60,8478010,Brayden Point,C,TBL,28,81,31,48,79
60,8480208,Drake Batherson,R,OTT,26,77,31,48,79
60,8480023,Robert Thomas,C,STL,25,76,24,55,79
60,8477504,Josh Morrissey,D,WPG,29,77,22,57,79
60,8480800,Quinn Hughes,D,VAN,25,73,12,67,79
60,8471215,Evgeni Malkin,C,PIT,38,76,26,52,78
60,8476460,Mark Scheifele,C,WPG,31,73,25,53,78
60,8476389,Vincent Trocheck,C,NYR,31,76,26,51,77
60,8477960,Adrian Kempe,R,LAK,28,82,38,38,76
60,8477402,Pavel Buchnevich,L,STL,29,76,38,38,76
60,8479343,Clayton Keller,R,UTA,26,77,23,53,76
60,8477933,Sam Reinhart,C,FLA,29,77,40,35,75
60,8476459,Mika Zibanejad,C,NYR,31,77,29,46,75
60,8477409,Carter Verhaeghe,C,FLA,29,77,33,41,74
60,8478439,Travis Konecny,R,PHI,27,74,29,45,74
60,8474600,Roman Josi,D,NSH,34,76,22,52,74
60,8477946,Dylan Larkin,C,DET,28,82,34,38,72
60,8477951,Nick Schmaltz,C,UTA,28,76,33,39,72
60,8477496,Elias Lindholm,C,BOS,30,79,28,44,72
60,8474578,Erik Karlsson,D,PIT,34,77,19,53,72
60,8471214,Alex Ovechkin,L,WSH,39,69,35,36,71
60,8480830,Andrei Svechnikov,R,CAR,24,68,30,41,71
60,8478414,Timo Meier,R,NJD,28,75,30,41,71
60,8475913,Mark Stone,R,VGK,32,74,26,45,71
60,8480036,Miro Heiskanen,D,DAL,25,77,15,56,71
60,8480865,Noah Dobson,D,NYI,24,80,11,60,71
60,8481068,Yegor Sharangovich,C,CGY,26,77,32,38,70
60,8475167,Victor Hedman,D,TBL,34,78,12,58,70
60,8478444,Brock Boeser,R,VAN,27,76,36,33,69
60,8479420,Tage Thompson,C,BUF,27,73,33,36,69
60,8481596,Shane Pinto,C,OTT,24,79,30,39,69
60,8480002,Nico Hischier,C,NJD,25,75,26,43,69
60,8479407,Jesper Bratt,L,NJD,26,74,22,47,69
60,8477501,Valeri Nichushkin,R,COL,29,80,39,29,68
60,8479675,Trevor Moore,L,LAK,29,78,32,36,68
60,8479337,Alex DeBrincat,R,DET,27,81,30,38,68
60,8478398,Kyle Connor,L,WPG,28,74,29,39,68
60,8478440,Dylan Strome,C,WSH,27,74,26,42,68
60,8473419,Brad Marchand,L,BOS,36,74,22,46,68
60,8477986,Brandon Montour,D,SEA,30,72,20,48,68
60,8477949,Alex Tuch,R,BUF,28,69,17,50,67
60,8477500,Bo Horvat,C,NYI,29,78,35,31,66
60,8478493,Joel Eriksson Ek,C,MIN,27,71,26,40,66
60,8477416,Oliver Bjorkstrand,R,SEA,29,74,21,45,66
60,8476454,Ryan Nugent-Hopkins,C,EDM,31,73,20,46,66
60,8478460,Zach Werenski,D,CBJ,27,79,17,49,66
60,8475810,Bryan Rust,R,PIT,32,73,31,34,65
60,8475794,Tyler Seguin,C,DAL,32,80,28,37,65
60,8471685,Anze Kopitar,C,LAK,37,79,22,43,65
60,8473994,Jamie Benn,L,DAL,35,81,21,44,65
60,8482665,Matty Beniers,C,SEA,22,75,21,44,65
60,8474102,David Perron,L,OTT,36,78,18,47,65
60,8477964,Ivan Barbashev,C,VGK,29,76,16,49,65
60,8476448,William Karlsson,C,VGK,31,77,27,37,64
60,8482684,Luke Hughes,D,NJD,21,66,7,57,64
60,8475184,Chris Kreider,L,NYR,33,77,36,27,63
60,8479542,Brandon Hagel,L,TBL,26,82,33,30,63
60,8481533,Trevor Zegras,C,ANA,23,75,31,32,63
60,8475158,Ryan O'Reilly,C,NSH,33,72,20,43,63
60,8476881,Tomas Hertl,C,VGK,31,78,30,32,62
60,8482078,Lucas Raymond,L,DET,22,82,28,34,62
60,8475692,Mats Zuccarello,R,MIN,37,64,22,40,62
60,8483808,Andrei Kuzmenko,L,CGY,28,81,30,31,61
60,8482720,Matthew Knies,L,TOR,22,76,25,36,61
60,8476539,Jonathan Marchessault,R,NSH,34,74,31,29,60
60,8478407,Vince Dunn,D,SEA,28,78,12,48,60
60,8475784,Jeff Skinner,C,EDM,32,77,29,30,59
60,8477935,Sam Bennett,C,FLA,28,77,27,32,59
60,8478975,Mason Marchment,L,DAL,29,82,23,36,59
60,8477940,Nikolaj Ehlers,L,WPG,28,68,23,36,59
60,8474679,Gustav Nyquist,C,NSH,35,74,20,39,59
60,8475798,Mikael Granlund,C,SJS,32,70,13,46,59
60,8477955,Jared McCann,L,SEA,28,70,32,26,58
60,8480797,Joel Farabee,L,PHI,24,72,23,35,58
60,8475765,Vladimir Tarasenko,R,DET,33,82,22,36,58
60,8475745,Charlie Coyle,C,BOS,32,79,19,39,58
60,8480064,Josh Norris,C,OTT,25,77,35,22,57
60,8475754,Brock Nelson,C,NYI,33,77,23,34,57
60,8484166,Adam Fantilli,C,CBJ,20,71,27,29,56
60,8476399,Blake Coleman,C,CGY,33,74,26,30,56
60,8475287,Erik Haula,L,NJD,33,70,22,34,56
60,8474150,Mikael Backlund,C,CGY,35,77,13,43,56
60,8478438,Tommy Novak,C,NSH,27,68,26,29,55
60,8478462,Nicolas Roy,C,VGK,27,74,21,34,55
60,8480018,Nick Suzuki,C,MTL,25,70,20,35,55
60,8471724,Kris Letang,D,PIT,37,78,15,40,55
60,8479999,Casey Mittelstadt,C,COL,26,81,11,44,55
60,8479325,Charlie McAvoy,D,BOS,27,76,6,49,55
60,8482740,Wyatt Johnston,C,DAL,21,82,25,29,54
60,8478873,Troy Terry,R,ANA,27,73,22,32,54
60,8484144,Connor Bedard,C,CHI,19,67,21,33,54
60,8478498,Jake DeBrusk,L,VAN,28,74,20,34,54
60,8481557,Matt Boldy,L,MIN,23,74,19,35,54
60,8482124,Quinton Byfield,R,LAK,22,80,18,36,54
60,8477447,Shea Theodore,D,VGK,29,59,8,46,54
60,8474590,John Carlson,D,WSH,34,64,8,46,54
60,8483431,Logan Cooley,C,UTA,20,70,25,28,53
60,8474141,Patrick Kane,R,DET,36,77,21,32,53
60,8476483,Rickard Rakell,R,PIT,31,75,29,23,52
60,8477456,J.T. Compher,L,DET,29,77,26,26,52
60,8480015,Owen Tippett,R,PHI,25,70,24,28,52
60,8477429,Andrew Copp,C,DET,30,77,22,30,52
60,8481540,Cole Caufield,R,MTL,23,77,20,32,52
60,8478856,Conor Garland,R,VAN,28,71,20,32,52
60,8480185,Eetu Luostarinen,C,FLA,26,71,20,32,52
60,8482093,Seth Jarvis,C,CAR,22,69,17,35,52
60,8475191,Reilly Smith,R,NYR,33,67,23,28,51
60,8476479,Phillip Danault,C,LAK,31,78,14,37,51
60,8478469,Thomas Chabot,D,OTT,27,78,12,39,51
60,8477426,Nicholas Paul,L,TBL,29,81,30,20,50
60,8478401,Pavel Zacha,C,BOS,27,75,26,24,50
60,8471698,T.J. Oshie,R,WSH,38,71,22,28,50
60,8481604,Pavel Dorofeyev,L,VGK,24,73,21,29,50
60,8477503,Max Domi,C,TOR,29,80,19,31,50
60,8478542,Evan Rodrigues,C,FLA,31,77,19,31,50
60,8480039,Martin Necas,C,CAR,25,68,18,32,50
60,8482699,Dylan Guenther,R,UTA,21,77,18,32,50
60,8482092,Ridly Greig,C,OTT,22,76,23,26,49
60,8476880,Tom Wilson,R,WSH,30,68,27,21,48
60,8479400,Pierre-Luc Dubois,L,WSH,26,68,24,24,48
60,8477451,Ryan Hartman,R,MIN,30,66,23,25,48
60,8475314,Anders Lee,L,NYI,34,76,22,26,48
60,8475786,Zach Hyman,L,EDM,32,75,21,27,48
60,8478458,John (Jack) Roslovic,C,CAR,27,64,18,30,48
60,8478055,Gustav Forsling,D,FLA,28,69,13,35,48
60,8482109,Alexis Lafrenière,L,NYR,23,73,28,19,47
60,8474641,Adam Henrique,C,EDM,34,76,22,25,47
60,8482159,Tyson Foerster,R,PHI,22,74,22,25,47
60,8474586,Jordan Eberle,R,SEA,34,75,18,29,47
60,8477998,Warren Foegele,L,LAK,28,77,18,29,47
60,8479987,Morgan Geekie,C,BOS,26,75,17,30,47
60,8475763,Kevin Hayes,R,PIT,32,62,13,33,46
60,8482745,Mason McTavish,C,ANA,21,71,12,34,46
60,8480803,Evan Bouchard,D,EDM,25,71,10,36,46
60,8482113,Anton Lundell,C,FLA,23,79,22,23,45
60,8474149,Evgenii Dadonov,R,DAL,35,79,22,23,45
60,8481560,Arthur Kaliyev,R,LAK,23,81,22,23,45
60,8475170,Brayden Schenn,C,STL,33,71,20,25,45
60,8475799,Nino Niederreiter,R,WPG,32,65,20,25,45
60,8484145,Zach Benson,L,BUF,19,64,19,26,45
60,8480839,Rasmus Dahlin,D,BUF,24,70,15,30,45
60,8480188,Fabian Zetterlund,L,SJS,25,69,15,30,45
60,8477346,MacKenzie Weegar,D,CGY,30,73,11,34,45
60,8480014,Gabriel Vilardi,C,WPG,25,65,24,20,44
60,8478233,Andrew Mangiapane,L,WSH,28,61,20,24,44
60,8480028,Morgan Frost,C,PHI,25,74,19,25,44
60,8483515,Juraj Slafkovsky,L,MTL,20,72,19,25,44
60,8475714,Calle Jarnkrok,C,TOR,33,73,18,26,44
60,8478396,Noah Hanifin,D,VGK,27,61,15,29,44
60,8476906,Shayne Gostisbehere,D,CAR,31,76,14,30,44
60,8481524,Bowen Byram,D,BUF,23,71,14,30,44
60,8476875,Mike Matheson,D,MTL,30,77,12,32,44
60,8482671,Owen Power,D,BUF,22,73,12,32,44
60,8478038,Devon Toews,D,COL,30,71,11,33,44
60,8476792,Torey Krug,D,STL,33,74,10,34,44
60,8476869,Brady Skjei,D,NSH,30,73,9,35,44
60,8476432,Boone Jenner,C,CBJ,31,63,29,14,43
60,8475169,Evander Kane,L,EDM,33,72,23,20,43
60,8483505,Matthew Poitras,C,BOS,20,76,20,23,43
60,8481577,Philip Tomasino,C,NSH,23,66,19,24,43
60,8481711,Matias Maccelli,L,UTA,24,78,17,26,43
60,8481528,Dylan Cozens,C,BUF,23,74,14,29,43
60,8482105,Jake Sanderson,D,OTT,22,75,12,31,43
60,8477932,Aaron Ekblad,D,FLA,28,72,12,31,43
60,8470613,Brent Burns,D,CAR,39,75,9,34,43
60,8476853,Morgan Rielly,D,TOR,30,69,8,35,43
60,8479410,Mikhail Sergachev,D,UTA,26,74,7,36,43
60,8477476,Artturi Lehkonen,L,COL,29,80,25,17,42
60,8478466,Daniel Sprong,R,VAN,27,71,22,20,42
60,8475168,Matt Duchene,C,DAL,33,80,18,24,42
60,8478519,Anthony Cirelli,C,TBL,27,81,17,25,42
60,8475151,Kyle Palmieri,C,NYI,33,77,17,25,42
60,8482702,Logan Stankoven,C,DAL,21,81,21,20,41
60,8476882,Teuvo Teravainen,C,CHI,30,71,20,21,41
60,8473986,Alex Killorn,L,ANA,35,69,17,24,41
60,8476826,Yanni Gourde,C,SEA,33,68,17,24,41
60,8477407,Anthony Duclair,L,NYI,29,78,17,24,41
60,8478397,Rasmus Andersson,D,CGY,28,70,9,32,41
60,8475726,Tyler Toffoli,C,SJS,32,72,22,18,40
60,8482110,Dawson Mercer,C,NJD,23,70,22,18,40
60,8478046,Danton Heinen,L,VAN,29,76,21,19,40
60,8482667,William Eklund,L,SJS,22,60,19,21,40
60,8482475,Yegor Chinakhov,R,CBJ,23,68,19,21,40
60,8481618,Alex Newhook,C,MTL,23,72,17,23,40
60,8478366,Frank Vatrano,R,ANA,30,74,16,24,40
60,8481186,Logan O'Connor,R,COL,28,79,16,24,40
60,8476462,Dougie Hamilton,D,NJD,31,68,15,25,40
60,8482149,Cole Perfetti,C,WPG,22,72,14,26,40
60,8482097,Jack Quinn,R,BUF,23,70,11,29,40
60,8475218,Mattias Ekholm,D,EDM,34,74,10,30,40
60,8479992,Michael Rasmussen,C,DET,25,77,18,21,39
60,8476927,Teddy Blueger,C,VAN,30,63,14,25,39
60,8477021,Alex Kerfoot,C,UTA,30,74,13,26,39
60,8476905,Chandler Stephenson,C,SEA,30,78,13,26,39
60,8482175,JJ Peterka,R,BUF,22,66,23,15,38
60,8480009,Eeli Tolvanen,R,SEA,25,74,18,20,38
60,8480068,Ryan Poehling,C,PHI,25,67,17,21,38
60,8481554,Kaapo Kakko,R,NYR,23,78,16,22,38
60,8478472,Mathieu Joseph,R,STL,27,66,12,26,38
60,8475753,Justin Faulk,D,STL,32,71,8,30,38
60,8481542,Moritz Seider,D,DET,23,77,4,34,38
60,8475768,Jaden Schwartz,C,SEA,32,72,21,16,37
60,8480829,Jesperi Kotkaniemi,C,CAR,24,71,18,19,37
60,8476392,Adam Lowry,C,WPG,31,66,16,21,37
60,8477511,Anthony Mantha,R,CGY,30,75,14,23,37
60,8484153,Leo Carlsson,C,ANA,20,73,14,23,37
60,8476480,Vladislav Namestnikov,C,WPG,32,68,13,24,37
60,8477444,Andre Burakovsky,L,SEA,29,64,12,25,37
60,8477494,Jonathan Drouin,L,COL,29,80,11,26,37
60,8474563,Drew Doughty,D,LAK,35,70,7,30,37
60,8476854,Hampus Lindholm,D,BOS,30,71,5,32,37
60,8480434,Sean Durzi,D,UTA,26,68,4,33,37
60,8476438,Brandon Saad,L,STL,32,71,24,12,36
60,8478474,Lawson Crouse,L,UTA,27,76,21,15,36
60,8479365,Trent Frederic,C,BOS,26,77,20,16,36
60,8483524,Shane Wright,C,SEA,20,68,20,16,36
60,8475760,Nick Bjugstad,C,UTA,32,75,17,19,36
60,8480813,Joe Veleno,C,DET,24,74,17,19,36
60,8477497,Sean Monahan,C,CBJ,30,66,15,21,36
60,8477479,Tyler Bertuzzi,L,CHI,29,63,15,21,36
60,8475193,Tomas Tatar,L,NJD,34,68,15,21,36
60,8480798,Philipp Kurashev,C,CHI,25,64,14,22,36
60,8477948,Travis Sanheim,D,PHI,28,74,10,26,36
60,8476923,Damon Severson,D,CBJ,30,81,9,27,36
60,8476458,Ryan Strome,C,ANA,31,70,9,27,36
60,8479639,Dylan Coghlan,D,WPG,26,66,9,27,36
60,8475200,Dmitry Orlov,D,CAR,33,76,9,27,36
60,8479425,Filip Hronek,D,VAN,27,72,7,29,36
60,8476979,Erik Gustafsson,D,DET,32,74,1,35,36
60,8475848,Brendan Gallagher,R,MTL,32,69,13,22,35
60,8482133,Thomas Bordeleau,C,SJS,22,65,10,25,35
60,8482146,Luke Evangelista,R,NSH,22,70,5,30,35
60,8475764,Cam Fowler,D,ANA,33,77,3,32,35
60,8482089,Jake Neighbours,L,STL,22,72,24,10,34
60,8480078,Filip Chytil,C,NYR,25,69,19,15,34
60,8476958,Jaccob Slavin,D,CAR,30,75,9,25,34
60,8481581,Thomas Harley,D,DAL,23,80,8,26,34
60,8479525,Ross Colton,C,COL,28,82,19,14,33
60,8478115,Pierre Engvall,L,NYI,28,80,18,15,33
60,8476474,Stefan Noesen,R,NJD,31,70,17,16,33
60,8480849,Barrett Hayton,C,UTA,24,70,16,17,33
60,8479591,Michael Eyssimont,C,TBL,28,82,16,17,33
60,8481624,Ilya Mikheyev,R,CHI,30,54,16,17,33
60,8479339,Patrik Laine,L,CBJ,26,66,15,18,33
60,8483490,Pavel Mintyukov,D,ANA,21,75,12,21,33
60,8480871,Adam Boqvist,D,FLA,24,63,7,26,33
60,8482712,Oskar Olausson,R,COL,22,78,6,27,33
60,8481703,Valtteri Puustinen,R,PIT,25,64,6,27,33
60,8476885,Jacob Trouba,D,NYR,30,70,6,27,33
60,8477495,Seth Jones,D,CHI,30,70,5,28,33
60,8481546,Cam York,D,PHI,23,66,5,28,33
60,8478042,Viktor Arvidsson,L,EDM,31,73,17,15,32
60,8478020,Michael Amadio,R,OTT,28,73,17,15,32
60,8478413,Jordan Greenway,L,BUF,27,70,16,16,32
60,8470621,Corey Perry,R,EDM,39,70,16,16,32
60,8478047,Michael Bunting,L,PIT,29,70,13,19,32
60,8482055,Drew O'Connor,L,PIT,26,62,12,20,32
60,8474151,Ryan McDonagh,D,TBL,35,78,4,28,32
60,8481656,Aliaksei Protas,C,WSH,23,72,17,14,31
60,8478463,Anthony Beauvillier,L,PIT,27,63,14,17,31
60,8479351,Sam Steel,C,DAL,26,82,14,17,31
60,8476469,Joel Armia,R,MTL,31,66,14,17,31
60,8476461,Sean Couturier,C,PHI,32,62,13,18,31
60,8480459,Pius Suter,C,VAN,28,72,13,18,31
60,8475793,Ryan Johansen,C,PHI,32,75,11,20,31
60,8482660,Kent Johnson,C,CBJ,22,67,9,22,31
60,8475790,Erik Gudbranson,D,CBJ,32,78,8,23,31
60,8480336,Sean Walker,D,CAR,30,76,7,24,31
60,8482122,Brock Faber,D,MIN,22,75,5,26,31
60,8479371,Dante Fabbro,D,NSH,26,61,3,28,31
60,8481535,Nils Hoglander,L,VAN,24,64,19,11,30
60,8476918,Jimmy Vesey,L,NYR,31,68,19,11,30
60,8479390,Taylor Raddysh,R,WSH,26,64,16,14,30
60,8479393,Noah Gregor,L,OTT,26,74,16,14,30
60,8479293,Brandon Tanev,L,SEA,33,67,16,14,30
60,8474053,Logan Couture,C,SJS,35,57,13,17,30
60,8480835,Jack Drury,C,CAR,24,62,12,18,30
60,8482809,Jackson Blake,R,CAR,21,64,10,20,30
60,8474565,Alex Pietrangelo,D,VGK,34,64,9,21,30
60,8480220,Noah Cates,L,PHI,25,70,8,22,30
60,8481014,Alexander Romanov,D,NYI,24,78,7,23,30
60,8480817,K'Andre Miller,D,NYR,24,77,7,23,30
60,8477969,Marcus Pettersson,D,PIT,28,79,4,26,30
60,8481606,Jordan Spence,D,LAK,23,66,4,26,30
60,8480113,Alex Iafallo,L,WPG,31,66,16,13,29
60,8475791,Taylor Hall,L,CHI,33,52,10,19,29
60,8481580,Connor McMichael,C,WSH,23,57,9,20,29
60,8477498,Darnell Nurse,D,EDM,29,72,8,21,29
60,8477220,Nate Schmidt,D,FLA,33,68,8,21,29
60,8474574,Tyler Myers,D,VAN,34,74,4,25,29
60,8482125,Alexander Holtz,R,VGK,22,67,14,14,28
60,8482705,Cole Sillinger,C,CBJ,21,63,14,14,28
60,8482749,Joshua Roy,R,MTL,21,70,11,17,28
60,8476872,Scott Laughton,C,PHI,30,78,10,18,28
60,8481523,Kirby Dach,C,MTL,23,67,10,18,28
60,8484203,Bradly Nadeau,L,CAR,19,61,10,18,28
60,8476960,Andreas Athanasiou,C,CHI,30,59,8,20,28
60,8479345,Jakob Chychrun,D,WSH,26,66,7,21,28
60,8477953,Kasperi Kapanen,R,STL,28,70,6,22,28
60,8478851,Alexandre Carrier,D,NSH,28,65,4,24,28
60,8480873,Rasmus Sandin,D,WSH,24,66,1,27,28
60,8479619,Michael Carcone,L,UTA,28,64,18,9,27
60,8476278,Colin Blackwell,C,DAL,31,77,14,13,27
60,8478891,Mason Appleton,C,WPG,28,60,13,14,27
60,8477987,Ryan Donato,C,CHI,28,55,12,15,27
60,8476925,Colton Sissons,C,NSH,31,65,12,15,27
60,8479996,Cody Glass,C,NSH,25,65,10,17,27
60,8480878,Nils Lundkvist,D,DAL,24,74,8,19,27
60,8477952,Robby Fabbri,C,ANA,28,61,18,8,26
60,8476292,Ondrej Palat,L,NJD,33,73,15,11,26
60,8482117,Lukas Reichel,L,CHI,22,61,14,12,26
60,8480980,Connor Dewar,C,TOR,25,67,14,12,26
60,8476981,Josh Anderson,R,MTL,30,62,13,13,26
60,8474715,Cameron Atkinson,R,TBL,35,80,13,13,26
60,8482111,Justin Barron,D,MTL,23,71,13,13,26
60,8479661,Tanner Jeannot,L,LAK,27,75,13,13,26
60,8481582,Nicholas Robertson,L,TOR,23,60,12,14,26
60,8480995,Pontus Holmberg,R,TOR,25,63,11,15,26
60,8476921,Jordan Martinook,L,CAR,32,56,10,16,26
60,8477488,Brett Pesce,D,NJD,30,71,5,21,26
60,8478500,Ivan Provorov,D,CBJ,27,77,4,22,26
60,8473507,Jeff Petry,D,DET,37,73,2,24,26
60,8480205,Emil Bemstrom,C,PIT,25,55,19,6,25
60,8480855,Jack McBain,C,UTA,24,67,14,11,25
60,8477478,William Carrier,L,CAR,30,54,14,11,25
60,8482074,Connor Zary,C,CGY,23,65,14,11,25
60,8475722,Jason Zucker,L,BUF,32,71,12,13,25
60,8475220,Marcus Foligno,L,MIN,33,61,7,18,25
60,8478443,Brandon Carlo,D,BOS,28,65,5,20,25
60,8477506,Ryan Pulock,D,NYI,30,79,3,22,25
60,8476457,Adam Larsson,D,SEA,32,68,2,23,25
60,8482079,Marco Rossi,C,MIN,23,55,15,9,24
60,8480281,Alexey Toropchenko,R,STL,25,60,13,11,24
60,8477903,Garnet Hathaway,R,PHI,33,67,11,13,24
60,8477353,Tyler Motte,C,DET,29,73,11,13,24
60,8476419,Jean-Gabriel Pageau,C,NYI,32,74,9,15,24
60,8474716,Jared Spurgeon,D,MIN,35,81,9,15,24
60,8476917,Adam Pelech,D,NYI,30,80,7,17,24
60,8481481,Blake Lizotte,C,PIT,27,65,7,17,24
60,8478013,Jake Walman,D,SJS,28,71,7,17,24
60,8480043,Timothy Liljegren,D,TOR,25,70,4,20,24
60,8481521,Ronnie Attard,D,PHI,25,61,4,20,24
60,8479976,Juuso Valimaki,D,UTA,26,69,1,23,24
60,8480789,Oliver Wahlstrom,R,NYI,24,73,14,9,23
60,8480893,Kirill Marchenko,R,CBJ,24,57,13,10,23
60,8477505,Alexander Wennberg,C,SJS,30,64,12,11,23
60,8477425,Miles Wood,L,COL,29,70,12,11,23
60,8476878,Zemgus Girgensons,C,TBL,30,80,12,11,23
60,8475149,Marcus Johansson,L,MIN,34,65,10,13,23
60,8481093,Rafael Harvey-Pinard,L,MTL,25,53,9,14,23
60,8473422,Nick Foligno,L,CHI,37,62,8,15,23
60,8482087,Kaiden Guhle,D,MTL,22,64,5,18,23
60,8481441,Joe Snively,C,DET,28,64,4,19,23
60,8480049,Dylan Samberg,D,WPG,25,68,3,20,23
60,8480222,Sebastian Aho,D,PIT,28,71,2,21,23
60,8476892,Colton Parayko,D,STL,31,69,2,21,23
60,8480887,Jordan Harris,D,MTL,24,50,2,21,23
60,8477450,Jason Dickinson,C,CHI,29,60,12,10,22
60,8479316,Luke Kunin,C,SJS,27,55,12,10,22
60,8479353,Brett Howden,C,VGK,26,72,11,11,22
60,8481704,Juuso Parssinen,C,NSH,23,60,11,11,22
60,8480021,Jack Studnicka,C,LAK,25,63,11,11,22
60,8483457,Lane Hutson,D,MTL,20,67,10,12,22
60,8477839,Conor Sheary,L,TBL,32,82,9,13,22
60,8473533,Jordan Staal,C,CAR,36,64,9,13,22
60,8479370,Tyson Jost,C,CAR,26,54,9,13,22
60,8480448,Parker Kelly,L,COL,25,78,8,14,22
60,8480802,Ryan McLeod,C,BUF,25,67,7,15,22
60,8480796,Martin Fehervary,D,WSH,25,66,6,16,22
60,8476463,Jonas Brodin,D,MIN,31,73,4,18,22
60,8478507,John Marino,D,UTA,27,63,1,21,22
60,8478840,Will Borgen,D,SEA,28,70,1,21,22
60,8479336,Carl Grundstrom,R,SJS,27,54,13,8,21
60,8480762,Eric Robinson,L,CAR,29,56,12,9,21
60,8478057,Dakota Joshua,C,VAN,28,61,11,10,21
60,8477446,Michael McCarron,R,NSH,29,51,11,10,21
60,8475855,Jesper Fast,R,CAR,33,61,10,11,21
60,8478508,Yakov Trenin,C,MIN,27,58,10,11,21
60,8480144,David Kampf,C,TOR,29,65,9,12,21
60,8482101,Danil Gushchin,L,SJS,22,55,8,13,21
60,8477507,Nikita Zadorov,D,BOS,29,73,8,13,21
60,8480748,Kiefer Sherwood,L,VAN,29,63,7,14,21
60,8481527,Kaedan Korczak,D,VGK,23,55,6,15,21
60,8478970,Jalen Chatfield,D,CAR,28,70,5,16,21
60,8476988,Matt Benning,D,SJS,30,67,5,16,21
60,8480035,Henri Jokiharju,D,BUF,25,57,4,17,21
60,8479982,Conor Timmins,D,TOR,26,52,4,17,21
60,8480891,Michael Kesselring,D,UTA,24,64,3,18,21
60,8479402,Jake Bean,D,CGY,26,62,2,19,21
60,8481059,Scott Perunovich,D,STL,26,55,2,19,21
60,8479941,Justin Danforth,R,CBJ,31,60,11,9,20
60,8479368,Max Jones,L,BOS,26,68,10,10,20
60,8481553,Bobby Brink,R,PHI,23,70,9,11,20
60,8476889,Radek Faksa,C,STL,30,60,9,11,20
60,8480806,Isac Lundestrom,C,ANA,25,60,9,11,20
60,8475343,Nic Dowd,C,WSH,34,57,8,12,20
60,8483445,Cutter Gauthier,L,ANA,20,63,8,12,20
60,8480074,Alexandre Texier,C,STL,25,60,8,12,20
60,8476897,Oskar Sundqvist,C,STL,30,70,7,13,20
60,8475231,Casey Cizikas,C,NYI,33,73,7,13,20
60,8482803,Olen Zellweger,D,ANA,21,67,7,13,20
60,8482073,Braden Schneider,D,NYR,23,62,6,14,20
60,8482624,Daniil Miromanov,D,CGY,27,66,5,15,20
60,8480192,Johnathan Kovacevic,D,NJD,27,58,5,15,20
60,8476879,Cody Ceci,D,EDM,31,68,5,15,20
60,8476422,Mike Reilly,D,NYI,31,74,4,16,20
60,8479398,Samuel Girard,D,COL,26,62,2,18,20
60,8481477,Nico Sturm,C,SJS,29,57,12,7,19
60,8474189,Lars Eller,C,PIT,35,62,11,8,19
60,8482155,Alex Laferriere,R,LAK,23,63,11,8,19
60,8478109,Victor Olofsson,L,VGK,29,65,8,11,19
60,8481028,Martin Pospisil,C,CGY,25,53,8,11,19
60,8483495,Simon Nemec,D,NJD,20,65,6,13,19
60,8476891,Matthew Grzelcyk,D,PIT,30,77,4,15,19
60,8482245,Artem Zub,D,OTT,29,66,4,15,19
60,8475171,Oliver Ekman-Larsson,D,TOR,33,67,3,16,19
60,8477435,Ryan Graves,D,PIT,29,74,3,16,19
60,8479998,Mikey Anderson,D,LAK,25,65,3,16,19
60,8475179,Dmitry Kulikov,D,FLA,34,64,3,16,19
60,8475188,Brayden McNabb,D,VGK,33,55,3,16,19
60,8475324,Nick Jensen,D,OTT,34,66,2,17,19
60,8474673,TJ Brodie,D,CHI,34,56,2,17,19
60,8478399,Jonas Siegenthaler,D,NJD,27,57,1,18,19
60,8481032,Paul Cotter,C,NJD,25,55,13,5,18
60,8477392,Hudson Fasching,R,NYI,29,64,12,6,18
60,8478569,Noel Acciari,C,PIT,33,59,10,8,18
60,8482259,Bobby McMann,C,TOR,28,60,9,9,18
60,8481522,Peyton Krebs,C,BUF,23,54,9,9,18
60,8483468,Jiri Kulich,C,BUF,20,60,9,9,18
60,8480848,Ty Dellandrea,C,SJS,24,41,8,10,18
60,8477919,Frederick Gaudreau,C,MIN,31,65,7,11,18
60,8478432,Christian Fischer,R,DET,27,71,7,11,18
60,8483491,Ivan Miroshnichenko,L,WSH,20,55,7,11,18
60,8483499,Liam Ohgren,L,MIN,20,59,7,11,18
60,8479520,Brandon Duhaime,R,WSH,27,53,7,11,18
60,8478911,Matt Roy,D,WSH,29,57,6,12,18
60,8473563,Nicklas Backstrom,C,WSH,37,59,6,12,18
60,8476525,Colin Miller,D,WPG,32,58,6,12,18
60,8479983,Mario Ferraro,D,SJS,26,65,6,12,18
60,8481013,Jonatan Berggren,R,DET,24,67,6,12,18
60,8482730,Brandt Clarke,D,LAK,21,53,6,12,18
60,8476994,Vinnie Hinostroza,C,NSH,30,46,5,13,18
60,8475181,Nick Leddy,D,STL,33,71,4,14,18
60,8478178,Darren Raddysh,D,TBL,28,74,4,14,18
60,8478882,Vladislav Gavrikov,D,LAK,29,61,3,15,18
60,8480172,Jan Rutta,D,SJS,34,63,2,16,18
60,8480070,Ian Mitchell,D,BOS,25,46,2,16,18
60,8482067,Connor Mackey,D,NYR,28,58,1,17,18
60,8476931,Jake McCabe,D,TOR,31,64,1,17,18
60,8477979,Nicolas Aube-Kubel,R,BUF,28,50,11,6,17
60,8478043,Sam Lafferty,C,BUF,29,58,10,7,17
60,8479066,Ryan Lomberg,L,CGY,30,65,9,8,17
60,8473453,Trevor Lewis,C,LAK,37,72,8,9,17
60,8475842,Sam Carrick,C,NYR,32,59,8,9,17
60,8481716,Dmitri Voronkov,L,CBJ,24,55,7,10,17
60,8480003,Jesper Boqvist,C,FLA,26,62,5,12,17
60,8476856,Mathew Dumba,D,DAL,30,74,5,12,17
60,8476867,Brendan Gaunce,C,MIN,30,40,5,12,17
60,8479026,Philippe Myers,D,TOR,27,57,4,13,17
60,8477947,Sonny Milano,L,WSH,28,64,3,14,17
60,8482655,Janis Moser,D,TBL,24,77,1,16,17
60,8479369,Andrew Peeke,D,BOS,26,58,1,16,17
60,8477989,Christian Dvorak,C,MTL,28,66,10,6,16
60,8477380,Jonny Brodzinski,C,NYR,31,57,9,7,16
60,8482176,Wyatt Kaiser,D,CHI,22,53,8,8,16
60,8478434,Keegan Kolesar,R,VGK,27,61,8,8,16
60,8480011,Klim Kostin,C,SJS,25,52,8,8,16
60,8479414,Nathan Bastian,R,NJD,27,58,7,9,16
60,8482142,Jamie Drysdale,D,PHI,22,61,7,9,16
60,8477369,Carson Soucy,D,VAN,30,60,6,10,16
60,8477015,Connor Brown,R,EDM,30,62,5,11,16
60,8482148,Hendrix Lapierre,C,WSH,22,55,5,11,16
60,8479980,Nicolas Hague,D,VGK,26,44,5,11,16
60,8476329,Travis Boyd,C,MIN,31,55,5,11,16
60,8480157,Calle Rosen,D,COL,30,54,5,11,16
60,8477845,Trevor van Riemsdyk,D,WSH,33,59,4,12,16
60,8483482,Tristan Luneau,D,ANA,20,61,4,12,16
60,8470600,Ryan Suter,D,STL,39,57,2,14,16
60,8478136,Jake Middleton,D,MIN,28,75,2,14,16
60,8480950,Ilya Lyubushkin,D,DAL,30,52,2,14,16
60,8477034,Jaycob Megna,D,FLA,32,43,2,14,16
60,8482062,Cole Smith,L,NSH,29,58,12,3,15
60,8479439,Jacob MacDonald,D,COL,31,44,9,6,15
60,8476934,Brock McGinn,L,ANA,30,51,9,6,15
60,8476374,Sean Kuraly,C,CBJ,31,54,7,8,15
60,8476312,Josh Manson,D,COL,33,59,6,9,15
60,8475279,Ben Chiarot,D,DET,33,71,6,9,15
60,8482679,Matt Coronato,R,CGY,22,54,6,9,15
60,8476467,Jamie Oleksiak,D,SEA,32,65,6,9,15
60,8479543,Michael Pezzetta,L,MTL,26,60,6,9,15
60,8482157,Will Cuylle,L,NYR,22,49,6,9,15
60,8479291,Kevin Rooney,C,CGY,31,54,5,10,15
60,8481550,Adam Beckman,L,NJD,23,37,4,11,15
60,8480355,Mark Kastelic,C,BOS,25,54,4,11,15
60,8477499,Rasmus Ristolainen,D,PHI,30,61,3,12,15
60,8480058,Pierre-Olivier Joseph,D,STL,25,56,2,13,15
60,8482762,Simon Edvinsson,D,DET,21,57,9,5,14
60,8479328,Julien Gauthier,R,NYI,27,66,8,6,14
60,8476873,Mark Jankowski,C,NSH,30,44,7,7,14
60,8477406,Mattias Janmark,C,EDM,32,62,6,8,14
60,8481019,David Gustafsson,C,WPG,24,43,5,9,14
60,8478585,Derek Ryan,C,EDM,38,70,5,9,14
60,8482751,Ryan Winterton,C,SEA,21,40,5,9,14
60,8480145,Neal Pionk,D,WPG,29,72,4,10,14
60,8474013,Ian Cole,D,UTA,35,53,4,10,14
60,8476902,Esa Lindell,D,DAL,30,70,3,11,14
60,8480246,Nick Perbix,D,TBL,26,64,3,11,14
60,8483460,David Jiricek,D,CBJ,21,56,3,11,14
60,8478133,Jake Evans,C,MTL,28,78,2,12,14
60,8475455,Brenden Dillon,D,NJD,34,62,2,12,14
60,8480860,Kevin Bahl,D,CGY,24,55,2,12,14
60,8476429,Scott Mayfield,D,NYI,32,74,1,13,14
60,8480073,Erik Brannstrom,D,COL,25,65,1,13,14
60,8476858,Phillip Di Giuseppe,L,VAN,31,42,12,1,13
60,8482737,Zack Bolduc,C,STL,21,53,7,6,13
60,8481601,Simon Holmstrom,R,NYI,23,63,6,7,13
60,8476822,Luke Glendening,C,TBL,35,80,5,8,13
60,8477573,Nathan Walker,L,STL,30,45,4,9,13
60,8480252,Cole Guttman,C,CHI,25,41,4,9,13
60,8475718,Justin Holl,D,DET,32,53,4,9,13
60,8474568,Luke Schenn,D,NSH,35,57,4,9,13
60,8482166,Shakir Mukhamadullin,D,SJS,22,52,4,9,13
60,8482666,Scott Morrow,D,CAR,22,44,4,9,13
60,8482634,Alex Steeves,C,TOR,25,53,3,10,13
60,8481708,Zac Jones,D,NYR,24,55,3,10,13
60,8478211,Dryden Hunt,L,CGY,29,55,3,10,13
60,8478452,Caleb Jones,D,LAK,27,56,2,11,13
60,8476967,Brett Kulak,D,EDM,30,66,2,11,13
60,8483565,Nick Blankenburg,D,NSH,26,56,6,6,12
60,8483493,Frank Nazar,C,CHI,20,54,6,6,12
60,8481532,Alex Turcotte,C,LAK,23,41,6,6,12
60,8479671,Mathieu Olivier,R,CBJ,27,51,5,7,12
60,8482744,James Malatesta,L,CBJ,21,46,5,7,12
60,8479718,Alex Barré-Boulet,C,MTL,27,54,5,7,12
60,8479344,Jesse Puljujarvi,R,PIT,26,56,5,7,12
60,8475225,Craig Smith,C,CHI,35,52,4,8,12
60,8481568,Alex Vlasic,D,CHI,23,59,4,8,12
60,8480727,Zach Whitecloud,D,VGK,28,44,4,8,12
60,8479359,Beck Malenstyn,L,BUF,26,47,4,8,12
60,8482659,Josh Doan,R,UTA,22,49,4,8,12
60,8477018,Ben Hutton,D,VGK,31,50,3,9,12
60,8475233,David Savard,D,MTL,34,64,2,10,12
60,8481598,Philip Broberg,D,EDM,23,41,2,10,12
60,8479972,Mason Shaw,C,WPG,26,43,2,10,12
60,8476331,Dylan DeMelo,D,WPG,31,62,0,12,12
60,8475690,Chris Tanev,D,TOR,35,61,0,12,12
60,8478421,A.J. Greer,L,FLA,28,51,8,3,11
60,8481789,Tye Kartye,L,SEA,23,42,8,3,11
60,8483763,Maksymilian Szuber,D,UTA,22,31,8,3,11
60,8480441,Trey Fix-Wolansky,R,CBJ,25,37,7,4,11
60,8477482,Zachary Sanford,L,CHI,30,30,7,4,11
60,8481517,Brett Leason,R,ANA,25,51,6,5,11
60,8477508,Curtis Lazar,C,NJD,29,50,6,5,11
60,8479315,Joey Anderson,R,CHI,26,49,4,7,11
60,8477931,Tomas Nosek,L,FLA,32,61,4,7,11
60,8480025,MacKenzie Entwistle,R,FLA,25,63,4,7,11
60,8483466,Kevin Korchinski,D,CHI,20,51,4,7,11
60,8473446,Erik Johnson,D,PHI,36,44,4,7,11
60,8475462,Radko Gudas,D,ANA,34,69,3,8,11
60,8478859,Niko Mikkola,D,FLA,28,58,3,8,11
60,8474612,Travis Hamonic,D,OTT,34,51,3,8,11
60,8477938,Haydn Fleury,D,WPG,28,39,3,8,11
60,8475208,Brian Dumoulin,D,ANA,33,66,2,9,11
60,8480879,Jacob Bernard-Docker,D,OTT,24,52,2,9,11
60,8476624,Barclay Goodrow,C,SJS,31,53,2,9,11
60,8480245,Olle Lycksell,R,PHI,25,37,2,9,11
60,8476874,Olli Maatta,D,DET,30,61,1,10,11
60,8481167,Brayden Pachal,D,CGY,25,39,1,10,11
60,8480807,Mattias Samuelsson,D,BUF,24,59,0,11,11
60,8479944,Zach Aston-Reese,C,VGK,30,51,8,2,10
60,8479994,Jaret Anderson-Dolan,C,WPG,25,35,7,3,10
60,8478831,Kevin Stenlund,C,UTA,28,54,7,3,10
60,8482077,Dylan Holloway,L,EDM,23,57,6,4,10
60,8479772,Zack MacEwen,R,OTT,28,50,5,5,10
60,8481161,Jake Christiansen,D,CBJ,25,55,5,5,10
60,8481751,Lukas Rousek,R,BUF,25,42,4,6,10
60,8481537,Nikita Okhotiuk,D,CGY,24,55,4,6,10
60,8481178,Egor Zamula,D,PHI,24,58,4,6,10
60,8476913,Devin Shore,C,MIN,30,41,4,6,10
60,8481147,Reese Johnson,C,MIN,26,32,4,6,10
60,8479442,Troy Stecher,D,EDM,30,61,3,7,10
60,8477851,Jordan Oesterle,D,BOS,32,39,3,7,10
60,8482192,Isaak Phillips,D,CHI,23,56,2,8,10
60,8481122,Simon Benoit,D,TOR,26,38,2,8,10
60,8471709,Marc-Edouard Vlasic,D,SJS,37,63,1,9,10
60,8480001,Urho Vaakanainen,D,ANA,25,53,0,10,10
60,8474166,Alec Martinez,D,CHI,37,49,0,10,10
60,8481641,Joel Kiviranta,L,COL,28,71,7,2,9
60,8481679,Maxence Guenette,D,OTT,23,33,7,2,9
60,8480289,Morgan Barron,C,WPG,26,54,6,3,9
60,8477887,Patrick Brown,C,BOS,32,48,4,5,9
60,8482713,Mackie Samoskevich,R,FLA,22,42,4,5,9
60,8481617,Vasily Podkolzin,R,VAN,23,45,3,6,9
60,8479372,Joshua Mahura,D,SEA,26,53,3,6,9
60,8478451,Ethan Bear,D,WSH,27,55,3,6,9
60,8475958,Michael Sgarbossa,C,WSH,32,33,3,6,9
60,8478416,Erik Cernak,D,TBL,27,74,2,7,9
60,8482095,Tyler Kleven,D,OTT,22,44,2,7,9
60,8475750,Jon Merrill,D,MIN,32,62,2,7,9
60,8476372,Nick Seeler,D,PHI,31,42,2,7,9
60,8481056,Spencer Stastney,D,NSH,24,34,1,8,9
60,8482859,Zack Ostapchuk,C,OTT,21,49,0,9,9
60,8482747,Brennan Othmann,L,NYR,21,45,5,3,8
60,8481599,Victor Soderstrom,D,UTA,23,40,3,5,8
60,8484254,Akito Hirose,D,VAN,25,37,3,5,8
60,8482451,Mikael Pyyhtia,L,CBJ,23,41,1,7,8
60,8481567,Henry Thrun,D,SJS,23,52,1,7,8
60,8483630,Pavol Regenda,L,ANA,25,26,1,7,8
60,8481518,Nolan Foote,L,NJD,24,43,5,2,7
60,8474034,Patrick Maroon,L,CHI,36,43,4,3,7
60,8480292,Carson Meyer,R,ANA,27,33,4,3,7
60,8484911,Collin Graf,R,SJS,22,49,4,3,7
60,8480845,Rasmus Kupari,C,WPG,24,44,4,3,7
60,8482807,Ethan Del Mastro,D,CHI,21,50,3,4,7
60,8484149,Gavin Brindley,C,CBJ,20,43,3,4,7
60,8482496,Nils Aman,C,VAN,24,40,3,4,7
60,8474567,Zach Bogosian,D,MIN,34,62,3,4,7
60,8481592,Jakob Pelletier,L,CGY,23,38,3,4,7
60,8475177,Calvin de Haan,D,COL,33,44,3,4,7
60,8480880,Jakub Lauko,C,MIN,24,35,3,4,7
60,8482511,Mason Lohrei,D,BOS,23,29,2,5,7
60,8477971,Andreas Englund,D,LAK,28,35,2,5,7
60,8482153,Brendan Brisson,C,VGK,23,32,2,5,7
60,8480990,Declan Chisholm,D,MIN,24,38,2,5,7
60,8481600,Tobias Bjornfot,D,FLA,23,45,1,6,7
60,8474090,Brendan Smith,D,DAL,35,52,1,6,7
60,8482784,Zach Dean,C,STL,21,43,1,6,7
60,8479378,Logan Stanley,D,WPG,26,50,1,6,7
60,8476441,Joel Edmundson,D,LAK,31,38,1,6,7
60,8478017,Mark Friedman,D,VAN,29,42,1,6,7
60,8478874,Adam Gaudette,R,OTT,28,33,0,7,7
60,8480844,Grigori Denisenko,L,VGK,24,24,5,1,6
60,8475762,Derek Forbort,D,VAN,32,40,3,3,6
60,8478409,Anthony Richard,C,PHI,28,28,3,3,6
60,8480007,Jonas Rondbjerg,R,VGK,25,43,3,3,6
60,8483012,Logan Morrison,C,SEA,22,36,3,3,6
60,8482145,Mavrik Bourque,C,DAL,22,49,3,3,6
60,8481609,Vladislav Kolyachonok,D,UTA,23,27,3,3,6
60,8477070,Liam O'Brien,C,UTA,30,53,3,3,6
60,8482172,Landon Slaggert,L,CHI,22,32,3,3,6
60,8476952,Dominic Toninato,C,WPG,30,38,2,4,6
60,8482141,Lukas Cormier,D,VGK,22,23,2,4,6
60,8471817,Ryan Reaves,R,TOR,37,58,2,4,6
60,8478146,Matthew Highmore,C,OTT,28,32,2,4,6
60,8477365,Connor Clifton,D,BUF,29,57,1,5,6
60,8479324,Ryan Lindgren,D,NYR,26,60,1,5,6
60,8483619,Filip Roos,D,OTT,25,27,1,5,6
60,8482861,Vincent Iorio,D,WSH,22,34,1,5,6
60,8481556,John Beecher,C,BOS,23,38,1,5,6
60,8478450,Parker Wotherspoon,D,BOS,27,35,1,5,6
60,8480196,Jacob Bryson,D,BUF,27,40,0,6,6
60,8479348,Kale Clague,D,BUF,26,37,0,6,6
60,8475235,Nicolas Deslauriers,L,PHI,33,40,4,1,5
60,8479991,Jake Leschyshyn,C,NYR,25,29,4,1,5
60,8476442,Matt Nieto,L,PIT,32,44,3,2,5
60,8481754,Nikita Nesterenko,C,ANA,23,34,3,2,5
60,8477384,Joshua Brown,D,EDM,30,36,3,2,5
60,8482964,Arber Xhekaj,D,MTL,23,44,2,3,5
60,8479968,Vinni Lettieri,C,BOS,29,47,2,3,5
60,8471677,Jack Johnson,D,CBJ,37,66,2,3,5
60,8482177,Marat Khusnutdinov,C,MIN,22,35,2,3,5
60,8479986,Kole Lind,R,DAL,26,48,2,3,5
60,8478424,Jansen Harkins,C,ANA,27,43,2,3,5
60,8477462,Robert Hagg,D,VGK,29,37,2,3,5
60,8477244,Chad Ruhwedel,D,NYR,34,30,2,3,5
60,8477401,John Hayden,C,SEA,29,26,2,3,5
60,8483549,Lucas Condotta,L,MTL,27,36,1,4,5
60,8482765,Isak Rosen,R,BUF,21,31,1,4,5
60,8476473,Connor Murphy,D,CHI,31,35,1,4,5
60,8482144,Jack Thompson,D,SJS,22,26,1,4,5
60,8480084,Nick DeSimone,D,NJD,30,14,1,4,5
60,8480870,Bo Groulx,C,NYR,24,29,1,4,5
60,8479576,Vincent Desharnais,D,VAN,28,34,1,4,5
60,8478454,Noah Juulsen,D,VAN,27,37,0,5,5
60,8481237,Kyle MacLean,C,NYI,25,25,4,0,4
60,8479638,Justin Brazeau,R,BOS,26,34,3,1,4
60,8479536,Axel Jonsson-Fjallby,L,WPG,26,39,3,1,4
60,8481605,Jackson LaCombe,D,ANA,23,24,2,2,4
60,8477962,Brendan Lemieux,L,CAR,28,35,2,2,4
60,8478021,William Lagesson,D,DET,28,26,2,2,4
60,8479981,Jonah Gadjovich,L,FLA,26,41,2,2,4
60,8481065,Angus Crookshank,L,OTT,25,21,2,2,4
60,8478051,Max Willman,C,NJD,29,25,2,2,4
60,8479367,William Lockwood,R,FLA,26,29,2,2,4
60,8480032,Shane Bowers,C,NJD,25,20,2,2,4
60,8479320,Maxime Lajoie,D,SEA,27,19,2,2,4
60,8481578,Graeme Clarke,R,MIN,23,13,2,2,4
60,8484258,Sam Malinski,D,COL,26,22,2,2,4
60,8482102,Vasily Ponomarev,C,PIT,22,13,2,2,4
60,8478468,Jeremy Lauzon,D,NSH,27,49,1,3,4
60,8481006,Tyler Tucker,D,STL,24,19,1,3,4
60,8482147,Jean-Luc Foudy,C,COL,22,24,1,3,4
60,8480834,Ty Emberson,D,SJS,24,33,1,3,4
60,8482250,Callahan Burke,C,VGK,27,27,1,3,4
60,8477527,Ross Johnston,L,ANA,30,38,1,3,4
60,8481699,Aku Raty,R,UTA,23,12,1,3,4
60,8479249,Andrew Poturalski,C,SJS,30,34,0,4,4
60,8479379,Givani Smith,R,SJS,26,32,0,4,4
60,8479985,Cale Fleury,D,SEA,26,29,3,0,3
60,8483397,Marc McLaughlin,C,BOS,25,36,2,1,3
60,8484287,Cole McWard,D,VAN,23,23,2,1,3
60,8482470,Ilya Solovyov,D,CGY,24,23,2,1,3
60,8482165,Yan Kuznetsov,D,CGY,22,18,2,1,3
60,8482070,Mitchell Chaffee,R,TBL,26,52,1,2,3
60,8482652,Walker Duehr,R,CGY,27,41,1,2,3
60,8481743,Marc Del Gaizo,D,NSH,25,21,1,2,3
60,8481701,Santeri Hatakka,D,NJD,23,31,1,2,3
60,8482061,Brandon Biro,L,SEA,26,10,1,2,3
60,8482094,Daemon Hunt,D,MIN,22,14,1,2,3
60,8483512,Matthew Savoie,C,EDM,20,22,1,2,3
60,8479362,Riley Tufte,L,BOS,26,25,1,2,3
60,8480890,Jan Jenik,C,OTT,24,22,1,2,3
60,8477467,Gustav Olofsson,D,SEA,30,18,1,2,3
60,8479419,Brett Murray,L,BUF,26,18,0,3,3
60,8482733,Logan Mailloux,D,MTL,31,37,0,3,3
60,8484325,Waltteri Merela,C,TBL,26,9,0,3,3
60,8481030,Jack St. Ivany,D,PIT,25,16,0,3,3
60,8482118,Sam Colangelo,R,ANA,23,19,0,3,3
60,8475755,Alexander Petrovic,D,DAL,32,13,0,3,3
60,8483570,Ben Meyers,C,SEA,26,24,2,0,2
60,8477473,Justin Bailey,R,SJS,29,22,2,0,2
60,8481543,Nikita Alexandrov,C,STL,24,19,2,0,2
60,8481422,Jake Lucchini,C,NSH,29,19,2,0,2
60,8481726,Adam Edstrom,C,NYR,24,7,2,0,2
60,8477993,Justin Kirkland,C,CGY,28,8,2,0,2
60,8477335,Kyle Burroughs,D,LAK,29,44,1,1,2
60,8482929,Emil Lilleberg,D,TBL,23,19,1,1,2
60,8481593,Jayden Struble,D,MTL,23,18,1,1,2
60,8482516,Matthew Kessel,D,STL,24,20,1,1,2
60,8477073,Kurtis MacDermid,L,NJD,30,26,1,1,2
60,8482858,Ryker Evans,D,SEA,23,20,1,1,2
60,8475413,Justin Dowling,C,NJD,34,15,1,1,2
60,8480267,Sammy Walker,C,MIN,25,16,1,1,2
60,8478477,Mitchell Stephens,C,SEA,27,17,1,1,2
60,8479330,Brandon Gignac,C,MTL,27,8,1,1,2
60,8477541,Dakota Mermis,D,TOR,30,8,1,1,2
60,8478881,Brett Seney,L,CHI,28,15,1,1,2
60,8478502,Dennis Gilbert,D,BUF,28,15,0,2,2
60,8481806,Louis Crevier,D,CHI,23,13,0,2,2
60,8482162,Roby Jarventie,L,EDM,22,17,0,2,2
60,8484259,Ondrej Pavel,C,COL,31,4,0,2,2
60,8482201,Gage Goncalves,C,TBL,23,30,1,0,1
60,8474062,Riley Nash,C,NYR,35,15,1,0,1
60,8483567,Georgii Merkulov,C,BOS,24,9,1,0,1
60,8478446,Glenn Gawdin,C,LAK,27,13,1,0,1
60,8480874,Adam Ginning,D,PHI,24,10,1,0,1
60,8483597,Milos Kelemen,L,UTA,25,12,1,0,1
60,8482787,Nikita Chibrikov,R,WPG,31,6,1,0,1
60,8478854,Ryan Shea,D,PIT,27,7,1,0,1
60,8483489,Fraser Minten,C,TOR,31,13,1,0,1
60,8477810,Joel Hanley,D,CGY,33,31,1,0,1
60,8481024,Linus Karlsson,C,VAN,25,7,1,0,1
60,8481655,Cole Schwindt,R,CGY,23,5,1,0,1
60,8482197,Adam Raska,R,MIN,23,11,1,0,1
60,8481541,Samuel Bolduc,D,NYI,24,23,0,1,1
60,8475795,Dylan McIlrath,D,WSH,32,14,0,1,1
60,8483407,Brandon Scanlin,D,NYR,25,6,0,1,1
60,8481719,Maxwell Crozier,D,TBL,24,18,0,1,1
60,8480075,Cameron Crotty,D,MIN,25,12,0,1,1
60,8481206,John Ludvig,D,PIT,24,13,0,1,1
60,8479587,Rhett Gardner,C,PHI,28,26,0,1,1
60,8480823,Alexander Alexeyev,D,WSH,25,10,0,1,1
60,8477320,Anton Blidh,L,NYR,29,21,0,1,1
60,8479522,Hardy Haman Aktell,D,WSH,26,1,0,1,1
60,8483609,Adam Klapka,R,CGY,24,4,0,1,1
60,8481462,Mason Morelli,L,VGK,28,14,0,1,1
60,8480468,James Hamblin,L,EDM,25,21,0,1,1
60,8482476,Emil Heineman,L,MTL,23,4,0,1,1
60,8483398,Declan Carlile,D,TBL,31,10,0,1,1
60,8483395,Arshdeep Bains,L,VAN,23,7,0,1,1
60,8482088,Justin Sourdif,R,FLA,22,18,0,1,1
60,8483920,Pierrick Dube,R,WSH,23,4,0,1,1
60,8476323,Max McCormick,L,SEA,32,4,0,1,1
60,8481585,Egor Afanasyev,L,SJS,23,15,0,0,0
60,8483471,Brad Lambert,C,WPG,31,5,0,0,0
60,8481043,Cole Koepke,L,BOS,26,10,0,0,0
60,8480851,Akil Thomas,C,LAK,24,22,0,0,0
60,8479421,Jacob Moverare,D,LAK,26,4,0,0,0
60,8482460,Matt Rempe,C,NYR,22,11,0,0,0
60,8481564,Ryan Johnson,D,BUF,23,13,0,0,0
60,8484304,Uvis Balinskis,D,FLA,28,10,0,0,0
60,8478011,Louie Belpedio,D,PHI,28,14,0,0,0
60,8481534,Raphael Lavoie,C,EDM,24,3,0,0,0
60,8484321,Nikolas Matinpalo,D,OTT,26,0,0,0,0
60,8477149,Scott Sabourin,R,SJS,32,8,0,0,0
60,8475780,Chris Wagner,R,COL,33,9,0,0,0
60,8480306,Grant Hutton,D,NYI,29,4,0,0,0
60,8484255,Jason Polin,R,COL,25,7,0,0,0
60,8482126,Emil Andrae,D,PHI,31,1,0,0,0
60,8478147,Bokondji Imama,L,PIT,28,6,0,0,0
60,8483546,Marshall Rifai,D,TOR,26,6,0,0,0
60,8483432,Luca Del Bel Belluz,C,CBJ,31,2,0,0,0
60,8484326,Patrik Koch,D,UTA,28,3,0,0,0
60,8483531,Brian Halonen,L,NJD,25,3,0,0,0
60,8483401,Marc Johnstone,R,PIT,28,4,0,0,0
60,8480274,Philip Kemp,D,EDM,25,3,0,0,0
60,8470794,Joe Pavelski,C,,40,0,0,0,0
60,8479321,Lucas Johansen,D,,27,0,0,0,0
60,8477950,Tony DeAngelo,D,,29,0,0,0,0
60,8471218,Blake Wheeler,R,,38,0,0,0,0
60,8475197,Tyson Barrie,D,,33,0,0,0,0
60,8474157,Max Pacioretty,L,,36,0,0,0,0
60,8475744,Evgeny Kuznetsov,C,,32,0,0,0,0
60,8474037,James van Riemsdyk,L,,35,0,0,0,0
60,8476907,Mackenzie MacEachern,L,,30,0,0,0,0
60,8480216,Jacob Peterson,C,,25,0,0,0,0
60,8474602,Justin Schultz,D,,34,0,0,0,0
60,8482222,Alexander Barabanov,L,,30,0,0,0,0
60,8474031,Kevin Shattenkirk,D,,35,0,0,0,0
60,8477330,Dominik Kubalik,L,,29,0,0,0,0
60,8480884,Calen Addison,D,,24,0,0,0,0
60,8475906,John Klingberg,D,,32,0,0,0,0
60,8480008,Adam Ruzicka,C,,25,0,0,0,0
60,8476884,Derrick Pouliot,D,,30,0,0,0,0
60,8476919,Chris Tierney,C,,30,0,0,0,0
60,8479415,Michael McLeod,C,,26,0,0,0,0
60,8474870,Tyler Johnson,C,,34,0,0,0,0
60,8470604,Jeff Carter,C,,39,0,0,0,0
60,8478104,Sammy Blais,L,,28,0,0,0,0
60,8474884,Mike Hoffman,C,,35,0,0,0,0
60,8481591,Sam Poulin,R,,23,0,0,0,0
60,8471274,Alex Goligoski,D,,39,0,0,0,0
60,8476871,Tanner Pearson,L,,32,0,0,0,0
60,8476393,Nick Cousins,C,,31,0,0,0,0
60,8479977,Kailer Yamamoto,R,,26,0,0,0,0
60,8479346,Dillon Dube,C,,26,0,0,0,0
60,8480184,Gustav Lindstrom,D,,26,0,0,0,0
60,8479376,Victor Mete,D,,26,0,0,0,0
60,8473449,Kyle Okposo,R,,36,0,0,0,0
60,8481058,Jesse Ylonen,R,,25,0,0,0,0
60,8475752,Tyler Pitlick,C,,33,0,0,0,0
60,8481239,Samuel Fagemo,L,,24,0,0,0,0
60,8480821,Filip Zadina,R,,25,0,0,0,0
60,8470966,Mark Giordano,D,,41,0,0,0,0
60,8478495,Denis Gurianov,R,,27,0,0,0,0
60,8477464,Nic Petan,C,,29,0,0,0,0
60,8478099,Kevin Labanc,R,,29,0,0,0,0
60,8482241,Radim Zohorna,L,,28,0,0,0,0
60,8474040,Sam Gagner,C,,35,0,0,0,0
60,8479514,Rem Pitlick,C,,27,0,0,0,0
60,8478430,Oliver Kylington,D,,27,0,0,0,0
60,8479533,Joona Koppanen,L,,26,0,0,0,0
60,8479984,Cal Foote,D,,26,0,0,0,0
60,8477126,Jayson Megna,C,,34,0,0,0,0
60,8475164,Jakob Silfverberg,R,,34,0,0,0,0
60,8474009,Nick Bonino,C,,36,0,0,0,0
60,8479458,Nikita Zaitsev,D,,33,0,0,0,0
60,8477944,Jakub Vrana,L,,28,0,0,0,0
60,8471699,Andrew Cogliano,C,,37,0,0,0,0
60,8478067,Oskar Lindblom,L,,28,0,0,0,0
60,8471686,Marc Staal,D,,37,0,0,0,0
60,8470610,Zach Parise,L,,40,0,0,0,0
60,8478904,Steven Lorentz,C,,28,0,0,0,0
60,8473473,Milan Lucic,L,,36,0,0,0,0
60,8480031,Maxime Comtois,L,,25,0,0,0,0
60,8478512,Austin Czarnik,C,,32,0,0,0,0
60,8473504,Cal Clutterbuck,R,,37,0,0,0,0
60,8477454,Adam Erne,L,,29,0,0,0,0
60,8479383,Boris Katchouk,L,,26,0,0,0,0
60,8475825,Jani Hakanpää,D,,32,0,0,0,0
60,8477846,Ryan Carpenter,C,,33,0,0,0,0
60,8477930,Pierre-Edouard Bellemare,L,,39,0,0,0,0
60,8478400,Colin White,C,,27,0,0,0,0
60,8480226,Marián Studenic,R,,26,0,0,0,0
60,8480853,Liam Foudy,C,,24,0,0,0,0
60,8475797,Jarred Tinordi,D,,32,0,0,0,0
60,8479423,Alex Nylander,L,,26,0,0,0,0
60,8474618,Marco Scandella,D,,34,0,0,0,0
60,8478028,Fredrik Olofsson,L,,28,0,0,0,0
60,8474709,Matt Martin,L,,35,0,0,0,0
60,8481070,Hugh McGing,L,,26,0,0,0,0
60,8479546,Oskar Steen,C,,26,0,0,0,0
60,8474145,Robert Bortuzzo,D,,35,0,0,0,0
60,8476915,Jujhar Khaira,L,,30,0,0,0,0
60,8475278,Byron Froese,C,,33,0,0,0,0
60,8481812,Nikolai Knyzhov,D,,27,0,0,0,0
60,8478408,Travis Dermott,D,,28,0,0,0,0
60,8481077,John Leonard,L,,26,0,0,0,0
60,8479547,Matthew Phillips,R,,26,0,0,0,0
60,8480836,Jonathan Gruden,C,,24,0,0,0,0
60,8481690,Tyler Angle,C,,24,0,0,0,0
60,8475766,Austin Watson,L,,32,0,0,0,0
60,8481016,Ruslan Iskhakov,C,,24,0,0,0,0
60,8478078,Rourke Chartier,C,,28,0,0,0,0
60,8480776,Sheldon Rempal,R,,29,0,0,0,0
60,8478956,Samuel Laberge,L,NJD,27,0,0,0,0
60,8483045,Cameron Butler,R,CBJ,31,1,0,0,0
60,8484314,Jiri Smejkal,L,,28,0,0,0,0
61,8478402,Connor McDavid,C,EDM,27,81,36,110,146
61,8479318,Auston Matthews,C,TOR,27,78,71,64,135
61,8477492,Nathan MacKinnon,C,COL,29,81,55,77,132
61,8476453,Nikita Kucherov,R,TBL,31,82,43,85,128
61,8480027,Jason Robertson,L,DAL,25,81,41,72,113
61,8476468,J.T. Miller,C,VAN,31,76,36,76,112
61,8476887,Filip Forsberg,L,NSH,30,77,46,64,110
61,8477934,Leon Draisaitl,C,EDM,29,80,40,70,110
61,8477956,David Pastrnak,R,BOS,28,81,55,54,109
61,8477939,William Nylander,R,TOR,28,81,54,55,109
61,8480012,Elias Pettersson,C,VAN,26,79,41,68,109
61,8477942,Kevin Fiala,L,LAK,28,82,39,66,105
61,8478483,Mitch Marner,R,TOR,27,81,33,72,105
61,8478864,Kirill Kaprizov,L,MIN,27,76,43,58,101
61,8480801,Brady Tkachuk,L,OTT,25,79,48,51,99
61,8481559,Jack Hughes,C,NJD,23,74,36,63,99
61,8478403,Jack Eichel,C,VGK,28,80,47,50,97
61,8478420,Mikko Rantanen,R,COL,28,82,46,51,97
61,8479314,Matthew Tkachuk,L,FLA,27,76,33,62,95
61,8475166,John Tavares,C,TOR,34,79,34,60,94
61,8477493,Aleksander Barkov,C,FLA,29,79,30,64,94
61,8482116,Tim Stützle,C,OTT,22,80,30,62,92
61,8478445,Mathew Barzal,C,NYI,27,80,22,70,92
61,8475172,Nazem Kadri,C,CGY,34,79,29,62,91
61,8477409,Carter Verhaeghe,C,FLA,29,80,42,48,90
61,8479407,Jesper Bratt,L,NJD,26,76,30,60,90
61,8475913,Mark Stone,R,VGK,32,77,30,59,89
61,8478010,Brayden Point,C,TBL,28,80,36,52,88
61,8478398,Kyle Connor,L,WPG,28,74,40,47,87
61,8477404,Jake Guentzel,C,TBL,30,80,36,51,87
61,8478550,Artemi Panarin,L,NYR,33,75,32,55,87
61,8476459,Mika Zibanejad,C,NYR,31,75,38,48,86
61,8476389,Vincent Trocheck,C,NYR,31,79,36,49,85
61,8480036,Miro Heiskanen,D,DAL,25,79,18,67,85
61,8474141,Patrick Kane,R,DET,36,82,36,48,84
61,8480002,Nico Hischier,C,NJD,25,74,28,56,84
61,8479323,Adam Fox,D,NYR,26,73,19,64,83
61,8475692,Mats Zuccarello,R,MIN,37,77,26,56,82
61,8478414,Timo Meier,R,NJD,28,78,35,46,81
61,8476456,Jonathan Huberdeau,C,CGY,31,77,19,62,81
61,8477933,Sam Reinhart,C,FLA,29,81,38,41,79
61,8471675,Sidney Crosby,C,PIT,37,72,32,47,79
61,8477501,Valeri Nichushkin,R,COL,29,80,42,36,78
61,8482740,Wyatt Johnston,C,DAL,21,82,34,44,78
61,8481557,Matt Boldy,L,MIN,23,74,16,62,78
61,8474564,Steven Stamkos,C,NSH,34,71,43,34,77
61,8477946,Dylan Larkin,C,DET,28,80,36,41,77
61,8476460,Mark Scheifele,C,WPG,31,76,33,44,77
61,8480023,Robert Thomas,C,STL,25,76,22,55,77
61,8480839,Rasmus Dahlin,D,BUF,24,72,18,59,77
61,8480800,Quinn Hughes,D,VAN,25,78,9,68,77
61,8475786,Zach Hyman,L,EDM,32,79,47,29,76
61,8476539,Jonathan Marchessault,R,NSH,34,74,39,37,76
61,8479337,Alex DeBrincat,R,DET,27,81,26,49,75
61,8471685,Anze Kopitar,C,LAK,37,79,18,57,75
61,8477500,Bo Horvat,C,NYI,29,80,43,31,74
61,8479542,Brandon Hagel,L,TBL,26,82,31,43,74
61,8473419,Brad Marchand,L,BOS,36,81,30,44,74
61,8474600,Roman Josi,D,NSH,34,74,17,57,74
61,8477960,Adrian Kempe,R,LAK,28,81,30,43,73
61,8476399,Blake Coleman,C,CGY,33,79,34,38,72
61,8477964,Ivan Barbashev,C,VGK,29,75,27,45,72
61,8476881,Tomas Hertl,C,VGK,31,76,34,37,71
61,8475810,Bryan Rust,R,PIT,32,71,32,39,71
61,8482078,Lucas Raymond,L,DET,22,79,30,41,71
61,8482093,Seth Jarvis,C,CAR,22,71,30,41,71
61,8471214,Alex Ovechkin,L,WSH,39,76,36,34,70
61,8478493,Joel Eriksson Ek,C,MIN,27,71,31,39,70
61,8480069,Cale Makar,D,COL,26,74,24,46,70
61,8475158,Ryan O'Reilly,C,NSH,33,74,20,50,70
61,8480865,Noah Dobson,D,NYI,24,79,10,60,70
61,8475765,Vladimir Tarasenko,R,DET,33,82,29,40,69
61,8479420,Tage Thompson,C,BUF,27,76,47,21,68
61,8478444,Brock Boeser,R,VAN,27,74,31,37,68
61,8476454,Ryan Nugent-Hopkins,C,EDM,31,80,22,46,68
61,8478439,Travis Konecny,R,PHI,27,76,24,43,67
61,8476853,Morgan Rielly,D,TOR,30,75,8,59,67
61,8474679,Gustav Nyquist,C,NSH,35,75,23,43,66
61,8477955,Jared McCann,L,SEA,28,75,36,29,65
61,8478449,Roope Hintz,C,DAL,28,81,33,32,65
61,8477496,Elias Lindholm,C,BOS,30,80,24,41,65
61,8475167,Victor Hedman,D,TBL,34,79,17,48,65
61,8477949,Alex Tuch,R,BUF,28,68,22,42,64
61,8480803,Evan Bouchard,D,EDM,25,72,12,52,64
61,8475184,Chris Kreider,L,NYR,33,74,32,31,63
61,8477951,Nick Schmaltz,C,UTA,28,75,23,40,63
61,8484144,Connor Bedard,C,CHI,19,73,13,50,63
61,8479675,Trevor Moore,L,LAK,29,81,32,30,62
61,8475784,Jeff Skinner,C,EDM,32,73,30,32,62
61,8475754,Brock Nelson,C,NYI,33,82,30,32,62
61,8480208,Drake Batherson,R,OTT,26,80,24,38,62
61,8476346,Johnny Gaudreau,L,CBJ,31,71,18,44,62
61,8477504,Josh Morrissey,D,WPG,29,75,9,53,62
61,8479343,Clayton Keller,R,UTA,26,77,28,33,61
61,8478440,Dylan Strome,C,WSH,27,69,24,37,61
61,8480018,Nick Suzuki,C,MTL,25,77,24,37,61
61,8480830,Andrei Svechnikov,R,CAR,24,74,23,38,61
61,8478462,Nicolas Roy,C,VGK,27,74,22,39,61
61,8473512,Claude Giroux,R,OTT,36,79,22,38,60
61,8471724,Kris Letang,D,PIT,37,79,13,46,59
61,8482109,Alexis Lafrenière,L,NYR,23,76,30,28,58
61,8478427,Sebastian Aho,C,CAR,27,71,24,34,58
61,8477940,Nikolaj Ehlers,L,WPG,28,70,24,34,58
61,8479999,Casey Mittelstadt,C,COL,26,80,15,43,58
61,8479425,Filip Hronek,D,VAN,27,74,13,45,58
61,8480015,Owen Tippett,R,PHI,25,75,32,25,57
61,8482745,Mason McTavish,C,ANA,21,71,25,32,57
61,8478519,Anthony Cirelli,C,TBL,27,80,25,32,57
61,8481711,Matias Maccelli,L,UTA,24,74,24,33,57
61,8477402,Pavel Buchnevich,L,STL,29,74,22,35,57
61,8476448,William Karlsson,C,VGK,31,76,21,36,57
61,8482124,Quinton Byfield,R,LAK,22,81,19,38,57
61,8479325,Charlie McAvoy,D,BOS,27,69,12,45,57
61,8476880,Tom Wilson,R,WSH,30,72,30,26,56
61,8471215,Evgeni Malkin,C,PIT,38,73,23,33,56
61,8480797,Joel Farabee,L,PHI,24,75,20,36,56
61,8478396,Noah Hanifin,D,VGK,27,67,16,40,56
61,8477447,Shea Theodore,D,VGK,29,62,15,41,56
61,8477407,Anthony Duclair,L,NYI,29,79,28,27,55
61,8474102,David Perron,L,OTT,36,77,25,30,55
61,8481540,Cole Caufield,R,MTL,23,78,22,33,55
61,8474578,Erik Karlsson,D,PIT,34,80,8,47,55
61,8478401,Pavel Zacha,C,BOS,27,78,30,24,54
61,8474150,Mikael Backlund,C,CGY,35,79,16,38,54
61,8475798,Mikael Granlund,C,SJS,32,73,15,39,54
61,8477503,Max Domi,C,TOR,29,76,12,42,54
61,8481068,Yegor Sharangovich,C,CGY,26,76,26,27,53
61,8482699,Dylan Guenther,R,UTA,21,73,24,29,53
61,8479385,Jordan Kyrou,C,STL,26,76,23,30,53
61,8478460,Zach Werenski,D,CBJ,27,80,10,43,53
61,8478407,Vince Dunn,D,SEA,28,77,7,46,53
61,8478042,Viktor Arvidsson,L,EDM,31,72,25,27,52
61,8478542,Evan Rodrigues,C,FLA,31,76,23,29,52
61,8475168,Matt Duchene,C,DAL,33,81,21,31,52
61,8476483,Rickard Rakell,R,PIT,31,68,30,21,51
61,8475794,Tyler Seguin,C,DAL,32,82,25,26,51
61,8482159,Tyson Foerster,R,PHI,22,75,24,27,51
61,8482665,Matty Beniers,C,SEA,22,76,21,30,51
61,8478873,Troy Terry,R,ANA,27,73,19,32,51
61,8484153,Leo Carlsson,C,ANA,20,75,14,37,51
61,8475169,Evander Kane,L,EDM,33,78,26,24,50
61,8477935,Sam Bennett,C,FLA,28,76,24,26,50
61,8474641,Adam Henrique,C,EDM,34,77,18,32,50
61,8475218,Mattias Ekholm,D,EDM,34,79,17,33,50
61,8477416,Oliver Bjorkstrand,R,SEA,29,77,16,34,50
61,8470613,Brent Burns,D,CAR,39,80,13,37,50
61,8476875,Mike Matheson,D,MTL,30,75,12,38,50
61,8478366,Frank Vatrano,R,ANA,30,71,29,20,49
61,8475726,Tyler Toffoli,C,SJS,32,70,28,21,49
61,8478047,Michael Bunting,L,PIT,29,67,20,29,49
61,8477494,Jonathan Drouin,L,COL,29,80,10,39,49
61,8478397,Rasmus Andersson,D,CGY,28,76,12,36,48
61,8480064,Josh Norris,C,OTT,25,74,31,16,47
61,8479525,Ross Colton,C,COL,28,81,23,24,47
61,8483431,Logan Cooley,C,UTA,20,75,22,25,47
61,8475170,Brayden Schenn,C,STL,33,74,21,26,47
61,8476872,Scott Laughton,C,PHI,30,79,19,28,47
61,8475191,Reilly Smith,R,NYR,33,72,15,32,47
61,8477346,MacKenzie Weegar,D,CGY,30,78,12,35,47
61,8478038,Devon Toews,D,COL,30,77,11,36,47
61,8480014,Gabriel Vilardi,C,WPG,25,68,29,17,46
61,8475799,Nino Niederreiter,R,WPG,32,66,24,22,46
61,8476882,Teuvo Teravainen,C,CHI,30,68,23,23,46
61,8481618,Alex Newhook,C,MTL,23,72,18,28,46
61,8473994,Jamie Benn,L,DAL,35,82,15,31,46
61,8476462,Dougie Hamilton,D,NJD,31,69,15,31,46
61,8476479,Phillip Danault,C,LAK,31,78,14,32,46
61,8478498,Jake DeBrusk,L,VAN,28,71,24,21,45
61,8481604,Pavel Dorofeyev,L,VGK,24,70,24,21,45
61,8475793,Ryan Johansen,C,PHI,32,74,24,21,45
61,8478856,Conor Garland,R,VAN,28,72,23,22,45
61,8475151,Kyle Palmieri,C,NYI,33,79,23,22,45
61,8479987,Morgan Geekie,C,BOS,26,79,20,25,45
61,8478975,Mason Marchment,L,DAL,29,80,19,26,45
61,8481533,Trevor Zegras,C,ANA,23,72,18,27,45
61,8482113,Anton Lundell,C,FLA,23,79,18,27,45
61,8476432,Boone Jenner,C,CBJ,31,69,24,20,44
61,8476826,Yanni Gourde,C,SEA,33,77,22,22,44
61,8478466,Daniel Sprong,R,VAN,27,72,17,27,44
61,8482097,Jack Quinn,R,BUF,23,65,17,27,44
61,8475745,Charlie Coyle,C,BOS,32,77,14,30,44
61,8478469,Thomas Chabot,D,OTT,27,74,14,30,44
61,8482684,Luke Hughes,D,NJD,21,70,10,34,44
61,8482110,Dawson Mercer,C,NJD,23,73,22,21,43
61,8482667,William Eklund,L,SJS,22,68,20,23,43
61,8480039,Martin Necas,C,CAR,25,68,17,26,43
61,8480188,Fabian Zetterlund,L,SJS,25,64,17,26,43
61,8480185,Eetu Luostarinen,C,FLA,26,75,14,29,43
61,8474563,Drew Doughty,D,LAK,35,67,11,32,43
61,8477498,Darnell Nurse,D,EDM,29,75,11,32,43
61,8479992,Michael Rasmussen,C,DET,25,79,22,20,42
61,8477998,Warren Foegele,L,LAK,28,76,18,24,42
61,8484166,Adam Fantilli,C,CBJ,20,69,15,27,42
61,8478458,John (Jack) Roslovic,C,CAR,27,68,15,27,42
61,8473986,Alex Killorn,L,ANA,35,71,15,27,42
61,8480028,Morgan Frost,C,PHI,25,73,9,33,42
61,8483515,Juraj Slafkovsky,L,MTL,20,73,9,33,42
61,8478474,Lawson Crouse,L,UTA,27,73,25,16,41
61,8477476,Artturi Lehkonen,L,COL,29,81,21,20,41
61,8475314,Anders Lee,L,NYI,34,77,17,24,41
61,8477511,Anthony Mantha,R,CGY,30,76,17,24,41
61,8478891,Mason Appleton,C,WPG,28,70,17,24,41
61,8479339,Patrik Laine,L,CBJ,26,62,16,25,41
61,8476792,Torey Krug,D,STL,33,73,13,28,41
61,8477021,Alex Kerfoot,C,UTA,30,72,9,32,41
61,8475764,Cam Fowler,D,ANA,33,75,6,35,41
61,8480817,K'Andre Miller,D,NYR,24,73,4,37,41
61,8482055,Drew O'Connor,L,PIT,26,68,20,20,40
61,8480078,Filip Chytil,C,NYR,25,68,18,22,40
61,8475760,Nick Bjugstad,C,UTA,32,73,16,24,40
61,8476918,Jimmy Vesey,L,NYR,31,72,16,24,40
61,8477429,Andrew Copp,C,DET,30,79,14,26,40
61,8480798,Philipp Kurashev,C,CHI,25,61,14,26,40
61,8476905,Chandler Stephenson,C,SEA,30,70,13,27,40
61,8475753,Justin Faulk,D,STL,32,71,12,28,40
61,8478500,Ivan Provorov,D,CBJ,27,81,8,32,40
61,8476869,Brady Skjei,D,NSH,30,71,5,35,40
61,8477456,J.T. Compher,L,DET,29,79,18,21,39
61,8482702,Logan Stankoven,C,DAL,21,81,18,21,39
61,8476419,Jean-Gabriel Pageau,C,NYI,32,75,18,21,39
61,8479400,Pierre-Luc Dubois,L,WSH,26,68,15,24,39
61,8477986,Brandon Montour,D,SEA,30,76,13,26,39
61,8478055,Gustav Forsling,D,FLA,28,72,11,28,39
61,8474590,John Carlson,D,WSH,34,67,7,32,39
61,8475722,Jason Zucker,L,BUF,32,73,25,13,38
61,8477451,Ryan Hartman,R,MIN,30,67,22,16,38
61,8477479,Tyler Bertuzzi,L,CHI,29,64,18,20,38
61,8478438,Tommy Novak,C,NSH,27,65,15,23,38
61,8481528,Dylan Cozens,C,BUF,23,72,14,24,38
61,8474565,Alex Pietrangelo,D,VGK,34,58,11,27,38
61,8481577,Philip Tomasino,C,NSH,23,59,10,28,38
61,8482105,Jake Sanderson,D,OTT,22,70,9,29,38
61,8476958,Jaccob Slavin,D,CAR,30,77,7,31,38
61,8476854,Hampus Lindholm,D,BOS,30,75,4,34,38
61,8480434,Sean Durzi,D,UTA,26,66,4,34,38
61,8481560,Arthur Kaliyev,R,LAK,23,77,21,16,37
61,8480459,Pius Suter,C,VAN,28,62,17,20,37
61,8477497,Sean Monahan,C,CBJ,30,69,14,23,37
61,8481524,Bowen Byram,D,BUF,23,71,13,24,37
61,8481703,Valtteri Puustinen,R,PIT,25,63,13,24,37
61,8479345,Jakob Chychrun,D,WSH,26,66,11,26,37
61,8473563,Nicklas Backstrom,C,WSH,37,60,8,29,37
61,8484145,Zach Benson,L,BUF,19,69,7,30,37
61,8475714,Calle Jarnkrok,C,TOR,33,75,19,17,36
61,8482146,Luke Evangelista,R,NSH,22,68,17,19,36
61,8483808,Andrei Kuzmenko,L,CGY,28,74,15,21,36
61,8475287,Erik Haula,L,NJD,33,73,15,21,36
61,8478463,Anthony Beauvillier,L,PIT,27,68,15,21,36
61,8484203,Bradly Nadeau,L,CAR,19,71,15,21,36
61,8479351,Sam Steel,C,DAL,26,81,14,22,36
61,8482671,Owen Power,D,BUF,22,70,8,28,36
61,8476906,Shayne Gostisbehere,D,CAR,31,77,7,29,36
61,8476917,Adam Pelech,D,NYI,30,77,5,31,36
61,8477425,Miles Wood,L,COL,29,76,23,12,35
61,8480893,Kirill Marchenko,R,CBJ,24,63,21,14,35
61,8477426,Nicholas Paul,L,TBL,29,81,18,17,35
61,8481554,Kaapo Kakko,R,NYR,23,75,18,17,35
61,8474715,Cameron Atkinson,R,TBL,35,81,18,17,35
61,8471698,T.J. Oshie,R,WSH,38,70,17,18,35
61,8476392,Adam Lowry,C,WPG,31,70,16,19,35
61,8478970,Jalen Chatfield,D,CAR,28,75,13,22,35
61,8476927,Teddy Blueger,C,VAN,30,70,12,23,35
61,8481186,Logan O'Connor,R,COL,28,78,8,27,35
61,8476923,Damon Severson,D,CBJ,30,78,8,27,35
61,8482712,Oskar Olausson,R,COL,22,76,6,29,35
61,8476885,Jacob Trouba,D,NYR,30,71,6,29,35
61,8481582,Nicholas Robertson,L,TOR,23,71,20,14,34
61,8478057,Dakota Joshua,C,VAN,28,64,19,15,34
61,8483524,Shane Wright,C,SEA,20,64,18,16,34
61,8482089,Jake Neighbours,L,STL,22,66,18,16,34
61,8474586,Jordan Eberle,R,SEA,34,76,17,17,34
61,8483445,Cutter Gauthier,L,ANA,20,64,15,19,34
61,8474149,Evgenii Dadonov,R,DAL,35,80,14,20,34
61,8477987,Ryan Donato,C,CHI,28,60,14,20,34
61,8480448,Parker Kelly,L,COL,25,73,14,20,34
61,8478233,Andrew Mangiapane,L,WSH,28,69,13,21,34
61,8480871,Adam Boqvist,D,FLA,24,70,10,24,34
61,8482092,Ridly Greig,C,OTT,22,77,15,18,33
61,8483505,Matthew Poitras,C,BOS,20,77,15,18,33
61,8479661,Tanner Jeannot,L,LAK,27,77,14,19,33
61,8480049,Dylan Samberg,D,WPG,25,69,9,24,33
61,8483490,Pavel Mintyukov,D,ANA,21,74,6,27,33
61,8479410,Mikhail Sergachev,D,UTA,26,69,5,28,33
61,8481542,Moritz Seider,D,DET,23,79,1,32,33
61,8476438,Brandon Saad,L,STL,32,70,20,12,32
61,8482175,JJ Peterka,R,BUF,22,65,17,15,32
61,8480829,Jesperi Kotkaniemi,C,CAR,24,65,17,15,32
61,8480849,Barrett Hayton,C,UTA,24,75,17,15,32
61,8481596,Shane Pinto,C,OTT,24,75,16,16,32
61,8479393,Noah Gregor,L,OTT,26,68,15,17,32
61,8482705,Cole Sillinger,C,CBJ,21,69,15,17,32
61,8482720,Matthew Knies,L,TOR,22,74,10,22,32
61,8476461,Sean Couturier,C,PHI,32,61,9,23,32
61,8477839,Conor Sheary,L,TBL,32,82,9,23,32
61,8479365,Trent Frederic,C,BOS,26,77,8,24,32
61,8477495,Seth Jones,D,CHI,30,70,7,25,32
61,8482122,Brock Faber,D,MIN,22,80,5,27,32
61,8481093,Rafael Harvey-Pinard,L,MTL,25,62,14,17,31
61,8478020,Michael Amadio,R,OTT,28,70,13,18,31
61,8476292,Ondrej Palat,L,NJD,33,65,13,18,31
61,8477505,Alexander Wennberg,C,SJS,30,61,13,18,31
61,8473422,Nick Foligno,L,CHI,37,65,13,18,31
61,8482624,Daniil Miromanov,D,CGY,27,65,10,21,31
61,8476474,Stefan Noesen,R,NJD,31,66,9,22,31
61,8477488,Brett Pesce,D,NJD,30,72,5,26,31
61,8481535,Nils Hoglander,L,VAN,24,65,17,13,30
61,8483468,Jiri Kulich,C,BUF,20,60,15,15,30
61,8479591,Michael Eyssimont,C,TBL,28,80,14,16,30
61,8477989,Christian Dvorak,C,MTL,28,66,13,17,30
61,8479996,Cody Glass,C,NSH,25,63,9,21,30
61,8474716,Jared Spurgeon,D,MIN,35,79,6,24,30
61,8480145,Neal Pionk,D,WPG,29,70,4,26,30
61,8479398,Samuel Girard,D,COL,26,68,1,29,30
61,8475763,Kevin Hayes,R,PIT,32,69,16,13,29
61,8476921,Jordan Martinook,L,CAR,32,59,16,13,29
61,8479390,Taylor Raddysh,R,WSH,26,64,15,14,29
61,8475231,Casey Cizikas,C,NYI,33,74,13,16,29
61,8482475,Yegor Chinakhov,R,CBJ,23,60,11,18,29
61,8475848,Brendan Gallagher,R,MTL,32,72,10,19,29
61,8477953,Kasperi Kapanen,R,STL,28,68,10,19,29
61,8481656,Aliaksei Protas,C,WSH,23,57,9,20,29
61,8481581,Thomas Harley,D,DAL,23,73,7,22,29
61,8479941,Justin Danforth,R,CBJ,31,66,19,9,28
61,8476278,Colin Blackwell,C,DAL,31,79,17,11,28
61,8476981,Josh Anderson,R,MTL,30,75,16,12,28
61,8479414,Nathan Bastian,R,NJD,27,55,14,14,28
61,8478472,Mathieu Joseph,R,STL,27,74,11,17,28
61,8475149,Marcus Johansson,L,MIN,34,67,11,17,28
61,8478434,Keegan Kolesar,R,VGK,27,68,9,19,28
61,8476480,Vladislav Namestnikov,C,WPG,32,66,8,20,28
61,8482133,Thomas Bordeleau,C,SJS,22,67,8,20,28
61,8480802,Ryan McLeod,C,BUF,25,69,8,20,28
61,8482149,Cole Perfetti,C,WPG,22,60,7,21,28
61,8478911,Matt Roy,D,WSH,29,61,6,22,28
61,8475200,Dmitry Orlov,D,CAR,33,73,5,23,28
61,8482245,Artem Zub,D,OTT,29,76,3,25,28
61,8477903,Garnet Hathaway,R,PHI,33,71,14,13,27
61,8480009,Eeli Tolvanen,R,SEA,25,63,12,15,27
61,8476897,Oskar Sundqvist,C,STL,30,66,12,15,27
61,8474189,Lars Eller,C,PIT,35,64,12,15,27
61,8478109,Victor Olofsson,L,VGK,29,68,10,17,27
61,8477450,Jason Dickinson,C,CHI,29,62,8,19,27
61,8482067,Connor Mackey,D,NYR,28,52,6,21,27
61,8476902,Esa Lindell,D,DAL,30,74,5,22,27
61,8477444,Andre Burakovsky,L,SEA,29,67,4,23,27
61,8479980,Nicolas Hague,D,VGK,26,54,4,23,27
61,8474151,Ryan McDonagh,D,TBL,35,80,2,25,27
61,8470621,Corey Perry,R,EDM,39,71,15,11,26
61,8481580,Connor McMichael,C,WSH,23,60,14,12,26
61,8482111,Justin Barron,D,MTL,23,67,12,14,26
61,8477508,Curtis Lazar,C,NJD,29,63,11,15,26
61,8482125,Alexander Holtz,R,VGK,22,70,10,16,26
61,8478432,Christian Fischer,R,DET,27,71,10,16,26
61,8480336,Sean Walker,D,CAR,30,71,7,19,26
61,8480873,Rasmus Sandin,D,WSH,24,58,6,20,26
61,8479402,Jake Bean,D,CGY,26,62,6,20,26
61,8477969,Marcus Pettersson,D,PIT,28,78,3,23,26
61,8473507,Jeff Petry,D,DET,37,75,3,23,26
61,8482074,Connor Zary,C,CGY,23,64,17,8,25
61,8478046,Danton Heinen,L,VAN,29,70,11,14,25
61,8478115,Pierre Engvall,L,NYI,28,77,10,15,25
61,8482117,Lukas Reichel,L,CHI,22,57,10,15,25
61,8483482,Tristan Luneau,D,ANA,20,62,10,15,25
61,8476458,Ryan Strome,C,ANA,31,65,9,16,25
61,8480113,Alex Iafallo,L,WPG,31,71,9,16,25
61,8480855,Jack McBain,C,UTA,24,67,9,16,25
61,8476979,Erik Gustafsson,D,DET,32,72,7,18,25
61,8476879,Cody Ceci,D,EDM,31,67,5,20,25
61,8481441,Joe Snively,C,DET,28,69,4,21,25
61,8482660,Kent Johnson,C,CBJ,22,59,3,22,25
61,8480289,Morgan Barron,C,WPG,26,62,15,9,24
61,8480220,Noah Cates,L,PHI,25,74,13,11,24
61,8476374,Sean Kuraly,C,CBJ,31,61,13,11,24
61,8476925,Colton Sissons,C,NSH,31,71,12,12,24
61,8475855,Jesper Fast,R,CAR,33,56,12,12,24
61,8476463,Jonas Brodin,D,MIN,31,75,10,14,24
61,8482101,Danil Gushchin,L,SJS,22,55,6,18,24
61,8476856,Mathew Dumba,D,DAL,30,69,5,19,24
61,8477932,Aaron Ekblad,D,FLA,28,70,4,20,24
61,8483491,Ivan Miroshnichenko,L,WSH,20,52,4,20,24
61,8476525,Colin Miller,D,WPG,32,66,4,20,24
61,8477948,Travis Sanheim,D,PHI,28,66,3,21,24
61,8480806,Isac Lundestrom,C,ANA,25,51,16,7,23
61,8481624,Ilya Mikheyev,R,CHI,30,59,15,8,23
61,8476878,Zemgus Girgensons,C,TBL,30,81,14,9,23
61,8475220,Marcus Foligno,L,MIN,33,62,13,10,23
61,8475768,Jaden Schwartz,C,SEA,32,75,12,11,23
61,8477952,Robby Fabbri,C,ANA,28,62,10,13,23
61,8478508,Yakov Trenin,C,MIN,27,56,10,13,23
61,8483457,Lane Hutson,D,MTL,20,70,9,14,23
61,8477947,Sonny Milano,L,WSH,28,64,9,14,23
61,8481606,Jordan Spence,D,LAK,23,65,7,16,23
61,8476312,Josh Manson,D,COL,33,68,7,16,23
61,8482073,Braden Schneider,D,NYR,23,67,5,18,23
61,8482655,Janis Moser,D,TBL,24,75,3,20,23
61,8481059,Scott Perunovich,D,STL,26,58,2,21,23
61,8482155,Alex Laferriere,R,LAK,23,69,14,8,22
61,8478043,Sam Lafferty,C,BUF,29,63,12,10,22
61,8477478,William Carrier,L,CAR,30,57,11,11,22
61,8478569,Noel Acciari,C,PIT,33,60,11,11,22
61,8481521,Ronnie Attard,D,PHI,25,62,10,12,22
61,8482157,Will Cuylle,L,NYR,22,65,10,12,22
61,8482749,Joshua Roy,R,MTL,21,63,9,13,22
61,8475171,Oliver Ekman-Larsson,D,TOR,33,70,9,13,22
61,8478133,Jake Evans,C,MTL,28,72,9,13,22
61,8480995,Pontus Holmberg,R,TOR,25,62,8,14,22
61,8478413,Jordan Greenway,L,BUF,27,64,6,16,22
61,8475791,Taylor Hall,L,CHI,33,51,6,16,22
61,8479976,Juuso Valimaki,D,UTA,26,61,5,17,22
61,8476931,Jake McCabe,D,TOR,31,61,5,17,22
61,8474013,Ian Cole,D,UTA,35,53,3,19,22
61,8478507,John Marino,D,UTA,27,60,1,21,22
61,8476331,Dylan DeMelo,D,WPG,31,69,1,21,22
61,8476469,Joel Armia,R,MTL,31,67,16,5,21
61,8477446,Michael McCarron,R,NSH,29,58,13,8,21
61,8479316,Luke Kunin,C,SJS,27,60,11,10,21
61,8476467,Jamie Oleksiak,D,SEA,32,68,9,12,21
61,8480835,Jack Drury,C,CAR,24,57,8,13,21
61,8479353,Brett Howden,C,VGK,26,70,8,13,21
61,8479982,Conor Timmins,D,TOR,26,66,8,13,21
61,8479293,Brandon Tanev,L,SEA,33,62,7,14,21
61,8480144,David Kampf,C,TOR,29,69,6,15,21
61,8479639,Dylan Coghlan,D,WPG,26,62,5,16,21
61,8481523,Kirby Dach,C,MTL,23,63,5,16,21
61,8477435,Ryan Graves,D,PIT,29,75,5,16,21
61,8477220,Nate Schmidt,D,FLA,33,66,4,17,21
61,8480950,Ilya Lyubushkin,D,DAL,30,64,4,17,21
61,8475324,Nick Jensen,D,OTT,34,71,3,18,21
61,8482062,Cole Smith,L,NSH,29,62,12,8,20
61,8480011,Klim Kostin,C,SJS,25,47,10,10,20
61,8474053,Logan Couture,C,SJS,35,63,9,11,20
61,8480748,Kiefer Sherwood,L,VAN,29,66,9,11,20
61,8481704,Juuso Parssinen,C,NSH,23,54,8,12,20
61,8477499,Rasmus Ristolainen,D,PHI,30,57,8,12,20
61,8477931,Tomas Nosek,L,FLA,32,64,7,13,20
61,8475233,David Savard,D,MTL,34,64,4,16,20
61,8479998,Mikey Anderson,D,LAK,25,64,3,17,20
61,8476422,Mike Reilly,D,NYI,31,76,2,18,20
61,8478416,Erik Cernak,D,TBL,27,68,0,20,20
61,8481032,Paul Cotter,C,NJD,25,63,13,6,19
61,8479520,Brandon Duhaime,R,WSH,27,51,13,6,19
61,8473453,Trevor Lewis,C,LAK,37,71,12,7,19
61,8482259,Bobby McMann,C,TOR,28,66,11,8,19
61,8482148,Hendrix Lapierre,C,WSH,22,58,10,9,19
61,8484149,Gavin Brindley,C,CBJ,20,45,10,9,19
61,8483499,Liam Ohgren,L,MIN,20,53,9,10,19
61,8476624,Barclay Goodrow,C,SJS,31,50,9,10,19
61,8477015,Connor Brown,R,EDM,30,71,8,11,19
61,8475343,Nic Dowd,C,WSH,34,58,7,12,19
61,8482176,Wyatt Kaiser,D,CHI,22,55,7,12,19
61,8479315,Joey Anderson,R,CHI,26,53,7,12,19
61,8477507,Nikita Zadorov,D,BOS,29,71,6,13,19
61,8480074,Alexandre Texier,C,STL,25,63,6,13,19
61,8476892,Colton Parayko,D,STL,31,67,5,14,19
61,8480891,Michael Kesselring,D,UTA,24,61,5,14,19
61,8474673,TJ Brodie,D,CHI,34,71,3,16,19
61,8477506,Ryan Pulock,D,NYI,30,76,2,17,19
61,8478882,Vladislav Gavrikov,D,LAK,29,68,2,17,19
61,8479066,Ryan Lomberg,L,CGY,30,66,11,7,18
61,8479328,Julien Gauthier,R,NYI,27,60,10,8,18
61,8480003,Jesper Boqvist,C,FLA,26,69,9,9,18
61,8481641,Joel Kiviranta,L,COL,28,73,9,9,18
61,8480021,Jack Studnicka,C,LAK,25,68,8,10,18
61,8480762,Eric Robinson,L,CAR,29,61,8,10,18
61,8482679,Matt Coronato,R,CGY,22,68,8,10,18
61,8479671,Mathieu Olivier,R,CBJ,27,55,8,10,18
61,8480068,Ryan Poehling,C,PHI,25,63,7,11,18
61,8473533,Jordan Staal,C,CAR,36,58,7,11,18
61,8481546,Cam York,D,PHI,23,74,5,13,18
61,8477353,Tyler Motte,C,DET,29,71,4,14,18
61,8476873,Mark Jankowski,C,NSH,30,49,4,14,18
61,8483565,Nick Blankenburg,D,NSH,26,61,4,14,18
61,8482087,Kaiden Guhle,D,MTL,22,66,3,15,18
61,8482142,Jamie Drysdale,D,PHI,22,66,3,15,18
61,8476891,Matthew Grzelcyk,D,PIT,30,72,2,16,18
61,8479026,Philippe Myers,D,TOR,27,57,2,16,18
61,8480246,Nick Perbix,D,TBL,26,72,2,16,18
61,8478840,Will Borgen,D,SEA,28,58,1,17,18
61,8480789,Oliver Wahlstrom,R,NYI,24,68,12,5,17
61,8480813,Joe Veleno,C,DET,24,71,11,6,17
61,8477070,Liam O'Brien,C,UTA,30,55,10,7,17
61,8480025,MacKenzie Entwistle,R,FLA,25,63,9,8,17
61,8479370,Tyson Jost,C,CAR,26,53,8,9,17
61,8475193,Tomas Tatar,L,NJD,34,60,7,10,17
61,8477369,Carson Soucy,D,VAN,30,54,7,10,17
61,8478013,Jake Walman,D,SJS,28,71,5,12,17
61,8481527,Kaedan Korczak,D,VGK,23,54,4,13,17
61,8478399,Jonas Siegenthaler,D,NJD,27,61,4,13,17
61,8477979,Nicolas Aube-Kubel,R,BUF,28,56,4,13,17
61,8478136,Jake Middleton,D,MIN,28,73,2,15,17
61,8475462,Radko Gudas,D,ANA,34,66,2,15,17
61,8476988,Matt Benning,D,SJS,30,69,1,16,17
61,8479336,Carl Grundstrom,R,SJS,27,50,12,4,16
61,8482762,Simon Edvinsson,D,DET,21,53,9,7,16
61,8481028,Martin Pospisil,C,CGY,25,58,7,9,16
61,8481601,Simon Holmstrom,R,NYI,23,62,7,9,16
61,8478831,Kevin Stenlund,C,UTA,28,60,7,9,16
61,8476934,Brock McGinn,L,ANA,30,57,6,10,16
61,8481517,Brett Leason,R,ANA,25,58,5,11,16
61,8481537,Nikita Okhotiuk,D,CGY,24,58,5,11,16
61,8482809,Jackson Blake,R,CAR,21,50,4,12,16
61,8480157,Calle Rosen,D,COL,30,50,4,12,16
61,8481599,Victor Soderstrom,D,UTA,23,51,4,12,16
61,8475179,Dmitry Kulikov,D,FLA,34,56,3,13,16
61,8475790,Erik Gudbranson,D,CBJ,32,75,2,14,16
61,8478443,Brandon Carlo,D,BOS,28,65,2,14,16
61,8480035,Henri Jokiharju,D,BUF,25,60,2,14,16
61,8470600,Ryan Suter,D,STL,39,67,2,14,16
61,8477845,Trevor van Riemsdyk,D,WSH,33,61,1,15,16
61,8476429,Scott Mayfield,D,NYI,32,73,1,15,16
61,8476858,Phillip Di Giuseppe,L,VAN,31,42,13,2,15
61,8479368,Max Jones,L,BOS,26,63,7,8,15
61,8481553,Bobby Brink,R,PHI,23,50,7,8,15
61,8479972,Mason Shaw,C,WPG,26,36,6,9,15
61,8477392,Hudson Fasching,R,NYI,29,65,5,10,15
61,8477406,Mattias Janmark,C,EDM,32,66,5,10,15
61,8476329,Travis Boyd,C,MIN,31,56,4,11,15
61,8476457,Adam Larsson,D,SEA,32,67,3,12,15
61,8478178,Darren Raddysh,D,TBL,28,74,3,12,15
61,8481568,Alex Vlasic,D,CHI,23,54,3,12,15
61,8474567,Zach Bogosian,D,MIN,34,67,3,12,15
61,8481014,Alexander Romanov,D,NYI,24,77,2,13,15
61,8479983,Mario Ferraro,D,SJS,26,74,2,13,15
61,8479371,Dante Fabbro,D,NSH,26,64,1,14,15
61,8480878,Nils Lundkvist,D,DAL,24,73,0,15,15
61,8481013,Jonatan Berggren,R,DET,24,61,7,7,14
61,8478451,Ethan Bear,D,WSH,27,52,7,7,14
61,8475225,Craig Smith,C,CHI,35,51,6,8,14
61,8478421,A.J. Greer,L,FLA,28,51,6,8,14
61,8479968,Vinni Lettieri,C,BOS,29,44,6,8,14
61,8481708,Zac Jones,D,NYR,24,52,5,9,14
61,8481522,Peyton Krebs,C,BUF,23,58,4,10,14
61,8477919,Frederick Gaudreau,C,MIN,31,61,4,10,14
61,8480727,Zach Whitecloud,D,VGK,28,44,4,10,14
61,8482192,Isaak Phillips,D,CHI,23,49,4,10,14
61,8480043,Timothy Liljegren,D,TOR,25,62,3,11,14
61,8480222,Sebastian Aho,D,PIT,28,71,3,11,14
61,8475279,Ben Chiarot,D,DET,33,65,3,11,14
61,8476874,Olli Maatta,D,DET,30,65,0,14,14
61,8476889,Radek Faksa,C,STL,30,55,10,3,13
61,8482079,Marco Rossi,C,MIN,23,53,9,4,13
61,8475842,Sam Carrick,C,NYR,32,59,8,5,13
61,8482737,Zack Bolduc,C,STL,21,52,8,5,13
61,8477380,Jonny Brodzinski,C,NYR,31,58,6,7,13
61,8479291,Kevin Rooney,C,CGY,31,53,6,7,13
61,8481592,Jakob Pelletier,L,CGY,23,36,6,7,13
61,8483495,Simon Nemec,D,NJD,20,53,5,8,13
61,8478211,Dryden Hunt,L,CGY,29,56,5,8,13
61,8480887,Jordan Harris,D,MTL,24,62,4,9,13
61,8475690,Chris Tanev,D,TOR,35,53,4,9,13
61,8482141,Lukas Cormier,D,VGK,22,30,4,9,13
61,8477018,Ben Hutton,D,VGK,31,47,3,10,13
61,8478452,Caleb Jones,D,LAK,27,53,2,11,13
61,8478851,Alexandre Carrier,D,NSH,28,61,1,12,13
61,8481178,Egor Zamula,D,PHI,24,57,1,12,13
61,8479359,Beck Malenstyn,L,BUF,26,48,7,5,12
61,8479619,Michael Carcone,L,UTA,28,66,6,6,12
61,8477482,Zachary Sanford,L,CHI,30,33,6,6,12
61,8480848,Ty Dellandrea,C,SJS,24,43,4,8,12
61,8479439,Jacob MacDonald,D,COL,31,51,4,8,12
61,8483493,Frank Nazar,C,CHI,20,47,4,8,12
61,8479718,Alex Barré-Boulet,C,MTL,27,46,4,8,12
61,8479344,Jesse Puljujarvi,R,PIT,26,49,4,8,12
61,8474574,Tyler Myers,D,VAN,34,69,3,9,12
61,8482634,Alex Steeves,C,TOR,25,55,3,9,12
61,8481481,Blake Lizotte,C,PIT,27,61,2,10,12
61,8475455,Brenden Dillon,D,NJD,34,58,1,11,12
61,8476967,Brett Kulak,D,EDM,30,63,1,11,12
61,8484254,Akito Hirose,D,VAN,25,31,1,11,12
61,8479324,Ryan Lindgren,D,NYR,26,60,1,11,12
61,8475181,Nick Leddy,D,STL,33,69,0,12,12
61,8480058,Pierre-Olivier Joseph,D,STL,25,53,0,12,12
61,8480807,Mattias Samuelsson,D,BUF,24,54,0,12,12
61,8471709,Marc-Edouard Vlasic,D,SJS,37,59,0,12,12
61,8476994,Vinnie Hinostroza,C,NSH,30,48,7,4,11
61,8480355,Mark Kastelic,C,BOS,25,63,7,4,11
61,8482077,Dylan Holloway,L,EDM,23,47,7,4,11
61,8482807,Ethan Del Mastro,D,CHI,21,55,7,4,11
61,8480980,Connor Dewar,C,TOR,25,59,6,5,11
61,8480252,Cole Guttman,C,CHI,25,46,6,5,11
61,8476960,Andreas Athanasiou,C,CHI,30,50,5,6,11
61,8482730,Brandt Clarke,D,LAK,21,51,5,6,11
61,8480880,Jakub Lauko,C,MIN,24,36,5,6,11
61,8480205,Emil Bemstrom,C,PIT,25,50,4,7,11
61,8479442,Troy Stecher,D,EDM,30,56,4,7,11
61,8479543,Michael Pezzetta,L,MTL,26,54,3,8,11
61,8481019,David Gustafsson,C,WPG,24,49,3,8,11
61,8480245,Olle Lycksell,R,PHI,25,33,3,8,11
61,8479772,Zack MacEwen,R,OTT,28,56,3,8,11
61,8482747,Brennan Othmann,L,NYR,21,42,3,8,11
61,8481617,Vasily Podkolzin,R,VAN,23,46,2,9,11
61,8479348,Kale Clague,D,BUF,26,36,2,9,11
61,8474568,Luke Schenn,D,NSH,35,59,1,10,11
61,8480441,Trey Fix-Wolansky,R,CBJ,25,33,1,10,11
61,8481122,Simon Benoit,D,TOR,26,36,1,10,11
61,8477365,Connor Clifton,D,BUF,29,54,1,10,11
61,8479249,Andrew Poturalski,C,SJS,30,32,1,10,11
61,8480001,Urho Vaakanainen,D,ANA,25,55,0,11,11
61,8476822,Luke Glendening,C,TBL,35,75,8,2,10
61,8482659,Josh Doan,R,UTA,22,52,6,4,10
61,8474034,Patrick Maroon,L,CHI,36,54,6,4,10
61,8480192,Johnathan Kovacevic,D,NJD,27,46,5,5,10
61,8481477,Nico Sturm,C,SJS,29,52,5,5,10
61,8478585,Derek Ryan,C,EDM,38,61,5,5,10
61,8482070,Mitchell Chaffee,R,TBL,26,45,5,5,10
61,8479944,Zach Aston-Reese,C,VGK,30,49,4,6,10
61,8480845,Rasmus Kupari,C,WPG,24,31,4,6,10
61,8476442,Matt Nieto,L,PIT,32,45,4,6,10
61,8482803,Olen Zellweger,D,ANA,21,66,3,7,10
61,8481598,Philip Broberg,D,EDM,23,50,3,7,10
61,8475208,Brian Dumoulin,D,ANA,33,61,3,7,10
61,8479994,Jaret Anderson-Dolan,C,WPG,25,33,3,7,10
61,8474090,Brendan Smith,D,DAL,35,49,3,7,10
61,8482964,Arber Xhekaj,D,MTL,23,38,3,7,10
61,8479372,Joshua Mahura,D,SEA,26,55,2,8,10
61,8482859,Zack Ostapchuk,C,OTT,21,58,2,8,10
61,8482451,Mikael Pyyhtia,L,CBJ,23,37,2,8,10
61,8480834,Ty Emberson,D,SJS,24,32,2,8,10
61,8481600,Tobias Bjornfot,D,FLA,23,46,1,9,10
61,8478468,Jeremy Lauzon,D,NSH,27,51,1,9,10
61,8479369,Andrew Peeke,D,BOS,26,66,0,10,10
61,8482095,Tyler Kleven,D,OTT,22,47,0,10,10
61,8480281,Alexey Toropchenko,R,STL,25,54,5,4,9
61,8482744,James Malatesta,L,CBJ,21,40,4,5,9
61,8478874,Adam Gaudette,R,OTT,28,39,4,5,9
61,8481754,Nikita Nesterenko,C,ANA,23,38,4,5,9
61,8480860,Kevin Bahl,D,CGY,24,44,3,6,9
61,8481567,Henry Thrun,D,SJS,23,54,3,6,9
61,8482496,Nils Aman,C,VAN,24,41,3,6,9
61,8482511,Mason Lohrei,D,BOS,23,31,3,6,9
61,8479536,Axel Jonsson-Fjallby,L,WPG,26,39,3,6,9
61,8480796,Martin Fehervary,D,WSH,25,51,2,7,9
61,8475718,Justin Holl,D,DET,32,58,2,7,9
61,8482166,Shakir Mukhamadullin,D,SJS,22,50,1,8,9
61,8473446,Erik Johnson,D,PHI,36,45,1,8,9
61,8475958,Michael Sgarbossa,C,WSH,32,32,1,8,9
61,8477573,Nathan Walker,L,STL,30,51,6,2,8
61,8483466,Kevin Korchinski,D,CHI,20,40,6,2,8
61,8481716,Dmitri Voronkov,L,CBJ,24,49,5,3,8
61,8476867,Brendan Gaunce,C,MIN,30,36,5,3,8
61,8482666,Scott Morrow,D,CAR,22,39,3,5,8
61,8481751,Lukas Rousek,R,BUF,25,38,3,5,8
61,8481609,Vladislav Kolyachonok,D,UTA,23,36,3,5,8
61,8478424,Jansen Harkins,C,ANA,27,44,3,5,8
61,8477335,Kyle Burroughs,D,LAK,29,44,3,5,8
61,8474612,Travis Hamonic,D,OTT,34,41,2,6,8
61,8477938,Haydn Fleury,D,WPG,28,46,2,6,8
61,8476372,Nick Seeler,D,PHI,31,36,2,6,8
61,8478454,Noah Juulsen,D,VAN,27,40,2,6,8
61,8480073,Erik Brannstrom,D,COL,25,56,1,7,8
61,8482861,Vincent Iorio,D,WSH,22,40,1,7,8
61,8481161,Jake Christiansen,D,CBJ,25,58,6,1,7
61,8482652,Walker Duehr,R,CGY,27,34,5,2,7
61,8480990,Declan Chisholm,D,MIN,24,30,4,3,7
61,8481701,Santeri Hatakka,D,NJD,23,46,4,3,7
61,8481532,Alex Turcotte,C,LAK,23,40,3,4,7
61,8484911,Collin Graf,R,SJS,22,41,3,4,7
61,8480844,Grigori Denisenko,L,VGK,24,28,3,4,7
61,8477073,Kurtis MacDermid,L,NJD,30,33,3,4,7
61,8478859,Niko Mikkola,D,FLA,28,56,2,5,7
61,8478017,Mark Friedman,D,VAN,29,40,2,5,7
61,8476952,Dominic Toninato,C,WPG,30,24,2,5,7
61,8477462,Robert Hagg,D,VGK,29,25,2,5,7
61,8480172,Jan Rutta,D,SJS,34,58,1,6,7
61,8479378,Logan Stanley,D,WPG,26,35,1,6,7
61,8483619,Filip Roos,D,OTT,25,30,1,6,7
61,8480196,Jacob Bryson,D,BUF,27,38,1,6,7
61,8471677,Jack Johnson,D,CBJ,37,58,1,6,7
61,8481605,Jackson LaCombe,D,ANA,23,33,1,6,7
61,8475762,Derek Forbort,D,VAN,32,48,0,7,7
61,8479991,Jake Leschyshyn,C,NYR,25,20,5,1,6
61,8480032,Shane Bowers,C,NJD,25,20,5,1,6
61,8482751,Ryan Winterton,C,SEA,21,37,3,3,6
61,8481789,Tye Kartye,L,SEA,23,42,3,3,6
61,8483549,Lucas Condotta,L,MTL,27,25,3,3,6
61,8477962,Brendan Lemieux,L,CAR,28,45,3,3,6
61,8479379,Givani Smith,R,SJS,26,29,3,3,6
61,8483570,Ben Meyers,C,SEA,26,32,3,3,6
61,8483460,David Jiricek,D,CBJ,21,62,2,4,6
61,8477971,Andreas Englund,D,LAK,28,37,2,4,6
61,8480007,Jonas Rondbjerg,R,VGK,25,43,2,4,6
61,8482765,Isak Rosen,R,BUF,21,26,2,4,6
61,8482733,Logan Mailloux,D,MTL,31,30,2,4,6
61,8480874,Adam Ginning,D,PHI,24,14,2,4,6
61,8477034,Jaycob Megna,D,FLA,32,46,1,5,6
61,8480879,Jacob Bernard-Docker,D,OTT,24,44,1,5,6
61,8481518,Nolan Foote,L,NJD,24,44,1,5,6
61,8477244,Chad Ruhwedel,D,NYR,34,38,1,5,6
61,8477887,Patrick Brown,C,BOS,32,45,0,6,6
61,8475177,Calvin de Haan,D,COL,33,37,0,6,6
61,8479638,Justin Brazeau,R,BOS,26,33,5,0,5
61,8479320,Maxime Lajoie,D,SEA,27,26,4,1,5
61,8476913,Devin Shore,C,MIN,30,35,3,2,5
61,8482153,Brendan Brisson,C,VGK,23,27,3,2,5
61,8482784,Zach Dean,C,STL,21,40,3,2,5
61,8478450,Parker Wotherspoon,D,BOS,27,36,3,2,5
61,8477401,John Hayden,C,SEA,29,29,3,2,5
61,8479367,William Lockwood,R,FLA,26,23,3,2,5
61,8479985,Cale Fleury,D,SEA,26,26,3,2,5
61,8480890,Jan Jenik,C,OTT,24,25,3,2,5
61,8482858,Ryker Evans,D,SEA,23,22,3,2,5
61,8483630,Pavol Regenda,L,ANA,25,31,2,3,5
61,8471817,Ryan Reaves,R,TOR,37,49,2,3,5
61,8484287,Cole McWard,D,VAN,23,20,2,3,5
61,8481543,Nikita Alexandrov,C,STL,24,25,2,3,5
61,8480070,Ian Mitchell,D,BOS,25,41,1,4,5
61,8474166,Alec Martinez,D,CHI,37,47,1,4,5
61,8481167,Brayden Pachal,D,CGY,25,41,0,5,5
61,8476441,Joel Edmundson,D,LAK,31,41,0,5,5
61,8481679,Maxence Guenette,D,OTT,23,34,3,1,4
61,8482172,Landon Slaggert,L,CHI,22,23,2,2,4
61,8478021,William Lagesson,D,DET,28,25,2,2,4
61,8481541,Samuel Bolduc,D,NYI,24,25,2,2,4
61,8477320,Anton Blidh,L,NYR,29,13,2,2,4
61,8481550,Adam Beckman,L,NJD,23,27,1,3,4
61,8483763,Maksymilian Szuber,D,UTA,22,31,1,3,4
61,8481147,Reese Johnson,C,MIN,26,37,1,3,4
61,8475750,Jon Merrill,D,MIN,32,62,1,3,4
61,8478146,Matthew Highmore,C,OTT,28,37,1,3,4
61,8479986,Kole Lind,R,DAL,26,43,1,3,4
61,8476473,Connor Murphy,D,CHI,31,37,1,3,4
61,8480870,Bo Groulx,C,NYR,24,31,1,3,4
61,8478477,Mitchell Stephens,C,SEA,27,12,1,3,4
61,8475188,Brayden McNabb,D,VGK,33,51,0,4,4
61,8482713,Mackie Samoskevich,R,FLA,22,38,0,4,4
61,8481030,Jack St. Ivany,D,PIT,25,17,0,4,4
61,8477810,Joel Hanley,D,CGY,33,30,0,4,4
61,8481056,Spencer Stastney,D,NSH,24,29,3,0,3
61,8482145,Mavrik Bourque,C,DAL,22,51,3,0,3
61,8484325,Waltteri Merela,C,TBL,26,22,3,0,3
61,8480292,Carson Meyer,R,ANA,27,29,2,1,3
61,8479981,Jonah Gadjovich,L,FLA,26,38,2,1,3
61,8483512,Matthew Savoie,C,EDM,20,17,2,1,3
61,8479419,Brett Murray,L,BUF,26,14,2,1,3
61,8482201,Gage Goncalves,C,TBL,23,33,2,1,3
61,8478409,Anthony Richard,C,PHI,28,35,1,2,3
61,8478051,Max Willman,C,NJD,29,24,1,2,3
61,8483397,Marc McLaughlin,C,BOS,25,25,1,2,3
61,8479362,Riley Tufte,L,BOS,26,18,1,2,3
61,8477851,Jordan Oesterle,D,BOS,32,38,0,3,3
61,8482250,Callahan Burke,C,VGK,27,23,0,3,3
61,8474062,Riley Nash,C,NYR,35,14,0,3,3
61,8478011,Louie Belpedio,D,PHI,28,11,0,3,3
61,8481578,Graeme Clarke,R,MIN,23,8,2,0,2
61,8477527,Ross Johnston,L,ANA,30,33,2,0,2
61,8481719,Maxwell Crozier,D,TBL,24,18,2,0,2
61,8481462,Mason Morelli,L,VGK,28,10,2,0,2
61,8482088,Justin Sourdif,R,FLA,22,16,2,0,2
61,8480306,Grant Hutton,D,NYI,29,9,2,0,2
61,8475235,Nicolas Deslauriers,L,PHI,33,46,1,1,2
61,8479576,Vincent Desharnais,D,VAN,28,38,1,1,2
61,8482102,Vasily Ponomarev,C,PIT,22,24,1,1,2
61,8477467,Gustav Olofsson,D,SEA,30,17,1,1,2
61,8482118,Sam Colangelo,R,ANA,23,19,1,1,2
61,8477473,Justin Bailey,R,SJS,29,24,1,1,2
61,8481422,Jake Lucchini,C,NSH,29,16,1,1,2
61,8482929,Emil Lilleberg,D,TBL,23,19,1,1,2
61,8478502,Dennis Gilbert,D,BUF,28,23,1,1,2
61,8483597,Milos Kelemen,L,UTA,25,11,1,1,2
61,8480823,Alexander Alexeyev,D,WSH,25,11,1,1,2
61,8480468,James Hamblin,L,EDM,25,15,1,1,2
61,8483395,Arshdeep Bains,L,VAN,23,9,1,1,2
61,8481585,Egor Afanasyev,L,SJS,23,14,1,1,2
61,8483471,Brad Lambert,C,WPG,31,10,1,1,2
61,8481043,Cole Koepke,L,BOS,26,16,1,1,2
61,8475780,Chris Wagner,R,COL,33,7,1,1,2
61,8477384,Joshua Brown,D,EDM,30,29,0,2,2
61,8482144,Jack Thompson,D,SJS,22,25,0,2,2
61,8481006,Tyler Tucker,D,STL,24,7,0,2,2
61,8481699,Aku Raty,R,UTA,23,6,0,2,2
61,8482516,Matthew Kessel,D,STL,24,27,0,2,2
61,8475413,Justin Dowling,C,NJD,34,13,0,2,2
61,8480267,Sammy Walker,C,MIN,25,16,0,2,2
61,8479587,Rhett Gardner,C,PHI,28,24,0,2,2
61,8484258,Sam Malinski,D,COL,26,11,1,0,1
61,8482094,Daemon Hunt,D,MIN,22,15,1,0,1
61,8477541,Dakota Mermis,D,TOR,30,9,1,0,1
61,8482162,Roby Jarventie,L,EDM,22,15,1,0,1
61,8475795,Dylan McIlrath,D,WSH,32,23,1,0,1
61,8481206,John Ludvig,D,PIT,24,15,1,0,1
61,8483398,Declan Carlile,D,TBL,31,7,1,0,1
61,8482460,Matt Rempe,C,NYR,22,12,1,0,1
61,8482126,Emil Andrae,D,PHI,31,4,1,0,1
61,8483546,Marshall Rifai,D,TOR,26,3,1,0,1
61,8483012,Logan Morrison,C,SEA,22,31,0,1,1
61,8482177,Marat Khusnutdinov,C,MIN,22,36,0,1,1
61,8482147,Jean-Luc Foudy,C,COL,22,24,0,1,1
61,8482061,Brandon Biro,L,SEA,26,16,0,1,1
61,8475755,Alexander Petrovic,D,DAL,32,11,0,1,1
61,8483489,Fraser Minten,C,TOR,31,9,0,1,1
61,8481024,Linus Karlsson,C,VAN,25,5,0,1,1
61,8480075,Cameron Crotty,D,MIN,25,11,0,1,1
61,8482476,Emil Heineman,L,MTL,23,8,0,1,1
61,8483920,Pierrick Dube,R,WSH,23,4,0,1,1
61,8481564,Ryan Johnson,D,BUF,23,14,0,1,1
61,8484304,Uvis Balinskis,D,FLA,28,10,0,1,1
61,8477149,Scott Sabourin,R,SJS,32,21,0,1,1
61,8483432,Luca Del Bel Belluz,C,CBJ,31,6,0,1,1
61,8481556,John Beecher,C,BOS,23,37,0,0,0
61,8480084,Nick DeSimone,D,NJD,30,17,0,0,0
61,8481237,Kyle MacLean,C,NYI,25,26,0,0,0
61,8481065,Angus Crookshank,L,OTT,25,10,0,0,0
61,8482470,Ilya Solovyov,D,CGY,24,17,0,0,0
61,8482165,Yan Kuznetsov,D,CGY,22,21,0,0,0
61,8481743,Marc Del Gaizo,D,NSH,25,22,0,0,0
61,8481726,Adam Edstrom,C,NYR,24,4,0,0,0
61,8477993,Justin Kirkland,C,CGY,28,7,0,0,0
61,8481593,Jayden Struble,D,MTL,23,20,0,0,0
61,8479330,Brandon Gignac,C,MTL,27,11,0,0,0
61,8478881,Brett Seney,L,CHI,28,7,0,0,0
61,8481806,Louis Crevier,D,CHI,23,14,0,0,0
61,8484259,Ondrej Pavel,C,COL,31,3,0,0,0
61,8483567,Georgii Merkulov,C,BOS,24,10,0,0,0
61,8478446,Glenn Gawdin,C,LAK,27,12,0,0,0
61,8482787,Nikita Chibrikov,R,WPG,31,9,0,0,0
61,8478854,Ryan Shea,D,PIT,27,5,0,0,0
61,8481655,Cole Schwindt,R,CGY,23,1,0,0,0
61,8482197,Adam Raska,R,MIN,23,7,0,0,0
61,8483407,Brandon Scanlin,D,NYR,25,6,0,0,0
61,8479522,Hardy Haman Aktell,D,WSH,26,2,0,0,0
61,8483609,Adam Klapka,R,CGY,24,1,0,0,0
61,8476323,Max McCormick,L,SEA,32,3,0,0,0
61,8480851,Akil Thomas,C,LAK,24,12,0,0,0
61,8479421,Jacob Moverare,D,LAK,26,2,0,0,0
61,8481534,Raphael Lavoie,C,EDM,24,1,0,0,0
61,8484321,Nikolas Matinpalo,D,OTT,26,5,0,0,0
61,8484255,Jason Polin,R,COL,25,9,0,0,0
61,8478147,Bokondji Imama,L,PIT,28,11,0,0,0
61,8484326,Patrik Koch,D,UTA,28,4,0,0,0
61,8483531,Brian Halonen,L,NJD,25,2,0,0,0
61,8483401,Marc Johnstone,R,PIT,28,1,0,0,0
61,8480274,Philip Kemp,D,EDM,25,1,0,0,0
61,8470794,Joe Pavelski,C,,40,0,0,0,0
61,8479321,Lucas Johansen,D,,27,0,0,0,0
61,8477950,Tony DeAngelo,D,,29,0,0,0,0
61,8471218,Blake Wheeler,R,,38,0,0,0,0
61,8475197,Tyson Barrie,D,,33,0,0,0,0
61,8474157,Max Pacioretty,L,,36,0,0,0,0
61,8475744,Evgeny Kuznetsov,C,,32,0,0,0,0
61,8474037,James van Riemsdyk,L,,35,0,0,0,0
61,8476907,Mackenzie MacEachern,L,,30,0,0,0,0
61,8480216,Jacob Peterson,C,,25,0,0,0,0
61,8474602,Justin Schultz,D,,34,0,0,0,0
61,8482222,Alexander Barabanov,L,,30,0,0,0,0
61,8474031,Kevin Shattenkirk,D,,35,0,0,0,0
61,8477330,Dominik Kubalik,L,,29,0,0,0,0
61,8480884,Calen Addison,D,,24,0,0,0,0
61,8475906,John Klingberg,D,,32,0,0,0,0
61,8480008,Adam Ruzicka,C,,25,0,0,0,0
61,8476884,Derrick Pouliot,D,,30,0,0,0,0
61,8476919,Chris Tierney,C,,30,0,0,0,0
61,8479415,Michael McLeod,C,,26,0,0,0,0
61,8474870,Tyler Johnson,C,,34,0,0,0,0
61,8470604,Jeff Carter,C,,39,0,0,0,0
61,8478104,Sammy Blais,L,,28,0,0,0,0
61,8474884,Mike Hoffman,C,,35,0,0,0,0
61,8481591,Sam Poulin,R,,23,0,0,0,0
61,8471274,Alex Goligoski,D,,39,0,0,0,0
61,8476871,Tanner Pearson,L,,32,0,0,0,0
61,8476393,Nick Cousins,C,,31,0,0,0,0
61,8479977,Kailer Yamamoto,R,,26,0,0,0,0
61,8479346,Dillon Dube,C,,26,0,0,0,0
61,8480184,Gustav Lindstrom,D,,26,0,0,0,0
61,8479376,Victor Mete,D,,26,0,0,0,0
61,8473449,Kyle Okposo,R,,36,0,0,0,0
61,8481058,Jesse Ylonen,R,,25,0,0,0,0
61,8475752,Tyler Pitlick,C,,33,0,0,0,0
61,8481239,Samuel Fagemo,L,,24,0,0,0,0
61,8480821,Filip Zadina,R,,25,0,0,0,0
61,8470966,Mark Giordano,D,,41,0,0,0,0
61,8478495,Denis Gurianov,R,,27,0,0,0,0
61,8477464,Nic Petan,C,,29,0,0,0,0
61,8478099,Kevin Labanc,R,,29,0,0,0,0
61,8482241,Radim Zohorna,L,,28,0,0,0,0
61,8474040,Sam Gagner,C,,35,0,0,0,0
61,8479514,Rem Pitlick,C,,27,0,0,0,0
61,8478430,Oliver Kylington,D,,27,0,0,0,0
61,8479533,Joona Koppanen,L,,26,0,0,0,0
61,8479984,Cal Foote,D,,26,0,0,0,0
61,8477126,Jayson Megna,C,,34,0,0,0,0
61,8475164,Jakob Silfverberg,R,,34,0,0,0,0
61,8474009,Nick Bonino,C,,36,0,0,0,0
61,8479458,Nikita Zaitsev,D,,33,0,0,0,0
61,8477944,Jakub Vrana,L,,28,0,0,0,0
61,8471699,Andrew Cogliano,C,,37,0,0,0,0
61,8478067,Oskar Lindblom,L,,28,0,0,0,0
61,8471686,Marc Staal,D,,37,0,0,0,0
61,8470610,Zach Parise,L,,40,0,0,0,0
61,8478904,Steven Lorentz,C,,28,0,0,0,0
61,8473473,Milan Lucic,L,,36,0,0,0,0
61,8480031,Maxime Comtois,L,,25,0,0,0,0
61,8478512,Austin Czarnik,C,,32,0,0,0,0
61,8473504,Cal Clutterbuck,R,,37,0,0,0,0
61,8477454,Adam Erne,L,,29,0,0,0,0
61,8479383,Boris Katchouk,L,,26,0,0,0,0
61,8475825,Jani Hakanpää,D,,32,0,0,0,0
61,8477846,Ryan Carpenter,C,,33,0,0,0,0
61,8477930,Pierre-Edouard Bellemare,L,,39,0,0,0,0
61,8478400,Colin White,C,,27,0,0,0,0
61,8480226,Marián Studenic,R,,26,0,0,0,0
61,8480853,Liam Foudy,C,,24,0,0,0,0
61,8475797,Jarred Tinordi,D,,32,0,0,0,0
61,8479423,Alex Nylander,L,,26,0,0,0,0
61,8474618,Marco Scandella,D,,34,0,0,0,0
61,8478028,Fredrik Olofsson,L,,28,0,0,0,0
61,8474709,Matt Martin,L,,35,0,0,0,0
61,8481070,Hugh McGing,L,,26,0,0,0,0
61,8479546,Oskar Steen,C,,26,0,0,0,0
61,8474145,Robert Bortuzzo,D,,35,0,0,0,0
61,8476915,Jujhar Khaira,L,,30,0,0,0,0
61,8475278,Byron Froese,C,,33,0,0,0,0
61,8481812,Nikolai Knyzhov,D,,27,0,0,0,0
61,8478408,Travis Dermott,D,,28,0,0,0,0
61,8481077,John Leonard,L,,26,0,0,0,0
61,8479547,Matthew Phillips,R,,26,0,0,0,0
61,8480836,Jonathan Gruden,C,,24,0,0,0,0
61,8481690,Tyler Angle,C,,24,0,0,0,0
61,8475766,Austin Watson,L,,32,0,0,0,0
61,8481016,Ruslan Iskhakov,C,,24,0,0,0,0
61,8478078,Rourke Chartier,C,,28,0,0,0,0
61,8480776,Sheldon Rempal,R,,29,0,0,0,0
61,8478956,Samuel Laberge,L,NJD,27,1,0,0,0
61,8483045,Cameron Butler,R,CBJ,31,1,0,0,0
61,8484314,Jiri Smejkal,L,,28,0,0,0,0
62,8477492,Nathan MacKinnon,C,COL,29,81,60,97,157
62,8476453,Nikita Kucherov,R,TBL,31,82,47,109,156
62,8478402,Connor McDavid,C,EDM,27,76,42,87,129
62,8477956,David Pastrnak,R,BOS,28,81,44,84,128
62,8478420,Mikko Rantanen,R,COL,28,82,51,70,121
62,8479318,Auston Matthews,C,TOR,27,80,68,52,120
62,8481559,Jack Hughes,C,NJD,23,74,53,63,116
62,8478483,Mitch Marner,R,TOR,27,81,30,86,116
62,8477934,Leon Draisaitl,C,EDM,29,78,39,75,114
62,8476887,Filip Forsberg,L,NSH,30,74,59,51,110
62,8476468,J.T. Miller,C,VAN,31,76,36,74,110
62,8480027,Jason Robertson,L,DAL,25,81,37,68,105
62,8478550,Artemi Panarin,L,NYR,33,75,29,75,104
62,8478010,Brayden Point,C,TBL,28,82,54,48,102
62,8477404,Jake Guentzel,C,TBL,30,82,47,52,99
62,8480800,Quinn Hughes,D,VAN,25,73,14,85,99
62,8480002,Nico Hischier,C,NJD,25,74,33,65,98
62,8479407,Jesper Bratt,L,NJD,26,75,37,59,96
62,8478444,Brock Boeser,R,VAN,27,78,46,49,95
62,8477493,Aleksander Barkov,C,FLA,29,76,31,63,94
62,8480012,Elias Pettersson,C,VAN,26,75,34,59,93
62,8477939,William Nylander,R,TOR,28,79,44,48,92
62,8477409,Carter Verhaeghe,C,FLA,29,78,46,42,88
62,8476459,Mika Zibanejad,C,NYR,31,77,35,52,87
62,8479314,Matthew Tkachuk,L,FLA,27,72,28,58,86
62,8480023,Robert Thomas,C,STL,25,70,25,61,86
62,8478445,Mathew Barzal,C,NYI,27,81,24,62,86
62,8478403,Jack Eichel,C,VGK,28,75,40,44,84
62,8471675,Sidney Crosby,C,PIT,37,72,37,47,84
62,8476346,Johnny Gaudreau,L,CBJ,31,72,21,63,84
62,8476389,Vincent Trocheck,C,NYR,31,77,43,40,83
62,8480801,Brady Tkachuk,L,OTT,25,77,33,50,83
62,8471214,Alex Ovechkin,L,WSH,39,74,32,51,83
62,8476539,Jonathan Marchessault,R,NSH,34,69,31,52,83
62,8477402,Pavel Buchnevich,L,STL,29,73,29,54,83
62,8480069,Cale Makar,D,COL,26,67,18,65,83
62,8477501,Valeri Nichushkin,R,COL,29,82,47,35,82
62,8477933,Sam Reinhart,C,FLA,29,80,37,44,81
62,8480018,Nick Suzuki,C,MTL,25,76,26,55,81
62,8476881,Tomas Hertl,C,VGK,31,80,45,35,80
62,8474564,Steven Stamkos,C,NSH,34,72,36,44,80
62,8480208,Drake Batherson,R,OTT,26,80,34,46,80
62,8475167,Victor Hedman,D,TBL,34,79,16,64,80
62,8479343,Clayton Keller,R,UTA,26,79,36,43,79
62,8478864,Kirill Kaprizov,L,MIN,27,70,39,39,78
62,8478398,Kyle Connor,L,WPG,28,76,39,39,78
62,8476460,Mark Scheifele,C,WPG,31,72,33,45,78
62,8473419,Brad Marchand,L,BOS,36,81,30,48,78
62,8480839,Rasmus Dahlin,D,BUF,24,77,15,63,78
62,8477500,Bo Horvat,C,NYI,29,79,38,39,77
62,8475168,Matt Duchene,C,DAL,33,80,32,45,77
62,8471215,Evgeni Malkin,C,PIT,38,69,30,47,77
62,8477940,Nikolaj Ehlers,L,WPG,28,71,22,55,77
62,8474578,Erik Karlsson,D,PIT,34,79,22,55,77
62,8475172,Nazem Kadri,C,CGY,34,79,38,38,76
62,8482116,Tim Stützle,C,OTT,22,80,28,48,76
62,8480036,Miro Heiskanen,D,DAL,25,77,10,66,76
62,8477960,Adrian Kempe,R,LAK,28,79,35,40,75
62,8482078,Lucas Raymond,L,DET,22,80,34,41,75
62,8479323,Adam Fox,D,NYR,26,76,21,54,75
62,8478439,Travis Konecny,R,PHI,27,78,32,42,74
62,8476454,Ryan Nugent-Hopkins,C,EDM,31,75,28,46,74
62,8475754,Brock Nelson,C,NYI,33,78,36,37,73
62,8475184,Chris Kreider,L,NYR,33,76,38,34,72
62,8480830,Andrei Svechnikov,R,CAR,24,72,28,44,72
62,8475913,Mark Stone,R,VGK,32,78,25,47,72
62,8479542,Brandon Hagel,L,TBL,26,82,38,33,71
62,8478493,Joel Eriksson Ek,C,MIN,27,73,32,39,71
62,8477946,Dylan Larkin,C,DET,28,80,29,42,71
62,8479337,Alex DeBrincat,R,DET,27,82,28,43,71
62,8478873,Troy Terry,R,ANA,27,74,27,44,71
62,8478414,Timo Meier,R,NJD,28,74,29,41,70
62,8471685,Anze Kopitar,C,LAK,37,79,27,43,70
62,8478460,Zach Werenski,D,CBJ,27,76,20,50,70
62,8482684,Luke Hughes,D,NJD,21,70,10,60,70
62,8477955,Jared McCann,L,SEA,28,74,33,36,69
62,8477407,Anthony Duclair,L,NYI,29,80,32,37,69
62,8479420,Tage Thompson,C,BUF,27,75,38,29,67
62,8479675,Trevor Moore,L,LAK,29,79,28,39,67
62,8484144,Connor Bedard,C,CHI,19,70,25,42,67
62,8483515,Juraj Slafkovsky,L,MTL,20,76,24,43,67
62,8475765,Vladimir Tarasenko,R,DET,33,82,21,46,67
62,8478449,Roope Hintz,C,DAL,28,81,38,28,66
62,8477494,Jonathan Drouin,L,COL,29,82,22,44,66
62,8475692,Mats Zuccarello,R,MIN,37,75,21,45,66
62,8479999,Casey Mittelstadt,C,COL,26,79,18,48,66
62,8475166,John Tavares,C,TOR,34,80,26,39,65
62,8478401,Pavel Zacha,C,BOS,27,80,25,40,65
62,8473512,Claude Giroux,R,OTT,36,78,24,41,65
62,8477504,Josh Morrissey,D,WPG,29,77,14,51,65
62,8475745,Charlie Coyle,C,BOS,32,78,29,35,64
62,8478427,Sebastian Aho,C,CAR,27,69,20,44,64
62,8480865,Noah Dobson,D,NYI,24,79,9,55,64
62,8477942,Kevin Fiala,L,LAK,28,80,27,36,63
62,8478440,Dylan Strome,C,WSH,27,74,26,37,63
62,8474600,Roman Josi,D,NSH,34,71,20,43,63
62,8479385,Jordan Kyrou,C,STL,26,75,32,30,62
62,8475810,Bryan Rust,R,PIT,32,72,31,31,62
62,8478975,Mason Marchment,L,DAL,29,81,25,37,62
62,8481557,Matt Boldy,L,MIN,23,70,23,39,62
62,8477986,Brandon Montour,D,SEA,30,69,21,41,62
62,8477416,Oliver Bjorkstrand,R,SEA,29,71,19,43,62
62,8482699,Dylan Guenther,R,UTA,21,75,32,29,61
62,8477476,Artturi Lehkonen,L,COL,29,80,24,37,61
62,8482740,Wyatt Johnston,C,DAL,21,81,31,29,60
62,8476432,Boone Jenner,C,CBJ,31,68,30,30,60
62,8482159,Tyson Foerster,R,PHI,22,75,29,31,60
62,8481528,Dylan Cozens,C,BUF,23,70,22,38,60
62,8482093,Seth Jarvis,C,CAR,22,77,21,39,60
62,8480803,Evan Bouchard,D,EDM,25,70,16,44,60
62,8479425,Filip Hronek,D,VAN,27,77,13,47,60
62,8478038,Devon Toews,D,COL,30,74,12,48,60
62,8474590,John Carlson,D,WSH,34,71,12,48,60
62,8481540,Cole Caufield,R,MTL,23,72,32,27,59
62,8476399,Blake Coleman,C,CGY,33,80,28,31,59
62,8474141,Patrick Kane,R,DET,36,81,24,35,59
62,8475798,Mikael Granlund,C,SJS,32,74,17,42,59
62,8479325,Charlie McAvoy,D,BOS,27,76,16,43,59
62,8476456,Jonathan Huberdeau,C,CGY,31,77,15,44,59
62,8480014,Gabriel Vilardi,C,WPG,25,69,34,24,58
62,8481533,Trevor Zegras,C,ANA,23,74,24,34,58
62,8477949,Alex Tuch,R,BUF,28,70,16,42,58
62,8477496,Elias Lindholm,C,BOS,30,78,26,31,57
62,8476448,William Karlsson,C,VGK,31,76,24,33,57
62,8476479,Phillip Danault,C,LAK,31,80,24,33,57
62,8478047,Michael Bunting,L,PIT,29,75,21,36,57
62,8484153,Leo Carlsson,C,ANA,20,77,30,26,56
62,8475786,Zach Hyman,L,EDM,32,77,27,29,56
62,8475169,Evander Kane,L,EDM,33,77,27,29,56
62,8475784,Jeff Skinner,C,EDM,32,77,23,33,56
62,8476826,Yanni Gourde,C,SEA,33,74,17,39,56
62,8479400,Pierre-Luc Dubois,L,WSH,26,72,16,40,56
62,8471724,Kris Letang,D,PIT,37,80,12,44,56
62,8473986,Alex Killorn,L,ANA,35,73,21,34,55
62,8481596,Shane Pinto,C,OTT,24,79,19,36,55
62,8482124,Quinton Byfield,R,LAK,22,76,18,37,55
62,8477951,Nick Schmaltz,C,UTA,28,77,16,39,55
62,8476875,Mike Matheson,D,MTL,30,71,8,47,55
62,8475151,Kyle Palmieri,C,NYI,33,78,25,29,54
62,8477456,J.T. Compher,L,DET,29,77,24,30,54
62,8478233,Andrew Mangiapane,L,WSH,28,68,21,33,54
62,8478397,Rasmus Andersson,D,CGY,28,76,17,37,54
62,8480064,Josh Norris,C,OTT,25,76,28,25,53
62,8482109,Alexis Lafrenière,L,NYR,23,78,25,28,53
62,8474641,Adam Henrique,C,EDM,34,79,22,31,53
62,8475753,Justin Faulk,D,STL,32,75,14,39,53
62,8482110,Dawson Mercer,C,NJD,23,71,23,29,52
62,8481560,Arthur Kaliyev,R,LAK,23,78,23,29,52
62,8480798,Philipp Kurashev,C,CHI,25,64,22,30,52
62,8475191,Reilly Smith,R,NYR,33,75,20,32,52
62,8478466,Daniel Sprong,R,VAN,27,72,17,35,52
62,8478407,Vince Dunn,D,SEA,28,71,11,41,52
62,8479992,Michael Rasmussen,C,DET,25,80,25,26,51
62,8475158,Ryan O'Reilly,C,NSH,33,70,24,27,51
62,8478498,Jake DeBrusk,L,VAN,28,71,23,28,51
62,8478856,Conor Garland,R,VAN,28,72,20,31,51
62,8476905,Chandler Stephenson,C,SEA,30,73,20,31,51
62,8478469,Thomas Chabot,D,OTT,27,74,17,34,51
62,8477503,Max Domi,C,TOR,29,76,14,37,51
62,8474563,Drew Doughty,D,LAK,35,70,9,42,51
62,8479410,Mikhail Sergachev,D,UTA,26,71,8,43,51
62,8482175,JJ Peterka,R,BUF,22,78,34,16,50
62,8476458,Ryan Strome,C,ANA,31,68,21,29,50
62,8477932,Aaron Ekblad,D,FLA,28,72,21,29,50
62,8477935,Sam Bennett,C,FLA,28,77,19,31,50
62,8484166,Adam Fantilli,C,CBJ,20,70,17,33,50
62,8475170,Brayden Schenn,C,STL,33,74,16,34,50
62,8474150,Mikael Backlund,C,CGY,35,73,12,38,50
62,8476792,Torey Krug,D,STL,33,68,9,41,50
62,8481618,Alex Newhook,C,MTL,23,73,23,26,49
62,8475794,Tyler Seguin,C,DAL,32,80,20,29,49
62,8476483,Rickard Rakell,R,PIT,31,70,27,21,48
62,8482113,Anton Lundell,C,FLA,23,73,24,24,48
62,8482149,Cole Perfetti,C,WPG,22,67,20,28,48
62,8477021,Alex Kerfoot,C,UTA,30,70,16,32,48
62,8482712,Oskar Olausson,R,COL,22,77,8,40,48
62,8476880,Tom Wilson,R,WSH,30,66,22,25,47
62,8478115,Pierre Engvall,L,NYI,28,77,20,27,47
62,8478519,Anthony Cirelli,C,TBL,27,81,19,28,47
62,8478042,Viktor Arvidsson,L,EDM,31,74,19,28,47
62,8477451,Ryan Hartman,R,MIN,30,69,16,31,47
62,8478438,Tommy Novak,C,NSH,27,67,16,31,47
62,8478055,Gustav Forsling,D,FLA,28,73,9,38,47
62,8475314,Anders Lee,L,NYI,34,79,27,19,46
62,8478057,Dakota Joshua,C,VAN,28,69,26,20,46
62,8482745,Mason McTavish,C,ANA,21,70,20,26,46
62,8475799,Nino Niederreiter,R,WPG,32,73,20,26,46
62,8482665,Matty Beniers,C,SEA,22,74,14,32,46
62,8474586,Jordan Eberle,R,SEA,34,75,14,32,46
62,8476958,Jaccob Slavin,D,CAR,30,77,13,33,46
62,8481542,Moritz Seider,D,DET,23,78,7,39,46
62,8475726,Tyler Toffoli,C,SJS,32,61,25,20,45
62,8474102,David Perron,L,OTT,36,77,21,24,45
62,8479987,Morgan Geekie,C,BOS,26,76,21,24,45
62,8479339,Patrik Laine,L,CBJ,26,67,21,24,45
62,8481068,Yegor Sharangovich,C,CGY,26,80,20,25,45
62,8475793,Ryan Johansen,C,PHI,32,77,19,26,45
62,8474679,Gustav Nyquist,C,NSH,35,76,14,31,45
62,8482105,Jake Sanderson,D,OTT,22,75,9,36,45
62,8477498,Darnell Nurse,D,EDM,29,72,8,37,45
62,8477511,Anthony Mantha,R,CGY,30,76,21,23,44
62,8475287,Erik Haula,L,NJD,33,73,18,26,44
62,8473994,Jamie Benn,L,DAL,35,82,15,29,44
62,8481711,Matias Maccelli,L,UTA,24,70,12,32,44
62,8477447,Shea Theodore,D,VGK,29,60,6,38,44
62,8480459,Pius Suter,C,VAN,28,68,29,14,43
62,8478462,Nicolas Roy,C,VGK,27,77,20,23,43
62,8476462,Dougie Hamilton,D,NJD,31,72,18,25,43
62,8477964,Ivan Barbashev,C,VGK,29,74,15,28,43
62,8479345,Jakob Chychrun,D,WSH,26,68,15,28,43
62,8480015,Owen Tippett,R,PHI,25,76,22,20,42
62,8478542,Evan Rodrigues,C,FLA,31,73,21,21,42
62,8477953,Kasperi Kapanen,R,STL,28,72,18,24,42
62,8470613,Brent Burns,D,CAR,39,74,16,26,42
62,8478472,Mathieu Joseph,R,STL,27,70,14,28,42
62,8476853,Morgan Rielly,D,TOR,30,69,8,34,42
62,8477426,Nicholas Paul,L,TBL,29,81,23,18,41
62,8483808,Andrei Kuzmenko,L,CGY,28,75,18,23,41
62,8480039,Martin Necas,C,CAR,25,67,17,24,41
62,8480028,Morgan Frost,C,PHI,25,72,17,24,41
62,8481577,Philip Tomasino,C,NSH,23,71,16,25,41
62,8480797,Joel Farabee,L,PHI,24,67,15,26,41
62,8480003,Jesper Boqvist,C,FLA,26,73,15,26,41
62,8482667,William Eklund,L,SJS,22,63,14,27,41
62,8475218,Mattias Ekholm,D,EDM,34,77,13,28,41
62,8477346,MacKenzie Weegar,D,CGY,30,76,11,30,41
62,8477495,Seth Jones,D,CHI,30,69,11,30,41
62,8481581,Thomas Harley,D,DAL,23,76,10,31,41
62,8477969,Marcus Pettersson,D,PIT,28,78,10,31,41
62,8482089,Jake Neighbours,L,STL,22,69,23,17,40
62,8471698,T.J. Oshie,R,WSH,38,67,21,19,40
62,8480009,Eeli Tolvanen,R,SEA,25,69,20,20,40
62,8480188,Fabian Zetterlund,L,SJS,25,68,19,21,40
62,8477479,Tyler Bertuzzi,L,CHI,29,66,18,22,40
62,8477952,Robby Fabbri,C,ANA,28,65,16,24,40
62,8474149,Evgenii Dadonov,R,DAL,35,80,14,26,40
62,8482720,Matthew Knies,L,TOR,22,71,12,28,40
62,8478396,Noah Hanifin,D,VGK,27,61,10,30,40
62,8476923,Damon Severson,D,CBJ,30,80,10,30,40
62,8480145,Neal Pionk,D,WPG,29,66,10,30,40
62,8476906,Shayne Gostisbehere,D,CAR,31,73,5,35,40
62,8479525,Ross Colton,C,COL,28,78,21,18,39
62,8477444,Andre Burakovsky,L,SEA,29,73,12,27,39
62,8478474,Lawson Crouse,L,UTA,27,75,23,15,38
62,8478366,Frank Vatrano,R,ANA,30,74,18,20,38
62,8475848,Brendan Gallagher,R,MTL,32,72,17,21,38
62,8480185,Eetu Luostarinen,C,FLA,26,79,15,23,38
62,8482092,Ridly Greig,C,OTT,22,74,15,23,38
62,8482146,Luke Evangelista,R,NSH,22,69,14,24,38
62,8477998,Warren Foegele,L,LAK,28,81,21,16,37
62,8476981,Josh Anderson,R,MTL,30,67,18,19,37
62,8479393,Noah Gregor,L,OTT,26,74,17,20,37
62,8479365,Trent Frederic,C,BOS,26,78,17,20,37
62,8477947,Sonny Milano,L,WSH,28,62,16,21,37
62,8475760,Nick Bjugstad,C,UTA,32,73,15,22,37
62,8476292,Ondrej Palat,L,NJD,33,60,14,23,37
62,8478463,Anthony Beauvillier,L,PIT,27,61,13,24,37
62,8474715,Cameron Atkinson,R,TBL,35,82,13,24,37
62,8476278,Colin Blackwell,C,DAL,31,78,21,15,36
62,8481186,Logan O'Connor,R,COL,28,79,16,20,36
62,8482133,Thomas Bordeleau,C,SJS,22,64,14,22,36
62,8475763,Kevin Hayes,R,PIT,32,63,12,24,36
62,8480078,Filip Chytil,C,NYR,25,70,11,25,36
62,8482097,Jack Quinn,R,BUF,23,54,10,26,36
62,8480434,Sean Durzi,D,UTA,26,68,4,32,36
62,8475768,Jaden Schwartz,C,SEA,32,69,19,16,35
62,8481604,Pavel Dorofeyev,L,VGK,24,72,18,17,35
62,8476469,Joel Armia,R,MTL,31,66,17,18,35
62,8482702,Logan Stankoven,C,DAL,21,80,16,19,35
62,8475722,Jason Zucker,L,BUF,32,74,16,19,35
62,8478046,Danton Heinen,L,VAN,29,65,16,19,35
62,8477919,Frederick Gaudreau,C,MIN,31,65,15,20,35
62,8483505,Matthew Poitras,C,BOS,20,72,12,23,35
62,8481523,Kirby Dach,C,MTL,23,67,12,23,35
62,8476869,Brady Skjei,D,NSH,30,72,9,26,35
62,8476438,Brandon Saad,L,STL,32,75,17,17,34
62,8482055,Drew O'Connor,L,PIT,26,65,16,18,34
62,8481535,Nils Hoglander,L,VAN,24,66,16,18,34
62,8481524,Bowen Byram,D,BUF,23,70,12,22,34
62,8478133,Jake Evans,C,MTL,28,68,12,22,34
62,8474565,Alex Pietrangelo,D,VGK,34,62,5,29,34
62,8481624,Ilya Mikheyev,R,CHI,30,55,18,15,33
62,8477497,Sean Monahan,C,CBJ,30,72,16,17,33
62,8475193,Tomas Tatar,L,NJD,34,66,16,17,33
62,8478109,Victor Olofsson,L,VGK,29,73,9,24,33
62,8480220,Noah Cates,L,PHI,25,68,8,25,33
62,8478500,Ivan Provorov,D,CBJ,27,80,4,29,33
62,8480893,Kirill Marchenko,R,CBJ,24,63,20,12,32
62,8475714,Calle Jarnkrok,C,TOR,33,68,18,14,32
62,8483431,Logan Cooley,C,UTA,20,73,16,16,32
62,8480748,Kiefer Sherwood,L,VAN,29,55,16,16,32
62,8477987,Ryan Donato,C,CHI,28,61,15,17,32
62,8477505,Alexander Wennberg,C,SJS,30,69,14,18,32
62,8474053,Logan Couture,C,SJS,35,60,13,19,32
62,8478458,John (Jack) Roslovic,C,CAR,27,64,12,20,32
62,8482101,Danil Gushchin,L,SJS,22,60,11,21,32
62,8476419,Jean-Gabriel Pageau,C,NYI,32,74,10,22,32
62,8481656,Aliaksei Protas,C,WSH,23,66,10,22,32
62,8481703,Valtteri Puustinen,R,PIT,25,66,8,24,32
62,8476917,Adam Pelech,D,NYI,30,78,5,27,32
62,8477506,Ryan Pulock,D,NYI,30,76,4,28,32
62,8478882,Vladislav Gavrikov,D,LAK,29,72,3,29,32
62,8476474,Stefan Noesen,R,NJD,31,70,17,14,31
62,8478020,Michael Amadio,R,OTT,28,79,16,15,31
62,8481554,Kaapo Kakko,R,NYR,23,68,15,16,31
62,8479591,Michael Eyssimont,C,TBL,28,80,14,17,31
62,8484145,Zach Benson,L,BUF,19,68,13,18,31
62,8476461,Sean Couturier,C,PHI,32,68,13,18,31
62,8480829,Jesperi Kotkaniemi,C,CAR,24,65,12,19,31
62,8482475,Yegor Chinakhov,R,CBJ,23,59,12,19,31
62,8480068,Ryan Poehling,C,PHI,25,64,12,19,31
62,8476872,Scott Laughton,C,PHI,30,73,11,20,31
62,8474189,Lars Eller,C,PIT,35,67,10,21,31
62,8480871,Adam Boqvist,D,FLA,24,68,8,23,31
62,8480336,Sean Walker,D,CAR,30,76,7,24,31
62,8475764,Cam Fowler,D,ANA,33,67,6,25,31
62,8478432,Christian Fischer,R,DET,27,70,20,10,30
62,8481093,Rafael Harvey-Pinard,L,MTL,25,57,16,14,30
62,8484203,Bradly Nadeau,L,CAR,19,65,13,17,30
62,8482125,Alexander Holtz,R,VGK,22,65,13,17,30
62,8479351,Sam Steel,C,DAL,26,78,9,21,30
62,8482671,Owen Power,D,BUF,22,65,9,21,30
62,8477948,Travis Sanheim,D,PHI,28,67,9,21,30
62,8482749,Joshua Roy,R,MTL,21,63,9,21,30
62,8480246,Nick Perbix,D,TBL,26,72,6,24,30
62,8474151,Ryan McDonagh,D,TBL,35,76,5,25,30
62,8480817,K'Andre Miller,D,NYR,24,77,4,26,30
62,8479353,Brett Howden,C,VGK,26,68,18,11,29
62,8482705,Cole Sillinger,C,CBJ,21,66,17,12,29
62,8477425,Miles Wood,L,COL,29,76,14,15,29
62,8476921,Jordan Martinook,L,CAR,32,72,14,15,29
62,8482660,Kent Johnson,C,CBJ,22,60,14,15,29
62,8480113,Alex Iafallo,L,WPG,31,70,13,16,29
62,8478413,Jordan Greenway,L,BUF,27,60,13,16,29
62,8480144,David Kampf,C,TOR,29,74,13,16,29
62,8475791,Taylor Hall,L,CHI,33,52,11,18,29
62,8474716,Jared Spurgeon,D,MIN,35,78,8,21,29
62,8479639,Dylan Coghlan,D,WPG,26,63,5,24,29
62,8482655,Janis Moser,D,TBL,24,80,4,25,29
62,8476892,Colton Parayko,D,STL,31,69,3,26,29
62,8476392,Adam Lowry,C,WPG,31,66,17,11,28
62,8480789,Oliver Wahlstrom,R,NYI,24,71,14,14,28
62,8473563,Nicklas Backstrom,C,WSH,37,58,10,18,28
62,8480855,Jack McBain,C,UTA,24,66,9,19,28
62,8478911,Matt Roy,D,WSH,29,69,8,20,28
62,8476885,Jacob Trouba,D,NYR,30,65,7,21,28
62,8475171,Oliver Ekman-Larsson,D,TOR,33,63,7,21,28
62,8476312,Josh Manson,D,COL,33,63,6,22,28
62,8476331,Dylan DeMelo,D,WPG,31,68,2,26,28
62,8473507,Jeff Petry,D,DET,37,71,1,27,28
62,8476897,Oskar Sundqvist,C,STL,30,63,18,9,27
62,8480813,Joe Veleno,C,DET,24,78,13,14,27
62,8477839,Conor Sheary,L,TBL,32,80,12,15,27
62,8483457,Lane Hutson,D,MTL,20,70,11,16,27
62,8479293,Brandon Tanev,L,SEA,33,58,11,16,27
62,8476422,Mike Reilly,D,NYI,31,74,11,16,27
62,8477429,Andrew Copp,C,DET,30,77,10,17,27
62,8476927,Teddy Blueger,C,VAN,30,67,8,19,27
62,8475343,Nic Dowd,C,WSH,34,60,8,19,27
62,8476979,Erik Gustafsson,D,DET,32,77,7,20,27
62,8482142,Jamie Drysdale,D,PHI,22,70,6,21,27
62,8482245,Artem Zub,D,OTT,29,66,5,22,27
62,8481606,Jordan Spence,D,LAK,23,63,5,22,27
62,8483565,Nick Blankenburg,D,NSH,26,60,5,22,27
62,8473422,Nick Foligno,L,CHI,37,54,16,10,26
62,8480849,Barrett Hayton,C,UTA,24,74,12,14,26
62,8480835,Jack Drury,C,CAR,24,60,12,14,26
62,8480448,Parker Kelly,L,COL,25,74,11,15,26
62,8482062,Cole Smith,L,NSH,29,61,11,15,26
62,8476925,Colton Sissons,C,NSH,31,62,9,17,26
62,8483491,Ivan Miroshnichenko,L,WSH,20,56,8,18,26
62,8479996,Cody Glass,C,NSH,25,62,7,19,26
62,8481546,Cam York,D,PHI,23,68,6,20,26
62,8476854,Hampus Lindholm,D,BOS,30,72,5,21,26
62,8476902,Esa Lindell,D,DAL,30,76,5,21,26
62,8474673,TJ Brodie,D,CHI,34,64,4,22,26
62,8477406,Mattias Janmark,C,EDM,32,70,13,12,25
62,8481582,Nicholas Robertson,L,TOR,23,67,12,13,25
62,8478508,Yakov Trenin,C,MIN,27,59,12,13,25
62,8477478,William Carrier,L,CAR,30,54,12,13,25
62,8480074,Alexandre Texier,C,STL,25,55,12,13,25
62,8481481,Blake Lizotte,C,PIT,27,59,12,13,25
62,8476918,Jimmy Vesey,L,NYR,31,63,10,15,25
62,8475149,Marcus Johansson,L,MIN,34,63,10,15,25
62,8483445,Cutter Gauthier,L,ANA,20,61,6,19,25
62,8482087,Kaiden Guhle,D,MTL,22,66,5,20,25
62,8479402,Jake Bean,D,CGY,26,64,4,21,25
62,8478013,Jake Walman,D,SJS,28,76,4,21,25
62,8476931,Jake McCabe,D,TOR,31,67,2,23,25
62,8470621,Corey Perry,R,EDM,39,67,16,8,24
62,8480995,Pontus Holmberg,R,TOR,25,59,16,8,24
62,8482074,Connor Zary,C,CGY,23,60,15,9,24
62,8479520,Brandon Duhaime,R,WSH,27,51,15,9,24
62,8481032,Paul Cotter,C,NJD,25,60,14,10,24
62,8479414,Nathan Bastian,R,NJD,27,61,10,14,24
62,8482117,Lukas Reichel,L,CHI,22,62,10,14,24
62,8476960,Andreas Athanasiou,C,CHI,30,58,10,14,24
62,8483482,Tristan Luneau,D,ANA,20,67,9,15,24
62,8475225,Craig Smith,C,CHI,35,47,9,15,24
62,8476878,Zemgus Girgensons,C,TBL,30,81,8,16,24
62,8481013,Jonatan Berggren,R,DET,24,61,8,16,24
62,8475200,Dmitry Orlov,D,CAR,33,72,5,19,24
62,8483490,Pavel Mintyukov,D,ANA,21,70,4,20,24
62,8477507,Nikita Zadorov,D,BOS,29,71,3,21,24
62,8480222,Sebastian Aho,D,PIT,28,69,2,22,24
62,8478569,Noel Acciari,C,PIT,33,49,13,10,23
62,8482679,Matt Coronato,R,CGY,22,65,13,10,23
62,8482079,Marco Rossi,C,MIN,23,52,13,10,23
62,8482111,Justin Barron,D,MTL,23,65,12,11,23
62,8479368,Max Jones,L,BOS,26,73,12,11,23
62,8479941,Justin Danforth,R,CBJ,31,55,11,12,23
62,8476882,Teuvo Teravainen,C,CHI,30,68,9,14,23
62,8477015,Connor Brown,R,EDM,30,62,9,14,23
62,8477353,Tyler Motte,C,DET,29,73,9,14,23
62,8477989,Christian Dvorak,C,MTL,28,62,8,15,23
62,8477508,Curtis Lazar,C,NJD,29,63,8,15,23
62,8482624,Daniil Miromanov,D,CGY,27,63,7,16,23
62,8479315,Joey Anderson,R,CHI,26,54,7,16,23
62,8476873,Mark Jankowski,C,NSH,30,51,6,17,23
62,8481441,Joe Snively,C,DET,28,63,5,18,23
62,8476891,Matthew Grzelcyk,D,PIT,30,70,5,18,23
62,8482122,Brock Faber,D,MIN,22,78,3,20,23
62,8480873,Rasmus Sandin,D,WSH,24,63,3,20,23
62,8477435,Ryan Graves,D,PIT,29,78,3,20,23
62,8475233,David Savard,D,MTL,34,64,2,21,23
62,8479661,Tanner Jeannot,L,LAK,27,73,13,9,22
62,8481601,Simon Holmstrom,R,NYI,23,69,13,9,22
62,8476374,Sean Kuraly,C,CBJ,31,60,12,10,22
62,8479390,Taylor Raddysh,R,WSH,26,68,11,11,22
62,8476480,Vladislav Namestnikov,C,WPG,32,55,11,11,22
62,8478891,Mason Appleton,C,WPG,28,69,10,12,22
62,8477220,Nate Schmidt,D,FLA,33,71,8,14,22
62,8475231,Casey Cizikas,C,NYI,33,73,7,15,22
62,8476525,Colin Miller,D,WPG,32,60,6,16,22
62,8478507,John Marino,D,UTA,27,68,1,21,22
62,8479316,Luke Kunin,C,SJS,27,56,13,8,21
62,8477979,Nicolas Aube-Kubel,R,BUF,28,55,8,13,21
62,8481553,Bobby Brink,R,PHI,23,68,7,14,21
62,8476457,Adam Larsson,D,SEA,32,67,6,15,21
62,8479982,Conor Timmins,D,TOR,26,66,5,16,21
62,8480035,Henri Jokiharju,D,BUF,25,66,5,16,21
62,8477488,Brett Pesce,D,NJD,30,69,4,17,21
62,8482803,Olen Zellweger,D,ANA,21,62,4,17,21
62,8479398,Samuel Girard,D,COL,26,59,3,18,21
62,8479371,Dante Fabbro,D,NSH,26,63,3,18,21
62,8480049,Dylan Samberg,D,WPG,25,66,2,19,21
62,8481059,Scott Perunovich,D,STL,26,67,2,19,21
62,8480281,Alexey Toropchenko,R,STL,25,60,13,7,20
62,8478585,Derek Ryan,C,EDM,38,65,12,8,20
62,8475855,Jesper Fast,R,CAR,33,58,11,9,20
62,8480802,Ryan McLeod,C,BUF,25,68,8,12,20
62,8482737,Zack Bolduc,C,STL,21,57,8,12,20
62,8483499,Liam Ohgren,L,MIN,20,54,7,13,20
62,8480878,Nils Lundkvist,D,DAL,24,72,7,13,20
62,8478178,Darren Raddysh,D,TBL,28,71,6,14,20
62,8481477,Nico Sturm,C,SJS,29,58,6,14,20
62,8476329,Travis Boyd,C,MIN,31,60,5,15,20
62,8478468,Jeremy Lauzon,D,NSH,27,60,4,16,20
62,8475324,Nick Jensen,D,OTT,34,70,2,18,20
62,8482067,Connor Mackey,D,NYR,28,61,1,19,20
62,8481641,Joel Kiviranta,L,COL,28,68,13,6,19
62,8482157,Will Cuylle,L,NYR,22,63,10,9,19
62,8478434,Keegan Kolesar,R,VGK,27,65,9,10,19
62,8473453,Trevor Lewis,C,LAK,37,68,9,10,19
62,8480806,Isac Lundestrom,C,ANA,25,60,8,11,19
62,8483468,Jiri Kulich,C,BUF,20,61,7,12,19
62,8483493,Frank Nazar,C,CHI,20,61,7,12,19
62,8476463,Jonas Brodin,D,MIN,31,78,6,13,19
62,8475220,Marcus Foligno,L,MIN,33,57,6,13,19
62,8476856,Mathew Dumba,D,DAL,30,71,5,14,19
62,8478452,Caleb Jones,D,LAK,27,56,4,15,19
62,8475181,Nick Leddy,D,STL,33,68,4,15,19
62,8481014,Alexander Romanov,D,NYI,24,76,3,16,19
62,8480043,Timothy Liljegren,D,TOR,25,64,2,17,19
62,8479369,Andrew Peeke,D,BOS,26,57,1,18,19
62,8477903,Garnet Hathaway,R,PHI,33,69,12,6,18
62,8482259,Bobby McMann,C,TOR,28,60,10,8,18
62,8476934,Brock McGinn,L,ANA,30,51,9,9,18
62,8482809,Jackson Blake,R,CAR,21,52,9,9,18
62,8479543,Michael Pezzetta,L,MTL,26,60,8,10,18
62,8476889,Radek Faksa,C,STL,30,54,7,11,18
62,8478970,Jalen Chatfield,D,CAR,28,71,6,12,18
62,8477450,Jason Dickinson,C,CHI,29,54,6,12,18
62,8475790,Erik Gudbranson,D,CBJ,32,78,5,13,18
62,8480073,Erik Brannstrom,D,COL,25,60,5,13,18
62,8478851,Alexandre Carrier,D,NSH,28,67,3,15,18
62,8475188,Brayden McNabb,D,VGK,33,58,2,16,18
62,8482073,Braden Schneider,D,NYR,23,58,1,17,18
62,8481568,Alex Vlasic,D,CHI,23,53,0,18,18
62,8483524,Shane Wright,C,SEA,20,52,10,7,17
62,8480205,Emil Bemstrom,C,PIT,25,53,9,8,17
62,8481019,David Gustafsson,C,WPG,24,49,9,8,17
62,8484149,Gavin Brindley,C,CBJ,20,50,8,9,17
62,8479066,Ryan Lomberg,L,CGY,30,65,8,9,17
62,8477573,Nathan Walker,L,STL,30,52,8,9,17
62,8481028,Martin Pospisil,C,CGY,25,52,7,10,17
62,8481522,Peyton Krebs,C,BUF,23,56,7,10,17
62,8477392,Hudson Fasching,R,NYI,29,61,6,11,17
62,8479026,Philippe Myers,D,TOR,27,48,5,12,17
62,8478840,Will Borgen,D,SEA,28,64,5,12,17
62,8480025,MacKenzie Entwistle,R,FLA,25,59,5,12,17
62,8479370,Tyson Jost,C,CAR,26,53,5,12,17
62,8477845,Trevor van Riemsdyk,D,WSH,33,64,5,12,17
62,8475179,Dmitry Kulikov,D,FLA,34,59,4,13,17
62,8476429,Scott Mayfield,D,NYI,32,74,4,13,17
62,8480950,Ilya Lyubushkin,D,DAL,30,60,3,14,17
62,8479998,Mikey Anderson,D,LAK,25,63,2,15,17
62,8475462,Radko Gudas,D,ANA,34,67,2,15,17
62,8478859,Niko Mikkola,D,FLA,28,50,2,15,17
62,8479359,Beck Malenstyn,L,BUF,26,45,11,5,16
62,8479619,Michael Carcone,L,UTA,28,59,10,6,16
62,8477446,Michael McCarron,R,NSH,29,43,9,7,16
62,8481580,Connor McMichael,C,WSH,23,55,7,9,16
62,8480021,Jack Studnicka,C,LAK,25,61,7,9,16
62,8480762,Eric Robinson,L,CAR,29,58,7,9,16
62,8477369,Carson Soucy,D,VAN,30,67,7,9,16
62,8483495,Simon Nemec,D,NJD,20,54,7,9,16
62,8482964,Arber Xhekaj,D,MTL,23,49,6,10,16
62,8481147,Reese Johnson,C,MIN,26,46,6,10,16
62,8476467,Jamie Oleksiak,D,SEA,32,67,5,11,16
62,8479718,Alex Barré-Boulet,C,MTL,27,48,4,12,16
62,8481598,Philip Broberg,D,EDM,23,49,4,12,16
62,8477499,Rasmus Ristolainen,D,PHI,30,56,3,13,16
62,8479378,Logan Stanley,D,WPG,26,48,3,13,16
62,8481167,Brayden Pachal,D,CGY,25,50,3,13,16
62,8479976,Juuso Valimaki,D,UTA,26,60,2,14,16
62,8474574,Tyler Myers,D,VAN,34,70,2,14,16
62,8473533,Jordan Staal,C,CAR,36,62,8,7,15
62,8478421,A.J. Greer,L,FLA,28,60,8,7,15
62,8475842,Sam Carrick,C,NYR,32,57,8,7,15
62,8482148,Hendrix Lapierre,C,WSH,22,56,7,8,15
62,8480355,Mark Kastelic,C,BOS,25,60,7,8,15
62,8476822,Luke Glendening,C,TBL,35,80,7,8,15
62,8478211,Dryden Hunt,L,CGY,29,63,6,9,15
62,8474034,Patrick Maroon,L,CHI,36,50,6,9,15
62,8478043,Sam Lafferty,C,BUF,29,60,4,11,15
62,8476624,Barclay Goodrow,C,SJS,31,55,3,12,15
62,8479972,Mason Shaw,C,WPG,26,43,3,12,15
62,8482744,James Malatesta,L,CBJ,21,43,3,12,15
62,8479324,Ryan Lindgren,D,NYR,26,71,2,13,15
62,8475750,Jon Merrill,D,MIN,32,58,2,13,15
62,8476879,Cody Ceci,D,EDM,31,68,0,15,15
62,8481178,Egor Zamula,D,PHI,24,57,0,15,15
62,8477034,Jaycob Megna,D,FLA,32,53,0,15,15
62,8481704,Juuso Parssinen,C,NSH,23,63,8,6,14
62,8479336,Carl Grundstrom,R,SJS,27,47,7,7,14
62,8479344,Jesse Puljujarvi,R,PIT,26,60,6,8,14
62,8482784,Zach Dean,C,STL,21,44,6,8,14
62,8481537,Nikita Okhotiuk,D,CGY,24,50,5,9,14
62,8479983,Mario Ferraro,D,SJS,26,68,5,9,14
62,8481592,Jakob Pelletier,L,CGY,23,41,5,9,14
62,8476967,Brett Kulak,D,EDM,30,60,5,9,14
62,8471709,Marc-Edouard Vlasic,D,SJS,37,60,4,10,14
62,8475208,Brian Dumoulin,D,ANA,33,62,4,10,14
62,8477931,Tomas Nosek,L,FLA,32,64,3,11,14
62,8475279,Ben Chiarot,D,DET,33,60,3,11,14
62,8477365,Connor Clifton,D,BUF,29,56,2,12,14
62,8478399,Jonas Siegenthaler,D,NJD,27,61,1,13,14
62,8475455,Brenden Dillon,D,NJD,34,62,1,13,14
62,8480196,Jacob Bryson,D,BUF,27,30,1,13,14
62,8482176,Wyatt Kaiser,D,CHI,22,54,0,14,14
62,8482807,Ethan Del Mastro,D,CHI,21,50,9,4,13
62,8476858,Phillip Di Giuseppe,L,VAN,31,43,7,6,13
62,8481617,Vasily Podkolzin,R,VAN,23,43,6,7,13
62,8479372,Joshua Mahura,D,SEA,26,53,5,8,13
62,8480796,Martin Fehervary,D,WSH,25,53,5,8,13
62,8481751,Lukas Rousek,R,BUF,25,43,5,8,13
62,8479944,Zach Aston-Reese,C,VGK,30,48,4,9,13
62,8479980,Nicolas Hague,D,VGK,26,57,3,10,13
62,8478136,Jake Middleton,D,MIN,28,71,3,10,13
62,8482634,Alex Steeves,C,TOR,25,50,2,11,13
62,8481701,Santeri Hatakka,D,NJD,23,35,1,12,13
62,8480070,Ian Mitchell,D,BOS,25,51,1,12,13
62,8478416,Erik Cernak,D,TBL,27,76,0,13,13
62,8478831,Kevin Stenlund,C,UTA,28,60,8,4,12
62,8482153,Brendan Brisson,C,VGK,23,41,7,5,12
62,8480845,Rasmus Kupari,C,WPG,24,45,5,7,12
62,8482451,Mikael Pyyhtia,L,CBJ,23,43,4,8,12
62,8481532,Alex Turcotte,C,LAK,23,45,4,8,12
62,8479442,Troy Stecher,D,EDM,30,49,3,9,12
62,8479986,Kole Lind,R,DAL,26,53,3,9,12
62,8478451,Ethan Bear,D,WSH,27,44,2,10,12
62,8475690,Chris Tanev,D,TOR,35,54,2,10,12
62,8479348,Kale Clague,D,BUF,26,40,2,10,12
62,8481567,Henry Thrun,D,SJS,23,48,2,10,12
62,8475718,Justin Holl,D,DET,32,63,2,10,12
62,8481708,Zac Jones,D,NYR,24,50,1,11,12
62,8480860,Kevin Bahl,D,CGY,24,54,1,11,12
62,8479576,Vincent Desharnais,D,VAN,28,31,0,12,12
62,8481518,Nolan Foote,L,NJD,24,42,8,3,11
62,8477380,Jonny Brodzinski,C,NYR,31,63,7,4,11
62,8482077,Dylan Holloway,L,EDM,23,50,7,4,11
62,8480980,Connor Dewar,C,TOR,25,66,7,4,11
62,8482730,Brandt Clarke,D,LAK,21,56,7,4,11
62,8481716,Dmitri Voronkov,L,CBJ,24,43,7,4,11
62,8483012,Logan Morrison,C,SEA,22,37,6,5,11
62,8479439,Jacob MacDonald,D,COL,31,57,5,6,11
62,8482652,Walker Duehr,R,CGY,27,35,5,6,11
62,8477401,John Hayden,C,SEA,29,38,5,6,11
62,8481521,Ronnie Attard,D,PHI,25,52,4,7,11
62,8480844,Grigori Denisenko,L,VGK,24,28,3,8,11
62,8474567,Zach Bogosian,D,MIN,34,60,2,9,11
62,8479291,Kevin Rooney,C,CGY,31,50,2,9,11
62,8470600,Ryan Suter,D,STL,39,62,1,10,11
62,8480887,Jordan Harris,D,MTL,24,52,1,10,11
62,8476473,Connor Murphy,D,CHI,31,42,1,10,11
62,8480807,Mattias Samuelsson,D,BUF,24,57,0,11,11
62,8480172,Jan Rutta,D,SJS,34,65,0,11,11
62,8482166,Shakir Mukhamadullin,D,SJS,22,57,8,2,10
62,8482762,Simon Edvinsson,D,DET,21,54,7,3,10
62,8480157,Calle Rosen,D,COL,30,38,5,5,10
62,8479772,Zack MacEwen,R,OTT,28,45,5,5,10
62,8476442,Matt Nieto,L,PIT,32,52,5,5,10
62,8477938,Haydn Fleury,D,WPG,28,44,5,5,10
62,8481789,Tye Kartye,L,SEA,23,48,5,5,10
62,8482192,Isaak Phillips,D,CHI,23,58,4,6,10
62,8478424,Jansen Harkins,C,ANA,27,41,4,6,10
62,8479379,Givani Smith,R,SJS,26,35,4,6,10
62,8480011,Klim Kostin,C,SJS,25,50,3,7,10
62,8481517,Brett Leason,R,ANA,25,57,3,7,10
62,8478443,Brandon Carlo,D,BOS,28,62,3,7,10
62,8481161,Jake Christiansen,D,CBJ,25,57,3,7,10
62,8482733,Logan Mailloux,D,MTL,31,41,3,7,10
62,8480727,Zach Whitecloud,D,VGK,28,51,2,8,10
62,8476994,Vinnie Hinostroza,C,NSH,30,45,2,8,10
62,8480441,Trey Fix-Wolansky,R,CBJ,25,42,1,9,10
62,8479249,Andrew Poturalski,C,SJS,30,31,1,9,10
62,8481527,Kaedan Korczak,D,VGK,23,43,0,10,10
62,8482155,Alex Laferriere,R,LAK,23,70,6,3,9
62,8482659,Josh Doan,R,UTA,22,49,6,3,9
62,8483570,Ben Meyers,C,SEA,26,34,5,4,9
62,8481679,Maxence Guenette,D,OTT,23,40,5,4,9
62,8482070,Mitchell Chaffee,R,TBL,26,48,4,5,9
62,8475235,Nicolas Deslauriers,L,PHI,33,53,4,5,9
62,8479671,Mathieu Olivier,R,CBJ,27,47,3,6,9
62,8475177,Calvin de Haan,D,COL,33,50,3,6,9
62,8474166,Alec Martinez,D,CHI,37,48,3,6,9
62,8474013,Ian Cole,D,UTA,35,52,2,7,9
62,8480891,Michael Kesselring,D,UTA,24,60,2,7,9
62,8476874,Olli Maatta,D,DET,30,61,2,7,9
62,8480001,Urho Vaakanainen,D,ANA,25,55,2,7,9
62,8481605,Jackson LaCombe,D,ANA,23,42,2,7,9
62,8474568,Luke Schenn,D,NSH,35,44,1,8,9
62,8478454,Noah Juulsen,D,VAN,27,38,1,8,9
62,8471817,Ryan Reaves,R,TOR,37,57,6,2,8
62,8476988,Matt Benning,D,SJS,30,64,5,3,8
62,8482859,Zack Ostapchuk,C,OTT,21,58,5,3,8
62,8477070,Liam O'Brien,C,UTA,30,57,4,4,8
62,8480192,Johnathan Kovacevic,D,NJD,27,53,4,4,8
62,8480292,Carson Meyer,R,ANA,27,27,4,4,8
62,8479328,Julien Gauthier,R,NYI,27,61,3,5,8
62,8482511,Mason Lohrei,D,BOS,23,26,3,5,8
62,8480252,Cole Guttman,C,CHI,25,40,2,6,8
62,8476372,Nick Seeler,D,PHI,31,45,2,6,8
62,8476952,Dominic Toninato,C,WPG,30,31,2,6,8
62,8481550,Adam Beckman,L,NJD,23,36,2,6,8
62,8483763,Maksymilian Szuber,D,UTA,22,35,2,6,8
62,8481599,Victor Soderstrom,D,UTA,23,41,1,7,8
62,8480834,Ty Emberson,D,SJS,24,31,1,7,8
62,8474612,Travis Hamonic,D,OTT,34,48,1,7,8
62,8476913,Devin Shore,C,MIN,30,40,1,7,8
62,8478450,Parker Wotherspoon,D,BOS,27,34,1,7,8
62,8477384,Joshua Brown,D,EDM,30,47,1,7,8
62,8480879,Jacob Bernard-Docker,D,OTT,24,47,0,8,8
62,8479994,Jaret Anderson-Dolan,C,WPG,25,31,7,0,7
62,8478409,Anthony Richard,C,PHI,28,24,5,2,7
62,8481556,John Beecher,C,BOS,23,38,5,2,7
62,8480245,Olle Lycksell,R,PHI,25,34,4,3,7
62,8482666,Scott Morrow,D,CAR,22,49,3,4,7
62,8482858,Ryker Evans,D,SEA,23,26,3,4,7
62,8483466,Kevin Korchinski,D,CHI,20,40,2,5,7
62,8484911,Collin Graf,R,SJS,22,45,2,5,7
62,8478017,Mark Friedman,D,VAN,29,38,2,5,7
62,8477962,Brendan Lemieux,L,CAR,28,36,2,5,7
62,8474090,Brendan Smith,D,DAL,35,52,1,6,7
62,8483460,David Jiricek,D,CBJ,21,53,1,6,7
62,8480990,Declan Chisholm,D,MIN,24,39,4,2,6
62,8482751,Ryan Winterton,C,SEA,21,27,4,2,6
62,8480289,Morgan Barron,C,WPG,26,46,3,3,6
62,8477482,Zachary Sanford,L,CHI,30,33,3,3,6
62,8478874,Adam Gaudette,R,OTT,28,36,3,3,6
62,8475958,Michael Sgarbossa,C,WSH,32,26,3,3,6
62,8481609,Vladislav Kolyachonok,D,UTA,23,34,3,3,6
62,8481541,Samuel Bolduc,D,NYI,24,32,3,3,6
62,8479981,Jonah Gadjovich,L,FLA,26,45,3,3,6
62,8479968,Vinni Lettieri,C,BOS,29,41,2,4,6
62,8481122,Simon Benoit,D,TOR,26,42,2,4,6
62,8479991,Jake Leschyshyn,C,NYR,25,34,2,4,6
62,8478021,William Lagesson,D,DET,28,28,2,4,6
62,8480058,Pierre-Olivier Joseph,D,STL,25,52,1,5,6
62,8477887,Patrick Brown,C,BOS,32,37,1,5,6
62,8482145,Mavrik Bourque,C,DAL,22,49,5,0,5
62,8480848,Ty Dellandrea,C,SJS,24,35,3,2,5
62,8480880,Jakub Lauko,C,MIN,24,33,3,2,5
62,8482765,Isak Rosen,R,BUF,21,30,3,2,5
62,8483397,Marc McLaughlin,C,BOS,25,27,3,2,5
62,8482496,Nils Aman,C,VAN,24,41,2,3,5
62,8475762,Derek Forbort,D,VAN,32,40,2,3,5
62,8480007,Jonas Rondbjerg,R,VGK,25,37,2,3,5
62,8479638,Justin Brazeau,R,BOS,26,33,2,3,5
62,8479985,Cale Fleury,D,SEA,26,34,2,3,5
62,8483630,Pavol Regenda,L,ANA,25,27,2,3,5
62,8484254,Akito Hirose,D,VAN,25,33,1,4,5
62,8482747,Brennan Othmann,L,NYR,21,35,1,4,5
62,8479536,Axel Jonsson-Fjallby,L,WPG,26,36,1,4,5
62,8473446,Erik Johnson,D,PHI,36,47,1,4,5
62,8483619,Filip Roos,D,OTT,25,31,1,4,5
62,8483549,Lucas Condotta,L,MTL,27,35,1,4,5
62,8477467,Gustav Olofsson,D,SEA,30,22,1,4,5
62,8477018,Ben Hutton,D,VGK,31,45,0,5,5
62,8477335,Kyle Burroughs,D,LAK,29,38,0,5,5
62,8471677,Jack Johnson,D,CBJ,37,68,0,5,5
62,8477971,Andreas Englund,D,LAK,28,30,0,5,5
62,8477244,Chad Ruhwedel,D,NYR,34,29,0,5,5
62,8476441,Joel Edmundson,D,LAK,31,35,0,5,5
62,8482172,Landon Slaggert,L,CHI,22,21,3,1,4
62,8482713,Mackie Samoskevich,R,FLA,22,36,3,1,4
62,8482147,Jean-Luc Foudy,C,COL,22,27,3,1,4
62,8481743,Marc Del Gaizo,D,NSH,25,26,3,1,4
62,8481719,Maxwell Crozier,D,TBL,24,16,2,2,4
62,8478502,Dennis Gilbert,D,BUF,28,21,2,2,4
62,8481699,Aku Raty,R,UTA,23,17,2,2,4
62,8484287,Cole McWard,D,VAN,23,25,1,3,4
62,8478146,Matthew Highmore,C,OTT,28,35,1,3,4
62,8480870,Bo Groulx,C,NYR,24,26,1,3,4
62,8478477,Mitchell Stephens,C,SEA,27,21,1,3,4
62,8477541,Dakota Mermis,D,TOR,30,12,1,3,4
62,8482177,Marat Khusnutdinov,C,MIN,22,30,1,3,4
62,8481056,Spencer Stastney,D,NSH,24,29,0,4,4
62,8480468,James Hamblin,L,EDM,25,20,3,0,3
62,8481543,Nikita Alexandrov,C,STL,24,21,2,1,3
62,8477527,Ross Johnston,L,ANA,30,35,2,1,3
62,8481585,Egor Afanasyev,L,SJS,23,14,2,1,3
62,8480267,Sammy Walker,C,MIN,25,15,2,1,3
62,8481600,Tobias Bjornfot,D,FLA,23,34,1,2,3
62,8481754,Nikita Nesterenko,C,ANA,23,32,1,2,3
62,8479419,Brett Murray,L,BUF,26,17,1,2,3
62,8477851,Jordan Oesterle,D,BOS,32,43,1,2,3
62,8482094,Daemon Hunt,D,MIN,22,18,1,2,3
62,8480075,Cameron Crotty,D,MIN,25,12,1,2,3
62,8482861,Vincent Iorio,D,WSH,22,32,0,3,3
62,8477320,Anton Blidh,L,NYR,29,19,0,3,3
62,8474062,Riley Nash,C,NYR,35,13,0,3,3
62,8480823,Alexander Alexeyev,D,WSH,25,9,0,3,3
62,8481006,Tyler Tucker,D,STL,24,18,0,3,3
62,8484304,Uvis Balinskis,D,FLA,28,12,0,3,3
62,8479362,Riley Tufte,L,BOS,26,24,2,0,2
62,8483471,Brad Lambert,C,WPG,31,7,2,0,2
62,8482141,Lukas Cormier,D,VGK,22,33,1,1,2
62,8482095,Tyler Kleven,D,OTT,22,40,1,1,2
62,8476867,Brendan Gaunce,C,MIN,30,32,1,1,2
62,8480890,Jan Jenik,C,OTT,24,26,1,1,2
62,8481462,Mason Morelli,L,VGK,28,11,1,1,2
62,8482102,Vasily Ponomarev,C,PIT,22,18,1,1,2
62,8481043,Cole Koepke,L,BOS,26,18,1,1,2
62,8475413,Justin Dowling,C,NJD,34,14,1,1,2
62,8479587,Rhett Gardner,C,PHI,28,18,1,1,2
62,8481206,John Ludvig,D,PIT,24,13,1,1,2
62,8478881,Brett Seney,L,CHI,28,14,1,1,2
62,8481806,Louis Crevier,D,CHI,23,14,1,1,2
62,8482787,Nikita Chibrikov,R,WPG,31,8,1,1,2
62,8477073,Kurtis MacDermid,L,NJD,30,38,0,2,2
62,8479320,Maxime Lajoie,D,SEA,27,19,0,2,2
62,8479367,William Lockwood,R,FLA,26,21,0,2,2
62,8481030,Jack St. Ivany,D,PIT,25,14,0,2,2
62,8477810,Joel Hanley,D,CGY,33,20,0,2,2
62,8483512,Matthew Savoie,C,EDM,20,24,0,2,2
62,8478051,Max Willman,C,NJD,29,21,0,2,2
62,8482250,Callahan Burke,C,VGK,27,16,0,2,2
62,8477473,Justin Bailey,R,SJS,29,24,0,2,2
62,8481422,Jake Lucchini,C,NSH,29,29,0,2,2
62,8482929,Emil Lilleberg,D,TBL,23,15,0,2,2
62,8482516,Matthew Kessel,D,STL,24,13,0,2,2
62,8475795,Dylan McIlrath,D,WSH,32,19,0,2,2
62,8477149,Scott Sabourin,R,SJS,32,15,0,2,2
62,8480851,Akil Thomas,C,LAK,24,22,0,2,2
62,8484325,Waltteri Merela,C,TBL,26,24,1,0,1
62,8483395,Arshdeep Bains,L,VAN,23,14,1,0,1
62,8475780,Chris Wagner,R,COL,33,13,1,0,1
62,8484258,Sam Malinski,D,COL,26,24,1,0,1
62,8482061,Brandon Biro,L,SEA,26,13,1,0,1
62,8475755,Alexander Petrovic,D,DAL,32,8,1,0,1
62,8481024,Linus Karlsson,C,VAN,25,9,1,0,1
62,8478446,Glenn Gawdin,C,LAK,27,13,1,0,1
62,8483407,Brandon Scanlin,D,NYR,25,5,1,0,1
62,8479421,Jacob Moverare,D,LAK,26,9,1,0,1
62,8478147,Bokondji Imama,L,PIT,28,10,1,0,1
62,8477462,Robert Hagg,D,VGK,29,22,0,1,1
62,8478011,Louie Belpedio,D,PHI,28,13,0,1,1
62,8481578,Graeme Clarke,R,MIN,23,14,0,1,1
62,8482118,Sam Colangelo,R,ANA,23,18,0,1,1
62,8483597,Milos Kelemen,L,UTA,25,10,0,1,1
62,8482144,Jack Thompson,D,SJS,22,23,0,1,1
62,8482162,Roby Jarventie,L,EDM,22,12,0,1,1
62,8482126,Emil Andrae,D,PHI,31,7,0,1,1
62,8481564,Ryan Johnson,D,BUF,23,10,0,1,1
62,8480084,Nick DeSimone,D,NJD,30,16,0,1,1
62,8481237,Kyle MacLean,C,NYI,25,23,0,1,1
62,8482470,Ilya Solovyov,D,CGY,24,18,0,1,1
62,8481593,Jayden Struble,D,MTL,23,14,0,1,1
62,8483609,Adam Klapka,R,CGY,24,3,0,1,1
62,8476323,Max McCormick,L,SEA,32,4,0,1,1
62,8480032,Shane Bowers,C,NJD,25,9,0,0,0
62,8480874,Adam Ginning,D,PHI,24,10,0,0,0
62,8482201,Gage Goncalves,C,TBL,23,19,0,0,0
62,8482088,Justin Sourdif,R,FLA,22,18,0,0,0
62,8480306,Grant Hutton,D,NYI,29,3,0,0,0
62,8483398,Declan Carlile,D,TBL,31,7,0,0,0
62,8482460,Matt Rempe,C,NYR,22,10,0,0,0
62,8483546,Marshall Rifai,D,TOR,26,7,0,0,0
62,8483489,Fraser Minten,C,TOR,31,16,0,0,0
62,8482476,Emil Heineman,L,MTL,23,7,0,0,0
62,8483920,Pierrick Dube,R,WSH,23,5,0,0,0
62,8483432,Luca Del Bel Belluz,C,CBJ,31,2,0,0,0
62,8481065,Angus Crookshank,L,OTT,25,10,0,0,0
62,8482165,Yan Kuznetsov,D,CGY,22,21,0,0,0
62,8481726,Adam Edstrom,C,NYR,24,5,0,0,0
62,8477993,Justin Kirkland,C,CGY,28,4,0,0,0
62,8479330,Brandon Gignac,C,MTL,27,15,0,0,0
62,8484259,Ondrej Pavel,C,COL,31,0,0,0,0
62,8483567,Georgii Merkulov,C,BOS,24,9,0,0,0
62,8478854,Ryan Shea,D,PIT,27,11,0,0,0
62,8481655,Cole Schwindt,R,CGY,23,6,0,0,0
62,8482197,Adam Raska,R,MIN,23,7,0,0,0
62,8479522,Hardy Haman Aktell,D,WSH,26,0,0,0,0
62,8481534,Raphael Lavoie,C,EDM,24,1,0,0,0
62,8484321,Nikolas Matinpalo,D,OTT,26,1,0,0,0
62,8484255,Jason Polin,R,COL,25,6,0,0,0
62,8484326,Patrik Koch,D,UTA,28,3,0,0,0
62,8483531,Brian Halonen,L,NJD,25,2,0,0,0
62,8483401,Marc Johnstone,R,PIT,28,3,0,0,0
62,8480274,Philip Kemp,D,EDM,25,0,0,0,0
62,8470794,Joe Pavelski,C,,40,0,0,0,0
62,8479321,Lucas Johansen,D,,27,0,0,0,0
62,8477950,Tony DeAngelo,D,,29,0,0,0,0
62,8471218,Blake Wheeler,R,,38,0,0,0,0
62,8475197,Tyson Barrie,D,,33,0,0,0,0
62,8474157,Max Pacioretty,L,,36,0,0,0,0
62,8475744,Evgeny Kuznetsov,C,,32,0,0,0,0
62,8474037,James van Riemsdyk,L,,35,0,0,0,0
62,8476907,Mackenzie MacEachern,L,,30,0,0,0,0
62,8480216,Jacob Peterson,C,,25,0,0,0,0
62,8474602,Justin Schultz,D,,34,0,0,0,0
62,8482222,Alexander Barabanov,L,,30,0,0,0,0
62,8474031,Kevin Shattenkirk,D,,35,0,0,0,0
62,8477330,Dominik Kubalik,L,,29,0,0,0,0
62,8480884,Calen Addison,D,,24,0,0,0,0
62,8475906,John Klingberg,D,,32,0,0,0,0
62,8480008,Adam Ruzicka,C,,25,0,0,0,0
62,8476884,Derrick Pouliot,D,,30,0,0,0,0
62,8476919,Chris Tierney,C,,30,0,0,0,0
62,8479415,Michael McLeod,C,,26,0,0,0,0
62,8474870,Tyler Johnson,C,,34,0,0,0,0
62,8470604,Jeff Carter,C,,39,0,0,0,0
62,8478104,Sammy Blais,L,,28,0,0,0,0
62,8474884,Mike Hoffman,C,,35,0,0,0,0
62,8481591,Sam Poulin,R,,23,0,0,0,0
62,8471274,Alex Goligoski,D,,39,0,0,0,0
62,8476871,Tanner Pearson,L,,32,0,0,0,0
62,8476393,Nick Cousins,C,,31,0,0,0,0
62,8479977,Kailer Yamamoto,R,,26,0,0,0,0
62,8479346,Dillon Dube,C,,26,0,0,0,0
62,8480184,Gustav Lindstrom,D,,26,0,0,0,0
62,8479376,Victor Mete,D,,26,0,0,0,0
62,8473449,Kyle Okposo,R,,36,0,0,0,0
62,8481058,Jesse Ylonen,R,,25,0,0,0,0
62,8475752,Tyler Pitlick,C,,33,0,0,0,0
62,8481239,Samuel Fagemo,L,,24,0,0,0,0
62,8480821,Filip Zadina,R,,25,0,0,0,0
62,8470966,Mark Giordano,D,,41,0,0,0,0
62,8478495,Denis Gurianov,R,,27,0,0,0,0
62,8477464,Nic Petan,C,,29,0,0,0,0
62,8478099,Kevin Labanc,R,,29,0,0,0,0
62,8482241,Radim Zohorna,L,,28,0,0,0,0
62,8474040,Sam Gagner,C,,35,0,0,0,0
62,8479514,Rem Pitlick,C,,27,0,0,0,0
62,8478430,Oliver Kylington,D,,27,0,0,0,0
62,8479533,Joona Koppanen,L,,26,0,0,0,0
62,8479984,Cal Foote,D,,26,0,0,0,0
62,8477126,Jayson Megna,C,,34,0,0,0,0
62,8475164,Jakob Silfverberg,R,,34,0,0,0,0
62,8474009,Nick Bonino,C,,36,0,0,0,0
62,8479458,Nikita Zaitsev,D,,33,0,0,0,0
62,8477944,Jakub Vrana,L,,28,0,0,0,0
62,8471699,Andrew Cogliano,C,,37,0,0,0,0
62,8478067,Oskar Lindblom,L,,28,0,0,0,0
62,8471686,Marc Staal,D,,37,0,0,0,0
62,8470610,Zach Parise,L,,40,0,0,0,0
62,8478904,Steven Lorentz,C,,28,0,0,0,0
62,8473473,Milan Lucic,L,,36,0,0,0,0
62,8480031,Maxime Comtois,L,,25,0,0,0,0
62,8478512,Austin Czarnik,C,,32,0,0,0,0
62,8473504,Cal Clutterbuck,R,,37,0,0,0,0
62,8477454,Adam Erne,L,,29,0,0,0,0
62,8479383,Boris Katchouk,L,,26,0,0,0,0
62,8475825,Jani Hakanpää,D,,32,0,0,0,0
62,8477846,Ryan Carpenter,C,,33,0,0,0,0
62,8477930,Pierre-Edouard Bellemare,L,,39,0,0,0,0
62,8478400,Colin White,C,,27,0,0,0,0
62,8480226,Marián Studenic,R,,26,0,0,0,0
62,8480853,Liam Foudy,C,,24,0,0,0,0
62,8475797,Jarred Tinordi,D,,32,0,0,0,0
62,8479423,Alex Nylander,L,,26,0,0,0,0
62,8474618,Marco Scandella,D,,34,0,0,0,0
62,8478028,Fredrik Olofsson,L,,28,0,0,0,0
62,8474709,Matt Martin,L,,35,0,0,0,0
62,8481070,Hugh McGing,L,,26,0,0,0,0
62,8479546,Oskar Steen,C,,26,0,0,0,0
62,8474145,Robert Bortuzzo,D,,35,0,0,0,0
62,8476915,Jujhar Khaira,L,,30,0,0,0,0
62,8475278,Byron Froese,C,,33,0,0,0,0
62,8481812,Nikolai Knyzhov,D,,27,0,0,0,0
62,8478408,Travis Dermott,D,,28,0,0,0,0
62,8481077,John Leonard,L,,26,0,0,0,0
62,8479547,Matthew Phillips,R,,26,0,0,0,0
62,8480836,Jonathan Gruden,C,,24,0,0,0,0
62,8481690,Tyler Angle,C,,24,0,0,0,0
62,8475766,Austin Watson,L,,32,0,0,0,0
62,8481016,Ruslan Iskhakov,C,,24,0,0,0,0
62,8478078,Rourke Chartier,C,,28,0,0,0,0
62,8480776,Sheldon Rempal,R,,29,0,0,0,0
62,8478956,Samuel Laberge,L,NJD,27,1,0,0,0
62,8483045,Cameron Butler,R,CBJ,31,2,0,0,0
62,8484314,Jiri Smejkal,L,,28,0,0,0,0
63,8478402,Connor McDavid,C,EDM,27,79,46,103,149
63,8477492,Nathan MacKinnon,C,COL,29,80,49,94,143
63,8476453,Nikita Kucherov,R,TBL,31,82,28,101,129
63,8477934,Leon Draisaitl,C,EDM,29,78,49,78,127
63,8479318,Auston Matthews,C,TOR,27,79,68,49,117
63,8481559,Jack Hughes,C,NJD,23,78,47,67,114
63,8477493,Aleksander Barkov,C,FLA,29,79,37,77,114
63,8478420,Mikko Rantanen,R,COL,28,81,46,67,113
63,8478483,Mitch Marner,R,TOR,27,79,34,77,111
63,8477404,Jake Guentzel,C,TBL,30,82,54,55,109
63,8480027,Jason Robertson,L,DAL,25,82,40,69,109
63,8477956,David Pastrnak,R,BOS,28,82,54,54,108
63,8480069,Cale Makar,D,COL,26,70,29,79,108
63,8476468,J.T. Miller,C,VAN,31,73,39,64,103
63,8477942,Kevin Fiala,L,LAK,28,81,42,60,102
63,8477939,William Nylander,R,TOR,28,76,44,57,101
63,8478864,Kirill Kaprizov,L,MIN,27,73,43,57,100
63,8474564,Steven Stamkos,C,NSH,34,71,35,58,93
63,8479314,Matthew Tkachuk,L,FLA,27,80,27,64,91
63,8478010,Brayden Point,C,TBL,28,82,45,45,90
63,8471675,Sidney Crosby,C,PIT,37,75,35,55,90
63,8478427,Sebastian Aho,C,CAR,27,71,38,50,88
63,8478403,Jack Eichel,C,VGK,28,80,39,48,87
63,8480002,Nico Hischier,C,NJD,25,77,32,55,87
63,8479343,Clayton Keller,R,UTA,26,77,45,41,86
63,8480800,Quinn Hughes,D,VAN,25,74,14,72,86
63,8475784,Jeff Skinner,C,EDM,32,81,35,50,85
63,8476887,Filip Forsberg,L,NSH,30,70,33,52,85
63,8484144,Connor Bedard,C,CHI,19,67,26,58,84
63,8478550,Artemi Panarin,L,NYR,33,79,25,59,84
63,8476454,Ryan Nugent-Hopkins,C,EDM,31,79,22,62,84
63,8477501,Valeri Nichushkin,R,COL,29,81,45,38,83
63,8475913,Mark Stone,R,VGK,32,78,33,50,83
63,8478445,Mathew Barzal,C,NYI,27,80,29,54,83
63,8475166,John Tavares,C,TOR,34,76,39,43,82
63,8479407,Jesper Bratt,L,NJD,26,76,27,55,82
63,8480012,Elias Pettersson,C,VAN,26,70,37,44,81
63,8480801,Brady Tkachuk,L,OTT,25,82,35,46,81
63,8478439,Travis Konecny,R,PHI,27,78,30,51,81
63,8480023,Robert Thomas,C,STL,25,73,26,55,81
63,8479323,Adam Fox,D,NYR,26,78,21,60,81
63,8478414,Timo Meier,R,NJD,28,73,40,40,80
63,8477933,Sam Reinhart,C,FLA,29,78,32,48,80
63,8477409,Carter Verhaeghe,C,FLA,29,79,43,36,79
63,8482116,Tim Stützle,C,OTT,22,80,27,51,78
63,8471215,Evgeni Malkin,C,PIT,38,72,35,42,77
63,8480865,Noah Dobson,D,NYI,24,79,17,60,77
63,8475692,Mats Zuccarello,R,MIN,37,75,15,61,76
63,8479337,Alex DeBrincat,R,DET,27,79,38,37,75
63,8478444,Brock Boeser,R,VAN,27,78,33,42,75
63,8481557,Matt Boldy,L,MIN,23,74,39,34,73
63,8482078,Lucas Raymond,L,DET,22,81,32,41,73
63,8477960,Adrian Kempe,R,LAK,28,79,30,43,73
63,8477946,Dylan Larkin,C,DET,28,80,37,35,72
63,8482093,Seth Jarvis,C,CAR,22,70,33,39,72
63,8480208,Drake Batherson,R,OTT,26,78,29,43,72
63,8476459,Mika Zibanejad,C,NYR,31,78,28,44,72
63,8474600,Roman Josi,D,NSH,34,75,22,50,72
63,8476346,Johnny Gaudreau,L,CBJ,31,72,11,61,72
63,8479385,Jordan Kyrou,C,STL,26,72,29,42,71
63,8478440,Dylan Strome,C,WSH,27,70,23,48,71
63,8480018,Nick Suzuki,C,MTL,25,74,31,39,70
63,8477402,Pavel Buchnevich,L,STL,29,76,30,40,70
63,8480830,Andrei Svechnikov,R,CAR,24,73,28,42,70
63,8480188,Fabian Zetterlund,L,SJS,25,67,40,29,69
63,8471214,Alex Ovechkin,L,WSH,39,74,38,31,69
63,8482665,Matty Beniers,C,SEA,22,78,31,38,69
63,8478401,Pavel Zacha,C,BOS,27,78,21,48,69
63,8473419,Brad Marchand,L,BOS,36,78,26,42,68
63,8479675,Trevor Moore,L,LAK,29,81,25,43,68
63,8475172,Nazem Kadri,C,CGY,34,77,21,47,68
63,8478975,Mason Marchment,L,DAL,29,81,21,47,68
63,8476881,Tomas Hertl,C,VGK,31,76,32,34,66
63,8478398,Kyle Connor,L,WPG,28,71,32,34,66
63,8479420,Tage Thompson,C,BUF,27,75,32,34,66
63,8473994,Jamie Benn,L,DAL,35,80,27,39,66
63,8478407,Vince Dunn,D,SEA,28,71,9,57,66
63,8477476,Artturi Lehkonen,L,COL,29,80,27,38,65
63,8478449,Roope Hintz,C,DAL,28,80,25,40,65
63,8480036,Miro Heiskanen,D,DAL,25,75,16,49,65
63,8481068,Yegor Sharangovich,C,CGY,26,78,29,35,64
63,8477496,Elias Lindholm,C,BOS,30,79,19,45,64
63,8480839,Rasmus Dahlin,D,BUF,24,71,15,49,64
63,8482684,Luke Hughes,D,NJD,21,73,8,56,64
63,8475765,Vladimir Tarasenko,R,DET,33,81,23,40,63
63,8477503,Max Domi,C,TOR,29,75,22,41,63
63,8478873,Troy Terry,R,ANA,27,77,20,43,63
63,8478397,Rasmus Andersson,D,CGY,28,74,16,47,63
63,8480803,Evan Bouchard,D,EDM,25,77,15,48,63
63,8474578,Erik Karlsson,D,PIT,34,79,11,52,63
63,8476853,Morgan Rielly,D,TOR,30,70,6,57,63
63,8475726,Tyler Toffoli,C,SJS,32,68,29,33,62
63,8482113,Anton Lundell,C,FLA,23,71,27,35,62
63,8475158,Ryan O'Reilly,C,NSH,33,70,21,41,62
63,8475786,Zach Hyman,L,EDM,32,70,37,24,61
63,8477955,Jared McCann,L,SEA,28,78,28,33,61
63,8474141,Patrick Kane,R,DET,36,82,25,36,61
63,8476448,William Karlsson,C,VGK,31,79,21,40,61
63,8475798,Mikael Granlund,C,SJS,32,67,20,41,61
63,8477456,J.T. Compher,L,DET,29,80,20,41,61
63,8476460,Mark Scheifele,C,WPG,31,68,20,40,60
63,8479999,Casey Mittelstadt,C,COL,26,81,20,40,60
63,8471685,Anze Kopitar,C,LAK,37,80,16,44,60
63,8477500,Bo Horvat,C,NYI,29,78,30,29,59
63,8480015,Owen Tippett,R,PHI,25,73,29,30,59
63,8478493,Joel Eriksson Ek,C,MIN,27,68,28,31,59
63,8476389,Vincent Trocheck,C,NYR,31,77,22,37,59
63,8473512,Claude Giroux,R,OTT,36,79,16,43,59
63,8476483,Rickard Rakell,R,PIT,31,72,36,22,58
63,8483431,Logan Cooley,C,UTA,20,73,28,30,58
63,8477949,Alex Tuch,R,BUF,28,65,24,34,58
63,8479400,Pierre-Luc Dubois,L,WSH,26,75,23,35,58
63,8475168,Matt Duchene,C,DAL,33,81,27,30,57
63,8477407,Anthony Duclair,L,NYI,29,74,24,33,57
63,8478047,Michael Bunting,L,PIT,29,73,24,33,57
63,8475754,Brock Nelson,C,NYI,33,81,22,35,57
63,8477416,Oliver Bjorkstrand,R,SEA,29,74,21,36,57
63,8474590,John Carlson,D,WSH,34,69,16,41,57
63,8478460,Zach Werenski,D,CBJ,27,82,15,42,57
63,8479542,Brandon Hagel,L,TBL,26,81,25,31,56
63,8482699,Dylan Guenther,R,UTA,21,74,25,31,56
63,8481528,Dylan Cozens,C,BUF,23,71,23,33,56
63,8477951,Nick Schmaltz,C,UTA,28,74,21,35,56
63,8477504,Josh Morrissey,D,WPG,29,73,15,41,56
63,8475167,Victor Hedman,D,TBL,34,78,6,50,56
63,8475184,Chris Kreider,L,NYR,33,77,32,23,55
63,8475170,Brayden Schenn,C,STL,33,74,27,28,55
63,8475745,Charlie Coyle,C,BOS,32,80,20,35,55
63,8477494,Jonathan Drouin,L,COL,29,80,19,36,55
63,8476875,Mike Matheson,D,MTL,30,73,17,38,55
63,8474679,Gustav Nyquist,C,NSH,35,74,23,31,54
63,8476479,Phillip Danault,C,LAK,31,79,22,32,54
63,8477021,Alex Kerfoot,C,UTA,30,74,21,33,54
63,8480798,Philipp Kurashev,C,CHI,25,65,19,35,54
63,8482740,Wyatt Johnston,C,DAL,21,82,33,20,53
63,8476399,Blake Coleman,C,CGY,33,81,27,26,53
63,8476826,Yanni Gourde,C,SEA,33,73,25,28,53
63,8476456,Jonathan Huberdeau,C,CGY,31,78,15,38,53
63,8479325,Charlie McAvoy,D,BOS,27,71,11,42,53
63,8476539,Jonathan Marchessault,R,NSH,34,72,26,26,52
63,8477935,Sam Bennett,C,FLA,28,78,22,30,52
63,8474563,Drew Doughty,D,LAK,35,71,19,33,52
63,8482667,William Eklund,L,SJS,22,70,16,36,52
63,8471724,Kris Letang,D,PIT,37,78,5,47,52
63,8481596,Shane Pinto,C,OTT,24,77,28,23,51
63,8481540,Cole Caufield,R,MTL,23,76,22,29,51
63,8476906,Shayne Gostisbehere,D,CAR,31,75,10,41,51
63,8479425,Filip Hronek,D,VAN,27,70,9,42,51
63,8475810,Bryan Rust,R,PIT,32,71,29,21,50
63,8475799,Nino Niederreiter,R,WPG,32,71,28,22,50
63,8480064,Josh Norris,C,OTT,25,76,27,23,50
63,8475151,Kyle Palmieri,C,NYI,33,78,25,25,50
63,8482159,Tyson Foerster,R,PHI,22,73,21,29,50
63,8474586,Jordan Eberle,R,SEA,34,79,20,30,50
63,8474102,David Perron,L,OTT,36,73,20,30,50
63,8477986,Brandon Montour,D,SEA,30,77,11,39,50
63,8477940,Nikolaj Ehlers,L,WPG,28,68,21,28,49
63,8480039,Martin Necas,C,CAR,25,69,20,29,49
63,8475794,Tyler Seguin,C,DAL,32,81,26,22,48
63,8482110,Dawson Mercer,C,NJD,23,76,24,24,48
63,8477511,Anthony Mantha,R,CGY,30,78,24,24,48
63,8478498,Jake DeBrusk,L,VAN,28,71,23,25,48
63,8480185,Eetu Luostarinen,C,FLA,26,76,23,25,48
63,8478542,Evan Rodrigues,C,FLA,31,74,21,27,48
63,8476905,Chandler Stephenson,C,SEA,30,75,20,28,48
63,8478519,Anthony Cirelli,C,TBL,27,82,20,28,48
63,8477444,Andre Burakovsky,L,SEA,29,71,19,29,48
63,8478042,Viktor Arvidsson,L,EDM,31,75,18,30,48
63,8481711,Matias Maccelli,L,UTA,24,76,14,34,48
63,8477447,Shea Theodore,D,VGK,29,57,13,35,48
63,8478469,Thomas Chabot,D,OTT,27,74,11,37,48
63,8477426,Nicholas Paul,L,TBL,29,82,28,19,47
63,8474150,Mikael Backlund,C,CGY,35,81,23,24,47
63,8482097,Jack Quinn,R,BUF,23,71,20,27,47
63,8482720,Matthew Knies,L,TOR,22,76,17,30,47
63,8474565,Alex Pietrangelo,D,VGK,34,67,14,33,47
63,8476958,Jaccob Slavin,D,CAR,30,71,8,39,47
63,8473986,Alex Killorn,L,ANA,35,66,21,25,46
63,8483515,Juraj Slafkovsky,L,MTL,20,80,20,26,46
63,8475218,Mattias Ekholm,D,EDM,34,78,15,31,46
63,8479992,Michael Rasmussen,C,DET,25,78,14,32,46
63,8477429,Andrew Copp,C,DET,30,80,13,33,46
63,8476432,Boone Jenner,C,CBJ,31,68,27,18,45
63,8479525,Ross Colton,C,COL,28,82,20,25,45
63,8482109,Alexis Lafrenière,L,NYR,23,79,18,27,45
63,8477964,Ivan Barbashev,C,VGK,29,78,15,30,45
63,8481542,Moritz Seider,D,DET,23,70,12,33,45
63,8479345,Jakob Chychrun,D,WSH,26,73,8,37,45
63,8475722,Jason Zucker,L,BUF,32,75,25,19,44
63,8484153,Leo Carlsson,C,ANA,20,69,21,23,44
63,8482745,Mason McTavish,C,ANA,21,73,21,23,44
63,8477497,Sean Monahan,C,CBJ,30,77,21,23,44
63,8475287,Erik Haula,L,NJD,33,74,18,26,44
63,8476462,Dougie Hamilton,D,NJD,31,67,11,33,44
63,8478466,Daniel Sprong,R,VAN,27,74,22,21,43
63,8478462,Nicolas Roy,C,VGK,27,77,21,22,43
63,8482702,Logan Stankoven,C,DAL,21,78,20,23,43
63,8481618,Alex Newhook,C,MTL,23,72,18,25,43
63,8483808,Andrei Kuzmenko,L,CGY,28,76,17,26,43
63,8482124,Quinton Byfield,R,LAK,22,77,14,29,43
63,8478038,Devon Toews,D,COL,30,63,9,34,43
63,8475169,Evander Kane,L,EDM,33,73,27,15,42
63,8475314,Anders Lee,L,NYI,34,76,25,17,42
63,8478366,Frank Vatrano,R,ANA,30,75,25,17,42
63,8479987,Morgan Geekie,C,BOS,26,78,21,21,42
63,8482146,Luke Evangelista,R,NSH,22,66,21,21,42
63,8480459,Pius Suter,C,VAN,28,70,20,22,42
63,8477998,Warren Foegele,L,LAK,28,76,18,24,42
63,8475191,Reilly Smith,R,NYR,33,75,17,25,42
63,8476292,Ondrej Palat,L,NJD,33,72,12,30,42
63,8476419,Jean-Gabriel Pageau,C,NYI,32,77,12,30,42
63,8476869,Brady Skjei,D,NSH,30,67,11,31,42
63,8478438,Tommy Novak,C,NSH,27,66,13,28,41
63,8470613,Brent Burns,D,CAR,39,74,12,29,41
63,8475714,Calle Jarnkrok,C,TOR,33,73,22,18,40
63,8478233,Andrew Mangiapane,L,WSH,28,68,21,19,40
63,8476438,Brandon Saad,L,STL,32,70,20,20,40
63,8480813,Joe Veleno,C,DET,24,75,19,21,40
63,8478856,Conor Garland,R,VAN,28,74,18,22,40
63,8474641,Adam Henrique,C,EDM,34,73,12,28,40
63,8475753,Justin Faulk,D,STL,32,73,12,28,40
63,8478046,Danton Heinen,L,VAN,29,71,12,28,40
63,8478396,Noah Hanifin,D,VGK,27,65,7,33,40
63,8476880,Tom Wilson,R,WSH,30,67,24,15,39
63,8476474,Stefan Noesen,R,NJD,31,68,24,15,39
63,8476882,Teuvo Teravainen,C,CHI,30,70,21,18,39
63,8480014,Gabriel Vilardi,C,WPG,25,68,19,20,39
63,8482175,JJ Peterka,R,BUF,22,67,19,20,39
63,8478891,Mason Appleton,C,WPG,28,69,16,23,39
63,8475793,Ryan Johansen,C,PHI,32,72,14,25,39
63,8476979,Erik Gustafsson,D,DET,32,73,7,32,39
63,8476461,Sean Couturier,C,PHI,32,70,17,21,38
63,8481533,Trevor Zegras,C,ANA,23,69,12,26,38
63,8479410,Mikhail Sergachev,D,UTA,26,65,6,32,38
63,8481604,Pavel Dorofeyev,L,VGK,24,69,21,16,37
63,8484166,Adam Fantilli,C,CBJ,20,59,20,17,37
63,8471698,T.J. Oshie,R,WSH,38,68,18,19,37
63,8478057,Dakota Joshua,C,VAN,28,68,17,20,37
63,8480797,Joel Farabee,L,PHI,24,74,17,20,37
63,8477505,Alexander Wennberg,C,SJS,30,70,11,26,37
63,8478458,John (Jack) Roslovic,C,CAR,27,62,10,27,37
63,8481577,Philip Tomasino,C,NSH,23,67,8,29,37
63,8476892,Colton Parayko,D,STL,31,70,8,29,37
63,8480829,Jesperi Kotkaniemi,C,CAR,24,68,19,17,36
63,8481186,Logan O'Connor,R,COL,28,78,18,18,36
63,8480835,Jack Drury,C,CAR,24,61,18,18,36
63,8481560,Arthur Kaliyev,R,LAK,23,80,17,19,36
63,8482105,Jake Sanderson,D,OTT,22,72,17,19,36
63,8477451,Ryan Hartman,R,MIN,30,70,15,21,36
63,8476792,Torey Krug,D,STL,33,68,13,23,36
63,8481581,Thomas Harley,D,DAL,23,76,11,25,36
63,8482149,Cole Perfetti,C,WPG,22,70,8,28,36
63,8482712,Oskar Olausson,R,COL,22,74,8,28,36
63,8476923,Damon Severson,D,CBJ,30,79,6,30,36
63,8476917,Adam Pelech,D,NYI,30,77,3,33,36
63,8482089,Jake Neighbours,L,STL,22,70,23,12,35
63,8479591,Michael Eyssimont,C,TBL,28,82,17,18,35
63,8475768,Jaden Schwartz,C,SEA,32,75,15,20,35
63,8480068,Ryan Poehling,C,PHI,25,68,13,22,35
63,8477498,Darnell Nurse,D,EDM,29,72,11,24,35
63,8478472,Mathieu Joseph,R,STL,27,67,10,25,35
63,8476854,Hampus Lindholm,D,BOS,30,81,10,25,35
63,8479398,Samuel Girard,D,COL,26,66,6,29,35
63,8479661,Tanner Jeannot,L,LAK,27,78,19,15,34
63,8477479,Tyler Bertuzzi,L,CHI,29,59,18,16,34
63,8478413,Jordan Greenway,L,BUF,27,62,11,23,34
63,8474716,Jared Spurgeon,D,MIN,35,77,9,25,34
63,8482122,Brock Faber,D,MIN,22,80,8,26,34
63,8480028,Morgan Frost,C,PHI,25,69,7,27,34
63,8484203,Bradly Nadeau,L,CAR,19,65,7,27,34
63,8482475,Yegor Chinakhov,R,CBJ,23,61,20,13,33
63,8478115,Pierre Engvall,L,NYI,28,78,17,16,33
63,8478474,Lawson Crouse,L,UTA,27,74,13,20,33
63,8483505,Matthew Poitras,C,BOS,20,73,13,20,33
63,8481522,Peyton Krebs,C,BUF,23,65,11,22,33
63,8475763,Kevin Hayes,R,PIT,32,65,10,23,33
63,8475200,Dmitry Orlov,D,CAR,33,72,10,23,33
63,8477346,MacKenzie Weegar,D,CGY,30,70,9,24,33
63,8480009,Eeli Tolvanen,R,SEA,25,68,9,24,33
63,8477948,Travis Sanheim,D,PHI,28,66,8,25,33
63,8481703,Valtteri Puustinen,R,PIT,25,60,7,26,33
63,8477488,Brett Pesce,D,NJD,30,72,7,26,33
63,8473422,Nick Foligno,L,CHI,37,61,16,16,32
63,8481553,Bobby Brink,R,PHI,23,67,16,16,32
63,8477952,Robby Fabbri,C,ANA,28,67,13,19,32
63,8475760,Nick Bjugstad,C,UTA,32,74,13,19,32
63,8480220,Noah Cates,L,PHI,25,69,13,19,32
63,8476927,Teddy Blueger,C,VAN,30,63,13,19,32
63,8482092,Ridly Greig,C,OTT,22,77,12,20,32
63,8480336,Sean Walker,D,CAR,30,77,10,22,32
63,8482133,Thomas Bordeleau,C,SJS,22,58,9,23,32
63,8478013,Jake Walman,D,SJS,28,75,9,23,32
63,8477495,Seth Jones,D,CHI,30,72,8,24,32
63,8474151,Ryan McDonagh,D,TBL,35,78,4,28,32
63,8474715,Cameron Atkinson,R,TBL,35,80,18,13,31
63,8482055,Drew O'Connor,L,PIT,26,70,16,15,31
63,8479365,Trent Frederic,C,BOS,26,76,14,17,31
63,8474189,Lars Eller,C,PIT,35,72,13,18,31
63,8479339,Patrik Laine,L,CBJ,26,61,12,19,31
63,8477947,Sonny Milano,L,WSH,28,57,11,20,31
63,8475848,Brendan Gallagher,R,MTL,32,62,10,21,31
63,8475149,Marcus Johansson,L,MIN,34,66,8,23,31
63,8475764,Cam Fowler,D,ANA,33,75,7,24,31
63,8480434,Sean Durzi,D,UTA,26,69,5,26,31
63,8480113,Alex Iafallo,L,WPG,31,65,16,14,30
63,8477839,Conor Sheary,L,TBL,32,82,16,14,30
63,8481535,Nils Hoglander,L,VAN,24,69,14,16,30
63,8481656,Aliaksei Protas,C,WSH,23,65,11,19,30
63,8476885,Jacob Trouba,D,NYR,30,69,10,20,30
63,8482101,Danil Gushchin,L,SJS,22,56,6,24,30
63,8477969,Marcus Pettersson,D,PIT,28,75,4,26,30
63,8480893,Kirill Marchenko,R,CBJ,24,60,17,12,29
63,8477353,Tyler Motte,C,DET,29,74,13,16,29
63,8475855,Jesper Fast,R,CAR,33,55,12,17,29
63,8476312,Josh Manson,D,COL,33,65,11,18,29
63,8477989,Christian Dvorak,C,MTL,28,67,10,19,29
63,8475791,Taylor Hall,L,CHI,33,61,9,20,29
63,8476872,Scott Laughton,C,PHI,30,73,8,21,29
63,8479983,Mario Ferraro,D,SJS,26,66,8,21,29
63,8475171,Oliver Ekman-Larsson,D,TOR,33,64,7,22,29
63,8482125,Alexander Holtz,R,VGK,22,68,14,14,28
63,8480849,Barrett Hayton,C,UTA,24,75,14,14,28
63,8479996,Cody Glass,C,NSH,25,64,12,16,28
63,8481554,Kaapo Kakko,R,NYR,23,67,11,17,28
63,8480748,Kiefer Sherwood,L,VAN,29,61,10,18,28
63,8476624,Barclay Goodrow,C,SJS,31,60,10,18,28
63,8482749,Joshua Roy,R,MTL,21,70,9,19,28
63,8476392,Adam Lowry,C,WPG,31,69,9,19,28
63,8476467,Jamie Oleksiak,D,SEA,32,64,8,20,28
63,8481523,Kirby Dach,C,MTL,23,69,7,21,28
63,8479351,Sam Steel,C,DAL,26,82,7,21,28
63,8482671,Owen Power,D,BUF,22,62,7,21,28
63,8480145,Neal Pionk,D,WPG,29,72,6,22,28
63,8480871,Adam Boqvist,D,FLA,24,66,6,22,28
63,8477932,Aaron Ekblad,D,FLA,28,70,4,24,28
63,8476879,Cody Ceci,D,EDM,31,72,4,24,28
63,8484145,Zach Benson,L,BUF,19,60,13,14,27
63,8481582,Nicholas Robertson,L,TOR,23,60,13,14,27
63,8478043,Sam Lafferty,C,BUF,29,61,13,14,27
63,8480789,Oliver Wahlstrom,R,NYI,24,70,10,17,27
63,8481580,Connor McMichael,C,WSH,23,67,10,17,27
63,8473563,Nicklas Backstrom,C,WSH,37,54,9,18,27
63,8480078,Filip Chytil,C,NYR,25,66,8,19,27
63,8482111,Justin Barron,D,MTL,23,69,8,19,27
63,8476458,Ryan Strome,C,ANA,31,65,7,20,27
63,8474053,Logan Couture,C,SJS,35,59,7,20,27
63,8482067,Connor Mackey,D,NYR,28,57,7,20,27
63,8482245,Artem Zub,D,OTT,29,71,3,24,27
63,8483490,Pavel Mintyukov,D,ANA,21,75,3,24,27
63,8475233,David Savard,D,MTL,34,59,3,24,27
63,8482259,Bobby McMann,C,TOR,28,66,17,9,26
63,8482074,Connor Zary,C,CGY,23,62,14,12,26
63,8480205,Emil Bemstrom,C,PIT,25,58,14,12,26
63,8475193,Tomas Tatar,L,NJD,34,55,13,13,26
63,8474149,Evgenii Dadonov,R,DAL,35,82,12,14,26
63,8483457,Lane Hutson,D,MTL,20,70,12,14,26
63,8478508,Yakov Trenin,C,MIN,27,59,12,14,26
63,8479390,Taylor Raddysh,R,WSH,26,63,12,14,26
63,8481704,Juuso Parssinen,C,NSH,23,56,12,14,26
63,8476329,Travis Boyd,C,MIN,31,62,11,15,26
63,8479316,Luke Kunin,C,SJS,27,58,10,16,26
63,8482142,Jamie Drysdale,D,PHI,22,65,9,17,26
63,8478133,Jake Evans,C,MTL,28,68,5,21,26
63,8481014,Alexander Romanov,D,NYI,24,78,4,22,26
63,8476931,Jake McCabe,D,TOR,31,69,2,24,26
63,8474673,TJ Brodie,D,CHI,34,65,1,25,26
63,8481481,Blake Lizotte,C,PIT,27,57,15,10,25
63,8475231,Casey Cizikas,C,NYI,33,75,15,10,25
63,8483491,Ivan Miroshnichenko,L,WSH,20,52,14,11,25
63,8476981,Josh Anderson,R,MTL,30,68,13,12,25
63,8476469,Joel Armia,R,MTL,31,64,13,12,25
63,8480003,Jesper Boqvist,C,FLA,26,66,11,14,25
63,8478463,Anthony Beauvillier,L,PIT,27,58,10,15,25
63,8479293,Brandon Tanev,L,SEA,33,62,10,15,25
63,8476925,Colton Sissons,C,NSH,31,66,10,15,25
63,8479315,Joey Anderson,R,CHI,26,50,10,15,25
63,8478970,Jalen Chatfield,D,CAR,28,74,9,16,25
63,8480073,Erik Brannstrom,D,COL,25,61,8,17,25
63,8479639,Dylan Coghlan,D,WPG,26,66,7,18,25
63,8481546,Cam York,D,PHI,23,67,7,18,25
63,8478500,Ivan Provorov,D,CBJ,27,81,6,19,25
63,8476463,Jonas Brodin,D,MIN,31,76,6,19,25
63,8481524,Bowen Byram,D,BUF,23,65,5,20,25
63,8480878,Nils Lundkvist,D,DAL,24,66,5,20,25
63,8478178,Darren Raddysh,D,TBL,28,65,5,20,25
63,8478507,John Marino,D,UTA,27,61,3,22,25
63,8477903,Garnet Hathaway,R,PHI,33,64,15,9,24
63,8480995,Pontus Holmberg,R,TOR,25,64,12,12,24
63,8483565,Nick Blankenburg,D,NSH,26,62,11,13,24
63,8477987,Ryan Donato,C,CHI,28,61,9,15,24
63,8481601,Simon Holmstrom,R,NYI,23,71,8,16,24
63,8477220,Nate Schmidt,D,FLA,33,65,8,16,24
63,8473507,Jeff Petry,D,DET,37,67,5,19,24
63,8480058,Pierre-Olivier Joseph,D,STL,25,54,5,19,24
63,8478911,Matt Roy,D,WSH,29,66,2,22,24
63,8480043,Timothy Liljegren,D,TOR,25,66,2,22,24
63,8481178,Egor Zamula,D,PHI,24,58,2,22,24
63,8477919,Frederick Gaudreau,C,MIN,31,58,14,9,23
63,8479336,Carl Grundstrom,R,SJS,27,49,14,9,23
63,8470621,Corey Perry,R,EDM,39,71,13,10,23
63,8479353,Brett Howden,C,VGK,26,73,11,12,23
63,8476878,Zemgus Girgensons,C,TBL,30,82,9,14,23
63,8482809,Jackson Blake,R,CAR,21,60,9,14,23
63,8480021,Jack Studnicka,C,LAK,25,66,9,14,23
63,8477953,Kasperi Kapanen,R,STL,28,68,8,15,23
63,8476422,Mike Reilly,D,NYI,31,72,8,15,23
63,8477508,Curtis Lazar,C,NJD,29,58,8,15,23
63,8481606,Jordan Spence,D,LAK,23,74,7,16,23
63,8476988,Matt Benning,D,SJS,30,72,7,16,23
63,8480246,Nick Perbix,D,TBL,26,72,5,18,23
63,8482803,Olen Zellweger,D,ANA,21,69,12,10,22
63,8477450,Jason Dickinson,C,CHI,29,64,12,10,22
63,8481093,Rafael Harvey-Pinard,L,MTL,25,59,11,11,22
63,8479941,Justin Danforth,R,CBJ,31,56,10,12,22
63,8477015,Connor Brown,R,EDM,30,63,10,12,22
63,8483493,Frank Nazar,C,CHI,20,54,9,13,22
63,8476921,Jordan Martinook,L,CAR,32,62,8,14,22
63,8483468,Jiri Kulich,C,BUF,20,58,8,14,22
63,8479393,Noah Gregor,L,OTT,26,77,7,15,22
63,8480144,David Kampf,C,TOR,29,73,5,17,22
63,8482087,Kaiden Guhle,D,MTL,22,69,5,17,22
63,8480049,Dylan Samberg,D,WPG,25,60,4,18,22
63,8475279,Ben Chiarot,D,DET,33,67,4,18,22
63,8478851,Alexandre Carrier,D,NSH,28,65,3,19,22
63,8476902,Esa Lindell,D,DAL,30,74,2,20,22
63,8478399,Jonas Siegenthaler,D,NJD,27,61,0,22,22
63,8477478,William Carrier,L,CAR,30,60,13,8,21
63,8478020,Michael Amadio,R,OTT,28,75,12,9,21
63,8482079,Marco Rossi,C,MIN,23,63,10,11,21
63,8478109,Victor Olofsson,L,VGK,29,65,7,14,21
63,8480802,Ryan McLeod,C,BUF,25,64,7,14,21
63,8480817,K'Andre Miller,D,NYR,24,71,6,15,21
63,8476525,Colin Miller,D,WPG,32,63,6,15,21
63,8482451,Mikael Pyyhtia,L,CBJ,23,44,3,18,21
63,8480891,Michael Kesselring,D,UTA,24,63,3,18,21
63,8478840,Will Borgen,D,SEA,28,65,2,19,21
63,8477425,Miles Wood,L,COL,29,77,11,9,20
63,8478055,Gustav Forsling,D,FLA,28,69,9,11,20
63,8479328,Julien Gauthier,R,NYI,27,61,9,11,20
63,8480855,Jack McBain,C,UTA,24,69,8,12,20
63,8482679,Matt Coronato,R,CGY,22,67,8,12,20
63,8477392,Hudson Fasching,R,NYI,29,59,7,13,20
63,8479370,Tyson Jost,C,CAR,26,50,7,13,20
63,8476994,Vinnie Hinostroza,C,NSH,30,48,7,13,20
63,8482148,Hendrix Lapierre,C,WSH,22,53,6,14,20
63,8478416,Erik Cernak,D,TBL,27,70,6,14,20
63,8478882,Vladislav Gavrikov,D,LAK,29,67,5,15,20
63,8475181,Nick Leddy,D,STL,33,67,4,16,20
63,8474574,Tyler Myers,D,VAN,34,65,2,18,20
63,8482655,Janis Moser,D,TBL,24,78,1,19,20
63,8480035,Henri Jokiharju,D,BUF,25,63,0,20,20
63,8481624,Ilya Mikheyev,R,CHI,30,52,12,7,19
63,8479414,Nathan Bastian,R,NJD,27,65,11,8,19
63,8473533,Jordan Staal,C,CAR,36,63,11,8,19
63,8482705,Cole Sillinger,C,CBJ,21,65,10,9,19
63,8479619,Michael Carcone,L,UTA,28,62,10,9,19
63,8476457,Adam Larsson,D,SEA,32,70,6,13,19
63,8479066,Ryan Lomberg,L,CGY,30,64,6,13,19
63,8482117,Lukas Reichel,L,CHI,22,58,5,14,19
63,8477435,Ryan Graves,D,PIT,29,77,5,14,19
63,8476856,Mathew Dumba,D,DAL,30,75,5,14,19
63,8481441,Joe Snively,C,DET,28,64,4,15,19
63,8479982,Conor Timmins,D,TOR,26,53,4,15,19
63,8478443,Brandon Carlo,D,BOS,28,63,4,15,19
63,8480873,Rasmus Sandin,D,WSH,24,65,2,17,19
63,8479998,Mikey Anderson,D,LAK,25,59,2,17,19
63,8479368,Max Jones,L,BOS,26,65,12,6,18
63,8477406,Mattias Janmark,C,EDM,32,69,9,9,18
63,8482737,Zack Bolduc,C,STL,21,63,9,9,18
63,8475220,Marcus Foligno,L,MIN,33,57,9,9,18
63,8476278,Colin Blackwell,C,DAL,31,76,8,10,18
63,8480848,Ty Dellandrea,C,SJS,24,41,8,10,18
63,8475718,Justin Holl,D,DET,32,67,7,11,18
63,8483445,Cutter Gauthier,L,ANA,20,67,6,12,18
63,8477573,Nathan Walker,L,STL,30,55,5,13,18
63,8479976,Juuso Valimaki,D,UTA,26,67,4,14,18
63,8481537,Nikita Okhotiuk,D,CGY,24,54,4,14,18
63,8477506,Ryan Pulock,D,NYI,30,79,3,15,18
63,8479980,Nicolas Hague,D,VGK,26,53,3,15,18
63,8479402,Jake Bean,D,CGY,26,64,2,16,18
63,8480796,Martin Fehervary,D,WSH,25,53,2,16,18
63,8475324,Nick Jensen,D,OTT,34,64,1,17,18
63,8476967,Brett Kulak,D,EDM,30,59,1,17,18
63,8483524,Shane Wright,C,SEA,20,60,11,6,17
63,8482157,Will Cuylle,L,NYR,22,60,10,7,17
63,8480448,Parker Kelly,L,COL,25,74,9,8,17
63,8476897,Oskar Sundqvist,C,STL,30,55,8,9,17
63,8478585,Derek Ryan,C,EDM,38,61,7,10,17
63,8475343,Nic Dowd,C,WSH,34,53,6,11,17
63,8483499,Liam Ohgren,L,MIN,20,52,5,12,17
63,8479026,Philippe Myers,D,TOR,27,51,5,12,17
63,8479986,Kole Lind,R,DAL,26,45,5,12,17
63,8476891,Matthew Grzelcyk,D,PIT,30,72,3,14,17
63,8475188,Brayden McNabb,D,VGK,33,57,2,15,17
63,8478859,Niko Mikkola,D,FLA,28,66,2,15,17
63,8478136,Jake Middleton,D,MIN,28,73,2,15,17
63,8480070,Ian Mitchell,D,BOS,25,48,1,16,17
63,8475842,Sam Carrick,C,NYR,32,67,11,5,16
63,8482077,Dylan Holloway,L,EDM,23,55,9,7,16
63,8481013,Jonatan Berggren,R,DET,24,57,8,8,16
63,8480355,Mark Kastelic,C,BOS,25,56,7,9,16
63,8477507,Nikita Zadorov,D,BOS,29,63,6,10,16
63,8479324,Ryan Lindgren,D,NYR,26,55,6,10,16
63,8476873,Mark Jankowski,C,NSH,30,55,5,11,16
63,8476429,Scott Mayfield,D,NYI,32,73,5,11,16
63,8474034,Patrick Maroon,L,CHI,36,43,5,11,16
63,8482624,Daniil Miromanov,D,CGY,27,67,4,12,16
63,8482192,Isaak Phillips,D,CHI,23,48,4,12,16
63,8480806,Isac Lundestrom,C,ANA,25,58,3,13,16
63,8480807,Mattias Samuelsson,D,BUF,24,59,3,13,16
63,8480001,Urho Vaakanainen,D,ANA,25,61,3,13,16
63,8479249,Andrew Poturalski,C,SJS,30,38,0,16,16
63,8481477,Nico Sturm,C,SJS,29,54,10,5,15
63,8478432,Christian Fischer,R,DET,27,73,9,6,15
63,8482762,Simon Edvinsson,D,DET,21,53,9,6,15
63,8479520,Brandon Duhaime,R,WSH,27,60,7,8,15
63,8480281,Alexey Toropchenko,R,STL,25,63,7,8,15
63,8480025,MacKenzie Entwistle,R,FLA,25,65,6,9,15
63,8481598,Philip Broberg,D,EDM,23,44,6,9,15
63,8477018,Ben Hutton,D,VGK,31,48,6,9,15
63,8482660,Kent Johnson,C,CBJ,22,59,5,10,15
63,8481032,Paul Cotter,C,NJD,25,57,5,10,15
63,8476960,Andreas Athanasiou,C,CHI,30,55,5,10,15
63,8479371,Dante Fabbro,D,NSH,26,65,5,10,15
63,8479439,Jacob MacDonald,D,COL,31,46,5,10,15
63,8479344,Jesse Puljujarvi,R,PIT,26,45,4,11,15
63,8482176,Wyatt Kaiser,D,CHI,22,52,4,11,15
63,8481527,Kaedan Korczak,D,VGK,23,52,4,11,15
63,8479369,Andrew Peeke,D,BOS,26,57,3,12,15
63,8471709,Marc-Edouard Vlasic,D,SJS,37,64,3,12,15
63,8481708,Zac Jones,D,NYR,24,52,3,12,15
63,8477499,Rasmus Ristolainen,D,PHI,30,57,2,13,15
63,8481521,Ronnie Attard,D,PHI,25,56,2,13,15
63,8480727,Zach Whitecloud,D,VGK,28,48,2,13,15
63,8476331,Dylan DeMelo,D,WPG,31,70,1,14,15
63,8475179,Dmitry Kulikov,D,FLA,34,65,1,14,15
63,8475462,Radko Gudas,D,ANA,34,68,1,14,15
63,8475690,Chris Tanev,D,TOR,35,59,0,15,15
63,8477446,Michael McCarron,R,NSH,29,56,10,4,14
63,8483482,Tristan Luneau,D,ANA,20,58,9,5,14
63,8476374,Sean Kuraly,C,CBJ,31,60,9,5,14
63,8481641,Joel Kiviranta,L,COL,28,72,7,7,14
63,8476889,Radek Faksa,C,STL,30,56,7,7,14
63,8480762,Eric Robinson,L,CAR,29,53,7,7,14
63,8483495,Simon Nemec,D,NJD,20,52,7,7,14
63,8480172,Jan Rutta,D,SJS,34,57,7,7,14
63,8481517,Brett Leason,R,ANA,25,58,7,7,14
63,8480980,Connor Dewar,C,TOR,25,65,6,8,14
63,8482062,Cole Smith,L,NSH,29,60,5,9,14
63,8477979,Nicolas Aube-Kubel,R,BUF,28,56,5,9,14
63,8481059,Scott Perunovich,D,STL,26,62,5,9,14
63,8480289,Morgan Barron,C,WPG,26,61,5,9,14
63,8480880,Jakub Lauko,C,MIN,24,38,5,9,14
63,8479291,Kevin Rooney,C,CGY,31,58,4,10,14
63,8477070,Liam O'Brien,C,UTA,30,57,4,10,14
63,8477845,Trevor van Riemsdyk,D,WSH,33,64,3,11,14
63,8481167,Brayden Pachal,D,CGY,25,51,2,12,14
63,8475790,Erik Gudbranson,D,CBJ,32,76,0,14,14
63,8475225,Craig Smith,C,CHI,35,48,11,2,13
63,8482807,Ethan Del Mastro,D,CHI,21,42,9,4,13
63,8476918,Jimmy Vesey,L,NYR,31,59,7,6,13
63,8480074,Alexandre Texier,C,STL,25,49,6,7,13
63,8476480,Vladislav Namestnikov,C,WPG,32,66,6,7,13
63,8484149,Gavin Brindley,C,CBJ,20,52,6,7,13
63,8479968,Vinni Lettieri,C,BOS,29,54,6,7,13
63,8477931,Tomas Nosek,L,FLA,32,62,5,8,13
63,8478468,Jeremy Lauzon,D,NSH,27,50,4,9,13
63,8482744,James Malatesta,L,CBJ,21,44,4,9,13
63,8477369,Carson Soucy,D,VAN,30,62,3,10,13
63,8480887,Jordan Harris,D,MTL,24,58,3,10,13
63,8475455,Brenden Dillon,D,NJD,34,52,1,12,13
63,8482659,Josh Doan,R,UTA,22,54,9,3,12
63,8473453,Trevor Lewis,C,LAK,37,71,7,5,12
63,8481716,Dmitri Voronkov,L,CBJ,24,57,7,5,12
63,8482155,Alex Laferriere,R,LAK,23,64,7,5,12
63,8483630,Pavol Regenda,L,ANA,25,29,7,5,12
63,8476442,Matt Nieto,L,PIT,32,57,5,7,12
63,8481019,David Gustafsson,C,WPG,24,49,4,8,12
63,8482784,Zach Dean,C,STL,21,44,4,8,12
63,8478452,Caleb Jones,D,LAK,27,54,3,9,12
63,8482073,Braden Schneider,D,NYR,23,69,3,9,12
63,8479442,Troy Stecher,D,EDM,30,52,3,9,12
63,8474612,Travis Hamonic,D,OTT,34,52,3,9,12
63,8476372,Nick Seeler,D,PHI,31,50,2,10,12
63,8480222,Sebastian Aho,D,PIT,28,69,1,11,12
63,8481567,Henry Thrun,D,SJS,23,42,1,11,12
63,8470600,Ryan Suter,D,STL,39,68,1,11,12
63,8475208,Brian Dumoulin,D,ANA,33,61,0,12,12
63,8482730,Brandt Clarke,D,LAK,21,51,0,12,12
63,8481599,Victor Soderstrom,D,UTA,23,42,0,12,12
63,8475235,Nicolas Deslauriers,L,PHI,33,54,8,3,11
63,8479359,Beck Malenstyn,L,BUF,26,49,6,5,11
63,8479718,Alex Barré-Boulet,C,MTL,27,50,6,5,11
63,8482652,Walker Duehr,R,CGY,27,41,6,5,11
63,8477887,Patrick Brown,C,BOS,32,47,6,5,11
63,8480007,Jonas Rondbjerg,R,VGK,25,33,6,5,11
63,8478434,Keegan Kolesar,R,VGK,27,60,5,6,11
63,8475958,Michael Sgarbossa,C,WSH,32,31,5,6,11
63,8476867,Brendan Gaunce,C,MIN,30,37,5,6,11
63,8477034,Jaycob Megna,D,FLA,32,47,4,7,11
63,8480157,Calle Rosen,D,COL,30,44,4,7,11
63,8477962,Brendan Lemieux,L,CAR,28,42,4,7,11
63,8479372,Joshua Mahura,D,SEA,26,58,3,8,11
63,8480192,Johnathan Kovacevic,D,NJD,27,49,3,8,11
63,8482511,Mason Lohrei,D,BOS,23,36,3,8,11
63,8479379,Givani Smith,R,SJS,26,33,2,9,11
63,8483619,Filip Roos,D,OTT,25,33,2,9,11
63,8476874,Olli Maatta,D,DET,30,61,0,11,11
63,8481751,Lukas Rousek,R,BUF,25,42,8,2,10
63,8481617,Vasily Podkolzin,R,VAN,23,53,7,3,10
63,8479944,Zach Aston-Reese,C,VGK,30,46,6,4,10
63,8478569,Noel Acciari,C,PIT,33,56,5,5,10
63,8478211,Dryden Hunt,L,CGY,29,51,5,5,10
63,8477938,Haydn Fleury,D,WPG,28,43,5,5,10
63,8481161,Jake Christiansen,D,CBJ,25,50,5,5,10
63,8481679,Maxence Guenette,D,OTT,23,35,5,5,10
63,8477365,Connor Clifton,D,BUF,29,53,4,6,10
63,8482070,Mitchell Chaffee,R,TBL,26,46,4,6,10
63,8474013,Ian Cole,D,UTA,35,55,4,6,10
63,8480252,Cole Guttman,C,CHI,25,38,4,6,10
63,8483763,Maksymilian Szuber,D,UTA,22,34,4,6,10
63,8483466,Kevin Korchinski,D,CHI,20,46,3,7,10
63,8481568,Alex Vlasic,D,CHI,23,56,2,8,10
63,8480845,Rasmus Kupari,C,WPG,24,42,2,8,10
63,8475177,Calvin de Haan,D,COL,33,53,2,8,10
63,8481550,Adam Beckman,L,NJD,23,38,2,8,10
63,8478017,Mark Friedman,D,VAN,29,46,2,8,10
63,8475750,Jon Merrill,D,MIN,32,59,1,9,10
63,8478831,Kevin Stenlund,C,UTA,28,50,7,2,9
63,8481592,Jakob Pelletier,L,CGY,23,37,5,4,9
63,8482634,Alex Steeves,C,TOR,25,48,5,4,9
63,8477380,Jonny Brodzinski,C,NYR,31,49,5,4,9
63,8482153,Brendan Brisson,C,VGK,23,29,4,5,9
63,8481518,Nolan Foote,L,NJD,24,41,4,5,9
63,8482166,Shakir Mukhamadullin,D,SJS,22,51,4,5,9
63,8480011,Klim Kostin,C,SJS,25,41,4,5,9
63,8482733,Logan Mailloux,D,MTL,31,28,4,5,9
63,8483397,Marc McLaughlin,C,BOS,25,33,4,5,9
63,8479536,Axel Jonsson-Fjallby,L,WPG,26,33,4,5,9
63,8478421,A.J. Greer,L,FLA,28,55,3,6,9
63,8477384,Joshua Brown,D,EDM,30,35,2,7,9
63,8476473,Connor Murphy,D,CHI,31,43,1,8,9
63,8483460,David Jiricek,D,CBJ,21,58,1,8,9
63,8482747,Brennan Othmann,L,NYR,21,44,1,8,9
63,8473446,Erik Johnson,D,PHI,36,45,1,8,9
63,8479972,Mason Shaw,C,WPG,26,32,6,2,8
63,8476822,Luke Glendening,C,TBL,35,78,5,3,8
63,8476858,Phillip Di Giuseppe,L,VAN,31,34,4,4,8
63,8479991,Jake Leschyshyn,C,NYR,25,26,4,4,8
63,8482177,Marat Khusnutdinov,C,MIN,22,35,4,4,8
63,8482964,Arber Xhekaj,D,MTL,23,46,3,5,8
63,8482496,Nils Aman,C,VAN,24,41,3,5,8
63,8481754,Nikita Nesterenko,C,ANA,23,41,3,5,8
63,8480950,Ilya Lyubushkin,D,DAL,30,56,2,6,8
63,8478424,Jansen Harkins,C,ANA,27,42,2,6,8
63,8482859,Zack Ostapchuk,C,OTT,21,55,2,6,8
63,8482765,Isak Rosen,R,BUF,21,24,2,6,8
63,8484254,Akito Hirose,D,VAN,25,43,2,6,8
63,8482144,Jack Thompson,D,SJS,22,32,2,6,8
63,8478454,Noah Juulsen,D,VAN,27,39,1,7,8
63,8480879,Jacob Bernard-Docker,D,OTT,24,44,1,7,8
63,8474090,Brendan Smith,D,DAL,35,57,1,7,8
63,8481600,Tobias Bjornfot,D,FLA,23,34,1,7,8
63,8476952,Dominic Toninato,C,WPG,30,31,0,8,8
63,8482861,Vincent Iorio,D,WSH,22,24,0,8,8
63,8478409,Anthony Richard,C,PHI,28,31,7,0,7
63,8481532,Alex Turcotte,C,LAK,23,48,5,2,7
63,8481789,Tye Kartye,L,SEA,23,35,5,2,7
63,8476934,Brock McGinn,L,ANA,30,51,4,3,7
63,8478451,Ethan Bear,D,WSH,27,47,4,3,7
63,8483012,Logan Morrison,C,SEA,22,32,4,3,7
63,8479543,Michael Pezzetta,L,MTL,26,60,3,4,7
63,8479772,Zack MacEwen,R,OTT,28,47,3,4,7
63,8474568,Luke Schenn,D,NSH,35,45,3,4,7
63,8484911,Collin Graf,R,SJS,22,41,3,4,7
63,8480990,Declan Chisholm,D,MIN,24,44,3,4,7
63,8477482,Zachary Sanford,L,CHI,30,35,3,4,7
63,8478146,Matthew Highmore,C,OTT,28,31,3,4,7
63,8477462,Robert Hagg,D,VGK,29,27,3,4,7
63,8481028,Martin Pospisil,C,CGY,25,43,2,5,7
63,8481541,Samuel Bolduc,D,NYI,24,28,2,5,7
63,8481122,Simon Benoit,D,TOR,26,46,2,5,7
63,8478021,William Lagesson,D,DET,28,34,2,5,7
63,8475762,Derek Forbort,D,VAN,32,38,2,5,7
63,8482095,Tyler Kleven,D,OTT,22,45,2,5,7
63,8480196,Jacob Bryson,D,BUF,27,44,1,6,7
63,8474567,Zach Bogosian,D,MIN,34,54,1,6,7
63,8474166,Alec Martinez,D,CHI,37,52,1,6,7
63,8478450,Parker Wotherspoon,D,BOS,27,35,0,7,7
63,8484287,Cole McWard,D,VAN,23,24,5,1,6
63,8479671,Mathieu Olivier,R,CBJ,27,48,3,3,6
63,8482145,Mavrik Bourque,C,DAL,22,54,3,3,6
63,8477473,Justin Bailey,R,SJS,29,20,3,3,6
63,8481147,Reese Johnson,C,MIN,26,44,2,4,6
63,8477401,John Hayden,C,SEA,29,30,2,4,6
63,8480441,Trey Fix-Wolansky,R,CBJ,25,37,2,4,6
63,8471817,Ryan Reaves,R,TOR,37,59,2,4,6
63,8482666,Scott Morrow,D,CAR,22,49,2,4,6
63,8484258,Sam Malinski,D,COL,26,24,2,4,6
63,8479378,Logan Stanley,D,WPG,26,45,1,5,6
63,8479576,Vincent Desharnais,D,VAN,28,31,1,5,6
63,8476913,Devin Shore,C,MIN,30,31,1,5,6
63,8471677,Jack Johnson,D,CBJ,37,66,1,5,6
63,8482929,Emil Lilleberg,D,TBL,23,24,0,6,6
63,8480292,Carson Meyer,R,ANA,27,33,3,2,5
63,8481556,John Beecher,C,BOS,23,33,3,2,5
63,8483549,Lucas Condotta,L,MTL,27,31,3,2,5
63,8482147,Jean-Luc Foudy,C,COL,22,24,3,2,5
63,8477851,Jordan Oesterle,D,BOS,32,38,3,2,5
63,8477335,Kyle Burroughs,D,LAK,29,44,2,3,5
63,8481585,Egor Afanasyev,L,SJS,23,18,2,3,5
63,8478011,Louie Belpedio,D,PHI,28,17,2,3,5
63,8481701,Santeri Hatakka,D,NJD,23,48,1,4,5
63,8482858,Ryker Evans,D,SEA,23,25,1,4,5
63,8481609,Vladislav Kolyachonok,D,UTA,23,32,1,4,5
63,8474062,Riley Nash,C,NYR,35,23,1,4,5
63,8479348,Kale Clague,D,BUF,26,41,0,5,5
63,8480860,Kevin Bahl,D,CGY,24,59,0,5,5
63,8479419,Brett Murray,L,BUF,26,19,0,5,5
63,8475795,Dylan McIlrath,D,WSH,32,13,0,5,5
63,8482751,Ryan Winterton,C,SEA,21,40,4,0,4
63,8479638,Justin Brazeau,R,BOS,26,32,4,0,4
63,8481743,Marc Del Gaizo,D,NSH,25,33,3,1,4
63,8483512,Matthew Savoie,C,EDM,20,20,3,1,4
63,8480844,Grigori Denisenko,L,VGK,24,37,2,2,4
63,8483570,Ben Meyers,C,SEA,26,31,2,2,4
63,8482162,Roby Jarventie,L,EDM,22,13,2,2,4
63,8480834,Ty Emberson,D,SJS,24,33,1,3,4
63,8480245,Olle Lycksell,R,PHI,25,32,1,3,4
63,8481543,Nikita Alexandrov,C,STL,24,29,1,3,4
63,8477527,Ross Johnston,L,ANA,30,29,1,3,4
63,8481056,Spencer Stastney,D,NSH,24,30,0,4,4
63,8479320,Maxime Lajoie,D,SEA,27,15,0,4,4
63,8475413,Justin Dowling,C,NJD,34,9,3,0,3
63,8479985,Cale Fleury,D,SEA,26,27,2,1,3
63,8480468,James Hamblin,L,EDM,25,23,2,1,3
63,8480075,Cameron Crotty,D,MIN,25,12,2,1,3
63,8479367,William Lockwood,R,FLA,26,23,2,1,3
63,8478051,Max Willman,C,NJD,29,13,2,1,3
63,8481422,Jake Lucchini,C,NSH,29,23,2,1,3
63,8481024,Linus Karlsson,C,VAN,25,11,2,1,3
63,8483546,Marshall Rifai,D,TOR,26,8,2,1,3
63,8483489,Fraser Minten,C,TOR,31,15,2,1,3
63,8478874,Adam Gaudette,R,OTT,28,38,1,2,3
63,8479981,Jonah Gadjovich,L,FLA,26,38,1,2,3
63,8476441,Joel Edmundson,D,LAK,31,42,1,2,3
63,8481564,Ryan Johnson,D,BUF,23,14,1,2,3
63,8477244,Chad Ruhwedel,D,NYR,34,31,0,3,3
63,8478502,Dennis Gilbert,D,BUF,28,20,0,3,3
63,8481593,Jayden Struble,D,MTL,23,20,0,3,3
63,8482201,Gage Goncalves,C,TBL,23,21,0,3,3
63,8479994,Jaret Anderson-Dolan,C,WPG,25,30,2,0,2
63,8477320,Anton Blidh,L,NYR,29,24,2,0,2
63,8482102,Vasily Ponomarev,C,PIT,22,18,2,0,2
63,8478881,Brett Seney,L,CHI,28,16,2,0,2
63,8475755,Alexander Petrovic,D,DAL,32,13,2,0,2
63,8482088,Justin Sourdif,R,FLA,22,27,2,0,2
63,8482165,Yan Kuznetsov,D,CGY,22,13,2,0,2
63,8479330,Brandon Gignac,C,MTL,27,8,2,0,2
63,8481605,Jackson LaCombe,D,ANA,23,25,1,1,2
63,8482713,Mackie Samoskevich,R,FLA,22,33,1,1,2
63,8481719,Maxwell Crozier,D,TBL,24,18,1,1,2
63,8480870,Bo Groulx,C,NYR,24,25,1,1,2
63,8478477,Mitchell Stephens,C,SEA,27,13,1,1,2
63,8479362,Riley Tufte,L,BOS,26,16,1,1,2
63,8482141,Lukas Cormier,D,VGK,22,18,1,1,2
63,8479587,Rhett Gardner,C,PHI,28,17,1,1,2
63,8477073,Kurtis MacDermid,L,NJD,30,27,1,1,2
63,8483407,Brandon Scanlin,D,NYR,25,10,1,1,2
63,8481065,Angus Crookshank,L,OTT,25,18,1,1,2
63,8477467,Gustav Olofsson,D,SEA,30,20,0,2,2
63,8477971,Andreas Englund,D,LAK,28,22,0,2,2
63,8480267,Sammy Walker,C,MIN,25,15,0,2,2
63,8477810,Joel Hanley,D,CGY,33,23,0,2,2
63,8482250,Callahan Burke,C,VGK,27,22,0,2,2
63,8482516,Matthew Kessel,D,STL,24,18,0,2,2
63,8479421,Jacob Moverare,D,LAK,26,8,0,2,2
63,8481237,Kyle MacLean,C,NYI,25,26,0,2,2
63,8477993,Justin Kirkland,C,CGY,28,6,0,2,2
63,8483471,Brad Lambert,C,WPG,31,12,1,0,1
63,8484325,Waltteri Merela,C,TBL,26,22,1,0,1
63,8475780,Chris Wagner,R,COL,33,8,1,0,1
63,8478446,Glenn Gawdin,C,LAK,27,9,1,0,1
63,8480032,Shane Bowers,C,NJD,25,16,1,0,1
63,8480306,Grant Hutton,D,NYI,29,6,1,0,1
63,8482460,Matt Rempe,C,NYR,22,7,1,0,1
63,8483567,Georgii Merkulov,C,BOS,24,10,1,0,1
63,8482172,Landon Slaggert,L,CHI,22,27,0,1,1
63,8480823,Alexander Alexeyev,D,WSH,25,13,0,1,1
63,8480890,Jan Jenik,C,OTT,24,21,0,1,1
63,8481043,Cole Koepke,L,BOS,26,14,0,1,1
63,8481206,John Ludvig,D,PIT,24,11,0,1,1
63,8481806,Louis Crevier,D,CHI,23,16,0,1,1
63,8481030,Jack St. Ivany,D,PIT,25,21,0,1,1
63,8477149,Scott Sabourin,R,SJS,32,16,0,1,1
63,8480851,Akil Thomas,C,LAK,24,15,0,1,1
63,8483395,Arshdeep Bains,L,VAN,23,3,0,1,1
63,8483398,Declan Carlile,D,TBL,31,9,0,1,1
63,8481699,Aku Raty,R,UTA,23,11,0,0,0
63,8477541,Dakota Mermis,D,TOR,30,6,0,0,0
63,8482094,Daemon Hunt,D,MIN,22,17,0,0,0
63,8481006,Tyler Tucker,D,STL,24,12,0,0,0
63,8484304,Uvis Balinskis,D,FLA,28,10,0,0,0
63,8481462,Mason Morelli,L,VGK,28,14,0,0,0
63,8482787,Nikita Chibrikov,R,WPG,31,9,0,0,0
63,8482061,Brandon Biro,L,SEA,26,8,0,0,0
63,8478147,Bokondji Imama,L,PIT,28,4,0,0,0
63,8481578,Graeme Clarke,R,MIN,23,2,0,0,0
63,8482118,Sam Colangelo,R,ANA,23,15,0,0,0
63,8483597,Milos Kelemen,L,UTA,25,10,0,0,0
63,8482126,Emil Andrae,D,PHI,31,3,0,0,0
63,8480084,Nick DeSimone,D,NJD,30,18,0,0,0
63,8482470,Ilya Solovyov,D,CGY,24,17,0,0,0
63,8483609,Adam Klapka,R,CGY,24,1,0,0,0
63,8476323,Max McCormick,L,SEA,32,2,0,0,0
63,8480874,Adam Ginning,D,PHI,24,8,0,0,0
63,8482476,Emil Heineman,L,MTL,23,6,0,0,0
63,8483920,Pierrick Dube,R,WSH,23,7,0,0,0
63,8483432,Luca Del Bel Belluz,C,CBJ,31,4,0,0,0
63,8481726,Adam Edstrom,C,NYR,24,2,0,0,0
63,8484259,Ondrej Pavel,C,COL,31,3,0,0,0
63,8478854,Ryan Shea,D,PIT,27,10,0,0,0
63,8481655,Cole Schwindt,R,CGY,23,5,0,0,0
63,8482197,Adam Raska,R,MIN,23,5,0,0,0
63,8479522,Hardy Haman Aktell,D,WSH,26,5,0,0,0
63,8481534,Raphael Lavoie,C,EDM,24,1,0,0,0
63,8484321,Nikolas Matinpalo,D,OTT,26,2,0,0,0
63,8484255,Jason Polin,R,COL,25,9,0,0,0
63,8484326,Patrik Koch,D,UTA,28,4,0,0,0
63,8483531,Brian Halonen,L,NJD,25,6,0,0,0
63,8483401,Marc Johnstone,R,PIT,28,1,0,0,0
63,8480274,Philip Kemp,D,EDM,25,3,0,0,0
63,8470794,Joe Pavelski,C,,40,0,0,0,0
63,8479321,Lucas Johansen,D,,27,0,0,0,0
63,8477950,Tony DeAngelo,D,,29,0,0,0,0
63,8471218,Blake Wheeler,R,,38,0,0,0,0
63,8475197,Tyson Barrie,D,,33,0,0,0,0
63,8474157,Max Pacioretty,L,,36,0,0,0,0
63,8475744,Evgeny Kuznetsov,C,,32,0,0,0,0
63,8474037,James van Riemsdyk,L,,35,0,0,0,0
63,8476907,Mackenzie MacEachern,L,,30,0,0,0,0
63,8480216,Jacob Peterson,C,,25,0,0,0,0
63,8474602,Justin Schultz,D,,34,0,0,0,0
63,8482222,Alexander Barabanov,L,,30,0,0,0,0
63,8474031,Kevin Shattenkirk,D,,35,0,0,0,0
63,8477330,Dominik Kubalik,L,,29,0,0,0,0
63,8480884,Calen Addison,D,,24,0,0,0,0
63,8475906,John Klingberg,D,,32,0,0,0,0
63,8480008,Adam Ruzicka,C,,25,0,0,0,0
63,8476884,Derrick Pouliot,D,,30,0,0,0,0
63,8476919,Chris Tierney,C,,30,0,0,0,0
63,8479415,Michael McLeod,C,,26,0,0,0,0
63,8474870,Tyler Johnson,C,,34,0,0,0,0
63,8470604,Jeff Carter,C,,39,0,0,0,0
63,8478104,Sammy Blais,L,,28,0,0,0,0
63,8474884,Mike Hoffman,C,,35,0,0,0,0
63,8481591,Sam Poulin,R,,23,0,0,0,0
63,8471274,Alex Goligoski,D,,39,0,0,0,0
63,8476871,Tanner Pearson,L,,32,0,0,0,0
63,8476393,Nick Cousins,C,,31,0,0,0,0
63,8479977,Kailer Yamamoto,R,,26,0,0,0,0
63,8479346,Dillon Dube,C,,26,0,0,0,0
63,8480184,Gustav Lindstrom,D,,26,0,0,0,0
63,8479376,Victor Mete,D,,26,0,0,0,0
63,8473449,Kyle Okposo,R,,36,0,0,0,0
63,8481058,Jesse Ylonen,R,,25,0,0,0,0
63,8475752,Tyler Pitlick,C,,33,0,0,0,0
63,8481239,Samuel Fagemo,L,,24,0,0,0,0
63,8480821,Filip Zadina,R,,25,0,0,0,0
63,8470966,Mark Giordano,D,,41,0,0,0,0
63,8478495,Denis Gurianov,R,,27,0,0,0,0
63,8477464,Nic Petan,C,,29,0,0,0,0
63,8478099,Kevin Labanc,R,,29,0,0,0,0
63,8482241,Radim Zohorna,L,,28,0,0,0,0
63,8474040,Sam Gagner,C,,35,0,0,0,0
63,8479514,Rem Pitlick,C,,27,0,0,0,0
63,8478430,Oliver Kylington,D,,27,0,0,0,0
63,8479533,Joona Koppanen,L,,26,0,0,0,0
63,8479984,Cal Foote,D,,26,0,0,0,0
63,8477126,Jayson Megna,C,,34,0,0,0,0
63,8475164,Jakob Silfverberg,R,,34,0,0,0,0
63,8474009,Nick Bonino,C,,36,0,0,0,0
63,8479458,Nikita Zaitsev,D,,33,0,0,0,0
63,8477944,Jakub Vrana,L,,28,0,0,0,0
63,8471699,Andrew Cogliano,C,,37,0,0,0,0
63,8478067,Oskar Lindblom,L,,28,0,0,0,0
63,8471686,Marc Staal,D,,37,0,0,0,0
63,8470610,Zach Parise,L,,40,0,0,0,0
63,8478904,Steven Lorentz,C,,28,0,0,0,0
63,8473473,Milan Lucic,L,,36,0,0,0,0
63,8480031,Maxime Comtois,L,,25,0,0,0,0
63,8478512,Austin Czarnik,C,,32,0,0,0,0
63,8473504,Cal Clutterbuck,R,,37,0,0,0,0
63,8477454,Adam Erne,L,,29,0,0,0,0
63,8479383,Boris Katchouk,L,,26,0,0,0,0
63,8475825,Jani Hakanpää,D,,32,0,0,0,0
63,8477846,Ryan Carpenter,C,,33,0,0,0,0
63,8477930,Pierre-Edouard Bellemare,L,,39,0,0,0,0
63,8478400,Colin White,C,,27,0,0,0,0
63,8480226,Marián Studenic,R,,26,0,0,0,0
63,8480853,Liam Foudy,C,,24,0,0,0,0
63,8475797,Jarred Tinordi,D,,32,0,0,0,0
63,8479423,Alex Nylander,L,,26,0,0,0,0
63,8474618,Marco Scandella,D,,34,0,0,0,0
63,8478028,Fredrik Olofsson,L,,28,0,0,0,0
63,8474709,Matt Martin,L,,35,0,0,0,0
63,8481070,Hugh McGing,L,,26,0,0,0,0
63,8479546,Oskar Steen,C,,26,0,0,0,0
63,8474145,Robert Bortuzzo,D,,35,0,0,0,0
63,8476915,Jujhar Khaira,L,,30,0,0,0,0
63,8475278,Byron Froese,C,,33,0,0,0,0
63,8481812,Nikolai Knyzhov,D,,27,0,0,0,0
63,8478408,Travis Dermott,D,,28,0,0,0,0
63,8481077,John Leonard,L,,26,0,0,0,0
63,8479547,Matthew Phillips,R,,26,0,0,0,0
63,8480836,Jonathan Gruden,C,,24,0,0,0,0
63,8481690,Tyler Angle,C,,24,0,0,0,0
63,8475766,Austin Watson,L,,32,0,0,0,0
63,8481016,Ruslan Iskhakov,C,,24,0,0,0,0
63,8478078,Rourke Chartier,C,,28,0,0,0,0
63,8480776,Sheldon Rempal,R,,29,0,0,0,0
63,8478956,Samuel Laberge,L,NJD,27,5,0,0,0
63,8483045,Cameron Butler,R,CBJ,31,0,0,0,0
63,8484314,Jiri Smejkal,L,,28,0,0,0,0
64,8478402,Connor McDavid,C,EDM,27,77,49,118,167
64,8477492,Nathan MacKinnon,C,COL,29,78,52,71,123
64,8476453,Nikita Kucherov,R,TBL,31,82,36,86,122
64,8477934,Leon Draisaitl,C,EDM,29,77,37,79,116
64,8479318,Auston Matthews,C,TOR,27,78,65,46,111
64,8476468,J.T. Miller,C,VAN,31,79,33,74,107
64,8477939,William Nylander,R,TOR,28,81,42,63,105
64,8481559,Jack Hughes,C,NJD,23,73,41,63,104
64,8477409,Carter Verhaeghe,C,FLA,29,76,52,49,101
64,8477956,David Pastrnak,R,BOS,28,81,47,54,101
64,8477493,Aleksander Barkov,C,FLA,29,80,35,66,101
64,8479314,Matthew Tkachuk,L,FLA,27,78,33,67,100
64,8479407,Jesper Bratt,L,NJD,26,78,38,60,98
64,8478550,Artemi Panarin,L,NYR,33,79,31,66,97
64,8478398,Kyle Connor,L,WPG,28,73,41,54,95
64,8477404,Jake Guentzel,C,TBL,30,82,38,57,95
64,8477942,Kevin Fiala,L,LAK,28,80,34,61,95
64,8478420,Mikko Rantanen,R,COL,28,80,36,58,94
64,8478864,Kirill Kaprizov,L,MIN,27,73,41,51,92
64,8476454,Ryan Nugent-Hopkins,C,EDM,31,76,25,67,92
64,8478445,Mathew Barzal,C,NYI,27,78,21,71,92
64,8477933,Sam Reinhart,C,FLA,29,79,37,54,91
64,8476887,Filip Forsberg,L,NSH,30,74,34,57,91
64,8480027,Jason Robertson,L,DAL,25,81,33,58,91
64,8475172,Nazem Kadri,C,CGY,34,80,31,60,91
64,8478483,Mitch Marner,R,TOR,27,79,23,68,91
64,8482078,Lucas Raymond,L,DET,22,81,38,52,90
64,8480002,Nico Hischier,C,NJD,25,78,32,58,90
64,8471675,Sidney Crosby,C,PIT,37,75,36,52,88
64,8484144,Connor Bedard,C,CHI,19,72,34,51,85
64,8475167,Victor Hedman,D,TBL,34,77,16,69,85
64,8475166,John Tavares,C,TOR,34,80,36,48,84
64,8474564,Steven Stamkos,C,NSH,34,74,31,53,84
64,8479323,Adam Fox,D,NYR,26,73,16,68,84
64,8480069,Cale Makar,D,COL,26,73,19,64,83
64,8473512,Claude Giroux,R,OTT,36,78,22,60,82
64,8476389,Vincent Trocheck,C,NYR,31,78,32,49,81
64,8482116,Tim Stützle,C,OTT,22,81,29,52,81
64,8471685,Anze Kopitar,C,LAK,37,80,24,57,81
64,8477501,Valeri Nichushkin,R,COL,29,82,37,43,80
64,8480800,Quinn Hughes,D,VAN,25,79,7,73,80
64,8479337,Alex DeBrincat,R,DET,27,80,38,41,79
64,8479542,Brandon Hagel,L,TBL,26,81,33,46,79
64,8480801,Brady Tkachuk,L,OTT,25,82,31,48,79
64,8478414,Timo Meier,R,NJD,28,75,31,48,79
64,8475913,Mark Stone,R,VGK,32,79,24,55,79
64,8480803,Evan Bouchard,D,EDM,25,75,14,65,79
64,8475810,Bryan Rust,R,PIT,32,72,41,37,78
64,8479420,Tage Thompson,C,BUF,27,73,39,39,78
64,8479343,Clayton Keller,R,UTA,26,79,37,41,78
64,8474600,Roman Josi,D,NSH,34,76,24,54,78
64,8473419,Brad Marchand,L,BOS,36,77,24,54,78
64,8480012,Elias Pettersson,C,VAN,26,71,31,45,76
64,8480036,Miro Heiskanen,D,DAL,25,78,12,64,76
64,8478449,Roope Hintz,C,DAL,28,80,43,32,75
64,8478427,Sebastian Aho,C,CAR,27,71,33,42,75
64,8477940,Nikolaj Ehlers,L,WPG,28,74,33,42,75
64,8474578,Erik Karlsson,D,PIT,34,78,19,56,75
64,8477951,Nick Schmaltz,C,UTA,28,78,15,60,75
64,8482684,Luke Hughes,D,NJD,21,73,12,63,75
64,8478403,Jack Eichel,C,VGK,28,80,34,40,74
64,8477946,Dylan Larkin,C,DET,28,79,27,47,74
64,8478010,Brayden Point,C,TBL,28,82,35,38,73
64,8481557,Matt Boldy,L,MIN,23,72,29,44,73
64,8476346,Johnny Gaudreau,L,CBJ,31,75,24,49,73
64,8476456,Jonathan Huberdeau,C,CGY,31,79,19,54,73
64,8478439,Travis Konecny,R,PHI,27,76,28,44,72
64,8477955,Jared McCann,L,SEA,28,78,35,36,71
64,8478047,Michael Bunting,L,PIT,29,71,31,40,71
64,8480208,Drake Batherson,R,OTT,26,75,30,41,71
64,8471215,Evgeni Malkin,C,PIT,38,72,24,47,71
64,8477402,Pavel Buchnevich,L,STL,29,72,23,48,71
64,8476460,Mark Scheifele,C,WPG,31,75,34,36,70
64,8480830,Andrei Svechnikov,R,CAR,24,71,27,43,70
64,8475765,Vladimir Tarasenko,R,DET,33,81,22,48,70
64,8480023,Robert Thomas,C,STL,25,73,17,53,70
64,8479385,Jordan Kyrou,C,STL,26,72,32,36,68
64,8475168,Matt Duchene,C,DAL,33,82,29,39,68
64,8474141,Patrick Kane,R,DET,36,81,23,45,68
64,8476881,Tomas Hertl,C,VGK,31,74,38,29,67
64,8477960,Adrian Kempe,R,LAK,28,79,30,37,67
64,8480039,Martin Necas,C,CAR,25,74,28,39,67
64,8477504,Josh Morrissey,D,WPG,29,77,11,56,67
64,8474679,Gustav Nyquist,C,NSH,35,70,21,45,66
64,8475169,Evander Kane,L,EDM,33,75,40,25,65
64,8477500,Bo Horvat,C,NYI,29,82,33,31,64
64,8478493,Joel Eriksson Ek,C,MIN,27,72,31,33,64
64,8475794,Tyler Seguin,C,DAL,32,81,31,33,64
64,8475158,Ryan O'Reilly,C,NSH,33,74,26,38,64
64,8476459,Mika Zibanejad,C,NYR,31,77,20,44,64
64,8478460,Zach Werenski,D,CBJ,27,79,19,45,64
64,8482093,Seth Jarvis,C,CAR,22,70,30,33,63
64,8471214,Alex Ovechkin,L,WSH,39,76,30,33,63
64,8477949,Alex Tuch,R,BUF,28,69,24,39,63
64,8480839,Rasmus Dahlin,D,BUF,24,70,18,45,63
64,8480865,Noah Dobson,D,NYI,24,81,13,50,63
64,8471724,Kris Letang,D,PIT,37,80,13,50,63
64,8476853,Morgan Rielly,D,TOR,30,72,9,54,63
64,8475786,Zach Hyman,L,EDM,32,76,36,26,62
64,8475754,Brock Nelson,C,NYI,33,79,36,26,62
64,8476539,Jonathan Marchessault,R,NSH,34,74,29,33,62
64,8478407,Vince Dunn,D,SEA,28,75,17,45,62
64,8478975,Mason Marchment,L,DAL,29,82,26,35,61
64,8482740,Wyatt Johnston,C,DAL,21,82,24,37,61
64,8476479,Phillip Danault,C,LAK,31,81,20,41,61
64,8475692,Mats Zuccarello,R,MIN,37,71,14,47,61
64,8478444,Brock Boeser,R,VAN,27,76,34,25,59
64,8475784,Jeff Skinner,C,EDM,32,75,28,31,59
64,8477496,Elias Lindholm,C,BOS,30,78,28,31,59
64,8480018,Nick Suzuki,C,MTL,25,78,25,34,59
64,8474586,Jordan Eberle,R,SEA,34,72,21,38,59
64,8476399,Blake Coleman,C,CGY,33,77,32,26,58
64,8481068,Yegor Sharangovich,C,CGY,26,78,30,28,58
64,8478440,Dylan Strome,C,WSH,27,69,20,38,58
64,8476448,William Karlsson,C,VGK,31,77,19,39,58
64,8477476,Artturi Lehkonen,L,COL,29,81,32,25,57
64,8474641,Adam Henrique,C,EDM,34,77,28,29,57
64,8481540,Cole Caufield,R,MTL,23,75,26,31,57
64,8478873,Troy Terry,R,ANA,27,72,25,32,57
64,8478401,Pavel Zacha,C,BOS,27,77,22,35,57
64,8477494,Jonathan Drouin,L,COL,29,80,22,35,57
64,8479999,Casey Mittelstadt,C,COL,26,82,21,36,57
64,8484153,Leo Carlsson,C,ANA,20,71,16,41,57
64,8479325,Charlie McAvoy,D,BOS,27,77,12,45,57
64,8480014,Gabriel Vilardi,C,WPG,25,74,28,28,56
64,8478498,Jake DeBrusk,L,VAN,28,74,25,31,56
64,8482665,Matty Beniers,C,SEA,22,73,22,34,56
64,8482745,Mason McTavish,C,ANA,21,67,20,36,56
64,8476826,Yanni Gourde,C,SEA,33,70,26,29,55
64,8475191,Reilly Smith,R,NYR,33,77,26,29,55
64,8478856,Conor Garland,R,VAN,28,68,25,30,55
64,8473994,Jamie Benn,L,DAL,35,81,20,35,55
64,8474563,Drew Doughty,D,LAK,35,74,16,39,55
64,8475798,Mikael Granlund,C,SJS,32,70,9,46,55
64,8482699,Dylan Guenther,R,UTA,21,73,29,25,54
64,8476872,Scott Laughton,C,PHI,30,72,25,29,54
64,8474150,Mikael Backlund,C,CGY,35,75,24,30,54
64,8473986,Alex Killorn,L,ANA,35,71,21,33,54
64,8477416,Oliver Bjorkstrand,R,SEA,29,74,19,35,54
64,8477495,Seth Jones,D,CHI,30,71,11,43,54
64,8479525,Ross Colton,C,COL,28,80,24,29,53
64,8480188,Fabian Zetterlund,L,SJS,25,69,23,30,53
64,8483431,Logan Cooley,C,UTA,20,75,21,32,53
64,8481577,Philip Tomasino,C,NSH,23,69,18,35,53
64,8477932,Aaron Ekblad,D,FLA,28,72,13,40,53
64,8478366,Frank Vatrano,R,ANA,30,72,34,18,52
64,8481711,Matias Maccelli,L,UTA,24,73,16,36,52
64,8481528,Dylan Cozens,C,BUF,23,65,21,30,51
64,8479339,Patrik Laine,L,CBJ,26,68,20,31,51
64,8482109,Alexis Lafrenière,L,NYR,23,75,34,16,50
64,8475726,Tyler Toffoli,C,SJS,32,71,25,25,50
64,8475314,Anders Lee,L,NYI,34,77,23,27,50
64,8474102,David Perron,L,OTT,36,77,17,33,50
64,8478462,Nicolas Roy,C,VGK,27,74,17,33,50
64,8481533,Trevor Zegras,C,ANA,23,68,15,35,50
64,8476462,Dougie Hamilton,D,NJD,31,74,12,38,50
64,8476905,Chandler Stephenson,C,SEA,30,74,11,39,50
64,8475184,Chris Kreider,L,NYR,33,74,28,21,49
64,8475170,Brayden Schenn,C,STL,33,76,26,23,49
64,8478519,Anthony Cirelli,C,TBL,27,82,24,25,49
64,8482702,Logan Stankoven,C,DAL,21,77,24,25,49
64,8475799,Nino Niederreiter,R,WPG,32,72,23,26,49
64,8477444,Andre Burakovsky,L,SEA,29,72,19,30,49
64,8479675,Trevor Moore,L,LAK,29,79,16,33,49
64,8480015,Owen Tippett,R,PHI,25,75,28,20,48
64,8477935,Sam Bennett,C,FLA,28,77,23,25,48
64,8480798,Philipp Kurashev,C,CHI,25,66,17,31,48
64,8477503,Max Domi,C,TOR,29,77,12,36,48
64,8478038,Devon Toews,D,COL,30,69,6,42,48
64,8478042,Viktor Arvidsson,L,EDM,31,74,23,24,47
64,8484166,Adam Fantilli,C,CBJ,20,69,20,27,47
64,8479400,Pierre-Luc Dubois,L,WSH,26,74,17,30,47
64,8478469,Thomas Chabot,D,OTT,27,75,11,36,47
64,8483808,Andrei Kuzmenko,L,CGY,28,72,22,24,46
64,8476882,Teuvo Teravainen,C,CHI,30,58,19,27,46
64,8483515,Juraj Slafkovsky,L,MTL,20,79,13,33,46
64,8479410,Mikhail Sergachev,D,UTA,26,71,10,36,46
64,8478115,Pierre Engvall,L,NYI,28,76,25,20,45
64,8475793,Ryan Johansen,C,PHI,32,71,24,21,45
64,8480064,Josh Norris,C,OTT,25,80,22,23,45
64,8471698,T.J. Oshie,R,WSH,38,69,21,24,45
64,8479992,Michael Rasmussen,C,DET,25,79,19,26,45
64,8477986,Brandon Montour,D,SEA,30,70,17,28,45
64,8482720,Matthew Knies,L,TOR,22,76,13,32,45
64,8478542,Evan Rodrigues,C,FLA,31,77,12,33,45
64,8475753,Justin Faulk,D,STL,32,73,12,33,45
64,8478397,Rasmus Andersson,D,CGY,28,68,11,34,45
64,8479365,Trent Frederic,C,BOS,26,78,26,18,44
64,8482113,Anton Lundell,C,FLA,23,79,23,21,44
64,8484145,Zach Benson,L,BUF,19,69,22,22,44
64,8477451,Ryan Hartman,R,MIN,30,66,21,23,44
64,8475151,Kyle Palmieri,C,NYI,33,79,15,29,44
64,8475745,Charlie Coyle,C,BOS,32,77,9,35,44
64,8475764,Cam Fowler,D,ANA,33,78,6,38,44
64,8481596,Shane Pinto,C,OTT,24,72,22,21,43
64,8481618,Alex Newhook,C,MTL,23,73,21,22,43
64,8478046,Danton Heinen,L,VAN,29,72,20,23,43
64,8481560,Arthur Kaliyev,R,LAK,23,75,20,23,43
64,8477407,Anthony Duclair,L,NYI,29,74,19,24,43
64,8479996,Cody Glass,C,NSH,25,63,19,24,43
64,8482175,JJ Peterka,R,BUF,22,65,17,26,43
64,8482124,Quinton Byfield,R,LAK,22,79,16,27,43
64,8482149,Cole Perfetti,C,WPG,22,67,16,27,43
64,8479345,Jakob Chychrun,D,WSH,26,66,14,29,43
64,8475218,Mattias Ekholm,D,EDM,34,73,13,30,43
64,8477346,MacKenzie Weegar,D,CGY,30,72,9,34,43
64,8476958,Jaccob Slavin,D,CAR,30,80,7,36,43
64,8477948,Travis Sanheim,D,PHI,28,75,7,36,43
64,8476438,Brandon Saad,L,STL,32,75,28,14,42
64,8482159,Tyson Foerster,R,PHI,22,75,21,21,42
64,8476458,Ryan Strome,C,ANA,31,68,19,23,42
64,8478458,John (Jack) Roslovic,C,CAR,27,69,17,25,42
64,8480028,Morgan Frost,C,PHI,25,75,15,27,42
64,8480797,Joel Farabee,L,PHI,24,79,10,32,42
64,8476432,Boone Jenner,C,CBJ,31,67,20,21,41
64,8478233,Andrew Mangiapane,L,WSH,28,72,18,23,41
64,8480009,Eeli Tolvanen,R,SEA,25,74,16,25,41
64,8476792,Torey Krug,D,STL,33,71,15,26,41
64,8481546,Cam York,D,PHI,23,74,12,29,41
64,8476483,Rickard Rakell,R,PIT,31,69,16,24,40
64,8482092,Ridly Greig,C,OTT,22,76,15,25,40
64,8473422,Nick Foligno,L,CHI,37,58,13,27,40
64,8476875,Mike Matheson,D,MTL,30,75,9,31,40
64,8481703,Valtteri Puustinen,R,PIT,25,61,9,31,40
64,8481582,Nicholas Robertson,L,TOR,23,67,21,18,39
64,8482110,Dawson Mercer,C,NJD,23,65,20,19,39
64,8475287,Erik Haula,L,NJD,33,72,19,20,39
64,8477953,Kasperi Kapanen,R,STL,28,74,19,20,39
64,8480185,Eetu Luostarinen,C,FLA,26,76,18,21,39
64,8476461,Sean Couturier,C,PHI,32,70,16,23,39
64,8477998,Warren Foegele,L,LAK,28,80,15,24,39
64,8476906,Shayne Gostisbehere,D,CAR,31,73,9,30,39
64,8477447,Shea Theodore,D,VGK,29,66,9,30,39
64,8477426,Nicholas Paul,L,TBL,29,81,21,17,38
64,8481186,Logan O'Connor,R,COL,28,80,21,17,38
64,8479987,Morgan Geekie,C,BOS,26,71,20,18,38
64,8477964,Ivan Barbashev,C,VGK,29,76,19,19,38
64,8477456,J.T. Compher,L,DET,29,78,15,23,38
64,8476869,Brady Skjei,D,NSH,30,69,14,24,38
64,8481553,Bobby Brink,R,PHI,23,65,13,25,38
64,8477506,Ryan Pulock,D,NYI,30,81,8,30,38
64,8474590,John Carlson,D,WSH,34,66,7,31,38
64,8480220,Noah Cates,L,PHI,25,73,19,18,37
64,8477947,Sonny Milano,L,WSH,28,66,16,21,37
64,8479591,Michael Eyssimont,C,TBL,28,81,14,23,37
64,8478438,Tommy Novak,C,NSH,27,65,12,25,37
64,8470613,Brent Burns,D,CAR,39,72,9,28,37
64,8476854,Hampus Lindholm,D,BOS,30,75,7,30,37
64,8477952,Robby Fabbri,C,ANA,28,66,21,15,36
64,8475722,Jason Zucker,L,BUF,32,65,16,20,36
64,8476474,Stefan Noesen,R,NJD,31,66,15,21,36
64,8475768,Jaden Schwartz,C,SEA,32,68,13,23,36
64,8473533,Jordan Staal,C,CAR,36,62,13,23,36
64,8477497,Sean Monahan,C,CBJ,30,62,12,24,36
64,8476292,Ondrej Palat,L,NJD,33,69,12,24,36
64,8481554,Kaapo Kakko,R,NYR,23,70,12,24,36
64,8478472,Mathieu Joseph,R,STL,27,67,11,25,36
64,8474053,Logan Couture,C,SJS,35,61,11,25,36
64,8483505,Matthew Poitras,C,BOS,20,76,10,26,36
64,8477498,Darnell Nurse,D,EDM,29,72,9,27,36
64,8480849,Barrett Hayton,C,UTA,24,73,20,15,35
64,8481604,Pavel Dorofeyev,L,VGK,24,77,17,18,35
64,8480459,Pius Suter,C,VAN,28,66,15,20,35
64,8482097,Jack Quinn,R,BUF,23,62,14,21,35
64,8481524,Bowen Byram,D,BUF,23,66,14,21,35
64,8482667,William Eklund,L,SJS,22,65,13,22,35
64,8478055,Gustav Forsling,D,FLA,28,72,10,25,35
64,8480871,Adam Boqvist,D,FLA,24,72,7,28,35
64,8482660,Kent Johnson,C,CBJ,22,64,7,28,35
64,8479941,Justin Danforth,R,CBJ,31,60,25,9,34
64,8475760,Nick Bjugstad,C,UTA,32,73,20,14,34
64,8475193,Tomas Tatar,L,NJD,34,70,18,16,34
64,8482705,Cole Sillinger,C,CBJ,21,67,18,16,34
64,8479293,Brandon Tanev,L,SEA,33,63,16,18,34
64,8477479,Tyler Bertuzzi,L,CHI,29,65,15,19,34
64,8474149,Evgenii Dadonov,R,DAL,35,80,15,19,34
64,8476392,Adam Lowry,C,WPG,31,68,13,21,34
64,8480434,Sean Durzi,D,UTA,26,70,7,27,34
64,8475171,Oliver Ekman-Larsson,D,TOR,33,64,7,27,34
64,8476981,Josh Anderson,R,MTL,30,67,20,13,33
64,8479661,Tanner Jeannot,L,LAK,27,76,19,14,33
64,8474189,Lars Eller,C,PIT,35,70,14,19,33
64,8477450,Jason Dickinson,C,CHI,29,58,12,21,33
64,8479315,Joey Anderson,R,CHI,26,61,10,23,33
64,8482105,Jake Sanderson,D,OTT,22,74,9,24,33
64,8479425,Filip Hronek,D,VAN,27,71,8,25,33
64,8482671,Owen Power,D,BUF,22,66,6,27,33
64,8482146,Luke Evangelista,R,NSH,22,67,15,17,32
64,8482475,Yegor Chinakhov,R,CBJ,23,69,14,18,32
64,8476480,Vladislav Namestnikov,C,WPG,32,59,12,20,32
64,8474565,Alex Pietrangelo,D,VGK,34,59,9,23,32
64,8476885,Jacob Trouba,D,NYR,30,78,7,25,32
64,8479353,Brett Howden,C,VGK,26,63,7,25,32
64,8478020,Michael Amadio,R,OTT,28,72,19,12,31
64,8481704,Juuso Parssinen,C,NSH,23,60,15,16,31
64,8477987,Ryan Donato,C,CHI,28,64,15,16,31
64,8478057,Dakota Joshua,C,VAN,28,62,14,17,31
64,8478463,Anthony Beauvillier,L,PIT,27,64,14,17,31
64,8477507,Nikita Zadorov,D,BOS,29,66,13,18,31
64,8483468,Jiri Kulich,C,BUF,20,60,12,19,31
64,8476419,Jean-Gabriel Pageau,C,NYI,32,80,9,22,31
64,8478413,Jordan Greenway,L,BUF,27,65,9,22,31
64,8482122,Brock Faber,D,MIN,22,80,9,22,31
64,8476925,Colton Sissons,C,NSH,31,70,9,22,31
64,8478133,Jake Evans,C,MTL,28,73,7,24,31
64,8481542,Moritz Seider,D,DET,23,75,5,26,31
64,8476917,Adam Pelech,D,NYI,30,76,5,26,31
64,8482089,Jake Neighbours,L,STL,22,68,17,13,30
64,8482055,Drew O'Connor,L,PIT,26,68,15,15,30
64,8479368,Max Jones,L,BOS,26,74,15,15,30
64,8478474,Lawson Crouse,L,UTA,27,74,14,16,30
64,8480813,Joe Veleno,C,DET,24,79,13,17,30
64,8476278,Colin Blackwell,C,DAL,31,77,13,17,30
64,8484203,Bradly Nadeau,L,CAR,19,63,12,18,30
64,8475763,Kevin Hayes,R,PIT,32,69,12,18,30
64,8480078,Filip Chytil,C,NYR,25,65,12,18,30
64,8479390,Taylor Raddysh,R,WSH,26,65,11,19,30
64,8477021,Alex Kerfoot,C,UTA,30,69,10,20,30
64,8476921,Jordan Martinook,L,CAR,32,67,10,20,30
64,8476927,Teddy Blueger,C,VAN,30,65,9,21,30
64,8478396,Noah Hanifin,D,VGK,27,63,7,23,30
64,8475200,Dmitry Orlov,D,CAR,33,75,7,23,30
64,8481606,Jordan Spence,D,LAK,23,73,7,23,30
64,8477488,Brett Pesce,D,NJD,30,64,6,24,30
64,8474151,Ryan McDonagh,D,TBL,35,80,5,25,30
64,8482712,Oskar Olausson,R,COL,22,76,4,26,30
64,8476923,Damon Severson,D,CBJ,30,78,3,27,30
64,8481535,Nils Hoglander,L,VAN,24,64,22,7,29
64,8480893,Kirill Marchenko,R,CBJ,24,57,17,12,29
64,8474715,Cameron Atkinson,R,TBL,35,82,15,14,29
64,8478466,Daniel Sprong,R,VAN,27,70,14,15,29
64,8475714,Calle Jarnkrok,C,TOR,33,72,13,16,29
64,8479351,Sam Steel,C,DAL,26,81,13,16,29
64,8477429,Andrew Copp,C,DET,30,76,11,18,29
64,8481014,Alexander Romanov,D,NYI,24,74,6,23,29
64,8481581,Thomas Harley,D,DAL,23,76,5,24,29
64,8480043,Timothy Liljegren,D,TOR,25,67,3,26,29
64,8478109,Victor Olofsson,L,VGK,29,69,17,11,28
64,8481477,Nico Sturm,C,SJS,29,60,17,11,28
64,8477511,Anthony Mantha,R,CGY,30,76,14,14,28
64,8476880,Tom Wilson,R,WSH,30,65,14,14,28
64,8480113,Alex Iafallo,L,WPG,31,66,14,14,28
64,8481624,Ilya Mikheyev,R,CHI,30,55,14,14,28
64,8480068,Ryan Poehling,C,PHI,25,54,13,15,28
64,8478432,Christian Fischer,R,DET,27,75,13,15,28
64,8481523,Kirby Dach,C,MTL,23,68,12,16,28
64,8476897,Oskar Sundqvist,C,STL,30,70,12,16,28
64,8477839,Conor Sheary,L,TBL,32,81,10,18,28
64,8480336,Sean Walker,D,CAR,30,73,9,19,28
64,8481481,Blake Lizotte,C,PIT,27,54,6,22,28
64,8474574,Tyler Myers,D,VAN,34,69,6,22,28
64,8476892,Colton Parayko,D,STL,31,73,4,24,28
64,8475181,Nick Leddy,D,STL,33,66,4,24,28
64,8480873,Rasmus Sandin,D,WSH,24,68,3,25,28
64,8479316,Luke Kunin,C,SJS,27,56,15,12,27
64,8476918,Jimmy Vesey,L,NYR,31,69,15,12,27
64,8480835,Jack Drury,C,CAR,24,51,12,15,27
64,8475791,Taylor Hall,L,CHI,33,46,9,18,27
64,8476463,Jonas Brodin,D,MIN,31,79,3,24,27
64,8483445,Cutter Gauthier,L,ANA,20,64,3,24,27
64,8476979,Erik Gustafsson,D,DET,32,73,2,25,27
64,8480049,Dylan Samberg,D,WPG,25,69,2,25,27
64,8477969,Marcus Pettersson,D,PIT,28,80,1,26,27
64,8479398,Samuel Girard,D,COL,26,70,0,27,27
64,8470621,Corey Perry,R,EDM,39,67,15,11,26
64,8476469,Joel Armia,R,MTL,31,65,14,12,26
64,8481580,Connor McMichael,C,WSH,23,62,12,14,26
64,8482679,Matt Coronato,R,CGY,22,69,12,14,26
64,8478891,Mason Appleton,C,WPG,28,51,8,18,26
64,8477989,Christian Dvorak,C,MTL,28,63,8,18,26
64,8478970,Jalen Chatfield,D,CAR,28,67,6,20,26
64,8481601,Simon Holmstrom,R,NYI,23,68,14,11,25
64,8478508,Yakov Trenin,C,MIN,27,64,13,12,25
64,8477380,Jonny Brodzinski,C,NYR,31,44,12,13,25
64,8481032,Paul Cotter,C,NJD,25,60,11,14,25
64,8483565,Nick Blankenburg,D,NSH,26,58,9,16,25
64,8482133,Thomas Bordeleau,C,SJS,22,61,8,17,25
64,8482101,Danil Gushchin,L,SJS,22,64,8,17,25
64,8483457,Lane Hutson,D,MTL,20,63,8,17,25
64,8476329,Travis Boyd,C,MIN,31,58,8,17,25
64,8474716,Jared Spurgeon,D,MIN,35,76,7,18,25
64,8475149,Marcus Johansson,L,MIN,34,67,7,18,25
64,8483524,Shane Wright,C,SEA,20,50,7,18,25
64,8480878,Nils Lundkvist,D,DAL,24,70,4,21,25
64,8476879,Cody Ceci,D,EDM,31,72,3,22,25
64,8478500,Ivan Provorov,D,CBJ,27,78,2,23,25
64,8480003,Jesper Boqvist,C,FLA,26,60,15,9,24
64,8480855,Jack McBain,C,UTA,24,60,15,9,24
64,8480205,Emil Bemstrom,C,PIT,25,65,14,10,24
64,8479393,Noah Gregor,L,OTT,26,73,10,14,24
64,8477446,Michael McCarron,R,NSH,29,55,10,14,24
64,8478911,Matt Roy,D,WSH,29,59,8,16,24
64,8482148,Hendrix Lapierre,C,WSH,22,50,8,16,24
64,8476624,Barclay Goodrow,C,SJS,31,47,7,17,24
64,8482655,Janis Moser,D,TBL,24,73,5,19,24
64,8482067,Connor Mackey,D,NYR,28,66,3,21,24
64,8476457,Adam Larsson,D,SEA,32,72,3,21,24
64,8478882,Vladislav Gavrikov,D,LAK,29,70,2,22,24
64,8477425,Miles Wood,L,COL,29,74,14,9,23
64,8478043,Sam Lafferty,C,BUF,29,67,13,10,23
64,8480829,Jesperi Kotkaniemi,C,CAR,24,65,12,11,23
64,8481656,Aliaksei Protas,C,WSH,23,66,12,11,23
64,8476878,Zemgus Girgensons,C,TBL,30,77,11,12,23
64,8477406,Mattias Janmark,C,EDM,32,66,10,13,23
64,8475848,Brendan Gallagher,R,MTL,32,70,9,14,23
64,8482111,Justin Barron,D,MTL,23,69,7,16,23
64,8482624,Daniil Miromanov,D,CGY,27,71,6,17,23
64,8483490,Pavel Mintyukov,D,ANA,21,67,5,18,23
64,8480073,Erik Brannstrom,D,COL,25,65,5,18,23
64,8480145,Neal Pionk,D,WPG,29,75,4,19,23
64,8482142,Jamie Drysdale,D,PHI,22,61,4,19,23
64,8479639,Dylan Coghlan,D,WPG,26,65,4,19,23
64,8475188,Brayden McNabb,D,VGK,33,59,3,20,23
64,8478507,John Marino,D,UTA,27,69,2,21,23
64,8474673,TJ Brodie,D,CHI,34,56,1,22,23
64,8480995,Pontus Holmberg,R,TOR,25,54,13,9,22
64,8475220,Marcus Foligno,L,MIN,33,58,11,11,22
64,8477505,Alexander Wennberg,C,SJS,30,61,9,13,22
64,8480789,Oliver Wahlstrom,R,NYI,24,64,9,13,22
64,8473563,Nicklas Backstrom,C,WSH,37,46,8,14,22
64,8480748,Kiefer Sherwood,L,VAN,29,61,5,17,22
64,8476856,Mathew Dumba,D,DAL,30,68,5,17,22
64,8479982,Conor Timmins,D,TOR,26,48,4,18,22
64,8478840,Will Borgen,D,SEA,28,71,1,21,22
64,8480802,Ryan McLeod,C,BUF,25,68,11,10,21
64,8483493,Frank Nazar,C,CHI,20,49,9,12,21
64,8476312,Josh Manson,D,COL,33,64,7,14,21
64,8478178,Darren Raddysh,D,TBL,28,68,7,14,21
64,8475343,Nic Dowd,C,WSH,34,59,7,14,21
64,8480817,K'Andre Miller,D,NYR,24,72,6,15,21
64,8477931,Tomas Nosek,L,FLA,32,63,6,15,21
64,8473507,Jeff Petry,D,DET,37,74,4,17,21
64,8479402,Jake Bean,D,CGY,26,72,4,17,21
64,8482117,Lukas Reichel,L,CHI,22,57,13,7,20
64,8482809,Jackson Blake,R,CAR,21,55,12,8,20
64,8479520,Brandon Duhaime,R,WSH,27,57,12,8,20
64,8481028,Martin Pospisil,C,CGY,25,52,12,8,20
64,8477979,Nicolas Aube-Kubel,R,BUF,28,66,9,11,20
64,8475231,Casey Cizikas,C,NYI,33,74,8,12,20
64,8480144,David Kampf,C,TOR,29,68,8,12,20
64,8477478,William Carrier,L,CAR,30,59,8,12,20
64,8475855,Jesper Fast,R,CAR,33,65,7,13,20
64,8477919,Frederick Gaudreau,C,MIN,31,61,7,13,20
64,8482087,Kaiden Guhle,D,MTL,22,62,3,17,20
64,8479976,Juuso Valimaki,D,UTA,26,64,3,17,20
64,8479619,Michael Carcone,L,UTA,28,61,12,7,19
64,8482125,Alexander Holtz,R,VGK,22,68,11,8,19
64,8482762,Simon Edvinsson,D,DET,21,62,11,8,19
64,8481093,Rafael Harvey-Pinard,L,MTL,25,59,10,9,19
64,8482192,Isaak Phillips,D,CHI,23,48,8,11,19
64,8481441,Joe Snively,C,DET,28,67,7,12,19
64,8477220,Nate Schmidt,D,FLA,33,66,6,13,19
64,8481019,David Gustafsson,C,WPG,24,42,6,13,19
64,8480246,Nick Perbix,D,TBL,26,77,5,14,19
64,8481522,Peyton Krebs,C,BUF,23,58,4,15,19
64,8482737,Zack Bolduc,C,STL,21,58,4,15,19
64,8476331,Dylan DeMelo,D,WPG,31,72,3,16,19
64,8482259,Bobby McMann,C,TOR,28,61,14,4,18
64,8479336,Carl Grundstrom,R,SJS,27,61,13,5,18
64,8478569,Noel Acciari,C,PIT,33,51,13,5,18
64,8482749,Joshua Roy,R,MTL,21,61,10,8,18
64,8476960,Andreas Athanasiou,C,CHI,30,44,10,8,18
64,8478013,Jake Walman,D,SJS,28,72,8,10,18
64,8476374,Sean Kuraly,C,CBJ,31,55,7,11,18
64,8480727,Zach Whitecloud,D,VGK,28,56,6,12,18
64,8483482,Tristan Luneau,D,ANA,20,68,6,12,18
64,8482157,Will Cuylle,L,NYR,22,60,5,13,18
64,8479543,Michael Pezzetta,L,MTL,26,54,5,13,18
64,8474568,Luke Schenn,D,NSH,35,53,5,13,18
64,8480891,Michael Kesselring,D,UTA,24,54,4,14,18
64,8476931,Jake McCabe,D,TOR,31,61,2,16,18
64,8476967,Brett Kulak,D,EDM,30,57,1,17,18
64,8482079,Marco Rossi,C,MIN,23,54,10,7,17
64,8478585,Derek Ryan,C,EDM,38,60,9,8,17
64,8476525,Colin Miller,D,WPG,32,61,8,9,17
64,8478421,A.J. Greer,L,FLA,28,60,8,9,17
64,8477435,Ryan Graves,D,PIT,29,78,7,10,17
64,8477070,Liam O'Brien,C,UTA,30,59,7,10,17
64,8482803,Olen Zellweger,D,ANA,21,65,6,11,17
64,8478416,Erik Cernak,D,TBL,27,71,6,11,17
64,8483499,Liam Ohgren,L,MIN,20,51,6,11,17
64,8476891,Matthew Grzelcyk,D,PIT,30,74,6,11,17
64,8479324,Ryan Lindgren,D,NYR,26,62,6,11,17
64,8479026,Philippe Myers,D,TOR,27,59,4,13,17
64,8479998,Mikey Anderson,D,LAK,25,63,3,14,17
64,8480058,Pierre-Olivier Joseph,D,STL,25,48,2,15,17
64,8475324,Nick Jensen,D,OTT,34,71,2,15,17
64,8482155,Alex Laferriere,R,LAK,23,61,11,5,16
64,8476873,Mark Jankowski,C,NSH,30,47,9,7,16
64,8483491,Ivan Miroshnichenko,L,WSH,20,59,7,9,16
64,8480021,Jack Studnicka,C,LAK,25,64,7,9,16
64,8481537,Nikita Okhotiuk,D,CGY,24,49,7,9,16
64,8480806,Isac Lundestrom,C,ANA,25,57,7,9,16
64,8480074,Alexandre Texier,C,STL,25,59,7,9,16
64,8482074,Connor Zary,C,CGY,23,66,6,10,16
64,8479369,Andrew Peeke,D,BOS,26,60,6,10,16
64,8476467,Jamie Oleksiak,D,SEA,32,61,5,11,16
64,8480796,Martin Fehervary,D,WSH,25,52,4,12,16
64,8475225,Craig Smith,C,CHI,35,60,4,12,16
64,8475455,Brenden Dillon,D,NJD,34,56,4,12,16
64,8479359,Beck Malenstyn,L,BUF,26,42,4,12,16
64,8475179,Dmitry Kulikov,D,FLA,34,61,3,13,16
64,8482095,Tyler Kleven,D,OTT,22,43,3,13,16
64,8475233,David Savard,D,MTL,34,66,2,14,16
64,8479371,Dante Fabbro,D,NSH,26,60,0,16,16
64,8475790,Erik Gudbranson,D,CBJ,32,81,0,16,16
64,8481716,Dmitri Voronkov,L,CBJ,24,47,11,4,15
64,8475842,Sam Carrick,C,NYR,32,55,9,6,15
64,8478211,Dryden Hunt,L,CGY,29,60,8,7,15
64,8480281,Alexey Toropchenko,R,STL,25,58,7,8,15
64,8482062,Cole Smith,L,NSH,29,56,7,8,15
64,8479718,Alex Barré-Boulet,C,MTL,27,49,7,8,15
64,8478434,Keegan Kolesar,R,VGK,27,61,7,8,15
64,8477015,Connor Brown,R,EDM,30,62,6,9,15
64,8470600,Ryan Suter,D,STL,39,62,6,9,15
64,8479066,Ryan Lomberg,L,CGY,30,58,5,10,15
64,8477499,Rasmus Ristolainen,D,PHI,30,60,5,10,15
64,8481517,Brett Leason,R,ANA,25,55,5,10,15
64,8481161,Jake Christiansen,D,CBJ,25,58,5,10,15
64,8481521,Ronnie Attard,D,PHI,25,57,4,11,15
64,8482073,Braden Schneider,D,NYR,23,63,4,11,15
64,8478851,Alexandre Carrier,D,NSH,28,70,3,12,15
64,8479980,Nicolas Hague,D,VGK,26,52,3,12,15
64,8478136,Jake Middleton,D,MIN,28,74,3,12,15
64,8475690,Chris Tanev,D,TOR,35,61,3,12,15
64,8480035,Henri Jokiharju,D,BUF,25,63,2,13,15
64,8477845,Trevor van Riemsdyk,D,WSH,33,58,2,13,15
64,8481178,Egor Zamula,D,PHI,24,55,1,14,15
64,8480807,Mattias Samuelsson,D,BUF,24,51,1,14,15
64,8480222,Sebastian Aho,D,PIT,28,74,1,14,15
64,8477353,Tyler Motte,C,DET,29,73,8,6,14
64,8480448,Parker Kelly,L,COL,25,76,8,6,14
64,8479328,Julien Gauthier,R,NYI,27,65,6,8,14
64,8482784,Zach Dean,C,STL,21,44,6,8,14
64,8480252,Cole Guttman,C,CHI,25,43,6,8,14
64,8477392,Hudson Fasching,R,NYI,29,64,5,9,14
64,8478831,Kevin Stenlund,C,UTA,28,52,5,9,14
64,8483495,Simon Nemec,D,NJD,20,55,4,10,14
64,8471677,Jack Johnson,D,CBJ,37,64,4,10,14
64,8480860,Kevin Bahl,D,CGY,24,57,4,10,14
64,8477903,Garnet Hathaway,R,PHI,33,54,2,12,14
64,8479249,Andrew Poturalski,C,SJS,30,38,2,12,14
64,8481598,Philip Broberg,D,EDM,23,45,2,12,14
64,8481568,Alex Vlasic,D,CHI,23,53,2,12,14
64,8482634,Alex Steeves,C,TOR,25,54,2,12,14
64,8477508,Curtis Lazar,C,NJD,29,57,10,3,13
64,8473453,Trevor Lewis,C,LAK,37,73,9,4,13
64,8482659,Josh Doan,R,UTA,22,53,7,6,13
64,8480355,Mark Kastelic,C,BOS,25,50,6,7,13
64,8476934,Brock McGinn,L,ANA,30,50,6,7,13
64,8480172,Jan Rutta,D,SJS,34,55,5,8,13
64,8476822,Luke Glendening,C,TBL,35,75,5,8,13
64,8476422,Mike Reilly,D,NYI,31,74,4,9,13
64,8482451,Mikael Pyyhtia,L,CBJ,23,40,4,9,13
64,8479414,Nathan Bastian,R,NJD,27,61,4,9,13
64,8481527,Kaedan Korczak,D,VGK,23,44,4,9,13
64,8476994,Vinnie Hinostroza,C,NSH,30,46,3,10,13
64,8482077,Dylan Holloway,L,EDM,23,56,3,10,13
64,8482176,Wyatt Kaiser,D,CHI,22,48,3,10,13
64,8475462,Radko Gudas,D,ANA,34,66,3,10,13
64,8481751,Lukas Rousek,R,BUF,25,41,3,10,13
64,8481592,Jakob Pelletier,L,CGY,23,41,3,10,13
64,8482245,Artem Zub,D,OTT,29,63,2,11,13
64,8478399,Jonas Siegenthaler,D,NJD,27,54,2,11,13
64,8480848,Ty Dellandrea,C,SJS,24,44,2,11,13
64,8481059,Scott Perunovich,D,STL,26,62,2,11,13
64,8475208,Brian Dumoulin,D,ANA,33,63,2,11,13
64,8483460,David Jiricek,D,CBJ,21,54,1,12,13
64,8474567,Zach Bogosian,D,MIN,34,63,1,12,13
64,8481518,Nolan Foote,L,NJD,24,44,11,1,12
64,8479344,Jesse Puljujarvi,R,PIT,26,52,7,5,12
64,8476889,Radek Faksa,C,STL,30,54,7,5,12
64,8480762,Eric Robinson,L,CAR,29,53,7,5,12
64,8471817,Ryan Reaves,R,TOR,37,56,7,5,12
64,8479994,Jaret Anderson-Dolan,C,WPG,25,42,7,5,12
64,8480845,Rasmus Kupari,C,WPG,24,40,6,6,12
64,8482859,Zack Ostapchuk,C,OTT,21,53,6,6,12
64,8480025,MacKenzie Entwistle,R,FLA,25,59,5,7,12
64,8480980,Connor Dewar,C,TOR,25,72,5,7,12
64,8481617,Vasily Podkolzin,R,VAN,23,58,5,7,12
64,8480192,Johnathan Kovacevic,D,NJD,27,51,3,9,12
64,8476952,Dominic Toninato,C,WPG,30,38,3,9,12
64,8476902,Esa Lindell,D,DAL,30,71,2,10,12
64,8474090,Brendan Smith,D,DAL,35,57,1,11,12
64,8482070,Mitchell Chaffee,R,TBL,26,51,10,1,11
64,8481532,Alex Turcotte,C,LAK,23,45,8,3,11
64,8477369,Carson Soucy,D,VAN,30,63,7,4,11
64,8482666,Scott Morrow,D,CAR,22,52,7,4,11
64,8482751,Ryan Winterton,C,SEA,21,43,6,5,11
64,8478452,Caleb Jones,D,LAK,27,60,5,6,11
64,8477034,Jaycob Megna,D,FLA,32,46,4,7,11
64,8484149,Gavin Brindley,C,CBJ,20,51,3,8,11
64,8480950,Ilya Lyubushkin,D,DAL,30,64,3,8,11
64,8478451,Ethan Bear,D,WSH,27,49,3,8,11
64,8477384,Joshua Brown,D,EDM,30,44,2,9,11
64,8481701,Santeri Hatakka,D,NJD,23,48,2,9,11
64,8480001,Urho Vaakanainen,D,ANA,25,49,1,10,11
64,8481567,Henry Thrun,D,SJS,23,50,1,10,11
64,8477851,Jordan Oesterle,D,BOS,32,43,1,10,11
64,8476874,Olli Maatta,D,DET,30,52,0,11,11
64,8481013,Jonatan Berggren,R,DET,24,55,7,3,10
64,8482730,Brandt Clarke,D,LAK,21,45,5,5,10
64,8479372,Joshua Mahura,D,SEA,26,57,5,5,10
64,8482744,James Malatesta,L,CBJ,21,48,4,6,10
64,8482166,Shakir Mukhamadullin,D,SJS,22,61,4,6,10
64,8481147,Reese Johnson,C,MIN,26,44,4,6,10
64,8478468,Jeremy Lauzon,D,NSH,27,54,3,7,10
64,8481550,Adam Beckman,L,NJD,23,42,3,7,10
64,8479972,Mason Shaw,C,WPG,26,47,3,7,10
64,8482964,Arber Xhekaj,D,MTL,23,54,3,7,10
64,8479291,Kevin Rooney,C,CGY,31,53,2,8,10
64,8480887,Jordan Harris,D,MTL,24,51,2,8,10
64,8479983,Mario Ferraro,D,SJS,26,73,1,9,10
64,8478443,Brandon Carlo,D,BOS,28,64,1,9,10
64,8480070,Ian Mitchell,D,BOS,25,48,1,9,10
64,8476429,Scott Mayfield,D,NYI,32,70,1,9,10
64,8479442,Troy Stecher,D,EDM,30,54,1,9,10
64,8476988,Matt Benning,D,SJS,30,60,0,10,10
64,8478859,Niko Mikkola,D,FLA,28,54,0,10,10
64,8479944,Zach Aston-Reese,C,VGK,30,42,6,3,9
64,8477573,Nathan Walker,L,STL,30,44,5,4,9
64,8479439,Jacob MacDonald,D,COL,31,43,5,4,9
64,8480880,Jakub Lauko,C,MIN,24,34,5,4,9
64,8476442,Matt Nieto,L,PIT,32,48,5,4,9
64,8483466,Kevin Korchinski,D,CHI,20,50,5,4,9
64,8476473,Connor Murphy,D,CHI,31,44,5,4,9
64,8476858,Phillip Di Giuseppe,L,VAN,31,49,5,4,9
64,8481754,Nikita Nesterenko,C,ANA,23,39,5,4,9
64,8479348,Kale Clague,D,BUF,26,39,5,4,9
64,8480289,Morgan Barron,C,WPG,26,51,4,5,9
64,8475235,Nicolas Deslauriers,L,PHI,33,50,4,5,9
64,8479379,Givani Smith,R,SJS,26,32,4,5,9
64,8477018,Ben Hutton,D,VGK,31,41,3,6,9
64,8477887,Patrick Brown,C,BOS,32,51,3,6,9
64,8478454,Noah Juulsen,D,VAN,27,38,3,6,9
64,8480292,Carson Meyer,R,ANA,27,35,3,6,9
64,8477938,Haydn Fleury,D,WPG,28,40,1,8,9
64,8475750,Jon Merrill,D,MIN,32,63,1,8,9
64,8482861,Vincent Iorio,D,WSH,22,36,1,8,9
64,8483570,Ben Meyers,C,SEA,26,38,7,1,8
64,8483630,Pavol Regenda,L,ANA,25,35,5,3,8
64,8477401,John Hayden,C,SEA,29,31,5,3,8
64,8475279,Ben Chiarot,D,DET,33,61,4,4,8
64,8474013,Ian Cole,D,UTA,35,53,4,4,8
64,8482807,Ethan Del Mastro,D,CHI,21,54,3,5,8
64,8477962,Brendan Lemieux,L,CAR,28,37,3,5,8
64,8478017,Mark Friedman,D,VAN,29,45,3,5,8
64,8482765,Isak Rosen,R,BUF,21,22,3,5,8
64,8477335,Kyle Burroughs,D,LAK,29,39,3,5,8
64,8479370,Tyson Jost,C,CAR,26,52,2,6,8
64,8474034,Patrick Maroon,L,CHI,36,53,2,6,8
64,8480157,Calle Rosen,D,COL,30,43,2,6,8
64,8482496,Nils Aman,C,VAN,24,37,2,6,8
64,8484254,Akito Hirose,D,VAN,25,35,2,6,8
64,8483012,Logan Morrison,C,SEA,22,37,2,6,8
64,8475718,Justin Holl,D,DET,32,67,1,7,8
64,8477365,Connor Clifton,D,BUF,29,55,1,7,8
64,8483549,Lucas Condotta,L,MTL,27,29,1,7,8
64,8476441,Joel Edmundson,D,LAK,31,36,0,8,8
64,8481641,Joel Kiviranta,L,COL,28,68,5,2,7
64,8482177,Marat Khusnutdinov,C,MIN,22,33,4,3,7
64,8479981,Jonah Gadjovich,L,FLA,26,42,4,3,7
64,8482652,Walker Duehr,R,CGY,27,34,3,4,7
64,8482153,Brendan Brisson,C,VGK,23,31,3,4,7
64,8482733,Logan Mailloux,D,MTL,31,33,3,4,7
64,8478409,Anthony Richard,C,PHI,28,37,3,4,7
64,8477073,Kurtis MacDermid,L,NJD,30,29,3,4,7
64,8482172,Landon Slaggert,L,CHI,22,25,3,4,7
64,8480007,Jonas Rondbjerg,R,VGK,25,48,2,5,7
64,8474166,Alec Martinez,D,CHI,37,52,2,5,7
64,8478011,Louie Belpedio,D,PHI,28,13,2,5,7
64,8480245,Olle Lycksell,R,PHI,25,33,2,5,7
64,8481167,Brayden Pachal,D,CGY,25,47,1,6,7
64,8480879,Jacob Bernard-Docker,D,OTT,24,47,1,6,7
64,8481122,Simon Benoit,D,TOR,26,47,1,6,7
64,8479378,Logan Stanley,D,WPG,26,33,1,6,7
64,8481708,Zac Jones,D,NYR,24,41,0,7,7
64,8473446,Erik Johnson,D,PHI,36,45,0,7,7
64,8481422,Jake Lucchini,C,NSH,29,20,6,0,6
64,8480011,Klim Kostin,C,SJS,25,40,5,1,6
64,8476867,Brendan Gaunce,C,MIN,30,36,4,2,6
64,8481789,Tye Kartye,L,SEA,23,38,4,2,6
64,8477482,Zachary Sanford,L,CHI,30,33,4,2,6
64,8478146,Matthew Highmore,C,OTT,28,42,4,2,6
64,8482201,Gage Goncalves,C,TBL,23,28,4,2,6
64,8484911,Collin Graf,R,SJS,22,34,3,3,6
64,8479320,Maxime Lajoie,D,SEA,27,25,3,3,6
64,8476372,Nick Seeler,D,PHI,31,37,2,4,6
64,8482747,Brennan Othmann,L,NYR,21,42,2,4,6
64,8475762,Derek Forbort,D,VAN,32,40,2,4,6
64,8476913,Devin Shore,C,MIN,30,40,2,4,6
64,8480834,Ty Emberson,D,SJS,24,30,2,4,6
64,8481605,Jackson LaCombe,D,ANA,23,36,2,4,6
64,8471709,Marc-Edouard Vlasic,D,SJS,37,66,1,5,6
64,8474612,Travis Hamonic,D,OTT,34,56,1,5,6
64,8475958,Michael Sgarbossa,C,WSH,32,26,1,5,6
64,8475177,Calvin de Haan,D,COL,33,47,1,5,6
64,8481600,Tobias Bjornfot,D,FLA,23,39,1,5,6
64,8477810,Joel Hanley,D,CGY,33,23,0,6,6
64,8478021,William Lagesson,D,DET,28,28,4,1,5
64,8479968,Vinni Lettieri,C,BOS,29,44,3,2,5
64,8478424,Jansen Harkins,C,ANA,27,49,3,2,5
64,8479772,Zack MacEwen,R,OTT,28,50,3,2,5
64,8481556,John Beecher,C,BOS,23,32,3,2,5
64,8481541,Samuel Bolduc,D,NYI,24,30,2,3,5
64,8479671,Mathieu Olivier,R,CBJ,27,48,2,3,5
64,8481593,Jayden Struble,D,MTL,23,19,2,3,5
64,8482713,Mackie Samoskevich,R,FLA,22,35,2,3,5
64,8481599,Victor Soderstrom,D,UTA,23,40,1,4,5
64,8483763,Maksymilian Szuber,D,UTA,22,35,1,4,5
64,8482144,Jack Thompson,D,SJS,22,25,1,4,5
64,8478450,Parker Wotherspoon,D,BOS,27,30,1,4,5
64,8484287,Cole McWard,D,VAN,23,19,1,4,5
64,8482145,Mavrik Bourque,C,DAL,22,54,1,4,5
64,8482511,Mason Lohrei,D,BOS,23,29,0,5,5
64,8482516,Matthew Kessel,D,STL,24,23,0,5,5
64,8481609,Vladislav Kolyachonok,D,UTA,23,33,4,0,4
64,8481679,Maxence Guenette,D,OTT,23,32,3,1,4
64,8478881,Brett Seney,L,CHI,28,17,3,1,4
64,8480267,Sammy Walker,C,MIN,25,17,3,1,4
64,8478446,Glenn Gawdin,C,LAK,27,10,3,1,4
64,8479986,Kole Lind,R,DAL,26,46,2,2,4
64,8483619,Filip Roos,D,OTT,25,29,2,2,4
64,8483397,Marc McLaughlin,C,BOS,25,29,2,2,4
64,8482858,Ryker Evans,D,SEA,23,24,2,2,4
64,8479985,Cale Fleury,D,SEA,26,17,2,2,4
64,8478874,Adam Gaudette,R,OTT,28,33,2,2,4
64,8479587,Rhett Gardner,C,PHI,28,25,2,2,4
64,8477971,Andreas Englund,D,LAK,28,27,2,2,4
64,8480851,Akil Thomas,C,LAK,24,22,2,2,4
64,8481462,Mason Morelli,L,VGK,28,19,2,2,4
64,8479991,Jake Leschyshyn,C,NYR,25,32,1,3,4
64,8475795,Dylan McIlrath,D,WSH,32,22,1,3,4
64,8482165,Yan Kuznetsov,D,CGY,22,18,1,3,4
64,8482141,Lukas Cormier,D,VGK,22,24,1,3,4
64,8484325,Waltteri Merela,C,TBL,26,19,1,3,4
64,8480084,Nick DeSimone,D,NJD,30,17,1,3,4
64,8480990,Declan Chisholm,D,MIN,24,35,0,4,4
64,8479576,Vincent Desharnais,D,VAN,28,33,0,4,4
64,8482929,Emil Lilleberg,D,TBL,23,19,0,4,4
64,8477527,Ross Johnston,L,ANA,30,33,0,4,4
64,8481056,Spencer Stastney,D,NSH,24,35,0,4,4
64,8480441,Trey Fix-Wolansky,R,CBJ,25,33,2,1,3
64,8484258,Sam Malinski,D,COL,26,18,2,1,3
64,8479362,Riley Tufte,L,BOS,26,27,2,1,3
64,8479638,Justin Brazeau,R,BOS,26,36,1,2,3
64,8481065,Angus Crookshank,L,OTT,25,18,1,2,3
64,8477467,Gustav Olofsson,D,SEA,30,20,1,2,3
64,8481237,Kyle MacLean,C,NYI,25,24,1,2,3
64,8483597,Milos Kelemen,L,UTA,25,15,1,2,3
64,8477473,Justin Bailey,R,SJS,29,23,0,3,3
64,8479419,Brett Murray,L,BUF,26,27,0,3,3
64,8480844,Grigori Denisenko,L,VGK,24,26,0,3,3
64,8479367,William Lockwood,R,FLA,26,27,0,3,3
64,8477244,Chad Ruhwedel,D,NYR,34,30,0,3,3
64,8482250,Callahan Burke,C,VGK,27,20,0,3,3
64,8477149,Scott Sabourin,R,SJS,32,15,0,3,3
64,8481006,Tyler Tucker,D,STL,24,14,0,3,3
64,8480468,James Hamblin,L,EDM,25,20,2,0,2
64,8480890,Jan Jenik,C,OTT,24,22,2,0,2
64,8484304,Uvis Balinskis,D,FLA,28,10,2,0,2
64,8481585,Egor Afanasyev,L,SJS,23,12,1,1,2
64,8477320,Anton Blidh,L,NYR,29,16,1,1,2
64,8480870,Bo Groulx,C,NYR,24,35,1,1,2
64,8481043,Cole Koepke,L,BOS,26,17,1,1,2
64,8481699,Aku Raty,R,UTA,23,17,1,1,2
64,8482118,Sam Colangelo,R,ANA,23,12,1,1,2
64,8477462,Robert Hagg,D,VGK,29,28,0,2,2
64,8481743,Marc Del Gaizo,D,NSH,25,17,0,2,2
64,8478051,Max Willman,C,NJD,29,15,0,2,2
64,8483407,Brandon Scanlin,D,NYR,25,7,0,2,2
64,8482094,Daemon Hunt,D,MIN,22,13,0,2,2
64,8482061,Brandon Biro,L,SEA,26,11,0,2,2
64,8482470,Ilya Solovyov,D,CGY,24,15,0,2,2
64,8474062,Riley Nash,C,NYR,35,18,1,0,1
64,8481543,Nikita Alexandrov,C,STL,24,20,1,0,1
64,8483489,Fraser Minten,C,TOR,31,9,1,0,1
64,8481719,Maxwell Crozier,D,TBL,24,21,1,0,1
64,8481806,Louis Crevier,D,CHI,23,16,1,0,1
64,8481030,Jack St. Ivany,D,PIT,25,16,1,0,1
64,8483395,Arshdeep Bains,L,VAN,23,6,1,0,1
64,8478147,Bokondji Imama,L,PIT,28,5,1,0,1
64,8481578,Graeme Clarke,R,MIN,23,6,1,0,1
64,8479536,Axel Jonsson-Fjallby,L,WPG,26,29,0,1,1
64,8480196,Jacob Bryson,D,BUF,27,54,0,1,1
64,8482147,Jean-Luc Foudy,C,COL,22,25,0,1,1
64,8480075,Cameron Crotty,D,MIN,25,9,0,1,1
64,8481564,Ryan Johnson,D,BUF,23,13,0,1,1
64,8478502,Dennis Gilbert,D,BUF,28,15,0,1,1
64,8482102,Vasily Ponomarev,C,PIT,22,17,0,1,1
64,8475755,Alexander Petrovic,D,DAL,32,8,0,1,1
64,8482088,Justin Sourdif,R,FLA,22,16,0,1,1
64,8480032,Shane Bowers,C,NJD,25,10,0,1,1
64,8480823,Alexander Alexeyev,D,WSH,25,15,0,1,1
64,8482787,Nikita Chibrikov,R,WPG,31,4,0,1,1
64,8483920,Pierrick Dube,R,WSH,23,3,0,1,1
64,8481655,Cole Schwindt,R,CGY,23,6,0,1,1
64,8484255,Jason Polin,R,COL,25,10,0,1,1
64,8483512,Matthew Savoie,C,EDM,20,27,0,0,0
64,8482162,Roby Jarventie,L,EDM,22,16,0,0,0
64,8475413,Justin Dowling,C,NJD,34,16,0,0,0
64,8481024,Linus Karlsson,C,VAN,25,6,0,0,0
64,8483546,Marshall Rifai,D,TOR,26,4,0,0,0
64,8479330,Brandon Gignac,C,MTL,27,9,0,0,0
64,8478477,Mitchell Stephens,C,SEA,27,16,0,0,0
64,8479421,Jacob Moverare,D,LAK,26,5,0,0,0
64,8477993,Justin Kirkland,C,CGY,28,5,0,0,0
64,8483471,Brad Lambert,C,WPG,31,12,0,0,0
64,8475780,Chris Wagner,R,COL,33,8,0,0,0
64,8480306,Grant Hutton,D,NYI,29,6,0,0,0
64,8482460,Matt Rempe,C,NYR,22,11,0,0,0
64,8483567,Georgii Merkulov,C,BOS,24,9,0,0,0
64,8481206,John Ludvig,D,PIT,24,5,0,0,0
64,8483398,Declan Carlile,D,TBL,31,6,0,0,0
64,8477541,Dakota Mermis,D,TOR,30,9,0,0,0
64,8482126,Emil Andrae,D,PHI,31,1,0,0,0
64,8483609,Adam Klapka,R,CGY,24,3,0,0,0
64,8476323,Max McCormick,L,SEA,32,2,0,0,0
64,8480874,Adam Ginning,D,PHI,24,14,0,0,0
64,8482476,Emil Heineman,L,MTL,23,12,0,0,0
64,8483432,Luca Del Bel Belluz,C,CBJ,31,4,0,0,0
64,8481726,Adam Edstrom,C,NYR,24,7,0,0,0
64,8484259,Ondrej Pavel,C,COL,31,4,0,0,0
64,8478854,Ryan Shea,D,PIT,27,7,0,0,0
64,8482197,Adam Raska,R,MIN,23,7,0,0,0
64,8479522,Hardy Haman Aktell,D,WSH,26,1,0,0,0
64,8481534,Raphael Lavoie,C,EDM,24,3,0,0,0
64,8484321,Nikolas Matinpalo,D,OTT,26,2,0,0,0
64,8484326,Patrik Koch,D,UTA,28,3,0,0,0
64,8483531,Brian Halonen,L,NJD,25,3,0,0,0
64,8483401,Marc Johnstone,R,PIT,28,1,0,0,0
64,8480274,Philip Kemp,D,EDM,25,0,0,0,0
64,8470794,Joe Pavelski,C,,40,0,0,0,0
64,8479321,Lucas Johansen,D,,27,0,0,0,0
64,8477950,Tony DeAngelo,D,,29,0,0,0,0
64,8471218,Blake Wheeler,R,,38,0,0,0,0
64,8475197,Tyson Barrie,D,,33,0,0,0,0
64,8474157,Max Pacioretty,L,,36,0,0,0,0
64,8475744,Evgeny Kuznetsov,C,,32,0,0,0,0
64,8474037,James van Riemsdyk,L,,35,0,0,0,0
64,8476907,Mackenzie MacEachern,L,,30,0,0,0,0
64,8480216,Jacob Peterson,C,,25,0,0,0,0
64,8474602,Justin Schultz,D,,34,0,0,0,0
64,8482222,Alexander Barabanov,L,,30,0,0,0,0
64,8474031,Kevin Shattenkirk,D,,35,0,0,0,0
64,8477330,Dominik Kubalik,L,,29,0,0,0,0
64,8480884,Calen Addison,D,,24,0,0,0,0
64,8475906,John Klingberg,D,,32,0,0,0,0
64,8480008,Adam Ruzicka,C,,25,0,0,0,0
64,8476884,Derrick Pouliot,D,,30,0,0,0,0
64,8476919,Chris Tierney,C,,30,0,0,0,0
64,8479415,Michael McLeod,C,,26,0,0,0,0
64,8474870,Tyler Johnson,C,,34,0,0,0,0
64,8470604,Jeff Carter,C,,39,0,0,0,0
64,8478104,Sammy Blais,L,,28,0,0,0,0
64,8474884,Mike Hoffman,C,,35,0,0,0,0
64,8481591,Sam Poulin,R,,23,0,0,0,0
64,8471274,Alex Goligoski,D,,39,0,0,0,0
64,8476871,Tanner Pearson,L,,32,0,0,0,0
64,8476393,Nick Cousins,C,,31,0,0,0,0
64,8479977,Kailer Yamamoto,R,,26,0,0,0,0
64,8479346,Dillon Dube,C,,26,0,0,0,0
64,8480184,Gustav Lindstrom,D,,26,0,0,0,0
64,8479376,Victor Mete,D,,26,0,0,0,0
64,8473449,Kyle Okposo,R,,36,0,0,0,0
64,8481058,Jesse Ylonen,R,,25,0,0,0,0
64,8475752,Tyler Pitlick,C,,33,0,0,0,0
64,8481239,Samuel Fagemo,L,,24,0,0,0,0
64,8480821,Filip Zadina,R,,25,0,0,0,0
64,8470966,Mark Giordano,D,,41,0,0,0,0
64,8478495,Denis Gurianov,R,,27,0,0,0,0
64,8477464,Nic Petan,C,,29,0,0,0,0
64,8478099,Kevin Labanc,R,,29,0,0,0,0
64,8482241,Radim Zohorna,L,,28,0,0,0,0
64,8474040,Sam Gagner,C,,35,0,0,0,0
64,8479514,Rem Pitlick,C,,27,0,0,0,0
64,8478430,Oliver Kylington,D,,27,0,0,0,0
64,8479533,Joona Koppanen,L,,26,0,0,0,0
64,8479984,Cal Foote,D,,26,0,0,0,0
64,8477126,Jayson Megna,C,,34,0,0,0,0
64,8475164,Jakob Silfverberg,R,,34,0,0,0,0
64,8474009,Nick Bonino,C,,36,0,0,0,0
64,8479458,Nikita Zaitsev,D,,33,0,0,0,0
64,8477944,Jakub Vrana,L,,28,0,0,0,0
64,8471699,Andrew Cogliano,C,,37,0,0,0,0
64,8478067,Oskar Lindblom,L,,28,0,0,0,0
64,8471686,Marc Staal,D,,37,0,0,0,0
64,8470610,Zach Parise,L,,40,0,0,0,0
64,8478904,Steven Lorentz,C,,28,0,0,0,0
64,8473473,Milan Lucic,L,,36,0,0,0,0
64,8480031,Maxime Comtois,L,,25,0,0,0,0
64,8478512,Austin Czarnik,C,,32,0,0,0,0
64,8473504,Cal Clutterbuck,R,,37,0,0,0,0
64,8477454,Adam Erne,L,,29,0,0,0,0
64,8479383,Boris Katchouk,L,,26,0,0,0,0
64,8475825,Jani Hakanpää,D,,32,0,0,0,0
64,8477846,Ryan Carpenter,C,,33,0,0,0,0
64,8477930,Pierre-Edouard Bellemare,L,,39,0,0,0,0
64,8478400,Colin White,C,,27,0,0,0,0
64,8480226,Marián Studenic,R,,26,0,0,0,0
64,8480853,Liam Foudy,C,,24,0,0,0,0
64,8475797,Jarred Tinordi,D,,32,0,0,0,0
64,8479423,Alex Nylander,L,,26,0,0,0,0
64,8474618,Marco Scandella,D,,34,0,0,0,0
64,8478028,Fredrik Olofsson,L,,28,0,0,0,0
64,8474709,Matt Martin,L,,35,0,0,0,0
64,8481070,Hugh McGing,L,,26,0,0,0,0
64,8479546,Oskar Steen,C,,26,0,0,0,0
64,8474145,Robert Bortuzzo,D,,35,0,0,0,0
64,8476915,Jujhar Khaira,L,,30,0,0,0,0
64,8475278,Byron Froese,C,,33,0,0,0,0
64,8481812,Nikolai Knyzhov,D,,27,0,0,0,0
64,8478408,Travis Dermott,D,,28,0,0,0,0
64,8481077,John Leonard,L,,26,0,0,0,0
64,8479547,Matthew Phillips,R,,26,0,0,0,0
64,8480836,Jonathan Gruden,C,,24,0,0,0,0
64,8481690,Tyler Angle,C,,24,0,0,0,0
64,8475766,Austin Watson,L,,32,0,0,0,0
64,8481016,Ruslan Iskhakov,C,,24,0,0,0,0
64,8478078,Rourke Chartier,C,,28,0,0,0,0
64,8480776,Sheldon Rempal,R,,29,0,0,0,0
64,8478956,Samuel Laberge,L,NJD,27,1,0,0,0
64,8483045,Cameron Butler,R,CBJ,31,0,0,0,0
64,8484314,Jiri Smejkal,L,,28,0,0,0,0
65,8477492,Nathan MacKinnon,C,COL,29,82,54,89,143
65,8476453,Nikita Kucherov,R,TBL,31,82,55,87,142
65,8478402,Connor McDavid,C,EDM,27,78,51,82,133
65,8479318,Auston Matthews,C,TOR,27,79,68,56,124
65,8481559,Jack Hughes,C,NJD,23,79,56,66,122
65,8477956,David Pastrnak,R,BOS,28,80,53,65,118
65,8478420,Mikko Rantanen,R,COL,28,82,54,61,115
65,8479314,Matthew Tkachuk,L,FLA,27,81,35,80,115
65,8477934,Leon Draisaitl,C,EDM,29,78,42,68,110
65,8480023,Robert Thomas,C,STL,25,78,28,80,108
65,8477493,Aleksander Barkov,C,FLA,29,80,30,75,105
65,8478483,Mitch Marner,R,TOR,27,81,29,76,105
65,8477404,Jake Guentzel,C,TBL,30,82,39,63,102
65,8476468,J.T. Miller,C,VAN,31,74,39,59,98
65,8476887,Filip Forsberg,L,NSH,30,70,35,62,97
65,8480069,Cale Makar,D,COL,26,67,22,73,95
65,8478010,Brayden Point,C,TBL,28,82,50,44,94
65,8474600,Roman Josi,D,NSH,34,76,24,70,94
65,8478427,Sebastian Aho,C,CAR,27,69,48,45,93
65,8477939,William Nylander,R,TOR,28,78,41,51,92
65,8475172,Nazem Kadri,C,CGY,34,80,31,61,92
65,8478864,Kirill Kaprizov,L,MIN,27,76,45,46,91
65,8478550,Artemi Panarin,L,NYR,33,73,25,65,90
65,8480012,Elias Pettersson,C,VAN,26,78,29,60,89
65,8478445,Mathew Barzal,C,NYI,27,81,24,65,89
65,8480800,Quinn Hughes,D,VAN,25,72,14,75,89
65,8477933,Sam Reinhart,C,FLA,29,80,45,43,88
65,8482116,Tim Stützle,C,OTT,22,78,39,49,88
65,8477942,Kevin Fiala,L,LAK,28,82,31,57,88
65,8478403,Jack Eichel,C,VGK,28,76,41,45,86
65,8471675,Sidney Crosby,C,PIT,37,74,36,49,85
65,8481557,Matt Boldy,L,MIN,23,75,36,49,85
65,8479407,Jesper Bratt,L,NJD,26,74,27,58,85
65,8476456,Jonathan Huberdeau,C,CGY,31,77,18,65,83
65,8479420,Tage Thompson,C,BUF,27,78,41,40,81
65,8478440,Dylan Strome,C,WSH,27,73,32,49,81
65,8476459,Mika Zibanejad,C,NYR,31,78,29,52,81
65,8475166,John Tavares,C,TOR,34,79,40,40,80
65,8474564,Steven Stamkos,C,NSH,34,74,30,50,80
65,8475692,Mats Zuccarello,R,MIN,37,72,20,60,80
65,8478398,Kyle Connor,L,WPG,28,76,33,46,79
65,8480801,Brady Tkachuk,L,OTT,25,78,34,44,78
65,8476460,Mark Scheifele,C,WPG,31,71,31,47,78
65,8480002,Nico Hischier,C,NJD,25,79,28,50,78
65,8480027,Jason Robertson,L,DAL,25,82,23,55,78
65,8478449,Roope Hintz,C,DAL,28,82,37,40,77
65,8475754,Brock Nelson,C,NYI,33,77,34,43,77
65,8479999,Casey Mittelstadt,C,COL,26,80,31,46,77
65,8477949,Alex Tuch,R,BUF,28,74,26,51,77
65,8478439,Travis Konecny,R,PHI,27,77,29,47,76
65,8477946,Dylan Larkin,C,DET,28,79,39,36,75
65,8479323,Adam Fox,D,NYR,26,76,17,58,75
65,8476539,Jonathan Marchessault,R,NSH,34,73,43,31,74
65,8480830,Andrei Svechnikov,R,CAR,24,72,37,37,74
65,8482093,Seth Jarvis,C,CAR,22,70,34,40,74
65,8480036,Miro Heiskanen,D,DAL,25,77,14,60,74
65,8480839,Rasmus Dahlin,D,BUF,24,72,19,54,73
65,8475184,Chris Kreider,L,NYR,33,73,49,23,72
65,8480208,Drake Batherson,R,OTT,26,81,26,46,72
65,8479385,Jordan Kyrou,C,STL,26,72,28,43,71
65,8478444,Brock Boeser,R,VAN,27,75,36,34,70
65,8481068,Yegor Sharangovich,C,CGY,26,78,35,34,69
65,8478414,Timo Meier,R,NJD,28,73,28,41,69
65,8477402,Pavel Buchnevich,L,STL,29,71,25,44,69
65,8479337,Alex DeBrincat,R,DET,27,81,33,35,68
65,8479542,Brandon Hagel,L,TBL,26,82,31,37,68
65,8476881,Tomas Hertl,C,VGK,31,77,30,38,68
65,8477501,Valeri Nichushkin,R,COL,29,81,27,41,68
65,8479325,Charlie McAvoy,D,BOS,27,78,9,59,68
65,8476399,Blake Coleman,C,CGY,33,77,32,35,67
65,8478401,Pavel Zacha,C,BOS,27,75,24,43,67
65,8480039,Martin Necas,C,CAR,25,73,23,44,67
65,8475913,Mark Stone,R,VGK,32,76,21,46,67
65,8478460,Zach Werenski,D,CBJ,27,78,14,53,67
65,8475167,Victor Hedman,D,TBL,34,81,11,56,67
65,8474578,Erik Karlsson,D,PIT,34,79,10,57,67
65,8482740,Wyatt Johnston,C,DAL,21,80,32,34,66
65,8474141,Patrick Kane,R,DET,36,80,27,39,66
65,8479343,Clayton Keller,R,UTA,26,77,25,41,66
65,8473512,Claude Giroux,R,OTT,36,80,21,45,66
65,8477951,Nick Schmaltz,C,UTA,28,76,27,38,65
65,8477504,Josh Morrissey,D,WPG,29,81,17,48,65
65,8471214,Alex Ovechkin,L,WSH,39,69,34,30,64
65,8479675,Trevor Moore,L,LAK,29,79,31,33,64
65,8477409,Carter Verhaeghe,C,FLA,29,78,31,32,63
65,8477960,Adrian Kempe,R,LAK,28,79,29,34,63
65,8484145,Zach Benson,L,BUF,19,66,23,40,63
65,8477500,Bo Horvat,C,NYI,29,80,35,27,62
65,8477511,Anthony Mantha,R,CGY,30,77,31,31,62
65,8477496,Elias Lindholm,C,BOS,30,78,25,37,62
65,8475798,Mikael Granlund,C,SJS,32,75,17,45,62
65,8480803,Evan Bouchard,D,EDM,25,74,12,50,62
65,8476853,Morgan Rielly,D,TOR,30,73,9,53,62
65,8476448,William Karlsson,C,VGK,31,75,29,32,61
65,8471685,Anze Kopitar,C,LAK,37,79,24,37,61
65,8482745,Mason McTavish,C,ANA,21,72,24,37,61
65,8476454,Ryan Nugent-Hopkins,C,EDM,31,77,23,38,61
65,8477940,Nikolaj Ehlers,L,WPG,28,71,23,38,61
65,8484144,Connor Bedard,C,CHI,19,69,22,39,61
65,8471215,Evgeni Malkin,C,PIT,38,74,22,39,61
65,8475765,Vladimir Tarasenko,R,DET,33,76,15,46,61
65,8482684,Luke Hughes,D,NJD,21,69,8,53,61
65,8480014,Gabriel Vilardi,C,WPG,25,72,30,30,60
65,8481540,Cole Caufield,R,MTL,23,80,27,33,60
65,8475786,Zach Hyman,L,EDM,32,78,26,34,60
65,8473419,Brad Marchand,L,BOS,36,79,24,36,60
65,8477451,Ryan Hartman,R,MIN,30,67,23,37,60
65,8474590,John Carlson,D,WSH,34,70,16,44,60
65,8482149,Cole Perfetti,C,WPG,22,74,23,36,59
65,8482110,Dawson Mercer,C,NJD,23,77,20,39,59
65,8477494,Jonathan Drouin,L,COL,29,80,18,41,59
65,8477955,Jared McCann,L,SEA,28,79,26,32,58
65,8476875,Mike Matheson,D,MTL,30,74,10,48,58
65,8480865,Noah Dobson,D,NYI,24,80,9,49,58
65,8475810,Bryan Rust,R,PIT,32,70,31,26,57
65,8477416,Oliver Bjorkstrand,R,SEA,29,74,26,31,57
65,8478519,Anthony Cirelli,C,TBL,27,82,23,34,57
65,8477456,J.T. Compher,L,DET,29,80,23,34,57
65,8470613,Brent Burns,D,CAR,39,78,19,38,57
65,8478038,Devon Toews,D,COL,30,69,12,45,57
65,8475151,Kyle Palmieri,C,NYI,33,80,21,35,56
65,8475793,Ryan Johansen,C,PHI,32,75,26,29,55
65,8482113,Anton Lundell,C,FLA,23,77,25,30,55
65,8474150,Mikael Backlund,C,CGY,35,76,22,33,55
65,8482078,Lucas Raymond,L,DET,22,82,21,34,55
65,8476346,Johnny Gaudreau,L,CBJ,31,70,20,35,55
65,8476389,Vincent Trocheck,C,NYR,31,76,18,37,55
65,8484153,Leo Carlsson,C,ANA,20,70,17,38,55
65,8475191,Reilly Smith,R,NYR,33,76,31,23,54
65,8475169,Evander Kane,L,EDM,33,78,28,26,54
65,8482159,Tyson Foerster,R,PHI,22,77,25,29,54
65,8476882,Teuvo Teravainen,C,CHI,30,69,20,34,54
65,8482665,Matty Beniers,C,SEA,22,76,19,35,54
65,8477346,MacKenzie Weegar,D,CGY,30,75,12,42,54
65,8471724,Kris Letang,D,PIT,37,77,10,44,54
65,8478047,Michael Bunting,L,PIT,29,70,20,33,53
65,8483808,Andrei Kuzmenko,L,CGY,28,74,28,24,52
65,8476483,Rickard Rakell,R,PIT,31,73,27,25,52
65,8477935,Sam Bennett,C,FLA,28,76,25,27,52
65,8475168,Matt Duchene,C,DAL,33,82,24,28,52
65,8477476,Artturi Lehkonen,L,COL,29,81,21,31,52
65,8478493,Joel Eriksson Ek,C,MIN,27,73,20,32,52
65,8480018,Nick Suzuki,C,MTL,25,71,20,32,52
65,8482124,Quinton Byfield,R,LAK,22,78,16,36,52
65,8477503,Max Domi,C,TOR,29,82,13,39,52
65,8478407,Vince Dunn,D,SEA,28,72,9,43,52
65,8474563,Drew Doughty,D,LAK,35,70,9,43,52
65,8476432,Boone Jenner,C,CBJ,31,69,33,18,51
65,8477964,Ivan Barbashev,C,VGK,29,72,27,24,51
65,8480188,Fabian Zetterlund,L,SJS,25,74,25,26,51
65,8479400,Pierre-Luc Dubois,L,WSH,26,68,21,30,51
65,8475745,Charlie Coyle,C,BOS,32,80,20,31,51
65,8475158,Ryan O'Reilly,C,NSH,33,72,17,34,51
65,8482720,Matthew Knies,L,TOR,22,75,17,34,51
65,8476906,Shayne Gostisbehere,D,CAR,31,75,9,42,51
65,8483515,Juraj Slafkovsky,L,MTL,20,75,20,30,50
65,8478873,Troy Terry,R,ANA,27,75,17,33,50
65,8475794,Tyler Seguin,C,DAL,32,81,25,24,49
65,8477407,Anthony Duclair,L,NYI,29,78,23,26,49
65,8480185,Eetu Luostarinen,C,FLA,26,81,22,27,49
65,8476880,Tom Wilson,R,WSH,30,70,22,27,49
65,8478975,Mason Marchment,L,DAL,29,82,18,31,49
65,8478542,Evan Rodrigues,C,FLA,31,73,17,32,49
65,8476462,Dougie Hamilton,D,NJD,31,73,12,37,49
65,8478366,Frank Vatrano,R,ANA,30,73,29,19,48
65,8482699,Dylan Guenther,R,UTA,21,72,28,20,48
65,8475314,Anders Lee,L,NYI,34,79,27,21,48
65,8480015,Owen Tippett,R,PHI,25,75,24,24,48
65,8483431,Logan Cooley,C,UTA,20,76,21,27,48
65,8474679,Gustav Nyquist,C,NSH,35,72,16,32,48
65,8478472,Mathieu Joseph,R,STL,27,70,15,33,48
65,8481542,Moritz Seider,D,DET,23,76,9,39,48
65,8474641,Adam Henrique,C,EDM,34,75,22,25,47
65,8478462,Nicolas Roy,C,VGK,27,76,21,26,47
65,8481528,Dylan Cozens,C,BUF,23,69,19,28,47
65,8476479,Phillip Danault,C,LAK,31,79,18,29,47
65,8481533,Trevor Zegras,C,ANA,23,69,16,31,47
65,8476905,Chandler Stephenson,C,SEA,30,74,15,32,47
65,8481604,Pavel Dorofeyev,L,VGK,24,76,21,25,46
65,8480797,Joel Farabee,L,PHI,24,78,13,33,46
65,8477429,Andrew Copp,C,DET,30,78,13,33,46
65,8476419,Jean-Gabriel Pageau,C,NYI,32,80,11,35,46
65,8478469,Thomas Chabot,D,OTT,27,76,10,36,46
65,8479525,Ross Colton,C,COL,28,80,20,25,45
65,8475784,Jeff Skinner,C,EDM,32,75,18,27,45
65,8484166,Adam Fantilli,C,CBJ,20,72,18,27,45
65,8481596,Shane Pinto,C,OTT,24,73,13,32,45
65,8481186,Logan O'Connor,R,COL,28,78,23,21,44
65,8477998,Warren Foegele,L,LAK,28,78,19,25,44
65,8478438,Tommy Novak,C,NSH,27,72,16,28,44
65,8482097,Jack Quinn,R,BUF,23,65,16,28,44
65,8479339,Patrik Laine,L,CBJ,26,61,15,29,44
65,8478458,John (Jack) Roslovic,C,CAR,27,65,14,30,44
65,8482671,Owen Power,D,BUF,22,71,13,31,44
65,8477426,Nicholas Paul,L,TBL,29,82,22,21,43
65,8477479,Tyler Bertuzzi,L,CHI,29,63,20,23,43
65,8478042,Viktor Arvidsson,L,EDM,31,77,18,25,43
65,8480028,Morgan Frost,C,PHI,25,78,14,29,43
65,8476792,Torey Krug,D,STL,33,67,13,30,43
65,8476869,Brady Skjei,D,NSH,30,72,13,30,43
65,8477447,Shea Theodore,D,VGK,29,66,9,34,43
65,8475170,Brayden Schenn,C,STL,33,68,23,19,42
65,8478115,Pierre Engvall,L,NYI,28,78,19,23,42
65,8471698,T.J. Oshie,R,WSH,38,72,19,23,42
65,8481711,Matias Maccelli,L,UTA,24,71,14,28,42
65,8477495,Seth Jones,D,CHI,30,70,11,31,42
65,8482475,Yegor Chinakhov,R,CBJ,23,64,11,31,42
65,8478397,Rasmus Andersson,D,CGY,28,71,9,33,42
65,8477021,Alex Kerfoot,C,UTA,30,74,9,33,42
65,8479345,Jakob Chychrun,D,WSH,26,68,8,34,42
65,8480064,Josh Norris,C,OTT,25,72,24,17,41
65,8478498,Jake DeBrusk,L,VAN,28,73,23,18,41
65,8479992,Michael Rasmussen,C,DET,25,81,21,20,41
65,8475848,Brendan Gallagher,R,MTL,32,73,20,21,41
65,8478233,Andrew Mangiapane,L,WSH,28,72,19,22,41
65,8478474,Lawson Crouse,L,UTA,27,73,19,22,41
65,8473986,Alex Killorn,L,ANA,35,68,16,25,41
65,8481577,Philip Tomasino,C,NSH,23,71,16,25,41
65,8480798,Philipp Kurashev,C,CHI,25,67,8,33,41
65,8482712,Oskar Olausson,R,COL,22,80,8,33,41
65,8474151,Ryan McDonagh,D,TBL,35,77,2,39,41
65,8480009,Eeli Tolvanen,R,SEA,25,76,21,19,40
65,8482667,William Eklund,L,SJS,22,68,20,20,40
65,8474102,David Perron,L,OTT,36,73,16,24,40
65,8477498,Darnell Nurse,D,EDM,29,74,12,28,40
65,8476958,Jaccob Slavin,D,CAR,30,75,4,36,40
65,8479425,Filip Hronek,D,VAN,27,74,3,37,40
65,8475726,Tyler Toffoli,C,SJS,32,63,25,14,39
65,8478463,Anthony Beauvillier,L,PIT,27,66,22,17,39
65,8476438,Brandon Saad,L,STL,32,72,21,18,39
65,8482055,Drew O'Connor,L,PIT,26,62,19,20,39
65,8476292,Ondrej Palat,L,NJD,33,69,15,24,39
65,8480113,Alex Iafallo,L,WPG,31,63,15,24,39
65,8484203,Bradly Nadeau,L,CAR,19,70,14,25,39
65,8477505,Alexander Wennberg,C,SJS,30,62,13,26,39
65,8475753,Justin Faulk,D,STL,32,72,12,27,39
65,8480434,Sean Durzi,D,UTA,26,70,12,27,39
65,8481581,Thomas Harley,D,DAL,23,74,12,27,39
65,8478396,Noah Hanifin,D,VGK,27,60,8,31,39
65,8476979,Erik Gustafsson,D,DET,32,76,6,33,39
65,8482146,Luke Evangelista,R,NSH,22,69,22,16,38
65,8474715,Cameron Atkinson,R,TBL,35,81,21,17,38
65,8482109,Alexis Lafrenière,L,NYR,23,73,18,20,38
65,8474716,Jared Spurgeon,D,MIN,35,78,17,21,38
65,8476921,Jordan Martinook,L,CAR,32,65,16,22,38
65,8480802,Ryan McLeod,C,BUF,25,66,16,22,38
65,8478856,Conor Garland,R,VAN,28,71,15,23,38
65,8483505,Matthew Poitras,C,BOS,20,68,11,27,38
65,8481523,Kirby Dach,C,MTL,23,73,11,27,38
65,8480145,Neal Pionk,D,WPG,29,69,10,28,38
65,8474565,Alex Pietrangelo,D,VGK,34,60,8,30,38
65,8475287,Erik Haula,L,NJD,33,70,21,16,37
65,8481554,Kaapo Kakko,R,NYR,23,70,19,18,37
65,8477497,Sean Monahan,C,CBJ,30,68,18,19,37
65,8478046,Danton Heinen,L,VAN,29,67,17,20,37
65,8477953,Kasperi Kapanen,R,STL,28,68,17,20,37
65,8479987,Morgan Geekie,C,BOS,26,75,17,20,37
65,8476458,Ryan Strome,C,ANA,31,66,15,22,37
65,8477425,Miles Wood,L,COL,29,77,13,24,37
65,8477986,Brandon Montour,D,SEA,30,72,12,25,37
65,8475200,Dmitry Orlov,D,CAR,33,75,6,31,37
65,8480336,Sean Walker,D,CAR,30,73,6,31,37
65,8476474,Stefan Noesen,R,NJD,31,62,15,21,36
65,8476925,Colton Sissons,C,NSH,31,64,15,21,36
65,8473994,Jamie Benn,L,DAL,35,81,14,22,36
65,8482702,Logan Stankoven,C,DAL,21,80,14,22,36
65,8482705,Cole Sillinger,C,CBJ,21,62,14,22,36
65,8482105,Jake Sanderson,D,OTT,22,75,13,23,36
65,8477488,Brett Pesce,D,NJD,30,70,11,25,36
65,8475714,Calle Jarnkrok,C,TOR,33,77,19,16,35
65,8475799,Nino Niederreiter,R,WPG,32,64,18,17,35
65,8481618,Alex Newhook,C,MTL,23,76,18,17,35
65,8475722,Jason Zucker,L,BUF,32,64,18,17,35
65,8480459,Pius Suter,C,VAN,28,66,18,17,35
65,8474149,Evgenii Dadonov,R,DAL,35,82,17,18,35
65,8482092,Ridly Greig,C,OTT,22,77,14,21,35
65,8475763,Kevin Hayes,R,PIT,32,69,14,21,35
65,8474053,Logan Couture,C,SJS,35,63,12,23,35
65,8476927,Teddy Blueger,C,VAN,30,65,12,23,35
65,8482079,Marco Rossi,C,MIN,23,56,12,23,35
65,8474586,Jordan Eberle,R,SEA,34,67,8,27,35
65,8479365,Trent Frederic,C,BOS,26,75,17,17,34
65,8473422,Nick Foligno,L,CHI,37,68,16,18,34
65,8480829,Jesperi Kotkaniemi,C,CAR,24,59,15,19,34
65,8478413,Jordan Greenway,L,BUF,27,67,14,20,34
65,8478055,Gustav Forsling,D,FLA,28,70,9,25,34
65,8477969,Marcus Pettersson,D,PIT,28,76,7,27,34
65,8475764,Cam Fowler,D,ANA,33,77,2,32,34
65,8475768,Jaden Schwartz,C,SEA,32,73,18,15,33
65,8481560,Arthur Kaliyev,R,LAK,23,76,16,17,33
65,8473533,Jordan Staal,C,CAR,36,55,16,17,33
65,8478891,Mason Appleton,C,WPG,28,63,15,18,33
65,8482624,Daniil Miromanov,D,CGY,27,61,14,19,33
65,8482660,Kent Johnson,C,CBJ,22,67,13,20,33
65,8480078,Filip Chytil,C,NYR,25,68,12,21,33
65,8477932,Aaron Ekblad,D,FLA,28,72,8,25,33
65,8476917,Adam Pelech,D,NYI,30,77,7,26,33
65,8475171,Oliver Ekman-Larsson,D,TOR,33,69,4,29,33
65,8475760,Nick Bjugstad,C,UTA,32,71,19,13,32
65,8482175,JJ Peterka,R,BUF,22,67,18,14,32
65,8477952,Robby Fabbri,C,ANA,28,67,17,15,32
65,8480849,Barrett Hayton,C,UTA,24,71,16,16,32
65,8475343,Nic Dowd,C,WSH,34,65,15,17,32
65,8476826,Yanni Gourde,C,SEA,33,67,14,18,32
65,8479591,Michael Eyssimont,C,TBL,28,80,13,19,32
65,8478466,Daniel Sprong,R,VAN,27,66,12,20,32
65,8476923,Damon Severson,D,CBJ,30,80,5,27,32
65,8481582,Nicholas Robertson,L,TOR,23,66,17,14,31
65,8482679,Matt Coronato,R,CGY,22,67,14,17,31
65,8478057,Dakota Joshua,C,VAN,28,70,13,18,31
65,8479398,Samuel Girard,D,COL,26,63,9,22,31
65,8482133,Thomas Bordeleau,C,SJS,22,63,9,22,31
65,8477839,Conor Sheary,L,TBL,32,81,7,24,31
65,8480817,K'Andre Miller,D,NYR,24,69,7,24,31
65,8478500,Ivan Provorov,D,CBJ,27,79,6,25,31
65,8480043,Timothy Liljegren,D,TOR,25,59,3,28,31
65,8480068,Ryan Poehling,C,PHI,25,72,16,14,30
65,8477947,Sonny Milano,L,WSH,28,66,14,16,30
65,8476897,Oskar Sundqvist,C,STL,30,70,14,16,30
65,8477478,William Carrier,L,CAR,30,59,14,16,30
65,8477989,Christian Dvorak,C,MTL,28,66,10,20,30
65,8480003,Jesper Boqvist,C,FLA,26,67,10,20,30
65,8476872,Scott Laughton,C,PHI,30,72,9,21,30
65,8477948,Travis Sanheim,D,PHI,28,66,8,22,30
65,8476854,Hampus Lindholm,D,BOS,30,73,7,23,30
65,8479410,Mikhail Sergachev,D,UTA,26,66,5,25,30
65,8482737,Zack Bolduc,C,STL,21,58,17,12,29
65,8480835,Jack Drury,C,CAR,24,52,12,17,29
65,8475149,Marcus Johansson,L,MIN,34,64,11,18,29
65,8482067,Connor Mackey,D,NYR,28,63,7,22,29
65,8483490,Pavel Mintyukov,D,ANA,21,69,7,22,29
65,8476856,Mathew Dumba,D,DAL,30,72,6,23,29
65,8476960,Andreas Athanasiou,C,CHI,30,55,17,11,28
65,8476392,Adam Lowry,C,WPG,31,65,15,13,28
65,8483524,Shane Wright,C,SEA,20,63,15,13,28
65,8481524,Bowen Byram,D,BUF,23,69,12,16,28
65,8478432,Christian Fischer,R,DET,27,74,10,18,28
65,8476918,Jimmy Vesey,L,NYR,31,68,10,18,28
65,8475791,Taylor Hall,L,CHI,33,59,9,19,28
65,8475231,Casey Cizikas,C,NYI,33,74,9,19,28
65,8477506,Ryan Pulock,D,NYI,30,80,7,21,28
65,8473563,Nicklas Backstrom,C,WSH,37,55,5,23,28
65,8477365,Connor Clifton,D,BUF,29,58,5,23,28
65,8482122,Brock Faber,D,MIN,22,76,4,24,28
65,8478109,Victor Olofsson,L,VGK,29,64,17,10,27
65,8480220,Noah Cates,L,PHI,25,66,14,13,27
65,8482259,Bobby McMann,C,TOR,28,68,13,14,27
65,8481656,Aliaksei Protas,C,WSH,23,69,11,16,27
65,8478970,Jalen Chatfield,D,CAR,28,71,9,18,27
65,8479982,Conor Timmins,D,TOR,26,67,9,18,27
65,8478133,Jake Evans,C,MTL,28,70,6,21,27
65,8481546,Cam York,D,PHI,23,69,3,24,27
65,8481535,Nils Hoglander,L,VAN,24,63,17,9,26
65,8481601,Simon Holmstrom,R,NYI,23,70,13,13,26
65,8481032,Paul Cotter,C,NJD,25,65,13,13,26
65,8482117,Lukas Reichel,L,CHI,22,53,11,15,26
65,8479293,Brandon Tanev,L,SEA,33,62,10,16,26
65,8482111,Justin Barron,D,MTL,23,64,10,16,26
65,8475218,Mattias Ekholm,D,EDM,34,72,8,18,26
65,8479353,Brett Howden,C,VGK,26,67,6,20,26
65,8481606,Jordan Spence,D,LAK,23,69,6,20,26
65,8478507,John Marino,D,UTA,27,69,5,21,26
65,8480873,Rasmus Sandin,D,WSH,24,58,2,24,26
65,8476822,Luke Glendening,C,TBL,35,78,13,12,25
65,8480205,Emil Bemstrom,C,PIT,25,60,10,15,25
65,8477444,Andre Burakovsky,L,SEA,29,65,9,16,25
65,8476461,Sean Couturier,C,PHI,32,67,9,16,25
65,8481553,Bobby Brink,R,PHI,23,60,9,16,25
65,8480144,David Kampf,C,TOR,29,67,9,16,25
65,8477220,Nate Schmidt,D,FLA,33,67,9,16,25
65,8478013,Jake Walman,D,SJS,28,70,8,17,25
65,8477353,Tyler Motte,C,DET,29,71,8,17,25
65,8480871,Adam Boqvist,D,FLA,24,71,7,18,25
65,8477508,Curtis Lazar,C,NJD,29,49,15,9,24
65,8476981,Josh Anderson,R,MTL,30,71,14,10,24
65,8478020,Michael Amadio,R,OTT,28,73,11,13,24
65,8481624,Ilya Mikheyev,R,CHI,30,62,11,13,24
65,8479393,Noah Gregor,L,OTT,26,72,11,13,24
65,8479996,Cody Glass,C,NSH,25,60,10,14,24
65,8479661,Tanner Jeannot,L,LAK,27,78,10,14,24
65,8483491,Ivan Miroshnichenko,L,WSH,20,59,10,14,24
65,8480806,Isac Lundestrom,C,ANA,25,64,10,14,24
65,8476885,Jacob Trouba,D,NYR,30,72,8,16,24
65,8483445,Cutter Gauthier,L,ANA,20,62,8,16,24
65,8480855,Jack McBain,C,UTA,24,71,8,16,24
65,8482809,Jackson Blake,R,CAR,21,59,7,17,24
65,8480049,Dylan Samberg,D,WPG,25,70,4,20,24
65,8482655,Janis Moser,D,TBL,24,78,4,20,24
65,8477435,Ryan Graves,D,PIT,29,73,4,20,24
65,8476892,Colton Parayko,D,STL,31,74,3,21,24
65,8480878,Nils Lundkvist,D,DAL,24,77,3,21,24
65,8475179,Dmitry Kulikov,D,FLA,34,62,3,21,24
65,8482089,Jake Neighbours,L,STL,22,61,15,8,23
65,8476278,Colin Blackwell,C,DAL,31,80,13,10,23
65,8479941,Justin Danforth,R,CBJ,31,57,12,11,23
65,8480789,Oliver Wahlstrom,R,NYI,24,67,12,11,23
65,8479351,Sam Steel,C,DAL,26,80,11,12,23
65,8482803,Olen Zellweger,D,ANA,21,70,11,12,23
65,8479315,Joey Anderson,R,CHI,26,47,9,14,23
65,8480813,Joe Veleno,C,DET,24,77,9,14,23
65,8477446,Michael McCarron,R,NSH,29,51,9,14,23
65,8477979,Nicolas Aube-Kubel,R,BUF,28,60,9,14,23
65,8476463,Jonas Brodin,D,MIN,31,76,6,17,23
65,8479402,Jake Bean,D,CGY,26,64,3,20,23
65,8481703,Valtteri Puustinen,R,PIT,25,63,2,21,23
65,8470621,Corey Perry,R,EDM,39,71,12,10,22
65,8479520,Brandon Duhaime,R,WSH,27,56,9,13,22
65,8476480,Vladislav Namestnikov,C,WPG,32,67,8,14,22
65,8480748,Kiefer Sherwood,L,VAN,29,61,8,14,22
65,8476457,Adam Larsson,D,SEA,32,74,6,16,22
65,8478911,Matt Roy,D,WSH,29,68,5,17,22
65,8476467,Jamie Oleksiak,D,SEA,32,72,5,17,22
65,8474673,TJ Brodie,D,CHI,34,65,2,20,22
65,8476331,Dylan DeMelo,D,WPG,31,70,1,21,22
65,8480893,Kirill Marchenko,R,CBJ,24,62,12,9,21
65,8477392,Hudson Fasching,R,NYI,29,60,11,10,21
65,8481704,Juuso Parssinen,C,NSH,23,57,10,11,21
65,8482148,Hendrix Lapierre,C,WSH,22,45,10,11,21
65,8475193,Tomas Tatar,L,NJD,34,68,9,12,21
65,8476469,Joel Armia,R,MTL,31,58,9,12,21
65,8481481,Blake Lizotte,C,PIT,27,58,8,13,21
65,8483482,Tristan Luneau,D,ANA,20,60,8,13,21
65,8478882,Vladislav Gavrikov,D,LAK,29,61,7,14,21
65,8480950,Ilya Lyubushkin,D,DAL,30,57,7,14,21
65,8477919,Frederick Gaudreau,C,MIN,31,61,6,15,21
65,8482176,Wyatt Kaiser,D,CHI,22,57,6,15,21
65,8479639,Dylan Coghlan,D,WPG,26,58,5,16,21
65,8478178,Darren Raddysh,D,TBL,28,66,4,17,21
65,8481059,Scott Perunovich,D,STL,26,70,1,20,21
65,8480074,Alexandre Texier,C,STL,25,55,10,10,20
65,8479390,Taylor Raddysh,R,WSH,26,60,9,11,20
65,8477406,Mattias Janmark,C,EDM,32,60,9,11,20
65,8482157,Will Cuylle,L,NYR,22,60,9,11,20
65,8477015,Connor Brown,R,EDM,30,64,8,12,20
65,8477903,Garnet Hathaway,R,PHI,33,60,8,12,20
65,8477450,Jason Dickinson,C,CHI,29,50,7,13,20
65,8481014,Alexander Romanov,D,NYI,24,79,6,14,20
65,8483457,Lane Hutson,D,MTL,20,72,6,14,20
65,8479369,Andrew Peeke,D,BOS,26,64,5,15,20
65,8479324,Ryan Lindgren,D,NYR,26,70,4,16,20
65,8475181,Nick Leddy,D,STL,33,67,3,17,20
65,8476422,Mike Reilly,D,NYI,31,76,3,17,20
65,8477369,Carson Soucy,D,VAN,30,61,3,17,20
65,8476879,Cody Ceci,D,EDM,31,71,1,19,20
65,8478569,Noel Acciari,C,PIT,33,55,13,6,19
65,8482074,Connor Zary,C,CGY,23,60,11,8,19
65,8482125,Alexander Holtz,R,VGK,22,72,10,9,19
65,8475855,Jesper Fast,R,CAR,33,58,9,10,19
65,8482155,Alex Laferriere,R,LAK,23,61,9,10,19
65,8480289,Morgan Barron,C,WPG,26,49,9,10,19
65,8477987,Ryan Donato,C,CHI,28,55,7,12,19
65,8483565,Nick Blankenburg,D,NSH,26,60,7,12,19
65,8476312,Josh Manson,D,COL,33,60,7,12,19
65,8477499,Rasmus Ristolainen,D,PHI,30,58,7,12,19
65,8478211,Dryden Hunt,L,CGY,29,59,5,14,19
65,8478416,Erik Cernak,D,TBL,27,71,4,15,19
65,8480246,Nick Perbix,D,TBL,26,75,3,16,19
65,8475188,Brayden McNabb,D,VGK,33,54,2,17,19
65,8481093,Rafael Harvey-Pinard,L,MTL,25,61,9,9,18
65,8476374,Sean Kuraly,C,CBJ,31,50,8,10,18
65,8478434,Keegan Kolesar,R,VGK,27,65,8,10,18
65,8479066,Ryan Lomberg,L,CGY,30,65,8,10,18
65,8480073,Erik Brannstrom,D,COL,25,59,7,11,18
65,8479359,Beck Malenstyn,L,BUF,26,45,7,11,18
65,8480807,Mattias Samuelsson,D,BUF,24,56,7,11,18
65,8474189,Lars Eller,C,PIT,35,55,6,12,18
65,8483468,Jiri Kulich,C,BUF,20,54,6,12,18
65,8476329,Travis Boyd,C,MIN,31,60,6,12,18
65,8482749,Joshua Roy,R,MTL,21,63,6,12,18
65,8480011,Klim Kostin,C,SJS,25,48,6,12,18
65,8479998,Mikey Anderson,D,LAK,25,65,4,14,18
65,8476525,Colin Miller,D,WPG,32,53,3,15,18
65,8479980,Nicolas Hague,D,VGK,26,50,3,15,18
65,8481178,Egor Zamula,D,PHI,24,65,3,15,18
65,8476429,Scott Mayfield,D,NYI,32,74,3,15,18
65,8475790,Erik Gudbranson,D,CBJ,32,78,1,17,18
65,8475690,Chris Tanev,D,TOR,35,64,1,17,18
65,8479983,Mario Ferraro,D,SJS,26,73,1,17,18
65,8480448,Parker Kelly,L,COL,25,69,12,5,17
65,8479368,Max Jones,L,BOS,26,61,11,6,17
65,8480281,Alexey Toropchenko,R,STL,25,54,11,6,17
65,8479968,Vinni Lettieri,C,BOS,29,52,11,6,17
65,8479336,Carl Grundstrom,R,SJS,27,46,10,7,17
65,8481517,Brett Leason,R,ANA,25,63,10,7,17
65,8478585,Derek Ryan,C,EDM,38,61,9,8,17
65,8479344,Jesse Puljujarvi,R,PIT,26,51,9,8,17
65,8479439,Jacob MacDonald,D,COL,31,56,9,8,17
65,8479328,Julien Gauthier,R,NYI,27,54,8,9,17
65,8477931,Tomas Nosek,L,FLA,32,56,7,10,17
65,8476889,Radek Faksa,C,STL,30,60,7,10,17
65,8478043,Sam Lafferty,C,BUF,29,57,6,11,17
65,8479543,Michael Pezzetta,L,MTL,26,49,6,11,17
65,8475220,Marcus Foligno,L,MIN,33,62,5,12,17
65,8480796,Martin Fehervary,D,WSH,25,51,5,12,17
65,8480222,Sebastian Aho,D,PIT,28,76,5,12,17
65,8478451,Ethan Bear,D,WSH,27,48,5,12,17
65,8481527,Kaedan Korczak,D,VGK,23,53,4,13,17
65,8476902,Esa Lindell,D,DAL,30,72,4,13,17
65,8475324,Nick Jensen,D,OTT,34,66,3,14,17
65,8479291,Kevin Rooney,C,CGY,31,50,3,14,17
65,8478443,Brandon Carlo,D,BOS,28,58,3,14,17
65,8480070,Ian Mitchell,D,BOS,25,49,3,14,17
65,8475233,David Savard,D,MTL,34,54,2,15,17
65,8473446,Erik Johnson,D,PHI,36,50,2,15,17
65,8477018,Ben Hutton,D,VGK,31,49,1,16,17
65,8478851,Alexandre Carrier,D,NSH,28,57,0,17,17
65,8481580,Connor McMichael,C,WSH,23,60,9,7,16
65,8479316,Luke Kunin,C,SJS,27,55,8,8,16
65,8476878,Zemgus Girgensons,C,TBL,30,78,7,9,16
65,8473453,Trevor Lewis,C,LAK,37,72,7,9,16
65,8481013,Jonatan Berggren,R,DET,24,62,7,9,16
65,8483499,Liam Ohgren,L,MIN,20,49,6,10,16
65,8481521,Ronnie Attard,D,PHI,25,57,6,10,16
65,8480980,Connor Dewar,C,TOR,25,64,6,10,16
65,8477380,Jonny Brodzinski,C,NYR,31,55,5,11,16
65,8483495,Simon Nemec,D,NJD,20,52,5,11,16
65,8480172,Jan Rutta,D,SJS,34,63,5,11,16
65,8482101,Danil Gushchin,L,SJS,22,56,4,12,16
65,8482142,Jamie Drysdale,D,PHI,22,56,4,12,16
65,8473507,Jeff Petry,D,DET,37,75,4,12,16
65,8482192,Isaak Phillips,D,CHI,23,53,3,13,16
65,8480891,Michael Kesselring,D,UTA,24,63,2,14,16
65,8476931,Jake McCabe,D,TOR,31,62,2,14,16
65,8482073,Braden Schneider,D,NYR,23,59,2,14,16
65,8477845,Trevor van Riemsdyk,D,WSH,33,62,2,14,16
65,8475718,Justin Holl,D,DET,32,55,2,14,16
65,8479371,Dante Fabbro,D,NSH,26,58,1,15,16
65,8478840,Will Borgen,D,SEA,28,70,0,16,16
65,8480252,Cole Guttman,C,CHI,25,38,9,6,15
65,8482666,Scott Morrow,D,CAR,22,45,9,6,15
65,8480995,Pontus Holmberg,R,TOR,25,56,8,7,15
65,8481441,Joe Snively,C,DET,28,63,8,7,15
65,8480021,Jack Studnicka,C,LAK,25,64,8,7,15
65,8482062,Cole Smith,L,NSH,29,61,8,7,15
65,8482784,Zach Dean,C,STL,21,47,8,7,15
65,8478831,Kevin Stenlund,C,UTA,28,54,7,8,15
65,8479414,Nathan Bastian,R,NJD,27,61,7,8,15
65,8481550,Adam Beckman,L,NJD,23,37,6,9,15
65,8482087,Kaiden Guhle,D,MTL,22,71,5,10,15
65,8475279,Ben Chiarot,D,DET,33,72,5,10,15
65,8477335,Kyle Burroughs,D,LAK,29,45,5,10,15
65,8479026,Philippe Myers,D,TOR,27,48,4,11,15
65,8480879,Jacob Bernard-Docker,D,OTT,24,46,3,12,15
65,8481708,Zac Jones,D,NYR,24,48,3,12,15
65,8479976,Juuso Valimaki,D,UTA,26,58,2,13,15
65,8470600,Ryan Suter,D,STL,39,59,2,13,15
65,8481716,Dmitri Voronkov,L,CBJ,24,44,10,4,14
65,8481522,Peyton Krebs,C,BUF,23,59,8,6,14
65,8482166,Shakir Mukhamadullin,D,SJS,22,57,8,6,14
65,8476624,Barclay Goodrow,C,SJS,31,60,7,7,14
65,8480355,Mark Kastelic,C,BOS,25,51,7,7,14
65,8476934,Brock McGinn,L,ANA,30,50,6,8,14
65,8484149,Gavin Brindley,C,CBJ,20,49,6,8,14
65,8479671,Mathieu Olivier,R,CBJ,27,46,6,8,14
65,8480058,Pierre-Olivier Joseph,D,STL,25,53,5,9,14
65,8480762,Eric Robinson,L,CAR,29,61,5,9,14
65,8483466,Kevin Korchinski,D,CHI,20,50,5,9,14
65,8476867,Brendan Gaunce,C,MIN,30,39,5,9,14
65,8477507,Nikita Zadorov,D,BOS,29,58,4,10,14
65,8476873,Mark Jankowski,C,NSH,30,53,4,10,14
65,8480007,Jonas Rondbjerg,R,VGK,25,37,4,10,14
65,8474090,Brendan Smith,D,DAL,35,50,3,11,14
65,8481600,Tobias Bjornfot,D,FLA,23,37,3,11,14
65,8475455,Brenden Dillon,D,NJD,34,59,2,12,14
65,8475208,Brian Dumoulin,D,ANA,33,65,1,13,14
65,8478452,Caleb Jones,D,LAK,27,49,1,13,14
65,8476988,Matt Benning,D,SJS,30,67,1,13,14
65,8481568,Alex Vlasic,D,CHI,23,48,0,14,14
65,8481518,Nolan Foote,L,NJD,24,41,9,4,13
65,8478421,A.J. Greer,L,FLA,28,58,8,5,13
65,8481477,Nico Sturm,C,SJS,29,50,7,6,13
65,8475842,Sam Carrick,C,NYR,32,65,5,8,13
65,8480192,Johnathan Kovacevic,D,NJD,27,54,4,9,13
65,8479372,Joshua Mahura,D,SEA,26,49,4,9,13
65,8478454,Noah Juulsen,D,VAN,27,37,4,9,13
65,8474034,Patrick Maroon,L,CHI,36,55,4,9,13
65,8480157,Calle Rosen,D,COL,30,56,4,9,13
65,8481028,Martin Pospisil,C,CGY,25,50,2,11,13
65,8480001,Urho Vaakanainen,D,ANA,25,61,2,11,13
65,8474612,Travis Hamonic,D,OTT,34,46,2,11,13
65,8475177,Calvin de Haan,D,COL,33,42,2,11,13
65,8476967,Brett Kulak,D,EDM,30,65,1,12,13
65,8482245,Artem Zub,D,OTT,29,65,1,12,13
65,8474567,Zach Bogosian,D,MIN,34,63,1,12,13
65,8482762,Simon Edvinsson,D,DET,21,57,8,4,12
65,8482730,Brandt Clarke,D,LAK,21,55,7,5,12
65,8479718,Alex Barré-Boulet,C,MTL,27,45,6,6,12
65,8480025,MacKenzie Entwistle,R,FLA,25,59,6,6,12
65,8475462,Radko Gudas,D,ANA,34,65,3,9,12
65,8481567,Henry Thrun,D,SJS,23,48,3,9,12
65,8478399,Jonas Siegenthaler,D,NJD,27,62,0,12,12
65,8479619,Michael Carcone,L,UTA,28,60,7,4,11
65,8477482,Zachary Sanford,L,CHI,30,36,7,4,11
65,8483493,Frank Nazar,C,CHI,20,50,6,5,11
65,8482634,Alex Steeves,C,TOR,25,50,6,5,11
65,8481641,Joel Kiviranta,L,COL,28,67,6,5,11
65,8479638,Justin Brazeau,R,BOS,26,31,5,6,11
65,8474574,Tyler Myers,D,VAN,34,68,4,7,11
65,8480848,Ty Dellandrea,C,SJS,24,34,4,7,11
65,8480441,Trey Fix-Wolansky,R,CBJ,25,38,4,7,11
65,8478508,Yakov Trenin,C,MIN,27,57,3,8,11
65,8481019,David Gustafsson,C,WPG,24,38,3,8,11
65,8475225,Craig Smith,C,CHI,35,52,3,8,11
65,8474013,Ian Cole,D,UTA,35,46,3,8,11
65,8479378,Logan Stanley,D,WPG,26,47,3,8,11
65,8481599,Victor Soderstrom,D,UTA,23,45,3,8,11
65,8476441,Joel Edmundson,D,LAK,31,44,2,9,11
65,8480035,Henri Jokiharju,D,BUF,25,59,1,10,11
65,8477573,Nathan Walker,L,STL,30,57,1,10,11
65,8478859,Niko Mikkola,D,FLA,28,58,0,11,11
65,8476858,Phillip Di Giuseppe,L,VAN,31,41,8,2,10
65,8482496,Nils Aman,C,VAN,24,44,7,3,10
65,8479972,Mason Shaw,C,WPG,26,35,4,6,10
65,8477938,Haydn Fleury,D,WPG,28,44,4,6,10
65,8480860,Kevin Bahl,D,CGY,24,62,3,7,10
65,8479986,Kole Lind,R,DAL,26,43,3,7,10
65,8480845,Rasmus Kupari,C,WPG,24,52,2,8,10
65,8471709,Marc-Edouard Vlasic,D,SJS,37,58,1,9,10
65,8480196,Jacob Bryson,D,BUF,27,41,1,9,10
65,8484254,Akito Hirose,D,VAN,25,48,0,10,10
65,8482807,Ethan Del Mastro,D,CHI,21,48,7,2,9
65,8482659,Josh Doan,R,UTA,22,52,5,4,9
65,8481617,Vasily Podkolzin,R,VAN,23,54,5,4,9
65,8481532,Alex Turcotte,C,LAK,23,48,5,4,9
65,8479944,Zach Aston-Reese,C,VGK,30,45,5,4,9
65,8475235,Nicolas Deslauriers,L,PHI,33,58,4,5,9
65,8475958,Michael Sgarbossa,C,WSH,32,24,4,5,9
65,8479536,Axel Jonsson-Fjallby,L,WPG,26,40,4,5,9
65,8476994,Vinnie Hinostroza,C,NSH,30,43,3,6,9
65,8481751,Lukas Rousek,R,BUF,25,46,3,6,9
65,8481701,Santeri Hatakka,D,NJD,23,37,3,6,9
65,8477887,Patrick Brown,C,BOS,32,52,3,6,9
65,8478017,Mark Friedman,D,VAN,29,41,3,6,9
65,8479370,Tyson Jost,C,CAR,26,51,3,6,9
65,8480245,Olle Lycksell,R,PHI,25,26,3,6,9
65,8481167,Brayden Pachal,D,CGY,25,47,3,6,9
65,8477462,Robert Hagg,D,VGK,29,26,3,6,9
65,8476891,Matthew Grzelcyk,D,PIT,30,76,2,7,9
65,8478136,Jake Middleton,D,MIN,28,70,2,7,9
65,8477034,Jaycob Megna,D,FLA,32,50,2,7,9
65,8476952,Dominic Toninato,C,WPG,30,35,1,8,9
65,8479348,Kale Clague,D,BUF,26,34,1,8,9
65,8477962,Brendan Lemieux,L,CAR,28,46,1,8,9
65,8479249,Andrew Poturalski,C,SJS,30,35,0,9,9
65,8482744,James Malatesta,L,CBJ,21,53,5,3,8
65,8481679,Maxence Guenette,D,OTT,23,34,5,3,8
65,8482095,Tyler Kleven,D,OTT,22,44,3,5,8
65,8481161,Jake Christiansen,D,CBJ,25,56,3,5,8
65,8482451,Mikael Pyyhtia,L,CBJ,23,43,3,5,8
65,8476442,Matt Nieto,L,PIT,32,48,3,5,8
65,8479981,Jonah Gadjovich,L,FLA,26,44,3,5,8
65,8482733,Logan Mailloux,D,MTL,31,34,3,5,8
65,8482713,Mackie Samoskevich,R,FLA,22,41,3,5,8
65,8477244,Chad Ruhwedel,D,NYR,34,30,3,5,8
65,8481537,Nikita Okhotiuk,D,CGY,24,51,2,6,8
65,8482859,Zack Ostapchuk,C,OTT,21,57,2,6,8
65,8474166,Alec Martinez,D,CHI,37,48,2,6,8
65,8478146,Matthew Highmore,C,OTT,28,35,2,6,8
65,8483619,Filip Roos,D,OTT,25,40,2,6,8
65,8481592,Jakob Pelletier,L,CGY,23,39,1,7,8
65,8481122,Simon Benoit,D,TOR,26,37,1,7,8
65,8482070,Mitchell Chaffee,R,TBL,26,46,6,1,7
65,8471817,Ryan Reaves,R,TOR,37,51,4,3,7
65,8482751,Ryan Winterton,C,SEA,21,37,4,3,7
65,8481609,Vladislav Kolyachonok,D,UTA,23,37,4,3,7
65,8478874,Adam Gaudette,R,OTT,28,36,4,3,7
65,8482077,Dylan Holloway,L,EDM,23,44,3,4,7
65,8476372,Nick Seeler,D,PHI,31,41,3,4,7
65,8480990,Declan Chisholm,D,MIN,24,37,3,4,7
65,8480844,Grigori Denisenko,L,VGK,24,33,3,4,7
65,8480890,Jan Jenik,C,OTT,24,31,3,4,7
65,8481543,Nikita Alexandrov,C,STL,24,23,3,4,7
65,8474568,Luke Schenn,D,NSH,35,58,2,5,7
65,8475762,Derek Forbort,D,VAN,32,41,2,5,7
65,8482250,Callahan Burke,C,VGK,27,26,2,5,7
65,8477070,Liam O'Brien,C,UTA,30,54,1,6,7
65,8483549,Lucas Condotta,L,MTL,27,36,1,6,7
65,8480834,Ty Emberson,D,SJS,24,32,1,6,7
65,8476874,Olli Maatta,D,DET,30,60,0,7,7
65,8478468,Jeremy Lauzon,D,NSH,27,56,0,7,7
65,8480887,Jordan Harris,D,MTL,24,57,0,7,7
65,8481605,Jackson LaCombe,D,ANA,23,25,0,7,7
65,8479994,Jaret Anderson-Dolan,C,WPG,25,36,4,2,6
65,8477851,Jordan Oesterle,D,BOS,32,46,4,2,6
65,8481754,Nikita Nesterenko,C,ANA,23,31,4,2,6
65,8481789,Tye Kartye,L,SEA,23,34,4,2,6
65,8481147,Reese Johnson,C,MIN,26,40,3,3,6
65,8482201,Gage Goncalves,C,TBL,23,30,3,3,6
65,8484911,Collin Graf,R,SJS,22,42,3,3,6
65,8478424,Jansen Harkins,C,ANA,27,39,3,3,6
65,8482964,Arber Xhekaj,D,MTL,23,40,2,4,6
65,8481556,John Beecher,C,BOS,23,36,2,4,6
65,8477971,Andreas Englund,D,LAK,28,28,2,4,6
65,8479991,Jake Leschyshyn,C,NYR,25,27,2,4,6
65,8481598,Philip Broberg,D,EDM,23,38,1,5,6
65,8479442,Troy Stecher,D,EDM,30,56,1,5,6
65,8475750,Jon Merrill,D,MIN,32,61,1,5,6
65,8477073,Kurtis MacDermid,L,NJD,30,28,1,5,6
65,8479772,Zack MacEwen,R,OTT,28,50,1,5,6
65,8482141,Lukas Cormier,D,VGK,22,25,1,5,6
65,8480727,Zach Whitecloud,D,VGK,28,49,0,6,6
65,8471677,Jack Johnson,D,CBJ,37,65,0,6,6
65,8483460,David Jiricek,D,CBJ,21,56,0,6,6
65,8482861,Vincent Iorio,D,WSH,22,32,0,6,6
65,8478450,Parker Wotherspoon,D,BOS,27,32,0,6,6
65,8481056,Spencer Stastney,D,NSH,24,30,0,6,6
65,8482147,Jean-Luc Foudy,C,COL,22,31,4,1,5
65,8483570,Ben Meyers,C,SEA,26,36,3,2,5
65,8482177,Marat Khusnutdinov,C,MIN,22,28,3,2,5
65,8484287,Cole McWard,D,VAN,23,16,3,2,5
65,8482511,Mason Lohrei,D,BOS,23,34,3,2,5
65,8480870,Bo Groulx,C,NYR,24,28,3,2,5
65,8477384,Joshua Brown,D,EDM,30,41,2,3,5
65,8482652,Walker Duehr,R,CGY,27,41,2,3,5
65,8482747,Brennan Othmann,L,NYR,21,40,2,3,5
65,8479419,Brett Murray,L,BUF,26,19,2,3,5
65,8479379,Givani Smith,R,SJS,26,33,1,4,5
65,8482153,Brendan Brisson,C,VGK,23,33,1,4,5
65,8479576,Vincent Desharnais,D,VAN,28,34,1,4,5
65,8481006,Tyler Tucker,D,STL,24,17,1,4,5
65,8481719,Maxwell Crozier,D,TBL,24,17,1,4,5
65,8480880,Jakub Lauko,C,MIN,24,35,0,5,5
65,8475795,Dylan McIlrath,D,WSH,32,18,0,5,5
65,8480292,Carson Meyer,R,ANA,27,41,3,1,4
65,8478051,Max Willman,C,NJD,29,14,3,1,4
65,8482765,Isak Rosen,R,BUF,21,28,2,2,4
65,8483763,Maksymilian Szuber,D,UTA,22,36,2,2,4
65,8483397,Marc McLaughlin,C,BOS,25,35,2,2,4
65,8479985,Cale Fleury,D,SEA,26,28,2,2,4
65,8484258,Sam Malinski,D,COL,26,20,2,2,4
65,8482929,Emil Lilleberg,D,TBL,23,23,1,3,4
65,8480468,James Hamblin,L,EDM,25,22,1,3,4
65,8481743,Marc Del Gaizo,D,NSH,25,25,1,3,4
65,8482172,Landon Slaggert,L,CHI,22,24,3,0,3
65,8480032,Shane Bowers,C,NJD,25,15,3,0,3
65,8475413,Justin Dowling,C,NJD,34,17,3,0,3
65,8483630,Pavol Regenda,L,ANA,25,30,2,1,3
65,8483012,Logan Morrison,C,SEA,22,39,2,1,3
65,8476913,Devin Shore,C,MIN,30,41,2,1,3
65,8478881,Brett Seney,L,CHI,28,12,2,1,3
65,8480267,Sammy Walker,C,MIN,25,16,2,1,3
65,8479367,William Lockwood,R,FLA,26,22,2,1,3
65,8477320,Anton Blidh,L,NYR,29,17,2,1,3
65,8477401,John Hayden,C,SEA,29,26,1,2,3
65,8482145,Mavrik Bourque,C,DAL,22,49,1,2,3
65,8481237,Kyle MacLean,C,NYI,25,26,1,2,3
65,8483597,Milos Kelemen,L,UTA,25,14,1,2,3
65,8474062,Riley Nash,C,NYR,35,21,1,2,3
65,8479330,Brandon Gignac,C,MTL,27,12,1,2,3
65,8481206,John Ludvig,D,PIT,24,13,1,2,3
65,8477473,Justin Bailey,R,SJS,29,19,0,3,3
65,8481043,Cole Koepke,L,BOS,26,26,0,3,3
65,8481422,Jake Lucchini,C,NSH,29,22,2,0,2
65,8477810,Joel Hanley,D,CGY,33,32,2,0,2
65,8482144,Jack Thompson,D,SJS,22,24,2,0,2
65,8483567,Georgii Merkulov,C,BOS,24,14,2,0,2
65,8478011,Louie Belpedio,D,PHI,28,16,1,1,2
65,8481541,Samuel Bolduc,D,NYI,24,16,1,1,2
65,8481593,Jayden Struble,D,MTL,23,26,1,1,2
65,8478446,Glenn Gawdin,C,LAK,27,15,1,1,2
65,8482858,Ryker Evans,D,SEA,23,19,1,1,2
65,8480851,Akil Thomas,C,LAK,24,16,1,1,2
65,8481699,Aku Raty,R,UTA,23,18,1,1,2
65,8482094,Daemon Hunt,D,MIN,22,24,1,1,2
65,8481655,Cole Schwindt,R,CGY,23,5,1,1,2
65,8476473,Connor Murphy,D,CHI,31,35,0,2,2
65,8479362,Riley Tufte,L,BOS,26,16,0,2,2
65,8481065,Angus Crookshank,L,OTT,25,18,0,2,2
65,8478502,Dennis Gilbert,D,BUF,28,15,0,2,2
65,8482102,Vasily Ponomarev,C,PIT,22,24,0,2,2
65,8483512,Matthew Savoie,C,EDM,20,20,0,2,2
65,8478477,Mitchell Stephens,C,SEA,27,16,0,2,2
65,8480306,Grant Hutton,D,NYI,29,10,0,2,2
65,8481462,Mason Morelli,L,VGK,28,14,1,0,1
65,8483407,Brandon Scanlin,D,NYR,25,5,1,0,1
65,8481806,Louis Crevier,D,CHI,23,18,1,0,1
65,8483395,Arshdeep Bains,L,VAN,23,8,1,0,1
65,8481578,Graeme Clarke,R,MIN,23,8,1,0,1
65,8480075,Cameron Crotty,D,MIN,25,7,1,0,1
65,8481564,Ryan Johnson,D,BUF,23,17,1,0,1
65,8482088,Justin Sourdif,R,FLA,22,11,1,0,1
65,8482162,Roby Jarventie,L,EDM,22,20,1,0,1
65,8481024,Linus Karlsson,C,VAN,25,8,1,0,1
65,8483531,Brian Halonen,L,NJD,25,4,1,0,1
65,8478409,Anthony Richard,C,PHI,28,32,0,1,1
65,8478021,William Lagesson,D,DET,28,21,0,1,1
65,8482516,Matthew Kessel,D,STL,24,13,0,1,1
65,8482165,Yan Kuznetsov,D,CGY,22,18,0,1,1
65,8484325,Waltteri Merela,C,TBL,26,18,0,1,1
65,8480084,Nick DeSimone,D,NJD,30,16,0,1,1
65,8477149,Scott Sabourin,R,SJS,32,23,0,1,1
65,8484304,Uvis Balinskis,D,FLA,28,5,0,1,1
65,8481585,Egor Afanasyev,L,SJS,23,15,0,1,1
65,8483489,Fraser Minten,C,TOR,31,11,0,1,1
65,8475755,Alexander Petrovic,D,DAL,32,13,0,1,1
65,8483471,Brad Lambert,C,WPG,31,5,0,1,1
65,8475780,Chris Wagner,R,COL,33,7,0,1,1
65,8483609,Adam Klapka,R,CGY,24,3,0,1,1
65,8480874,Adam Ginning,D,PHI,24,12,0,1,1
65,8482476,Emil Heineman,L,MTL,23,5,0,1,1
65,8481726,Adam Edstrom,C,NYR,24,8,0,1,1
65,8479320,Maxime Lajoie,D,SEA,27,19,0,0,0
65,8479587,Rhett Gardner,C,PHI,28,11,0,0,0
65,8477527,Ross Johnston,L,ANA,30,32,0,0,0
65,8477467,Gustav Olofsson,D,SEA,30,17,0,0,0
65,8482118,Sam Colangelo,R,ANA,23,12,0,0,0
65,8482061,Brandon Biro,L,SEA,26,17,0,0,0
65,8482470,Ilya Solovyov,D,CGY,24,11,0,0,0
65,8481030,Jack St. Ivany,D,PIT,25,17,0,0,0
65,8478147,Bokondji Imama,L,PIT,28,10,0,0,0
65,8480823,Alexander Alexeyev,D,WSH,25,12,0,0,0
65,8482787,Nikita Chibrikov,R,WPG,31,8,0,0,0
65,8483920,Pierrick Dube,R,WSH,23,1,0,0,0
65,8484255,Jason Polin,R,COL,25,6,0,0,0
65,8483546,Marshall Rifai,D,TOR,26,5,0,0,0
65,8479421,Jacob Moverare,D,LAK,26,6,0,0,0
65,8477993,Justin Kirkland,C,CGY,28,6,0,0,0
65,8482460,Matt Rempe,C,NYR,22,8,0,0,0
65,8483398,Declan Carlile,D,TBL,31,4,0,0,0
65,8477541,Dakota Mermis,D,TOR,30,8,0,0,0
65,8482126,Emil Andrae,D,PHI,31,2,0,0,0
65,8476323,Max McCormick,L,SEA,32,3,0,0,0
65,8483432,Luca Del Bel Belluz,C,CBJ,31,8,0,0,0
65,8484259,Ondrej Pavel,C,COL,31,3,0,0,0
65,8478854,Ryan Shea,D,PIT,27,5,0,0,0
65,8482197,Adam Raska,R,MIN,23,5,0,0,0
65,8479522,Hardy Haman Aktell,D,WSH,26,5,0,0,0
65,8481534,Raphael Lavoie,C,EDM,24,6,0,0,0
65,8484321,Nikolas Matinpalo,D,OTT,26,0,0,0,0
65,8484326,Patrik Koch,D,UTA,28,2,0,0,0
65,8483401,Marc Johnstone,R,PIT,28,2,0,0,0
65,8480274,Philip Kemp,D,EDM,25,1,0,0,0
65,8470794,Joe Pavelski,C,,40,0,0,0,0
65,8479321,Lucas Johansen,D,,27,0,0,0,0
65,8477950,Tony DeAngelo,D,,29,0,0,0,0
65,8471218,Blake Wheeler,R,,38,0,0,0,0
65,8475197,Tyson Barrie,D,,33,0,0,0,0
65,8474157,Max Pacioretty,L,,36,0,0,0,0
65,8475744,Evgeny Kuznetsov,C,,32,0,0,0,0
65,8474037,James van Riemsdyk,L,,35,0,0,0,0
65,8476907,Mackenzie MacEachern,L,,30,0,0,0,0
65,8480216,Jacob Peterson,C,,25,0,0,0,0
65,8474602,Justin Schultz,D,,34,0,0,0,0
65,8482222,Alexander Barabanov,L,,30,0,0,0,0
65,8474031,Kevin Shattenkirk,D,,35,0,0,0,0
65,8477330,Dominik Kubalik,L,,29,0,0,0,0
65,8480884,Calen Addison,D,,24,0,0,0,0
65,8475906,John Klingberg,D,,32,0,0,0,0
65,8480008,Adam Ruzicka,C,,25,0,0,0,0
65,8476884,Derrick Pouliot,D,,30,0,0,0,0
65,8476919,Chris Tierney,C,,30,0,0,0,0
65,8479415,Michael McLeod,C,,26,0,0,0,0
65,8474870,Tyler Johnson,C,,34,0,0,0,0
65,8470604,Jeff Carter,C,,39,0,0,0,0
65,8478104,Sammy Blais,L,,28,0,0,0,0
65,8474884,Mike Hoffman,C,,35,0,0,0,0
65,8481591,Sam Poulin,R,,23,0,0,0,0
65,8471274,Alex Goligoski,D,,39,0,0,0,0
65,8476871,Tanner Pearson,L,,32,0,0,0,0
65,8476393,Nick Cousins,C,,31,0,0,0,0
65,8479977,Kailer Yamamoto,R,,26,0,0,0,0
65,8479346,Dillon Dube,C,,26,0,0,0,0
65,8480184,Gustav Lindstrom,D,,26,0,0,0,0
65,8479376,Victor Mete,D,,26,0,0,0,0
65,8473449,Kyle Okposo,R,,36,0,0,0,0
65,8481058,Jesse Ylonen,R,,25,0,0,0,0
65,8475752,Tyler Pitlick,C,,33,0,0,0,0
65,8481239,Samuel Fagemo,L,,24,0,0,0,0
65,8480821,Filip Zadina,R,,25,0,0,0,0
65,8470966,Mark Giordano,D,,41,0,0,0,0
65,8478495,Denis Gurianov,R,,27,0,0,0,0
65,8477464,Nic Petan,C,,29,0,0,0,0
65,8478099,Kevin Labanc,R,,29,0,0,0,0
65,8482241,Radim Zohorna,L,,28,0,0,0,0
65,8474040,Sam Gagner,C,,35,0,0,0,0
65,8479514,Rem Pitlick,C,,27,0,0,0,0
65,8478430,Oliver Kylington,D,,27,0,0,0,0
65,8479533,Joona Koppanen,L,,26,0,0,0,0
65,8479984,Cal Foote,D,,26,0,0,0,0
65,8477126,Jayson Megna,C,,34,0,0,0,0
65,8475164,Jakob Silfverberg,R,,34,0,0,0,0
65,8474009,Nick Bonino,C,,36,0,0,0,0
65,8479458,Nikita Zaitsev,D,,33,0,0,0,0
65,8477944,Jakub Vrana,L,,28,0,0,0,0
65,8471699,Andrew Cogliano,C,,37,0,0,0,0
65,8478067,Oskar Lindblom,L,,28,0,0,0,0
65,8471686,Marc Staal,D,,37,0,0,0,0
65,8470610,Zach Parise,L,,40,0,0,0,0
65,8478904,Steven Lorentz,C,,28,0,0,0,0
65,8473473,Milan Lucic,L,,36,0,0,0,0
65,8480031,Maxime Comtois,L,,25,0,0,0,0
65,8478512,Austin Czarnik,C,,32,0,0,0,0
65,8473504,Cal Clutterbuck,R,,37,0,0,0,0
65,8477454,Adam Erne,L,,29,0,0,0,0
65,8479383,Boris Katchouk,L,,26,0,0,0,0
65,8475825,Jani Hakanpää,D,,32,0,0,0,0
65,8477846,Ryan Carpenter,C,,33,0,0,0,0
65,8477930,Pierre-Edouard Bellemare,L,,39,0,0,0,0
65,8478400,Colin White,C,,27,0,0,0,0
65,8480226,Marián Studenic,R,,26,0,0,0,0
65,8480853,Liam Foudy,C,,24,0,0,0,0
65,8475797,Jarred Tinordi,D,,32,0,0,0,0
65,8479423,Alex Nylander,L,,26,0,0,0,0
65,8474618,Marco Scandella,D,,34,0,0,0,0
65,8478028,Fredrik Olofsson,L,,28,0,0,0,0
65,8474709,Matt Martin,L,,35,0,0,0,0
65,8481070,Hugh McGing,L,,26,0,0,0,0
65,8479546,Oskar Steen,C,,26,0,0,0,0
65,8474145,Robert Bortuzzo,D,,35,0,0,0,0
65,8476915,Jujhar Khaira,L,,30,0,0,0,0
65,8475278,Byron Froese,C,,33,0,0,0,0
65,8481812,Nikolai Knyzhov,D,,27,0,0,0,0
65,8478408,Travis Dermott,D,,28,0,0,0,0
65,8481077,John Leonard,L,,26,0,0,0,0
65,8479547,Matthew Phillips,R,,26,0,0,0,0
65,8480836,Jonathan Gruden,C,,24,0,0,0,0
65,8481690,Tyler Angle,C,,24,0,0,0,0
65,8475766,Austin Watson,L,,32,0,0,0,0
65,8481016,Ruslan Iskhakov,C,,24,0,0,0,0
65,8478078,Rourke Chartier,C,,28,0,0,0,0
65,8480776,Sheldon Rempal,R,,29,0,0,0,0
65,8478956,Samuel Laberge,L,NJD,27,2,0,0,0
65,8483045,Cameron Butler,R,CBJ,31,1,0,0,0
65,8484314,Jiri Smejkal,L,,28,0,0,0,0
66,8478402,Connor McDavid,C,EDM,27,77,45,117,162
66,8476453,Nikita Kucherov,R,TBL,31,82,43,94,137
66,8477492,Nathan MacKinnon,C,COL,29,79,49,83,132
66,8479318,Auston Matthews,C,TOR,27,79,60,65,125
66,8477934,Leon Draisaitl,C,EDM,29,76,48,67,115
66,8478483,Mitch Marner,R,TOR,27,79,33,78,111
66,8477956,David Pastrnak,R,BOS,28,78,48,62,110
66,8478420,Mikko Rantanen,R,COL,28,81,51,58,109
66,8478398,Kyle Connor,L,WPG,28,75,46,57,103
66,8477946,Dylan Larkin,C,DET,28,81,42,61,103
66,8475172,Nazem Kadri,C,CGY,34,79,33,68,101
66,8477933,Sam Reinhart,C,FLA,29,79,43,54,97
66,8477939,William Nylander,R,TOR,28,77,49,47,96
66,8478550,Artemi Panarin,L,NYR,33,79,26,70,96
66,8478864,Kirill Kaprizov,L,MIN,27,78,42,53,95
66,8471675,Sidney Crosby,C,PIT,37,73,43,48,91
66,8476468,J.T. Miller,C,VAN,31,76,38,53,91
66,8477493,Aleksander Barkov,C,FLA,29,79,28,63,91
66,8476887,Filip Forsberg,L,NSH,30,73,43,47,90
66,8478010,Brayden Point,C,TBL,28,82,43,46,89
66,8479407,Jesper Bratt,L,NJD,26,77,34,55,89
66,8480027,Jason Robertson,L,DAL,25,81,39,49,88
66,8481559,Jack Hughes,C,NJD,23,71,31,57,88
66,8479343,Clayton Keller,R,UTA,26,78,35,52,87
66,8477501,Valeri Nichushkin,R,COL,29,81,34,53,87
66,8480069,Cale Makar,D,COL,26,71,24,63,87
66,8480801,Brady Tkachuk,L,OTT,25,80,42,44,86
66,8477404,Jake Guentzel,C,TBL,30,82,40,44,84
66,8475166,John Tavares,C,TOR,34,79,38,46,84
66,8478427,Sebastian Aho,C,CAR,27,75,35,49,84
66,8479385,Jordan Kyrou,C,STL,26,75,29,55,84
66,8479314,Matthew Tkachuk,L,FLA,27,77,25,58,83
66,8480023,Robert Thomas,C,STL,25,74,25,58,83
66,8475913,Mark Stone,R,VGK,32,78,32,50,82
66,8482116,Tim Stützle,C,OTT,22,79,27,55,82
66,8477955,Jared McCann,L,SEA,28,73,34,47,81
66,8477942,Kevin Fiala,L,LAK,28,80,27,54,81
66,8480208,Drake Batherson,R,OTT,26,78,27,54,81
66,8476459,Mika Zibanejad,C,NYR,31,79,31,49,80
66,8480036,Miro Heiskanen,D,DAL,25,75,16,64,80
66,8477402,Pavel Buchnevich,L,STL,29,69,24,55,79
66,8478445,Mathew Barzal,C,NYI,27,80,20,59,79
66,8479323,Adam Fox,D,NYR,26,76,14,65,79
66,8478403,Jack Eichel,C,VGK,28,76,40,38,78
66,8474600,Roman Josi,D,NSH,34,77,18,60,78
66,8478414,Timo Meier,R,NJD,28,80,42,35,77
66,8479337,Alex DeBrincat,R,DET,27,81,29,47,76
66,8476456,Jonathan Huberdeau,C,CGY,31,77,20,56,76
66,8480800,Quinn Hughes,D,VAN,25,75,7,69,76
66,8476539,Jonathan Marchessault,R,NSH,34,74,43,32,75
66,8479420,Tage Thompson,C,BUF,27,72,41,34,75
66,8478444,Brock Boeser,R,VAN,27,74,34,41,75
66,8474141,Patrick Kane,R,DET,36,81,29,46,75
66,8476881,Tomas Hertl,C,VGK,31,77,28,47,75
66,8478440,Dylan Strome,C,WSH,27,72,26,49,75
66,8477500,Bo Horvat,C,NYI,29,80,42,32,74
66,8477409,Carter Verhaeghe,C,FLA,29,82,38,36,74
66,8473512,Claude Giroux,R,OTT,36,78,25,49,74
66,8480803,Evan Bouchard,D,EDM,25,73,15,59,74
66,8478439,Travis Konecny,R,PHI,27,76,31,42,73
66,8474564,Steven Stamkos,C,NSH,34,73,33,39,72
66,8475692,Mats Zuccarello,R,MIN,37,74,33,38,71
66,8482078,Lucas Raymond,L,DET,22,79,33,38,71
66,8480012,Elias Pettersson,C,VAN,26,75,30,41,71
66,8477940,Nikolaj Ehlers,L,WPG,28,72,24,47,71
66,8477496,Elias Lindholm,C,BOS,30,81,25,45,70
66,8480002,Nico Hischier,C,NJD,25,71,31,38,69
66,8479542,Brandon Hagel,L,TBL,26,82,27,42,69
66,8480018,Nick Suzuki,C,MTL,25,74,27,42,69
66,8473419,Brad Marchand,L,BOS,36,78,25,44,69
66,8474578,Erik Karlsson,D,PIT,34,80,12,57,69
66,8479400,Pierre-Luc Dubois,L,WSH,26,70,34,34,68
66,8478401,Pavel Zacha,C,BOS,27,75,29,39,68
66,8484144,Connor Bedard,C,CHI,19,70,29,39,68
66,8475167,Victor Hedman,D,TBL,34,80,17,51,68
66,8481557,Matt Boldy,L,MIN,23,74,27,40,67
66,8476460,Mark Scheifele,C,WPG,31,68,29,37,66
66,8482740,Wyatt Johnston,C,DAL,21,82,28,38,66
66,8478407,Vince Dunn,D,SEA,28,77,18,48,66
66,8478460,Zach Werenski,D,CBJ,27,81,15,51,66
66,8476346,Johnny Gaudreau,L,CBJ,31,70,12,54,66
66,8480830,Andrei Svechnikov,R,CAR,24,69,26,39,65
66,8477960,Adrian Kempe,R,LAK,28,78,30,34,64
66,8475765,Vladimir Tarasenko,R,DET,33,81,24,40,64
66,8475168,Matt Duchene,C,DAL,33,82,20,44,64
66,8482109,Alexis Lafrenière,L,NYR,23,77,37,26,63
66,8481540,Cole Caufield,R,MTL,23,74,27,36,63
66,8476389,Vincent Trocheck,C,NYR,31,79,25,38,63
66,8482684,Luke Hughes,D,NJD,21,73,10,53,63
66,8475184,Chris Kreider,L,NYR,33,75,36,26,62
66,8475754,Brock Nelson,C,NYI,33,80,30,32,62
66,8478493,Joel Eriksson Ek,C,MIN,27,71,28,34,62
66,8479675,Trevor Moore,L,LAK,29,77,27,35,62
66,8475786,Zach Hyman,L,EDM,32,76,27,35,62
66,8477949,Alex Tuch,R,BUF,28,73,26,36,62
66,8478366,Frank Vatrano,R,ANA,30,71,28,33,61
66,8476454,Ryan Nugent-Hopkins,C,EDM,31,77,24,37,61
66,8478047,Michael Bunting,L,PIT,29,69,22,39,61
66,8482745,Mason McTavish,C,ANA,21,73,21,40,61
66,8476448,William Karlsson,C,VGK,31,74,32,28,60
66,8475726,Tyler Toffoli,C,SJS,32,70,25,35,60
66,8482113,Anton Lundell,C,FLA,23,78,22,38,60
66,8477504,Josh Morrissey,D,WPG,29,71,13,47,60
66,8471214,Alex Ovechkin,L,WSH,39,72,32,27,59
66,8475714,Calle Jarnkrok,C,TOR,33,73,31,28,59
66,8477935,Sam Bennett,C,FLA,28,76,28,31,59
66,8477951,Nick Schmaltz,C,UTA,28,79,21,38,59
66,8473986,Alex Killorn,L,ANA,35,71,29,29,58
66,8482093,Seth Jarvis,C,CAR,22,68,26,32,58
66,8480839,Rasmus Dahlin,D,BUF,24,73,18,40,58
66,8475798,Mikael Granlund,C,SJS,32,67,18,40,58
66,8476853,Morgan Rielly,D,TOR,30,73,12,46,58
66,8475810,Bryan Rust,R,PIT,32,69,31,26,57
66,8478449,Roope Hintz,C,DAL,28,82,20,37,57
66,8477503,Max Domi,C,TOR,29,77,13,44,57
66,8471215,Evgeni Malkin,C,PIT,38,73,25,31,56
66,8478975,Mason Marchment,L,DAL,29,81,20,36,56
66,8475745,Charlie Coyle,C,BOS,32,76,19,37,56
66,8482665,Matty Beniers,C,SEA,22,73,18,38,56
66,8481542,Moritz Seider,D,DET,23,73,11,45,56
66,8477476,Artturi Lehkonen,L,COL,29,81,28,27,55
66,8476399,Blake Coleman,C,CGY,33,78,27,28,55
66,8476483,Rickard Rakell,R,PIT,31,71,25,30,55
66,8478873,Troy Terry,R,ANA,27,76,25,30,55
66,8473994,Jamie Benn,L,DAL,35,82,21,34,55
66,8475158,Ryan O'Reilly,C,NSH,33,72,20,35,55
66,8477407,Anthony Duclair,L,NYI,29,76,20,35,55
66,8483808,Andrei Kuzmenko,L,CGY,28,73,18,37,55
66,8481711,Matias Maccelli,L,UTA,24,74,16,39,55
66,8474150,Mikael Backlund,C,CGY,35,75,19,35,54
66,8481528,Dylan Cozens,C,BUF,23,76,18,36,54
66,8476905,Chandler Stephenson,C,SEA,30,71,15,39,54
66,8480865,Noah Dobson,D,NYI,24,80,5,49,54
66,8475799,Nino Niederreiter,R,WPG,32,70,27,26,53
66,8477429,Andrew Copp,C,DET,30,81,24,29,53
66,8478042,Viktor Arvidsson,L,EDM,31,76,16,37,53
66,8482699,Dylan Guenther,R,UTA,21,68,23,29,52
66,8476880,Tom Wilson,R,WSH,30,68,20,32,52
66,8480039,Martin Necas,C,CAR,25,66,18,34,52
66,8471724,Kris Letang,D,PIT,37,79,13,39,52
66,8475169,Evander Kane,L,EDM,33,74,32,19,51
66,8480014,Gabriel Vilardi,C,WPG,25,69,28,23,51
66,8477964,Ivan Barbashev,C,VGK,29,76,16,35,51
66,8479999,Casey Mittelstadt,C,COL,26,75,14,37,51
66,8478055,Gustav Forsling,D,FLA,28,70,12,39,51
66,8474590,John Carlson,D,WSH,34,70,11,40,51
66,8477447,Shea Theodore,D,VGK,29,69,6,45,51
66,8483515,Juraj Slafkovsky,L,MTL,20,72,27,23,50
66,8480797,Joel Farabee,L,PHI,24,72,21,29,50
66,8484153,Leo Carlsson,C,ANA,20,67,18,32,50
66,8475170,Brayden Schenn,C,STL,33,73,18,32,50
66,8475191,Reilly Smith,R,NYR,33,70,13,37,50
66,8475794,Tyler Seguin,C,DAL,32,79,29,20,49
66,8481604,Pavel Dorofeyev,L,VGK,24,71,22,27,49
66,8474102,David Perron,L,OTT,36,78,21,28,49
66,8476479,Phillip Danault,C,LAK,31,77,20,29,49
66,8481596,Shane Pinto,C,OTT,24,72,19,30,49
66,8475763,Kevin Hayes,R,PIT,32,68,18,31,49
66,8477416,Oliver Bjorkstrand,R,SEA,29,64,14,35,49
66,8479525,Ross Colton,C,COL,28,80,25,23,48
66,8477494,Jonathan Drouin,L,COL,29,82,14,34,48
66,8478396,Noah Hanifin,D,VGK,27,65,13,35,48
66,8479325,Charlie McAvoy,D,BOS,27,75,8,40,48
66,8477426,Nicholas Paul,L,TBL,29,82,30,17,47
66,8482089,Jake Neighbours,L,STL,22,75,29,18,47
66,8476432,Boone Jenner,C,CBJ,31,65,27,20,47
66,8474641,Adam Henrique,C,EDM,34,76,23,24,47
66,8478233,Andrew Mangiapane,L,WSH,28,63,23,24,47
66,8480188,Fabian Zetterlund,L,SJS,25,68,22,25,47
66,8476792,Torey Krug,D,STL,33,68,22,25,47
66,8477986,Brandon Montour,D,SEA,30,72,15,32,47
66,8478469,Thomas Chabot,D,OTT,27,78,7,40,47
66,8478462,Nicolas Roy,C,VGK,27,77,21,25,46
66,8477953,Kasperi Kapanen,R,STL,28,72,21,25,46
66,8474586,Jordan Eberle,R,SEA,34,76,21,25,46
66,8481560,Arthur Kaliyev,R,LAK,23,80,16,30,46
66,8480817,K'Andre Miller,D,NYR,24,72,11,35,46
66,8471698,T.J. Oshie,R,WSH,38,68,25,20,45
66,8475151,Kyle Palmieri,C,NYI,33,75,24,21,45
66,8477511,Anthony Mantha,R,CGY,30,78,23,22,45
66,8481068,Yegor Sharangovich,C,CGY,26,73,21,24,45
66,8481533,Trevor Zegras,C,ANA,23,68,19,26,45
66,8477497,Sean Monahan,C,CBJ,30,75,19,26,45
66,8484145,Zach Benson,L,BUF,19,64,18,27,45
66,8482720,Matthew Knies,L,TOR,22,75,14,31,45
66,8474679,Gustav Nyquist,C,NSH,35,72,14,31,45
66,8479345,Jakob Chychrun,D,WSH,26,69,9,36,45
66,8476958,Jaccob Slavin,D,CAR,30,77,9,36,45
66,8474563,Drew Doughty,D,LAK,35,73,8,37,45
66,8477998,Warren Foegele,L,LAK,28,80,27,17,44
66,8482702,Logan Stankoven,C,DAL,21,82,26,18,44
66,8477451,Ryan Hartman,R,MIN,30,68,20,24,44
66,8482667,William Eklund,L,SJS,22,68,19,25,44
66,8483431,Logan Cooley,C,UTA,20,75,18,26,44
66,8484166,Adam Fantilli,C,CBJ,20,71,18,26,44
66,8476854,Hampus Lindholm,D,BOS,30,73,13,31,44
66,8476869,Brady Skjei,D,NSH,30,73,10,34,44
66,8480064,Josh Norris,C,OTT,25,78,24,19,43
66,8478472,Mathieu Joseph,R,STL,27,67,21,22,43
66,8476882,Teuvo Teravainen,C,CHI,30,67,13,30,43
66,8481618,Alex Newhook,C,MTL,23,74,11,32,43
66,8478856,Conor Garland,R,VAN,28,71,10,33,43
66,8476462,Dougie Hamilton,D,NJD,31,68,8,35,43
66,8482175,JJ Peterka,R,BUF,22,72,23,19,42
66,8475784,Jeff Skinner,C,EDM,32,76,19,23,42
66,8481524,Bowen Byram,D,BUF,23,69,16,26,42
66,8477021,Alex Kerfoot,C,UTA,30,66,14,28,42
66,8477932,Aaron Ekblad,D,FLA,28,69,14,28,42
66,8475753,Justin Faulk,D,STL,32,70,13,29,42
66,8478397,Rasmus Andersson,D,CGY,28,71,10,32,42
66,8470613,Brent Burns,D,CAR,39,69,9,33,42
66,8482712,Oskar Olausson,R,COL,22,79,6,36,42
66,8478038,Devon Toews,D,COL,30,71,5,37,42
66,8479992,Michael Rasmussen,C,DET,25,81,25,16,41
66,8481186,Logan O'Connor,R,COL,28,80,21,20,41
66,8476458,Ryan Strome,C,ANA,31,66,21,20,41
66,8477479,Tyler Bertuzzi,L,CHI,29,64,20,21,41
66,8482149,Cole Perfetti,C,WPG,22,68,18,23,41
66,8480113,Alex Iafallo,L,WPG,31,63,14,27,41
66,8480434,Sean Durzi,D,UTA,26,66,12,29,41
66,8475287,Erik Haula,L,NJD,33,70,12,29,41
66,8483505,Matthew Poitras,C,BOS,20,72,10,31,41
66,8475218,Mattias Ekholm,D,EDM,34,69,10,31,41
66,8471685,Anze Kopitar,C,LAK,37,80,20,20,40
66,8482110,Dawson Mercer,C,NJD,23,70,20,20,40
66,8482705,Cole Sillinger,C,CBJ,21,68,18,22,40
66,8478519,Anthony Cirelli,C,TBL,27,82,17,23,40
66,8482159,Tyson Foerster,R,PHI,22,72,17,23,40
66,8480015,Owen Tippett,R,PHI,25,71,17,23,40
66,8482092,Ridly Greig,C,OTT,22,76,16,24,40
66,8477456,J.T. Compher,L,DET,29,80,13,27,40
66,8482124,Quinton Byfield,R,LAK,22,79,13,27,40
66,8476906,Shayne Gostisbehere,D,CAR,31,73,11,29,40
66,8477346,MacKenzie Weegar,D,CGY,30,72,10,30,40
66,8476875,Mike Matheson,D,MTL,30,72,7,33,40
66,8478474,Lawson Crouse,L,UTA,27,77,20,19,39
66,8478438,Tommy Novak,C,NSH,27,68,19,20,39
66,8476438,Brandon Saad,L,STL,32,73,18,21,39
66,8480028,Morgan Frost,C,PHI,25,74,15,24,39
66,8474053,Logan Couture,C,SJS,35,64,15,24,39
66,8480798,Philipp Kurashev,C,CHI,25,63,14,25,39
66,8479591,Michael Eyssimont,C,TBL,28,81,14,25,39
66,8478911,Matt Roy,D,WSH,29,70,9,30,39
66,8477948,Travis Sanheim,D,PHI,28,76,7,32,39
66,8479987,Morgan Geekie,C,BOS,26,78,16,22,38
66,8474715,Cameron Atkinson,R,TBL,35,81,10,28,38
66,8480043,Timothy Liljegren,D,TOR,25,63,1,37,38
66,8475768,Jaden Schwartz,C,SEA,32,70,22,15,37
66,8475760,Nick Bjugstad,C,UTA,32,72,20,17,37
66,8478498,Jake DeBrusk,L,VAN,28,72,18,19,37
66,8478057,Dakota Joshua,C,VAN,28,71,14,23,37
66,8475848,Brendan Gallagher,R,MTL,32,72,13,24,37
66,8479339,Patrik Laine,L,CBJ,26,68,12,25,37
66,8479365,Trent Frederic,C,BOS,26,79,20,16,36
66,8476872,Scott Laughton,C,PHI,30,72,20,16,36
66,8482079,Marco Rossi,C,MIN,23,61,16,20,36
66,8474149,Evgenii Dadonov,R,DAL,35,79,14,22,36
66,8480849,Barrett Hayton,C,UTA,24,70,13,23,36
66,8478458,John (Jack) Roslovic,C,CAR,27,66,9,27,36
66,8482105,Jake Sanderson,D,OTT,22,77,8,28,36
66,8479410,Mikhail Sergachev,D,UTA,26,71,8,28,36
66,8479316,Luke Kunin,C,SJS,27,63,23,12,35
66,8482055,Drew O'Connor,L,PIT,26,71,20,15,35
66,8478020,Michael Amadio,R,OTT,28,72,19,16,35
66,8478046,Danton Heinen,L,VAN,29,67,18,17,35
66,8478466,Daniel Sprong,R,VAN,27,73,17,18,35
66,8477495,Seth Jones,D,CHI,30,66,13,22,35
66,8477505,Alexander Wennberg,C,SJS,30,63,11,24,35
66,8475171,Oliver Ekman-Larsson,D,TOR,33,70,8,27,35
66,8476979,Erik Gustafsson,D,DET,32,75,4,31,35
66,8480835,Jack Drury,C,CAR,24,58,18,16,34
66,8478891,Mason Appleton,C,WPG,28,69,17,17,34
66,8476419,Jean-Gabriel Pageau,C,NYI,32,78,14,20,34
66,8475149,Marcus Johansson,L,MIN,34,66,14,20,34
66,8482097,Jack Quinn,R,BUF,23,66,13,21,34
66,8478542,Evan Rodrigues,C,FLA,31,75,12,22,34
66,8478413,Jordan Greenway,L,BUF,27,67,11,23,34
66,8481703,Valtteri Puustinen,R,PIT,25,61,9,25,34
66,8475181,Nick Leddy,D,STL,33,73,7,27,34
66,8476917,Adam Pelech,D,NYI,30,80,2,32,34
66,8480078,Filip Chytil,C,NYR,25,69,18,15,33
66,8480205,Emil Bemstrom,C,PIT,25,60,17,16,33
66,8480813,Joe Veleno,C,DET,24,79,17,16,33
66,8481582,Nicholas Robertson,L,TOR,23,71,16,17,33
66,8479351,Sam Steel,C,DAL,26,80,16,17,33
66,8476826,Yanni Gourde,C,SEA,33,68,14,19,33
66,8477444,Andre Burakovsky,L,SEA,29,70,14,19,33
66,8476392,Adam Lowry,C,WPG,31,63,12,21,33
66,8480871,Adam Boqvist,D,FLA,24,71,7,26,33
66,8478463,Anthony Beauvillier,L,PIT,27,66,17,15,32
66,8476921,Jordan Martinook,L,CAR,32,60,17,15,32
66,8479390,Taylor Raddysh,R,WSH,26,64,17,15,32
66,8475793,Ryan Johansen,C,PHI,32,76,14,18,32
66,8480185,Eetu Luostarinen,C,FLA,26,75,14,18,32
66,8475193,Tomas Tatar,L,NJD,34,73,12,20,32
66,8480336,Sean Walker,D,CAR,30,76,11,21,32
66,8476480,Vladislav Namestnikov,C,WPG,32,61,9,23,32
66,8482133,Thomas Bordeleau,C,SJS,22,65,6,26,32
66,8481606,Jordan Spence,D,LAK,23,69,6,26,32
66,8473507,Jeff Petry,D,DET,37,79,6,26,32
66,8479353,Brett Howden,C,VGK,26,68,18,13,31
66,8482475,Yegor Chinakhov,R,CBJ,23,65,16,15,31
66,8480009,Eeli Tolvanen,R,SEA,25,69,16,15,31
66,8475314,Anders Lee,L,NYI,34,79,15,16,31
66,8480802,Ryan McLeod,C,BUF,25,69,14,17,31
66,8474189,Lars Eller,C,PIT,35,65,14,17,31
66,8479368,Max Jones,L,BOS,26,65,13,18,31
66,8476897,Oskar Sundqvist,C,STL,30,63,12,19,31
66,8475855,Jesper Fast,R,CAR,33,60,12,19,31
66,8482146,Luke Evangelista,R,NSH,22,66,11,20,31
66,8474716,Jared Spurgeon,D,MIN,35,76,10,21,31
66,8475200,Dmitry Orlov,D,CAR,33,73,10,21,31
66,8476474,Stefan Noesen,R,NJD,31,68,10,21,31
66,8482122,Brock Faber,D,MIN,22,80,7,24,31
66,8480220,Noah Cates,L,PHI,25,65,7,24,31
66,8477969,Marcus Pettersson,D,PIT,28,77,3,28,31
66,8477425,Miles Wood,L,COL,29,79,17,13,30
66,8477989,Christian Dvorak,C,MTL,28,62,16,14,30
66,8477987,Ryan Donato,C,CHI,28,61,16,14,30
66,8477450,Jason Dickinson,C,CHI,29,50,14,16,30
66,8479661,Tanner Jeannot,L,LAK,27,77,13,17,30
66,8476278,Colin Blackwell,C,DAL,31,77,13,17,30
66,8476292,Ondrej Palat,L,NJD,33,69,12,18,30
66,8477488,Brett Pesce,D,NJD,30,75,7,23,30
66,8476923,Damon Severson,D,CBJ,30,78,7,23,30
66,8482671,Owen Power,D,BUF,22,66,6,24,30
66,8479425,Filip Hronek,D,VAN,27,73,6,24,30
66,8481581,Thomas Harley,D,DAL,23,75,6,24,30
66,8483445,Cutter Gauthier,L,ANA,20,63,6,24,30
66,8475764,Cam Fowler,D,ANA,33,74,3,27,30
66,8477506,Ryan Pulock,D,NYI,30,76,1,29,30
66,8476461,Sean Couturier,C,PHI,32,71,15,14,29
66,8480789,Oliver Wahlstrom,R,NYI,24,71,15,14,29
66,8477952,Robby Fabbri,C,ANA,28,73,12,17,29
66,8482624,Daniil Miromanov,D,CGY,27,61,8,21,29
66,8481577,Philip Tomasino,C,NSH,23,66,7,22,29
66,8483490,Pavel Mintyukov,D,ANA,21,67,7,22,29
66,8476931,Jake McCabe,D,TOR,31,68,7,22,29
66,8479293,Brandon Tanev,L,SEA,33,63,16,12,28
66,8476981,Josh Anderson,R,MTL,30,74,14,14,28
66,8482809,Jackson Blake,R,CAR,21,56,14,14,28
66,8470621,Corey Perry,R,EDM,39,73,14,14,28
66,8480829,Jesperi Kotkaniemi,C,CAR,24,73,13,15,28
66,8473422,Nick Foligno,L,CHI,37,63,11,17,28
66,8476925,Colton Sissons,C,NSH,31,68,9,19,28
66,8482749,Joshua Roy,R,MTL,21,64,9,19,28
66,8481656,Aliaksei Protas,C,WSH,23,67,8,20,28
66,8478500,Ivan Provorov,D,CBJ,27,76,7,21,28
66,8479983,Mario Ferraro,D,SJS,26,77,7,21,28
66,8480727,Zach Whitecloud,D,VGK,28,49,7,21,28
66,8481523,Kirby Dach,C,MTL,23,63,6,22,28
66,8476331,Dylan DeMelo,D,WPG,31,63,5,23,28
66,8482660,Kent Johnson,C,CBJ,22,64,2,26,28
66,8480893,Kirill Marchenko,R,CBJ,24,67,16,11,27
66,8480068,Ryan Poehling,C,PHI,25,73,13,14,27
66,8477015,Connor Brown,R,EDM,30,71,13,14,27
66,8476927,Teddy Blueger,C,VAN,30,61,11,16,27
66,8481624,Ilya Mikheyev,R,CHI,30,57,11,16,27
66,8477353,Tyler Motte,C,DET,29,71,10,17,27
66,8484203,Bradly Nadeau,L,CAR,19,63,8,19,27
66,8480145,Neal Pionk,D,WPG,29,75,7,20,27
66,8482067,Connor Mackey,D,NYR,28,63,6,21,27
66,8474565,Alex Pietrangelo,D,VGK,34,56,4,23,27
66,8477845,Trevor van Riemsdyk,D,WSH,33,60,2,25,27
66,8479941,Justin Danforth,R,CBJ,31,61,19,7,26
66,8480459,Pius Suter,C,VAN,28,68,16,10,26
66,8482259,Bobby McMann,C,TOR,28,64,16,10,26
66,8476918,Jimmy Vesey,L,NYR,31,67,15,11,26
66,8480855,Jack McBain,C,UTA,24,64,13,13,26
66,8478109,Victor Olofsson,L,VGK,29,67,12,14,26
66,8481580,Connor McMichael,C,WSH,23,70,12,14,26
66,8477220,Nate Schmidt,D,FLA,33,68,11,15,26
66,8476960,Andreas Athanasiou,C,CHI,30,55,10,16,26
66,8477947,Sonny Milano,L,WSH,28,62,9,17,26
66,8479398,Samuel Girard,D,COL,26,69,7,19,26
66,8476892,Colton Parayko,D,STL,31,67,5,21,26
66,8476457,Adam Larsson,D,SEA,32,62,1,25,26
66,8476878,Zemgus Girgensons,C,TBL,30,80,15,10,25
66,8480144,David Kampf,C,TOR,29,68,11,14,25
66,8480748,Kiefer Sherwood,L,VAN,29,63,11,14,25
66,8481522,Peyton Krebs,C,BUF,23,56,10,15,25
66,8478970,Jalen Chatfield,D,CAR,28,68,6,19,25
66,8479402,Jake Bean,D,CGY,26,69,5,20,25
66,8477507,Nikita Zadorov,D,BOS,29,66,5,20,25
66,8480873,Rasmus Sandin,D,WSH,24,63,3,22,25
66,8476463,Jonas Brodin,D,MIN,31,75,2,23,25
66,8480281,Alexey Toropchenko,R,STL,25,58,17,7,24
66,8477478,William Carrier,L,CAR,30,61,15,9,24
66,8473533,Jordan Staal,C,CAR,36,69,12,12,24
66,8483457,Lane Hutson,D,MTL,20,67,12,12,24
66,8478115,Pierre Engvall,L,NYI,28,79,11,13,24
66,8477392,Hudson Fasching,R,NYI,29,66,11,13,24
66,8481535,Nils Hoglander,L,VAN,24,70,10,14,24
66,8473563,Nicklas Backstrom,C,WSH,37,58,9,15,24
66,8480762,Eric Robinson,L,CAR,29,54,9,15,24
66,8477839,Conor Sheary,L,TBL,32,82,8,16,24
66,8481553,Bobby Brink,R,PHI,23,64,6,18,24
66,8482074,Connor Zary,C,CGY,23,66,6,18,24
66,8476525,Colin Miller,D,WPG,32,61,6,18,24
66,8478133,Jake Evans,C,MTL,28,67,4,20,24
66,8480246,Nick Perbix,D,TBL,26,76,4,20,24
66,8478851,Alexandre Carrier,D,NSH,28,63,4,20,24
66,8479639,Dylan Coghlan,D,WPG,26,67,3,21,24
66,8475179,Dmitry Kulikov,D,FLA,34,62,2,22,24
66,8476902,Esa Lindell,D,DAL,30,72,2,22,24
66,8481059,Scott Perunovich,D,STL,26,63,0,24,24
66,8476469,Joel Armia,R,MTL,31,65,16,7,23
66,8481601,Simon Holmstrom,R,NYI,23,70,14,9,23
66,8481093,Rafael Harvey-Pinard,L,MTL,25,63,13,10,23
66,8479359,Beck Malenstyn,L,BUF,26,50,12,11,23
66,8478013,Jake Walman,D,SJS,28,70,10,13,23
66,8477498,Darnell Nurse,D,EDM,29,72,7,16,23
66,8479718,Alex Barré-Boulet,C,MTL,27,53,7,16,23
66,8480448,Parker Kelly,L,COL,25,73,14,8,22
66,8478432,Christian Fischer,R,DET,27,75,9,13,22
66,8479393,Noah Gregor,L,OTT,26,66,8,14,22
66,8476422,Mike Reilly,D,NYI,31,74,8,14,22
66,8479324,Ryan Lindgren,D,NYR,26,59,7,15,22
66,8482655,Janis Moser,D,TBL,24,80,6,16,22
66,8474151,Ryan McDonagh,D,TBL,35,76,3,19,22
66,8476885,Jacob Trouba,D,NYR,30,76,3,19,22
66,8477435,Ryan Graves,D,PIT,29,79,3,19,22
66,8480049,Dylan Samberg,D,WPG,25,68,2,20,22
66,8480995,Pontus Holmberg,R,TOR,25,58,12,9,21
66,8480021,Jack Studnicka,C,LAK,25,54,12,9,21
66,8483491,Ivan Miroshnichenko,L,WSH,20,55,11,10,21
66,8478508,Yakov Trenin,C,MIN,27,63,11,10,21
66,8477508,Curtis Lazar,C,NJD,29,66,10,11,21
66,8477979,Nicolas Aube-Kubel,R,BUF,28,56,10,11,21
66,8482117,Lukas Reichel,L,CHI,22,58,9,12,21
66,8478434,Keegan Kolesar,R,VGK,27,67,9,12,21
66,8482679,Matt Coronato,R,CGY,22,70,8,13,21
66,8481481,Blake Lizotte,C,PIT,27,59,7,14,21
66,8479370,Tyson Jost,C,CAR,26,60,6,15,21
66,8478882,Vladislav Gavrikov,D,LAK,29,68,5,16,21
66,8481546,Cam York,D,PHI,23,67,4,17,21
66,8482803,Olen Zellweger,D,ANA,21,64,4,17,21
66,8480807,Mattias Samuelsson,D,BUF,24,48,2,19,21
66,8477903,Garnet Hathaway,R,PHI,33,59,12,8,20
66,8481554,Kaapo Kakko,R,NYR,23,66,11,9,20
66,8477406,Mattias Janmark,C,EDM,32,70,11,9,20
66,8479336,Carl Grundstrom,R,SJS,27,42,10,10,20
66,8480980,Connor Dewar,C,TOR,25,64,10,10,20
66,8482125,Alexander Holtz,R,VGK,22,66,9,11,20
66,8476374,Sean Kuraly,C,CBJ,31,54,8,12,20
66,8477499,Rasmus Ristolainen,D,PHI,30,62,6,14,20
66,8484149,Gavin Brindley,C,CBJ,20,48,6,14,20
66,8476429,Scott Mayfield,D,NYI,32,77,5,15,20
66,8482730,Brandt Clarke,D,LAK,21,54,5,15,20
66,8476891,Matthew Grzelcyk,D,PIT,30,77,4,16,20
66,8479982,Conor Timmins,D,TOR,26,53,3,17,20
66,8475790,Erik Gudbranson,D,CBJ,32,79,3,17,20
66,8474574,Tyler Myers,D,VAN,34,71,3,17,20
66,8480001,Urho Vaakanainen,D,ANA,25,60,1,19,20
66,8480074,Alexandre Texier,C,STL,25,62,12,7,19
66,8479619,Michael Carcone,L,UTA,28,64,11,8,19
66,8473453,Trevor Lewis,C,LAK,37,73,9,10,19
66,8475722,Jason Zucker,L,BUF,32,67,8,11,19
66,8480289,Morgan Barron,C,WPG,26,58,8,11,19
66,8479066,Ryan Lomberg,L,CGY,30,64,8,11,19
66,8477446,Michael McCarron,R,NSH,29,54,7,12,19
66,8478585,Derek Ryan,C,EDM,38,60,7,12,19
66,8482101,Danil Gushchin,L,SJS,22,52,7,12,19
66,8475343,Nic Dowd,C,WSH,34,58,6,13,19
66,8476988,Matt Benning,D,SJS,30,67,5,14,19
66,8474673,TJ Brodie,D,CHI,34,64,4,15,19
66,8476329,Travis Boyd,C,MIN,31,53,3,16,19
66,8475690,Chris Tanev,D,TOR,35,56,2,17,19
66,8475324,Nick Jensen,D,OTT,34,66,2,17,19
66,8481521,Ronnie Attard,D,PHI,25,62,2,17,19
66,8480058,Pierre-Olivier Joseph,D,STL,25,54,2,17,19
66,8475188,Brayden McNabb,D,VGK,33,58,1,18,19
66,8479998,Mikey Anderson,D,LAK,25,61,1,18,19
66,8480355,Mark Kastelic,C,BOS,25,55,11,7,18
66,8483524,Shane Wright,C,SEA,20,64,9,9,18
66,8480025,MacKenzie Entwistle,R,FLA,25,62,9,9,18
66,8476467,Jamie Oleksiak,D,SEA,32,70,6,12,18
66,8480011,Klim Kostin,C,SJS,25,53,6,12,18
66,8476624,Barclay Goodrow,C,SJS,31,58,6,12,18
66,8475225,Craig Smith,C,CHI,35,54,6,12,18
66,8481019,David Gustafsson,C,WPG,24,46,5,13,18
66,8480878,Nils Lundkvist,D,DAL,24,63,4,14,18
66,8471709,Marc-Edouard Vlasic,D,SJS,37,55,4,14,18
66,8477365,Connor Clifton,D,BUF,29,54,3,15,18
66,8478507,John Marino,D,UTA,27,66,3,15,18
66,8481477,Nico Sturm,C,SJS,29,51,10,7,17
66,8482062,Cole Smith,L,NSH,29,58,9,8,17
66,8482077,Dylan Holloway,L,EDM,23,55,9,8,17
66,8481032,Paul Cotter,C,NJD,25,62,8,9,17
66,8476873,Mark Jankowski,C,NSH,30,54,8,9,17
66,8475231,Casey Cizikas,C,NYI,33,65,7,10,17
66,8482166,Shakir Mukhamadullin,D,SJS,22,48,7,10,17
66,8482737,Zack Bolduc,C,STL,21,60,6,11,17
66,8483468,Jiri Kulich,C,BUF,20,57,6,11,17
66,8483499,Liam Ohgren,L,MIN,20,58,6,11,17
66,8482142,Jamie Drysdale,D,PHI,22,61,6,11,17
66,8481567,Henry Thrun,D,SJS,23,45,6,11,17
66,8481014,Alexander Romanov,D,NYI,24,77,5,12,17
66,8475220,Marcus Foligno,L,MIN,33,54,4,13,17
66,8481441,Joe Snively,C,DET,28,62,4,13,17
66,8482176,Wyatt Kaiser,D,CHI,22,51,3,14,17
66,8478840,Will Borgen,D,SEA,28,64,3,14,17
66,8479976,Juuso Valimaki,D,UTA,26,66,3,14,17
66,8480860,Kevin Bahl,D,CGY,24,53,3,14,17
66,8479369,Andrew Peeke,D,BOS,26,62,1,16,17
66,8480891,Michael Kesselring,D,UTA,24,53,1,16,17
66,8482659,Josh Doan,R,UTA,22,61,9,7,16
66,8482155,Alex Laferriere,R,LAK,23,60,8,8,16
66,8477931,Tomas Nosek,L,FLA,32,61,8,8,16
66,8480292,Carson Meyer,R,ANA,27,40,8,8,16
66,8480003,Jesper Boqvist,C,FLA,26,64,7,9,16
66,8476879,Cody Ceci,D,EDM,31,68,7,9,16
66,8478043,Sam Lafferty,C,BUF,29,58,7,9,16
66,8476994,Vinnie Hinostroza,C,NSH,30,56,7,9,16
66,8480796,Martin Fehervary,D,WSH,25,45,6,10,16
66,8482666,Scott Morrow,D,CAR,22,56,6,10,16
66,8479414,Nathan Bastian,R,NJD,27,56,6,10,16
66,8478421,A.J. Greer,L,FLA,28,54,6,10,16
66,8477573,Nathan Walker,L,STL,30,50,6,10,16
66,8483482,Tristan Luneau,D,ANA,20,61,5,11,16
66,8480035,Henri Jokiharju,D,BUF,25,62,5,11,16
66,8478569,Noel Acciari,C,PIT,33,52,4,12,16
66,8483466,Kevin Korchinski,D,CHI,20,62,4,12,16
66,8482451,Mikael Pyyhtia,L,CBJ,23,37,4,12,16
66,8474013,Ian Cole,D,UTA,35,52,3,13,16
66,8482192,Isaak Phillips,D,CHI,23,45,2,14,16
66,8482087,Kaiden Guhle,D,MTL,22,64,2,14,16
66,8482634,Alex Steeves,C,TOR,25,55,2,14,16
66,8475462,Radko Gudas,D,ANA,34,65,1,15,16
66,8479520,Brandon Duhaime,R,WSH,27,53,10,5,15
66,8475842,Sam Carrick,C,NYR,32,59,9,6,15
66,8481704,Juuso Parssinen,C,NSH,23,50,8,7,15
66,8483565,Nick Blankenburg,D,NSH,26,67,8,7,15
66,8474034,Patrick Maroon,L,CHI,36,48,7,8,15
66,8477380,Jonny Brodzinski,C,NYR,31,49,6,9,15
66,8482157,Will Cuylle,L,NYR,22,65,5,10,15
66,8481701,Santeri Hatakka,D,NJD,23,39,5,10,15
66,8477938,Haydn Fleury,D,WPG,28,43,4,11,15
66,8476874,Olli Maatta,D,DET,30,63,4,11,15
66,8475791,Taylor Hall,L,CHI,33,55,3,12,15
66,8476312,Josh Manson,D,COL,33,60,3,12,15
66,8478416,Erik Cernak,D,TBL,27,70,2,13,15
66,8475233,David Savard,D,MTL,34,69,2,13,15
66,8482073,Braden Schneider,D,NYR,23,65,2,13,15
66,8478136,Jake Middleton,D,MIN,28,76,2,13,15
66,8482148,Hendrix Lapierre,C,WSH,22,54,8,6,14
66,8476822,Luke Glendening,C,TBL,35,80,7,7,14
66,8480806,Isac Lundestrom,C,ANA,25,56,7,7,14
66,8479996,Cody Glass,C,NSH,25,55,6,8,14
66,8479536,Axel Jonsson-Fjallby,L,WPG,26,32,6,8,14
66,8482245,Artem Zub,D,OTT,29,68,5,9,14
66,8481599,Victor Soderstrom,D,UTA,23,51,5,9,14
66,8479315,Joey Anderson,R,CHI,26,53,4,10,14
66,8478178,Darren Raddysh,D,TBL,28,67,4,10,14
66,8482111,Justin Barron,D,MTL,23,64,3,11,14
66,8477369,Carson Soucy,D,VAN,30,64,3,11,14
66,8481600,Tobias Bjornfot,D,FLA,23,40,3,11,14
66,8481178,Egor Zamula,D,PHI,24,53,2,12,14
66,8470600,Ryan Suter,D,STL,39,65,1,13,14
66,8476967,Brett Kulak,D,EDM,30,61,1,13,14
66,8481537,Nikita Okhotiuk,D,CGY,24,56,9,4,13
66,8481641,Joel Kiviranta,L,COL,28,73,6,7,13
66,8475455,Brenden Dillon,D,NJD,34,50,5,8,13
66,8480441,Trey Fix-Wolansky,R,CBJ,25,39,5,8,13
66,8475762,Derek Forbort,D,VAN,32,47,5,8,13
66,8476856,Mathew Dumba,D,DAL,30,72,4,9,13
66,8481527,Kaedan Korczak,D,VGK,23,43,4,9,13
66,8471817,Ryan Reaves,R,TOR,37,53,4,9,13
66,8477919,Frederick Gaudreau,C,MIN,31,65,3,10,13
66,8475279,Ben Chiarot,D,DET,33,64,3,10,13
66,8478452,Caleb Jones,D,LAK,27,57,3,10,13
66,8480887,Jordan Harris,D,MTL,24,57,3,10,13
66,8480073,Erik Brannstrom,D,COL,25,64,2,11,13
66,8474612,Travis Hamonic,D,OTT,34,50,2,11,13
66,8480172,Jan Rutta,D,SJS,34,66,0,13,13
66,8482652,Walker Duehr,R,CGY,27,40,9,3,12
66,8482744,James Malatesta,L,CBJ,21,38,7,5,12
66,8476889,Radek Faksa,C,STL,30,55,6,6,12
66,8476934,Brock McGinn,L,ANA,30,56,6,6,12
66,8481617,Vasily Podkolzin,R,VAN,23,47,4,8,12
66,8482859,Zack Ostapchuk,C,OTT,21,53,4,8,12
66,8479980,Nicolas Hague,D,VGK,26,59,3,9,12
66,8479344,Jesse Puljujarvi,R,PIT,26,57,3,9,12
66,8479439,Jacob MacDonald,D,COL,31,50,3,9,12
66,8478443,Brandon Carlo,D,BOS,28,51,3,9,12
66,8474567,Zach Bogosian,D,MIN,34,59,3,9,12
66,8479328,Julien Gauthier,R,NYI,27,61,2,10,12
66,8480070,Ian Mitchell,D,BOS,25,49,2,10,12
66,8479249,Andrew Poturalski,C,SJS,30,34,1,11,12
66,8479671,Mathieu Olivier,R,CBJ,27,45,8,3,11
66,8477070,Liam O'Brien,C,UTA,30,49,8,3,11
66,8479291,Kevin Rooney,C,CGY,31,50,5,6,11
66,8479378,Logan Stanley,D,WPG,26,44,5,6,11
66,8482807,Ethan Del Mastro,D,CHI,21,50,5,6,11
66,8481708,Zac Jones,D,NYR,24,45,4,7,11
66,8482762,Simon Edvinsson,D,DET,21,55,4,7,11
66,8481013,Jonatan Berggren,R,DET,24,52,3,8,11
66,8479026,Philippe Myers,D,TOR,27,57,3,8,11
66,8477034,Jaycob Megna,D,FLA,32,48,3,8,11
66,8482784,Zach Dean,C,STL,21,39,2,9,11
66,8480222,Sebastian Aho,D,PIT,28,68,1,10,11
66,8480848,Ty Dellandrea,C,SJS,24,47,7,3,10
66,8478211,Dryden Hunt,L,CGY,29,51,6,4,10
66,8480845,Rasmus Kupari,C,WPG,24,43,5,5,10
66,8481161,Jake Christiansen,D,CBJ,25,50,5,5,10
66,8477018,Ben Hutton,D,VGK,31,40,4,6,10
66,8481716,Dmitri Voronkov,L,CBJ,24,44,4,6,10
66,8482496,Nils Aman,C,VAN,24,38,4,6,10
66,8479372,Joshua Mahura,D,SEA,26,54,3,7,10
66,8481568,Alex Vlasic,D,CHI,23,58,1,9,10
66,8478399,Jonas Siegenthaler,D,NJD,27,58,1,9,10
66,8475718,Justin Holl,D,DET,32,63,0,10,10
66,8476858,Phillip Di Giuseppe,L,VAN,31,43,7,2,9
66,8482095,Tyler Kleven,D,OTT,22,42,7,2,9
66,8481789,Tye Kartye,L,SEA,23,50,7,2,9
66,8481517,Brett Leason,R,ANA,25,52,5,4,9
66,8475235,Nicolas Deslauriers,L,PHI,33,53,5,4,9
66,8481556,John Beecher,C,BOS,23,28,5,4,9
66,8477851,Jordan Oesterle,D,BOS,32,47,4,5,9
66,8483493,Frank Nazar,C,CHI,20,46,3,6,9
66,8476473,Connor Murphy,D,CHI,31,35,3,6,9
66,8479348,Kale Clague,D,BUF,26,43,2,7,9
66,8477401,John Hayden,C,SEA,29,33,2,7,9
66,8479371,Dante Fabbro,D,NSH,26,65,1,8,9
66,8475750,Jon Merrill,D,MIN,32,66,1,8,9
66,8477482,Zachary Sanford,L,CHI,30,38,6,2,8
66,8481028,Martin Pospisil,C,CGY,25,54,5,3,8
66,8479638,Justin Brazeau,R,BOS,26,42,5,3,8
66,8477887,Patrick Brown,C,BOS,32,43,5,3,8
66,8483570,Ben Meyers,C,SEA,26,31,5,3,8
66,8479543,Michael Pezzetta,L,MTL,26,58,4,4,8
66,8480252,Cole Guttman,C,CHI,25,43,4,4,8
66,8478831,Kevin Stenlund,C,UTA,28,61,4,4,8
66,8480192,Johnathan Kovacevic,D,NJD,27,55,4,4,8
66,8478859,Niko Mikkola,D,FLA,28,55,4,4,8
66,8478451,Ethan Bear,D,WSH,27,51,3,5,8
66,8481167,Brayden Pachal,D,CGY,25,48,3,5,8
66,8477962,Brendan Lemieux,L,CAR,28,26,3,5,8
66,8483460,David Jiricek,D,CBJ,21,66,3,5,8
66,8478409,Anthony Richard,C,PHI,28,31,3,5,8
66,8477335,Kyle Burroughs,D,LAK,29,43,2,6,8
66,8475208,Brian Dumoulin,D,ANA,33,66,2,6,8
66,8480157,Calle Rosen,D,COL,30,40,2,6,8
66,8475177,Calvin de Haan,D,COL,33,43,2,6,8
66,8476442,Matt Nieto,L,PIT,32,50,2,6,8
66,8481598,Philip Broberg,D,EDM,23,50,2,6,8
66,8482751,Ryan Winterton,C,SEA,21,34,1,7,8
66,8479442,Troy Stecher,D,EDM,30,45,1,7,8
66,8483495,Simon Nemec,D,NJD,20,55,0,8,8
66,8480879,Jacob Bernard-Docker,D,OTT,24,39,0,8,8
66,8474568,Luke Schenn,D,NSH,35,49,0,8,8
66,8479968,Vinni Lettieri,C,BOS,29,43,6,1,7
66,8481550,Adam Beckman,L,NJD,23,35,5,2,7
66,8481679,Maxence Guenette,D,OTT,23,35,5,2,7
66,8476867,Brendan Gaunce,C,MIN,30,34,3,4,7
66,8479994,Jaret Anderson-Dolan,C,WPG,25,38,3,4,7
66,8479991,Jake Leschyshyn,C,NYR,25,30,3,4,7
66,8483763,Maksymilian Szuber,D,UTA,22,41,3,4,7
66,8481518,Nolan Foote,L,NJD,24,34,2,5,7
66,8476441,Joel Edmundson,D,LAK,31,36,2,5,7
66,8479986,Kole Lind,R,DAL,26,51,2,5,7
66,8481056,Spencer Stastney,D,NSH,24,28,2,5,7
66,8482747,Brennan Othmann,L,NYR,21,37,2,5,7
66,8479419,Brett Murray,L,BUF,26,19,2,5,7
66,8480950,Ilya Lyubushkin,D,DAL,30,61,1,6,7
66,8483619,Filip Roos,D,OTT,25,35,1,6,7
66,8482511,Mason Lohrei,D,BOS,23,29,1,6,7
66,8478468,Jeremy Lauzon,D,NSH,27,50,0,7,7
66,8482861,Vincent Iorio,D,WSH,22,34,0,7,7
66,8478450,Parker Wotherspoon,D,BOS,27,40,0,7,7
66,8476952,Dominic Toninato,C,WPG,30,37,5,1,6
66,8481592,Jakob Pelletier,L,CGY,23,40,5,1,6
66,8479972,Mason Shaw,C,WPG,26,35,3,3,6
66,8484254,Akito Hirose,D,VAN,25,48,3,3,6
66,8481751,Lukas Rousek,R,BUF,25,39,3,3,6
66,8478017,Mark Friedman,D,VAN,29,39,3,3,6
66,8480245,Olle Lycksell,R,PHI,25,35,3,3,6
66,8481605,Jackson LaCombe,D,ANA,23,35,3,3,6
66,8481754,Nikita Nesterenko,C,ANA,23,33,3,3,6
66,8484911,Collin Graf,R,SJS,22,37,3,3,6
66,8482141,Lukas Cormier,D,VGK,22,25,3,3,6
66,8482733,Logan Mailloux,D,MTL,31,29,2,4,6
66,8476372,Nick Seeler,D,PHI,31,31,2,4,6
66,8480990,Declan Chisholm,D,MIN,24,34,2,4,6
66,8480834,Ty Emberson,D,SJS,24,37,2,4,6
66,8471677,Jack Johnson,D,CBJ,37,62,2,4,6
66,8483012,Logan Morrison,C,SEA,22,41,2,4,6
66,8482145,Mavrik Bourque,C,DAL,22,46,2,4,6
66,8482144,Jack Thompson,D,SJS,22,27,2,4,6
66,8480007,Jonas Rondbjerg,R,VGK,25,36,0,6,6
66,8481532,Alex Turcotte,C,LAK,23,53,4,1,5
66,8478011,Louie Belpedio,D,PHI,28,17,3,2,5
66,8473446,Erik Johnson,D,PHI,36,51,2,3,5
66,8474166,Alec Martinez,D,CHI,37,48,2,3,5
66,8483549,Lucas Condotta,L,MTL,27,32,2,3,5
66,8478424,Jansen Harkins,C,ANA,27,39,2,3,5
66,8479772,Zack MacEwen,R,OTT,28,52,2,3,5
66,8479379,Givani Smith,R,SJS,26,33,2,3,5
66,8480880,Jakub Lauko,C,MIN,24,33,2,3,5
66,8482172,Landon Slaggert,L,CHI,22,29,2,3,5
66,8479320,Maxime Lajoie,D,SEA,27,24,2,3,5
66,8481147,Reese Johnson,C,MIN,26,36,1,4,5
66,8482964,Arber Xhekaj,D,MTL,23,53,1,4,5
66,8476913,Devin Shore,C,MIN,30,30,1,4,5
66,8477384,Joshua Brown,D,EDM,30,53,0,5,5
66,8478146,Matthew Highmore,C,OTT,28,35,3,1,4
66,8482070,Mitchell Chaffee,R,TBL,26,44,3,1,4
66,8480870,Bo Groulx,C,NYR,24,30,3,1,4
66,8484258,Sam Malinski,D,COL,26,24,3,1,4
66,8481422,Jake Lucchini,C,NSH,29,25,3,1,4
66,8474090,Brendan Smith,D,DAL,35,58,2,2,4
66,8482713,Mackie Samoskevich,R,FLA,22,43,2,2,4
66,8481609,Vladislav Kolyachonok,D,UTA,23,26,2,2,4
66,8477073,Kurtis MacDermid,L,NJD,30,28,2,2,4
66,8482765,Isak Rosen,R,BUF,21,23,2,2,4
66,8483630,Pavol Regenda,L,ANA,25,32,2,2,4
66,8480851,Akil Thomas,C,LAK,24,23,2,2,4
66,8478502,Dennis Gilbert,D,BUF,28,20,2,2,4
66,8482470,Ilya Solovyov,D,CGY,24,20,2,2,4
66,8477462,Robert Hagg,D,VGK,29,28,1,3,4
66,8477971,Andreas Englund,D,LAK,28,27,1,3,4
66,8482147,Jean-Luc Foudy,C,COL,22,21,1,3,4
66,8479985,Cale Fleury,D,SEA,26,32,1,3,4
66,8481065,Angus Crookshank,L,OTT,25,21,1,3,4
66,8478454,Noah Juulsen,D,VAN,27,28,0,4,4
66,8479944,Zach Aston-Reese,C,VGK,30,45,0,4,4
66,8475958,Michael Sgarbossa,C,WSH,32,26,0,4,4
66,8482177,Marat Khusnutdinov,C,MIN,22,31,0,4,4
66,8475795,Dylan McIlrath,D,WSH,32,14,0,4,4
66,8479367,William Lockwood,R,FLA,26,24,0,4,4
66,8478874,Adam Gaudette,R,OTT,28,35,3,0,3
66,8483397,Marc McLaughlin,C,BOS,25,35,3,0,3
66,8479362,Riley Tufte,L,BOS,26,23,3,0,3
66,8479981,Jonah Gadjovich,L,FLA,26,38,2,1,3
66,8482153,Brendan Brisson,C,VGK,23,32,2,1,3
66,8475413,Justin Dowling,C,NJD,34,12,2,1,3
66,8474062,Riley Nash,C,NYR,35,16,2,1,3
66,8481541,Samuel Bolduc,D,NYI,24,25,2,1,3
66,8482858,Ryker Evans,D,SEA,23,23,2,1,3
66,8482061,Brandon Biro,L,SEA,26,13,2,1,3
66,8477244,Chad Ruhwedel,D,NYR,34,25,1,2,3
66,8480844,Grigori Denisenko,L,VGK,24,33,1,2,3
66,8480890,Jan Jenik,C,OTT,24,31,1,2,3
66,8481543,Nikita Alexandrov,C,STL,24,19,1,2,3
66,8482250,Callahan Burke,C,VGK,27,25,1,2,3
66,8478021,William Lagesson,D,DET,28,20,1,2,3
66,8484304,Uvis Balinskis,D,FLA,28,9,1,2,3
66,8480196,Jacob Bryson,D,BUF,27,45,0,3,3
66,8479576,Vincent Desharnais,D,VAN,28,27,0,3,3
66,8482929,Emil Lilleberg,D,TBL,23,25,0,3,3
66,8481024,Linus Karlsson,C,VAN,25,9,0,3,3
66,8477527,Ross Johnston,L,ANA,30,32,0,3,3
66,8484255,Jason Polin,R,COL,25,7,2,0,2
66,8481122,Simon Benoit,D,TOR,26,37,1,1,2
66,8483395,Arshdeep Bains,L,VAN,23,6,1,1,2
66,8480084,Nick DeSimone,D,NJD,30,19,1,1,2
66,8483489,Fraser Minten,C,TOR,31,12,1,1,2
66,8483471,Brad Lambert,C,WPG,31,9,1,1,2
66,8477467,Gustav Olofsson,D,SEA,30,14,1,1,2
66,8481030,Jack St. Ivany,D,PIT,25,14,1,1,2
66,8482787,Nikita Chibrikov,R,WPG,31,8,1,1,2
66,8484287,Cole McWard,D,VAN,23,20,0,2,2
66,8481237,Kyle MacLean,C,NYI,25,24,0,2,2
66,8481043,Cole Koepke,L,BOS,26,24,0,2,2
66,8477810,Joel Hanley,D,CGY,33,26,0,2,2
66,8483567,Georgii Merkulov,C,BOS,24,9,0,2,2
66,8483512,Matthew Savoie,C,EDM,20,13,0,2,2
66,8482516,Matthew Kessel,D,STL,24,16,0,2,2
66,8477149,Scott Sabourin,R,SJS,32,14,0,2,2
66,8479587,Rhett Gardner,C,PHI,28,20,0,2,2
66,8482201,Gage Goncalves,C,TBL,23,21,1,0,1
66,8478051,Max Willman,C,NJD,29,27,1,0,1
66,8480267,Sammy Walker,C,MIN,25,15,1,0,1
66,8483597,Milos Kelemen,L,UTA,25,10,1,0,1
66,8481564,Ryan Johnson,D,BUF,23,12,1,0,1
66,8482162,Roby Jarventie,L,EDM,22,14,1,0,1
66,8484325,Waltteri Merela,C,TBL,26,23,1,0,1
66,8481585,Egor Afanasyev,L,SJS,23,15,1,0,1
66,8475755,Alexander Petrovic,D,DAL,32,16,1,0,1
66,8475780,Chris Wagner,R,COL,33,10,1,0,1
66,8481726,Adam Edstrom,C,NYR,24,11,1,0,1
66,8482118,Sam Colangelo,R,ANA,23,16,1,0,1
66,8478147,Bokondji Imama,L,PIT,28,5,1,0,1
66,8481534,Raphael Lavoie,C,EDM,24,2,1,0,1
66,8481743,Marc Del Gaizo,D,NSH,25,20,0,1,1
66,8478881,Brett Seney,L,CHI,28,10,0,1,1
66,8477320,Anton Blidh,L,NYR,29,18,0,1,1
66,8481206,John Ludvig,D,PIT,24,10,0,1,1
66,8477473,Justin Bailey,R,SJS,29,20,0,1,1
66,8478446,Glenn Gawdin,C,LAK,27,13,0,1,1
66,8481699,Aku Raty,R,UTA,23,16,0,1,1
66,8482094,Daemon Hunt,D,MIN,22,14,0,1,1
66,8478477,Mitchell Stephens,C,SEA,27,15,0,1,1
66,8481462,Mason Morelli,L,VGK,28,16,0,1,1
66,8481578,Graeme Clarke,R,MIN,23,12,0,1,1
66,8480075,Cameron Crotty,D,MIN,25,12,0,1,1
66,8482165,Yan Kuznetsov,D,CGY,22,16,0,1,1
66,8480874,Adam Ginning,D,PHI,24,8,0,1,1
66,8482476,Emil Heineman,L,MTL,23,5,0,1,1
66,8480823,Alexander Alexeyev,D,WSH,25,10,0,1,1
66,8483920,Pierrick Dube,R,WSH,23,4,0,1,1
66,8483546,Marshall Rifai,D,TOR,26,5,0,1,1
66,8482460,Matt Rempe,C,NYR,22,8,0,1,1
66,8482197,Adam Raska,R,MIN,23,8,0,1,1
66,8481006,Tyler Tucker,D,STL,24,16,0,0,0
66,8481719,Maxwell Crozier,D,TBL,24,11,0,0,0
66,8480468,James Hamblin,L,EDM,25,18,0,0,0
66,8480032,Shane Bowers,C,NJD,25,10,0,0,0
66,8479330,Brandon Gignac,C,MTL,27,12,0,0,0
66,8481593,Jayden Struble,D,MTL,23,17,0,0,0
66,8481655,Cole Schwindt,R,CGY,23,5,0,0,0
66,8482102,Vasily Ponomarev,C,PIT,22,15,0,0,0
66,8480306,Grant Hutton,D,NYI,29,3,0,0,0
66,8483407,Brandon Scanlin,D,NYR,25,11,0,0,0
66,8481806,Louis Crevier,D,CHI,23,13,0,0,0
66,8482088,Justin Sourdif,R,FLA,22,17,0,0,0
66,8483531,Brian Halonen,L,NJD,25,3,0,0,0
66,8483609,Adam Klapka,R,CGY,24,5,0,0,0
66,8479421,Jacob Moverare,D,LAK,26,4,0,0,0
66,8477993,Justin Kirkland,C,CGY,28,6,0,0,0
66,8483398,Declan Carlile,D,TBL,31,7,0,0,0
66,8477541,Dakota Mermis,D,TOR,30,10,0,0,0
66,8482126,Emil Andrae,D,PHI,31,4,0,0,0
66,8476323,Max McCormick,L,SEA,32,6,0,0,0
66,8483432,Luca Del Bel Belluz,C,CBJ,31,5,0,0,0
66,8484259,Ondrej Pavel,C,COL,31,3,0,0,0
66,8478854,Ryan Shea,D,PIT,27,8,0,0,0
66,8479522,Hardy Haman Aktell,D,WSH,26,6,0,0,0
66,8484321,Nikolas Matinpalo,D,OTT,26,2,0,0,0
66,8484326,Patrik Koch,D,UTA,28,0,0,0,0
66,8483401,Marc Johnstone,R,PIT,28,0,0,0,0
66,8480274,Philip Kemp,D,EDM,25,1,0,0,0
66,8470794,Joe Pavelski,C,,40,0,0,0,0
66,8479321,Lucas Johansen,D,,27,0,0,0,0
66,8477950,Tony DeAngelo,D,,29,0,0,0,0
66,8471218,Blake Wheeler,R,,38,0,0,0,0
66,8475197,Tyson Barrie,D,,33,0,0,0,0
66,8474157,Max Pacioretty,L,,36,0,0,0,0
66,8475744,Evgeny Kuznetsov,C,,32,0,0,0,0
66,8474037,James van Riemsdyk,L,,35,0,0,0,0
66,8476907,Mackenzie MacEachern,L,,30,0,0,0,0
66,8480216,Jacob Peterson,C,,25,0,0,0,0
66,8474602,Justin Schultz,D,,34,0,0,0,0
66,8482222,Alexander Barabanov,L,,30,0,0,0,0
66,8474031,Kevin Shattenkirk,D,,35,0,0,0,0
66,8477330,Dominik Kubalik,L,,29,0,0,0,0
66,8480884,Calen Addison,D,,24,0,0,0,0
66,8475906,John Klingberg,D,,32,0,0,0,0
66,8480008,Adam Ruzicka,C,,25,0,0,0,0
66,8476884,Derrick Pouliot,D,,30,0,0,0,0
66,8476919,Chris Tierney,C,,30,0,0,0,0
66,8479415,Michael McLeod,C,,26,0,0,0,0
66,8474870,Tyler Johnson,C,,34,0,0,0,0
66,8470604,Jeff Carter,C,,39,0,0,0,0
66,8478104,Sammy Blais,L,,28,0,0,0,0
66,8474884,Mike Hoffman,C,,35,0,0,0,0
66,8481591,Sam Poulin,R,,23,0,0,0,0
66,8471274,Alex Goligoski,D,,39,0,0,0,0
66,8476871,Tanner Pearson,L,,32,0,0,0,0
66,8476393,Nick Cousins,C,,31,0,0,0,0
66,8479977,Kailer Yamamoto,R,,26,0,0,0,0
66,8479346,Dillon Dube,C,,26,0,0,0,0
66,8480184,Gustav Lindstrom,D,,26,0,0,0,0
66,8479376,Victor Mete,D,,26,0,0,0,0
66,8473449,Kyle Okposo,R,,36,0,0,0,0
66,8481058,Jesse Ylonen,R,,25,0,0,0,0
66,8475752,Tyler Pitlick,C,,33,0,0,0,0
66,8481239,Samuel Fagemo,L,,24,0,0,0,0
66,8480821,Filip Zadina,R,,25,0,0,0,0
66,8470966,Mark Giordano,D,,41,0,0,0,0
66,8478495,Denis Gurianov,R,,27,0,0,0,0
66,8477464,Nic Petan,C,,29,0,0,0,0
66,8478099,Kevin Labanc,R,,29,0,0,0,0
66,8482241,Radim Zohorna,L,,28,0,0,0,0
66,8474040,Sam Gagner,C,,35,0,0,0,0
66,8479514,Rem Pitlick,C,,27,0,0,0,0
66,8478430,Oliver Kylington,D,,27,0,0,0,0
66,8479533,Joona Koppanen,L,,26,0,0,0,0
66,8479984,Cal Foote,D,,26,0,0,0,0
66,8477126,Jayson Megna,C,,34,0,0,0,0
66,8475164,Jakob Silfverberg,R,,34,0,0,0,0
66,8474009,Nick Bonino,C,,36,0,0,0,0
66,8479458,Nikita Zaitsev,D,,33,0,0,0,0
66,8477944,Jakub Vrana,L,,28,0,0,0,0
66,8471699,Andrew Cogliano,C,,37,0,0,0,0
66,8478067,Oskar Lindblom,L,,28,0,0,0,0
66,8471686,Marc Staal,D,,37,0,0,0,0
66,8470610,Zach Parise,L,,40,0,0,0,0
66,8478904,Steven Lorentz,C,,28,0,0,0,0
66,8473473,Milan Lucic,L,,36,0,0,0,0
66,8480031,Maxime Comtois,L,,25,0,0,0,0
66,8478512,Austin Czarnik,C,,32,0,0,0,0
66,8473504,Cal Clutterbuck,R,,37,0,0,0,0
66,8477454,Adam Erne,L,,29,0,0,0,0
66,8479383,Boris Katchouk,L,,26,0,0,0,0
66,8475825,Jani Hakanpää,D,,32,0,0,0,0
66,8477846,Ryan Carpenter,C,,33,0,0,0,0
66,8477930,Pierre-Edouard Bellemare,L,,39,0,0,0,0
66,8478400,Colin White,C,,27,0,0,0,0
66,8480226,Marián Studenic,R,,26,0,0,0,0
66,8480853,Liam Foudy,C,,24,0,0,0,0
66,8475797,Jarred Tinordi,D,,32,0,0,0,0
66,8479423,Alex Nylander,L,,26,0,0,0,0
66,8474618,Marco Scandella,D,,34,0,0,0,0
66,8478028,Fredrik Olofsson,L,,28,0,0,0,0
66,8474709,Matt Martin,L,,35,0,0,0,0
66,8481070,Hugh McGing,L,,26,0,0,0,0
66,8479546,Oskar Steen,C,,26,0,0,0,0
66,8474145,Robert Bortuzzo,D,,35,0,0,0,0
66,8476915,Jujhar Khaira,L,,30,0,0,0,0
66,8475278,Byron Froese,C,,33,0,0,0,0
66,8481812,Nikolai Knyzhov,D,,27,0,0,0,0
66,8478408,Travis Dermott,D,,28,0,0,0,0
66,8481077,John Leonard,L,,26,0,0,0,0
66,8479547,Matthew Phillips,R,,26,0,0,0,0
66,8480836,Jonathan Gruden,C,,24,0,0,0,0
66,8481690,Tyler Angle,C,,24,0,0,0,0
66,8475766,Austin Watson,L,,32,0,0,0,0
66,8481016,Ruslan Iskhakov,C,,24,0,0,0,0
66,8478078,Rourke Chartier,C,,28,0,0,0,0
66,8480776,Sheldon Rempal,R,,29,0,0,0,0
66,8478956,Samuel Laberge,L,NJD,27,2,0,0,0
66,8483045,Cameron Butler,R,CBJ,31,0,0,0,0
66,8484314,Jiri Smejkal,L,,28,0,0,0,0
67,8477492,Nathan MacKinnon,C,COL,29,82,58,85,143
67,8478402,Connor McDavid,C,EDM,27,78,42,94,136
67,8477934,Leon Draisaitl,C,EDM,29,81,53,75,128
67,8476453,Nikita Kucherov,R,TBL,31,82,32,93,125
67,8478420,Mikko Rantanen,R,COL,28,81,54,66,120
67,8477956,David Pastrnak,R,BOS,28,80,50,68,118
67,8478483,Mitch Marner,R,TOR,27,80,30,86,116
67,8477939,William Nylander,R,TOR,28,77,44,65,109
67,8478864,Kirill Kaprizov,L,MIN,27,72,48,60,108
67,8480002,Nico Hischier,C,NJD,25,73,33,72,105
67,8480027,Jason Robertson,L,DAL,25,82,37,66,103
67,8481559,Jack Hughes,C,NJD,23,75,42,60,102
67,8479314,Matthew Tkachuk,L,FLA,27,80,36,66,102
67,8477404,Jake Guentzel,C,TBL,30,82,56,44,100
67,8479318,Auston Matthews,C,TOR,27,79,55,44,99
67,8477942,Kevin Fiala,L,LAK,28,81,34,65,99
67,8476468,J.T. Miller,C,VAN,31,77,39,59,98
67,8477946,Dylan Larkin,C,DET,28,81,45,51,96
67,8478550,Artemi Panarin,L,NYR,33,73,27,68,95
67,8480012,Elias Pettersson,C,VAN,26,79,35,58,93
67,8475172,Nazem Kadri,C,CGY,34,79,39,53,92
67,8475913,Mark Stone,R,VGK,32,79,35,57,92
67,8478398,Kyle Connor,L,WPG,28,76,44,43,87
67,8475166,John Tavares,C,TOR,34,79,42,42,84
67,8471675,Sidney Crosby,C,PIT,37,71,36,48,84
67,8482116,Tim Stützle,C,OTT,22,78,29,54,83
67,8480801,Brady Tkachuk,L,OTT,25,79,35,47,82
67,8477501,Valeri Nichushkin,R,COL,29,80,41,40,81
67,8478010,Brayden Point,C,TBL,28,82,38,43,81
67,8477493,Aleksander Barkov,C,FLA,29,77,25,56,81
67,8477933,Sam Reinhart,C,FLA,29,79,37,43,80
67,8475786,Zach Hyman,L,EDM,32,78,37,43,80
67,8479385,Jordan Kyrou,C,STL,26,70,35,45,80
67,8476887,Filip Forsberg,L,NSH,30,73,36,43,79
67,8477496,Elias Lindholm,C,BOS,30,78,36,43,79
67,8480208,Drake Batherson,R,OTT,26,80,30,49,79
67,8480018,Nick Suzuki,C,MTL,25,74,23,56,79
67,8478439,Travis Konecny,R,PHI,27,74,30,48,78
67,8477951,Nick Schmaltz,C,UTA,28,78,29,49,78
67,8473419,Brad Marchand,L,BOS,36,79,37,40,77
67,8478493,Joel Eriksson Ek,C,MIN,27,71,35,42,77
67,8480803,Evan Bouchard,D,EDM,25,77,13,64,77
67,8477949,Alex Tuch,R,BUF,28,71,22,54,76
67,8476389,Vincent Trocheck,C,NYR,31,80,38,37,75
67,8479542,Brandon Hagel,L,TBL,26,82,34,41,75
67,8478449,Roope Hintz,C,DAL,28,82,32,43,75
67,8474141,Patrick Kane,R,DET,36,81,28,47,75
67,8481557,Matt Boldy,L,MIN,23,69,23,52,75
67,8482740,Wyatt Johnston,C,DAL,21,81,38,36,74
67,8474564,Steven Stamkos,C,NSH,34,72,32,42,74
67,8477402,Pavel Buchnevich,L,STL,29,74,28,46,74
67,8484144,Connor Bedard,C,CHI,19,66,28,46,74
67,8474600,Roman Josi,D,NSH,34,78,27,47,74
67,8471685,Anze Kopitar,C,LAK,37,79,27,47,74
67,8480069,Cale Makar,D,COL,26,67,19,55,74
67,8479323,Adam Fox,D,NYR,26,75,13,61,74
67,8475167,Victor Hedman,D,TBL,34,79,14,59,73
67,8478414,Timo Meier,R,NJD,28,74,36,36,72
67,8479343,Clayton Keller,R,UTA,26,79,25,47,72
67,8480800,Quinn Hughes,D,VAN,25,76,11,61,72
67,8475184,Chris Kreider,L,NYR,33,80,46,25,71
67,8478403,Jack Eichel,C,VGK,28,75,32,39,71
67,8475168,Matt Duchene,C,DAL,33,82,27,44,71
67,8478445,Mathew Barzal,C,NYI,27,80,26,45,71
67,8479420,Tage Thompson,C,BUF,27,71,33,37,70
67,8476454,Ryan Nugent-Hopkins,C,EDM,31,77,30,40,70
67,8480023,Robert Thomas,C,STL,25,68,19,51,70
67,8476456,Jonathan Huberdeau,C,CGY,31,78,17,53,70
67,8471214,Alex Ovechkin,L,WSH,39,72,37,32,69
67,8478427,Sebastian Aho,C,CAR,27,73,24,45,69
67,8478401,Pavel Zacha,C,BOS,27,80,22,47,69
67,8478519,Anthony Cirelli,C,TBL,27,82,19,50,69
67,8475692,Mats Zuccarello,R,MIN,37,75,23,45,68
67,8474578,Erik Karlsson,D,PIT,34,76,18,50,68
67,8481540,Cole Caufield,R,MTL,23,75,41,26,67
67,8475726,Tyler Toffoli,C,SJS,32,73,34,33,67
67,8477940,Nikolaj Ehlers,L,WPG,28,72,32,34,66
67,8479337,Alex DeBrincat,R,DET,27,81,26,40,66
67,8478444,Brock Boeser,R,VAN,27,74,26,40,66
67,8476459,Mika Zibanejad,C,NYR,31,75,18,48,66
67,8476460,Mark Scheifele,C,WPG,31,71,25,40,65
67,8478440,Dylan Strome,C,WSH,27,74,23,41,64
67,8475798,Mikael Granlund,C,SJS,32,70,15,49,64
67,8477409,Carter Verhaeghe,C,FLA,29,81,28,35,63
67,8474102,David Perron,L,OTT,36,76,22,41,63
67,8479325,Charlie McAvoy,D,BOS,27,75,16,47,63
67,8478407,Vince Dunn,D,SEA,28,74,14,49,63
67,8476875,Mike Matheson,D,MTL,30,73,9,54,63
67,8483808,Andrei Kuzmenko,L,CGY,28,74,28,34,62
67,8481528,Dylan Cozens,C,BUF,23,76,25,37,62
67,8477960,Adrian Kempe,R,LAK,28,79,20,42,62
67,8477504,Josh Morrissey,D,WPG,29,76,16,46,62
67,8476881,Tomas Hertl,C,VGK,31,80,24,37,61
67,8471215,Evgeni Malkin,C,PIT,38,69,19,42,61
67,8480839,Rasmus Dahlin,D,BUF,24,70,15,46,61
67,8479675,Trevor Moore,L,LAK,29,82,30,30,60
67,8476399,Blake Coleman,C,CGY,33,81,27,33,60
67,8476479,Phillip Danault,C,LAK,31,78,26,34,60
67,8480830,Andrei Svechnikov,R,CAR,24,68,22,38,60
67,8475810,Bryan Rust,R,PIT,32,70,32,27,59
67,8475169,Evander Kane,L,EDM,33,77,32,27,59
67,8477955,Jared McCann,L,SEA,28,74,25,34,59
67,8480865,Noah Dobson,D,NYI,24,78,8,51,59
67,8475784,Jeff Skinner,C,EDM,32,73,29,29,58
67,8481068,Yegor Sharangovich,C,CGY,26,77,25,33,58
67,8475754,Brock Nelson,C,NYI,33,81,23,35,58
67,8478873,Troy Terry,R,ANA,27,73,27,30,57
67,8474641,Adam Henrique,C,EDM,34,77,27,30,57
67,8478975,Mason Marchment,L,DAL,29,82,24,33,57
67,8474586,Jordan Eberle,R,SEA,34,76,24,33,57
67,8479400,Pierre-Luc Dubois,L,WSH,26,70,21,36,57
67,8482745,Mason McTavish,C,ANA,21,74,20,37,57
67,8479999,Casey Mittelstadt,C,COL,26,82,19,38,57
67,8476432,Boone Jenner,C,CBJ,31,68,36,20,56
67,8480064,Josh Norris,C,OTT,25,76,29,27,56
67,8475158,Ryan O'Reilly,C,NSH,33,72,26,30,56
67,8475765,Vladimir Tarasenko,R,DET,33,81,23,33,56
67,8479407,Jesper Bratt,L,NJD,26,80,14,42,56
67,8473512,Claude Giroux,R,OTT,36,80,14,42,56
67,8478047,Michael Bunting,L,PIT,29,72,21,34,55
67,8478460,Zach Werenski,D,CBJ,27,80,14,41,55
67,8482684,Luke Hughes,D,NJD,21,71,9,46,55
67,8477451,Ryan Hartman,R,MIN,30,75,29,25,54
67,8477416,Oliver Bjorkstrand,R,SEA,29,69,26,28,54
67,8475794,Tyler Seguin,C,DAL,32,80,24,30,54
67,8482124,Quinton Byfield,R,LAK,22,80,23,31,54
67,8482720,Matthew Knies,L,TOR,22,77,19,35,54
67,8477346,MacKenzie Weegar,D,CGY,30,75,16,38,54
67,8480036,Miro Heiskanen,D,DAL,25,72,11,43,54
67,8482093,Seth Jarvis,C,CAR,22,69,29,24,53
67,8476539,Jonathan Marchessault,R,NSH,34,76,29,23,52
67,8477476,Artturi Lehkonen,L,COL,29,80,28,24,52
67,8477500,Bo Horvat,C,NYI,29,79,24,28,52
67,8482078,Lucas Raymond,L,DET,22,80,18,34,52
67,8475753,Justin Faulk,D,STL,32,68,13,39,52
67,8476853,Morgan Rielly,D,TOR,30,75,9,43,52
67,8477494,Jonathan Drouin,L,COL,29,79,9,43,52
67,8475151,Kyle Palmieri,C,NYI,33,76,25,26,51
67,8482113,Anton Lundell,C,FLA,23,77,22,29,51
67,8480028,Morgan Frost,C,PHI,25,74,21,30,51
67,8478366,Frank Vatrano,R,ANA,30,74,20,31,51
67,8484153,Leo Carlsson,C,ANA,20,78,19,32,51
67,8480188,Fabian Zetterlund,L,SJS,25,61,19,32,51
67,8475218,Mattias Ekholm,D,EDM,34,73,16,35,51
67,8476346,Johnny Gaudreau,L,CBJ,31,68,12,39,51
67,8484166,Adam Fantilli,C,CBJ,20,65,24,26,50
67,8480797,Joel Farabee,L,PHI,24,75,22,28,50
67,8482159,Tyson Foerster,R,PHI,22,78,22,28,50
67,8475191,Reilly Smith,R,NYR,33,76,21,29,50
67,8478498,Jake DeBrusk,L,VAN,28,76,19,31,50
67,8478466,Daniel Sprong,R,VAN,27,65,18,32,50
67,8475170,Brayden Schenn,C,STL,33,70,13,37,50
67,8479425,Filip Hronek,D,VAN,27,73,13,37,50
67,8481560,Arthur Kaliyev,R,LAK,23,80,24,25,49
67,8477935,Sam Bennett,C,FLA,28,77,23,26,49
67,8475714,Calle Jarnkrok,C,TOR,33,74,21,28,49
67,8476448,William Karlsson,C,VGK,31,77,20,29,49
67,8478458,John (Jack) Roslovic,C,CAR,27,73,18,31,49
67,8477964,Ivan Barbashev,C,VGK,29,76,16,33,49
67,8474679,Gustav Nyquist,C,NSH,35,73,15,34,49
67,8477503,Max Domi,C,TOR,29,75,11,38,49
67,8471724,Kris Letang,D,PIT,37,78,6,43,49
67,8479992,Michael Rasmussen,C,DET,25,76,24,24,48
67,8482109,Alexis Lafrenière,L,NYR,23,76,23,25,48
67,8477511,Anthony Mantha,R,CGY,30,77,18,30,48
67,8476792,Torey Krug,D,STL,33,68,13,35,48
67,8483505,Matthew Poitras,C,BOS,20,74,13,35,48
67,8476419,Jean-Gabriel Pageau,C,NYI,32,78,12,36,48
67,8483431,Logan Cooley,C,UTA,20,77,21,26,47
67,8478133,Jake Evans,C,MTL,28,70,21,26,47
67,8482665,Matty Beniers,C,SEA,22,78,17,30,47
67,8484145,Zach Benson,L,BUF,19,72,17,30,47
67,8479987,Morgan Geekie,C,BOS,26,77,11,36,47
67,8476438,Brandon Saad,L,STL,32,71,25,21,46
67,8473994,Jamie Benn,L,DAL,35,82,23,23,46
67,8482699,Dylan Guenther,R,UTA,21,77,21,25,46
67,8476880,Tom Wilson,R,WSH,30,66,21,25,46
67,8476906,Shayne Gostisbehere,D,CAR,31,76,15,31,46
67,8474590,John Carlson,D,WSH,34,75,11,35,46
67,8479365,Trent Frederic,C,BOS,26,78,24,21,45
67,8482110,Dawson Mercer,C,NJD,23,69,20,25,45
67,8478413,Jordan Greenway,L,BUF,27,69,20,25,45
67,8482667,William Eklund,L,SJS,22,62,17,28,45
67,8482149,Cole Perfetti,C,WPG,22,63,15,30,45
67,8481524,Bowen Byram,D,BUF,23,69,11,34,45
67,8480145,Neal Pionk,D,WPG,29,75,8,37,45
67,8475314,Anders Lee,L,NYI,34,79,29,15,44
67,8477998,Warren Foegele,L,LAK,28,82,18,26,44
67,8475722,Jason Zucker,L,BUF,32,66,17,27,44
67,8477456,J.T. Compher,L,DET,29,79,16,28,44
67,8480798,Philipp Kurashev,C,CHI,25,67,15,29,44
67,8478438,Tommy Novak,C,NSH,27,69,14,30,44
67,8476869,Brady Skjei,D,NSH,30,74,12,32,44
67,8478469,Thomas Chabot,D,OTT,27,69,11,33,44
67,8475745,Charlie Coyle,C,BOS,32,78,22,21,43
67,8483515,Juraj Slafkovsky,L,MTL,20,71,20,23,43
67,8482175,JJ Peterka,R,BUF,22,64,20,23,43
67,8476981,Josh Anderson,R,MTL,30,73,20,23,43
67,8478462,Nicolas Roy,C,VGK,27,80,19,24,43
67,8478856,Conor Garland,R,VAN,28,74,17,26,43
67,8475768,Jaden Schwartz,C,SEA,32,71,16,27,43
67,8474716,Jared Spurgeon,D,MIN,35,78,12,31,43
67,8477986,Brandon Montour,D,SEA,30,71,20,22,42
67,8478891,Mason Appleton,C,WPG,28,66,20,22,42
67,8480009,Eeli Tolvanen,R,SEA,25,71,20,22,42
67,8480039,Martin Necas,C,CAR,25,67,19,23,42
67,8479525,Ross Colton,C,COL,28,79,19,23,42
67,8478396,Noah Hanifin,D,VGK,27,64,16,26,42
67,8478233,Andrew Mangiapane,L,WSH,28,69,16,26,42
67,8476927,Teddy Blueger,C,VAN,30,66,16,26,42
67,8477021,Alex Kerfoot,C,UTA,30,74,15,27,42
67,8478042,Viktor Arvidsson,L,EDM,31,75,12,30,42
67,8474150,Mikael Backlund,C,CGY,35,76,10,32,42
67,8477495,Seth Jones,D,CHI,30,65,10,32,42
67,8476979,Erik Gustafsson,D,DET,32,73,7,35,42
67,8478038,Devon Toews,D,COL,30,70,6,36,42
67,8475848,Brendan Gallagher,R,MTL,32,67,24,17,41
67,8481186,Logan O'Connor,R,COL,28,81,20,21,41
67,8481618,Alex Newhook,C,MTL,23,68,16,25,41
67,8476882,Teuvo Teravainen,C,CHI,30,62,15,26,41
67,8477444,Andre Burakovsky,L,SEA,29,69,15,26,41
67,8475760,Nick Bjugstad,C,UTA,32,73,14,27,41
67,8476854,Hampus Lindholm,D,BOS,30,73,12,29,41
67,8478397,Rasmus Andersson,D,CGY,28,72,11,30,41
67,8474563,Drew Doughty,D,LAK,35,70,9,32,41
67,8482660,Kent Johnson,C,CBJ,22,65,9,32,41
67,8477447,Shea Theodore,D,VGK,29,66,5,36,41
67,8478115,Pierre Engvall,L,NYI,28,78,18,22,40
67,8482702,Logan Stankoven,C,DAL,21,81,16,24,40
67,8476958,Jaccob Slavin,D,CAR,30,74,13,27,40
67,8471698,T.J. Oshie,R,WSH,38,74,22,17,39
67,8481711,Matias Maccelli,L,UTA,24,78,13,26,39
67,8479351,Sam Steel,C,DAL,26,81,13,26,39
67,8482092,Ridly Greig,C,OTT,22,75,12,27,39
67,8476925,Colton Sissons,C,NSH,31,67,12,27,39
67,8470613,Brent Burns,D,CAR,39,73,11,28,39
67,8478542,Evan Rodrigues,C,FLA,31,74,9,30,39
67,8481523,Kirby Dach,C,MTL,23,64,7,32,39
67,8475799,Nino Niederreiter,R,WPG,32,67,21,17,38
67,8477497,Sean Monahan,C,CBJ,30,69,17,21,38
67,8476826,Yanni Gourde,C,SEA,33,73,15,23,38
67,8474565,Alex Pietrangelo,D,VGK,34,67,15,23,38
67,8483468,Jiri Kulich,C,BUF,20,58,13,25,38
67,8476462,Dougie Hamilton,D,NJD,31,72,12,26,38
67,8480817,K'Andre Miller,D,NYR,24,68,9,29,38
67,8480893,Kirill Marchenko,R,CBJ,24,63,25,12,37
67,8476483,Rickard Rakell,R,PIT,31,67,24,13,37
67,8482089,Jake Neighbours,L,STL,22,71,23,14,37
67,8479591,Michael Eyssimont,C,TBL,28,81,20,17,37
67,8482712,Oskar Olausson,R,COL,22,76,13,24,37
67,8474053,Logan Couture,C,SJS,35,58,12,25,37
67,8477932,Aaron Ekblad,D,FLA,28,73,11,26,37
67,8482671,Owen Power,D,BUF,22,70,8,29,37
67,8481581,Thomas Harley,D,DAL,23,73,7,30,37
67,8482101,Danil Gushchin,L,SJS,22,63,7,30,37
67,8478472,Mathieu Joseph,R,STL,27,67,13,23,36
67,8477498,Darnell Nurse,D,EDM,29,73,12,24,36
67,8476458,Ryan Strome,C,ANA,31,73,11,25,36
67,8479410,Mikhail Sergachev,D,UTA,26,67,7,29,36
67,8481604,Pavel Dorofeyev,L,VGK,24,71,22,13,35
67,8482055,Drew O'Connor,L,PIT,26,62,21,14,35
67,8482146,Luke Evangelista,R,NSH,22,68,20,15,35
67,8473986,Alex Killorn,L,ANA,35,70,18,17,35
67,8478474,Lawson Crouse,L,UTA,27,71,18,17,35
67,8482097,Jack Quinn,R,BUF,23,63,18,17,35
67,8478463,Anthony Beauvillier,L,PIT,27,67,18,17,35
67,8475287,Erik Haula,L,NJD,33,73,17,18,35
67,8480220,Noah Cates,L,PHI,25,65,14,21,35
67,8480434,Sean Durzi,D,UTA,26,68,11,24,35
67,8481577,Philip Tomasino,C,NSH,23,63,10,25,35
67,8481606,Jordan Spence,D,LAK,23,68,8,27,35
67,8476905,Chandler Stephenson,C,SEA,30,70,7,28,35
67,8478911,Matt Roy,D,WSH,29,71,7,28,35
67,8476278,Colin Blackwell,C,DAL,31,76,19,15,34
67,8480185,Eetu Luostarinen,C,FLA,26,74,18,16,34
67,8481596,Shane Pinto,C,OTT,24,74,15,19,34
67,8477426,Nicholas Paul,L,TBL,29,81,15,19,34
67,8477479,Tyler Bertuzzi,L,CHI,29,54,15,19,34
67,8476872,Scott Laughton,C,PHI,30,74,15,19,34
67,8480849,Barrett Hayton,C,UTA,24,72,15,19,34
67,8477407,Anthony Duclair,L,NYI,29,77,14,20,34
67,8482705,Cole Sillinger,C,CBJ,21,71,13,21,34
67,8481703,Valtteri Puustinen,R,PIT,25,61,9,25,34
67,8476923,Damon Severson,D,CBJ,30,80,5,29,34
67,8475764,Cam Fowler,D,ANA,33,76,2,32,34
67,8482259,Bobby McMann,C,TOR,28,66,24,9,33
67,8480014,Gabriel Vilardi,C,WPG,25,69,20,13,33
67,8473422,Nick Foligno,L,CHI,37,60,19,14,33
67,8480015,Owen Tippett,R,PHI,25,73,17,16,33
67,8477952,Robby Fabbri,C,ANA,28,69,17,16,33
67,8474149,Evgenii Dadonov,R,DAL,35,80,16,17,33
67,8476292,Ondrej Palat,L,NJD,33,71,16,17,33
67,8478046,Danton Heinen,L,VAN,29,64,14,19,33
67,8476480,Vladislav Namestnikov,C,WPG,32,71,12,21,33
67,8480336,Sean Walker,D,CAR,30,77,10,23,33
67,8482105,Jake Sanderson,D,OTT,22,74,6,27,33
67,8476331,Dylan DeMelo,D,WPG,31,64,4,29,33
67,8476918,Jimmy Vesey,L,NYR,31,71,17,15,32
67,8477429,Andrew Copp,C,DET,30,77,13,19,32
67,8476921,Jordan Martinook,L,CAR,32,65,13,19,32
67,8481533,Trevor Zegras,C,ANA,23,74,9,23,32
67,8483490,Pavel Mintyukov,D,ANA,21,71,9,23,32
67,8475791,Taylor Hall,L,CHI,33,61,8,24,32
67,8477948,Travis Sanheim,D,PHI,28,66,7,25,32
67,8476902,Esa Lindell,D,DAL,30,74,6,26,32
67,8477425,Miles Wood,L,COL,29,81,17,14,31
67,8480802,Ryan McLeod,C,BUF,25,65,13,18,31
67,8480113,Alex Iafallo,L,WPG,31,69,12,19,31
67,8482133,Thomas Bordeleau,C,SJS,22,56,11,20,31
67,8476469,Joel Armia,R,MTL,31,69,17,13,30
67,8477505,Alexander Wennberg,C,SJS,30,69,15,15,30
67,8475193,Tomas Tatar,L,NJD,34,63,14,16,30
67,8475793,Ryan Johansen,C,PHI,32,77,12,18,30
67,8477979,Nicolas Aube-Kubel,R,BUF,28,59,11,19,30
67,8479293,Brandon Tanev,L,SEA,33,64,10,20,30
67,8479339,Patrik Laine,L,CBJ,26,68,5,25,30
67,8475200,Dmitry Orlov,D,CAR,33,79,5,25,30
67,8478500,Ivan Provorov,D,CBJ,27,76,3,27,30
67,8483524,Shane Wright,C,SEA,20,66,16,13,29
67,8477989,Christian Dvorak,C,MTL,28,63,15,14,29
67,8476392,Adam Lowry,C,WPG,31,66,12,17,29
67,8473563,Nicklas Backstrom,C,WSH,37,53,11,18,29
67,8481542,Moritz Seider,D,DET,23,79,7,22,29
67,8478020,Michael Amadio,R,OTT,28,76,18,10,28
67,8480459,Pius Suter,C,VAN,28,71,17,11,28
67,8480806,Isac Lundestrom,C,ANA,25,58,17,11,28
67,8476474,Stefan Noesen,R,NJD,31,66,16,12,28
67,8482475,Yegor Chinakhov,R,CBJ,23,66,15,13,28
67,8482074,Connor Zary,C,CGY,23,64,15,13,28
67,8481554,Kaapo Kakko,R,NYR,23,68,15,13,28
67,8480074,Alexandre Texier,C,STL,25,59,15,13,28
67,8476960,Andreas Athanasiou,C,CHI,30,57,14,14,28
67,8481535,Nils Hoglander,L,VAN,24,62,14,14,28
67,8478013,Jake Walman,D,SJS,28,67,14,14,28
67,8480068,Ryan Poehling,C,PHI,25,74,12,16,28
67,8480748,Kiefer Sherwood,L,VAN,29,60,12,16,28
67,8477953,Kasperi Kapanen,R,STL,28,71,11,17,28
67,8476461,Sean Couturier,C,PHI,32,64,10,18,28
67,8482122,Brock Faber,D,MIN,22,76,7,21,28
67,8481441,Joe Snively,C,DET,28,70,4,24,28
67,8480873,Rasmus Sandin,D,WSH,24,65,2,26,28
67,8481601,Simon Holmstrom,R,NYI,23,70,14,13,27
67,8475220,Marcus Foligno,L,MIN,33,58,13,14,27
67,8484203,Bradly Nadeau,L,CAR,19,67,11,16,27
67,8475231,Casey Cizikas,C,NYI,33,79,9,18,27
67,8480003,Jesper Boqvist,C,FLA,26,66,9,18,27
67,8481546,Cam York,D,PHI,23,67,8,19,27
67,8479976,Juuso Valimaki,D,UTA,26,66,8,19,27
67,8475149,Marcus Johansson,L,MIN,34,68,7,20,27
67,8480871,Adam Boqvist,D,FLA,24,67,7,20,27
67,8476329,Travis Boyd,C,MIN,31,63,5,22,27
67,8477506,Ryan Pulock,D,NYI,30,74,4,23,27
67,8477969,Marcus Pettersson,D,PIT,28,81,3,24,27
67,8477488,Brett Pesce,D,NJD,30,72,3,24,27
67,8478416,Erik Cernak,D,TBL,27,74,2,25,27
67,8473453,Trevor Lewis,C,LAK,37,73,17,9,26
67,8482125,Alexander Holtz,R,VGK,22,74,14,12,26
67,8482624,Daniil Miromanov,D,CGY,27,62,11,15,26
67,8481093,Rafael Harvey-Pinard,L,MTL,25,63,11,15,26
67,8479345,Jakob Chychrun,D,WSH,26,66,10,16,26
67,8479661,Tanner Jeannot,L,LAK,27,77,10,16,26
67,8482111,Justin Barron,D,MTL,23,65,9,17,26
67,8477919,Frederick Gaudreau,C,MIN,31,64,9,17,26
67,8475171,Oliver Ekman-Larsson,D,TOR,33,64,8,18,26
67,8480144,David Kampf,C,TOR,29,64,7,19,26
67,8473533,Jordan Staal,C,CAR,36,64,7,19,26
67,8479398,Samuel Girard,D,COL,26,67,4,22,26
67,8478851,Alexandre Carrier,D,NSH,28,68,3,23,26
67,8479390,Taylor Raddysh,R,WSH,26,65,15,10,25
67,8481704,Juuso Parssinen,C,NSH,23,57,13,12,25
67,8477507,Nikita Zadorov,D,BOS,29,66,11,14,25
67,8474715,Cameron Atkinson,R,TBL,35,80,8,17,25
67,8482142,Jamie Drysdale,D,PHI,22,63,8,17,25
67,8483457,Lane Hutson,D,MTL,20,68,6,19,25
67,8478055,Gustav Forsling,D,FLA,28,72,5,20,25
67,8480891,Michael Kesselring,D,UTA,24,66,5,20,25
67,8479998,Mikey Anderson,D,LAK,25,72,2,23,25
67,8478136,Jake Middleton,D,MIN,28,76,2,23,25
67,8479316,Luke Kunin,C,SJS,27,56,10,14,24
67,8480078,Filip Chytil,C,NYR,25,68,10,14,24
67,8480855,Jack McBain,C,UTA,24,66,10,14,24
67,8477947,Sonny Milano,L,WSH,28,69,10,14,24
67,8479996,Cody Glass,C,NSH,25,55,10,14,24
67,8476873,Mark Jankowski,C,NSH,30,48,9,15,24
67,8477015,Connor Brown,R,EDM,30,64,6,18,24
67,8476312,Josh Manson,D,COL,33,64,6,18,24
67,8476457,Adam Larsson,D,SEA,32,70,5,19,24
67,8480043,Timothy Liljegren,D,TOR,25,70,4,20,24
67,8478882,Vladislav Gavrikov,D,LAK,29,58,3,21,24
67,8478057,Dakota Joshua,C,VAN,28,68,13,10,23
67,8478508,Yakov Trenin,C,MIN,27,60,13,10,23
67,8482117,Lukas Reichel,L,CHI,22,58,13,10,23
67,8481624,Ilya Mikheyev,R,CHI,30,59,11,12,23
67,8483491,Ivan Miroshnichenko,L,WSH,20,50,11,12,23
67,8480813,Joe Veleno,C,DET,24,78,10,13,23
67,8478109,Victor Olofsson,L,VGK,29,68,10,13,23
67,8476422,Mike Reilly,D,NYI,31,74,9,14,23
67,8476897,Oskar Sundqvist,C,STL,30,70,8,15,23
67,8476994,Vinnie Hinostroza,C,NSH,30,58,8,15,23
67,8476889,Radek Faksa,C,STL,30,58,8,15,23
67,8475343,Nic Dowd,C,WSH,34,59,7,16,23
67,8480878,Nils Lundkvist,D,DAL,24,70,5,18,23
67,8483565,Nick Blankenburg,D,NSH,26,56,5,18,23
67,8476885,Jacob Trouba,D,NYR,30,68,4,19,23
67,8476463,Jonas Brodin,D,MIN,31,75,3,20,23
67,8479619,Michael Carcone,L,UTA,28,54,15,7,22
67,8482079,Marco Rossi,C,MIN,23,52,13,9,22
67,8483482,Tristan Luneau,D,ANA,20,65,11,11,22
67,8480205,Emil Bemstrom,C,PIT,25,64,10,12,22
67,8477450,Jason Dickinson,C,CHI,29,55,10,12,22
67,8479315,Joey Anderson,R,CHI,26,59,9,13,22
67,8481028,Martin Pospisil,C,CGY,25,56,7,15,22
67,8479353,Brett Howden,C,VGK,26,68,6,16,22
67,8476917,Adam Pelech,D,NYI,30,78,5,17,22
67,8474574,Tyler Myers,D,VAN,34,73,4,18,22
67,8475462,Radko Gudas,D,ANA,34,64,4,18,22
67,8475233,David Savard,D,MTL,34,65,1,21,22
67,8480281,Alexey Toropchenko,R,STL,25,62,16,5,21
67,8476878,Zemgus Girgensons,C,TBL,30,79,12,9,21
67,8479393,Noah Gregor,L,OTT,26,75,12,9,21
67,8481580,Connor McMichael,C,WSH,23,62,11,10,21
67,8477839,Conor Sheary,L,TBL,32,81,11,10,21
67,8482803,Olen Zellweger,D,ANA,21,66,11,10,21
67,8470621,Corey Perry,R,EDM,39,67,10,11,21
67,8481032,Paul Cotter,C,NJD,25,59,9,12,21
67,8479414,Nathan Bastian,R,NJD,27,59,9,12,21
67,8477369,Carson Soucy,D,VAN,30,56,8,13,21
67,8481582,Nicholas Robertson,L,TOR,23,68,7,14,21
67,8481553,Bobby Brink,R,PHI,23,63,6,15,21
67,8482634,Alex Steeves,C,TOR,25,54,6,15,21
67,8481527,Kaedan Korczak,D,VGK,23,50,5,16,21
67,8476892,Colton Parayko,D,STL,31,65,4,17,21
67,8475181,Nick Leddy,D,STL,33,73,3,18,21
67,8476931,Jake McCabe,D,TOR,31,65,3,18,21
67,8480001,Urho Vaakanainen,D,ANA,25,56,3,18,21
67,8482067,Connor Mackey,D,NYR,28,64,1,20,21
67,8482737,Zack Bolduc,C,STL,21,60,15,5,20
67,8480762,Eric Robinson,L,CAR,29,61,10,10,20
67,8481477,Nico Sturm,C,SJS,29,54,10,10,20
67,8477392,Hudson Fasching,R,NYI,29,66,9,11,20
67,8477508,Curtis Lazar,C,NJD,29,64,9,11,20
67,8478178,Darren Raddysh,D,TBL,28,70,9,11,20
67,8475855,Jesper Fast,R,CAR,33,59,8,12,20
67,8481481,Blake Lizotte,C,PIT,27,58,8,12,20
67,8483499,Liam Ohgren,L,MIN,20,52,8,12,20
67,8480157,Calle Rosen,D,COL,30,41,8,12,20
67,8482730,Brandt Clarke,D,LAK,21,56,7,13,20
67,8480172,Jan Rutta,D,SJS,34,61,6,14,20
67,8479026,Philippe Myers,D,TOR,27,50,6,14,20
67,8481656,Aliaksei Protas,C,WSH,23,65,4,16,20
67,8481014,Alexander Romanov,D,NYI,24,80,4,16,20
67,8478840,Will Borgen,D,SEA,28,69,3,17,20
67,8473507,Jeff Petry,D,DET,37,72,2,18,20
67,8479639,Dylan Coghlan,D,WPG,26,70,1,19,20
67,8479982,Conor Timmins,D,TOR,26,60,1,19,20
67,8475225,Craig Smith,C,CHI,35,51,11,8,19
67,8480835,Jack Drury,C,CAR,24,57,10,9,19
67,8480789,Oliver Wahlstrom,R,NYI,24,59,9,10,19
67,8478970,Jalen Chatfield,D,CAR,28,76,8,11,19
67,8476374,Sean Kuraly,C,CBJ,31,52,8,11,19
67,8480025,MacKenzie Entwistle,R,FLA,25,64,8,11,19
67,8478421,A.J. Greer,L,FLA,28,52,8,11,19
67,8474034,Patrick Maroon,L,CHI,36,54,8,11,19
67,8477478,William Carrier,L,CAR,30,53,7,12,19
67,8480246,Nick Perbix,D,TBL,26,77,6,13,19
67,8482245,Artem Zub,D,OTT,29,67,5,14,19
67,8479718,Alex Barré-Boulet,C,MTL,27,47,4,15,19
67,8480860,Kevin Bahl,D,CGY,24,55,4,15,19
67,8479980,Nicolas Hague,D,VGK,26,57,2,17,19
67,8474151,Ryan McDonagh,D,TBL,35,77,0,19,19
67,8477353,Tyler Motte,C,DET,29,70,12,6,18
67,8477903,Garnet Hathaway,R,PHI,33,68,11,7,18
67,8481522,Peyton Krebs,C,BUF,23,55,9,9,18
67,8479066,Ryan Lomberg,L,CGY,30,66,9,9,18
67,8481161,Jake Christiansen,D,CBJ,25,64,9,9,18
67,8482155,Alex Laferriere,R,LAK,23,63,8,10,18
67,8482809,Jackson Blake,R,CAR,21,58,7,11,18
67,8478585,Derek Ryan,C,EDM,38,59,5,13,18
67,8479344,Jesse Puljujarvi,R,PIT,26,54,5,13,18
67,8476988,Matt Benning,D,SJS,30,66,4,14,18
67,8476467,Jamie Oleksiak,D,SEA,32,67,4,14,18
67,8478399,Jonas Siegenthaler,D,NJD,27,61,3,15,18
67,8476856,Mathew Dumba,D,DAL,30,73,2,16,18
67,8475279,Ben Chiarot,D,DET,33,70,1,17,18
67,8478043,Sam Lafferty,C,BUF,29,58,12,5,17
67,8479941,Justin Danforth,R,CBJ,31,54,9,8,17
67,8481537,Nikita Okhotiuk,D,CGY,24,52,9,8,17
67,8477987,Ryan Donato,C,CHI,28,60,8,9,17
67,8482749,Joshua Roy,R,MTL,21,60,8,9,17
67,8478432,Christian Fischer,R,DET,27,68,8,9,17
67,8481013,Jonatan Berggren,R,DET,24,62,8,9,17
67,8480829,Jesperi Kotkaniemi,C,CAR,24,57,7,10,17
67,8481641,Joel Kiviranta,L,COL,28,75,7,10,17
67,8483493,Frank Nazar,C,CHI,20,56,7,10,17
67,8481019,David Gustafsson,C,WPG,24,48,6,11,17
67,8477220,Nate Schmidt,D,FLA,33,61,5,12,17
67,8478569,Noel Acciari,C,PIT,33,55,5,12,17
67,8480887,Jordan Harris,D,MTL,24,48,5,12,17
67,8480049,Dylan Samberg,D,WPG,25,64,4,13,17
67,8476429,Scott Mayfield,D,NYI,32,73,4,13,17
67,8479439,Jacob MacDonald,D,COL,31,53,4,13,17
67,8478507,John Marino,D,UTA,27,63,3,14,17
67,8479324,Ryan Lindgren,D,NYR,26,63,1,16,17
67,8476891,Matthew Grzelcyk,D,PIT,30,78,0,17,17
67,8481518,Nolan Foote,L,NJD,24,46,11,5,16
67,8479336,Carl Grundstrom,R,SJS,27,66,10,6,16
67,8482157,Will Cuylle,L,NYR,22,62,9,7,16
67,8480448,Parker Kelly,L,COL,25,75,8,8,16
67,8474189,Lars Eller,C,PIT,35,65,7,9,16
67,8477406,Mattias Janmark,C,EDM,32,70,6,10,16
67,8474567,Zach Bogosian,D,MIN,34,63,6,10,16
67,8482655,Janis Moser,D,TBL,24,75,5,11,16
67,8478452,Caleb Jones,D,LAK,27,60,5,11,16
67,8474673,TJ Brodie,D,CHI,34,52,3,13,16
67,8479369,Andrew Peeke,D,BOS,26,61,3,13,16
67,8480807,Mattias Samuelsson,D,BUF,24,61,2,14,16
67,8475455,Brenden Dillon,D,NJD,34,60,1,15,16
67,8480073,Erik Brannstrom,D,COL,25,61,1,15,16
67,8475763,Kevin Hayes,R,PIT,32,65,9,6,15
67,8477931,Tomas Nosek,L,FLA,32,55,9,6,15
67,8480289,Morgan Barron,C,WPG,26,51,8,7,15
67,8476624,Barclay Goodrow,C,SJS,31,51,8,7,15
67,8482747,Brennan Othmann,L,NYR,21,41,8,7,15
67,8480011,Klim Kostin,C,SJS,25,42,7,8,15
67,8475842,Sam Carrick,C,NYR,32,58,7,8,15
67,8482062,Cole Smith,L,NSH,29,52,6,9,15
67,8476867,Brendan Gaunce,C,MIN,30,35,5,10,15
67,8479402,Jake Bean,D,CGY,26,61,4,11,15
67,8475324,Nick Jensen,D,OTT,34,70,4,11,15
67,8483445,Cutter Gauthier,L,ANA,20,61,3,12,15
67,8482807,Ethan Del Mastro,D,CHI,21,54,3,12,15
67,8476952,Dominic Toninato,C,WPG,30,34,3,12,15
67,8481059,Scott Perunovich,D,STL,26,64,2,13,15
67,8475790,Erik Gudbranson,D,CBJ,32,75,2,13,15
67,8476525,Colin Miller,D,WPG,32,59,1,14,15
67,8482087,Kaiden Guhle,D,MTL,22,63,1,14,15
67,8481568,Alex Vlasic,D,CHI,23,58,1,14,15
67,8481716,Dmitri Voronkov,L,CBJ,24,47,11,3,14
67,8478434,Keegan Kolesar,R,VGK,27,65,8,6,14
67,8482762,Simon Edvinsson,D,DET,21,58,8,6,14
67,8480995,Pontus Holmberg,R,TOR,25,60,7,7,14
67,8477018,Ben Hutton,D,VGK,31,41,7,7,14
67,8482784,Zach Dean,C,STL,21,40,6,8,14
67,8480980,Connor Dewar,C,TOR,25,60,5,9,14
67,8484149,Gavin Brindley,C,CBJ,20,52,5,9,14
67,8480441,Trey Fix-Wolansky,R,CBJ,25,45,5,9,14
67,8481617,Vasily Podkolzin,R,VAN,23,48,5,9,14
67,8479372,Joshua Mahura,D,SEA,26,46,5,9,14
67,8481517,Brett Leason,R,ANA,25,52,5,9,14
67,8479368,Max Jones,L,BOS,26,61,4,10,14
67,8478859,Niko Mikkola,D,FLA,28,60,4,10,14
67,8479543,Michael Pezzetta,L,MTL,26,64,3,11,14
67,8481167,Brayden Pachal,D,CGY,25,44,3,11,14
67,8476879,Cody Ceci,D,EDM,31,66,2,12,14
67,8480035,Henri Jokiharju,D,BUF,25,62,2,12,14
67,8474013,Ian Cole,D,UTA,35,50,2,12,14
67,8482192,Isaak Phillips,D,CHI,23,57,2,12,14
67,8476967,Brett Kulak,D,EDM,30,61,2,12,14
67,8478443,Brandon Carlo,D,BOS,28,66,2,12,14
67,8480070,Ian Mitchell,D,BOS,25,45,1,13,14
67,8474090,Brendan Smith,D,DAL,35,58,1,13,14
67,8471817,Ryan Reaves,R,TOR,37,60,9,4,13
67,8476822,Luke Glendening,C,TBL,35,79,7,6,13
67,8477070,Liam O'Brien,C,UTA,30,51,7,6,13
67,8480252,Cole Guttman,C,CHI,25,30,7,6,13
67,8479359,Beck Malenstyn,L,BUF,26,46,6,7,13
67,8482176,Wyatt Kaiser,D,CHI,22,52,6,7,13
67,8482679,Matt Coronato,R,CGY,22,62,5,8,13
67,8475179,Dmitry Kulikov,D,FLA,34,62,4,9,13
67,8479370,Tyson Jost,C,CAR,26,55,4,9,13
67,8475208,Brian Dumoulin,D,ANA,33,56,4,9,13
67,8477435,Ryan Graves,D,PIT,29,72,3,10,13
67,8479983,Mario Ferraro,D,SJS,26,67,2,11,13
67,8475690,Chris Tanev,D,TOR,35,58,1,12,13
67,8480058,Pierre-Olivier Joseph,D,STL,25,56,1,12,13
67,8480727,Zach Whitecloud,D,VGK,28,49,0,13,13
67,8477573,Nathan Walker,L,STL,30,47,8,4,12
67,8478831,Kevin Stenlund,C,UTA,28,53,8,4,12
67,8479328,Julien Gauthier,R,NYI,27,50,6,6,12
67,8477446,Michael McCarron,R,NSH,29,63,5,7,12
67,8477851,Jordan Oesterle,D,BOS,32,41,5,7,12
67,8480192,Johnathan Kovacevic,D,NJD,27,58,4,8,12
67,8481600,Tobias Bjornfot,D,FLA,23,44,2,10,12
67,8475718,Justin Holl,D,DET,32,58,2,10,12
67,8475750,Jon Merrill,D,MIN,32,63,2,10,12
67,8482073,Braden Schneider,D,NYR,23,63,1,11,12
67,8474568,Luke Schenn,D,NSH,35,55,1,11,12
67,8471709,Marc-Edouard Vlasic,D,SJS,37,55,0,12,12
67,8481178,Egor Zamula,D,PHI,24,56,0,12,12
67,8482496,Nils Aman,C,VAN,24,34,6,5,11
67,8478874,Adam Gaudette,R,OTT,28,41,6,5,11
67,8482659,Josh Doan,R,UTA,22,55,5,6,11
67,8479671,Mathieu Olivier,R,CBJ,27,56,5,6,11
67,8479772,Zack MacEwen,R,OTT,28,61,5,6,11
67,8477482,Zachary Sanford,L,CHI,30,43,4,7,11
67,8480950,Ilya Lyubushkin,D,DAL,30,60,4,7,11
67,8481751,Lukas Rousek,R,BUF,25,32,4,7,11
67,8477380,Jonny Brodzinski,C,NYR,31,49,3,8,11
67,8476874,Olli Maatta,D,DET,30,60,3,8,11
67,8470600,Ryan Suter,D,STL,39,59,3,8,11
67,8482751,Ryan Winterton,C,SEA,21,40,3,8,11
67,8479981,Jonah Gadjovich,L,FLA,26,40,3,8,11
67,8475188,Brayden McNabb,D,VGK,33,52,2,9,11
67,8480355,Mark Kastelic,C,BOS,25,59,2,9,11
67,8480845,Rasmus Kupari,C,WPG,24,48,2,9,11
67,8479348,Kale Clague,D,BUF,26,38,2,9,11
67,8474166,Alec Martinez,D,CHI,37,55,1,10,11
67,8480222,Sebastian Aho,D,PIT,28,69,0,11,11
67,8482077,Dylan Holloway,L,EDM,23,48,7,3,10
67,8481592,Jakob Pelletier,L,CGY,23,38,7,3,10
67,8477938,Haydn Fleury,D,WPG,28,39,6,4,10
67,8475235,Nicolas Deslauriers,L,PHI,33,43,6,4,10
67,8480021,Jack Studnicka,C,LAK,25,58,5,5,10
67,8479291,Kevin Rooney,C,CGY,31,52,5,5,10
67,8480848,Ty Dellandrea,C,SJS,24,43,5,5,10
67,8476442,Matt Nieto,L,PIT,32,49,5,5,10
67,8484911,Collin Graf,R,SJS,22,41,5,5,10
67,8481708,Zac Jones,D,NYR,24,51,4,6,10
67,8481521,Ronnie Attard,D,PHI,25,56,3,7,10
67,8477365,Connor Clifton,D,BUF,29,49,3,7,10
67,8483466,Kevin Korchinski,D,CHI,20,50,3,7,10
67,8481599,Victor Soderstrom,D,UTA,23,46,3,7,10
67,8482964,Arber Xhekaj,D,MTL,23,51,3,7,10
67,8477845,Trevor van Riemsdyk,D,WSH,33,52,2,8,10
67,8480796,Martin Fehervary,D,WSH,25,56,2,8,10
67,8479442,Troy Stecher,D,EDM,30,56,2,8,10
67,8478451,Ethan Bear,D,WSH,27,49,1,9,10
67,8479371,Dante Fabbro,D,NSH,26,56,0,10,10
67,8476372,Nick Seeler,D,PHI,31,42,0,10,10
67,8471677,Jack Johnson,D,CBJ,37,69,0,10,10
67,8483495,Simon Nemec,D,NJD,20,48,6,3,9
67,8478424,Jansen Harkins,C,ANA,27,42,6,3,9
67,8479520,Brandon Duhaime,R,WSH,27,57,5,4,9
67,8479968,Vinni Lettieri,C,BOS,29,45,5,4,9
67,8483630,Pavol Regenda,L,ANA,25,37,5,4,9
67,8482095,Tyler Kleven,D,OTT,22,48,4,5,9
67,8478017,Mark Friedman,D,VAN,29,35,4,5,9
67,8479378,Logan Stanley,D,WPG,26,45,3,6,9
67,8477335,Kyle Burroughs,D,LAK,29,36,3,6,9
67,8478468,Jeremy Lauzon,D,NSH,27,51,3,6,9
67,8482861,Vincent Iorio,D,WSH,22,34,3,6,9
67,8479536,Axel Jonsson-Fjallby,L,WPG,26,33,2,7,9
67,8476473,Connor Murphy,D,CHI,31,40,0,9,9
67,8481789,Tye Kartye,L,SEA,23,33,6,2,8
67,8481147,Reese Johnson,C,MIN,26,42,5,3,8
67,8482166,Shakir Mukhamadullin,D,SJS,22,56,4,4,8
67,8482666,Scott Morrow,D,CAR,22,37,4,4,8
67,8477034,Jaycob Megna,D,FLA,32,42,4,4,8
67,8478409,Anthony Richard,C,PHI,28,35,4,4,8
67,8483549,Lucas Condotta,L,MTL,27,34,4,4,8
67,8480879,Jacob Bernard-Docker,D,OTT,24,50,3,5,8
67,8479379,Givani Smith,R,SJS,26,29,3,5,8
67,8480870,Bo Groulx,C,NYR,24,32,3,5,8
67,8482153,Brendan Brisson,C,VGK,23,32,3,5,8
67,8481567,Henry Thrun,D,SJS,23,49,2,6,8
67,8480292,Carson Meyer,R,ANA,27,31,2,6,8
67,8482148,Hendrix Lapierre,C,WSH,22,50,2,6,8
67,8477962,Brendan Lemieux,L,CAR,28,38,2,6,8
67,8482511,Mason Lohrei,D,BOS,23,32,2,6,8
67,8482713,Mackie Samoskevich,R,FLA,22,40,2,6,8
67,8474612,Travis Hamonic,D,OTT,34,42,1,7,8
67,8481598,Philip Broberg,D,EDM,23,44,1,7,8
67,8473446,Erik Johnson,D,PHI,36,49,1,7,8
67,8479249,Andrew Poturalski,C,SJS,30,36,0,8,8
67,8482652,Walker Duehr,R,CGY,27,38,4,3,7
67,8482859,Zack Ostapchuk,C,OTT,21,47,4,3,7
67,8481754,Nikita Nesterenko,C,ANA,23,33,4,3,7
67,8481006,Tyler Tucker,D,STL,24,21,3,4,7
67,8482102,Vasily Ponomarev,C,PIT,22,25,3,4,7
67,8481701,Santeri Hatakka,D,NJD,23,35,2,5,7
67,8476441,Joel Edmundson,D,LAK,31,41,2,5,7
67,8483619,Filip Roos,D,OTT,25,36,2,5,7
67,8480834,Ty Emberson,D,SJS,24,37,2,5,7
67,8475958,Michael Sgarbossa,C,WSH,32,25,2,5,7
67,8475177,Calvin de Haan,D,COL,33,42,0,7,7
67,8476858,Phillip Di Giuseppe,L,VAN,31,41,4,2,6
67,8481605,Jackson LaCombe,D,ANA,23,38,4,2,6
67,8483012,Logan Morrison,C,SEA,22,38,4,2,6
67,8480844,Grigori Denisenko,L,VGK,24,33,4,2,6
67,8481532,Alex Turcotte,C,LAK,23,43,3,3,6
67,8477473,Justin Bailey,R,SJS,29,27,3,3,6
67,8478211,Dryden Hunt,L,CGY,29,49,2,4,6
67,8477401,John Hayden,C,SEA,29,34,2,4,6
67,8477887,Patrick Brown,C,BOS,32,51,2,4,6
67,8484254,Akito Hirose,D,VAN,25,34,2,4,6
67,8482733,Logan Mailloux,D,MTL,31,36,2,4,6
67,8482451,Mikael Pyyhtia,L,CBJ,23,38,1,5,6
67,8479994,Jaret Anderson-Dolan,C,WPG,25,30,1,5,6
67,8482858,Ryker Evans,D,SEA,23,26,1,5,6
67,8479576,Vincent Desharnais,D,VAN,28,42,1,5,6
67,8477499,Rasmus Ristolainen,D,PHI,30,58,0,6,6
67,8483460,David Jiricek,D,CBJ,21,48,0,6,6
67,8476913,Devin Shore,C,MIN,30,33,0,6,6
67,8478146,Matthew Highmore,C,OTT,28,33,0,6,6
67,8480196,Jacob Bryson,D,BUF,27,43,0,6,6
67,8482145,Mavrik Bourque,C,DAL,22,52,4,1,5
67,8482070,Mitchell Chaffee,R,TBL,26,52,4,1,5
67,8481609,Vladislav Kolyachonok,D,UTA,23,27,4,1,5
67,8484287,Cole McWard,D,VAN,23,26,4,1,5
67,8476934,Brock McGinn,L,ANA,30,42,3,2,5
67,8481556,John Beecher,C,BOS,23,30,3,2,5
67,8477971,Andreas Englund,D,LAK,28,25,3,2,5
67,8482744,James Malatesta,L,CBJ,21,37,2,3,5
67,8483570,Ben Meyers,C,SEA,26,28,2,3,5
67,8481056,Spencer Stastney,D,NSH,24,30,2,3,5
67,8480007,Jonas Rondbjerg,R,VGK,25,34,2,3,5
67,8479944,Zach Aston-Reese,C,VGK,30,40,2,3,5
67,8482177,Marat Khusnutdinov,C,MIN,22,30,2,3,5
67,8479367,William Lockwood,R,FLA,26,26,2,3,5
67,8481122,Simon Benoit,D,TOR,26,31,2,3,5
67,8481699,Aku Raty,R,UTA,23,13,2,3,5
67,8480990,Declan Chisholm,D,MIN,24,34,1,4,5
67,8477527,Ross Johnston,L,ANA,30,30,1,4,5
67,8480880,Jakub Lauko,C,MIN,24,32,0,5,5
67,8479985,Cale Fleury,D,SEA,26,30,0,5,5
67,8479587,Rhett Gardner,C,PHI,28,20,0,5,5
67,8479638,Justin Brazeau,R,BOS,26,37,4,0,4
67,8481543,Nikita Alexandrov,C,STL,24,26,3,1,4
67,8480267,Sammy Walker,C,MIN,25,20,3,1,4
67,8484258,Sam Malinski,D,COL,26,27,2,2,4
67,8477467,Gustav Olofsson,D,SEA,30,17,2,2,4
67,8483763,Maksymilian Szuber,D,UTA,22,34,1,3,4
67,8479986,Kole Lind,R,DAL,26,43,1,3,4
67,8479972,Mason Shaw,C,WPG,26,35,1,3,4
67,8482141,Lukas Cormier,D,VGK,22,23,1,3,4
67,8482144,Jack Thompson,D,SJS,22,34,1,3,4
67,8482765,Isak Rosen,R,BUF,21,37,1,3,4
67,8478454,Noah Juulsen,D,VAN,27,31,1,3,4
67,8481550,Adam Beckman,L,NJD,23,38,0,4,4
67,8478450,Parker Wotherspoon,D,BOS,27,33,0,4,4
67,8481743,Marc Del Gaizo,D,NSH,25,24,0,4,4
67,8481679,Maxence Guenette,D,OTT,23,34,3,0,3
67,8483397,Marc McLaughlin,C,BOS,25,26,3,0,3
67,8475413,Justin Dowling,C,NJD,34,11,3,0,3
67,8480468,James Hamblin,L,EDM,25,24,3,0,3
67,8478502,Dennis Gilbert,D,BUF,28,19,2,1,3
67,8475762,Derek Forbort,D,VAN,32,46,1,2,3
67,8480245,Olle Lycksell,R,PHI,25,27,1,2,3
67,8482172,Landon Slaggert,L,CHI,22,24,1,2,3
67,8482470,Ilya Solovyov,D,CGY,24,22,1,2,3
67,8481541,Samuel Bolduc,D,NYI,24,30,1,2,3
67,8477244,Chad Ruhwedel,D,NYR,34,33,1,2,3
67,8480890,Jan Jenik,C,OTT,24,22,1,2,3
67,8482201,Gage Goncalves,C,TBL,23,23,1,2,3
67,8484325,Waltteri Merela,C,TBL,26,18,1,2,3
67,8477320,Anton Blidh,L,NYR,29,14,1,2,3
67,8481719,Maxwell Crozier,D,TBL,24,14,1,2,3
67,8480075,Cameron Crotty,D,MIN,25,13,0,3,3
67,8482165,Yan Kuznetsov,D,CGY,22,22,0,3,3
67,8479419,Brett Murray,L,BUF,26,22,2,0,2
67,8478011,Louie Belpedio,D,PHI,28,15,2,0,2
67,8483395,Arshdeep Bains,L,VAN,23,12,2,0,2
67,8481237,Kyle MacLean,C,NYI,25,32,2,0,2
67,8482094,Daemon Hunt,D,MIN,22,14,2,0,2
67,8478854,Ryan Shea,D,PIT,27,10,2,0,2
67,8479991,Jake Leschyshyn,C,NYR,25,24,1,1,2
67,8478021,William Lagesson,D,DET,28,22,1,1,2
67,8481585,Egor Afanasyev,L,SJS,23,12,1,1,2
67,8480823,Alexander Alexeyev,D,WSH,25,9,1,1,2
67,8481422,Jake Lucchini,C,NSH,29,18,0,2,2
67,8480851,Akil Thomas,C,LAK,24,17,0,2,2
67,8475795,Dylan McIlrath,D,WSH,32,12,0,2,2
67,8474062,Riley Nash,C,NYR,35,16,0,2,2
67,8482250,Callahan Burke,C,VGK,27,18,0,2,2
67,8484304,Uvis Balinskis,D,FLA,28,11,0,2,2
67,8481024,Linus Karlsson,C,VAN,25,13,0,2,2
67,8477810,Joel Hanley,D,CGY,33,27,0,2,2
67,8482516,Matthew Kessel,D,STL,24,18,0,2,2
67,8480874,Adam Ginning,D,PHI,24,17,0,2,2
67,8481593,Jayden Struble,D,MTL,23,23,0,2,2
67,8479320,Maxime Lajoie,D,SEA,27,22,1,0,1
67,8477073,Kurtis MacDermid,L,NJD,30,30,1,0,1
67,8482147,Jean-Luc Foudy,C,COL,22,26,1,0,1
67,8482929,Emil Lilleberg,D,TBL,23,20,1,0,1
67,8483489,Fraser Minten,C,TOR,31,11,1,0,1
67,8481043,Cole Koepke,L,BOS,26,24,1,0,1
67,8481726,Adam Edstrom,C,NYR,24,9,1,0,1
67,8482118,Sam Colangelo,R,ANA,23,13,1,0,1
67,8478881,Brett Seney,L,CHI,28,8,1,0,1
67,8478477,Mitchell Stephens,C,SEA,27,18,1,0,1
67,8482476,Emil Heineman,L,MTL,23,11,1,0,1
67,8483407,Brandon Scanlin,D,NYR,25,7,1,0,1
67,8477993,Justin Kirkland,C,CGY,28,7,1,0,1
67,8477541,Dakota Mermis,D,TOR,30,12,1,0,1
67,8484326,Patrik Koch,D,UTA,28,5,1,0,1
67,8477384,Joshua Brown,D,EDM,30,42,0,1,1
67,8479362,Riley Tufte,L,BOS,26,19,0,1,1
67,8482061,Brandon Biro,L,SEA,26,7,0,1,1
67,8481030,Jack St. Ivany,D,PIT,25,21,0,1,1
67,8482787,Nikita Chibrikov,R,WPG,31,5,0,1,1
67,8483567,Georgii Merkulov,C,BOS,24,8,0,1,1
67,8483597,Milos Kelemen,L,UTA,25,13,0,1,1
67,8481564,Ryan Johnson,D,BUF,23,11,0,1,1
67,8481206,John Ludvig,D,PIT,24,7,0,1,1
67,8481578,Graeme Clarke,R,MIN,23,7,0,1,1
67,8482460,Matt Rempe,C,NYR,22,12,0,1,1
67,8479330,Brandon Gignac,C,MTL,27,11,0,1,1
67,8482088,Justin Sourdif,R,FLA,22,22,0,1,1
67,8483609,Adam Klapka,R,CGY,24,3,0,1,1
67,8482126,Emil Andrae,D,PHI,31,3,0,1,1
67,8483401,Marc Johnstone,R,PIT,28,4,0,1,1
67,8477462,Robert Hagg,D,VGK,29,23,0,0,0
67,8481065,Angus Crookshank,L,OTT,25,11,0,0,0
67,8484255,Jason Polin,R,COL,25,1,0,0,0
67,8480084,Nick DeSimone,D,NJD,30,15,0,0,0
67,8483471,Brad Lambert,C,WPG,31,10,0,0,0
67,8483512,Matthew Savoie,C,EDM,20,19,0,0,0
67,8477149,Scott Sabourin,R,SJS,32,15,0,0,0
67,8478051,Max Willman,C,NJD,29,15,0,0,0
67,8482162,Roby Jarventie,L,EDM,22,14,0,0,0
67,8475755,Alexander Petrovic,D,DAL,32,12,0,0,0
67,8475780,Chris Wagner,R,COL,33,5,0,0,0
67,8478147,Bokondji Imama,L,PIT,28,6,0,0,0
67,8481534,Raphael Lavoie,C,EDM,24,3,0,0,0
67,8478446,Glenn Gawdin,C,LAK,27,12,0,0,0
67,8481462,Mason Morelli,L,VGK,28,14,0,0,0
67,8483920,Pierrick Dube,R,WSH,23,4,0,0,0
67,8483546,Marshall Rifai,D,TOR,26,7,0,0,0
67,8482197,Adam Raska,R,MIN,23,6,0,0,0
67,8480032,Shane Bowers,C,NJD,25,17,0,0,0
67,8481655,Cole Schwindt,R,CGY,23,7,0,0,0
67,8480306,Grant Hutton,D,NYI,29,5,0,0,0
67,8481806,Louis Crevier,D,CHI,23,9,0,0,0
67,8483531,Brian Halonen,L,NJD,25,1,0,0,0
67,8479421,Jacob Moverare,D,LAK,26,6,0,0,0
67,8483398,Declan Carlile,D,TBL,31,6,0,0,0
67,8476323,Max McCormick,L,SEA,32,5,0,0,0
67,8483432,Luca Del Bel Belluz,C,CBJ,31,0,0,0,0
67,8484259,Ondrej Pavel,C,COL,31,1,0,0,0
67,8479522,Hardy Haman Aktell,D,WSH,26,3,0,0,0
67,8484321,Nikolas Matinpalo,D,OTT,26,2,0,0,0
67,8480274,Philip Kemp,D,EDM,25,0,0,0,0
67,8470794,Joe Pavelski,C,,40,0,0,0,0
67,8479321,Lucas Johansen,D,,27,0,0,0,0
67,8477950,Tony DeAngelo,D,,29,0,0,0,0
67,8471218,Blake Wheeler,R,,38,0,0,0,0
67,8475197,Tyson Barrie,D,,33,0,0,0,0
67,8474157,Max Pacioretty,L,,36,0,0,0,0
67,8475744,Evgeny Kuznetsov,C,,32,0,0,0,0
67,8474037,James van Riemsdyk,L,,35,0,0,0,0
67,8476907,Mackenzie MacEachern,L,,30,0,0,0,0
67,8480216,Jacob Peterson,C,,25,0,0,0,0
67,8474602,Justin Schultz,D,,34,0,0,0,0
67,8482222,Alexander Barabanov,L,,30,0,0,0,0
67,8474031,Kevin Shattenkirk,D,,35,0,0,0,0
67,8477330,Dominik Kubalik,L,,29,0,0,0,0
67,8480884,Calen Addison,D,,24,0,0,0,0
67,8475906,John Klingberg,D,,32,0,0,0,0
67,8480008,Adam Ruzicka,C,,25,0,0,0,0
67,8476884,Derrick Pouliot,D,,30,0,0,0,0
67,8476919,Chris Tierney,C,,30,0,0,0,0
67,8479415,Michael McLeod,C,,26,0,0,0,0
67,8474870,Tyler Johnson,C,,34,0,0,0,0
67,8470604,Jeff Carter,C,,39,0,0,0,0
67,8478104,Sammy Blais,L,,28,0,0,0,0
67,8474884,Mike Hoffman,C,,35,0,0,0,0
67,8481591,Sam Poulin,R,,23,0,0,0,0
67,8471274,Alex Goligoski,D,,39,0,0,0,0
67,8476871,Tanner Pearson,L,,32,0,0,0,0
67,8476393,Nick Cousins,C,,31,0,0,0,0
67,8479977,Kailer Yamamoto,R,,26,0,0,0,0
67,8479346,Dillon Dube,C,,26,0,0,0,0
67,8480184,Gustav Lindstrom,D,,26,0,0,0,0
67,8479376,Victor Mete,D,,26,0,0,0,0
67,8473449,Kyle Okposo,R,,36,0,0,0,0
67,8481058,Jesse Ylonen,R,,25,0,0,0,0
67,8475752,Tyler Pitlick,C,,33,0,0,0,0
67,8481239,Samuel Fagemo,L,,24,0,0,0,0
67,8480821,Filip Zadina,R,,25,0,0,0,0
67,8470966,Mark Giordano,D,,41,0,0,0,0
67,8478495,Denis Gurianov,R,,27,0,0,0,0
67,8477464,Nic Petan,C,,29,0,0,0,0
67,8478099,Kevin Labanc,R,,29,0,0,0,0
67,8482241,Radim Zohorna,L,,28,0,0,0,0
67,8474040,Sam Gagner,C,,35,0,0,0,0
67,8479514,Rem Pitlick,C,,27,0,0,0,0
67,8478430,Oliver Kylington,D,,27,0,0,0,0
67,8479533,Joona Koppanen,L,,26,0,0,0,0
67,8479984,Cal Foote,D,,26,0,0,0,0
67,8477126,Jayson Megna,C,,34,0,0,0,0
67,8475164,Jakob Silfverberg,R,,34,0,0,0,0
67,8474009,Nick Bonino,C,,36,0,0,0,0
67,8479458,Nikita Zaitsev,D,,33,0,0,0,0
67,8477944,Jakub Vrana,L,,28,0,0,0,0
67,8471699,Andrew Cogliano,C,,37,0,0,0,0
67,8478067,Oskar Lindblom,L,,28,0,0,0,0
67,8471686,Marc Staal,D,,37,0,0,0,0
67,8470610,Zach Parise,L,,40,0,0,0,0
67,8478904,Steven Lorentz,C,,28,0,0,0,0
67,8473473,Milan Lucic,L,,36,0,0,0,0
67,8480031,Maxime Comtois,L,,25,0,0,0,0
67,8478512,Austin Czarnik,C,,32,0,0,0,0
67,8473504,Cal Clutterbuck,R,,37,0,0,0,0
67,8477454,Adam Erne,L,,29,0,0,0,0
67,8479383,Boris Katchouk,L,,26,0,0,0,0
67,8475825,Jani Hakanpää,D,,32,0,0,0,0
67,8477846,Ryan Carpenter,C,,33,0,0,0,0
67,8477930,Pierre-Edouard Bellemare,L,,39,0,0,0,0
67,8478400,Colin White,C,,27,0,0,0,0
67,8480226,Marián Studenic,R,,26,0,0,0,0
67,8480853,Liam Foudy,C,,24,0,0,0,0
67,8475797,Jarred Tinordi,D,,32,0,0,0,0
67,8479423,Alex Nylander,L,,26,0,0,0,0
67,8474618,Marco Scandella,D,,34,0,0,0,0
67,8478028,Fredrik Olofsson,L,,28,0,0,0,0
67,8474709,Matt Martin,L,,35,0,0,0,0
67,8481070,Hugh McGing,L,,26,0,0,0,0
67,8479546,Oskar Steen,C,,26,0,0,0,0
67,8474145,Robert Bortuzzo,D,,35,0,0,0,0
67,8476915,Jujhar Khaira,L,,30,0,0,0,0
67,8475278,Byron Froese,C,,33,0,0,0,0
67,8481812,Nikolai Knyzhov,D,,27,0,0,0,0
67,8478408,Travis Dermott,D,,28,0,0,0,0
67,8481077,John Leonard,L,,26,0,0,0,0
67,8479547,Matthew Phillips,R,,26,0,0,0,0
67,8480836,Jonathan Gruden,C,,24,0,0,0,0
67,8481690,Tyler Angle,C,,24,0,0,0,0
67,8475766,Austin Watson,L,,32,0,0,0,0
67,8481016,Ruslan Iskhakov,C,,24,0,0,0,0
67,8478078,Rourke Chartier,C,,28,0,0,0,0
67,8480776,Sheldon Rempal,R,,29,0,0,0,0
67,8478956,Samuel Laberge,L,NJD,27,0,0,0,0
67,8483045,Cameron Butler,R,CBJ,31,0,0,0,0
67,8484314,Jiri Smejkal,L,,28,0,0,0,0
68,8476453,Nikita Kucherov,R,TBL,31,82,47,91,138
68,8478402,Connor McDavid,C,EDM,27,79,39,98,137
68,8477492,Nathan MacKinnon,C,COL,29,82,49,85,134
68,8477956,David Pastrnak,R,BOS,28,77,57,64,121
68,8479318,Auston Matthews,C,TOR,27,80,70,50,120
68,8477934,Leon Draisaitl,C,EDM,29,79,41,78,119
68,8477404,Jake Guentzel,C,TBL,30,81,47,70,117
68,8478864,Kirill Kaprizov,L,MIN,27,72,60,55,115
68,8478550,Artemi Panarin,L,NYR,33,79,36,79,115
68,8479314,Matthew Tkachuk,L,FLA,27,81,44,69,113
68,8480801,Brady Tkachuk,L,OTT,25,80,54,56,110
68,8477493,Aleksander Barkov,C,FLA,29,78,28,78,106
68,8476468,J.T. Miller,C,VAN,31,79,32,72,104
68,8478420,Mikko Rantanen,R,COL,28,82,52,49,101
68,8477946,Dylan Larkin,C,DET,28,80,47,52,99
68,8478010,Brayden Point,C,TBL,28,82,51,47,98
68,8476887,Filip Forsberg,L,NSH,30,74,50,47,97
68,8480012,Elias Pettersson,C,VAN,26,77,31,65,96
68,8481559,Jack Hughes,C,NJD,23,72,37,56,93
68,8478398,Kyle Connor,L,WPG,28,74,40,52,92
68,8478483,Mitch Marner,R,TOR,27,78,29,63,92
68,8480027,Jason Robertson,L,DAL,25,82,31,60,91
68,8474564,Steven Stamkos,C,NSH,34,74,36,54,90
68,8478403,Jack Eichel,C,VGK,28,79,47,41,88
68,8478427,Sebastian Aho,C,CAR,27,72,40,48,88
68,8479407,Jesper Bratt,L,NJD,26,75,33,55,88
68,8477501,Valeri Nichushkin,R,COL,29,81,47,40,87
68,8478449,Roope Hintz,C,DAL,28,82,38,49,87
68,8477960,Adrian Kempe,R,LAK,28,81,40,46,86
68,8482116,Tim Stützle,C,OTT,22,77,34,52,86
68,8475913,Mark Stone,R,VGK,32,78,28,58,86
68,8482078,Lucas Raymond,L,DET,22,81,37,48,85
68,8475172,Nazem Kadri,C,CGY,34,80,36,49,85
68,8477942,Kevin Fiala,L,LAK,28,82,30,55,85
68,8480069,Cale Makar,D,COL,26,72,24,61,85
68,8482740,Wyatt Johnston,C,DAL,21,82,47,37,84
68,8478414,Timo Meier,R,NJD,28,75,41,43,84
68,8471675,Sidney Crosby,C,PIT,37,78,34,49,83
68,8480800,Quinn Hughes,D,VAN,25,80,17,66,83
68,8473512,Claude Giroux,R,OTT,36,80,30,52,82
68,8475692,Mats Zuccarello,R,MIN,37,76,22,59,81
68,8474600,Roman Josi,D,NSH,34,75,16,65,81
68,8480002,Nico Hischier,C,NJD,25,74,30,50,80
68,8476875,Mike Matheson,D,MTL,30,75,10,70,80
68,8477409,Carter Verhaeghe,C,FLA,29,78,37,42,79
68,8480023,Robert Thomas,C,STL,25,76,26,53,79
68,8476454,Ryan Nugent-Hopkins,C,EDM,31,78,23,56,79
68,8475167,Victor Hedman,D,TBL,34,75,17,62,79
68,8479343,Clayton Keller,R,UTA,26,77,41,37,78
68,8484144,Connor Bedard,C,CHI,19,70,32,46,78
68,8478493,Joel Eriksson Ek,C,MIN,27,73,31,47,78
68,8475786,Zach Hyman,L,EDM,32,79,44,33,77
68,8478439,Travis Konecny,R,PHI,27,73,32,45,77
68,8473419,Brad Marchand,L,BOS,36,76,29,48,77
68,8481557,Matt Boldy,L,MIN,23,67,39,37,76
68,8479385,Jordan Kyrou,C,STL,26,71,35,41,76
68,8471215,Evgeni Malkin,C,PIT,38,79,31,45,76
68,8476346,Johnny Gaudreau,L,CBJ,31,71,20,56,76
68,8477504,Josh Morrissey,D,WPG,29,74,18,58,76
68,8479675,Trevor Moore,L,LAK,29,81,32,43,75
68,8477939,William Nylander,R,TOR,28,77,35,39,74
68,8476456,Jonathan Huberdeau,C,CGY,31,80,23,51,74
68,8477949,Alex Tuch,R,BUF,28,72,29,44,73
68,8480830,Andrei Svechnikov,R,CAR,24,72,29,44,73
68,8476459,Mika Zibanejad,C,NYR,31,76,26,47,73
68,8480208,Drake Batherson,R,OTT,26,78,32,40,72
68,8475810,Bryan Rust,R,PIT,32,73,31,41,72
68,8476460,Mark Scheifele,C,WPG,31,77,30,42,72
68,8476389,Vincent Trocheck,C,NYR,31,75,26,45,71
68,8476853,Morgan Rielly,D,TOR,30,70,9,62,71
68,8477933,Sam Reinhart,C,FLA,29,76,36,34,70
68,8478519,Anthony Cirelli,C,TBL,27,81,32,38,70
68,8475158,Ryan O'Reilly,C,NSH,33,73,26,44,70
68,8480036,Miro Heiskanen,D,DAL,25,79,16,54,70
68,8480865,Noah Dobson,D,NYI,24,80,15,55,70
68,8476881,Tomas Hertl,C,VGK,31,77,36,33,69
68,8479337,Alex DeBrincat,R,DET,27,82,31,38,69
68,8479542,Brandon Hagel,L,TBL,26,80,29,40,69
68,8482124,Quinton Byfield,R,LAK,22,80,26,43,69
68,8477496,Elias Lindholm,C,BOS,30,81,21,48,69
68,8473994,Jamie Benn,L,DAL,35,82,16,53,69
68,8478445,Mathew Barzal,C,NYI,27,80,20,48,68
68,8475726,Tyler Toffoli,C,SJS,32,69,35,32,67
68,8479420,Tage Thompson,C,BUF,27,74,32,35,67
68,8475754,Brock Nelson,C,NYI,33,79,31,36,67
68,8479999,Casey Mittelstadt,C,COL,26,80,19,48,67
68,8475184,Chris Kreider,L,NYR,33,78,30,36,66
68,8477940,Nikolaj Ehlers,L,WPG,28,71,24,42,66
68,8471214,Alex Ovechkin,L,WSH,39,63,22,44,66
68,8480803,Evan Bouchard,D,EDM,25,77,20,46,66
68,8475166,John Tavares,C,TOR,34,79,29,36,65
68,8478401,Pavel Zacha,C,BOS,27,80,29,36,65
68,8475784,Jeff Skinner,C,EDM,32,75,24,41,65
68,8474578,Erik Karlsson,D,PIT,34,79,13,52,65
68,8476539,Jonathan Marchessault,R,NSH,34,69,35,29,64
68,8477951,Nick Schmaltz,C,UTA,28,76,25,39,64
68,8474141,Patrick Kane,R,DET,36,81,23,41,64
68,8480839,Rasmus Dahlin,D,BUF,24,73,15,49,64
68,8481540,Cole Caufield,R,MTL,23,79,35,28,63
68,8478047,Michael Bunting,L,PIT,29,71,35,28,63
68,8477500,Bo Horvat,C,NYI,29,75,32,31,63
68,8478440,Dylan Strome,C,WSH,27,75,25,38,63
68,8475798,Mikael Granlund,C,SJS,32,70,15,48,63
68,8475168,Matt Duchene,C,DAL,33,81,27,35,62
68,8474150,Mikael Backlund,C,CGY,35,79,23,39,62
68,8480018,Nick Suzuki,C,MTL,25,79,15,47,62
68,8482159,Tyson Foerster,R,PHI,22,78,30,31,61
68,8477935,Sam Bennett,C,FLA,28,77,26,35,61
68,8482097,Jack Quinn,R,BUF,23,69,24,36,60
68,8478873,Troy Terry,R,ANA,27,73,23,37,60
68,8478856,Conor Garland,R,VAN,28,75,23,37,60
68,8478438,Tommy Novak,C,NSH,27,72,20,40,60
68,8478460,Zach Werenski,D,CBJ,27,81,17,43,60
68,8476905,Chandler Stephenson,C,SEA,30,78,16,44,60
68,8481528,Dylan Cozens,C,BUF,23,75,31,28,59
68,8476432,Boone Jenner,C,CBJ,31,70,29,30,59
68,8479525,Ross Colton,C,COL,28,82,26,33,59
68,8482665,Matty Beniers,C,SEA,22,77,24,35,59
68,8475169,Evander Kane,L,EDM,33,75,33,25,58
68,8484166,Adam Fantilli,C,CBJ,20,71,24,34,58
68,8475765,Vladimir Tarasenko,R,DET,33,79,22,36,58
68,8478366,Frank Vatrano,R,ANA,30,76,34,23,57
68,8480015,Owen Tippett,R,PHI,25,81,33,24,57
68,8477476,Artturi Lehkonen,L,COL,29,79,31,26,57
68,8476448,William Karlsson,C,VGK,31,78,28,29,57
68,8478975,Mason Marchment,L,DAL,29,79,25,32,57
68,8477511,Anthony Mantha,R,CGY,30,73,24,33,57
68,8474679,Gustav Nyquist,C,NSH,35,75,20,37,57
68,8471685,Anze Kopitar,C,LAK,37,79,14,43,57
68,8477494,Jonathan Drouin,L,COL,29,79,13,44,57
68,8481711,Matias Maccelli,L,UTA,24,76,12,45,57
68,8479325,Charlie McAvoy,D,BOS,27,75,9,48,57
68,8480188,Fabian Zetterlund,L,SJS,25,68,32,24,56
68,8483515,Juraj Slafkovsky,L,MTL,20,75,26,29,55
68,8477426,Nicholas Paul,L,TBL,29,82,29,25,54
68,8474641,Adam Henrique,C,EDM,34,79,26,28,54
68,8475151,Kyle Palmieri,C,NYI,33,79,24,30,54
68,8477479,Tyler Bertuzzi,L,CHI,29,66,24,30,54
68,8479339,Patrik Laine,L,CBJ,26,62,20,34,54
68,8476462,Dougie Hamilton,D,NJD,31,69,19,35,54
68,8477964,Ivan Barbashev,C,VGK,29,78,16,38,54
68,8476906,Shayne Gostisbehere,D,CAR,31,76,9,45,54
68,8479323,Adam Fox,D,NYR,26,71,7,47,54
68,8480064,Josh Norris,C,OTT,25,77,31,22,53
68,8482113,Anton Lundell,C,FLA,23,80,19,34,53
68,8482745,Mason McTavish,C,ANA,21,65,21,31,52
68,8477998,Warren Foegele,L,LAK,28,80,21,31,52
68,8477402,Pavel Buchnevich,L,STL,29,77,18,34,52
68,8471724,Kris Letang,D,PIT,37,80,6,46,52
68,8481068,Yegor Sharangovich,C,CGY,26,75,25,26,51
68,8478466,Daniel Sprong,R,VAN,27,69,25,26,51
68,8482110,Dawson Mercer,C,NJD,23,74,24,27,51
68,8478407,Vince Dunn,D,SEA,28,70,15,36,51
68,8474590,John Carlson,D,WSH,34,71,11,40,51
68,8478444,Brock Boeser,R,VAN,27,74,30,20,50
68,8482699,Dylan Guenther,R,UTA,21,79,22,28,50
68,8483808,Andrei Kuzmenko,L,CGY,28,77,20,30,50
68,8477451,Ryan Hartman,R,MIN,30,68,16,34,50
68,8480014,Gabriel Vilardi,C,WPG,25,67,32,17,49
68,8480797,Joel Farabee,L,PHI,24,74,24,25,49
68,8477955,Jared McCann,L,SEA,28,75,23,26,49
68,8480039,Martin Necas,C,CAR,25,65,21,28,49
68,8476479,Phillip Danault,C,LAK,31,78,20,29,49
68,8475170,Brayden Schenn,C,STL,33,70,20,29,49
68,8477416,Oliver Bjorkstrand,R,SEA,29,75,18,31,49
68,8479591,Michael Eyssimont,C,TBL,28,80,17,32,49
68,8482093,Seth Jarvis,C,CAR,22,70,24,24,48
68,8478462,Nicolas Roy,C,VGK,27,76,14,34,48
68,8477495,Seth Jones,D,CHI,30,66,13,35,48
68,8482705,Cole Sillinger,C,CBJ,21,73,25,22,47
68,8475191,Reilly Smith,R,NYR,33,73,23,24,47
68,8481560,Arthur Kaliyev,R,LAK,23,79,15,32,47
68,8481533,Trevor Zegras,C,ANA,23,75,11,36,47
68,8476438,Brandon Saad,L,STL,32,73,26,20,46
68,8475848,Brendan Gallagher,R,MTL,32,70,20,26,46
68,8480028,Morgan Frost,C,PHI,25,73,17,29,46
68,8481581,Thomas Harley,D,DAL,23,77,14,32,46
68,8470613,Brent Burns,D,CAR,39,72,11,35,46
68,8482684,Luke Hughes,D,NJD,21,69,6,40,46
68,8475314,Anders Lee,L,NYI,34,81,25,20,45
68,8479987,Morgan Geekie,C,BOS,26,79,22,23,45
68,8482092,Ridly Greig,C,OTT,22,75,20,25,45
68,8479345,Jakob Chychrun,D,WSH,26,71,19,26,45
68,8475794,Tyler Seguin,C,DAL,32,82,17,28,45
68,8480113,Alex Iafallo,L,WPG,31,67,16,29,45
68,8477503,Max Domi,C,TOR,29,78,15,30,45
68,8475745,Charlie Coyle,C,BOS,32,75,15,30,45
68,8482175,JJ Peterka,R,BUF,22,71,15,30,45
68,8482702,Logan Stankoven,C,DAL,21,82,23,21,44
68,8481618,Alex Newhook,C,MTL,23,75,21,23,44
68,8483431,Logan Cooley,C,UTA,20,73,17,27,44
68,8478542,Evan Rodrigues,C,FLA,31,74,16,28,44
68,8476854,Hampus Lindholm,D,BOS,30,69,14,30,44
68,8475764,Cam Fowler,D,ANA,33,75,6,37,43
68,8475799,Nino Niederreiter,R,WPG,32,73,32,10,42
68,8482109,Alexis Lafrenière,L,NYR,23,74,24,18,42
68,8477497,Sean Monahan,C,CBJ,30,68,19,23,42
68,8479400,Pierre-Luc Dubois,L,WSH,26,71,18,24,42
68,8482667,William Eklund,L,SJS,22,63,14,28,42
68,8475753,Justin Faulk,D,STL,32,72,13,29,42
68,8476923,Damon Severson,D,CBJ,30,77,10,32,42
68,8474563,Drew Doughty,D,LAK,35,70,9,33,42
68,8478469,Thomas Chabot,D,OTT,27,74,7,35,42
68,8481542,Moritz Seider,D,DET,23,78,7,35,42
68,8475760,Nick Bjugstad,C,UTA,32,74,22,19,41
68,8477407,Anthony Duclair,L,NYI,29,80,22,19,41
68,8482133,Thomas Bordeleau,C,SJS,22,66,10,31,41
68,8481546,Cam York,D,PHI,23,67,7,34,41
68,8481032,Paul Cotter,C,NJD,25,64,26,14,40
68,8484153,Leo Carlsson,C,ANA,20,75,22,18,40
68,8476897,Oskar Sundqvist,C,STL,30,65,19,21,40
68,8477021,Alex Kerfoot,C,UTA,30,77,18,22,40
68,8481577,Philip Tomasino,C,NSH,23,71,15,25,40
68,8481186,Logan O'Connor,R,COL,28,77,13,27,40
68,8474716,Jared Spurgeon,D,MIN,35,79,12,28,40
68,8478891,Mason Appleton,C,WPG,28,65,12,28,40
68,8475218,Mattias Ekholm,D,EDM,34,75,9,31,40
68,8477488,Brett Pesce,D,NJD,30,66,4,36,40
68,8482712,Oskar Olausson,R,COL,22,73,2,38,40
68,8480078,Filip Chytil,C,NYR,25,72,21,18,39
68,8475763,Kevin Hayes,R,PIT,32,69,19,20,39
68,8478498,Jake DeBrusk,L,VAN,28,74,18,21,39
68,8482149,Cole Perfetti,C,WPG,22,70,18,21,39
68,8475768,Jaden Schwartz,C,SEA,32,69,18,21,39
68,8477444,Andre Burakovsky,L,SEA,29,76,18,21,39
68,8476399,Blake Coleman,C,CGY,33,77,16,23,39
68,8474586,Jordan Eberle,R,SEA,34,77,15,24,39
68,8480185,Eetu Luostarinen,C,FLA,26,68,13,26,39
68,8481596,Shane Pinto,C,OTT,24,78,13,26,39
68,8478396,Noah Hanifin,D,VGK,27,72,12,27,39
68,8481524,Bowen Byram,D,BUF,23,70,11,28,39
68,8477346,MacKenzie Weegar,D,CGY,30,73,8,31,39
68,8480459,Pius Suter,C,VAN,28,67,20,18,38
68,8474102,David Perron,L,OTT,36,77,17,21,38
68,8477429,Andrew Copp,C,DET,30,78,17,21,38
68,8480798,Philipp Kurashev,C,CHI,25,63,13,25,38
68,8476292,Ondrej Palat,L,NJD,33,69,12,26,38
68,8477986,Brandon Montour,D,SEA,30,75,11,27,38
68,8478038,Devon Toews,D,COL,30,66,10,28,38
68,8476458,Ryan Strome,C,ANA,31,64,10,28,38
68,8475714,Calle Jarnkrok,C,TOR,33,75,20,17,37
68,8478115,Pierre Engvall,L,NYI,28,77,18,19,37
68,8479365,Trent Frederic,C,BOS,26,73,17,20,37
68,8480829,Jesperi Kotkaniemi,C,CAR,24,69,17,20,37
68,8476419,Jean-Gabriel Pageau,C,NYI,32,78,16,21,37
68,8484145,Zach Benson,L,BUF,19,67,13,24,37
68,8482720,Matthew Knies,L,TOR,22,75,11,26,37
68,8481703,Valtteri Puustinen,R,PIT,25,56,8,29,37
68,8478397,Rasmus Andersson,D,CGY,28,75,5,32,37
68,8477987,Ryan Donato,C,CHI,28,65,21,15,36
68,8481554,Kaapo Kakko,R,NYR,23,63,20,16,36
68,8481604,Pavel Dorofeyev,L,VGK,24,66,18,18,36
68,8479992,Michael Rasmussen,C,DET,25,75,15,21,36
68,8476826,Yanni Gourde,C,SEA,33,71,13,23,36
68,8476882,Teuvo Teravainen,C,CHI,30,64,10,26,36
68,8475149,Marcus Johansson,L,MIN,34,60,9,27,36
68,8478055,Gustav Forsling,D,FLA,28,76,8,28,36
68,8476792,Torey Krug,D,STL,33,70,7,29,36
68,8476892,Colton Parayko,D,STL,31,73,5,31,36
68,8480893,Kirill Marchenko,R,CBJ,24,63,22,13,35
68,8480009,Eeli Tolvanen,R,SEA,25,74,17,18,35
68,8480835,Jack Drury,C,CAR,24,57,17,18,35
68,8475287,Erik Haula,L,NJD,33,68,16,19,35
68,8476872,Scott Laughton,C,PHI,30,75,13,22,35
68,8482146,Luke Evangelista,R,NSH,22,66,11,24,35
68,8479425,Filip Hronek,D,VAN,27,73,6,29,35
68,8474151,Ryan McDonagh,D,TBL,35,73,2,33,35
68,8477456,J.T. Compher,L,DET,29,79,15,19,34
68,8473986,Alex Killorn,L,ANA,35,73,14,20,34
68,8478233,Andrew Mangiapane,L,WSH,28,68,10,24,34
68,8473422,Nick Foligno,L,CHI,37,57,10,24,34
68,8477498,Darnell Nurse,D,EDM,29,70,8,26,34
68,8476885,Jacob Trouba,D,NYR,30,76,8,26,34
68,8476463,Jonas Brodin,D,MIN,31,78,4,30,34
68,8476981,Josh Anderson,R,MTL,30,70,17,16,33
68,8478458,John (Jack) Roslovic,C,CAR,27,64,10,23,33
68,8478472,Mathieu Joseph,R,STL,27,63,10,23,33
68,8478133,Jake Evans,C,MTL,28,73,9,24,33
68,8476979,Erik Gustafsson,D,DET,32,74,9,24,33
68,8477932,Aaron Ekblad,D,FLA,28,76,9,24,33
68,8475200,Dmitry Orlov,D,CAR,33,73,9,24,33
68,8481606,Jordan Spence,D,LAK,23,69,8,25,33
68,8477969,Marcus Pettersson,D,PIT,28,78,7,26,33
68,8476958,Jaccob Slavin,D,CAR,30,76,6,27,33
68,8476917,Adam Pelech,D,NYI,30,78,3,30,33
68,8482475,Yegor Chinakhov,R,CBJ,23,70,18,14,32
68,8476880,Tom Wilson,R,WSH,30,66,17,15,32
68,8476483,Rickard Rakell,R,PIT,31,72,14,18,32
68,8477953,Kasperi Kapanen,R,STL,28,66,12,20,32
68,8481582,Nicholas Robertson,L,TOR,23,72,12,20,32
68,8482671,Owen Power,D,BUF,22,65,10,22,32
68,8476869,Brady Skjei,D,NSH,30,71,8,24,32
68,8480802,Ryan McLeod,C,BUF,25,65,8,24,32
68,8482105,Jake Sanderson,D,OTT,22,73,5,27,32
68,8478020,Michael Amadio,R,OTT,28,67,17,14,31
68,8471698,T.J. Oshie,R,WSH,38,59,16,15,31
68,8478474,Lawson Crouse,L,UTA,27,69,16,15,31
68,8480068,Ryan Poehling,C,PHI,25,65,14,17,31
68,8475220,Marcus Foligno,L,MIN,33,59,12,19,31
68,8476474,Stefan Noesen,R,NJD,31,72,11,20,31
68,8476927,Teddy Blueger,C,VAN,30,64,10,21,31
68,8476392,Adam Lowry,C,WPG,31,62,10,21,31
68,8477948,Travis Sanheim,D,PHI,28,74,9,22,31
68,8482803,Olen Zellweger,D,ANA,21,60,9,22,31
68,8480434,Sean Durzi,D,UTA,26,69,8,23,31
68,8482122,Brock Faber,D,MIN,22,81,8,23,31
68,8475171,Oliver Ekman-Larsson,D,TOR,33,69,5,26,31
68,8482655,Janis Moser,D,TBL,24,79,5,26,31
68,8480001,Urho Vaakanainen,D,ANA,25,59,4,27,31
68,8478046,Danton Heinen,L,VAN,29,71,16,14,30
68,8478042,Viktor Arvidsson,L,EDM,31,71,13,17,30
68,8480220,Noah Cates,L,PHI,25,77,13,17,30
68,8483505,Matthew Poitras,C,BOS,20,76,11,19,30
68,8477505,Alexander Wennberg,C,SJS,30,62,11,19,30
68,8480871,Adam Boqvist,D,FLA,24,65,10,20,30
68,8479410,Mikhail Sergachev,D,UTA,26,69,6,24,30
68,8476931,Jake McCabe,D,TOR,31,64,1,29,30
68,8481477,Nico Sturm,C,SJS,29,58,18,11,29
68,8476921,Jordan Martinook,L,CAR,32,68,13,16,29
68,8484203,Bradly Nadeau,L,CAR,19,70,12,17,29
68,8480336,Sean Walker,D,CAR,30,76,9,20,29
68,8476461,Sean Couturier,C,PHI,32,69,9,20,29
68,8480817,K'Andre Miller,D,NYR,24,62,8,21,29
68,8481553,Bobby Brink,R,PHI,23,65,6,23,29
68,8480145,Neal Pionk,D,WPG,29,66,5,24,29
68,8474565,Alex Pietrangelo,D,VGK,34,62,4,25,29
68,8479398,Samuel Girard,D,COL,26,62,3,26,29
68,8478500,Ivan Provorov,D,CBJ,27,81,1,28,29
68,8477952,Robby Fabbri,C,ANA,28,65,15,13,28
68,8483445,Cutter Gauthier,L,ANA,20,67,13,15,28
68,8480849,Barrett Hayton,C,UTA,24,70,12,16,28
68,8477947,Sonny Milano,L,WSH,28,62,12,16,28
68,8480813,Joe Veleno,C,DET,24,77,11,17,28
68,8480748,Kiefer Sherwood,L,VAN,29,57,10,18,28
68,8479393,Noah Gregor,L,OTT,26,67,10,18,28
68,8476925,Colton Sissons,C,NSH,31,63,9,19,28
68,8482624,Daniil Miromanov,D,CGY,27,71,9,19,28
68,8477919,Frederick Gaudreau,C,MIN,31,57,9,19,28
68,8476994,Vinnie Hinostroza,C,NSH,30,48,9,19,28
68,8475181,Nick Leddy,D,STL,33,68,9,19,28
68,8475791,Taylor Hall,L,CHI,33,58,7,21,28
68,8476902,Esa Lindell,D,DAL,30,75,7,21,28
68,8476331,Dylan DeMelo,D,WPG,31,76,2,26,28
68,8482259,Bobby McMann,C,TOR,28,65,19,8,27
68,8479390,Taylor Raddysh,R,WSH,26,63,17,10,27
68,8474189,Lars Eller,C,PIT,35,64,12,15,27
68,8478507,John Marino,D,UTA,27,70,2,25,27
68,8478109,Victor Olofsson,L,VGK,29,63,16,10,26
68,8481535,Nils Hoglander,L,VAN,24,63,14,12,26
68,8482055,Drew O'Connor,L,PIT,26,62,13,13,26
68,8481093,Rafael Harvey-Pinard,L,MTL,25,58,13,13,26
68,8477450,Jason Dickinson,C,CHI,29,54,13,13,26
68,8483524,Shane Wright,C,SEA,20,55,12,14,26
68,8480074,Alexandre Texier,C,STL,25,54,12,14,26
68,8475722,Jason Zucker,L,BUF,32,66,10,16,26
68,8482660,Kent Johnson,C,CBJ,22,69,10,16,26
68,8475231,Casey Cizikas,C,NYI,33,77,9,17,26
68,8482142,Jamie Drysdale,D,PHI,22,66,9,17,26
68,8474053,Logan Couture,C,SJS,35,57,8,18,26
68,8474149,Evgenii Dadonov,R,DAL,35,79,8,18,26
68,8483482,Tristan Luneau,D,ANA,20,59,8,18,26
68,8481014,Alexander Romanov,D,NYI,24,77,3,23,26
68,8478416,Erik Cernak,D,TBL,27,71,2,24,26
68,8476278,Colin Blackwell,C,DAL,31,76,15,10,25
68,8478463,Anthony Beauvillier,L,PIT,27,67,10,15,25
68,8477447,Shea Theodore,D,VGK,29,53,9,16,25
68,8479996,Cody Glass,C,NSH,25,58,9,16,25
68,8481481,Blake Lizotte,C,PIT,27,64,9,16,25
68,8477989,Christian Dvorak,C,MTL,28,57,8,17,25
68,8476422,Mike Reilly,D,NYI,31,69,8,17,25
68,8479353,Brett Howden,C,VGK,26,66,8,17,25
68,8483490,Pavel Mintyukov,D,ANA,21,69,7,18,25
68,8477508,Curtis Lazar,C,NJD,29,52,5,20,25
68,8475179,Dmitry Kulikov,D,FLA,34,69,5,20,25
68,8480891,Michael Kesselring,D,UTA,24,56,4,21,25
68,8475790,Erik Gudbranson,D,CBJ,32,76,4,21,25
68,8475279,Ben Chiarot,D,DET,33,71,3,22,25
68,8477425,Miles Wood,L,COL,29,73,16,8,24
68,8478413,Jordan Greenway,L,BUF,27,62,15,9,24
68,8476878,Zemgus Girgensons,C,TBL,30,79,15,9,24
68,8478057,Dakota Joshua,C,VAN,28,58,13,11,24
68,8481641,Joel Kiviranta,L,COL,28,72,13,11,24
68,8482679,Matt Coronato,R,CGY,22,67,13,11,24
68,8475343,Nic Dowd,C,WSH,34,63,12,12,24
68,8476918,Jimmy Vesey,L,NYR,31,72,11,13,24
68,8482125,Alexander Holtz,R,VGK,22,69,10,14,24
68,8479520,Brandon Duhaime,R,WSH,27,67,10,14,24
68,8479293,Brandon Tanev,L,SEA,33,66,9,15,24
68,8474715,Cameron Atkinson,R,TBL,35,82,9,15,24
68,8484149,Gavin Brindley,C,CBJ,20,50,9,15,24
68,8481656,Aliaksei Protas,C,WSH,23,63,8,16,24
68,8481624,Ilya Mikheyev,R,CHI,30,57,7,17,24
68,8477839,Conor Sheary,L,TBL,32,82,7,17,24
68,8477506,Ryan Pulock,D,NYI,30,80,5,19,24
68,8476457,Adam Larsson,D,SEA,32,74,3,21,24
68,8482067,Connor Mackey,D,NYR,28,67,1,23,24
68,8482155,Alex Laferriere,R,LAK,23,63,13,10,23
68,8476822,Luke Glendening,C,TBL,35,78,12,11,23
68,8482089,Jake Neighbours,L,STL,22,69,11,12,23
68,8477015,Connor Brown,R,EDM,30,63,10,13,23
68,8478432,Christian Fischer,R,DET,27,71,8,15,23
68,8478911,Matt Roy,D,WSH,29,63,7,16,23
68,8481441,Joe Snively,C,DET,28,69,6,17,23
68,8481059,Scott Perunovich,D,STL,26,58,5,18,23
68,8473563,Nicklas Backstrom,C,WSH,37,57,4,19,23
68,8480246,Nick Perbix,D,TBL,26,74,3,20,23
68,8480806,Isac Lundestrom,C,ANA,25,61,12,10,22
68,8479414,Nathan Bastian,R,NJD,27,54,11,11,22
68,8477478,William Carrier,L,CAR,30,53,11,11,22
68,8478585,Derek Ryan,C,EDM,38,61,10,12,22
68,8481523,Kirby Dach,C,MTL,23,70,9,13,22
68,8479351,Sam Steel,C,DAL,26,80,8,14,22
68,8481028,Martin Pospisil,C,CGY,25,60,6,16,22
68,8479315,Joey Anderson,R,CHI,26,48,5,17,22
68,8480073,Erik Brannstrom,D,COL,25,69,4,18,22
68,8478851,Alexandre Carrier,D,NSH,28,69,3,19,22
68,8475188,Brayden McNabb,D,VGK,33,57,3,19,22
68,8476856,Mathew Dumba,D,DAL,30,64,2,20,22
68,8476429,Scott Mayfield,D,NYI,32,71,2,20,22
68,8473453,Trevor Lewis,C,LAK,37,75,12,9,21
68,8483493,Frank Nazar,C,CHI,20,52,12,9,21
68,8478043,Sam Lafferty,C,BUF,29,58,11,10,21
68,8483495,Simon Nemec,D,NJD,20,59,11,10,21
68,8479368,Max Jones,L,BOS,26,71,10,11,21
68,8480355,Mark Kastelic,C,BOS,25,58,10,11,21
68,8478013,Jake Walman,D,SJS,28,70,9,12,21
68,8482079,Marco Rossi,C,MIN,23,60,9,12,21
68,8482101,Danil Gushchin,L,SJS,22,59,7,14,21
68,8473533,Jordan Staal,C,CAR,36,57,7,14,21
68,8479324,Ryan Lindgren,D,NYR,26,64,7,14,21
68,8482451,Mikael Pyyhtia,L,CBJ,23,45,7,14,21
68,8479998,Mikey Anderson,D,LAK,25,65,6,15,21
68,8481522,Peyton Krebs,C,BUF,23,64,6,15,21
68,8478882,Vladislav Gavrikov,D,LAK,29,64,5,16,21
68,8479983,Mario Ferraro,D,SJS,26,68,4,17,21
68,8480878,Nils Lundkvist,D,DAL,24,71,2,19,21
68,8474673,TJ Brodie,D,CHI,34,63,2,19,21
68,8482245,Artem Zub,D,OTT,29,73,1,20,21
68,8479369,Andrew Peeke,D,BOS,26,67,0,21,21
68,8475225,Craig Smith,C,CHI,35,58,12,8,20
68,8478508,Yakov Trenin,C,MIN,27,61,9,11,20
68,8482117,Lukas Reichel,L,CHI,22,55,9,11,20
68,8477392,Hudson Fasching,R,NYI,29,64,9,11,20
68,8480789,Oliver Wahlstrom,R,NYI,24,68,8,12,20
68,8476329,Travis Boyd,C,MIN,31,53,6,14,20
68,8483457,Lane Hutson,D,MTL,20,69,6,14,20
68,8477406,Mattias Janmark,C,EDM,32,59,6,14,20
68,8477499,Rasmus Ristolainen,D,PHI,30,61,6,14,20
68,8476891,Matthew Grzelcyk,D,PIT,30,75,5,15,20
68,8479980,Nicolas Hague,D,VGK,26,52,4,16,20
68,8477220,Nate Schmidt,D,FLA,33,69,3,17,20
68,8480049,Dylan Samberg,D,WPG,25,58,0,20,20
68,8480144,David Kampf,C,TOR,29,70,11,8,19
68,8470621,Corey Perry,R,EDM,39,70,11,8,19
68,8480762,Eric Robinson,L,CAR,29,64,10,9,19
68,8479718,Alex Barré-Boulet,C,MTL,27,53,9,10,19
68,8476480,Vladislav Namestnikov,C,WPG,32,69,8,11,19
68,8480003,Jesper Boqvist,C,FLA,26,65,8,11,19
68,8475193,Tomas Tatar,L,NJD,34,69,7,12,19
68,8477903,Garnet Hathaway,R,PHI,33,64,7,12,19
68,8481517,Brett Leason,R,ANA,25,55,7,12,19
68,8476889,Radek Faksa,C,STL,30,67,6,13,19
68,8478178,Darren Raddysh,D,TBL,28,72,5,14,19
68,8476988,Matt Benning,D,SJS,30,69,5,14,19
68,8480873,Rasmus Sandin,D,WSH,24,65,4,15,19
68,8482087,Kaiden Guhle,D,MTL,22,64,4,15,19
68,8479982,Conor Timmins,D,TOR,26,60,2,17,19
68,8480727,Zach Whitecloud,D,VGK,28,54,2,17,19
68,8482062,Cole Smith,L,NSH,29,52,13,5,18
68,8476873,Mark Jankowski,C,NSH,30,56,12,6,18
68,8481580,Connor McMichael,C,WSH,23,62,12,6,18
68,8479661,Tanner Jeannot,L,LAK,27,73,11,7,18
68,8483499,Liam Ohgren,L,MIN,20,56,11,7,18
68,8479066,Ryan Lomberg,L,CGY,30,63,11,7,18
68,8475793,Ryan Johansen,C,PHI,32,72,9,9,18
68,8476374,Sean Kuraly,C,CBJ,31,48,8,10,18
68,8476312,Josh Manson,D,COL,33,62,7,11,18
68,8483491,Ivan Miroshnichenko,L,WSH,20,61,7,11,18
68,8480448,Parker Kelly,L,COL,25,71,7,11,18
68,8479370,Tyson Jost,C,CAR,26,58,7,11,18
68,8480855,Jack McBain,C,UTA,24,65,6,12,18
68,8476525,Colin Miller,D,WPG,32,60,6,12,18
68,8480252,Cole Guttman,C,CHI,25,43,6,12,18
68,8477435,Ryan Graves,D,PIT,29,77,5,13,18
68,8479976,Juuso Valimaki,D,UTA,26,63,4,14,18
68,8482111,Justin Barron,D,MTL,23,66,4,14,18
68,8473507,Jeff Petry,D,DET,37,73,4,14,18
68,8478970,Jalen Chatfield,D,CAR,28,71,4,14,18
68,8479371,Dante Fabbro,D,NSH,26,59,3,15,18
68,8471709,Marc-Edouard Vlasic,D,SJS,37,57,2,16,18
68,8476469,Joel Armia,R,MTL,31,60,9,8,17
68,8477979,Nicolas Aube-Kubel,R,BUF,28,59,8,9,17
68,8480980,Connor Dewar,C,TOR,25,67,8,9,17
68,8476934,Brock McGinn,L,ANA,30,49,8,9,17
68,8479941,Justin Danforth,R,CBJ,31,49,7,10,17
68,8477369,Carson Soucy,D,VAN,30,68,6,11,17
68,8476442,Matt Nieto,L,PIT,32,45,6,11,17
68,8482730,Brandt Clarke,D,LAK,21,56,5,12,17
68,8477507,Nikita Zadorov,D,BOS,29,63,4,13,17
68,8479639,Dylan Coghlan,D,WPG,26,68,4,13,17
68,8476467,Jamie Oleksiak,D,SEA,32,69,4,13,17
68,8481537,Nikita Okhotiuk,D,CGY,24,56,4,13,17
68,8480807,Mattias Samuelsson,D,BUF,24,53,2,15,17
68,8481568,Alex Vlasic,D,CHI,23,57,2,15,17
68,8475718,Justin Holl,D,DET,32,59,1,16,17
68,8481601,Simon Holmstrom,R,NYI,23,70,10,6,16
68,8478421,A.J. Greer,L,FLA,28,61,10,6,16
68,8479336,Carl Grundstrom,R,SJS,27,52,10,6,16
68,8478434,Keegan Kolesar,R,VGK,27,66,10,6,16
68,8482659,Josh Doan,R,UTA,22,56,9,7,16
68,8483468,Jiri Kulich,C,BUF,20,55,8,8,16
68,8480281,Alexey Toropchenko,R,STL,25,62,7,9,16
68,8479026,Philippe Myers,D,TOR,27,54,7,9,16
68,8477353,Tyler Motte,C,DET,29,74,7,9,16
68,8482809,Jackson Blake,R,CAR,21,56,6,10,16
68,8479344,Jesse Puljujarvi,R,PIT,26,48,6,10,16
68,8480441,Trey Fix-Wolansky,R,CBJ,25,38,6,10,16
68,8480070,Ian Mitchell,D,BOS,25,50,6,10,16
68,8479671,Mathieu Olivier,R,CBJ,27,40,6,10,16
68,8477380,Jonny Brodzinski,C,NYR,31,49,6,10,16
68,8482744,James Malatesta,L,CBJ,21,53,6,10,16
68,8482634,Alex Steeves,C,TOR,25,39,5,11,16
68,8480025,MacKenzie Entwistle,R,FLA,25,60,5,11,16
68,8480011,Klim Kostin,C,SJS,25,52,5,11,16
68,8479328,Julien Gauthier,R,NYI,27,60,5,11,16
68,8481521,Ronnie Attard,D,PHI,25,56,5,11,16
68,8482176,Wyatt Kaiser,D,CHI,22,62,3,13,16
68,8478136,Jake Middleton,D,MIN,28,73,2,14,16
68,8479249,Andrew Poturalski,C,SJS,30,33,2,14,16
68,8481527,Kaedan Korczak,D,VGK,23,44,1,15,16
68,8476879,Cody Ceci,D,EDM,31,69,0,16,16
68,8482737,Zack Bolduc,C,STL,21,56,7,8,15
68,8478211,Dryden Hunt,L,CGY,29,53,7,8,15
68,8481617,Vasily Podkolzin,R,VAN,23,48,6,9,15
68,8476960,Andreas Athanasiou,C,CHI,30,53,5,10,15
68,8481704,Juuso Parssinen,C,NSH,23,56,5,10,15
68,8479619,Michael Carcone,L,UTA,28,58,5,10,15
68,8476624,Barclay Goodrow,C,SJS,31,49,5,10,15
68,8480995,Pontus Holmberg,R,TOR,25,58,5,10,15
68,8482166,Shakir Mukhamadullin,D,SJS,22,59,5,10,15
68,8482148,Hendrix Lapierre,C,WSH,22,53,4,11,15
68,8477365,Connor Clifton,D,BUF,29,55,3,12,15
68,8480043,Timothy Liljegren,D,TOR,25,61,2,13,15
68,8482073,Braden Schneider,D,NYR,23,62,2,13,15
68,8474574,Tyler Myers,D,VAN,34,63,0,15,15
68,8478831,Kevin Stenlund,C,UTA,28,50,10,4,14
68,8482074,Connor Zary,C,CGY,23,60,8,6,14
68,8482157,Will Cuylle,L,NYR,22,65,7,7,14
68,8477070,Liam O'Brien,C,UTA,30,59,7,7,14
68,8471817,Ryan Reaves,R,TOR,37,59,6,8,14
68,8478424,Jansen Harkins,C,ANA,27,47,6,8,14
68,8482095,Tyler Kleven,D,OTT,22,41,6,8,14
68,8479439,Jacob MacDonald,D,COL,31,43,5,9,14
68,8480289,Morgan Barron,C,WPG,26,49,4,10,14
68,8479543,Michael Pezzetta,L,MTL,26,61,4,10,14
68,8481751,Lukas Rousek,R,BUF,25,39,4,10,14
68,8478840,Will Borgen,D,SEA,28,68,3,11,14
68,8480860,Kevin Bahl,D,CGY,24,56,3,11,14
68,8474567,Zach Bogosian,D,MIN,34,61,3,11,14
68,8480192,Johnathan Kovacevic,D,NJD,27,50,3,11,14
68,8475233,David Savard,D,MTL,34,67,2,12,14
68,8480172,Jan Rutta,D,SJS,34,57,2,12,14
68,8481708,Zac Jones,D,NYR,24,55,2,12,14
68,8478451,Ethan Bear,D,WSH,27,47,2,12,14
68,8483565,Nick Blankenburg,D,NSH,26,67,1,13,14
68,8479402,Jake Bean,D,CGY,26,67,1,13,14
68,8478443,Brandon Carlo,D,BOS,28,61,1,13,14
68,8479316,Luke Kunin,C,SJS,27,61,8,5,13
68,8475842,Sam Carrick,C,NYR,32,59,8,5,13
68,8482077,Dylan Holloway,L,EDM,23,58,8,5,13
68,8480021,Jack Studnicka,C,LAK,25,58,8,5,13
68,8482713,Mackie Samoskevich,R,FLA,22,43,8,5,13
68,8482762,Simon Edvinsson,D,DET,21,52,7,6,13
68,8477446,Michael McCarron,R,NSH,29,56,7,6,13
68,8480848,Ty Dellandrea,C,SJS,24,49,7,6,13
68,8480950,Ilya Lyubushkin,D,DAL,30,66,5,8,13
68,8480035,Henri Jokiharju,D,BUF,25,60,4,9,13
68,8481599,Victor Soderstrom,D,UTA,23,40,4,9,13
68,8479442,Troy Stecher,D,EDM,30,58,4,9,13
68,8479972,Mason Shaw,C,WPG,26,36,4,9,13
68,8471677,Jack Johnson,D,CBJ,37,63,3,10,13
68,8479968,Vinni Lettieri,C,BOS,29,50,3,10,13
68,8481178,Egor Zamula,D,PHI,24,51,2,11,13
68,8475462,Radko Gudas,D,ANA,34,71,1,12,13
68,8477845,Trevor van Riemsdyk,D,WSH,33,56,1,12,13
68,8475324,Nick Jensen,D,OTT,34,68,0,13,13
68,8480205,Emil Bemstrom,C,PIT,25,55,10,2,12
68,8481716,Dmitri Voronkov,L,CBJ,24,39,9,3,12
68,8482749,Joshua Roy,R,MTL,21,60,7,5,12
68,8481592,Jakob Pelletier,L,CGY,23,39,7,5,12
68,8481754,Nikita Nesterenko,C,ANA,23,43,7,5,12
68,8482964,Arber Xhekaj,D,MTL,23,43,5,7,12
68,8482747,Brennan Othmann,L,NYR,21,32,4,8,12
68,8482192,Isaak Phillips,D,CHI,23,54,4,8,12
68,8476874,Olli Maatta,D,DET,30,60,4,8,12
68,8481605,Jackson LaCombe,D,ANA,23,35,4,8,12
68,8480196,Jacob Bryson,D,BUF,27,41,4,8,12
68,8479944,Zach Aston-Reese,C,VGK,30,50,4,8,12
68,8481019,David Gustafsson,C,WPG,24,53,3,9,12
68,8475690,Chris Tanev,D,TOR,35,59,2,10,12
68,8483460,David Jiricek,D,CBJ,21,57,2,10,12
68,8480990,Declan Chisholm,D,MIN,24,39,2,10,12
68,8480796,Martin Fehervary,D,WSH,25,53,1,11,12
68,8481789,Tye Kartye,L,SEA,23,46,9,2,11
68,8474034,Patrick Maroon,L,CHI,36,49,7,4,11
68,8481518,Nolan Foote,L,NJD,24,40,6,5,11
68,8482807,Ethan Del Mastro,D,CHI,21,52,6,5,11
68,8479359,Beck Malenstyn,L,BUF,26,41,6,5,11
68,8479638,Justin Brazeau,R,BOS,26,40,6,5,11
68,8481013,Jonatan Berggren,R,DET,24,58,5,6,11
68,8477931,Tomas Nosek,L,FLA,32,60,5,6,11
68,8478399,Jonas Siegenthaler,D,NJD,27,55,4,7,11
68,8478452,Caleb Jones,D,LAK,27,45,2,9,11
68,8480222,Sebastian Aho,D,PIT,28,74,2,9,11
68,8480879,Jacob Bernard-Docker,D,OTT,24,43,1,10,11
68,8481701,Santeri Hatakka,D,NJD,23,40,1,10,11
68,8481122,Simon Benoit,D,TOR,26,42,1,10,11
68,8475208,Brian Dumoulin,D,ANA,33,64,0,11,11
68,8482784,Zach Dean,C,STL,21,43,6,4,10
68,8477573,Nathan Walker,L,STL,30,46,6,4,10
68,8476867,Brendan Gaunce,C,MIN,30,31,4,6,10
68,8480880,Jakub Lauko,C,MIN,24,33,4,6,10
68,8475455,Brenden Dillon,D,NJD,34,57,2,8,10
68,8482861,Vincent Iorio,D,WSH,22,34,2,8,10
68,8479378,Logan Stanley,D,WPG,26,55,1,9,10
68,8478874,Adam Gaudette,R,OTT,28,41,0,10,10
68,8481567,Henry Thrun,D,SJS,23,53,0,10,10
68,8473446,Erik Johnson,D,PHI,36,53,0,10,10
68,8475855,Jesper Fast,R,CAR,33,55,7,2,9
68,8477482,Zachary Sanford,L,CHI,30,33,5,4,9
68,8478569,Noel Acciari,C,PIT,33,52,4,5,9
68,8484911,Collin Graf,R,SJS,22,38,4,5,9
68,8482652,Walker Duehr,R,CGY,27,38,4,5,9
68,8480887,Jordan Harris,D,MTL,24,47,3,6,9
68,8481600,Tobias Bjornfot,D,FLA,23,35,3,6,9
68,8480844,Grigori Denisenko,L,VGK,24,38,3,6,9
68,8478146,Matthew Highmore,C,OTT,28,36,3,6,9
68,8481609,Vladislav Kolyachonok,D,UTA,23,40,3,6,9
68,8476967,Brett Kulak,D,EDM,30,59,2,7,9
68,8470600,Ryan Suter,D,STL,39,60,2,7,9
68,8477335,Kyle Burroughs,D,LAK,29,46,2,7,9
68,8481550,Adam Beckman,L,NJD,23,39,2,7,9
68,8481167,Brayden Pachal,D,CGY,25,40,1,8,9
68,8475750,Jon Merrill,D,MIN,32,63,1,8,9
68,8479291,Kevin Rooney,C,CGY,31,51,1,8,9
68,8478017,Mark Friedman,D,VAN,29,37,1,8,9
68,8478468,Jeremy Lauzon,D,NSH,27,47,1,8,9
68,8483549,Lucas Condotta,L,MTL,27,31,4,4,8
68,8474612,Travis Hamonic,D,OTT,34,52,4,4,8
68,8479994,Jaret Anderson-Dolan,C,WPG,25,34,4,4,8
68,8482177,Marat Khusnutdinov,C,MIN,22,37,4,4,8
68,8480157,Calle Rosen,D,COL,30,44,3,5,8
68,8476952,Dominic Toninato,C,WPG,30,27,3,5,8
68,8483466,Kevin Korchinski,D,CHI,20,48,3,5,8
68,8482733,Logan Mailloux,D,MTL,31,39,3,5,8
68,8482145,Mavrik Bourque,C,DAL,22,46,3,5,8
68,8479986,Kole Lind,R,DAL,26,51,3,5,8
68,8482141,Lukas Cormier,D,VGK,22,26,3,5,8
68,8482765,Isak Rosen,R,BUF,21,31,3,5,8
68,8481679,Maxence Guenette,D,OTT,23,28,2,6,8
68,8480058,Pierre-Olivier Joseph,D,STL,25,58,1,7,8
68,8476372,Nick Seeler,D,PHI,31,37,1,7,8
68,8480007,Jonas Rondbjerg,R,VGK,25,40,1,7,8
68,8482070,Mitchell Chaffee,R,TBL,26,55,5,2,7
68,8479536,Axel Jonsson-Fjallby,L,WPG,26,33,4,3,7
68,8481532,Alex Turcotte,C,LAK,23,47,4,3,7
68,8477462,Robert Hagg,D,VGK,29,27,4,3,7
68,8479348,Kale Clague,D,BUF,26,38,3,4,7
68,8480292,Carson Meyer,R,ANA,27,27,3,4,7
68,8479985,Cale Fleury,D,SEA,26,39,3,4,7
68,8484258,Sam Malinski,D,COL,26,29,3,4,7
68,8481161,Jake Christiansen,D,CBJ,25,57,2,5,7
68,8475235,Nicolas Deslauriers,L,PHI,33,47,2,5,7
68,8482666,Scott Morrow,D,CAR,22,48,2,5,7
68,8481598,Philip Broberg,D,EDM,23,41,2,5,7
68,8479372,Joshua Mahura,D,SEA,26,51,1,6,7
68,8474090,Brendan Smith,D,DAL,35,51,1,6,7
68,8474568,Luke Schenn,D,NSH,35,49,1,6,7
68,8474166,Alec Martinez,D,CHI,37,45,1,6,7
68,8479991,Jake Leschyshyn,C,NYR,25,31,1,6,7
68,8477384,Joshua Brown,D,EDM,30,43,1,6,7
68,8482153,Brendan Brisson,C,VGK,23,34,0,7,7
68,8476441,Joel Edmundson,D,LAK,31,44,0,7,7
68,8475762,Derek Forbort,D,VAN,32,45,0,7,7
68,8476858,Phillip Di Giuseppe,L,VAN,31,41,5,1,6
68,8477018,Ben Hutton,D,VGK,31,45,3,3,6
68,8479981,Jonah Gadjovich,L,FLA,26,43,3,3,6
68,8480845,Rasmus Kupari,C,WPG,24,47,3,3,6
68,8480870,Bo Groulx,C,NYR,24,27,3,3,6
68,8479772,Zack MacEwen,R,OTT,28,57,2,4,6
68,8477938,Haydn Fleury,D,WPG,28,35,2,4,6
68,8482859,Zack Ostapchuk,C,OTT,21,49,2,4,6
68,8481056,Spencer Stastney,D,NSH,24,36,2,4,6
68,8474013,Ian Cole,D,UTA,35,53,1,5,6
68,8477034,Jaycob Megna,D,FLA,32,45,1,5,6
68,8477962,Brendan Lemieux,L,CAR,28,34,1,5,6
68,8475177,Calvin de Haan,D,COL,33,45,1,5,6
68,8477887,Patrick Brown,C,BOS,32,42,1,5,6
68,8484254,Akito Hirose,D,VAN,25,37,1,5,6
68,8478477,Mitchell Stephens,C,SEA,27,18,1,5,6
68,8480084,Nick DeSimone,D,NJD,30,27,0,6,6
68,8480851,Akil Thomas,C,LAK,24,16,4,1,5
68,8483012,Logan Morrison,C,SEA,22,30,3,2,5
68,8481147,Reese Johnson,C,MIN,26,38,2,3,5
68,8483619,Filip Roos,D,OTT,25,39,2,3,5
68,8477401,John Hayden,C,SEA,29,19,2,3,5
68,8481743,Marc Del Gaizo,D,NSH,25,19,2,3,5
68,8476913,Devin Shore,C,MIN,30,40,1,4,5
68,8481593,Jayden Struble,D,MTL,23,22,1,4,5
68,8482147,Jean-Luc Foudy,C,COL,22,33,1,4,5
68,8478454,Noah Juulsen,D,VAN,27,35,0,5,5
68,8482511,Mason Lohrei,D,BOS,23,34,3,1,4
68,8481556,John Beecher,C,BOS,23,32,3,1,4
68,8481024,Linus Karlsson,C,VAN,25,9,3,1,4
68,8483630,Pavol Regenda,L,ANA,25,25,2,2,4
68,8475958,Michael Sgarbossa,C,WSH,32,31,2,2,4
68,8483397,Marc McLaughlin,C,BOS,25,34,2,2,4
68,8475413,Justin Dowling,C,NJD,34,20,2,2,4
68,8482165,Yan Kuznetsov,D,CGY,22,21,2,2,4
68,8478409,Anthony Richard,C,PHI,28,26,1,3,4
68,8480834,Ty Emberson,D,SJS,24,28,1,3,4
68,8483763,Maksymilian Szuber,D,UTA,22,28,1,3,4
68,8478450,Parker Wotherspoon,D,BOS,27,31,1,3,4
68,8480245,Olle Lycksell,R,PHI,25,30,1,3,4
68,8479320,Maxime Lajoie,D,SEA,27,23,1,3,4
68,8476473,Connor Murphy,D,CHI,31,34,0,4,4
68,8479587,Rhett Gardner,C,PHI,28,15,0,4,4
68,8482470,Ilya Solovyov,D,CGY,24,16,0,4,4
68,8482929,Emil Lilleberg,D,TBL,23,29,0,4,4
68,8478446,Glenn Gawdin,C,LAK,27,12,0,4,4
68,8482751,Ryan Winterton,C,SEA,21,34,3,0,3
68,8479367,William Lockwood,R,FLA,26,23,3,0,3
68,8482496,Nils Aman,C,VAN,24,41,2,1,3
68,8479379,Givani Smith,R,SJS,26,30,2,1,3
68,8479576,Vincent Desharnais,D,VAN,28,31,2,1,3
68,8483570,Ben Meyers,C,SEA,26,34,2,1,3
68,8481543,Nikita Alexandrov,C,STL,24,26,2,1,3
68,8480890,Jan Jenik,C,OTT,24,26,2,1,3
68,8482250,Callahan Burke,C,VGK,27,17,2,1,3
68,8481578,Graeme Clarke,R,MIN,23,15,2,1,3
68,8478859,Niko Mikkola,D,FLA,28,50,1,2,3
68,8482172,Landon Slaggert,L,CHI,22,23,1,2,3
68,8477244,Chad Ruhwedel,D,NYR,34,35,1,2,3
68,8482201,Gage Goncalves,C,TBL,23,21,1,2,3
68,8482088,Justin Sourdif,R,FLA,22,17,1,2,3
68,8481065,Angus Crookshank,L,OTT,25,19,1,2,3
68,8477149,Scott Sabourin,R,SJS,32,11,1,2,3
68,8482858,Ryker Evans,D,SEA,23,15,0,3,3
68,8477527,Ross Johnston,L,ANA,30,36,0,3,3
68,8482516,Matthew Kessel,D,STL,24,16,0,3,3
68,8484287,Cole McWard,D,VAN,23,23,2,0,2
68,8482102,Vasily Ponomarev,C,PIT,22,22,1,1,2
68,8477971,Andreas Englund,D,LAK,28,27,1,1,2
68,8480267,Sammy Walker,C,MIN,25,21,1,1,2
68,8477467,Gustav Olofsson,D,SEA,30,8,1,1,2
68,8482144,Jack Thompson,D,SJS,22,31,1,1,2
68,8484325,Waltteri Merela,C,TBL,26,19,1,1,2
68,8481719,Maxwell Crozier,D,TBL,24,13,1,1,2
68,8482094,Daemon Hunt,D,MIN,22,10,1,1,2
68,8478021,William Lagesson,D,DET,28,25,1,1,2
68,8481043,Cole Koepke,L,BOS,26,15,1,1,2
68,8482118,Sam Colangelo,R,ANA,23,8,1,1,2
68,8481030,Jack St. Ivany,D,PIT,25,11,1,1,2
68,8479330,Brandon Gignac,C,MTL,27,6,1,1,2
68,8478051,Max Willman,C,NJD,29,23,1,1,2
68,8475780,Chris Wagner,R,COL,33,13,1,1,2
68,8481541,Samuel Bolduc,D,NYI,24,31,0,2,2
68,8478011,Louie Belpedio,D,PHI,28,7,0,2,2
68,8480874,Adam Ginning,D,PHI,24,17,0,2,2
68,8477073,Kurtis MacDermid,L,NJD,30,26,0,2,2
68,8481564,Ryan Johnson,D,BUF,23,14,0,2,2
68,8481206,John Ludvig,D,PIT,24,10,0,2,2
68,8475755,Alexander Petrovic,D,DAL,32,9,0,2,2
68,8483398,Declan Carlile,D,TBL,31,6,0,2,2
68,8481699,Aku Raty,R,UTA,23,16,1,0,1
68,8477320,Anton Blidh,L,NYR,29,23,1,0,1
68,8477810,Joel Hanley,D,CGY,33,17,1,0,1
68,8478881,Brett Seney,L,CHI,28,16,1,0,1
68,8482061,Brandon Biro,L,SEA,26,8,1,0,1
68,8483512,Matthew Savoie,C,EDM,20,21,1,0,1
68,8482162,Roby Jarventie,L,EDM,22,21,1,0,1
68,8481534,Raphael Lavoie,C,EDM,24,4,1,0,1
68,8480032,Shane Bowers,C,NJD,25,17,1,0,1
68,8477851,Jordan Oesterle,D,BOS,32,42,0,1,1
68,8477473,Justin Bailey,R,SJS,29,17,0,1,1
68,8480468,James Hamblin,L,EDM,25,12,0,1,1
68,8480075,Cameron Crotty,D,MIN,25,8,0,1,1
68,8479419,Brett Murray,L,BUF,26,16,0,1,1
68,8483395,Arshdeep Bains,L,VAN,23,17,0,1,1
68,8481585,Egor Afanasyev,L,SJS,23,20,0,1,1
68,8481422,Jake Lucchini,C,NSH,29,21,0,1,1
68,8475795,Dylan McIlrath,D,WSH,32,18,0,1,1
68,8483489,Fraser Minten,C,TOR,31,12,0,1,1
68,8482476,Emil Heineman,L,MTL,23,7,0,1,1
68,8479362,Riley Tufte,L,BOS,26,17,0,1,1
68,8483567,Georgii Merkulov,C,BOS,24,8,0,1,1
68,8482126,Emil Andrae,D,PHI,31,3,0,1,1
68,8484255,Jason Polin,R,COL,25,4,0,1,1
68,8483471,Brad Lambert,C,WPG,31,7,0,1,1
68,8481806,Louis Crevier,D,CHI,23,11,0,1,1
68,8476323,Max McCormick,L,SEA,32,2,0,1,1
68,8483432,Luca Del Bel Belluz,C,CBJ,31,5,0,1,1
68,8481006,Tyler Tucker,D,STL,24,17,0,0,0
68,8478502,Dennis Gilbert,D,BUF,28,23,0,0,0
68,8481237,Kyle MacLean,C,NYI,25,16,0,0,0
68,8478854,Ryan Shea,D,PIT,27,8,0,0,0
68,8480823,Alexander Alexeyev,D,WSH,25,11,0,0,0
68,8474062,Riley Nash,C,NYR,35,13,0,0,0
68,8484304,Uvis Balinskis,D,FLA,28,7,0,0,0
68,8481726,Adam Edstrom,C,NYR,24,12,0,0,0
68,8483407,Brandon Scanlin,D,NYR,25,0,0,0,0
68,8477993,Justin Kirkland,C,CGY,28,5,0,0,0
68,8477541,Dakota Mermis,D,TOR,30,10,0,0,0
68,8484326,Patrik Koch,D,UTA,28,4,0,0,0
68,8482787,Nikita Chibrikov,R,WPG,31,3,0,0,0
68,8483597,Milos Kelemen,L,UTA,25,9,0,0,0
68,8482460,Matt Rempe,C,NYR,22,11,0,0,0
68,8483609,Adam Klapka,R,CGY,24,4,0,0,0
68,8483401,Marc Johnstone,R,PIT,28,1,0,0,0
68,8478147,Bokondji Imama,L,PIT,28,6,0,0,0
68,8481462,Mason Morelli,L,VGK,28,9,0,0,0
68,8483920,Pierrick Dube,R,WSH,23,0,0,0,0
68,8483546,Marshall Rifai,D,TOR,26,3,0,0,0
68,8482197,Adam Raska,R,MIN,23,7,0,0,0
68,8481655,Cole Schwindt,R,CGY,23,3,0,0,0
68,8480306,Grant Hutton,D,NYI,29,6,0,0,0
68,8483531,Brian Halonen,L,NJD,25,1,0,0,0
68,8479421,Jacob Moverare,D,LAK,26,6,0,0,0
68,8484259,Ondrej Pavel,C,COL,31,3,0,0,0
68,8479522,Hardy Haman Aktell,D,WSH,26,3,0,0,0
68,8484321,Nikolas Matinpalo,D,OTT,26,1,0,0,0
68,8480274,Philip Kemp,D,EDM,25,0,0,0,0
68,8470794,Joe Pavelski,C,,40,0,0,0,0
68,8479321,Lucas Johansen,D,,27,0,0,0,0
68,8477950,Tony DeAngelo,D,,29,0,0,0,0
68,8471218,Blake Wheeler,R,,38,0,0,0,0
68,8475197,Tyson Barrie,D,,33,0,0,0,0
68,8474157,Max Pacioretty,L,,36,0,0,0,0
68,8475744,Evgeny Kuznetsov,C,,32,0,0,0,0
68,8474037,James van Riemsdyk,L,,35,0,0,0,0
68,8476907,Mackenzie MacEachern,L,,30,0,0,0,0
68,8480216,Jacob Peterson,C,,25,0,0,0,0
68,8474602,Justin Schultz,D,,34,0,0,0,0
68,8482222,Alexander Barabanov,L,,30,0,0,0,0
68,8474031,Kevin Shattenkirk,D,,35,0,0,0,0
68,8477330,Dominik Kubalik,L,,29,0,0,0,0
68,8480884,Calen Addison,D,,24,0,0,0,0
68,8475906,John Klingberg,D,,32,0,0,0,0
68,8480008,Adam Ruzicka,C,,25,0,0,0,0
68,8476884,Derrick Pouliot,D,,30,0,0,0,0
68,8476919,Chris Tierney,C,,30,0,0,0,0
68,8479415,Michael McLeod,C,,26,0,0,0,0
68,8474870,Tyler Johnson,C,,34,0,0,0,0
68,8470604,Jeff Carter,C,,39,0,0,0,0
68,8478104,Sammy Blais,L,,28,0,0,0,0
68,8474884,Mike Hoffman,C,,35,0,0,0,0
68,8481591,Sam Poulin,R,,23,0,0,0,0
68,8471274,Alex Goligoski,D,,39,0,0,0,0
68,8476871,Tanner Pearson,L,,32,0,0,0,0
68,8476393,Nick Cousins,C,,31,0,0,0,0
68,8479977,Kailer Yamamoto,R,,26,0,0,0,0
68,8479346,Dillon Dube,C,,26,0,0,0,0
68,8480184,Gustav Lindstrom,D,,26,0,0,0,0
68,8479376,Victor Mete,D,,26,0,0,0,0
68,8473449,Kyle Okposo,R,,36,0,0,0,0
68,8481058,Jesse Ylonen,R,,25,0,0,0,0
68,8475752,Tyler Pitlick,C,,33,0,0,0,0
68,8481239,Samuel Fagemo,L,,24,0,0,0,0
68,8480821,Filip Zadina,R,,25,0,0,0,0
68,8470966,Mark Giordano,D,,41,0,0,0,0
68,8478495,Denis Gurianov,R,,27,0,0,0,0
68,8477464,Nic Petan,C,,29,0,0,0,0
68,8478099,Kevin Labanc,R,,29,0,0,0,0
68,8482241,Radim Zohorna,L,,28,0,0,0,0
68,8474040,Sam Gagner,C,,35,0,0,0,0
68,8479514,Rem Pitlick,C,,27,0,0,0,0
68,8478430,Oliver Kylington,D,,27,0,0,0,0
68,8479533,Joona Koppanen,L,,26,0,0,0,0
68,8479984,Cal Foote,D,,26,0,0,0,0
68,8477126,Jayson Megna,C,,34,0,0,0,0
68,8475164,Jakob Silfverberg,R,,34,0,0,0,0
68,8474009,Nick Bonino,C,,36,0,0,0,0
68,8479458,Nikita Zaitsev,D,,33,0,0,0,0
68,8477944,Jakub Vrana,L,,28,0,0,0,0
68,8471699,Andrew Cogliano,C,,37,0,0,0,0
68,8478067,Oskar Lindblom,L,,28,0,0,0,0
68,8471686,Marc Staal,D,,37,0,0,0,0
68,8470610,Zach Parise,L,,40,0,0,0,0
68,8478904,Steven Lorentz,C,,28,0,0,0,0
68,8473473,Milan Lucic,L,,36,0,0,0,0
68,8480031,Maxime Comtois,L,,25,0,0,0,0
68,8478512,Austin Czarnik,C,,32,0,0,0,0
68,8473504,Cal Clutterbuck,R,,37,0,0,0,0
68,8477454,Adam Erne,L,,29,0,0,0,0
68,8479383,Boris Katchouk,L,,26,0,0,0,0
68,8475825,Jani Hakanpää,D,,32,0,0,0,0
68,8477846,Ryan Carpenter,C,,33,0,0,0,0
68,8477930,Pierre-Edouard Bellemare,L,,39,0,0,0,0
68,8478400,Colin White,C,,27,0,0,0,0
68,8480226,Marián Studenic,R,,26,0,0,0,0
68,8480853,Liam Foudy,C,,24,0,0,0,0
68,8475797,Jarred Tinordi,D,,32,0,0,0,0
68,8479423,Alex Nylander,L,,26,0,0,0,0
68,8474618,Marco Scandella,D,,34,0,0,0,0
68,8478028,Fredrik Olofsson,L,,28,0,0,0,0
68,8474709,Matt Martin,L,,35,0,0,0,0
68,8481070,Hugh McGing,L,,26,0,0,0,0
68,8479546,Oskar Steen,C,,26,0,0,0,0
68,8474145,Robert Bortuzzo,D,,35,0,0,0,0
68,8476915,Jujhar Khaira,L,,30,0,0,0,0
68,8475278,Byron Froese,C,,33,0,0,0,0
68,8481812,Nikolai Knyzhov,D,,27,0,0,0,0
68,8478408,Travis Dermott,D,,28,0,0,0,0
68,8481077,John Leonard,L,,26,0,0,0,0
68,8479547,Matthew Phillips,R,,26,0,0,0,0
68,8480836,Jonathan Gruden,C,,24,0,0,0,0
68,8481690,Tyler Angle,C,,24,0,0,0,0
68,8475766,Austin Watson,L,,32,0,0,0,0
68,8481016,Ruslan Iskhakov,C,,24,0,0,0,0
68,8478078,Rourke Chartier,C,,28,0,0,0,0
68,8480776,Sheldon Rempal,R,,29,0,0,0,0
68,8478956,Samuel Laberge,L,NJD,27,0,0,0,0
68,8483045,Cameron Butler,R,CBJ,31,0,0,0,0
68,8484314,Jiri Smejkal,L,,28,0,0,0,0
69,8476453,Nikita Kucherov,R,TBL,31,82,44,89,133
69,8477492,Nathan MacKinnon,C,COL,29,81,50,81,131
69,8481559,Jack Hughes,C,NJD,23,73,39,84,123
69,8479318,Auston Matthews,C,TOR,27,79,72,47,119
69,8477934,Leon Draisaitl,C,EDM,29,77,45,74,119
69,8478402,Connor McDavid,C,EDM,27,78,35,80,115
69,8476887,Filip Forsberg,L,NSH,30,76,40,71,111
69,8471675,Sidney Crosby,C,PIT,37,73,55,55,110
69,8478420,Mikko Rantanen,R,COL,28,81,48,56,104
69,8478483,Mitch Marner,R,TOR,27,81,36,67,103
69,8479314,Matthew Tkachuk,L,FLA,27,80,31,72,103
69,8482116,Tim Stützle,C,OTT,22,81,35,66,101
69,8478550,Artemi Panarin,L,NYR,33,78,32,69,101
69,8477956,David Pastrnak,R,BOS,28,79,47,52,99
69,8480002,Nico Hischier,C,NJD,25,75,39,60,99
69,8478403,Jack Eichel,C,VGK,28,76,42,53,95
69,8476459,Mika Zibanejad,C,NYR,31,77,41,53,94
69,8477493,Aleksander Barkov,C,FLA,29,78,33,61,94
69,8473419,Brad Marchand,L,BOS,36,81,39,54,93
69,8475172,Nazem Kadri,C,CGY,34,79,29,63,92
69,8478864,Kirill Kaprizov,L,MIN,27,72,40,51,91
69,8477933,Sam Reinhart,C,FLA,29,80,42,47,89
69,8479343,Clayton Keller,R,UTA,26,77,34,54,88
69,8480830,Andrei Svechnikov,R,CAR,24,75,38,49,87
69,8479407,Jesper Bratt,L,NJD,26,76,26,61,87
69,8477939,William Nylander,R,TOR,28,80,40,45,85
69,8476460,Mark Scheifele,C,WPG,31,74,39,45,84
69,8477404,Jake Guentzel,C,TBL,30,82,33,51,84
69,8474600,Roman Josi,D,NSH,34,74,28,56,84
69,8476539,Jonathan Marchessault,R,NSH,34,77,40,42,82
69,8480027,Jason Robertson,L,DAL,25,82,31,51,82
69,8476468,J.T. Miller,C,VAN,31,73,26,56,82
69,8477946,Dylan Larkin,C,DET,28,80,45,36,81
69,8481557,Matt Boldy,L,MIN,23,73,41,40,81
69,8484144,Connor Bedard,C,CHI,19,70,25,56,81
69,8478445,Mathew Barzal,C,NYI,27,81,16,64,80
69,8478398,Kyle Connor,L,WPG,28,74,43,36,79
69,8480801,Brady Tkachuk,L,OTT,25,82,41,38,79
69,8474564,Steven Stamkos,C,NSH,34,71,34,45,79
69,8480069,Cale Makar,D,COL,26,71,24,55,79
69,8477409,Carter Verhaeghe,C,FLA,29,79,35,43,78
69,8475913,Mark Stone,R,VGK,32,76,31,47,78
69,8471214,Alex Ovechkin,L,WSH,39,70,39,38,77
69,8475166,John Tavares,C,TOR,34,80,36,41,77
69,8476881,Tomas Hertl,C,VGK,31,70,31,46,77
69,8477949,Alex Tuch,R,BUF,28,76,34,42,76
69,8474141,Patrick Kane,R,DET,36,81,29,47,76
69,8477942,Kevin Fiala,L,LAK,28,79,27,49,76
69,8480023,Robert Thomas,C,STL,25,73,25,51,76
69,8476456,Jonathan Huberdeau,C,CGY,31,74,18,58,76
69,8479675,Trevor Moore,L,LAK,29,82,35,40,75
69,8481540,Cole Caufield,R,MTL,23,76,37,37,74
69,8477501,Valeri Nichushkin,R,COL,29,80,31,43,74
69,8478439,Travis Konecny,R,PHI,27,75,27,47,74
69,8478440,Dylan Strome,C,WSH,27,72,27,47,74
69,8478407,Vince Dunn,D,SEA,28,78,14,60,74
69,8475184,Chris Kreider,L,NYR,33,72,39,34,73
69,8471215,Evgeni Malkin,C,PIT,38,74,32,41,73
69,8480012,Elias Pettersson,C,VAN,26,75,28,45,73
69,8477402,Pavel Buchnevich,L,STL,29,77,28,45,73
69,8477955,Jared McCann,L,SEA,28,76,35,37,72
69,8478460,Zach Werenski,D,CBJ,27,77,13,59,72
69,8475170,Brayden Schenn,C,STL,33,78,26,45,71
69,8479325,Charlie McAvoy,D,BOS,27,77,18,53,71
69,8479323,Adam Fox,D,NYR,26,74,15,56,71
69,8480018,Nick Suzuki,C,MTL,25,73,24,46,70
69,8476454,Ryan Nugent-Hopkins,C,EDM,31,77,22,48,70
69,8478873,Troy Terry,R,ANA,27,73,25,44,69
69,8478414,Timo Meier,R,NJD,28,73,24,45,69
69,8471685,Anze Kopitar,C,LAK,37,78,22,47,69
69,8476389,Vincent Trocheck,C,NYR,31,80,20,49,69
69,8479420,Tage Thompson,C,BUF,27,71,35,33,68
69,8477960,Adrian Kempe,R,LAK,28,77,27,41,68
69,8478493,Joel Eriksson Ek,C,MIN,27,72,31,36,67
69,8477416,Oliver Bjorkstrand,R,SEA,29,77,27,40,67
69,8475167,Victor Hedman,D,TBL,34,78,11,56,67
69,8475754,Brock Nelson,C,NYI,33,81,37,29,66
69,8480015,Owen Tippett,R,PHI,25,77,34,32,66
69,8475784,Jeff Skinner,C,EDM,32,75,32,33,65
69,8478427,Sebastian Aho,C,CAR,27,62,31,34,65
69,8477500,Bo Horvat,C,NYI,29,80,30,35,65
69,8479385,Jordan Kyrou,C,STL,26,71,29,36,65
69,8475168,Matt Duchene,C,DAL,33,81,29,36,65
69,8482699,Dylan Guenther,R,UTA,21,75,29,36,65
69,8477504,Josh Morrissey,D,WPG,29,73,13,52,65
69,8479542,Brandon Hagel,L,TBL,26,82,29,35,64
69,8478010,Brayden Point,C,TBL,28,82,26,38,64
69,8478462,Nicolas Roy,C,VGK,27,75,23,41,64
69,8475726,Tyler Toffoli,C,SJS,32,68,34,29,63
69,8477511,Anthony Mantha,R,CGY,30,76,30,33,63
69,8480208,Drake Batherson,R,OTT,26,78,26,37,63
69,8475798,Mikael Granlund,C,SJS,32,69,13,50,63
69,8475692,Mats Zuccarello,R,MIN,37,71,12,51,63
69,8480839,Rasmus Dahlin,D,BUF,24,69,12,51,63
69,8476448,William Karlsson,C,VGK,31,75,29,33,62
69,8481596,Shane Pinto,C,OTT,24,78,29,33,62
69,8483431,Logan Cooley,C,UTA,20,75,27,35,62
69,8480036,Miro Heiskanen,D,DAL,25,78,9,53,62
69,8475794,Tyler Seguin,C,DAL,32,79,27,34,61
69,8475786,Zach Hyman,L,EDM,32,80,26,35,61
69,8476905,Chandler Stephenson,C,SEA,30,70,20,41,61
69,8473994,Jamie Benn,L,DAL,35,82,17,44,61
69,8476346,Johnny Gaudreau,L,CBJ,31,70,16,45,61
69,8482740,Wyatt Johnston,C,DAL,21,81,32,28,60
69,8477940,Nikolaj Ehlers,L,WPG,28,68,30,30,60
69,8474586,Jordan Eberle,R,SEA,34,69,26,34,60
69,8477951,Nick Schmaltz,C,UTA,28,79,20,40,60
69,8480865,Noah Dobson,D,NYI,24,77,12,48,60
69,8478444,Brock Boeser,R,VAN,27,75,31,28,59
69,8482110,Dawson Mercer,C,NJD,23,75,28,31,59
69,8478449,Roope Hintz,C,DAL,28,80,24,35,59
69,8475745,Charlie Coyle,C,BOS,32,79,21,38,59
69,8477496,Elias Lindholm,C,BOS,30,78,20,39,59
69,8480803,Evan Bouchard,D,EDM,25,72,12,47,59
69,8475810,Bryan Rust,R,PIT,32,74,23,35,58
69,8483808,Andrei Kuzmenko,L,CGY,28,77,23,35,58
69,8482665,Matty Beniers,C,SEA,22,72,21,37,58
69,8477346,MacKenzie Weegar,D,CGY,30,71,15,43,58
69,8477476,Artturi Lehkonen,L,COL,29,81,29,28,57
69,8482124,Quinton Byfield,R,LAK,22,78,20,37,57
69,8482684,Luke Hughes,D,NJD,21,75,13,44,57
69,8480800,Quinn Hughes,D,VAN,25,69,2,55,57
69,8476432,Boone Jenner,C,CBJ,31,67,35,21,56
69,8481068,Yegor Sharangovich,C,CGY,26,78,28,28,56
69,8481533,Trevor Zegras,C,ANA,23,71,23,33,56
69,8476479,Phillip Danault,C,LAK,31,81,21,35,56
69,8473512,Claude Giroux,R,OTT,36,79,20,36,56
69,8475765,Vladimir Tarasenko,R,DET,33,78,17,39,56
69,8482720,Matthew Knies,L,TOR,22,78,15,41,56
69,8474578,Erik Karlsson,D,PIT,34,80,14,42,56
69,8477407,Anthony Duclair,L,NYI,29,77,25,30,55
69,8477456,J.T. Compher,L,DET,29,80,25,30,55
69,8482078,Lucas Raymond,L,DET,22,80,21,34,55
69,8481528,Dylan Cozens,C,BUF,23,70,18,37,55
69,8482745,Mason McTavish,C,ANA,21,69,17,38,55
69,8474150,Mikael Backlund,C,CGY,35,80,14,41,55
69,8482109,Alexis Lafrenière,L,NYR,23,76,30,24,54
69,8480028,Morgan Frost,C,PHI,25,78,14,40,54
69,8479425,Filip Hronek,D,VAN,27,74,11,43,54
69,8479337,Alex DeBrincat,R,DET,27,81,27,26,53
69,8482093,Seth Jarvis,C,CAR,22,71,23,30,53
69,8476875,Mike Matheson,D,MTL,30,74,12,41,53
69,8478047,Michael Bunting,L,PIT,29,71,27,25,52
69,8479400,Pierre-Luc Dubois,L,WSH,26,67,23,29,52
69,8482113,Anton Lundell,C,FLA,23,77,21,31,52
69,8484153,Leo Carlsson,C,ANA,20,73,18,34,52
69,8478401,Pavel Zacha,C,BOS,27,79,17,35,52
69,8477503,Max Domi,C,TOR,29,76,14,38,52
69,8477447,Shea Theodore,D,VGK,29,60,13,39,52
69,8477986,Brandon Montour,D,SEA,30,76,12,40,52
69,8475158,Ryan O'Reilly,C,NSH,33,76,28,23,51
69,8480797,Joel Farabee,L,PHI,24,73,21,30,51
69,8477935,Sam Bennett,C,FLA,28,77,17,34,51
69,8477426,Nicholas Paul,L,TBL,29,82,25,25,50
69,8474641,Adam Henrique,C,EDM,34,74,21,29,50
69,8475793,Ryan Johansen,C,PHI,32,76,21,29,50
69,8474102,David Perron,L,OTT,36,79,17,33,50
69,8481711,Matias Maccelli,L,UTA,24,77,11,39,50
69,8476399,Blake Coleman,C,CGY,33,80,28,21,49
69,8477451,Ryan Hartman,R,MIN,30,67,19,30,49
69,8478856,Conor Garland,R,VAN,28,75,18,31,49
69,8478038,Devon Toews,D,COL,30,71,14,35,49
69,8476906,Shayne Gostisbehere,D,CAR,31,78,13,36,49
69,8476853,Morgan Rielly,D,TOR,30,73,5,44,49
69,8484166,Adam Fantilli,C,CBJ,20,71,23,25,48
69,8478519,Anthony Cirelli,C,TBL,27,82,22,26,48
69,8473986,Alex Killorn,L,ANA,35,76,19,29,48
69,8481604,Pavel Dorofeyev,L,VGK,24,72,17,31,48
69,8474565,Alex Pietrangelo,D,VGK,34,65,15,33,48
69,8476882,Teuvo Teravainen,C,CHI,30,71,23,24,47
69,8476826,Yanni Gourde,C,SEA,33,72,20,27,47
69,8479999,Casey Mittelstadt,C,COL,26,79,19,28,47
69,8477964,Ivan Barbashev,C,VGK,29,73,19,28,47
69,8479339,Patrik Laine,L,CBJ,26,67,17,30,47
69,8474590,John Carlson,D,WSH,34,72,15,32,47
69,8478438,Tommy Novak,C,NSH,27,69,12,35,47
69,8471724,Kris Letang,D,PIT,37,82,9,38,47
69,8475169,Evander Kane,L,EDM,33,76,27,19,46
69,8478474,Lawson Crouse,L,UTA,27,74,24,22,46
69,8480039,Martin Necas,C,CAR,25,72,23,23,46
69,8478498,Jake DeBrusk,L,VAN,28,73,18,28,46
69,8470613,Brent Burns,D,CAR,39,77,9,37,46
69,8481542,Moritz Seider,D,DET,23,77,3,43,46
69,8478466,Daniel Sprong,R,VAN,27,72,25,20,45
69,8475191,Reilly Smith,R,NYR,33,71,22,23,45
69,8482159,Tyson Foerster,R,PHI,22,66,21,24,45
69,8478042,Viktor Arvidsson,L,EDM,31,70,19,26,45
69,8479345,Jakob Chychrun,D,WSH,26,63,12,33,45
69,8478542,Evan Rodrigues,C,FLA,31,79,19,25,44
69,8481577,Philip Tomasino,C,NSH,23,66,16,28,44
69,8478975,Mason Marchment,L,DAL,29,80,13,31,44
69,8474563,Drew Doughty,D,LAK,35,71,12,32,44
69,8477932,Aaron Ekblad,D,FLA,28,68,11,33,44
69,8478469,Thomas Chabot,D,OTT,27,74,10,34,44
69,8478397,Rasmus Andersson,D,CGY,28,70,7,37,44
69,8477444,Andre Burakovsky,L,SEA,29,70,21,22,43
69,8475768,Jaden Schwartz,C,SEA,32,70,20,23,43
69,8476483,Rickard Rakell,R,PIT,31,71,20,23,43
69,8475287,Erik Haula,L,NJD,33,71,17,26,43
69,8478115,Pierre Engvall,L,NYI,28,79,15,28,43
69,8478458,John (Jack) Roslovic,C,CAR,27,71,14,29,43
69,8478472,Mathieu Joseph,R,STL,27,72,14,29,43
69,8476462,Dougie Hamilton,D,NJD,31,71,13,30,43
69,8477998,Warren Foegele,L,LAK,28,77,19,23,42
69,8479987,Morgan Geekie,C,BOS,26,74,19,23,42
69,8477497,Sean Monahan,C,CBJ,30,65,19,23,42
69,8479992,Michael Rasmussen,C,DET,25,81,16,26,42
69,8477498,Darnell Nurse,D,EDM,29,75,13,29,42
69,8482175,JJ Peterka,R,BUF,22,74,27,14,41
69,8471698,T.J. Oshie,R,WSH,38,67,20,21,41
69,8480849,Barrett Hayton,C,UTA,24,67,15,26,41
69,8482122,Brock Faber,D,MIN,22,79,11,30,41
69,8480145,Neal Pionk,D,WPG,29,72,11,30,41
69,8479410,Mikhail Sergachev,D,UTA,26,74,10,31,41
69,8475760,Nick Bjugstad,C,UTA,32,74,21,19,40
69,8478366,Frank Vatrano,R,ANA,30,73,20,20,40
69,8475799,Nino Niederreiter,R,WPG,32,72,20,20,40
69,8476880,Tom Wilson,R,WSH,30,62,19,21,40
69,8481560,Arthur Kaliyev,R,LAK,23,80,18,22,40
69,8475848,Brendan Gallagher,R,MTL,32,71,15,25,40
69,8478055,Gustav Forsling,D,FLA,28,70,15,25,40
69,8483515,Juraj Slafkovsky,L,MTL,20,70,14,26,40
69,8475218,Mattias Ekholm,D,EDM,34,76,13,27,40
69,8483490,Pavel Mintyukov,D,ANA,21,71,13,27,40
69,8477021,Alex Kerfoot,C,UTA,30,72,10,30,40
69,8479525,Ross Colton,C,COL,28,80,16,23,39
69,8481524,Bowen Byram,D,BUF,23,61,16,23,39
69,8479316,Luke Kunin,C,SJS,27,58,15,24,39
69,8474679,Gustav Nyquist,C,NSH,35,70,13,26,39
69,8476474,Stefan Noesen,R,NJD,31,64,13,26,39
69,8476979,Erik Gustafsson,D,DET,32,75,9,30,39
69,8476958,Jaccob Slavin,D,CAR,30,78,5,34,39
69,8475314,Anders Lee,L,NYI,34,79,25,13,38
69,8480014,Gabriel Vilardi,C,WPG,25,69,23,15,38
69,8482055,Drew O'Connor,L,PIT,26,66,22,16,38
69,8477952,Robby Fabbri,C,ANA,28,63,21,17,38
69,8480185,Eetu Luostarinen,C,FLA,26,71,19,19,38
69,8480009,Eeli Tolvanen,R,SEA,25,62,17,21,38
69,8475714,Calle Jarnkrok,C,TOR,33,72,15,23,38
69,8482667,William Eklund,L,SJS,22,66,13,25,38
69,8482702,Logan Stankoven,C,DAL,21,80,12,26,38
69,8480798,Philipp Kurashev,C,CHI,25,67,12,26,38
69,8476458,Ryan Strome,C,ANA,31,72,12,26,38
69,8476923,Damon Severson,D,CBJ,30,78,9,29,38
69,8475764,Cam Fowler,D,ANA,33,78,4,34,38
69,8481618,Alex Newhook,C,MTL,23,68,18,19,37
69,8477479,Tyler Bertuzzi,L,CHI,29,69,15,22,37
69,8480113,Alex Iafallo,L,WPG,31,70,15,22,37
69,8483505,Matthew Poitras,C,BOS,20,70,15,22,37
69,8477429,Andrew Copp,C,DET,30,78,14,23,37
69,8482092,Ridly Greig,C,OTT,22,78,13,24,37
69,8481581,Thomas Harley,D,DAL,23,70,10,27,37
69,8478396,Noah Hanifin,D,VGK,27,61,10,27,37
69,8480817,K'Andre Miller,D,NYR,24,70,10,27,37
69,8482105,Jake Sanderson,D,OTT,22,74,9,28,37
69,8481703,Valtteri Puustinen,R,PIT,25,61,7,30,37
69,8476438,Brandon Saad,L,STL,32,60,19,17,36
69,8476480,Vladislav Namestnikov,C,WPG,32,63,18,18,36
69,8480064,Josh Norris,C,OTT,25,80,17,19,36
69,8482097,Jack Quinn,R,BUF,23,59,12,24,36
69,8482660,Kent Johnson,C,CBJ,22,65,12,24,36
69,8476927,Teddy Blueger,C,VAN,30,69,7,29,36
69,8480043,Timothy Liljegren,D,TOR,25,69,4,32,36
69,8480188,Fabian Zetterlund,L,SJS,25,69,17,18,35
69,8482101,Danil Gushchin,L,SJS,22,63,17,18,35
69,8482624,Daniil Miromanov,D,CGY,27,67,16,19,35
69,8479365,Trent Frederic,C,BOS,26,77,14,21,35
69,8473422,Nick Foligno,L,CHI,37,55,14,21,35
69,8478463,Anthony Beauvillier,L,PIT,27,66,14,21,35
69,8481186,Logan O'Connor,R,COL,28,80,13,22,35
69,8481553,Bobby Brink,R,PHI,23,67,13,22,35
69,8475753,Justin Faulk,D,STL,32,76,12,23,35
69,8480802,Ryan McLeod,C,BUF,25,69,12,23,35
69,8475149,Marcus Johansson,L,MIN,34,65,11,24,35
69,8474149,Evgenii Dadonov,R,DAL,35,80,20,14,34
69,8478432,Christian Fischer,R,DET,27,75,20,14,34
69,8475151,Kyle Palmieri,C,NYI,33,79,18,16,34
69,8475722,Jason Zucker,L,BUF,32,67,18,16,34
69,8482146,Luke Evangelista,R,NSH,22,68,16,18,34
69,8478046,Danton Heinen,L,VAN,29,71,15,19,34
69,8481624,Ilya Mikheyev,R,CHI,30,61,14,20,34
69,8476925,Colton Sissons,C,NSH,31,67,11,23,34
69,8481523,Kirby Dach,C,MTL,23,70,9,25,34
69,8481546,Cam York,D,PHI,23,69,4,30,34
69,8479941,Justin Danforth,R,CBJ,31,60,17,16,33
69,8478020,Michael Amadio,R,OTT,28,69,15,18,33
69,8480003,Jesper Boqvist,C,FLA,26,70,14,19,33
69,8482074,Connor Zary,C,CGY,23,69,14,19,33
69,8480871,Adam Boqvist,D,FLA,24,70,13,20,33
69,8477494,Jonathan Drouin,L,COL,29,81,11,22,33
69,8477987,Ryan Donato,C,CHI,28,60,9,24,33
69,8476854,Hampus Lindholm,D,BOS,30,71,8,25,33
69,8480434,Sean Durzi,D,UTA,26,68,8,25,33
69,8476792,Torey Krug,D,STL,33,73,6,27,33
69,8477495,Seth Jones,D,CHI,30,72,4,29,33
69,8476869,Brady Skjei,D,NSH,30,75,4,29,33
69,8482149,Cole Perfetti,C,WPG,22,68,14,18,32
69,8476872,Scott Laughton,C,PHI,30,73,14,18,32
69,8479996,Cody Glass,C,NSH,25,62,14,18,32
69,8470621,Corey Perry,R,EDM,39,70,14,18,32
69,8481656,Aliaksei Protas,C,WSH,23,70,9,23,32
69,8476419,Jean-Gabriel Pageau,C,NYI,32,76,6,26,32
69,8476331,Dylan DeMelo,D,WPG,31,71,4,28,32
69,8480049,Dylan Samberg,D,WPG,25,70,3,29,32
69,8476981,Josh Anderson,R,MTL,30,68,17,14,31
69,8482705,Cole Sillinger,C,CBJ,21,70,16,15,31
69,8474053,Logan Couture,C,SJS,35,62,16,15,31
69,8482475,Yegor Chinakhov,R,CBJ,23,65,14,17,31
69,8480748,Kiefer Sherwood,L,VAN,29,61,14,17,31
69,8481481,Blake Lizotte,C,PIT,27,62,12,19,31
69,8480835,Jack Drury,C,CAR,24,56,11,20,31
69,8477505,Alexander Wennberg,C,SJS,30,65,11,20,31
69,8478840,Will Borgen,D,SEA,28,69,9,22,31
69,8482671,Owen Power,D,BUF,22,75,7,24,31
69,8480878,Nils Lundkvist,D,DAL,24,75,7,24,31
69,8478507,John Marino,D,UTA,27,69,2,29,31
69,8481580,Connor McMichael,C,WSH,23,69,16,14,30
69,8484145,Zach Benson,L,BUF,19,56,14,16,30
69,8474189,Lars Eller,C,PIT,35,57,14,16,30
69,8480829,Jesperi Kotkaniemi,C,CAR,24,69,11,19,30
69,8483524,Shane Wright,C,SEA,20,66,11,19,30
69,8480806,Isac Lundestrom,C,ANA,25,66,11,19,30
69,8482089,Jake Neighbours,L,STL,22,70,17,12,29
69,8480459,Pius Suter,C,VAN,28,69,15,14,29
69,8475763,Kevin Hayes,R,PIT,32,70,11,18,29
69,8478891,Mason Appleton,C,WPG,28,62,10,19,29
69,8474716,Jared Spurgeon,D,MIN,35,76,9,20,29
69,8478233,Andrew Mangiapane,L,WSH,28,64,7,22,29
69,8480873,Rasmus Sandin,D,WSH,24,63,2,27,29
69,8483493,Frank Nazar,C,CHI,20,61,18,10,28
69,8479393,Noah Gregor,L,OTT,26,72,16,12,28
69,8478057,Dakota Joshua,C,VAN,28,67,16,12,28
69,8481554,Kaapo Kakko,R,NYR,23,71,15,13,28
69,8476461,Sean Couturier,C,PHI,32,66,15,13,28
69,8479661,Tanner Jeannot,L,LAK,27,80,15,13,28
69,8479591,Michael Eyssimont,C,TBL,28,81,14,14,28
69,8481535,Nils Hoglander,L,VAN,24,64,14,14,28
69,8476921,Jordan Martinook,L,CAR,32,65,12,16,28
69,8478013,Jake Walman,D,SJS,28,73,11,17,28
69,8477989,Christian Dvorak,C,MTL,28,67,9,19,28
69,8476885,Jacob Trouba,D,NYR,30,71,7,21,28
69,8482133,Thomas Bordeleau,C,SJS,22,61,6,22,28
69,8477488,Brett Pesce,D,NJD,30,72,6,22,28
69,8477506,Ryan Pulock,D,NYI,30,77,5,23,28
69,8477969,Marcus Pettersson,D,PIT,28,80,3,25,28
69,8475193,Tomas Tatar,L,NJD,34,66,18,9,27
69,8478109,Victor Olofsson,L,VGK,29,69,16,11,27
69,8482712,Oskar Olausson,R,COL,22,82,11,16,27
69,8479293,Brandon Tanev,L,SEA,33,66,10,17,27
69,8481606,Jordan Spence,D,LAK,23,71,9,18,27
69,8476988,Matt Benning,D,SJS,30,69,6,21,27
69,8479983,Mario Ferraro,D,SJS,26,73,5,22,27
69,8477220,Nate Schmidt,D,FLA,33,65,5,22,27
69,8479402,Jake Bean,D,CGY,26,64,5,22,27
69,8478851,Alexandre Carrier,D,NSH,28,75,3,24,27
69,8473533,Jordan Staal,C,CAR,36,69,15,11,26
69,8480068,Ryan Poehling,C,PHI,25,68,14,12,26
69,8480078,Filip Chytil,C,NYR,25,68,13,13,26
69,8476292,Ondrej Palat,L,NJD,33,67,11,15,26
69,8476392,Adam Lowry,C,WPG,31,65,11,15,26
69,8479351,Sam Steel,C,DAL,26,82,11,15,26
69,8480855,Jack McBain,C,UTA,24,72,11,15,26
69,8473563,Nicklas Backstrom,C,WSH,37,55,8,18,26
69,8475220,Marcus Foligno,L,MIN,33,65,7,19,26
69,8482067,Connor Mackey,D,NYR,28,66,7,19,26
69,8474151,Ryan McDonagh,D,TBL,35,80,5,21,26
69,8478911,Matt Roy,D,WSH,29,63,2,24,26
69,8482117,Lukas Reichel,L,CHI,22,60,15,10,25
69,8476278,Colin Blackwell,C,DAL,31,79,13,12,25
69,8476624,Barclay Goodrow,C,SJS,31,49,12,13,25
69,8477947,Sonny Milano,L,WSH,28,61,11,14,25
69,8482125,Alexander Holtz,R,VGK,22,70,11,14,25
69,8478043,Sam Lafferty,C,BUF,29,60,11,14,25
69,8483491,Ivan Miroshnichenko,L,WSH,20,60,11,14,25
69,8477015,Connor Brown,R,EDM,30,69,10,15,25
69,8484203,Bradly Nadeau,L,CAR,19,63,8,17,25
69,8475171,Oliver Ekman-Larsson,D,TOR,33,65,7,18,25
69,8475200,Dmitry Orlov,D,CAR,33,68,6,19,25
69,8476457,Adam Larsson,D,SEA,32,63,6,19,25
69,8476917,Adam Pelech,D,NYI,30,79,5,20,25
69,8479639,Dylan Coghlan,D,WPG,26,67,5,20,25
69,8475690,Chris Tanev,D,TOR,35,52,5,20,25
69,8481441,Joe Snively,C,DET,28,68,3,22,25
69,8482245,Artem Zub,D,OTT,29,70,3,22,25
69,8480893,Kirill Marchenko,R,CBJ,24,60,16,8,24
69,8476878,Zemgus Girgensons,C,TBL,30,79,14,10,24
69,8479368,Max Jones,L,BOS,26,64,13,11,24
69,8482155,Alex Laferriere,R,LAK,23,64,12,12,24
69,8477839,Conor Sheary,L,TBL,32,81,11,13,24
69,8482079,Marco Rossi,C,MIN,23,60,10,14,24
69,8482749,Joshua Roy,R,MTL,21,69,10,14,24
69,8477353,Tyler Motte,C,DET,29,71,9,15,24
69,8476918,Jimmy Vesey,L,NYR,31,67,8,16,24
69,8482111,Justin Barron,D,MTL,23,63,8,16,24
69,8476525,Colin Miller,D,WPG,32,63,7,17,24
69,8475181,Nick Leddy,D,STL,33,71,5,19,24
69,8479976,Juuso Valimaki,D,UTA,26,65,4,20,24
69,8473507,Jeff Petry,D,DET,37,69,3,21,24
69,8483445,Cutter Gauthier,L,ANA,20,63,13,10,23
69,8473453,Trevor Lewis,C,LAK,37,69,12,11,23
69,8480789,Oliver Wahlstrom,R,NYI,24,68,12,11,23
69,8474715,Cameron Atkinson,R,TBL,35,81,11,12,23
69,8476897,Oskar Sundqvist,C,STL,30,62,10,13,23
69,8480336,Sean Walker,D,CAR,30,74,10,13,23
69,8475791,Taylor Hall,L,CHI,33,56,10,13,23
69,8479353,Brett Howden,C,VGK,26,68,10,13,23
69,8476856,Mathew Dumba,D,DAL,30,67,9,14,23
69,8477953,Kasperi Kapanen,R,STL,28,70,8,15,23
69,8482142,Jamie Drysdale,D,PHI,22,60,8,15,23
69,8483468,Jiri Kulich,C,BUF,20,50,8,15,23
69,8476374,Sean Kuraly,C,CBJ,31,54,7,16,23
69,8480980,Connor Dewar,C,TOR,25,68,7,16,23
69,8478500,Ivan Provorov,D,CBJ,27,80,5,18,23
69,8480073,Erik Brannstrom,D,COL,25,66,4,19,23
69,8475324,Nick Jensen,D,OTT,34,69,3,20,23
69,8476463,Jonas Brodin,D,MIN,31,76,2,21,23
69,8476931,Jake McCabe,D,TOR,31,69,1,22,23
69,8481093,Rafael Harvey-Pinard,L,MTL,25,54,15,7,22
69,8480813,Joe Veleno,C,DET,24,75,13,9,22
69,8482259,Bobby McMann,C,TOR,28,60,12,10,22
69,8481582,Nicholas Robertson,L,TOR,23,70,11,11,22
69,8477573,Nathan Walker,L,STL,30,61,11,11,22
69,8479390,Taylor Raddysh,R,WSH,26,69,10,12,22
69,8475231,Casey Cizikas,C,NYI,33,75,8,14,22
69,8477478,William Carrier,L,CAR,30,59,8,14,22
69,8479671,Mathieu Olivier,R,CBJ,27,55,6,16,22
69,8481521,Ronnie Attard,D,PHI,25,56,4,18,22
69,8482655,Janis Moser,D,TBL,24,75,3,19,22
69,8481527,Kaedan Korczak,D,VGK,23,58,3,19,22
69,8476879,Cody Ceci,D,EDM,31,77,3,19,22
69,8482809,Jackson Blake,R,CAR,21,57,8,13,21
69,8478413,Jordan Greenway,L,BUF,27,57,7,14,21
69,8480995,Pontus Holmberg,R,TOR,25,60,7,14,21
69,8477931,Tomas Nosek,L,FLA,32,64,7,14,21
69,8477948,Travis Sanheim,D,PHI,28,66,5,16,21
69,8477435,Ryan Graves,D,PIT,29,79,5,16,21
69,8477507,Nikita Zadorov,D,BOS,29,70,5,16,21
69,8481014,Alexander Romanov,D,NYI,24,77,4,17,21
69,8479371,Dante Fabbro,D,NSH,26,63,2,19,21
69,8478882,Vladislav Gavrikov,D,LAK,29,65,1,20,21
69,8482087,Kaiden Guhle,D,MTL,22,68,0,21,21
69,8477425,Miles Wood,L,COL,29,79,14,6,20
69,8482062,Cole Smith,L,NSH,29,52,11,9,20
69,8478434,Keegan Kolesar,R,VGK,27,65,10,10,20
69,8480011,Klim Kostin,C,SJS,25,54,10,10,20
69,8480355,Mark Kastelic,C,BOS,25,64,9,11,20
69,8479336,Carl Grundstrom,R,SJS,27,53,9,11,20
69,8476467,Jamie Oleksiak,D,SEA,32,63,5,15,20
69,8483565,Nick Blankenburg,D,NSH,26,63,5,15,20
69,8476891,Matthew Grzelcyk,D,PIT,30,74,3,17,20
69,8476892,Colton Parayko,D,STL,31,69,2,18,20
69,8475790,Erik Gudbranson,D,CBJ,32,76,0,20,20
69,8479619,Michael Carcone,L,UTA,28,58,14,5,19
69,8478508,Yakov Trenin,C,MIN,27,63,10,9,19
69,8482679,Matt Coronato,R,CGY,22,64,8,11,19
69,8482803,Olen Zellweger,D,ANA,21,69,7,12,19
69,8479315,Joey Anderson,R,CHI,26,54,7,12,19
69,8476960,Andreas Athanasiou,C,CHI,30,49,7,12,19
69,8480220,Noah Cates,L,PHI,25,67,5,14,19
69,8476902,Esa Lindell,D,DAL,30,79,5,14,19
69,8480950,Ilya Lyubushkin,D,DAL,30,63,5,14,19
69,8476422,Mike Reilly,D,NYI,31,76,1,18,19
69,8481477,Nico Sturm,C,SJS,29,53,12,6,18
69,8483499,Liam Ohgren,L,MIN,20,51,11,7,18
69,8475343,Nic Dowd,C,WSH,34,58,10,8,18
69,8475225,Craig Smith,C,CHI,35,42,9,9,18
69,8477903,Garnet Hathaway,R,PHI,33,67,9,9,18
69,8476469,Joel Armia,R,MTL,31,69,9,9,18
69,8477446,Michael McCarron,R,NSH,29,55,9,9,18
69,8483482,Tristan Luneau,D,ANA,20,64,8,10,18
69,8477919,Frederick Gaudreau,C,MIN,31,54,7,11,18
69,8480144,David Kampf,C,TOR,29,70,7,11,18
69,8482148,Hendrix Lapierre,C,WSH,22,50,6,12,18
69,8478970,Jalen Chatfield,D,CAR,28,73,5,13,18
69,8480035,Henri Jokiharju,D,BUF,25,57,3,15,18
69,8470600,Ryan Suter,D,STL,39,64,3,15,18
69,8477508,Curtis Lazar,C,NJD,29,57,9,8,17
69,8476822,Luke Glendening,C,TBL,35,80,9,8,17
69,8477406,Mattias Janmark,C,EDM,32,69,9,8,17
69,8479370,Tyson Jost,C,CAR,26,51,9,8,17
69,8481704,Juuso Parssinen,C,NSH,23,56,8,9,17
69,8480289,Morgan Barron,C,WPG,26,45,8,9,17
69,8480205,Emil Bemstrom,C,PIT,25,58,8,9,17
69,8476429,Scott Mayfield,D,NYI,32,71,4,13,17
69,8475455,Brenden Dillon,D,NJD,34,56,4,13,17
69,8481522,Peyton Krebs,C,BUF,23,60,3,14,17
69,8481537,Nikita Okhotiuk,D,CGY,24,51,3,14,17
69,8480172,Jan Rutta,D,SJS,34,65,3,14,17
69,8481059,Scott Perunovich,D,STL,26,55,1,16,17
69,8482073,Braden Schneider,D,NYR,23,60,1,16,17
69,8474673,TJ Brodie,D,CHI,34,65,0,17,17
69,8480887,Jordan Harris,D,MTL,24,57,0,17,17
69,8481032,Paul Cotter,C,NJD,25,55,11,5,16
69,8479414,Nathan Bastian,R,NJD,27,64,11,5,16
69,8481028,Martin Pospisil,C,CGY,25,61,11,5,16
69,8481550,Adam Beckman,L,NJD,23,43,9,7,16
69,8482807,Ethan Del Mastro,D,CHI,21,46,8,8,16
69,8483457,Lane Hutson,D,MTL,20,60,7,9,16
69,8479066,Ryan Lomberg,L,CGY,30,64,7,9,16
69,8482176,Wyatt Kaiser,D,CHI,22,58,7,9,16
69,8482077,Dylan Holloway,L,EDM,23,50,7,9,16
69,8478133,Jake Evans,C,MTL,28,66,6,10,16
69,8476889,Radek Faksa,C,STL,30,54,6,10,16
69,8479026,Philippe Myers,D,TOR,27,54,6,10,16
69,8478416,Erik Cernak,D,TBL,27,66,4,12,16
69,8480246,Nick Perbix,D,TBL,26,72,4,12,16
69,8475188,Brayden McNabb,D,VGK,33,57,4,12,16
69,8482730,Brandt Clarke,D,LAK,21,59,4,12,16
69,8478136,Jake Middleton,D,MIN,28,74,4,12,16
69,8480192,Johnathan Kovacevic,D,NJD,27,50,4,12,16
69,8482192,Isaak Phillips,D,CHI,23,51,4,12,16
69,8476874,Olli Maatta,D,DET,30,64,4,12,16
69,8479348,Kale Clague,D,BUF,26,44,4,12,16
69,8482451,Mikael Pyyhtia,L,CBJ,23,44,3,13,16
69,8479369,Andrew Peeke,D,BOS,26,54,3,13,16
69,8476312,Josh Manson,D,COL,33,62,3,13,16
69,8477018,Ben Hutton,D,VGK,31,43,3,13,16
69,8479982,Conor Timmins,D,TOR,26,57,2,14,16
69,8481708,Zac Jones,D,NYR,24,57,2,14,16
69,8478443,Brandon Carlo,D,BOS,28,57,2,14,16
69,8477845,Trevor van Riemsdyk,D,WSH,33,54,2,14,16
69,8475842,Sam Carrick,C,NYR,32,59,9,6,15
69,8477450,Jason Dickinson,C,CHI,29,51,8,7,15
69,8482737,Zack Bolduc,C,STL,21,64,8,7,15
69,8474034,Patrick Maroon,L,CHI,36,48,8,7,15
69,8477392,Hudson Fasching,R,NYI,29,60,7,8,15
69,8480448,Parker Kelly,L,COL,25,75,7,8,15
69,8477369,Carson Soucy,D,VAN,30,63,6,9,15
69,8481161,Jake Christiansen,D,CBJ,25,53,6,9,15
69,8471709,Marc-Edouard Vlasic,D,SJS,37,55,5,10,15
69,8477499,Rasmus Ristolainen,D,PHI,30,63,4,11,15
69,8475462,Radko Gudas,D,ANA,34,65,4,11,15
69,8481567,Henry Thrun,D,SJS,23,50,4,11,15
69,8481568,Alex Vlasic,D,CHI,23,56,3,12,15
69,8480222,Sebastian Aho,D,PIT,28,75,3,12,15
69,8475855,Jesper Fast,R,CAR,33,52,3,12,15
69,8480891,Michael Kesselring,D,UTA,24,59,2,13,15
69,8479998,Mikey Anderson,D,LAK,25,59,2,13,15
69,8477365,Connor Clifton,D,BUF,29,61,2,13,15
69,8477938,Haydn Fleury,D,WPG,28,41,2,13,15
69,8480074,Alexandre Texier,C,STL,25,55,10,4,14
69,8480880,Jakub Lauko,C,MIN,24,36,10,4,14
69,8481601,Simon Holmstrom,R,NYI,23,65,9,5,14
69,8479328,Julien Gauthier,R,NYI,27,58,9,5,14
69,8476873,Mark Jankowski,C,NSH,30,53,8,6,14
69,8476934,Brock McGinn,L,ANA,30,52,8,6,14
69,8478211,Dryden Hunt,L,CGY,29,54,8,6,14
69,8480281,Alexey Toropchenko,R,STL,25,58,7,7,14
69,8480292,Carson Meyer,R,ANA,27,41,7,7,14
69,8482634,Alex Steeves,C,TOR,25,46,4,10,14
69,8480796,Martin Fehervary,D,WSH,25,62,4,10,14
69,8479372,Joshua Mahura,D,SEA,26,56,3,11,14
69,8474166,Alec Martinez,D,CHI,37,44,1,13,14
69,8484149,Gavin Brindley,C,CBJ,20,46,9,4,13
69,8481716,Dmitri Voronkov,L,CBJ,24,38,9,4,13
69,8476858,Phillip Di Giuseppe,L,VAN,31,50,8,5,13
69,8482157,Will Cuylle,L,NYR,22,59,7,6,13
69,8479359,Beck Malenstyn,L,BUF,26,47,7,6,13
69,8479994,Jaret Anderson-Dolan,C,WPG,25,40,7,6,13
69,8482166,Shakir Mukhamadullin,D,SJS,22,54,6,7,13
69,8480848,Ty Dellandrea,C,SJS,24,38,5,8,13
69,8478569,Noel Acciari,C,PIT,33,57,5,8,13
69,8480007,Jonas Rondbjerg,R,VGK,25,43,4,9,13
69,8478178,Darren Raddysh,D,TBL,28,72,3,10,13
69,8481019,David Gustafsson,C,WPG,24,51,3,10,13
69,8481013,Jonatan Berggren,R,DET,24,56,3,10,13
69,8479249,Andrew Poturalski,C,SJS,30,31,2,11,13
69,8475233,David Savard,D,MTL,34,66,2,11,13
69,8478451,Ethan Bear,D,WSH,27,60,2,11,13
69,8480860,Kevin Bahl,D,CGY,24,55,1,12,13
69,8475179,Dmitry Kulikov,D,FLA,34,63,0,13,13
69,8478831,Kevin Stenlund,C,UTA,28,53,8,4,12
69,8481609,Vladislav Kolyachonok,D,UTA,23,29,8,4,12
69,8479520,Brandon Duhaime,R,WSH,27,57,6,6,12
69,8480001,Urho Vaakanainen,D,ANA,25,48,5,7,12
69,8476994,Vinnie Hinostroza,C,NSH,30,53,5,7,12
69,8477380,Jonny Brodzinski,C,NYR,31,47,4,8,12
69,8477070,Liam O'Brien,C,UTA,30,51,4,8,12
69,8480845,Rasmus Kupari,C,WPG,24,47,4,8,12
69,8478859,Niko Mikkola,D,FLA,28,57,4,8,12
69,8475750,Jon Merrill,D,MIN,32,60,3,9,12
69,8476329,Travis Boyd,C,MIN,31,55,2,10,12
69,8477979,Nicolas Aube-Kubel,R,BUF,28,66,2,10,12
69,8474567,Zach Bogosian,D,MIN,34,68,2,10,12
69,8480727,Zach Whitecloud,D,VGK,28,46,1,11,12
69,8480807,Mattias Samuelsson,D,BUF,24,53,1,11,12
69,8475208,Brian Dumoulin,D,ANA,33,60,1,11,12
69,8479398,Samuel Girard,D,COL,26,61,0,12,12
69,8480762,Eric Robinson,L,CAR,29,58,8,3,11
69,8479718,Alex Barré-Boulet,C,MTL,27,55,7,4,11
69,8481617,Vasily Podkolzin,R,VAN,23,43,7,4,11
69,8481789,Tye Kartye,L,SEA,23,43,7,4,11
69,8480252,Cole Guttman,C,CHI,25,36,6,5,11
69,8478421,A.J. Greer,L,FLA,28,58,6,5,11
69,8479442,Troy Stecher,D,EDM,30,57,5,6,11
69,8476442,Matt Nieto,L,PIT,32,55,4,7,11
69,8480441,Trey Fix-Wolansky,R,CBJ,25,46,4,7,11
69,8482744,James Malatesta,L,CBJ,21,37,4,7,11
69,8479543,Michael Pezzetta,L,MTL,26,56,4,7,11
69,8480021,Jack Studnicka,C,LAK,25,63,4,7,11
69,8479324,Ryan Lindgren,D,NYR,26,59,2,9,11
69,8478452,Caleb Jones,D,LAK,27,49,2,9,11
69,8474574,Tyler Myers,D,VAN,34,64,0,11,11
69,8482666,Scott Morrow,D,CAR,22,44,7,3,10
69,8479986,Kole Lind,R,DAL,26,49,6,4,10
69,8482652,Walker Duehr,R,CGY,27,34,5,5,10
69,8483466,Kevin Korchinski,D,CHI,20,44,5,5,10
69,8481641,Joel Kiviranta,L,COL,28,71,4,6,10
69,8475279,Ben Chiarot,D,DET,33,65,3,7,10
69,8478585,Derek Ryan,C,EDM,38,63,3,7,10
69,8480879,Jacob Bernard-Docker,D,OTT,24,46,3,7,10
69,8479291,Kevin Rooney,C,CGY,31,43,3,7,10
69,8479536,Axel Jonsson-Fjallby,L,WPG,26,39,3,7,10
69,8475177,Calvin de Haan,D,COL,33,48,3,7,10
69,8477527,Ross Johnston,L,ANA,30,34,3,7,10
69,8481517,Brett Leason,R,ANA,25,49,2,8,10
69,8481701,Santeri Hatakka,D,NJD,23,39,2,8,10
69,8474013,Ian Cole,D,UTA,35,57,2,8,10
69,8480834,Ty Emberson,D,SJS,24,34,2,8,10
69,8471677,Jack Johnson,D,CBJ,37,68,1,9,10
69,8476967,Brett Kulak,D,EDM,30,60,1,9,10
69,8477384,Joshua Brown,D,EDM,30,36,0,10,10
69,8481532,Alex Turcotte,C,LAK,23,48,5,4,9
69,8481147,Reese Johnson,C,MIN,26,35,5,4,9
69,8483495,Simon Nemec,D,NJD,20,57,4,5,9
69,8482659,Josh Doan,R,UTA,22,47,4,5,9
69,8481751,Lukas Rousek,R,BUF,25,44,4,5,9
69,8479944,Zach Aston-Reese,C,VGK,30,47,4,5,9
69,8479980,Nicolas Hague,D,VGK,26,49,3,6,9
69,8479972,Mason Shaw,C,WPG,26,32,2,7,9
69,8483460,David Jiricek,D,CBJ,21,60,2,7,9
69,8480058,Pierre-Olivier Joseph,D,STL,25,52,2,7,9
69,8480070,Ian Mitchell,D,BOS,25,46,1,8,9
69,8477335,Kyle Burroughs,D,LAK,29,43,1,8,9
69,8476372,Nick Seeler,D,PHI,31,49,1,8,9
69,8477034,Jaycob Megna,D,FLA,32,51,1,8,9
69,8478399,Jonas Siegenthaler,D,NJD,27,59,0,9,9
69,8481518,Nolan Foote,L,NJD,24,36,5,3,8
69,8478146,Matthew Highmore,C,OTT,28,35,4,4,8
69,8471817,Ryan Reaves,R,TOR,37,54,3,5,8
69,8479439,Jacob MacDonald,D,COL,31,51,3,5,8
69,8479985,Cale Fleury,D,SEA,26,36,3,5,8
69,8477887,Patrick Brown,C,BOS,32,45,3,5,8
69,8479344,Jesse Puljujarvi,R,PIT,26,47,2,6,8
69,8479378,Logan Stanley,D,WPG,26,35,2,6,8
69,8476952,Dominic Toninato,C,WPG,30,30,2,6,8
69,8481598,Philip Broberg,D,EDM,23,38,2,6,8
69,8479772,Zack MacEwen,R,OTT,28,55,2,6,8
69,8478468,Jeremy Lauzon,D,NSH,27,55,1,7,8
69,8474612,Travis Hamonic,D,OTT,34,48,0,8,8
69,8481754,Nikita Nesterenko,C,ANA,23,29,7,0,7
69,8480025,MacKenzie Entwistle,R,FLA,25,59,6,1,7
69,8481556,John Beecher,C,BOS,23,28,6,1,7
69,8482747,Brennan Othmann,L,NYR,21,39,5,2,7
69,8478017,Mark Friedman,D,VAN,29,35,5,2,7
69,8482153,Brendan Brisson,C,VGK,23,44,5,2,7
69,8483012,Logan Morrison,C,SEA,22,34,5,2,7
69,8482762,Simon Edvinsson,D,DET,21,52,4,3,7
69,8476867,Brendan Gaunce,C,MIN,30,39,4,3,7
69,8481167,Brayden Pachal,D,CGY,25,47,4,3,7
69,8483763,Maksymilian Szuber,D,UTA,22,29,4,3,7
69,8482751,Ryan Winterton,C,SEA,21,38,4,3,7
69,8481599,Victor Soderstrom,D,UTA,23,36,3,4,7
69,8482964,Arber Xhekaj,D,MTL,23,46,3,4,7
69,8481122,Simon Benoit,D,TOR,26,35,3,4,7
69,8482859,Zack Ostapchuk,C,OTT,21,51,3,4,7
69,8481237,Kyle MacLean,C,NYI,25,26,3,4,7
69,8478424,Jansen Harkins,C,ANA,27,40,2,5,7
69,8480157,Calle Rosen,D,COL,30,43,2,5,7
69,8479419,Brett Murray,L,BUF,26,23,2,5,7
69,8475718,Justin Holl,D,DET,32,54,1,6,7
69,8482095,Tyler Kleven,D,OTT,22,46,1,6,7
69,8484254,Akito Hirose,D,VAN,25,41,1,6,7
69,8478450,Parker Wotherspoon,D,BOS,27,38,0,7,7
69,8476473,Connor Murphy,D,CHI,31,43,0,7,7
69,8482070,Mitchell Chaffee,R,TBL,26,46,5,1,6
69,8484287,Cole McWard,D,VAN,23,24,5,1,6
69,8483630,Pavol Regenda,L,ANA,25,27,4,2,6
69,8480245,Olle Lycksell,R,PHI,25,27,4,2,6
69,8482165,Yan Kuznetsov,D,CGY,22,22,3,3,6
69,8478409,Anthony Richard,C,PHI,28,39,3,3,6
69,8475762,Derek Forbort,D,VAN,32,51,2,4,6
69,8479981,Jonah Gadjovich,L,FLA,26,42,2,4,6
69,8475958,Michael Sgarbossa,C,WSH,32,25,2,4,6
69,8477473,Justin Bailey,R,SJS,29,24,2,4,6
69,8480196,Jacob Bryson,D,BUF,27,42,1,5,6
69,8480990,Declan Chisholm,D,MIN,24,31,1,5,6
69,8473446,Erik Johnson,D,PHI,36,57,1,5,6
69,8484258,Sam Malinski,D,COL,26,19,1,5,6
69,8476913,Devin Shore,C,MIN,30,33,1,5,6
69,8479379,Givani Smith,R,SJS,26,26,1,5,6
69,8477244,Chad Ruhwedel,D,NYR,34,30,1,5,6
69,8478502,Dennis Gilbert,D,BUF,28,18,1,5,6
69,8476441,Joel Edmundson,D,LAK,31,39,0,6,6
69,8479638,Justin Brazeau,R,BOS,26,36,4,1,5
69,8475235,Nicolas Deslauriers,L,PHI,33,47,4,1,5
69,8482765,Isak Rosen,R,BUF,21,35,3,2,5
69,8481679,Maxence Guenette,D,OTT,23,30,3,2,5
69,8477401,John Hayden,C,SEA,29,34,3,2,5
69,8480844,Grigori Denisenko,L,VGK,24,27,2,3,5
69,8481178,Egor Zamula,D,PHI,24,47,1,4,5
69,8478874,Adam Gaudette,R,OTT,28,34,1,4,5
69,8482141,Lukas Cormier,D,VGK,22,28,1,4,5
69,8483619,Filip Roos,D,OTT,25,32,1,4,5
69,8480890,Jan Jenik,C,OTT,24,22,1,4,5
69,8477149,Scott Sabourin,R,SJS,32,19,1,4,5
69,8481541,Samuel Bolduc,D,NYI,24,28,1,4,5
69,8477851,Jordan Oesterle,D,BOS,32,41,1,4,5
69,8481605,Jackson LaCombe,D,ANA,23,37,0,5,5
69,8477482,Zachary Sanford,L,CHI,30,35,0,5,5
69,8482145,Mavrik Bourque,C,DAL,22,49,0,5,5
69,8474090,Brendan Smith,D,DAL,35,53,0,5,5
69,8474568,Luke Schenn,D,NSH,35,43,0,5,5
69,8481056,Spencer Stastney,D,NSH,24,28,0,5,5
69,8481543,Nikita Alexandrov,C,STL,24,24,4,0,4
69,8481592,Jakob Pelletier,L,CGY,23,36,3,1,4
69,8481600,Tobias Bjornfot,D,FLA,23,40,3,1,4
69,8478446,Glenn Gawdin,C,LAK,27,14,3,1,4
69,8479968,Vinni Lettieri,C,BOS,29,49,2,2,4
69,8482177,Marat Khusnutdinov,C,MIN,22,37,2,2,4
69,8481593,Jayden Struble,D,MTL,23,23,2,2,4
69,8484911,Collin Graf,R,SJS,22,41,1,3,4
69,8482733,Logan Mailloux,D,MTL,31,35,1,3,4
69,8480870,Bo Groulx,C,NYR,24,26,1,3,4
69,8477962,Brendan Lemieux,L,CAR,28,34,1,3,4
69,8482511,Mason Lohrei,D,BOS,23,38,1,3,4
69,8479320,Maxime Lajoie,D,SEA,27,15,1,3,4
69,8482250,Callahan Burke,C,VGK,27,21,1,3,4
69,8479991,Jake Leschyshyn,C,NYR,25,29,0,4,4
69,8478021,William Lagesson,D,DET,28,36,0,4,4
69,8481065,Angus Crookshank,L,OTT,25,11,3,0,3
69,8482516,Matthew Kessel,D,STL,24,22,3,0,3
69,8480032,Shane Bowers,C,NJD,25,19,3,0,3
69,8482784,Zach Dean,C,STL,21,35,2,1,3
69,8483549,Lucas Condotta,L,MTL,27,35,2,1,3
69,8483397,Marc McLaughlin,C,BOS,25,40,2,1,3
69,8477320,Anton Blidh,L,NYR,29,28,2,1,3
69,8482061,Brandon Biro,L,SEA,26,13,2,1,3
69,8481422,Jake Lucchini,C,NSH,29,13,2,1,3
69,8479362,Riley Tufte,L,BOS,26,15,2,1,3
69,8477541,Dakota Mermis,D,TOR,30,10,2,1,3
69,8482460,Matt Rempe,C,NYR,22,8,2,1,3
69,8477462,Robert Hagg,D,VGK,29,25,1,2,3
69,8478477,Mitchell Stephens,C,SEA,27,23,1,2,3
69,8483570,Ben Meyers,C,SEA,26,26,1,2,3
69,8477467,Gustav Olofsson,D,SEA,30,19,1,2,3
69,8484325,Waltteri Merela,C,TBL,26,18,1,2,3
69,8482118,Sam Colangelo,R,ANA,23,13,1,2,3
69,8478011,Louie Belpedio,D,PHI,28,14,1,2,3
69,8481699,Aku Raty,R,UTA,23,21,1,2,3
69,8480468,James Hamblin,L,EDM,25,20,1,2,3
69,8482147,Jean-Luc Foudy,C,COL,22,22,0,3,3
69,8478454,Noah Juulsen,D,VAN,27,33,0,3,3
69,8482470,Ilya Solovyov,D,CGY,24,21,0,3,3
69,8482929,Emil Lilleberg,D,TBL,23,14,0,3,3
69,8479576,Vincent Desharnais,D,VAN,28,38,0,3,3
69,8482102,Vasily Ponomarev,C,PIT,22,19,0,3,3
69,8482713,Mackie Samoskevich,R,FLA,22,37,2,0,2
69,8482144,Jack Thompson,D,SJS,22,19,2,0,2
69,8482162,Roby Jarventie,L,EDM,22,11,2,0,2
69,8479367,William Lockwood,R,FLA,26,18,1,1,2
69,8482496,Nils Aman,C,VAN,24,37,1,1,2
69,8480267,Sammy Walker,C,MIN,25,20,1,1,2
69,8483471,Brad Lambert,C,WPG,31,9,1,1,2
69,8481743,Marc Del Gaizo,D,NSH,25,16,0,2,2
69,8475413,Justin Dowling,C,NJD,34,12,0,2,2
69,8479587,Rhett Gardner,C,PHI,28,18,0,2,2
69,8482172,Landon Slaggert,L,CHI,22,24,0,2,2
69,8482088,Justin Sourdif,R,FLA,22,15,0,2,2
69,8477971,Andreas Englund,D,LAK,28,25,0,2,2
69,8477073,Kurtis MacDermid,L,NJD,30,35,0,2,2
69,8478881,Brett Seney,L,CHI,28,15,0,2,2
69,8475795,Dylan McIlrath,D,WSH,32,19,0,2,2
69,8474062,Riley Nash,C,NYR,35,23,0,2,2
69,8484304,Uvis Balinskis,D,FLA,28,8,0,2,2
69,8483407,Brandon Scanlin,D,NYR,25,5,0,2,2
69,8480851,Akil Thomas,C,LAK,24,14,1,0,1
69,8481719,Maxwell Crozier,D,TBL,24,26,1,0,1
69,8483512,Matthew Savoie,C,EDM,20,20,1,0,1
69,8480075,Cameron Crotty,D,MIN,25,10,1,0,1
69,8481006,Tyler Tucker,D,STL,24,10,1,0,1
69,8480306,Grant Hutton,D,NYI,29,7,1,0,1
69,8480084,Nick DeSimone,D,NJD,30,13,0,1,1
69,8482858,Ryker Evans,D,SEA,23,17,0,1,1
69,8481043,Cole Koepke,L,BOS,26,17,0,1,1
69,8478051,Max Willman,C,NJD,29,21,0,1,1
69,8475780,Chris Wagner,R,COL,33,5,0,1,1
69,8480874,Adam Ginning,D,PHI,24,8,0,1,1
69,8483398,Declan Carlile,D,TBL,31,9,0,1,1
69,8477810,Joel Hanley,D,CGY,33,24,0,1,1
69,8481534,Raphael Lavoie,C,EDM,24,5,0,1,1
69,8483395,Arshdeep Bains,L,VAN,23,7,0,1,1
69,8483920,Pierrick Dube,R,WSH,23,8,0,1,1
69,8482861,Vincent Iorio,D,WSH,22,26,0,0,0
69,8481024,Linus Karlsson,C,VAN,25,3,0,0,0
69,8481578,Graeme Clarke,R,MIN,23,7,0,0,0
69,8482201,Gage Goncalves,C,TBL,23,26,0,0,0
69,8482094,Daemon Hunt,D,MIN,22,18,0,0,0
69,8481030,Jack St. Ivany,D,PIT,25,14,0,0,0
69,8479330,Brandon Gignac,C,MTL,27,11,0,0,0
69,8481564,Ryan Johnson,D,BUF,23,12,0,0,0
69,8481206,John Ludvig,D,PIT,24,4,0,0,0
69,8475755,Alexander Petrovic,D,DAL,32,7,0,0,0
69,8481585,Egor Afanasyev,L,SJS,23,15,0,0,0
69,8483489,Fraser Minten,C,TOR,31,10,0,0,0
69,8482476,Emil Heineman,L,MTL,23,6,0,0,0
69,8483567,Georgii Merkulov,C,BOS,24,9,0,0,0
69,8482126,Emil Andrae,D,PHI,31,3,0,0,0
69,8484255,Jason Polin,R,COL,25,3,0,0,0
69,8481806,Louis Crevier,D,CHI,23,13,0,0,0
69,8476323,Max McCormick,L,SEA,32,3,0,0,0
69,8483432,Luca Del Bel Belluz,C,CBJ,31,3,0,0,0
69,8478854,Ryan Shea,D,PIT,27,4,0,0,0
69,8480823,Alexander Alexeyev,D,WSH,25,7,0,0,0
69,8481726,Adam Edstrom,C,NYR,24,6,0,0,0
69,8477993,Justin Kirkland,C,CGY,28,7,0,0,0
69,8484326,Patrik Koch,D,UTA,28,6,0,0,0
69,8482787,Nikita Chibrikov,R,WPG,31,6,0,0,0
69,8483597,Milos Kelemen,L,UTA,25,12,0,0,0
69,8483609,Adam Klapka,R,CGY,24,3,0,0,0
69,8483401,Marc Johnstone,R,PIT,28,1,0,0,0
69,8478147,Bokondji Imama,L,PIT,28,2,0,0,0
69,8481462,Mason Morelli,L,VGK,28,13,0,0,0
69,8483546,Marshall Rifai,D,TOR,26,8,0,0,0
69,8482197,Adam Raska,R,MIN,23,9,0,0,0
69,8481655,Cole Schwindt,R,CGY,23,5,0,0,0
69,8483531,Brian Halonen,L,NJD,25,0,0,0,0
69,8479421,Jacob Moverare,D,LAK,26,11,0,0,0
69,8484259,Ondrej Pavel,C,COL,31,4,0,0,0
69,8479522,Hardy Haman Aktell,D,WSH,26,3,0,0,0
69,8484321,Nikolas Matinpalo,D,OTT,26,3,0,0,0
69,8480274,Philip Kemp,D,EDM,25,1,0,0,0
69,8470794,Joe Pavelski,C,,40,0,0,0,0
69,8479321,Lucas Johansen,D,,27,0,0,0,0
69,8477950,Tony DeAngelo,D,,29,0,0,0,0
69,8471218,Blake Wheeler,R,,38,0,0,0,0
69,8475197,Tyson Barrie,D,,33,0,0,0,0
69,8474157,Max Pacioretty,L,,36,0,0,0,0
69,8475744,Evgeny Kuznetsov,C,,32,0,0,0,0
69,8474037,James van Riemsdyk,L,,35,0,0,0,0
69,8476907,Mackenzie MacEachern,L,,30,0,0,0,0
69,8480216,Jacob Peterson,C,,25,0,0,0,0
69,8474602,Justin Schultz,D,,34,0,0,0,0
69,8482222,Alexander Barabanov,L,,30,0,0,0,0
69,8474031,Kevin Shattenkirk,D,,35,0,0,0,0
69,8477330,Dominik Kubalik,L,,29,0,0,0,0
69,8480884,Calen Addison,D,,24,0,0,0,0
69,8475906,John Klingberg,D,,32,0,0,0,0
69,8480008,Adam Ruzicka,C,,25,0,0,0,0
69,8476884,Derrick Pouliot,D,,30,0,0,0,0
69,8476919,Chris Tierney,C,,30,0,0,0,0
69,8479415,Michael McLeod,C,,26,0,0,0,0
69,8474870,Tyler Johnson,C,,34,0,0,0,0
69,8470604,Jeff Carter,C,,39,0,0,0,0
69,8478104,Sammy Blais,L,,28,0,0,0,0
69,8474884,Mike Hoffman,C,,35,0,0,0,0
69,8481591,Sam Poulin,R,,23,0,0,0,0
69,8471274,Alex Goligoski,D,,39,0,0,0,0
69,8476871,Tanner Pearson,L,,32,0,0,0,0
69,8476393,Nick Cousins,C,,31,0,0,0,0
69,8479977,Kailer Yamamoto,R,,26,0,0,0,0
69,8479346,Dillon Dube,C,,26,0,0,0,0
69,8480184,Gustav Lindstrom,D,,26,0,0,0,0
69,8479376,Victor Mete,D,,26,0,0,0,0
69,8473449,Kyle Okposo,R,,36,0,0,0,0
69,8481058,Jesse Ylonen,R,,25,0,0,0,0
69,8475752,Tyler Pitlick,C,,33,0,0,0,0
69,8481239,Samuel Fagemo,L,,24,0,0,0,0
69,8480821,Filip Zadina,R,,25,0,0,0,0
69,8470966,Mark Giordano,D,,41,0,0,0,0
69,8478495,Denis Gurianov,R,,27,0,0,0,0
69,8477464,Nic Petan,C,,29,0,0,0,0
69,8478099,Kevin Labanc,R,,29,0,0,0,0
69,8482241,Radim Zohorna,L,,28,0,0,0,0
69,8474040,Sam Gagner,C,,35,0,0,0,0
69,8479514,Rem Pitlick,C,,27,0,0,0,0
69,8478430,Oliver Kylington,D,,27,0,0,0,0
69,8479533,Joona Koppanen,L,,26,0,0,0,0
69,8479984,Cal Foote,D,,26,0,0,0,0
69,8477126,Jayson Megna,C,,34,0,0,0,0
69,8475164,Jakob Silfverberg,R,,34,0,0,0,0
69,8474009,Nick Bonino,C,,36,0,0,0,0
69,8479458,Nikita Zaitsev,D,,33,0,0,0,0
69,8477944,Jakub Vrana,L,,28,0,0,0,0
69,8471699,Andrew Cogliano,C,,37,0,0,0,0
69,8478067,Oskar Lindblom,L,,28,0,0,0,0
69,8471686,Marc Staal,D,,37,0,0,0,0
69,8470610,Zach Parise,L,,40,0,0,0,0
69,8478904,Steven Lorentz,C,,28,0,0,0,0
69,8473473,Milan Lucic,L,,36,0,0,0,0
69,8480031,Maxime Comtois,L,,25,0,0,0,0
69,8478512,Austin Czarnik,C,,32,0,0,0,0
69,8473504,Cal Clutterbuck,R,,37,0,0,0,0
69,8477454,Adam Erne,L,,29,0,0,0,0
69,8479383,Boris Katchouk,L,,26,0,0,0,0
69,8475825,Jani Hakanpää,D,,32,0,0,0,0
69,8477846,Ryan Carpenter,C,,33,0,0,0,0
69,8477930,Pierre-Edouard Bellemare,L,,39,0,0,0,0
69,8478400,Colin White,C,,27,0,0,0,0
69,8480226,Marián Studenic,R,,26,0,0,0,0
69,8480853,Liam Foudy,C,,24,0,0,0,0
69,8475797,Jarred Tinordi,D,,32,0,0,0,0
69,8479423,Alex Nylander,L,,26,0,0,0,0
69,8474618,Marco Scandella,D,,34,0,0,0,0
69,8478028,Fredrik Olofsson,L,,28,0,0,0,0
69,8474709,Matt Martin,L,,35,0,0,0,0
69,8481070,Hugh McGing,L,,26,0,0,0,0
69,8479546,Oskar Steen,C,,26,0,0,0,0
69,8474145,Robert Bortuzzo,D,,35,0,0,0,0
69,8476915,Jujhar Khaira,L,,30,0,0,0,0
69,8475278,Byron Froese,C,,33,0,0,0,0
69,8481812,Nikolai Knyzhov,D,,27,0,0,0,0
69,8478408,Travis Dermott,D,,28,0,0,0,0
69,8481077,John Leonard,L,,26,0,0,0,0
69,8479547,Matthew Phillips,R,,26,0,0,0,0
69,8480836,Jonathan Gruden,C,,24,0,0,0,0
69,8481690,Tyler Angle,C,,24,0,0,0,0
69,8475766,Austin Watson,L,,32,0,0,0,0
69,8481016,Ruslan Iskhakov,C,,24,0,0,0,0
69,8478078,Rourke Chartier,C,,28,0,0,0,0
69,8480776,Sheldon Rempal,R,,29,0,0,0,0
69,8478956,Samuel Laberge,L,NJD,27,2,0,0,0
69,8483045,Cameron Butler,R,CBJ,31,1,0,0,0
69,8484314,Jiri Smejkal,L,,28,0,0,0,0
70,8476453,Nikita Kucherov,R,TBL,31,80,43,98,141
70,8477492,Nathan MacKinnon,C,COL,29,82,55,81,136
70,8478402,Connor McDavid,C,EDM,27,77,37,99,136
70,8479318,Auston Matthews,C,TOR,27,79,59,64,123
70,8477956,David Pastrnak,R,BOS,28,80,58,61,119
70,8480800,Quinn Hughes,D,VAN,25,79,17,99,116
70,8477934,Leon Draisaitl,C,EDM,29,78,41,74,115
70,8477939,William Nylander,R,TOR,28,81,46,68,114
70,8478550,Artemi Panarin,L,NYR,33,77,35,79,114
70,8476468,J.T. Miller,C,VAN,31,77,32,81,113
70,8478420,Mikko Rantanen,R,COL,28,81,45,66,111
70,8478483,Mitch Marner,R,TOR,27,79,43,67,110
70,8481559,Jack Hughes,C,NJD,23,76,40,68,108
70,8480012,Elias Pettersson,C,VAN,26,79,48,59,107
70,8479314,Matthew Tkachuk,L,FLA,27,78,31,70,101
70,8480027,Jason Robertson,L,DAL,25,81,27,71,98
70,8478445,Mathew Barzal,C,NYI,27,80,27,71,98
70,8478864,Kirill Kaprizov,L,MIN,27,72,41,55,96
70,8478010,Brayden Point,C,TBL,28,81,44,49,93
70,8476887,Filip Forsberg,L,NSH,30,73,50,41,91
70,8477933,Sam Reinhart,C,FLA,29,78,40,51,91
70,8479323,Adam Fox,D,NYR,26,75,14,76,90
70,8480801,Brady Tkachuk,L,OTT,25,80,36,52,88
70,8474564,Steven Stamkos,C,NSH,34,74,29,58,87
70,8480069,Cale Makar,D,COL,26,71,25,62,87
70,8480036,Miro Heiskanen,D,DAL,25,77,18,68,86
70,8471675,Sidney Crosby,C,PIT,37,75,39,46,85
70,8479337,Alex DeBrincat,R,DET,27,80,39,46,85
70,8476389,Vincent Trocheck,C,NYR,31,78,33,52,85
70,8482116,Tim Stützle,C,OTT,22,80,23,62,85
70,8482740,Wyatt Johnston,C,DAL,21,82,47,37,84
70,8477404,Jake Guentzel,C,TBL,30,82,42,42,84
70,8473419,Brad Marchand,L,BOS,36,78,34,50,84
70,8477501,Valeri Nichushkin,R,COL,29,82,42,41,83
70,8479343,Clayton Keller,R,UTA,26,77,35,47,82
70,8475913,Mark Stone,R,VGK,32,78,34,48,82
70,8477942,Kevin Fiala,L,LAK,28,79,33,48,81
70,8479420,Tage Thompson,C,BUF,27,77,43,37,80
70,8471214,Alex Ovechkin,L,WSH,39,76,38,40,78
70,8475166,John Tavares,C,TOR,34,82,28,50,78
70,8477402,Pavel Buchnevich,L,STL,29,73,27,51,78
70,8477476,Artturi Lehkonen,L,COL,29,82,39,38,77
70,8475172,Nazem Kadri,C,CGY,34,77,30,47,77
70,8474141,Patrick Kane,R,DET,36,79,29,48,77
70,8480002,Nico Hischier,C,NJD,25,77,25,52,77
70,8480865,Noah Dobson,D,NYI,24,81,11,66,77
70,8478449,Roope Hintz,C,DAL,28,82,39,37,76
70,8479407,Jesper Bratt,L,NJD,26,76,33,43,76
70,8477951,Nick Schmaltz,C,UTA,28,74,25,51,76
70,8477493,Aleksander Barkov,C,FLA,29,76,22,54,76
70,8475167,Victor Hedman,D,TBL,34,75,11,65,76
70,8478398,Kyle Connor,L,WPG,28,77,40,35,75
70,8477946,Dylan Larkin,C,DET,28,79,33,42,75
70,8478403,Jack Eichel,C,VGK,28,76,28,47,75
70,8476454,Ryan Nugent-Hopkins,C,EDM,31,79,23,52,75
70,8476459,Mika Zibanejad,C,NYR,31,74,33,41,74
70,8478439,Travis Konecny,R,PHI,27,77,27,47,74
70,8475754,Brock Nelson,C,NYI,33,80,39,34,73
70,8484144,Connor Bedard,C,CHI,19,69,29,44,73
70,8478414,Timo Meier,R,NJD,28,76,32,40,72
70,8477409,Carter Verhaeghe,C,FLA,29,78,28,44,72
70,8476456,Jonathan Huberdeau,C,CGY,31,80,20,52,72
70,8475786,Zach Hyman,L,EDM,32,77,34,37,71
70,8475765,Vladimir Tarasenko,R,DET,33,78,24,47,71
70,8481557,Matt Boldy,L,MIN,23,72,33,37,70
70,8477494,Jonathan Drouin,L,COL,29,82,21,49,70
70,8476539,Jonathan Marchessault,R,NSH,34,74,40,29,69
70,8480023,Robert Thomas,C,STL,25,70,20,49,69
70,8474600,Roman Josi,D,NSH,34,75,17,52,69
70,8478444,Brock Boeser,R,VAN,27,73,36,32,68
70,8475168,Matt Duchene,C,DAL,33,81,26,42,68
70,8475810,Bryan Rust,R,PIT,32,74,32,35,67
70,8477940,Nikolaj Ehlers,L,WPG,28,78,21,46,67
70,8477504,Josh Morrissey,D,WPG,29,76,15,52,67
70,8478498,Jake DeBrusk,L,VAN,28,76,38,28,66
70,8477960,Adrian Kempe,R,LAK,28,80,34,32,66
70,8479385,Jordan Kyrou,C,STL,26,71,27,39,66
70,8481540,Cole Caufield,R,MTL,23,74,35,30,65
70,8475692,Mats Zuccarello,R,MIN,37,71,13,52,65
70,8476881,Tomas Hertl,C,VGK,31,77,31,33,64
70,8477500,Bo Horvat,C,NYI,29,80,29,35,64
70,8476346,Johnny Gaudreau,L,CBJ,31,72,10,54,64
70,8482078,Lucas Raymond,L,DET,22,81,28,35,63
70,8482093,Seth Jarvis,C,CAR,22,73,27,36,63
70,8479542,Brandon Hagel,L,TBL,26,82,25,38,63
70,8477496,Elias Lindholm,C,BOS,30,79,25,38,63
70,8479400,Pierre-Luc Dubois,L,WSH,26,76,25,38,63
70,8476460,Mark Scheifele,C,WPG,31,75,23,40,63
70,8479675,Trevor Moore,L,LAK,29,80,23,40,63
70,8471215,Evgeni Malkin,C,PIT,38,71,23,40,63
70,8477456,J.T. Compher,L,DET,29,81,28,34,62
70,8478427,Sebastian Aho,C,CAR,27,74,27,35,62
70,8473994,Jamie Benn,L,DAL,35,81,26,36,62
70,8478493,Joel Eriksson Ek,C,MIN,27,71,25,37,62
70,8478873,Troy Terry,R,ANA,27,74,20,42,62
70,8471724,Kris Letang,D,PIT,37,80,12,50,62
70,8478366,Frank Vatrano,R,ANA,30,72,35,26,61
70,8475151,Kyle Palmieri,C,NYI,33,78,32,29,61
70,8480015,Owen Tippett,R,PHI,25,72,30,31,61
70,8475784,Jeff Skinner,C,EDM,32,77,26,35,61
70,8478856,Conor Garland,R,VAN,28,75,26,35,61
70,8471685,Anze Kopitar,C,LAK,37,80,19,42,61
70,8476875,Mike Matheson,D,MTL,30,78,15,46,61
70,8477949,Alex Tuch,R,BUF,28,72,21,39,60
70,8477986,Brandon Montour,D,SEA,30,75,19,41,60
70,8478047,Michael Bunting,L,PIT,29,67,17,43,60
70,8478975,Mason Marchment,L,DAL,29,81,28,31,59
70,8480208,Drake Batherson,R,OTT,26,77,25,34,59
70,8478440,Dylan Strome,C,WSH,27,71,17,42,59
70,8477955,Jared McCann,L,SEA,28,77,29,29,58
70,8477964,Ivan Barbashev,C,VGK,29,72,26,32,58
70,8482109,Alexis Lafrenière,L,NYR,23,74,25,33,58
70,8478233,Andrew Mangiapane,L,WSH,28,68,25,33,58
70,8478438,Tommy Novak,C,NSH,27,70,19,39,58
70,8478460,Zach Werenski,D,CBJ,27,81,18,40,58
70,8481711,Matias Maccelli,L,UTA,24,80,17,41,58
70,8474590,John Carlson,D,WSH,34,70,14,44,58
70,8478407,Vince Dunn,D,SEA,28,72,12,46,58
70,8477447,Shea Theodore,D,VGK,29,65,12,46,58
70,8481068,Yegor Sharangovich,C,CGY,26,79,30,27,57
70,8476483,Rickard Rakell,R,PIT,31,73,29,28,57
70,8482720,Matthew Knies,L,TOR,22,77,20,37,57
70,8476792,Torey Krug,D,STL,33,72,19,38,57
70,8473512,Claude Giroux,R,OTT,36,78,16,41,57
70,8478397,Rasmus Andersson,D,CGY,28,75,13,44,57
70,8476399,Blake Coleman,C,CGY,33,78,32,24,56
70,8478466,Daniel Sprong,R,VAN,27,66,22,34,56
70,8479999,Casey Mittelstadt,C,COL,26,81,21,35,56
70,8475170,Brayden Schenn,C,STL,33,74,27,28,55
70,8473986,Alex Killorn,L,ANA,35,72,27,28,55
70,8482110,Dawson Mercer,C,NJD,23,74,26,29,55
70,8482745,Mason McTavish,C,ANA,21,73,18,37,55
70,8476853,Morgan Rielly,D,TOR,30,73,7,48,55
70,8480014,Gabriel Vilardi,C,WPG,25,71,31,23,54
70,8477416,Oliver Bjorkstrand,R,SEA,29,74,26,28,54
70,8475768,Jaden Schwartz,C,SEA,32,76,23,31,54
70,8477511,Anthony Mantha,R,CGY,30,75,22,32,54
70,8482665,Matty Beniers,C,SEA,22,71,18,36,54
70,8484153,Leo Carlsson,C,ANA,20,75,18,36,54
70,8475798,Mikael Granlund,C,SJS,32,68,11,43,54
70,8476448,William Karlsson,C,VGK,31,79,21,32,53
70,8477407,Anthony Duclair,L,NYI,29,80,19,34,53
70,8475184,Chris Kreider,L,NYR,33,71,36,16,52
70,8480830,Andrei Svechnikov,R,CAR,24,63,25,27,52
70,8474586,Jordan Eberle,R,SEA,34,75,22,30,52
70,8480839,Rasmus Dahlin,D,BUF,24,66,15,37,52
70,8483808,Andrei Kuzmenko,L,CGY,28,76,27,24,51
70,8477451,Ryan Hartman,R,MIN,30,68,25,26,51
70,8475794,Tyler Seguin,C,DAL,32,82,24,27,51
70,8482699,Dylan Guenther,R,UTA,21,73,22,29,51
70,8483515,Juraj Slafkovsky,L,MTL,20,76,22,29,51
70,8479987,Morgan Geekie,C,BOS,26,76,21,30,51
70,8475158,Ryan O'Reilly,C,NSH,33,72,15,36,51
70,8478472,Mathieu Joseph,R,STL,27,70,15,36,51
70,8479325,Charlie McAvoy,D,BOS,27,79,9,42,51
70,8475314,Anders Lee,L,NYI,34,79,31,19,50
70,8481618,Alex Newhook,C,MTL,23,71,23,27,50
70,8476905,Chandler Stephenson,C,SEA,30,68,20,30,50
70,8477444,Andre Burakovsky,L,SEA,29,74,19,31,50
70,8476479,Phillip Danault,C,LAK,31,79,17,33,50
70,8481528,Dylan Cozens,C,BUF,23,72,17,33,50
70,8475753,Justin Faulk,D,STL,32,72,12,38,50
70,8482113,Anton Lundell,C,FLA,23,77,20,29,49
70,8480803,Evan Bouchard,D,EDM,25,79,13,36,49
70,8478474,Lawson Crouse,L,UTA,27,72,28,20,48
70,8477935,Sam Bennett,C,FLA,28,75,22,26,48
70,8479992,Michael Rasmussen,C,DET,25,81,22,26,48
70,8476826,Yanni Gourde,C,SEA,33,68,17,31,48
70,8478055,Gustav Forsling,D,FLA,28,74,15,33,48
70,8478401,Pavel Zacha,C,BOS,27,82,13,35,48
70,8474563,Drew Doughty,D,LAK,35,75,12,36,48
70,8478038,Devon Toews,D,COL,30,77,10,38,48
70,8474641,Adam Henrique,C,EDM,34,77,25,22,47
70,8477998,Warren Foegele,L,LAK,28,78,20,27,47
70,8482702,Logan Stankoven,C,DAL,21,79,20,27,47
70,8476432,Boone Jenner,C,CBJ,31,68,24,22,46
70,8482159,Tyson Foerster,R,PHI,22,71,22,24,46
70,8475191,Reilly Smith,R,NYR,33,75,21,25,46
70,8477497,Sean Monahan,C,CBJ,30,67,19,27,46
70,8474578,Erik Karlsson,D,PIT,34,79,17,29,46
70,8478042,Viktor Arvidsson,L,EDM,31,74,16,30,46
70,8480018,Nick Suzuki,C,MTL,25,73,14,32,46
70,8481542,Moritz Seider,D,DET,23,77,8,38,46
70,8480797,Joel Farabee,L,PHI,24,72,21,24,45
70,8475218,Mattias Ekholm,D,EDM,34,74,20,25,45
70,8479525,Ross Colton,C,COL,28,81,20,25,45
70,8481533,Trevor Zegras,C,ANA,23,70,19,26,45
70,8482124,Quinton Byfield,R,LAK,22,79,18,27,45
70,8476461,Sean Couturier,C,PHI,32,68,16,29,45
70,8477503,Max Domi,C,TOR,29,76,12,33,45
70,8482684,Luke Hughes,D,NJD,21,69,6,39,45
70,8476438,Brandon Saad,L,STL,32,72,30,14,44
70,8475169,Evander Kane,L,EDM,33,74,24,20,44
70,8481596,Shane Pinto,C,OTT,24,75,23,21,44
70,8481604,Pavel Dorofeyev,L,VGK,24,64,21,23,44
70,8478057,Dakota Joshua,C,VAN,28,67,21,23,44
70,8475745,Charlie Coyle,C,BOS,32,76,16,28,44
70,8478462,Nicolas Roy,C,VGK,27,73,13,31,44
70,8479425,Filip Hronek,D,VAN,27,80,9,35,44
70,8476958,Jaccob Slavin,D,CAR,30,72,6,38,44
70,8478519,Anthony Cirelli,C,TBL,27,81,22,21,43
70,8476880,Tom Wilson,R,WSH,30,74,22,21,43
70,8478046,Danton Heinen,L,VAN,29,72,19,24,43
70,8479345,Jakob Chychrun,D,WSH,26,71,16,27,43
70,8476854,Hampus Lindholm,D,BOS,30,74,9,34,43
70,8480188,Fabian Zetterlund,L,SJS,25,62,22,20,42
70,8478463,Anthony Beauvillier,L,PIT,27,73,20,22,42
70,8476292,Ondrej Palat,L,NJD,33,72,19,23,42
70,8477479,Tyler Bertuzzi,L,CHI,29,64,18,24,42
70,8476872,Scott Laughton,C,PHI,30,73,18,24,42
70,8478115,Pierre Engvall,L,NYI,28,77,17,25,42
70,8475722,Jason Zucker,L,BUF,32,72,17,25,42
70,8480039,Martin Necas,C,CAR,25,69,16,26,42
70,8478458,John (Jack) Roslovic,C,CAR,27,69,14,28,42
70,8482097,Jack Quinn,R,BUF,23,63,14,28,42
70,8481577,Philip Tomasino,C,NSH,23,69,12,30,42
70,8476462,Dougie Hamilton,D,NJD,31,67,12,30,42
70,8476869,Brady Skjei,D,NSH,30,74,11,31,42
70,8477932,Aaron Ekblad,D,FLA,28,68,9,33,42
70,8481581,Thomas Harley,D,DAL,23,75,9,33,42
70,8478542,Evan Rodrigues,C,FLA,31,78,25,16,41
70,8475726,Tyler Toffoli,C,SJS,32,63,21,20,41
70,8475848,Brendan Gallagher,R,MTL,32,66,19,22,41
70,8481524,Bowen Byram,D,BUF,23,73,17,24,41
70,8479365,Trent Frederic,C,BOS,26,75,17,24,41
70,8474150,Mikael Backlund,C,CGY,35,75,13,28,41
70,8474679,Gustav Nyquist,C,NSH,35,72,9,32,41
70,8481582,Nicholas Robertson,L,TOR,23,73,23,17,40
70,8481560,Arthur Kaliyev,R,LAK,23,82,21,19,40
70,8482149,Cole Perfetti,C,WPG,22,64,19,21,40
70,8478469,Thomas Chabot,D,OTT,27,78,13,27,40
70,8478396,Noah Hanifin,D,VGK,27,64,13,27,40
70,8480113,Alex Iafallo,L,WPG,31,68,12,28,40
70,8475764,Cam Fowler,D,ANA,33,77,6,34,40
70,8481535,Nils Hoglander,L,VAN,24,69,22,17,39
70,8476981,Josh Anderson,R,MTL,30,72,16,23,39
70,8474102,David Perron,L,OTT,36,79,14,25,39
70,8480028,Morgan Frost,C,PHI,25,73,11,28,39
70,8474565,Alex Pietrangelo,D,VGK,34,66,9,30,39
70,8470613,Brent Burns,D,CAR,39,75,8,31,39
70,8482712,Oskar Olausson,R,COL,22,79,3,36,39
70,8477426,Nicholas Paul,L,TBL,29,80,19,19,38
70,8480068,Ryan Poehling,C,PHI,25,73,18,20,38
70,8474149,Evgenii Dadonov,R,DAL,35,78,16,22,38
70,8482146,Luke Evangelista,R,NSH,22,68,15,23,38
70,8476927,Teddy Blueger,C,VAN,30,66,12,26,38
70,8477495,Seth Jones,D,CHI,30,66,11,27,38
70,8483505,Matthew Poitras,C,BOS,20,75,8,30,38
70,8475799,Nino Niederreiter,R,WPG,32,64,20,17,37
70,8483431,Logan Cooley,C,UTA,20,70,18,19,37
70,8479591,Michael Eyssimont,C,TBL,28,81,18,19,37
70,8484166,Adam Fantilli,C,CBJ,20,68,17,20,37
70,8481186,Logan O'Connor,R,COL,28,80,15,22,37
70,8480009,Eeli Tolvanen,R,SEA,25,72,14,23,37
70,8476419,Jean-Gabriel Pageau,C,NYI,32,78,10,27,37
70,8476906,Shayne Gostisbehere,D,CAR,31,74,7,30,37
70,8476979,Erik Gustafsson,D,DET,32,79,7,30,37
70,8481546,Cam York,D,PHI,23,73,7,30,37
70,8482122,Brock Faber,D,MIN,22,78,6,31,37
70,8480145,Neal Pionk,D,WPG,29,70,6,31,37
70,8482092,Ridly Greig,C,OTT,22,75,19,17,36
70,8480748,Kiefer Sherwood,L,VAN,29,64,17,19,36
70,8482133,Thomas Bordeleau,C,SJS,22,67,14,22,36
70,8476458,Ryan Strome,C,ANA,31,62,12,24,36
70,8480817,K'Andre Miller,D,NYR,24,67,7,29,36
70,8475714,Calle Jarnkrok,C,TOR,33,72,21,14,35
70,8480064,Josh Norris,C,OTT,25,74,20,15,35
70,8482475,Yegor Chinakhov,R,CBJ,23,68,20,15,35
70,8475287,Erik Haula,L,NJD,33,69,17,18,35
70,8476897,Oskar Sundqvist,C,STL,30,74,17,18,35
70,8476918,Jimmy Vesey,L,NYR,31,63,16,19,35
70,8477919,Frederick Gaudreau,C,MIN,31,68,15,20,35
70,8478133,Jake Evans,C,MTL,28,70,15,20,35
70,8480336,Sean Walker,D,CAR,30,76,11,24,35
70,8476882,Teuvo Teravainen,C,CHI,30,65,10,25,35
70,8474053,Logan Couture,C,SJS,35,56,10,25,35
70,8482667,William Eklund,L,SJS,22,64,9,26,35
70,8479402,Jake Bean,D,CGY,26,65,6,29,35
70,8480220,Noah Cates,L,PHI,25,70,21,13,34
70,8484145,Zach Benson,L,BUF,19,70,14,20,34
70,8475193,Tomas Tatar,L,NJD,34,67,14,20,34
70,8475793,Ryan Johansen,C,PHI,32,73,13,21,34
70,8482175,JJ Peterka,R,BUF,22,61,12,22,34
70,8481523,Kirby Dach,C,MTL,23,62,10,24,34
70,8474716,Jared Spurgeon,D,MIN,35,76,10,24,34
70,8476463,Jonas Brodin,D,MIN,31,78,7,27,34
70,8482655,Janis Moser,D,TBL,24,78,4,30,34
70,8480893,Kirill Marchenko,R,CBJ,24,60,18,15,33
70,8480849,Barrett Hayton,C,UTA,24,71,17,16,33
70,8480185,Eetu Luostarinen,C,FLA,26,75,17,16,33
70,8477429,Andrew Copp,C,DET,30,79,15,18,33
70,8477021,Alex Kerfoot,C,UTA,30,76,14,19,33
70,8471698,T.J. Oshie,R,WSH,38,72,12,21,33
70,8481656,Aliaksei Protas,C,WSH,23,61,12,21,33
70,8477505,Alexander Wennberg,C,SJS,30,66,12,21,33
70,8473422,Nick Foligno,L,CHI,37,62,11,22,33
70,8477953,Kasperi Kapanen,R,STL,28,69,11,22,33
70,8476923,Damon Severson,D,CBJ,30,79,6,27,33
70,8480802,Ryan McLeod,C,BUF,25,60,16,16,32
70,8475763,Kevin Hayes,R,PIT,32,66,16,16,32
70,8476474,Stefan Noesen,R,NJD,31,70,14,18,32
70,8475149,Marcus Johansson,L,MIN,34,67,13,19,32
70,8480829,Jesperi Kotkaniemi,C,CAR,24,66,13,19,32
70,8477947,Sonny Milano,L,WSH,28,63,12,20,32
70,8476902,Esa Lindell,D,DAL,30,77,7,25,32
70,8481553,Bobby Brink,R,PHI,23,61,17,14,31
70,8477987,Ryan Donato,C,CHI,28,65,17,14,31
70,8475760,Nick Bjugstad,C,UTA,32,71,16,15,31
70,8470621,Corey Perry,R,EDM,39,72,14,17,31
70,8481624,Ilya Mikheyev,R,CHI,30,70,11,20,31
70,8483468,Jiri Kulich,C,BUF,20,60,10,21,31
70,8481703,Valtteri Puustinen,R,PIT,25,63,8,23,31
70,8480789,Oliver Wahlstrom,R,NYI,24,73,7,24,31
70,8478136,Jake Middleton,D,MIN,28,69,7,24,31
70,8479410,Mikhail Sergachev,D,UTA,26,66,6,25,31
70,8474574,Tyler Myers,D,VAN,34,66,6,25,31
70,8477948,Travis Sanheim,D,PHI,28,75,4,27,31
70,8475343,Nic Dowd,C,WSH,34,59,16,14,30
70,8477952,Robby Fabbri,C,ANA,28,64,14,16,30
70,8480078,Filip Chytil,C,NYR,25,67,13,17,30
70,8476422,Mike Reilly,D,NYI,31,75,11,19,30
70,8476885,Jacob Trouba,D,NYR,30,72,9,21,30
70,8479339,Patrik Laine,L,CBJ,26,59,8,22,30
70,8482671,Owen Power,D,BUF,22,72,8,22,30
70,8481606,Jordan Spence,D,LAK,23,61,7,23,30
70,8482089,Jake Neighbours,L,STL,22,65,18,11,29
70,8478413,Jordan Greenway,L,BUF,27,63,14,15,29
70,8482055,Drew O'Connor,L,PIT,26,60,12,17,29
70,8483499,Liam Ohgren,L,MIN,20,56,12,17,29
70,8476480,Vladislav Namestnikov,C,WPG,32,65,10,19,29
70,8482624,Daniil Miromanov,D,CGY,27,63,8,21,29
70,8483445,Cutter Gauthier,L,ANA,20,59,8,21,29
70,8480878,Nils Lundkvist,D,DAL,24,77,6,23,29
70,8478500,Ivan Provorov,D,CBJ,27,77,5,24,29
70,8480459,Pius Suter,C,VAN,28,66,16,12,28
70,8476925,Colton Sissons,C,NSH,31,67,15,13,28
70,8480798,Philipp Kurashev,C,CHI,25,66,12,16,28
70,8482705,Cole Sillinger,C,CBJ,21,69,12,16,28
70,8477989,Christian Dvorak,C,MTL,28,65,11,17,28
70,8482125,Alexander Holtz,R,VGK,22,71,9,19,28
70,8477498,Darnell Nurse,D,EDM,29,69,7,21,28
70,8480246,Nick Perbix,D,TBL,26,70,7,21,28
70,8478911,Matt Roy,D,WSH,29,66,4,24,28
70,8481554,Kaapo Kakko,R,NYR,23,75,16,11,27
70,8482155,Alex Laferriere,R,LAK,23,67,16,11,27
70,8474715,Cameron Atkinson,R,TBL,35,80,14,13,27
70,8473453,Trevor Lewis,C,LAK,37,73,10,17,27
70,8482101,Danil Gushchin,L,SJS,22,56,8,19,27
70,8482749,Joshua Roy,R,MTL,21,65,7,20,27
70,8483490,Pavel Mintyukov,D,ANA,21,66,6,21,27
70,8480871,Adam Boqvist,D,FLA,24,70,6,21,27
70,8477488,Brett Pesce,D,NJD,30,73,5,22,27
70,8475171,Oliver Ekman-Larsson,D,TOR,33,67,5,22,27
70,8480434,Sean Durzi,D,UTA,26,69,4,23,27
70,8482259,Bobby McMann,C,TOR,28,60,17,9,26
70,8478109,Victor Olofsson,L,VGK,29,74,16,10,26
70,8480995,Pontus Holmberg,R,TOR,25,62,14,12,26
70,8479351,Sam Steel,C,DAL,26,80,12,14,26
70,8476878,Zemgus Girgensons,C,TBL,30,79,12,14,26
70,8476960,Andreas Athanasiou,C,CHI,30,46,12,14,26
70,8479353,Brett Howden,C,VGK,26,66,9,17,26
70,8482809,Jackson Blake,R,CAR,21,52,9,17,26
70,8477979,Nicolas Aube-Kubel,R,BUF,28,59,9,17,26
70,8482105,Jake Sanderson,D,OTT,22,75,8,18,26
70,8478882,Vladislav Gavrikov,D,LAK,29,72,4,22,26
70,8477969,Marcus Pettersson,D,PIT,28,77,3,23,26
70,8475231,Casey Cizikas,C,NYI,33,72,16,9,25
70,8482074,Connor Zary,C,CGY,23,66,12,13,25
70,8482079,Marco Rossi,C,MIN,23,59,12,13,25
70,8483457,Lane Hutson,D,MTL,20,70,12,13,25
70,8483493,Frank Nazar,C,CHI,20,50,11,14,25
70,8476392,Adam Lowry,C,WPG,31,59,10,15,25
70,8479066,Ryan Lomberg,L,CGY,30,67,9,16,25
70,8480855,Jack McBain,C,UTA,24,69,8,17,25
70,8481521,Ronnie Attard,D,PHI,25,54,8,17,25
70,8479983,Mario Ferraro,D,SJS,26,71,7,18,25
70,8482117,Lukas Reichel,L,CHI,22,59,7,18,25
70,8482111,Justin Barron,D,MTL,23,62,5,20,25
70,8477506,Ryan Pulock,D,NYI,30,75,4,21,25
70,8476931,Jake McCabe,D,TOR,31,65,4,21,25
70,8476967,Brett Kulak,D,EDM,30,65,3,22,25
70,8479336,Carl Grundstrom,R,SJS,27,52,15,9,24
70,8478020,Michael Amadio,R,OTT,28,68,14,10,24
70,8479390,Taylor Raddysh,R,WSH,26,58,13,11,24
70,8481580,Connor McMichael,C,WSH,23,62,11,13,24
70,8484203,Bradly Nadeau,L,CAR,19,64,10,14,24
70,8474189,Lars Eller,C,PIT,35,62,9,15,24
70,8477353,Tyler Motte,C,DET,29,75,9,15,24
70,8480074,Alexandre Texier,C,STL,25,57,9,15,24
70,8480813,Joe Veleno,C,DET,24,73,8,16,24
70,8481704,Juuso Parssinen,C,NSH,23,65,7,17,24
70,8479976,Juuso Valimaki,D,UTA,26,67,6,18,24
70,8477507,Nikita Zadorov,D,BOS,29,69,6,18,24
70,8477346,MacKenzie Weegar,D,CGY,30,72,4,20,24
70,8477435,Ryan Graves,D,PIT,29,76,4,20,24
70,8476892,Colton Parayko,D,STL,31,71,3,21,24
70,8483524,Shane Wright,C,SEA,20,69,14,9,23
70,8478891,Mason Appleton,C,WPG,28,66,12,11,23
70,8478013,Jake Walman,D,SJS,28,68,12,11,23
70,8481093,Rafael Harvey-Pinard,L,MTL,25,57,11,12,23
70,8475842,Sam Carrick,C,NYR,32,58,11,12,23
70,8480448,Parker Kelly,L,COL,25,75,11,12,23
70,8482660,Kent Johnson,C,CBJ,22,63,9,14,23
70,8477392,Hudson Fasching,R,NYI,29,63,9,14,23
70,8477369,Carson Soucy,D,VAN,30,59,7,16,23
70,8482142,Jamie Drysdale,D,PHI,22,66,6,17,23
70,8483565,Nick Blankenburg,D,NSH,26,55,5,18,23
70,8480144,David Kampf,C,TOR,29,69,5,18,23
70,8473507,Jeff Petry,D,DET,37,73,4,19,23
70,8476856,Mathew Dumba,D,DAL,30,71,3,20,23
70,8476278,Colin Blackwell,C,DAL,31,75,14,8,22
70,8481477,Nico Sturm,C,SJS,29,54,13,9,22
70,8479996,Cody Glass,C,NSH,25,65,12,10,22
70,8479328,Julien Gauthier,R,NYI,27,65,11,11,22
70,8483491,Ivan Miroshnichenko,L,WSH,20,53,10,12,22
70,8476469,Joel Armia,R,MTL,31,67,10,12,22
70,8478178,Darren Raddysh,D,TBL,28,64,6,16,22
70,8475208,Brian Dumoulin,D,ANA,33,56,5,17,22
70,8481527,Kaedan Korczak,D,VGK,23,46,4,18,22
70,8480860,Kevin Bahl,D,CGY,24,51,4,18,22
70,8479398,Samuel Girard,D,COL,26,62,4,18,22
70,8475181,Nick Leddy,D,STL,33,68,2,20,22
70,8478043,Sam Lafferty,C,BUF,29,62,13,8,21
70,8481481,Blake Lizotte,C,PIT,27,60,12,9,21
70,8479393,Noah Gregor,L,OTT,26,71,11,10,21
70,8477406,Mattias Janmark,C,EDM,32,64,11,10,21
70,8475200,Dmitry Orlov,D,CAR,33,71,7,14,21
70,8473563,Nicklas Backstrom,C,WSH,37,51,5,16,21
70,8474151,Ryan McDonagh,D,TBL,35,77,4,17,21
70,8475790,Erik Gudbranson,D,CBJ,32,79,4,17,21
70,8481522,Peyton Krebs,C,BUF,23,59,4,17,21
70,8474673,TJ Brodie,D,CHI,34,55,4,17,21
70,8478507,John Marino,D,UTA,27,65,3,18,21
70,8476457,Adam Larsson,D,SEA,32,68,3,18,21
70,8482192,Isaak Phillips,D,CHI,23,58,3,18,21
70,8479293,Brandon Tanev,L,SEA,33,56,14,6,20
70,8480003,Jesper Boqvist,C,FLA,26,71,11,9,20
70,8478585,Derek Ryan,C,EDM,38,57,11,9,20
70,8479439,Jacob MacDonald,D,COL,31,53,11,9,20
70,8480835,Jack Drury,C,CAR,24,61,10,10,20
70,8477839,Conor Sheary,L,TBL,32,81,10,10,20
70,8478508,Yakov Trenin,C,MIN,27,59,10,10,20
70,8473533,Jordan Staal,C,CAR,36,60,9,11,20
70,8476889,Radek Faksa,C,STL,30,62,9,11,20
70,8480289,Morgan Barron,C,WPG,26,54,8,12,20
70,8475791,Taylor Hall,L,CHI,33,60,7,13,20
70,8477478,William Carrier,L,CAR,30,64,6,14,20
70,8478443,Brandon Carlo,D,BOS,28,60,5,15,20
70,8475324,Nick Jensen,D,OTT,34,67,3,17,20
70,8480035,Henri Jokiharju,D,BUF,25,63,2,18,20
70,8477845,Trevor van Riemsdyk,D,WSH,33,56,2,18,20
70,8476921,Jordan Martinook,L,CAR,32,61,11,8,19
70,8481032,Paul Cotter,C,NJD,25,65,9,10,19
70,8481013,Jonatan Berggren,R,DET,24,65,9,10,19
70,8475855,Jesper Fast,R,CAR,33,56,8,11,19
70,8480205,Emil Bemstrom,C,PIT,25,56,7,12,19
70,8483482,Tristan Luneau,D,ANA,20,67,6,13,19
70,8484149,Gavin Brindley,C,CBJ,20,45,6,13,19
70,8477425,Miles Wood,L,COL,29,80,5,14,19
70,8478434,Keegan Kolesar,R,VGK,27,61,5,14,19
70,8482148,Hendrix Lapierre,C,WSH,22,51,5,14,19
70,8475188,Brayden McNabb,D,VGK,33,55,5,14,19
70,8478851,Alexandre Carrier,D,NSH,28,70,4,15,19
70,8480172,Jan Rutta,D,SJS,34,67,4,15,19
70,8477499,Rasmus Ristolainen,D,PHI,30,61,2,17,19
70,8475179,Dmitry Kulikov,D,FLA,34,60,2,17,19
70,8478840,Will Borgen,D,SEA,28,67,1,18,19
70,8480049,Dylan Samberg,D,WPG,25,66,0,19,19
70,8476891,Matthew Grzelcyk,D,PIT,30,74,0,19,19
70,8482679,Matt Coronato,R,CGY,22,67,10,8,18
70,8479414,Nathan Bastian,R,NJD,27,64,10,8,18
70,8477380,Jonny Brodzinski,C,NYR,31,55,10,8,18
70,8479941,Justin Danforth,R,CBJ,31,58,9,9,18
70,8479661,Tanner Jeannot,L,LAK,27,77,9,9,18
70,8481028,Martin Pospisil,C,CGY,25,61,8,10,18
70,8479316,Luke Kunin,C,SJS,27,64,7,11,18
70,8479026,Philippe Myers,D,TOR,27,47,7,11,18
70,8481599,Victor Soderstrom,D,UTA,23,54,5,13,18
70,8477015,Connor Brown,R,EDM,30,65,4,14,18
70,8481550,Adam Beckman,L,NJD,23,37,4,14,18
70,8475462,Radko Gudas,D,ANA,34,64,4,14,18
70,8479372,Joshua Mahura,D,SEA,26,49,2,16,18
70,8480891,Michael Kesselring,D,UTA,24,50,1,17,18
70,8482062,Cole Smith,L,NSH,29,49,13,4,17
70,8479619,Michael Carcone,L,UTA,28,62,11,6,17
70,8482077,Dylan Holloway,L,EDM,23,54,11,6,17
70,8480762,Eric Robinson,L,CAR,29,60,10,7,17
70,8475220,Marcus Foligno,L,MIN,33,63,8,9,17
70,8480281,Alexey Toropchenko,R,STL,25,63,8,9,17
70,8477220,Nate Schmidt,D,FLA,33,67,7,10,17
70,8477903,Garnet Hathaway,R,PHI,33,58,7,10,17
70,8475762,Derek Forbort,D,VAN,32,47,6,11,17
70,8480073,Erik Brannstrom,D,COL,25,63,4,13,17
70,8480727,Zach Whitecloud,D,VGK,28,53,4,13,17
70,8476917,Adam Pelech,D,NYI,30,78,3,14,17
70,8479639,Dylan Coghlan,D,WPG,26,60,3,14,17
70,8476879,Cody Ceci,D,EDM,31,69,3,14,17
70,8471677,Jack Johnson,D,CBJ,37,64,3,14,17
70,8480001,Urho Vaakanainen,D,ANA,25,65,2,15,17
70,8475279,Ben Chiarot,D,DET,33,66,2,15,17
70,8481059,Scott Perunovich,D,STL,26,64,1,16,17
70,8480873,Rasmus Sandin,D,WSH,24,60,0,17,17
70,8481708,Zac Jones,D,NYR,24,51,0,17,17
70,8477450,Jason Dickinson,C,CHI,29,53,11,5,16
70,8481641,Joel Kiviranta,L,COL,28,65,10,6,16
70,8479359,Beck Malenstyn,L,BUF,26,53,9,7,16
70,8482157,Will Cuylle,L,NYR,22,56,8,8,16
70,8476467,Jamie Oleksiak,D,SEA,32,67,7,9,16
70,8479370,Tyson Jost,C,CAR,26,52,7,9,16
70,8479315,Joey Anderson,R,CHI,26,50,6,10,16
70,8480021,Jack Studnicka,C,LAK,25,57,6,10,16
70,8478432,Christian Fischer,R,DET,27,76,5,11,16
70,8476429,Scott Mayfield,D,NYI,32,75,5,11,16
70,8476312,Josh Manson,D,COL,33,55,5,11,16
70,8478017,Mark Friedman,D,VAN,29,41,5,11,16
70,8479371,Dante Fabbro,D,NSH,26,64,4,12,16
70,8481019,David Gustafsson,C,WPG,24,51,4,12,16
70,8482073,Braden Schneider,D,NYR,23,66,3,13,16
70,8482451,Mikael Pyyhtia,L,CBJ,23,43,3,13,16
70,8471709,Marc-Edouard Vlasic,D,SJS,37,62,3,13,16
70,8480157,Calle Rosen,D,COL,30,47,3,13,16
70,8482245,Artem Zub,D,OTT,29,66,2,14,16
70,8482067,Connor Mackey,D,NYR,28,62,1,15,16
70,8478452,Caleb Jones,D,LAK,27,54,1,15,16
70,8480980,Connor Dewar,C,TOR,25,66,9,6,15
70,8481601,Simon Holmstrom,R,NYI,23,63,9,6,15
70,8480025,MacKenzie Entwistle,R,FLA,25,65,9,6,15
70,8476374,Sean Kuraly,C,CBJ,31,57,8,7,15
70,8479671,Mathieu Olivier,R,CBJ,27,50,8,7,15
70,8480011,Klim Kostin,C,SJS,25,53,7,8,15
70,8480806,Isac Lundestrom,C,ANA,25,59,5,10,15
70,8479324,Ryan Lindgren,D,NYR,26,63,5,10,15
70,8480192,Johnathan Kovacevic,D,NJD,27,59,4,11,15
70,8476874,Olli Maatta,D,DET,30,65,4,11,15
70,8476988,Matt Benning,D,SJS,30,61,3,12,15
70,8482087,Kaiden Guhle,D,MTL,22,70,3,12,15
70,8478399,Jonas Siegenthaler,D,NJD,27,64,2,13,15
70,8480043,Timothy Liljegren,D,TOR,25,63,1,14,15
70,8481014,Alexander Romanov,D,NYI,24,77,1,14,15
70,8481568,Alex Vlasic,D,CHI,23,47,1,14,15
70,8475233,David Savard,D,MTL,34,65,1,14,15
70,8480058,Pierre-Olivier Joseph,D,STL,25,57,1,14,15
70,8481716,Dmitri Voronkov,L,CBJ,24,51,10,4,14
70,8482744,James Malatesta,L,CBJ,21,39,10,4,14
70,8480355,Mark Kastelic,C,BOS,25,57,8,6,14
70,8482803,Olen Zellweger,D,ANA,21,65,8,6,14
70,8476624,Barclay Goodrow,C,SJS,31,55,7,7,14
70,8476329,Travis Boyd,C,MIN,31,53,5,9,14
70,8476442,Matt Nieto,L,PIT,32,46,5,9,14
70,8470600,Ryan Suter,D,STL,39,59,4,10,14
70,8481537,Nikita Okhotiuk,D,CGY,24,53,4,10,14
70,8480796,Martin Fehervary,D,WSH,25,53,4,10,14
70,8482095,Tyler Kleven,D,OTT,22,44,4,10,14
70,8481600,Tobias Bjornfot,D,FLA,23,46,3,11,14
70,8475718,Justin Holl,D,DET,32,62,2,12,14
70,8476331,Dylan DeMelo,D,WPG,31,72,1,13,14
70,8482634,Alex Steeves,C,TOR,25,43,1,13,14
70,8479982,Conor Timmins,D,TOR,26,67,0,14,14
70,8481518,Nolan Foote,L,NJD,24,35,9,4,13
70,8477446,Michael McCarron,R,NSH,29,51,7,6,13
70,8480848,Ty Dellandrea,C,SJS,24,52,7,6,13
70,8477938,Haydn Fleury,D,WPG,28,47,6,7,13
70,8481517,Brett Leason,R,ANA,25,59,6,7,13
70,8482807,Ethan Del Mastro,D,CHI,21,53,5,8,13
70,8481598,Philip Broberg,D,EDM,23,37,3,10,13
70,8481178,Egor Zamula,D,PHI,24,55,1,12,13
70,8482784,Zach Dean,C,STL,21,39,9,3,12
70,8482166,Shakir Mukhamadullin,D,SJS,22,60,7,5,12
70,8481617,Vasily Podkolzin,R,VAN,23,49,7,5,12
70,8479344,Jesse Puljujarvi,R,PIT,26,50,7,5,12
70,8474034,Patrick Maroon,L,CHI,36,50,6,6,12
70,8478569,Noel Acciari,C,PIT,33,60,6,6,12
70,8479520,Brandon Duhaime,R,WSH,27,58,6,6,12
70,8482659,Josh Doan,R,UTA,22,55,6,6,12
70,8479968,Vinni Lettieri,C,BOS,29,46,6,6,12
70,8477573,Nathan Walker,L,STL,30,41,5,7,12
70,8476994,Vinnie Hinostroza,C,NSH,30,48,5,7,12
70,8480845,Rasmus Kupari,C,WPG,24,41,5,7,12
70,8479291,Kevin Rooney,C,CGY,31,52,5,7,12
70,8483495,Simon Nemec,D,NJD,20,54,5,7,12
70,8482496,Nils Aman,C,VAN,24,32,5,7,12
70,8480222,Sebastian Aho,D,PIT,28,70,4,8,12
70,8473446,Erik Johnson,D,PHI,36,39,4,8,12
70,8476525,Colin Miller,D,WPG,32,60,3,9,12
70,8477508,Curtis Lazar,C,NJD,29,56,3,9,12
70,8474567,Zach Bogosian,D,MIN,34,60,3,9,12
70,8479543,Michael Pezzetta,L,MTL,26,58,3,9,12
70,8479980,Nicolas Hague,D,VGK,26,48,3,9,12
70,8477931,Tomas Nosek,L,FLA,32,60,2,10,12
70,8475455,Brenden Dillon,D,NJD,34,59,2,10,12
70,8482859,Zack Ostapchuk,C,OTT,21,57,2,10,12
70,8480196,Jacob Bryson,D,BUF,27,46,2,10,12
70,8474090,Brendan Smith,D,DAL,35,51,2,10,12
70,8475690,Chris Tanev,D,TOR,35,52,1,11,12
70,8479998,Mikey Anderson,D,LAK,25,58,0,12,12
70,8476934,Brock McGinn,L,ANA,30,55,7,4,11
70,8479944,Zach Aston-Reese,C,VGK,30,51,7,4,11
70,8478424,Jansen Harkins,C,ANA,27,46,7,4,11
70,8478211,Dryden Hunt,L,CGY,29,49,6,5,11
70,8478451,Ethan Bear,D,WSH,27,51,6,5,11
70,8482737,Zack Bolduc,C,STL,21,60,5,6,11
70,8480844,Grigori Denisenko,L,VGK,24,29,5,6,11
70,8481441,Joe Snively,C,DET,28,57,4,7,11
70,8479718,Alex Barré-Boulet,C,MTL,27,53,4,7,11
70,8478468,Jeremy Lauzon,D,NSH,27,56,4,7,11
70,8482145,Mavrik Bourque,C,DAL,22,52,4,7,11
70,8482176,Wyatt Kaiser,D,CHI,22,55,2,9,11
70,8478416,Erik Cernak,D,TBL,27,73,1,10,11
70,8480807,Mattias Samuelsson,D,BUF,24,60,1,10,11
70,8480879,Jacob Bernard-Docker,D,OTT,24,43,1,10,11
70,8476372,Nick Seeler,D,PHI,31,46,1,10,11
70,8484254,Akito Hirose,D,VAN,25,35,0,11,11
70,8476873,Mark Jankowski,C,NSH,30,50,6,4,10
70,8471817,Ryan Reaves,R,TOR,37,50,6,4,10
70,8482070,Mitchell Chaffee,R,TBL,26,57,6,4,10
70,8478421,A.J. Greer,L,FLA,28,56,5,5,10
70,8479442,Troy Stecher,D,EDM,30,51,5,5,10
70,8476822,Luke Glendening,C,TBL,35,79,4,6,10
70,8481701,Santeri Hatakka,D,NJD,23,33,4,6,10
70,8476867,Brendan Gaunce,C,MIN,30,34,4,6,10
70,8483619,Filip Roos,D,OTT,25,38,4,6,10
70,8478970,Jalen Chatfield,D,CAR,28,71,3,7,10
70,8482730,Brandt Clarke,D,LAK,21,54,3,7,10
70,8474166,Alec Martinez,D,CHI,37,53,3,7,10
70,8478859,Niko Mikkola,D,FLA,28,57,3,7,10
70,8482666,Scott Morrow,D,CAR,22,53,3,7,10
70,8479986,Kole Lind,R,DAL,26,50,3,7,10
70,8476952,Dominic Toninato,C,WPG,30,30,3,7,10
70,8482747,Brennan Othmann,L,NYR,21,53,3,7,10
70,8482762,Simon Edvinsson,D,DET,21,49,2,8,10
70,8483549,Lucas Condotta,L,MTL,27,40,2,8,10
70,8480887,Jordan Harris,D,MTL,24,50,1,9,10
70,8477365,Connor Clifton,D,BUF,29,44,1,9,10
70,8475177,Calvin de Haan,D,COL,33,44,1,9,10
70,8474013,Ian Cole,D,UTA,35,55,1,9,10
70,8477851,Jordan Oesterle,D,BOS,32,36,7,2,9
70,8481556,John Beecher,C,BOS,23,30,6,3,9
70,8479368,Max Jones,L,BOS,26,60,4,5,9
70,8481147,Reese Johnson,C,MIN,26,38,4,5,9
70,8477335,Kyle Burroughs,D,LAK,29,41,4,5,9
70,8482765,Isak Rosen,R,BUF,21,31,4,5,9
70,8477482,Zachary Sanford,L,CHI,30,36,4,5,9
70,8477018,Ben Hutton,D,VGK,31,46,3,6,9
70,8480292,Carson Meyer,R,ANA,27,31,3,6,9
70,8481567,Henry Thrun,D,SJS,23,45,2,7,9
70,8475750,Jon Merrill,D,MIN,32,61,2,7,9
70,8478831,Kevin Stenlund,C,UTA,28,52,1,8,9
70,8482652,Walker Duehr,R,CGY,27,35,1,8,9
70,8477887,Patrick Brown,C,BOS,32,46,0,9,9
70,8479378,Logan Stanley,D,WPG,26,41,5,3,8
70,8478409,Anthony Richard,C,PHI,28,33,5,3,8
70,8475235,Nicolas Deslauriers,L,PHI,33,58,5,3,8
70,8475225,Craig Smith,C,CHI,35,47,4,4,8
70,8480441,Trey Fix-Wolansky,R,CBJ,25,41,4,4,8
70,8481532,Alex Turcotte,C,LAK,23,42,4,4,8
70,8479972,Mason Shaw,C,WPG,26,40,4,4,8
70,8479772,Zack MacEwen,R,OTT,28,62,4,4,8
70,8479981,Jonah Gadjovich,L,FLA,26,42,3,5,8
70,8477401,John Hayden,C,SEA,29,33,3,5,8
70,8484911,Collin Graf,R,SJS,22,36,3,5,8
70,8477962,Brendan Lemieux,L,CAR,28,40,3,5,8
70,8481161,Jake Christiansen,D,CBJ,25,53,2,6,8
70,8481751,Lukas Rousek,R,BUF,25,31,2,6,8
70,8474568,Luke Schenn,D,NSH,35,48,1,7,8
70,8479249,Andrew Poturalski,C,SJS,30,38,0,8,8
70,8481122,Simon Benoit,D,TOR,26,43,0,8,8
70,8476858,Phillip Di Giuseppe,L,VAN,31,34,4,3,7
70,8481789,Tye Kartye,L,SEA,23,37,4,3,7
70,8480252,Cole Guttman,C,CHI,25,29,3,4,7
70,8481754,Nikita Nesterenko,C,ANA,23,43,3,4,7
70,8481167,Brayden Pachal,D,CGY,25,52,3,4,7
70,8482751,Ryan Winterton,C,SEA,21,35,3,4,7
70,8480890,Jan Jenik,C,OTT,24,27,3,4,7
70,8479348,Kale Clague,D,BUF,26,38,2,5,7
70,8480007,Jonas Rondbjerg,R,VGK,25,42,2,5,7
70,8477384,Joshua Brown,D,EDM,30,48,2,5,7
70,8483460,David Jiricek,D,CBJ,21,59,2,5,7
70,8474612,Travis Hamonic,D,OTT,34,48,2,5,7
70,8482964,Arber Xhekaj,D,MTL,23,47,2,5,7
70,8478450,Parker Wotherspoon,D,BOS,27,34,2,5,7
70,8476473,Connor Murphy,D,CHI,31,42,2,5,7
70,8476913,Devin Shore,C,MIN,30,37,2,5,7
70,8478874,Adam Gaudette,R,OTT,28,41,2,5,7
70,8481543,Nikita Alexandrov,C,STL,24,24,2,5,7
70,8478146,Matthew Highmore,C,OTT,28,32,1,6,7
70,8479369,Andrew Peeke,D,BOS,26,59,0,7,7
70,8479320,Maxime Lajoie,D,SEA,27,25,0,7,7
70,8479638,Justin Brazeau,R,BOS,26,43,5,1,6
70,8480070,Ian Mitchell,D,BOS,25,51,3,3,6
70,8483397,Marc McLaughlin,C,BOS,25,33,3,3,6
70,8477070,Liam O'Brien,C,UTA,30,47,2,4,6
70,8480834,Ty Emberson,D,SJS,24,29,2,4,6
70,8482733,Logan Mailloux,D,MTL,31,36,2,4,6
70,8480870,Bo Groulx,C,NYR,24,23,2,4,6
70,8482861,Vincent Iorio,D,WSH,22,32,2,4,6
70,8481605,Jackson LaCombe,D,ANA,23,32,1,5,6
70,8478454,Noah Juulsen,D,VAN,27,33,1,5,6
70,8482144,Jack Thompson,D,SJS,22,29,1,5,6
70,8480950,Ilya Lyubushkin,D,DAL,30,55,0,6,6
70,8477034,Jaycob Megna,D,FLA,32,38,0,6,6
70,8481679,Maxence Guenette,D,OTT,23,29,4,1,5
70,8479536,Axel Jonsson-Fjallby,L,WPG,26,37,3,2,5
70,8484287,Cole McWard,D,VAN,23,23,3,2,5
70,8482177,Marat Khusnutdinov,C,MIN,22,27,3,2,5
70,8479994,Jaret Anderson-Dolan,C,WPG,25,32,2,3,5
70,8477462,Robert Hagg,D,VGK,29,27,2,3,5
70,8480851,Akil Thomas,C,LAK,24,18,2,3,5
70,8483466,Kevin Korchinski,D,CHI,20,52,1,4,5
70,8480267,Sammy Walker,C,MIN,25,22,1,4,5
70,8476441,Joel Edmundson,D,LAK,31,37,0,5,5
70,8479576,Vincent Desharnais,D,VAN,28,29,0,5,5
70,8483630,Pavol Regenda,L,ANA,25,22,4,0,4
70,8480880,Jakub Lauko,C,MIN,24,33,3,1,4
70,8480032,Shane Bowers,C,NJD,25,13,3,1,4
70,8483012,Logan Morrison,C,SEA,22,32,2,2,4
70,8480990,Declan Chisholm,D,MIN,24,38,2,2,4
70,8484325,Waltteri Merela,C,TBL,26,17,2,2,4
70,8482147,Jean-Luc Foudy,C,COL,22,20,2,2,4
70,8482713,Mackie Samoskevich,R,FLA,22,36,2,2,4
70,8479367,William Lockwood,R,FLA,26,26,2,2,4
70,8481462,Mason Morelli,L,VGK,28,14,2,2,4
70,8481609,Vladislav Kolyachonok,D,UTA,23,37,1,3,4
70,8479985,Cale Fleury,D,SEA,26,28,1,3,4
70,8480245,Olle Lycksell,R,PHI,25,33,1,3,4
70,8482250,Callahan Burke,C,VGK,27,26,1,3,4
70,8481699,Aku Raty,R,UTA,23,18,1,3,4
70,8481743,Marc Del Gaizo,D,NSH,25,22,1,3,4
70,8477810,Joel Hanley,D,CGY,33,23,1,3,4
70,8477527,Ross Johnston,L,ANA,30,33,0,4,4
70,8477073,Kurtis MacDermid,L,NJD,30,29,0,4,4
70,8482858,Ryker Evans,D,SEA,23,22,0,4,4
70,8483395,Arshdeep Bains,L,VAN,23,13,0,4,4
70,8482153,Brendan Brisson,C,VGK,23,31,2,1,3
70,8475958,Michael Sgarbossa,C,WSH,32,29,2,1,3
70,8479362,Riley Tufte,L,BOS,26,16,2,1,3
70,8482172,Landon Slaggert,L,CHI,22,29,2,1,3
70,8482088,Justin Sourdif,R,FLA,22,13,2,1,3
70,8482201,Gage Goncalves,C,TBL,23,24,2,1,3
70,8483567,Georgii Merkulov,C,BOS,24,15,2,1,3
70,8479419,Brett Murray,L,BUF,26,19,1,2,3
70,8482165,Yan Kuznetsov,D,CGY,22,26,1,2,3
70,8479379,Givani Smith,R,SJS,26,30,1,2,3
70,8478502,Dennis Gilbert,D,BUF,28,19,1,2,3
70,8482141,Lukas Cormier,D,VGK,22,22,1,2,3
70,8479991,Jake Leschyshyn,C,NYR,25,23,1,2,3
70,8477971,Andreas Englund,D,LAK,28,31,1,2,3
70,8475795,Dylan McIlrath,D,WSH,32,13,1,2,3
70,8481719,Maxwell Crozier,D,TBL,24,21,1,2,3
70,8481056,Spencer Stastney,D,NSH,24,28,0,3,3
70,8481592,Jakob Pelletier,L,CGY,23,35,0,3,3
70,8482511,Mason Lohrei,D,BOS,23,30,0,3,3
70,8482929,Emil Lilleberg,D,TBL,23,25,0,3,3
70,8483398,Declan Carlile,D,TBL,31,9,0,3,3
70,8482094,Daemon Hunt,D,MIN,22,19,0,3,3
70,8480468,James Hamblin,L,EDM,25,19,2,0,2
70,8483432,Luca Del Bel Belluz,C,CBJ,31,6,2,0,2
70,8483763,Maksymilian Szuber,D,UTA,22,27,1,1,2
70,8478021,William Lagesson,D,DET,28,21,1,1,2
70,8477320,Anton Blidh,L,NYR,29,25,1,1,2
70,8477541,Dakota Mermis,D,TOR,30,14,1,1,2
70,8478477,Mitchell Stephens,C,SEA,27,22,1,1,2
70,8483471,Brad Lambert,C,WPG,31,9,1,1,2
70,8479587,Rhett Gardner,C,PHI,28,19,1,1,2
70,8478881,Brett Seney,L,CHI,28,14,1,1,2
70,8481585,Egor Afanasyev,L,SJS,23,14,1,1,2
70,8483489,Fraser Minten,C,TOR,31,15,1,1,2
70,8480823,Alexander Alexeyev,D,WSH,25,15,1,1,2
70,8484258,Sam Malinski,D,COL,26,20,0,2,2
70,8478446,Glenn Gawdin,C,LAK,27,13,0,2,2
70,8474062,Riley Nash,C,NYR,35,14,0,2,2
70,8483512,Matthew Savoie,C,EDM,20,20,0,2,2
70,8480084,Nick DeSimone,D,NJD,30,14,0,2,2
70,8481578,Graeme Clarke,R,MIN,23,8,0,2,2
70,8477473,Justin Bailey,R,SJS,29,23,1,0,1
70,8477244,Chad Ruhwedel,D,NYR,34,30,1,0,1
70,8481065,Angus Crookshank,L,OTT,25,8,1,0,1
70,8482061,Brandon Biro,L,SEA,26,16,1,0,1
70,8483570,Ben Meyers,C,SEA,26,25,1,0,1
70,8477467,Gustav Olofsson,D,SEA,30,19,1,0,1
70,8482102,Vasily Ponomarev,C,PIT,22,20,1,0,1
70,8482162,Roby Jarventie,L,EDM,22,17,1,0,1
70,8484304,Uvis Balinskis,D,FLA,28,12,1,0,1
70,8481043,Cole Koepke,L,BOS,26,17,1,0,1
70,8478051,Max Willman,C,NJD,29,14,1,0,1
70,8482787,Nikita Chibrikov,R,WPG,31,3,1,0,1
70,8482197,Adam Raska,R,MIN,23,6,1,0,1
70,8481655,Cole Schwindt,R,CGY,23,5,1,0,1
70,8483531,Brian Halonen,L,NJD,25,2,1,0,1
70,8481237,Kyle MacLean,C,NYI,25,16,0,1,1
70,8481541,Samuel Bolduc,D,NYI,24,25,0,1,1
70,8482516,Matthew Kessel,D,STL,24,15,0,1,1
70,8482118,Sam Colangelo,R,ANA,23,15,0,1,1
70,8482470,Ilya Solovyov,D,CGY,24,12,0,1,1
70,8475413,Justin Dowling,C,NJD,34,10,0,1,1
70,8481006,Tyler Tucker,D,STL,24,14,0,1,1
70,8480874,Adam Ginning,D,PHI,24,11,0,1,1
70,8481030,Jack St. Ivany,D,PIT,25,14,0,1,1
70,8479330,Brandon Gignac,C,MTL,27,9,0,1,1
70,8475755,Alexander Petrovic,D,DAL,32,9,0,1,1
70,8484255,Jason Polin,R,COL,25,7,0,1,1
70,8481806,Louis Crevier,D,CHI,23,11,0,1,1
70,8476323,Max McCormick,L,SEA,32,4,0,1,1
70,8481726,Adam Edstrom,C,NYR,24,10,0,1,1
70,8483597,Milos Kelemen,L,UTA,25,17,0,1,1
70,8479421,Jacob Moverare,D,LAK,26,9,0,1,1
70,8477149,Scott Sabourin,R,SJS,32,11,0,0,0
70,8481593,Jayden Struble,D,MTL,23,14,0,0,0
70,8481422,Jake Lucchini,C,NSH,29,17,0,0,0
70,8482460,Matt Rempe,C,NYR,22,13,0,0,0
70,8478011,Louie Belpedio,D,PHI,28,10,0,0,0
70,8483407,Brandon Scanlin,D,NYR,25,6,0,0,0
70,8480075,Cameron Crotty,D,MIN,25,13,0,0,0
70,8480306,Grant Hutton,D,NYI,29,6,0,0,0
70,8475780,Chris Wagner,R,COL,33,4,0,0,0
70,8481534,Raphael Lavoie,C,EDM,24,3,0,0,0
70,8483920,Pierrick Dube,R,WSH,23,2,0,0,0
70,8481024,Linus Karlsson,C,VAN,25,6,0,0,0
70,8481564,Ryan Johnson,D,BUF,23,11,0,0,0
70,8481206,John Ludvig,D,PIT,24,14,0,0,0
70,8482476,Emil Heineman,L,MTL,23,6,0,0,0
70,8482126,Emil Andrae,D,PHI,31,2,0,0,0
70,8478854,Ryan Shea,D,PIT,27,8,0,0,0
70,8477993,Justin Kirkland,C,CGY,28,3,0,0,0
70,8484326,Patrik Koch,D,UTA,28,2,0,0,0
70,8483609,Adam Klapka,R,CGY,24,4,0,0,0
70,8483401,Marc Johnstone,R,PIT,28,2,0,0,0
70,8478147,Bokondji Imama,L,PIT,28,6,0,0,0
70,8483546,Marshall Rifai,D,TOR,26,1,0,0,0
70,8484259,Ondrej Pavel,C,COL,31,3,0,0,0
70,8479522,Hardy Haman Aktell,D,WSH,26,5,0,0,0
70,8484321,Nikolas Matinpalo,D,OTT,26,4,0,0,0
70,8480274,Philip Kemp,D,EDM,25,0,0,0,0
70,8470794,Joe Pavelski,C,,40,0,0,0,0
70,8479321,Lucas Johansen,D,,27,0,0,0,0
70,8477950,Tony DeAngelo,D,,29,0,0,0,0
70,8471218,Blake Wheeler,R,,38,0,0,0,0
70,8475197,Tyson Barrie,D,,33,0,0,0,0
70,8474157,Max Pacioretty,L,,36,0,0,0,0
70,8475744,Evgeny Kuznetsov,C,,32,0,0,0,0
70,8474037,James van Riemsdyk,L,,35,0,0,0,0
70,8476907,Mackenzie MacEachern,L,,30,0,0,0,0
70,8480216,Jacob Peterson,C,,25,0,0,0,0
70,8474602,Justin Schultz,D,,34,0,0,0,0
70,8482222,Alexander Barabanov,L,,30,0,0,0,0
70,8474031,Kevin Shattenkirk,D,,35,0,0,0,0
70,8477330,Dominik Kubalik,L,,29,0,0,0,0
70,8480884,Calen Addison,D,,24,0,0,0,0
70,8475906,John Klingberg,D,,32,0,0,0,0
70,8480008,Adam Ruzicka,C,,25,0,0,0,0
70,8476884,Derrick Pouliot,D,,30,0,0,0,0
70,8476919,Chris Tierney,C,,30,0,0,0,0
70,8479415,Michael McLeod,C,,26,0,0,0,0
70,8474870,Tyler Johnson,C,,34,0,0,0,0
70,8470604,Jeff Carter,C,,39,0,0,0,0
70,8478104,Sammy Blais,L,,28,0,0,0,0
70,8474884,Mike Hoffman,C,,35,0,0,0,0
70,8481591,Sam Poulin,R,,23,0,0,0,0
70,8471274,Alex Goligoski,D,,39,0,0,0,0
70,8476871,Tanner Pearson,L,,32,0,0,0,0
70,8476393,Nick Cousins,C,,31,0,0,0,0
70,8479977,Kailer Yamamoto,R,,26,0,0,0,0
70,8479346,Dillon Dube,C,,26,0,0,0,0
70,8480184,Gustav Lindstrom,D,,26,0,0,0,0
70,8479376,Victor Mete,D,,26,0,0,0,0
70,8473449,Kyle Okposo,R,,36,0,0,0,0
70,8481058,Jesse Ylonen,R,,25,0,0,0,0
70,8475752,Tyler Pitlick,C,,33,0,0,0,0
70,8481239,Samuel Fagemo,L,,24,0,0,0,0
70,8480821,Filip Zadina,R,,25,0,0,0,0
70,8470966,Mark Giordano,D,,41,0,0,0,0
70,8478495,Denis Gurianov,R,,27,0,0,0,0
70,8477464,Nic Petan,C,,29,0,0,0,0
70,8478099,Kevin Labanc,R,,29,0,0,0,0
70,8482241,Radim Zohorna,L,,28,0,0,0,0
70,8474040,Sam Gagner,C,,35,0,0,0,0
70,8479514,Rem Pitlick,C,,27,0,0,0,0
70,8478430,Oliver Kylington,D,,27,0,0,0,0
70,8479533,Joona Koppanen,L,,26,0,0,0,0
70,8479984,Cal Foote,D,,26,0,0,0,0
70,8477126,Jayson Megna,C,,34,0,0,0,0
70,8475164,Jakob Silfverberg,R,,34,0,0,0,0
70,8474009,Nick Bonino,C,,36,0,0,0,0
70,8479458,Nikita Zaitsev,D,,33,0,0,0,0
70,8477944,Jakub Vrana,L,,28,0,0,0,0
70,8471699,Andrew Cogliano,C,,37,0,0,0,0
70,8478067,Oskar Lindblom,L,,28,0,0,0,0
70,8471686,Marc Staal,D,,37,0,0,0,0
70,8470610,Zach Parise,L,,40,0,0,0,0
70,8478904,Steven Lorentz,C,,28,0,0,0,0
70,8473473,Milan Lucic,L,,36,0,0,0,0
70,8480031,Maxime Comtois,L,,25,0,0,0,0
70,8478512,Austin Czarnik,C,,32,0,0,0,0
70,8473504,Cal Clutterbuck,R,,37,0,0,0,0
70,8477454,Adam Erne,L,,29,0,0,0,0
70,8479383,Boris Katchouk,L,,26,0,0,0,0
70,8475825,Jani Hakanpää,D,,32,0,0,0,0
70,8477846,Ryan Carpenter,C,,33,0,0,0,0
70,8477930,Pierre-Edouard Bellemare,L,,39,0,0,0,0
70,8478400,Colin White,C,,27,0,0,0,0
70,8480226,Marián Studenic,R,,26,0,0,0,0
70,8480853,Liam Foudy,C,,24,0,0,0,0
70,8475797,Jarred Tinordi,D,,32,0,0,0,0
70,8479423,Alex Nylander,L,,26,0,0,0,0
70,8474618,Marco Scandella,D,,34,0,0,0,0
70,8478028,Fredrik Olofsson,L,,28,0,0,0,0
70,8474709,Matt Martin,L,,35,0,0,0,0
70,8481070,Hugh McGing,L,,26,0,0,0,0
70,8479546,Oskar Steen,C,,26,0,0,0,0
70,8474145,Robert Bortuzzo,D,,35,0,0,0,0
70,8476915,Jujhar Khaira,L,,30,0,0,0,0
70,8475278,Byron Froese,C,,33,0,0,0,0
70,8481812,Nikolai Knyzhov,D,,27,0,0,0,0
70,8478408,Travis Dermott,D,,28,0,0,0,0
70,8481077,John Leonard,L,,26,0,0,0,0
70,8479547,Matthew Phillips,R,,26,0,0,0,0
70,8480836,Jonathan Gruden,C,,24,0,0,0,0
70,8481690,Tyler Angle,C,,24,0,0,0,0
70,8475766,Austin Watson,L,,32,0,0,0,0
70,8481016,Ruslan Iskhakov,C,,24,0,0,0,0
70,8478078,Rourke Chartier,C,,28,0,0,0,0
70,8480776,Sheldon Rempal,R,,29,0,0,0,0
70,8478956,Samuel Laberge,L,NJD,27,2,0,0,0
70,8483045,Cameron Butler,R,CBJ,31,0,0,0,0
70,8484314,Jiri Smejkal,L,,28,0,0,0,0
71,8478420,Mikko Rantanen,R,COL,28,82,45,79,124
71,8476453,Nikita Kucherov,R,TBL,31,82,35,88,123
71,8479318,Auston Matthews,C,TOR,27,80,67,52,119
71,8477492,Nathan MacKinnon,C,COL,29,82,40,75,115
71,8481559,Jack Hughes,C,NJD,23,73,54,60,114
71,8477956,David Pastrnak,R,BOS,28,77,50,61,111
71,8478402,Connor McDavid,C,EDM,27,79,21,89,110
71,8477934,Leon Draisaitl,C,EDM,29,80,35,74,109
71,8478550,Artemi Panarin,L,NYR,33,79,37,71,108
71,8476468,J.T. Miller,C,VAN,31,73,31,74,105
71,8478864,Kirill Kaprizov,L,MIN,27,77,40,63,103
71,8478427,Sebastian Aho,C,CAR,27,72,40,63,103
71,8477939,William Nylander,R,TOR,28,79,44,55,99
71,8480069,Cale Makar,D,COL,26,71,26,73,99
71,8471675,Sidney Crosby,C,PIT,37,74,36,62,98
71,8474600,Roman Josi,D,NSH,34,78,25,72,97
71,8476887,Filip Forsberg,L,NSH,30,73,46,50,96
71,8480036,Miro Heiskanen,D,DAL,25,79,14,82,96
71,8477942,Kevin Fiala,L,LAK,28,82,35,59,94
71,8480027,Jason Robertson,L,DAL,25,82,28,65,93
71,8478483,Mitch Marner,R,TOR,27,79,26,67,93
71,8477404,Jake Guentzel,C,TBL,30,82,35,57,92
71,8477493,Aleksander Barkov,C,FLA,29,80,30,62,92
71,8478010,Brayden Point,C,TBL,28,82,42,48,90
71,8477946,Dylan Larkin,C,DET,28,81,42,46,88
71,8482116,Tim Stützle,C,OTT,22,80,31,56,87
71,8477933,Sam Reinhart,C,FLA,29,77,35,51,86
71,8471215,Evgeni Malkin,C,PIT,38,76,35,51,86
71,8476539,Jonathan Marchessault,R,NSH,34,74,43,42,85
71,8478414,Timo Meier,R,NJD,28,76,34,51,85
71,8478403,Jack Eichel,C,VGK,28,77,39,45,84
71,8480018,Nick Suzuki,C,MTL,25,78,34,50,84
71,8475810,Bryan Rust,R,PIT,32,74,42,40,82
71,8475172,Nazem Kadri,C,CGY,34,77,31,51,82
71,8480023,Robert Thomas,C,STL,25,73,24,58,82
71,8479407,Jesper Bratt,L,NJD,26,78,30,51,81
71,8474564,Steven Stamkos,C,NSH,34,76,25,56,81
71,8480012,Elias Pettersson,C,VAN,26,74,30,49,79
71,8477960,Adrian Kempe,R,LAK,28,80,39,39,78
71,8475913,Mark Stone,R,VGK,32,70,33,45,78
71,8480800,Quinn Hughes,D,VAN,25,72,16,62,78
71,8476389,Vincent Trocheck,C,NYR,31,75,36,41,77
71,8478398,Kyle Connor,L,WPG,28,74,36,41,77
71,8479343,Clayton Keller,R,UTA,26,77,34,43,77
71,8479314,Matthew Tkachuk,L,FLA,27,79,18,59,77
71,8471214,Alex Ovechkin,L,WSH,39,67,37,39,76
71,8473419,Brad Marchand,L,BOS,36,79,36,40,76
71,8480002,Nico Hischier,C,NJD,25,73,29,47,76
71,8480801,Brady Tkachuk,L,OTT,25,80,38,37,75
71,8478449,Roope Hintz,C,DAL,28,81,34,41,75
71,8480208,Drake Batherson,R,OTT,26,79,25,50,75
71,8476346,Johnny Gaudreau,L,CBJ,31,72,14,61,75
71,8477501,Valeri Nichushkin,R,COL,29,81,43,31,74
71,8475754,Brock Nelson,C,NYI,33,78,29,45,74
71,8479385,Jordan Kyrou,C,STL,26,74,29,45,74
71,8478873,Troy Terry,R,ANA,27,79,25,49,74
71,8473994,Jamie Benn,L,DAL,35,82,20,54,74
71,8482740,Wyatt Johnston,C,DAL,21,82,46,27,73
71,8476459,Mika Zibanejad,C,NYR,31,77,30,43,73
71,8475765,Vladimir Tarasenko,R,DET,33,80,27,46,73
71,8476456,Jonathan Huberdeau,C,CGY,31,77,23,50,73
71,8482093,Seth Jarvis,C,CAR,22,70,30,42,72
71,8473512,Claude Giroux,R,OTT,36,78,26,46,72
71,8480839,Rasmus Dahlin,D,BUF,24,72,25,47,72
71,8477949,Alex Tuch,R,BUF,28,74,22,50,72
71,8476454,Ryan Nugent-Hopkins,C,EDM,31,79,19,53,72
71,8475167,Victor Hedman,D,TBL,34,81,15,56,71
71,8479323,Adam Fox,D,NYR,26,75,11,60,71
71,8478440,Dylan Strome,C,WSH,27,74,23,47,70
71,8478445,Mathew Barzal,C,NYI,27,77,20,50,70
71,8471685,Anze Kopitar,C,LAK,37,81,20,50,70
71,8481540,Cole Caufield,R,MTL,23,71,34,35,69
71,8477496,Elias Lindholm,C,BOS,30,80,24,45,69
71,8479420,Tage Thompson,C,BUF,27,76,32,36,68
71,8481557,Matt Boldy,L,MIN,23,70,31,36,67
71,8484144,Connor Bedard,C,CHI,19,65,26,41,67
71,8479337,Alex DeBrincat,R,DET,27,81,25,42,67
71,8475168,Matt Duchene,C,DAL,33,80,24,43,67
71,8474141,Patrick Kane,R,DET,36,80,22,45,67
71,8476853,Morgan Rielly,D,TOR,30,72,8,59,67
71,8477500,Bo Horvat,C,NYI,29,81,34,32,66
71,8476881,Tomas Hertl,C,VGK,31,73,27,39,66
71,8480039,Martin Necas,C,CAR,25,75,26,40,66
71,8480803,Evan Bouchard,D,EDM,25,74,11,55,66
71,8475786,Zach Hyman,L,EDM,32,76,34,31,65
71,8480830,Andrei Svechnikov,R,CAR,24,75,28,37,65
71,8474590,John Carlson,D,WSH,34,71,16,49,65
71,8475784,Jeff Skinner,C,EDM,32,80,32,32,64
71,8482078,Lucas Raymond,L,DET,22,78,31,33,64
71,8475166,John Tavares,C,TOR,34,74,29,34,63
71,8473986,Alex Killorn,L,ANA,35,69,29,34,63
71,8479542,Brandon Hagel,L,TBL,26,82,27,36,63
71,8478439,Travis Konecny,R,PHI,27,76,23,40,63
71,8484153,Leo Carlsson,C,ANA,20,76,21,42,63
71,8475692,Mats Zuccarello,R,MIN,37,74,10,53,63
71,8477409,Carter Verhaeghe,C,FLA,29,81,35,27,62
71,8478407,Vince Dunn,D,SEA,28,67,16,46,62
71,8478493,Joel Eriksson Ek,C,MIN,27,69,34,27,61
71,8477940,Nikolaj Ehlers,L,WPG,28,66,28,33,61
71,8476460,Mark Scheifele,C,WPG,31,70,28,33,61
71,8478401,Pavel Zacha,C,BOS,27,77,22,39,61
71,8474578,Erik Karlsson,D,PIT,34,78,14,47,61
71,8477504,Josh Morrissey,D,WPG,29,78,8,53,61
71,8479325,Charlie McAvoy,D,BOS,27,75,9,51,60
71,8477951,Nick Schmaltz,C,UTA,28,77,19,40,59
71,8478396,Noah Hanifin,D,VGK,27,68,19,40,59
71,8478460,Zach Werenski,D,CBJ,27,79,16,43,59
71,8475798,Mikael Granlund,C,SJS,32,72,15,44,59
71,8476875,Mike Matheson,D,MTL,30,76,11,48,59
71,8482109,Alexis Lafrenière,L,NYR,23,77,29,29,58
71,8477476,Artturi Lehkonen,L,COL,29,79,23,34,57
71,8477456,J.T. Compher,L,DET,29,81,21,36,57
71,8475158,Ryan O'Reilly,C,NSH,33,66,21,36,57
71,8477402,Pavel Buchnevich,L,STL,29,76,17,40,57
71,8479999,Casey Mittelstadt,C,COL,26,81,17,40,57
71,8477986,Brandon Montour,D,SEA,30,71,14,43,57
71,8480865,Noah Dobson,D,NYI,24,79,10,47,57
71,8477955,Jared McCann,L,SEA,28,75,26,30,56
71,8478366,Frank Vatrano,R,ANA,30,80,24,32,56
71,8478975,Mason Marchment,L,DAL,29,82,23,33,56
71,8474679,Gustav Nyquist,C,NSH,35,72,22,34,56
71,8476479,Phillip Danault,C,LAK,31,82,21,35,56
71,8476880,Tom Wilson,R,WSH,30,73,31,24,55
71,8474150,Mikael Backlund,C,CGY,35,78,23,32,55
71,8478856,Conor Garland,R,VAN,28,76,18,37,55
71,8475184,Chris Kreider,L,NYR,33,75,29,25,54
71,8482665,Matty Beniers,C,SEA,22,76,23,31,54
71,8481577,Philip Tomasino,C,NSH,23,67,20,34,54
71,8481711,Matias Maccelli,L,UTA,24,77,16,38,54
71,8477346,MacKenzie Weegar,D,CGY,30,74,14,40,54
71,8470613,Brent Burns,D,CAR,39,80,12,42,54
71,8471724,Kris Letang,D,PIT,37,77,10,44,54
71,8480015,Owen Tippett,R,PHI,25,78,26,27,53
71,8481068,Yegor Sharangovich,C,CGY,26,81,26,27,53
71,8482699,Dylan Guenther,R,UTA,21,73,26,27,53
71,8475170,Brayden Schenn,C,STL,33,72,23,30,53
71,8482124,Quinton Byfield,R,LAK,22,79,20,33,53
71,8477447,Shea Theodore,D,VGK,29,61,11,42,53
71,8479525,Ross Colton,C,COL,28,78,26,26,52
71,8476448,William Karlsson,C,VGK,31,74,24,28,52
71,8475191,Reilly Smith,R,NYR,33,74,23,29,52
71,8475745,Charlie Coyle,C,BOS,32,78,23,29,52
71,8479675,Trevor Moore,L,LAK,29,79,21,31,52
71,8474102,David Perron,L,OTT,36,77,19,33,52
71,8482149,Cole Perfetti,C,WPG,22,70,17,35,52
71,8483515,Juraj Slafkovsky,L,MTL,20,72,16,36,52
71,8482745,Mason McTavish,C,ANA,21,76,15,37,52
71,8476869,Brady Skjei,D,NSH,30,74,15,37,52
71,8482110,Dawson Mercer,C,NJD,23,71,22,29,51
71,8477407,Anthony Duclair,L,NYI,29,79,22,29,51
71,8478042,Viktor Arvidsson,L,EDM,31,80,21,30,51
71,8477494,Jonathan Drouin,L,COL,29,79,14,37,51
71,8482684,Luke Hughes,D,NJD,21,68,6,45,51
71,8480188,Fabian Zetterlund,L,SJS,25,68,29,21,50
71,8476399,Blake Coleman,C,CGY,33,79,27,23,50
71,8478474,Lawson Crouse,L,UTA,27,72,25,25,50
71,8477511,Anthony Mantha,R,CGY,30,77,20,30,50
71,8477416,Oliver Bjorkstrand,R,SEA,29,68,19,31,50
71,8480797,Joel Farabee,L,PHI,24,69,18,32,50
71,8476432,Boone Jenner,C,CBJ,31,71,23,26,49
71,8478047,Michael Bunting,L,PIT,29,77,20,29,49
71,8478438,Tommy Novak,C,NSH,27,68,13,36,49
71,8481542,Moritz Seider,D,DET,23,72,8,41,49
71,8475169,Evander Kane,L,EDM,33,71,29,19,48
71,8477935,Sam Bennett,C,FLA,28,74,27,21,48
71,8480009,Eeli Tolvanen,R,SEA,25,75,25,23,48
71,8480849,Barrett Hayton,C,UTA,24,71,22,26,48
71,8478444,Brock Boeser,R,VAN,27,73,20,28,48
71,8476458,Ryan Strome,C,ANA,31,68,20,28,48
71,8484166,Adam Fantilli,C,CBJ,20,73,19,29,48
71,8474586,Jordan Eberle,R,SEA,34,71,15,33,48
71,8476905,Chandler Stephenson,C,SEA,30,76,15,33,48
71,8476792,Torey Krug,D,STL,33,75,14,34,48
71,8478397,Rasmus Andersson,D,CGY,28,69,7,41,48
71,8471698,T.J. Oshie,R,WSH,38,71,23,24,47
71,8479987,Morgan Geekie,C,BOS,26,77,20,27,47
71,8482113,Anton Lundell,C,FLA,23,75,19,28,47
71,8477021,Alex Kerfoot,C,UTA,30,76,12,35,47
71,8475768,Jaden Schwartz,C,SEA,32,70,27,19,46
71,8481604,Pavel Dorofeyev,L,VGK,24,75,24,22,46
71,8483808,Andrei Kuzmenko,L,CGY,28,76,18,28,46
71,8476906,Shayne Gostisbehere,D,CAR,31,74,15,31,46
71,8475753,Justin Faulk,D,STL,32,71,11,35,46
71,8474563,Drew Doughty,D,LAK,35,75,7,39,46
71,8479400,Pierre-Luc Dubois,L,WSH,26,69,19,26,45
71,8477444,Andre Burakovsky,L,SEA,29,72,19,26,45
71,8483431,Logan Cooley,C,UTA,20,74,15,30,45
71,8481581,Thomas Harley,D,DAL,23,77,10,35,45
71,8477948,Travis Sanheim,D,PHI,28,75,6,39,45
71,8474641,Adam Henrique,C,EDM,34,77,27,17,44
71,8476474,Stefan Noesen,R,NJD,31,67,24,20,44
71,8475726,Tyler Toffoli,C,SJS,32,71,21,23,44
71,8482159,Tyson Foerster,R,PHI,22,72,17,27,44
71,8475287,Erik Haula,L,NJD,33,70,16,28,44
71,8477497,Sean Monahan,C,CBJ,30,68,15,29,44
71,8482133,Thomas Bordeleau,C,SJS,22,67,13,31,44
71,8474565,Alex Pietrangelo,D,VGK,34,63,9,35,44
71,8482702,Logan Stankoven,C,DAL,21,79,21,22,43
71,8475714,Calle Jarnkrok,C,TOR,33,74,21,22,43
71,8476882,Teuvo Teravainen,C,CHI,30,63,18,25,43
71,8480434,Sean Durzi,D,UTA,26,74,9,34,43
71,8479425,Filip Hronek,D,VAN,27,70,7,36,43
71,8477998,Warren Foegele,L,LAK,28,81,22,20,42
71,8480185,Eetu Luostarinen,C,FLA,26,72,20,22,42
71,8480113,Alex Iafallo,L,WPG,31,73,19,23,42
71,8475151,Kyle Palmieri,C,NYI,33,79,18,24,42
71,8482720,Matthew Knies,L,TOR,22,79,17,25,42
71,8481596,Shane Pinto,C,OTT,24,73,16,26,42
71,8477479,Tyler Bertuzzi,L,CHI,29,66,14,28,42
71,8481618,Alex Newhook,C,MTL,23,68,13,29,42
71,8477495,Seth Jones,D,CHI,30,71,7,35,42
71,8476483,Rickard Rakell,R,PIT,31,72,24,17,41
71,8478498,Jake DeBrusk,L,VAN,28,71,23,18,41
71,8479339,Patrik Laine,L,CBJ,26,64,21,20,41
71,8480798,Philipp Kurashev,C,CHI,25,69,20,21,41
71,8476826,Yanni Gourde,C,SEA,33,71,14,27,41
71,8478462,Nicolas Roy,C,VGK,27,77,12,29,41
71,8478038,Devon Toews,D,COL,30,65,9,32,41
71,8479410,Mikhail Sergachev,D,UTA,26,66,7,34,41
71,8475314,Anders Lee,L,NYI,34,77,24,16,40
71,8477426,Nicholas Paul,L,TBL,29,82,22,18,40
71,8481186,Logan O'Connor,R,COL,28,79,21,19,40
71,8478057,Dakota Joshua,C,VAN,28,72,19,21,40
71,8474149,Evgenii Dadonov,R,DAL,35,80,19,21,40
71,8481656,Aliaksei Protas,C,WSH,23,66,18,22,40
71,8477451,Ryan Hartman,R,MIN,30,69,15,25,40
71,8478519,Anthony Cirelli,C,TBL,27,82,15,25,40
71,8482097,Jack Quinn,R,BUF,23,65,13,27,40
71,8479365,Trent Frederic,C,BOS,26,74,13,27,40
71,8484145,Zach Benson,L,BUF,19,69,11,29,40
71,8476885,Jacob Trouba,D,NYR,30,70,8,32,40
71,8482175,JJ Peterka,R,BUF,22,73,27,12,39
71,8478115,Pierre Engvall,L,NYI,28,77,19,20,39
71,8476927,Teddy Blueger,C,VAN,30,69,19,20,39
71,8478466,Daniel Sprong,R,VAN,27,63,17,22,39
71,8481533,Trevor Zegras,C,ANA,23,73,17,22,39
71,8477964,Ivan Barbashev,C,VGK,29,76,14,25,39
71,8475722,Jason Zucker,L,BUF,32,65,21,17,38
71,8479992,Michael Rasmussen,C,DET,25,79,20,18,38
71,8477503,Max Domi,C,TOR,29,75,19,19,38
71,8476292,Ondrej Palat,L,NJD,33,69,16,22,38
71,8476461,Sean Couturier,C,PHI,32,66,14,24,38
71,8481524,Bowen Byram,D,BUF,23,75,14,24,38
71,8476925,Colton Sissons,C,NSH,31,65,11,27,38
71,8483490,Pavel Mintyukov,D,ANA,21,73,10,28,38
71,8480078,Filip Chytil,C,NYR,25,64,9,29,38
71,8476438,Brandon Saad,L,STL,32,73,22,15,37
71,8481554,Kaapo Kakko,R,NYR,23,70,22,15,37
71,8478472,Mathieu Joseph,R,STL,27,71,18,19,37
71,8479390,Taylor Raddysh,R,WSH,26,67,17,20,37
71,8481528,Dylan Cozens,C,BUF,23,72,16,21,37
71,8480028,Morgan Frost,C,PHI,25,70,16,21,37
71,8482667,William Eklund,L,SJS,22,66,14,23,37
71,8479345,Jakob Chychrun,D,WSH,26,67,13,24,37
71,8482146,Luke Evangelista,R,NSH,22,69,13,24,37
71,8480829,Jesperi Kotkaniemi,C,CAR,24,71,13,24,37
71,8481703,Valtteri Puustinen,R,PIT,25,58,10,27,37
71,8476854,Hampus Lindholm,D,BOS,30,72,6,31,37
71,8476958,Jaccob Slavin,D,CAR,30,75,2,35,37
71,8475799,Nino Niederreiter,R,WPG,32,72,24,12,36
71,8475848,Brendan Gallagher,R,MTL,32,71,21,15,36
71,8475794,Tyler Seguin,C,DAL,32,82,20,16,36
71,8476392,Adam Lowry,C,WPG,31,64,13,23,36
71,8484203,Bradly Nadeau,L,CAR,19,62,13,23,36
71,8482660,Kent Johnson,C,CBJ,22,60,12,24,36
71,8483505,Matthew Poitras,C,BOS,20,69,10,26,36
71,8475200,Dmitry Orlov,D,CAR,33,75,8,28,36
71,8475764,Cam Fowler,D,ANA,33,72,2,34,36
71,8480893,Kirill Marchenko,R,CBJ,24,69,22,13,35
71,8476872,Scott Laughton,C,PHI,30,73,18,17,35
71,8478891,Mason Appleton,C,WPG,28,63,18,17,35
71,8478542,Evan Rodrigues,C,FLA,31,71,16,19,35
71,8479351,Sam Steel,C,DAL,26,79,12,23,35
71,8482624,Daniil Miromanov,D,CGY,27,64,7,28,35
71,8474151,Ryan McDonagh,D,TBL,35,77,7,28,35
71,8482089,Jake Neighbours,L,STL,22,69,25,9,34
71,8479591,Michael Eyssimont,C,TBL,28,82,18,16,34
71,8480459,Pius Suter,C,VAN,28,72,18,16,34
71,8482079,Marco Rossi,C,MIN,23,55,18,16,34
71,8479661,Tanner Jeannot,L,LAK,27,75,16,18,34
71,8475193,Tomas Tatar,L,NJD,34,70,14,20,34
71,8482092,Ridly Greig,C,OTT,22,73,13,21,34
71,8476462,Dougie Hamilton,D,NJD,31,72,8,26,34
71,8482122,Brock Faber,D,MIN,22,78,8,26,34
71,8480205,Emil Bemstrom,C,PIT,25,53,8,26,34
71,8480014,Gabriel Vilardi,C,WPG,25,59,20,13,33
71,8480064,Josh Norris,C,OTT,25,77,19,14,33
71,8475793,Ryan Johansen,C,PHI,32,76,19,14,33
71,8473533,Jordan Staal,C,CAR,36,66,18,15,33
71,8478463,Anthony Beauvillier,L,PIT,27,74,15,18,33
71,8482705,Cole Sillinger,C,CBJ,21,69,15,18,33
71,8480068,Ryan Poehling,C,PHI,25,67,12,21,33
71,8474716,Jared Spurgeon,D,MIN,35,76,12,21,33
71,8474053,Logan Couture,C,SJS,35,64,10,23,33
71,8481704,Juuso Parssinen,C,NSH,23,56,10,23,33
71,8477932,Aaron Ekblad,D,FLA,28,69,9,24,33
71,8480145,Neal Pionk,D,WPG,29,74,7,26,33
71,8478500,Ivan Provorov,D,CBJ,27,78,7,26,33
71,8481606,Jordan Spence,D,LAK,23,71,6,27,33
71,8477987,Ryan Donato,C,CHI,28,66,17,15,32
71,8480789,Oliver Wahlstrom,R,NYI,24,72,17,15,32
71,8474715,Cameron Atkinson,R,TBL,35,82,16,16,32
71,8475220,Marcus Foligno,L,MIN,33,62,16,16,32
71,8482475,Yegor Chinakhov,R,CBJ,23,63,15,17,32
71,8481535,Nils Hoglander,L,VAN,24,69,14,18,32
71,8478046,Danton Heinen,L,VAN,29,64,12,20,32
71,8475218,Mattias Ekholm,D,EDM,34,73,10,22,32
71,8478055,Gustav Forsling,D,FLA,28,70,9,23,32
71,8477947,Sonny Milano,L,WSH,28,66,9,23,32
71,8478458,John (Jack) Roslovic,C,CAR,27,65,8,24,32
71,8482712,Oskar Olausson,R,COL,22,76,6,26,32
71,8477969,Marcus Pettersson,D,PIT,28,76,6,26,32
71,8477488,Brett Pesce,D,NJD,30,73,4,28,32
71,8477952,Robby Fabbri,C,ANA,28,58,17,14,31
71,8478109,Victor Olofsson,L,VGK,29,71,13,18,31
71,8478469,Thomas Chabot,D,OTT,27,74,5,26,31
71,8480043,Timothy Liljegren,D,TOR,25,70,3,28,31
71,8482074,Connor Zary,C,CGY,23,60,17,13,30
71,8479293,Brandon Tanev,L,SEA,33,64,17,13,30
71,8478020,Michael Amadio,R,OTT,28,78,13,17,30
71,8477919,Frederick Gaudreau,C,MIN,31,65,11,19,30
71,8476979,Erik Gustafsson,D,DET,32,74,4,26,30
71,8481560,Arthur Kaliyev,R,LAK,23,76,17,12,29
71,8476278,Colin Blackwell,C,DAL,31,79,17,12,29
71,8475760,Nick Bjugstad,C,UTA,32,72,15,14,29
71,8476419,Jean-Gabriel Pageau,C,NYI,32,74,12,17,29
71,8476480,Vladislav Namestnikov,C,WPG,32,68,11,18,29
71,8477953,Kasperi Kapanen,R,STL,28,70,10,19,29
71,8481546,Cam York,D,PHI,23,63,9,20,29
71,8478133,Jake Evans,C,MTL,28,69,8,21,29
71,8480220,Noah Cates,L,PHI,25,76,7,22,29
71,8479398,Samuel Girard,D,COL,26,64,7,22,29
71,8479402,Jake Bean,D,CGY,26,66,4,25,29
71,8480873,Rasmus Sandin,D,WSH,24,65,2,27,29
71,8479996,Cody Glass,C,NSH,25,60,15,13,28
71,8480336,Sean Walker,D,CAR,30,75,12,16,28
71,8477505,Alexander Wennberg,C,SJS,30,64,12,16,28
71,8478233,Andrew Mangiapane,L,WSH,28,69,11,17,28
71,8475149,Marcus Johansson,L,MIN,34,72,11,17,28
71,8482671,Owen Power,D,BUF,22,74,10,18,28
71,8476923,Damon Severson,D,CBJ,30,76,8,20,28
71,8477429,Andrew Copp,C,DET,30,80,5,23,28
71,8473507,Jeff Petry,D,DET,37,77,5,23,28
71,8476917,Adam Pelech,D,NYI,30,77,5,23,28
71,8482111,Justin Barron,D,MTL,23,70,14,13,27
71,8477989,Christian Dvorak,C,MTL,28,64,9,18,27
71,8480817,K'Andre Miller,D,NYR,24,74,5,22,27
71,8478136,Jake Middleton,D,MIN,28,75,4,23,27
71,8481582,Nicholas Robertson,L,TOR,23,63,13,13,26
71,8475763,Kevin Hayes,R,PIT,32,68,13,13,26
71,8475343,Nic Dowd,C,WSH,34,60,13,13,26
71,8475842,Sam Carrick,C,NYR,32,62,13,13,26
71,8476469,Joel Armia,R,MTL,31,69,13,13,26
71,8481032,Paul Cotter,C,NJD,25,59,13,13,26
71,8480748,Kiefer Sherwood,L,VAN,29,63,12,14,26
71,8479316,Luke Kunin,C,SJS,27,60,10,16,26
71,8481523,Kirby Dach,C,MTL,23,63,7,19,26
71,8478013,Jake Walman,D,SJS,28,72,7,19,26
71,8476463,Jonas Brodin,D,MIN,31,81,6,20,26
71,8476312,Josh Manson,D,COL,33,66,6,20,26
71,8482245,Artem Zub,D,OTT,29,64,6,20,26
71,8476331,Dylan DeMelo,D,WPG,31,70,2,24,26
71,8480813,Joe Veleno,C,DET,24,77,14,11,25
71,8478569,Noel Acciari,C,PIT,33,59,13,12,25
71,8479718,Alex Barré-Boulet,C,MTL,27,54,13,12,25
71,8476918,Jimmy Vesey,L,NYR,31,69,11,14,25
71,8478432,Christian Fischer,R,DET,27,73,11,14,25
71,8478970,Jalen Chatfield,D,CAR,28,76,11,14,25
71,8479353,Brett Howden,C,VGK,26,67,10,15,25
71,8483524,Shane Wright,C,SEA,20,63,10,15,25
71,8483445,Cutter Gauthier,L,ANA,20,65,9,16,25
71,8480835,Jack Drury,C,CAR,24,57,9,16,25
71,8480871,Adam Boqvist,D,FLA,24,71,8,17,25
71,8473422,Nick Foligno,L,CHI,37,60,7,18,25
71,8478911,Matt Roy,D,WSH,29,61,6,19,25
71,8473563,Nicklas Backstrom,C,WSH,37,63,6,19,25
71,8483565,Nick Blankenburg,D,NSH,26,59,5,20,25
71,8476892,Colton Parayko,D,STL,31,74,2,23,25
71,8477506,Ryan Pulock,D,NYI,30,79,1,24,25
71,8477446,Michael McCarron,R,NSH,29,56,15,9,24
71,8479619,Michael Carcone,L,UTA,28,59,14,10,24
71,8477450,Jason Dickinson,C,CHI,29,62,13,11,24
71,8478043,Sam Lafferty,C,BUF,29,59,9,15,24
71,8481624,Ilya Mikheyev,R,CHI,30,58,8,16,24
71,8476921,Jordan Martinook,L,CAR,32,64,8,16,24
71,8477435,Ryan Graves,D,PIT,29,73,7,17,24
71,8480860,Kevin Bahl,D,CGY,24,57,7,17,24
71,8480802,Ryan McLeod,C,BUF,25,61,6,18,24
71,8482105,Jake Sanderson,D,OTT,22,73,6,18,24
71,8475790,Erik Gudbranson,D,CBJ,32,77,6,18,24
71,8475171,Oliver Ekman-Larsson,D,TOR,33,62,4,20,24
71,8479639,Dylan Coghlan,D,WPG,26,55,4,20,24
71,8482062,Cole Smith,L,NSH,29,56,15,8,23
71,8473453,Trevor Lewis,C,LAK,37,78,11,12,23
71,8477507,Nikita Zadorov,D,BOS,29,67,11,12,23
71,8480144,David Kampf,C,TOR,29,71,11,12,23
71,8483482,Tristan Luneau,D,ANA,20,59,11,12,23
71,8475225,Craig Smith,C,CHI,35,47,11,12,23
71,8480074,Alexandre Texier,C,STL,25,54,10,13,23
71,8476981,Josh Anderson,R,MTL,30,75,9,14,23
71,8479371,Dante Fabbro,D,NSH,26,64,9,14,23
71,8480855,Jack McBain,C,UTA,24,68,8,15,23
71,8476902,Esa Lindell,D,DAL,30,77,7,16,23
71,8477498,Darnell Nurse,D,EDM,29,76,7,16,23
71,8481093,Rafael Harvey-Pinard,L,MTL,25,57,7,16,23
71,8482655,Janis Moser,D,TBL,24,74,4,19,23
71,8478443,Brandon Carlo,D,BOS,28,65,3,20,23
71,8480049,Dylan Samberg,D,WPG,25,69,2,21,23
71,8474189,Lars Eller,C,PIT,35,56,12,10,22
71,8479368,Max Jones,L,BOS,26,66,12,10,22
71,8475855,Jesper Fast,R,CAR,33,61,11,11,22
71,8476856,Mathew Dumba,D,DAL,30,68,10,12,22
71,8482157,Will Cuylle,L,NYR,22,58,10,12,22
71,8480003,Jesper Boqvist,C,FLA,26,69,9,13,22
71,8481441,Joe Snively,C,DET,28,62,9,13,22
71,8482101,Danil Gushchin,L,SJS,22,59,8,14,22
71,8479983,Mario Ferraro,D,SJS,26,66,6,16,22
71,8478882,Vladislav Gavrikov,D,LAK,29,68,3,19,22
71,8476467,Jamie Oleksiak,D,SEA,32,70,3,19,22
71,8476429,Scott Mayfield,D,NYI,32,77,1,21,22
71,8470621,Corey Perry,R,EDM,39,65,16,5,21
71,8478508,Yakov Trenin,C,MIN,27,65,14,7,21
71,8476897,Oskar Sundqvist,C,STL,30,65,9,12,21
71,8478413,Jordan Greenway,L,BUF,27,64,9,12,21
71,8482055,Drew O'Connor,L,PIT,26,59,9,12,21
71,8478434,Keegan Kolesar,R,VGK,27,68,8,13,21
71,8480762,Eric Robinson,L,CAR,29,60,8,13,21
71,8480980,Connor Dewar,C,TOR,25,60,8,13,21
71,8482737,Zack Bolduc,C,STL,21,57,8,13,21
71,8477979,Nicolas Aube-Kubel,R,BUF,28,57,7,14,21
71,8480355,Mark Kastelic,C,BOS,25,53,7,14,21
71,8476329,Travis Boyd,C,MIN,31,57,6,15,21
71,8479998,Mikey Anderson,D,LAK,25,61,6,15,21
71,8483468,Jiri Kulich,C,BUF,20,56,5,16,21
71,8477839,Conor Sheary,L,TBL,32,81,5,16,21
71,8475791,Taylor Hall,L,CHI,33,62,4,17,21
71,8475188,Brayden McNabb,D,VGK,33,56,1,20,21
71,8482073,Braden Schneider,D,NYR,23,64,1,20,21
71,8480448,Parker Kelly,L,COL,25,71,11,9,20
71,8482117,Lukas Reichel,L,CHI,22,52,10,10,20
71,8482125,Alexander Holtz,R,VGK,22,68,9,11,20
71,8476960,Andreas Athanasiou,C,CHI,30,52,9,11,20
71,8474034,Patrick Maroon,L,CHI,36,51,9,11,20
71,8476422,Mike Reilly,D,NYI,31,75,5,15,20
71,8475181,Nick Leddy,D,STL,33,69,4,16,20
71,8479372,Joshua Mahura,D,SEA,26,58,3,17,20
71,8480891,Michael Kesselring,D,UTA,24,66,3,17,20
71,8481014,Alexander Romanov,D,NYI,24,76,3,17,20
71,8477845,Trevor van Riemsdyk,D,WSH,33,62,2,18,20
71,8481601,Simon Holmstrom,R,NYI,23,68,16,3,19
71,8476822,Luke Glendening,C,TBL,35,78,16,3,19
71,8481553,Bobby Brink,R,PHI,23,58,11,8,19
71,8482259,Bobby McMann,C,TOR,28,73,11,8,19
71,8481580,Connor McMichael,C,WSH,23,66,11,8,19
71,8477903,Garnet Hathaway,R,PHI,33,58,10,9,19
71,8482803,Olen Zellweger,D,ANA,21,64,10,9,19
71,8479393,Noah Gregor,L,OTT,26,72,9,10,19
71,8481517,Brett Leason,R,ANA,25,61,9,10,19
71,8483457,Lane Hutson,D,MTL,20,66,7,12,19
71,8476988,Matt Benning,D,SJS,30,67,5,14,19
71,8476525,Colin Miller,D,WPG,32,58,5,14,19
71,8476873,Mark Jankowski,C,NSH,30,56,5,14,19
71,8483491,Ivan Miroshnichenko,L,WSH,20,46,4,15,19
71,8478507,John Marino,D,UTA,27,64,4,15,19
71,8475324,Nick Jensen,D,OTT,34,75,4,15,19
71,8478840,Will Borgen,D,SEA,28,63,4,15,19
71,8480878,Nils Lundkvist,D,DAL,24,67,3,16,19
71,8476931,Jake McCabe,D,TOR,31,62,3,16,19
71,8476457,Adam Larsson,D,SEA,32,58,2,17,19
71,8479982,Conor Timmins,D,TOR,26,57,2,17,19
71,8477015,Connor Brown,R,EDM,30,65,11,7,18
71,8481028,Martin Pospisil,C,CGY,25,57,9,9,18
71,8479315,Joey Anderson,R,CHI,26,56,9,9,18
71,8476374,Sean Kuraly,C,CBJ,31,55,9,9,18
71,8482155,Alex Laferriere,R,LAK,23,64,8,10,18
71,8482749,Joshua Roy,R,MTL,21,61,8,10,18
71,8477392,Hudson Fasching,R,NYI,29,69,8,10,18
71,8480806,Isac Lundestrom,C,ANA,25,57,8,10,18
71,8482087,Kaiden Guhle,D,MTL,22,60,8,10,18
71,8481481,Blake Lizotte,C,PIT,27,64,7,11,18
71,8482142,Jamie Drysdale,D,PHI,22,63,6,12,18
71,8476891,Matthew Grzelcyk,D,PIT,30,76,4,14,18
71,8475279,Ben Chiarot,D,DET,33,71,4,14,18
71,8481527,Kaedan Korczak,D,VGK,23,46,3,15,18
71,8475462,Radko Gudas,D,ANA,34,61,3,15,18
71,8480887,Jordan Harris,D,MTL,24,58,3,15,18
71,8478831,Kevin Stenlund,C,UTA,28,55,13,4,17
71,8481477,Nico Sturm,C,SJS,29,52,9,8,17
71,8481019,David Gustafsson,C,WPG,24,50,6,11,17
71,8477508,Curtis Lazar,C,NJD,29,55,6,11,17
71,8480246,Nick Perbix,D,TBL,26,70,3,14,17
71,8480172,Jan Rutta,D,SJS,34,59,3,14,17
71,8477369,Carson Soucy,D,VAN,30,63,1,16,17
71,8476878,Zemgus Girgensons,C,TBL,30,80,12,4,16
71,8479671,Mathieu Olivier,R,CBJ,27,47,9,7,16
71,8479941,Justin Danforth,R,CBJ,31,62,8,8,16
71,8479066,Ryan Lomberg,L,CGY,30,65,7,9,16
71,8478585,Derek Ryan,C,EDM,38,56,7,9,16
71,8475690,Chris Tanev,D,TOR,35,63,7,9,16
71,8480995,Pontus Holmberg,R,TOR,25,54,6,10,16
71,8482148,Hendrix Lapierre,C,WSH,22,55,6,10,16
71,8481521,Ronnie Attard,D,PHI,25,50,5,11,16
71,8482192,Isaak Phillips,D,CHI,23,56,5,11,16
71,8482067,Connor Mackey,D,NYR,28,59,4,12,16
71,8480058,Pierre-Olivier Joseph,D,STL,25,44,4,12,16
71,8475455,Brenden Dillon,D,NJD,34,59,4,12,16
71,8481567,Henry Thrun,D,SJS,23,46,4,12,16
71,8483499,Liam Ohgren,L,MIN,20,54,3,13,16
71,8480073,Erik Brannstrom,D,COL,25,60,2,14,16
71,8478851,Alexandre Carrier,D,NSH,28,63,1,15,16
71,8481679,Maxence Guenette,D,OTT,23,35,10,5,15
71,8477406,Mattias Janmark,C,EDM,32,71,7,8,15
71,8481522,Peyton Krebs,C,BUF,23,55,7,8,15
71,8475231,Casey Cizikas,C,NYI,33,70,6,9,15
71,8481537,Nikita Okhotiuk,D,CGY,24,51,6,9,15
71,8478211,Dryden Hunt,L,CGY,29,55,6,9,15
71,8478451,Ethan Bear,D,WSH,27,50,5,10,15
71,8478421,A.J. Greer,L,FLA,28,61,5,10,15
71,8475208,Brian Dumoulin,D,ANA,33,67,4,11,15
71,8480035,Henri Jokiharju,D,BUF,25,59,4,11,15
71,8480796,Martin Fehervary,D,WSH,25,55,4,11,15
71,8480001,Urho Vaakanainen,D,ANA,25,60,3,12,15
71,8474568,Luke Schenn,D,NSH,35,52,3,12,15
71,8478178,Darren Raddysh,D,TBL,28,68,2,13,15
71,8474673,TJ Brodie,D,CHI,34,59,1,14,15
71,8477887,Patrick Brown,C,BOS,32,49,10,4,14
71,8477353,Tyler Motte,C,DET,29,74,9,5,14
71,8481617,Vasily Podkolzin,R,VAN,23,46,9,5,14
71,8477478,William Carrier,L,CAR,30,51,8,6,14
71,8480252,Cole Guttman,C,CHI,25,34,8,6,14
71,8476994,Vinnie Hinostroza,C,NSH,30,48,7,7,14
71,8482679,Matt Coronato,R,CGY,22,65,6,8,14
71,8480281,Alexey Toropchenko,R,STL,25,66,6,8,14
71,8481518,Nolan Foote,L,NJD,24,40,6,8,14
71,8477938,Haydn Fleury,D,WPG,28,51,6,8,14
71,8479772,Zack MacEwen,R,OTT,28,54,6,8,14
71,8481161,Jake Christiansen,D,CBJ,25,57,6,8,14
71,8476624,Barclay Goodrow,C,SJS,31,47,4,10,14
71,8482859,Zack Ostapchuk,C,OTT,21,55,4,10,14
71,8476934,Brock McGinn,L,ANA,30,47,4,10,14
71,8482730,Brandt Clarke,D,LAK,21,44,4,10,14
71,8470600,Ryan Suter,D,STL,39,69,2,12,14
71,8481178,Egor Zamula,D,PHI,24,57,1,13,14
71,8477425,Miles Wood,L,COL,29,73,9,4,13
71,8480025,MacKenzie Entwistle,R,FLA,25,62,6,7,13
71,8476889,Radek Faksa,C,STL,30,51,5,8,13
71,8479414,Nathan Bastian,R,NJD,27,61,5,8,13
71,8479986,Kole Lind,R,DAL,26,44,5,8,13
71,8480192,Johnathan Kovacevic,D,NJD,27,44,4,9,13
71,8483495,Simon Nemec,D,NJD,20,50,4,9,13
71,8480222,Sebastian Aho,D,PIT,28,72,3,10,13
71,8478416,Erik Cernak,D,TBL,27,73,3,10,13
71,8482176,Wyatt Kaiser,D,CHI,22,50,2,11,13
71,8475233,David Savard,D,MTL,34,60,1,12,13
71,8474574,Tyler Myers,D,VAN,34,70,0,13,13
71,8481641,Joel Kiviranta,L,COL,28,66,11,1,12
71,8476858,Phillip Di Giuseppe,L,VAN,31,44,9,3,12
71,8479336,Carl Grundstrom,R,SJS,27,49,8,4,12
71,8482166,Shakir Mukhamadullin,D,SJS,22,53,7,5,12
71,8482809,Jackson Blake,R,CAR,21,50,6,6,12
71,8479344,Jesse Puljujarvi,R,PIT,26,50,6,6,12
71,8481013,Jonatan Berggren,R,DET,24,58,5,7,12
71,8484149,Gavin Brindley,C,CBJ,20,53,5,7,12
71,8480021,Jack Studnicka,C,LAK,25,61,5,7,12
71,8479378,Logan Stanley,D,WPG,26,37,5,7,12
71,8480950,Ilya Lyubushkin,D,DAL,30,68,5,7,12
71,8477499,Rasmus Ristolainen,D,PHI,30,56,4,8,12
71,8478452,Caleb Jones,D,LAK,27,53,4,8,12
71,8479439,Jacob MacDonald,D,COL,31,48,3,9,12
71,8478017,Mark Friedman,D,VAN,29,48,3,9,12
71,8476967,Brett Kulak,D,EDM,30,60,2,10,12
71,8479980,Nicolas Hague,D,VGK,26,50,2,10,12
71,8481701,Santeri Hatakka,D,NJD,23,44,2,10,12
71,8471709,Marc-Edouard Vlasic,D,SJS,37,63,1,11,12
71,8482634,Alex Steeves,C,TOR,25,55,1,11,12
71,8473446,Erik Johnson,D,PHI,36,51,1,11,12
71,8479976,Juuso Valimaki,D,UTA,26,63,0,12,12
71,8479249,Andrew Poturalski,C,SJS,30,38,0,12,12
71,8482077,Dylan Holloway,L,EDM,23,55,8,3,11
71,8482652,Walker Duehr,R,CGY,27,38,7,4,11
71,8479370,Tyson Jost,C,CAR,26,44,6,5,11
71,8476442,Matt Nieto,L,PIT,32,48,6,5,11
71,8471817,Ryan Reaves,R,TOR,37,55,6,5,11
71,8479328,Julien Gauthier,R,NYI,27,60,5,6,11
71,8482807,Ethan Del Mastro,D,CHI,21,48,5,6,11
71,8481059,Scott Perunovich,D,STL,26,51,4,7,11
71,8480011,Klim Kostin,C,SJS,25,49,4,7,11
71,8477573,Nathan Walker,L,STL,30,43,4,7,11
71,8479442,Troy Stecher,D,EDM,30,54,4,7,11
71,8479994,Jaret Anderson-Dolan,C,WPG,25,38,4,7,11
71,8483549,Lucas Condotta,L,MTL,27,35,3,8,11
71,8479369,Andrew Peeke,D,BOS,26,66,3,8,11
71,8480727,Zach Whitecloud,D,VGK,28,52,2,9,11
71,8481568,Alex Vlasic,D,CHI,23,56,2,9,11
71,8474166,Alec Martinez,D,CHI,37,44,2,9,11
71,8483460,David Jiricek,D,CBJ,21,58,2,9,11
71,8474612,Travis Hamonic,D,OTT,34,53,2,9,11
71,8477220,Nate Schmidt,D,FLA,33,71,1,10,11
71,8478399,Jonas Siegenthaler,D,NJD,27,62,1,10,11
71,8480807,Mattias Samuelsson,D,BUF,24,54,1,10,11
71,8481167,Brayden Pachal,D,CGY,25,41,1,10,11
71,8476372,Nick Seeler,D,PHI,31,44,0,11,11
71,8477365,Connor Clifton,D,BUF,29,52,0,11,11
71,8482496,Nils Aman,C,VAN,24,37,8,2,10
71,8479944,Zach Aston-Reese,C,VGK,30,57,6,4,10
71,8483493,Frank Nazar,C,CHI,20,48,5,5,10
71,8479520,Brandon Duhaime,R,WSH,27,41,5,5,10
71,8477482,Zachary Sanford,L,CHI,30,43,5,5,10
71,8482659,Josh Doan,R,UTA,22,48,4,6,10
71,8479968,Vinni Lettieri,C,BOS,29,45,4,6,10
71,8482451,Mikael Pyyhtia,L,CBJ,23,48,3,7,10
71,8481147,Reese Johnson,C,MIN,26,41,3,7,10
71,8477018,Ben Hutton,D,VGK,31,45,3,7,10
71,8474567,Zach Bogosian,D,MIN,34,57,2,8,10
71,8482747,Brennan Othmann,L,NYR,21,49,2,8,10
71,8475179,Dmitry Kulikov,D,FLA,34,59,1,9,10
71,8475177,Calvin de Haan,D,COL,33,49,1,9,10
71,8476473,Connor Murphy,D,CHI,31,44,1,9,10
71,8480070,Ian Mitchell,D,BOS,25,50,1,9,10
71,8476874,Olli Maatta,D,DET,30,59,0,10,10
71,8482762,Simon Edvinsson,D,DET,21,56,7,2,9
71,8480292,Carson Meyer,R,ANA,27,28,5,4,9
71,8481550,Adam Beckman,L,NJD,23,42,4,5,9
71,8476867,Brendan Gaunce,C,MIN,30,38,4,5,9
71,8477527,Ross Johnston,L,ANA,30,37,4,5,9
71,8483570,Ben Meyers,C,SEA,26,27,4,5,9
71,8480289,Morgan Barron,C,WPG,26,50,3,6,9
71,8475718,Justin Holl,D,DET,32,54,3,6,9
71,8479543,Michael Pezzetta,L,MTL,26,58,3,6,9
71,8482666,Scott Morrow,D,CAR,22,37,3,6,9
71,8477962,Brendan Lemieux,L,CAR,28,41,3,6,9
71,8482964,Arber Xhekaj,D,MTL,23,50,3,6,9
71,8481708,Zac Jones,D,NYR,24,53,2,7,9
71,8479359,Beck Malenstyn,L,BUF,26,39,2,7,9
71,8480848,Ty Dellandrea,C,SJS,24,44,2,7,9
71,8476952,Dominic Toninato,C,WPG,30,39,2,7,9
71,8478146,Matthew Highmore,C,OTT,28,36,2,7,9
71,8476879,Cody Ceci,D,EDM,31,73,1,8,9
71,8478468,Jeremy Lauzon,D,NSH,27,57,1,8,9
71,8475750,Jon Merrill,D,MIN,32,60,0,9,9
71,8477034,Jaycob Megna,D,FLA,32,46,0,9,9
71,8480880,Jakub Lauko,C,MIN,24,27,6,2,8
71,8484254,Akito Hirose,D,VAN,25,40,5,3,8
71,8481754,Nikita Nesterenko,C,ANA,23,37,5,3,8
71,8477380,Jonny Brodzinski,C,NYR,31,50,4,4,8
71,8479026,Philippe Myers,D,TOR,27,51,4,4,8
71,8477931,Tomas Nosek,L,FLA,32,66,4,4,8
71,8478859,Niko Mikkola,D,FLA,28,56,4,4,8
71,8481532,Alex Turcotte,C,LAK,23,38,4,4,8
71,8482153,Brendan Brisson,C,VGK,23,28,4,4,8
71,8480845,Rasmus Kupari,C,WPG,24,38,3,5,8
71,8479291,Kevin Rooney,C,CGY,31,53,3,5,8
71,8479320,Maxime Lajoie,D,SEA,27,29,3,5,8
71,8479324,Ryan Lindgren,D,NYR,26,63,2,6,8
71,8474090,Brendan Smith,D,DAL,35,48,2,6,8
71,8477401,John Hayden,C,SEA,29,31,2,6,8
71,8482733,Logan Mailloux,D,MTL,31,30,2,6,8
71,8480196,Jacob Bryson,D,BUF,27,42,1,7,8
71,8480879,Jacob Bernard-Docker,D,OTT,24,47,1,7,8
71,8474013,Ian Cole,D,UTA,35,48,1,7,8
71,8481598,Philip Broberg,D,EDM,23,47,0,8,8
71,8480157,Calle Rosen,D,COL,30,54,5,2,7
71,8483397,Marc McLaughlin,C,BOS,25,34,5,2,7
71,8482147,Jean-Luc Foudy,C,COL,22,37,5,2,7
71,8482165,Yan Kuznetsov,D,CGY,22,20,5,2,7
71,8471677,Jack Johnson,D,CBJ,37,67,4,3,7
71,8480007,Jonas Rondbjerg,R,VGK,25,33,4,3,7
71,8482141,Lukas Cormier,D,VGK,22,24,4,3,7
71,8480441,Trey Fix-Wolansky,R,CBJ,25,28,3,4,7
71,8479981,Jonah Gadjovich,L,FLA,26,43,3,4,7
71,8482144,Jack Thompson,D,SJS,22,30,3,4,7
71,8479536,Axel Jonsson-Fjallby,L,WPG,26,40,3,4,7
71,8477462,Robert Hagg,D,VGK,29,27,3,4,7
71,8479367,William Lockwood,R,FLA,26,25,3,4,7
71,8481056,Spencer Stastney,D,NSH,24,27,2,5,7
71,8482511,Mason Lohrei,D,BOS,23,30,2,5,7
71,8481600,Tobias Bjornfot,D,FLA,23,40,1,6,7
71,8482751,Ryan Winterton,C,SEA,21,38,1,6,7
71,8477070,Liam O'Brien,C,UTA,30,52,5,1,6
71,8482784,Zach Dean,C,STL,21,37,4,2,6
71,8478424,Jansen Harkins,C,ANA,27,39,4,2,6
71,8479348,Kale Clague,D,BUF,26,38,4,2,6
71,8480834,Ty Emberson,D,SJS,24,36,4,2,6
71,8480890,Jan Jenik,C,OTT,24,24,3,3,6
71,8481543,Nikita Alexandrov,C,STL,24,33,3,3,6
71,8481609,Vladislav Kolyachonok,D,UTA,23,37,3,3,6
71,8480245,Olle Lycksell,R,PHI,25,34,3,3,6
71,8481592,Jakob Pelletier,L,CGY,23,35,3,3,6
71,8481716,Dmitri Voronkov,L,CBJ,24,39,2,4,6
71,8481751,Lukas Rousek,R,BUF,25,42,2,4,6
71,8483763,Maksymilian Szuber,D,UTA,22,35,2,4,6
71,8481599,Victor Soderstrom,D,UTA,23,39,1,5,6
71,8477851,Jordan Oesterle,D,BOS,32,39,1,5,6
71,8477335,Kyle Burroughs,D,LAK,29,47,1,5,6
71,8481122,Simon Benoit,D,TOR,26,36,1,5,6
71,8482861,Vincent Iorio,D,WSH,22,29,0,6,6
71,8482145,Mavrik Bourque,C,DAL,22,52,3,2,5
71,8476913,Devin Shore,C,MIN,30,29,3,2,5
71,8479379,Givani Smith,R,SJS,26,27,3,2,5
71,8482744,James Malatesta,L,CBJ,21,38,2,3,5
71,8479576,Vincent Desharnais,D,VAN,28,37,2,3,5
71,8479985,Cale Fleury,D,SEA,26,33,2,3,5
71,8482858,Ryker Evans,D,SEA,23,20,2,3,5
71,8482070,Mitchell Chaffee,R,TBL,26,37,1,4,5
71,8479972,Mason Shaw,C,WPG,26,38,1,4,5
71,8484911,Collin Graf,R,SJS,22,36,1,4,5
71,8477384,Joshua Brown,D,EDM,30,35,1,4,5
71,8478450,Parker Wotherspoon,D,BOS,27,28,1,4,5
71,8476441,Joel Edmundson,D,LAK,31,28,1,4,5
71,8480990,Declan Chisholm,D,MIN,24,34,1,4,5
71,8479419,Brett Murray,L,BUF,26,29,1,4,5
71,8480084,Nick DeSimone,D,NJD,30,20,1,4,5
71,8483466,Kevin Korchinski,D,CHI,20,51,0,5,5
71,8477810,Joel Hanley,D,CGY,33,29,0,5,5
71,8482095,Tyler Kleven,D,OTT,22,41,3,1,4
71,8479638,Justin Brazeau,R,BOS,26,36,3,1,4
71,8480851,Akil Thomas,C,LAK,24,18,3,1,4
71,8480468,James Hamblin,L,EDM,25,18,3,1,4
71,8482118,Sam Colangelo,R,ANA,23,10,3,1,4
71,8483597,Milos Kelemen,L,UTA,25,14,3,1,4
71,8481789,Tye Kartye,L,SEA,23,34,2,2,4
71,8483012,Logan Morrison,C,SEA,22,31,2,2,4
71,8478477,Mitchell Stephens,C,SEA,27,22,2,2,4
71,8480844,Grigori Denisenko,L,VGK,24,37,1,3,4
71,8478454,Noah Juulsen,D,VAN,27,34,1,3,4
71,8483630,Pavol Regenda,L,ANA,25,24,1,3,4
71,8482088,Justin Sourdif,R,FLA,22,13,1,3,4
71,8479991,Jake Leschyshyn,C,NYR,25,29,1,3,4
71,8477467,Gustav Olofsson,D,SEA,30,23,1,3,4
71,8484304,Uvis Balinskis,D,FLA,28,10,1,3,4
71,8478011,Louie Belpedio,D,PHI,28,16,3,0,3
71,8481556,John Beecher,C,BOS,23,32,2,1,3
71,8475235,Nicolas Deslauriers,L,PHI,33,51,2,1,3
71,8478881,Brett Seney,L,CHI,28,15,2,1,3
71,8484258,Sam Malinski,D,COL,26,15,2,1,3
71,8477473,Justin Bailey,R,SJS,29,22,2,1,3
71,8477244,Chad Ruhwedel,D,NYR,34,30,2,1,3
71,8478854,Ryan Shea,D,PIT,27,10,2,1,3
71,8475762,Derek Forbort,D,VAN,32,35,1,2,3
71,8478874,Adam Gaudette,R,OTT,28,33,1,2,3
71,8481719,Maxwell Crozier,D,TBL,24,19,1,2,3
71,8478409,Anthony Richard,C,PHI,28,37,0,3,3
71,8477971,Andreas Englund,D,LAK,28,34,0,3,3
71,8482929,Emil Lilleberg,D,TBL,23,24,0,3,3
71,8482516,Matthew Kessel,D,STL,24,26,0,3,3
71,8482765,Isak Rosen,R,BUF,21,28,2,0,2
71,8484287,Cole McWard,D,VAN,23,23,2,0,2
71,8480032,Shane Bowers,C,NJD,25,10,2,0,2
71,8484325,Waltteri Merela,C,TBL,26,26,2,0,2
71,8483398,Declan Carlile,D,TBL,31,6,2,0,2
71,8483489,Fraser Minten,C,TOR,31,13,2,0,2
71,8478446,Glenn Gawdin,C,LAK,27,10,2,0,2
71,8483512,Matthew Savoie,C,EDM,20,15,2,0,2
71,8481065,Angus Crookshank,L,OTT,25,15,2,0,2
71,8481237,Kyle MacLean,C,NYI,25,23,2,0,2
71,8481541,Samuel Bolduc,D,NYI,24,24,2,0,2
71,8480874,Adam Ginning,D,PHI,24,15,2,0,2
71,8481422,Jake Lucchini,C,NSH,29,22,2,0,2
71,8481605,Jackson LaCombe,D,ANA,23,36,1,1,2
71,8480267,Sammy Walker,C,MIN,25,15,1,1,2
71,8482250,Callahan Burke,C,VGK,27,19,1,1,2
71,8479362,Riley Tufte,L,BOS,26,29,1,1,2
71,8479587,Rhett Gardner,C,PHI,28,23,1,1,2
71,8474062,Riley Nash,C,NYR,35,17,1,1,2
71,8481578,Graeme Clarke,R,MIN,23,9,1,1,2
71,8482061,Brandon Biro,L,SEA,26,12,1,1,2
71,8482470,Ilya Solovyov,D,CGY,24,21,1,1,2
71,8475413,Justin Dowling,C,NJD,34,21,1,1,2
71,8481726,Adam Edstrom,C,NYR,24,10,1,1,2
71,8477149,Scott Sabourin,R,SJS,32,11,1,1,2
71,8483619,Filip Roos,D,OTT,25,28,0,2,2
71,8477073,Kurtis MacDermid,L,NJD,30,30,0,2,2
71,8483395,Arshdeep Bains,L,VAN,23,11,0,2,2
71,8475958,Michael Sgarbossa,C,WSH,32,27,0,2,2
71,8478502,Dennis Gilbert,D,BUF,28,13,0,2,2
71,8477320,Anton Blidh,L,NYR,29,12,0,2,2
71,8477541,Dakota Mermis,D,TOR,30,9,0,2,2
71,8481564,Ryan Johnson,D,BUF,23,13,0,2,2
71,8482177,Marat Khusnutdinov,C,MIN,22,31,1,0,1
71,8481699,Aku Raty,R,UTA,23,19,1,0,1
71,8481743,Marc Del Gaizo,D,NSH,25,18,1,0,1
71,8481585,Egor Afanasyev,L,SJS,23,18,1,0,1
71,8479330,Brandon Gignac,C,MTL,27,13,1,0,1
71,8479421,Jacob Moverare,D,LAK,26,11,1,0,1
71,8482460,Matt Rempe,C,NYR,22,12,1,0,1
71,8480870,Bo Groulx,C,NYR,24,25,0,1,1
71,8482713,Mackie Samoskevich,R,FLA,22,36,0,1,1
71,8482172,Landon Slaggert,L,CHI,22,15,0,1,1
71,8475795,Dylan McIlrath,D,WSH,32,19,0,1,1
71,8482094,Daemon Hunt,D,MIN,22,19,0,1,1
71,8478021,William Lagesson,D,DET,28,29,0,1,1
71,8480823,Alexander Alexeyev,D,WSH,25,9,0,1,1
71,8481043,Cole Koepke,L,BOS,26,21,0,1,1
71,8484255,Jason Polin,R,COL,25,6,0,1,1
71,8481806,Louis Crevier,D,CHI,23,13,0,1,1
71,8481593,Jayden Struble,D,MTL,23,22,0,1,1
71,8483407,Brandon Scanlin,D,NYR,25,4,0,1,1
71,8480075,Cameron Crotty,D,MIN,25,12,0,1,1
71,8481206,John Ludvig,D,PIT,24,15,0,1,1
71,8477993,Justin Kirkland,C,CGY,28,6,0,1,1
71,8483609,Adam Klapka,R,CGY,24,4,0,1,1
71,8481462,Mason Morelli,L,VGK,28,14,0,0,0
71,8482201,Gage Goncalves,C,TBL,23,26,0,0,0
71,8483567,Georgii Merkulov,C,BOS,24,8,0,0,0
71,8483432,Luca Del Bel Belluz,C,CBJ,31,5,0,0,0
71,8483471,Brad Lambert,C,WPG,31,3,0,0,0
71,8482102,Vasily Ponomarev,C,PIT,22,18,0,0,0
71,8482162,Roby Jarventie,L,EDM,22,16,0,0,0
71,8478051,Max Willman,C,NJD,29,18,0,0,0
71,8482787,Nikita Chibrikov,R,WPG,31,9,0,0,0
71,8482197,Adam Raska,R,MIN,23,5,0,0,0
71,8481655,Cole Schwindt,R,CGY,23,1,0,0,0
71,8483531,Brian Halonen,L,NJD,25,1,0,0,0
71,8481006,Tyler Tucker,D,STL,24,13,0,0,0
71,8481030,Jack St. Ivany,D,PIT,25,15,0,0,0
71,8475755,Alexander Petrovic,D,DAL,32,8,0,0,0
71,8476323,Max McCormick,L,SEA,32,8,0,0,0
71,8480306,Grant Hutton,D,NYI,29,5,0,0,0
71,8475780,Chris Wagner,R,COL,33,12,0,0,0
71,8481534,Raphael Lavoie,C,EDM,24,1,0,0,0
71,8483920,Pierrick Dube,R,WSH,23,4,0,0,0
71,8481024,Linus Karlsson,C,VAN,25,7,0,0,0
71,8482476,Emil Heineman,L,MTL,23,6,0,0,0
71,8482126,Emil Andrae,D,PHI,31,2,0,0,0
71,8484326,Patrik Koch,D,UTA,28,0,0,0,0
71,8483401,Marc Johnstone,R,PIT,28,0,0,0,0
71,8478147,Bokondji Imama,L,PIT,28,4,0,0,0
71,8483546,Marshall Rifai,D,TOR,26,10,0,0,0
71,8484259,Ondrej Pavel,C,COL,31,2,0,0,0
71,8479522,Hardy Haman Aktell,D,WSH,26,4,0,0,0
71,8484321,Nikolas Matinpalo,D,OTT,26,2,0,0,0
71,8480274,Philip Kemp,D,EDM,25,0,0,0,0
71,8470794,Joe Pavelski,C,,40,0,0,0,0
71,8479321,Lucas Johansen,D,,27,0,0,0,0
71,8477950,Tony DeAngelo,D,,29,0,0,0,0
71,8471218,Blake Wheeler,R,,38,0,0,0,0
71,8475197,Tyson Barrie,D,,33,0,0,0,0
71,8474157,Max Pacioretty,L,,36,0,0,0,0
71,8475744,Evgeny Kuznetsov,C,,32,0,0,0,0
71,8474037,James van Riemsdyk,L,,35,0,0,0,0
71,8476907,Mackenzie MacEachern,L,,30,0,0,0,0
71,8480216,Jacob Peterson,C,,25,0,0,0,0
71,8474602,Justin Schultz,D,,34,0,0,0,0
71,8482222,Alexander Barabanov,L,,30,0,0,0,0
71,8474031,Kevin Shattenkirk,D,,35,0,0,0,0
71,8477330,Dominik Kubalik,L,,29,0,0,0,0
71,8480884,Calen Addison,D,,24,0,0,0,0
71,8475906,John Klingberg,D,,32,0,0,0,0
71,8480008,Adam Ruzicka,C,,25,0,0,0,0
71,8476884,Derrick Pouliot,D,,30,0,0,0,0
71,8476919,Chris Tierney,C,,30,0,0,0,0
71,8479415,Michael McLeod,C,,26,0,0,0,0
71,8474870,Tyler Johnson,C,,34,0,0,0,0
71,8470604,Jeff Carter,C,,39,0,0,0,0
71,8478104,Sammy Blais,L,,28,0,0,0,0
71,8474884,Mike Hoffman,C,,35,0,0,0,0
71,8481591,Sam Poulin,R,,23,0,0,0,0
71,8471274,Alex Goligoski,D,,39,0,0,0,0
71,8476871,Tanner Pearson,L,,32,0,0,0,0
71,8476393,Nick Cousins,C,,31,0,0,0,0
71,8479977,Kailer Yamamoto,R,,26,0,0,0,0
71,8479346,Dillon Dube,C,,26,0,0,0,0
71,8480184,Gustav Lindstrom,D,,26,0,0,0,0
71,8479376,Victor Mete,D,,26,0,0,0,0
71,8473449,Kyle Okposo,R,,36,0,0,0,0
71,8481058,Jesse Ylonen,R,,25,0,0,0,0
71,8475752,Tyler Pitlick,C,,33,0,0,0,0
71,8481239,Samuel Fagemo,L,,24,0,0,0,0
71,8480821,Filip Zadina,R,,25,0,0,0,0
71,8470966,Mark Giordano,D,,41,0,0,0,0
71,8478495,Denis Gurianov,R,,27,0,0,0,0
71,8477464,Nic Petan,C,,29,0,0,0,0
71,8478099,Kevin Labanc,R,,29,0,0,0,0
71,8482241,Radim Zohorna,L,,28,0,0,0,0
71,8474040,Sam Gagner,C,,35,0,0,0,0
71,8479514,Rem Pitlick,C,,27,0,0,0,0
71,8478430,Oliver Kylington,D,,27,0,0,0,0
71,8479533,Joona Koppanen,L,,26,0,0,0,0
71,8479984,Cal Foote,D,,26,0,0,0,0
71,8477126,Jayson Megna,C,,34,0,0,0,0
71,8475164,Jakob Silfverberg,R,,34,0,0,0,0
71,8474009,Nick Bonino,C,,36,0,0,0,0
71,8479458,Nikita Zaitsev,D,,33,0,0,0,0
71,8477944,Jakub Vrana,L,,28,0,0,0,0
71,8471699,Andrew Cogliano,C,,37,0,0,0,0
71,8478067,Oskar Lindblom,L,,28,0,0,0,0
71,8471686,Marc Staal,D,,37,0,0,0,0
71,8470610,Zach Parise,L,,40,0,0,0,0
71,8478904,Steven Lorentz,C,,28,0,0,0,0
71,8473473,Milan Lucic,L,,36,0,0,0,0
71,8480031,Maxime Comtois,L,,25,0,0,0,0
71,8478512,Austin Czarnik,C,,32,0,0,0,0
71,8473504,Cal Clutterbuck,R,,37,0,0,0,0
71,8477454,Adam Erne,L,,29,0,0,0,0
71,8479383,Boris Katchouk,L,,26,0,0,0,0
71,8475825,Jani Hakanpää,D,,32,0,0,0,0
71,8477846,Ryan Carpenter,C,,33,0,0,0,0
71,8477930,Pierre-Edouard Bellemare,L,,39,0,0,0,0
71,8478400,Colin White,C,,27,0,0,0,0
71,8480226,Marián Studenic,R,,26,0,0,0,0
71,8480853,Liam Foudy,C,,24,0,0,0,0
71,8475797,Jarred Tinordi,D,,32,0,0,0,0
71,8479423,Alex Nylander,L,,26,0,0,0,0
71,8474618,Marco Scandella,D,,34,0,0,0,0
71,8478028,Fredrik Olofsson,L,,28,0,0,0,0
71,8474709,Matt Martin,L,,35,0,0,0,0
71,8481070,Hugh McGing,L,,26,0,0,0,0
71,8479546,Oskar Steen,C,,26,0,0,0,0
71,8474145,Robert Bortuzzo,D,,35,0,0,0,0
71,8476915,Jujhar Khaira,L,,30,0,0,0,0
71,8475278,Byron Froese,C,,33,0,0,0,0
71,8481812,Nikolai Knyzhov,D,,27,0,0,0,0
71,8478408,Travis Dermott,D,,28,0,0,0,0
71,8481077,John Leonard,L,,26,0,0,0,0
71,8479547,Matthew Phillips,R,,26,0,0,0,0
71,8480836,Jonathan Gruden,C,,24,0,0,0,0
71,8481690,Tyler Angle,C,,24,0,0,0,0
71,8475766,Austin Watson,L,,32,0,0,0,0
71,8481016,Ruslan Iskhakov,C,,24,0,0,0,0
71,8478078,Rourke Chartier,C,,28,0,0,0,0
71,8480776,Sheldon Rempal,R,,29,0,0,0,0
71,8478956,Samuel Laberge,L,NJD,27,0,0,0,0
71,8483045,Cameron Butler,R,CBJ,31,0,0,0,0
71,8484314,Jiri Smejkal,L,,28,0,0,0,0
72,8477492,Nathan MacKinnon,C,COL,29,78,56,94,150
72,8476453,Nikita Kucherov,R,TBL,31,82,49,100,149
72,8478402,Connor McDavid,C,EDM,27,79,36,93,129
72,8478483,Mitch Marner,R,TOR,27,79,34,90,124
72,8481559,Jack Hughes,C,NJD,23,81,53,68,121
72,8479318,Auston Matthews,C,TOR,27,78,57,62,119
72,8479314,Matthew Tkachuk,L,FLA,27,78,33,77,110
72,8477934,Leon Draisaitl,C,EDM,29,78,35,74,109
72,8477939,William Nylander,R,TOR,28,79,48,55,103
72,8478010,Brayden Point,C,TBL,28,82,49,53,102
72,8477956,David Pastrnak,R,BOS,28,78,46,56,102
72,8477946,Dylan Larkin,C,DET,28,82,48,48,96
72,8478864,Kirill Kaprizov,L,MIN,27,71,42,53,95
72,8477404,Jake Guentzel,C,TBL,30,81,34,61,95
72,8479343,Clayton Keller,R,UTA,26,78,45,49,94
72,8477402,Pavel Buchnevich,L,STL,29,80,37,57,94
72,8479323,Adam Fox,D,NYR,26,77,14,77,91
72,8477409,Carter Verhaeghe,C,FLA,29,78,47,43,90
72,8473419,Brad Marchand,L,BOS,36,80,38,52,90
72,8475166,John Tavares,C,TOR,34,80,37,53,90
72,8480036,Miro Heiskanen,D,DAL,25,78,18,70,88
72,8478403,Jack Eichel,C,VGK,28,77,47,40,87
72,8480023,Robert Thomas,C,STL,25,76,26,61,87
72,8476468,J.T. Miller,C,VAN,31,74,26,60,86
72,8480002,Nico Hischier,C,NJD,25,77,26,60,86
72,8477942,Kevin Fiala,L,LAK,28,80,22,64,86
72,8475913,Mark Stone,R,VGK,32,74,34,51,85
72,8477951,Nick Schmaltz,C,UTA,28,76,33,52,85
72,8478550,Artemi Panarin,L,NYR,33,79,31,54,85
72,8478449,Roope Hintz,C,DAL,28,81,44,40,84
72,8477949,Alex Tuch,R,BUF,28,75,27,57,84
72,8474578,Erik Karlsson,D,PIT,34,80,26,58,84
72,8480027,Jason Robertson,L,DAL,25,82,37,46,83
72,8478460,Zach Werenski,D,CBJ,27,80,25,58,83
72,8477493,Aleksander Barkov,C,FLA,29,75,28,54,82
72,8482116,Tim Stützle,C,OTT,22,77,25,55,80
72,8480018,Nick Suzuki,C,MTL,25,74,23,57,80
72,8475754,Brock Nelson,C,NYI,33,80,40,39,79
72,8479407,Jesper Bratt,L,NJD,26,73,29,50,79
72,8478047,Michael Bunting,L,PIT,29,78,28,51,79
72,8479385,Jordan Kyrou,C,STL,26,72,23,56,79
72,8471675,Sidney Crosby,C,PIT,37,71,40,38,78
72,8471214,Alex Ovechkin,L,WSH,39,74,40,38,78
72,8480012,Elias Pettersson,C,VAN,26,74,32,46,78
72,8478420,Mikko Rantanen,R,COL,28,82,24,54,78
72,8474600,Roman Josi,D,NSH,34,70,24,54,78
72,8480208,Drake Batherson,R,OTT,26,80,40,37,77
72,8479420,Tage Thompson,C,BUF,27,78,36,41,77
72,8479337,Alex DeBrincat,R,DET,27,79,27,49,76
72,8478440,Dylan Strome,C,WSH,27,71,26,50,76
72,8476346,Johnny Gaudreau,L,CBJ,31,72,21,55,76
72,8476460,Mark Scheifele,C,WPG,31,74,31,44,75
72,8478445,Mathew Barzal,C,NYI,27,79,30,45,75
72,8478427,Sebastian Aho,C,CAR,27,73,33,41,74
72,8477501,Valeri Nichushkin,R,COL,29,82,36,37,73
72,8480839,Rasmus Dahlin,D,BUF,24,73,11,62,73
72,8484144,Connor Bedard,C,CHI,19,66,31,41,72
72,8478439,Travis Konecny,R,PHI,27,74,30,42,72
72,8478975,Mason Marchment,L,DAL,29,81,28,44,72
72,8480069,Cale Makar,D,COL,26,66,21,51,72
72,8482740,Wyatt Johnston,C,DAL,21,80,40,31,71
72,8480801,Brady Tkachuk,L,OTT,25,78,33,38,71
72,8477416,Oliver Bjorkstrand,R,SEA,29,76,28,43,71
72,8481557,Matt Boldy,L,MIN,23,72,27,44,71
72,8475172,Nazem Kadri,C,CGY,34,78,26,45,71
72,8476454,Ryan Nugent-Hopkins,C,EDM,31,80,23,48,71
72,8475167,Victor Hedman,D,TBL,34,82,15,56,71
72,8480800,Quinn Hughes,D,VAN,25,76,10,61,71
72,8478873,Troy Terry,R,ANA,27,78,33,37,70
72,8478401,Pavel Zacha,C,BOS,27,79,29,41,70
72,8477500,Bo Horvat,C,NYI,29,81,27,43,70
72,8474141,Patrick Kane,R,DET,36,81,26,44,70
72,8471685,Anze Kopitar,C,LAK,37,82,24,46,70
72,8471724,Kris Letang,D,PIT,37,78,15,54,69
72,8476459,Mika Zibanejad,C,NYR,31,77,24,44,68
72,8481711,Matias Maccelli,L,UTA,24,74,20,48,68
72,8476539,Jonathan Marchessault,R,NSH,34,77,39,28,67
72,8475794,Tyler Seguin,C,DAL,32,82,33,34,67
72,8480039,Martin Necas,C,CAR,25,72,28,39,67
72,8477940,Nikolaj Ehlers,L,WPG,28,74,24,43,67
72,8476456,Jonathan Huberdeau,C,CGY,31,80,20,47,67
72,8477933,Sam Reinhart,C,FLA,29,74,33,33,66
72,8475184,Chris Kreider,L,NYR,33,76,30,36,66
72,8477960,Adrian Kempe,R,LAK,28,82,27,39,66
72,8476905,Chandler Stephenson,C,SEA,30,71,26,40,66
72,8471215,Evgeni Malkin,C,PIT,38,71,18,48,66
72,8478407,Vince Dunn,D,SEA,28,72,18,48,66
72,8475692,Mats Zuccarello,R,MIN,37,75,16,50,66
72,8478398,Kyle Connor,L,WPG,28,73,31,34,65
72,8479542,Brandon Hagel,L,TBL,26,82,30,35,65
72,8476389,Vincent Trocheck,C,NYR,31,74,26,39,65
72,8480830,Andrei Svechnikov,R,CAR,24,67,26,39,65
72,8482665,Matty Beniers,C,SEA,22,76,22,43,65
72,8477476,Artturi Lehkonen,L,COL,29,79,40,24,64
72,8481540,Cole Caufield,R,MTL,23,75,33,31,64
72,8482078,Lucas Raymond,L,DET,22,78,32,32,64
72,8474564,Steven Stamkos,C,NSH,34,74,31,33,64
72,8475745,Charlie Coyle,C,BOS,32,77,28,36,64
72,8476448,William Karlsson,C,VGK,31,78,18,46,64
72,8475168,Matt Duchene,C,DAL,33,80,29,34,63
72,8475158,Ryan O'Reilly,C,NSH,33,73,24,39,63
72,8478414,Timo Meier,R,NJD,28,69,23,40,63
72,8484166,Adam Fantilli,C,CBJ,20,70,28,34,62
72,8476887,Filip Forsberg,L,NSH,30,75,20,42,62
72,8473994,Jamie Benn,L,DAL,35,82,15,47,62
72,8475810,Bryan Rust,R,PIT,32,73,29,32,61
72,8477496,Elias Lindholm,C,BOS,30,81,29,32,61
72,8477494,Jonathan Drouin,L,COL,29,81,10,51,61
72,8475765,Vladimir Tarasenko,R,DET,33,82,26,33,59
72,8475784,Jeff Skinner,C,EDM,32,75,24,35,59
72,8477986,Brandon Montour,D,SEA,30,77,21,38,59
72,8480803,Evan Bouchard,D,EDM,25,75,17,42,59
72,8475151,Kyle Palmieri,C,NYI,33,78,30,28,58
72,8476399,Blake Coleman,C,CGY,33,77,27,31,58
72,8476479,Phillip Danault,C,LAK,31,79,25,33,58
72,8482093,Seth Jarvis,C,CAR,22,71,22,36,58
72,8482745,Mason McTavish,C,ANA,21,67,23,34,57
72,8481528,Dylan Cozens,C,BUF,23,65,23,34,57
72,8479400,Pierre-Luc Dubois,L,WSH,26,75,22,35,57
72,8475786,Zach Hyman,L,EDM,32,77,29,27,56
72,8480015,Owen Tippett,R,PHI,25,76,26,30,56
72,8477935,Sam Bennett,C,FLA,28,75,26,30,56
72,8473512,Claude Giroux,R,OTT,36,81,25,31,56
72,8478519,Anthony Cirelli,C,TBL,27,82,24,32,56
72,8474586,Jordan Eberle,R,SEA,34,69,23,33,56
72,8480865,Noah Dobson,D,NYI,24,79,8,48,56
72,8476881,Tomas Hertl,C,VGK,31,78,27,28,55
72,8475170,Brayden Schenn,C,STL,33,71,24,31,55
72,8478458,John (Jack) Roslovic,C,CAR,27,73,23,32,55
72,8477503,Max Domi,C,TOR,29,73,19,36,55
72,8481596,Shane Pinto,C,OTT,24,77,18,37,55
72,8476853,Morgan Rielly,D,TOR,30,68,9,46,55
72,8482124,Quinton Byfield,R,LAK,22,79,20,34,54
72,8479675,Trevor Moore,L,LAK,29,80,16,38,54
72,8477504,Josh Morrissey,D,WPG,29,71,12,42,54
72,8476875,Mike Matheson,D,MTL,30,74,9,45,54
72,8482684,Luke Hughes,D,NJD,21,74,9,45,54
72,8482109,Alexis Lafrenière,L,NYR,23,77,37,16,53
72,8480014,Gabriel Vilardi,C,WPG,25,74,32,21,53
72,8478493,Joel Eriksson Ek,C,MIN,27,74,24,29,53
72,8478856,Conor Garland,R,VAN,28,70,23,30,53
72,8475798,Mikael Granlund,C,SJS,32,69,17,36,53
72,8482699,Dylan Guenther,R,UTA,21,75,24,28,52
72,8476826,Yanni Gourde,C,SEA,33,71,22,30,52
72,8484145,Zach Benson,L,BUF,19,68,20,32,52
72,8483515,Juraj Slafkovsky,L,MTL,20,75,17,35,52
72,8477955,Jared McCann,L,SEA,28,74,23,28,51
72,8482159,Tyson Foerster,R,PHI,22,76,23,28,51
72,8473986,Alex Killorn,L,ANA,35,70,22,29,51
72,8477497,Sean Monahan,C,CBJ,30,67,17,34,51
72,8483431,Logan Cooley,C,UTA,20,68,15,36,51
72,8474679,Gustav Nyquist,C,NSH,35,72,12,39,51
72,8474590,John Carlson,D,WSH,34,69,7,44,51
72,8482702,Logan Stankoven,C,DAL,21,81,16,34,50
72,8482097,Jack Quinn,R,BUF,23,70,14,36,50
72,8476906,Shayne Gostisbehere,D,CAR,31,76,11,39,50
72,8478397,Rasmus Andersson,D,CGY,28,73,9,41,50
72,8478444,Brock Boeser,R,VAN,27,72,24,25,49
72,8479525,Ross Colton,C,COL,28,82,23,26,49
72,8484153,Leo Carlsson,C,ANA,20,70,17,32,49
72,8481068,Yegor Sharangovich,C,CGY,26,77,24,24,48
72,8482110,Dawson Mercer,C,NJD,23,73,23,25,48
72,8479999,Casey Mittelstadt,C,COL,26,81,21,27,48
72,8477426,Nicholas Paul,L,TBL,29,82,21,27,48
72,8477456,J.T. Compher,L,DET,29,78,20,28,48
72,8477407,Anthony Duclair,L,NYI,29,78,19,29,48
72,8478438,Tommy Novak,C,NSH,27,73,18,30,48
72,8478042,Viktor Arvidsson,L,EDM,31,73,16,32,48
72,8477479,Tyler Bertuzzi,L,CHI,29,66,16,32,48
72,8481582,Nicholas Robertson,L,TOR,23,72,30,17,47
72,8475726,Tyler Toffoli,C,SJS,32,61,26,21,47
72,8476483,Rickard Rakell,R,PIT,31,70,24,23,47
72,8481533,Trevor Zegras,C,ANA,23,72,18,29,47
72,8475722,Jason Zucker,L,BUF,32,65,17,30,47
72,8476792,Torey Krug,D,STL,33,71,13,34,47
72,8476923,Damon Severson,D,CBJ,30,78,10,37,47
72,8476854,Hampus Lindholm,D,BOS,30,77,8,39,47
72,8478366,Frank Vatrano,R,ANA,30,72,25,21,46
72,8475169,Evander Kane,L,EDM,33,76,24,22,46
72,8481186,Logan O'Connor,R,COL,28,81,20,26,46
72,8474102,David Perron,L,OTT,36,77,19,27,46
72,8480064,Josh Norris,C,OTT,25,77,17,29,46
72,8475763,Kevin Hayes,R,PIT,32,71,17,29,46
72,8479325,Charlie McAvoy,D,BOS,27,71,3,43,46
72,8479365,Trent Frederic,C,BOS,26,77,23,22,45
72,8482475,Yegor Chinakhov,R,CBJ,23,66,23,22,45
72,8479987,Morgan Geekie,C,BOS,26,80,21,24,45
72,8477964,Ivan Barbashev,C,VGK,29,76,20,25,45
72,8480009,Eeli Tolvanen,R,SEA,25,71,19,26,45
72,8475768,Jaden Schwartz,C,SEA,32,69,15,30,45
72,8481542,Moritz Seider,D,DET,23,75,5,40,45
72,8477511,Anthony Mantha,R,CGY,30,73,23,21,44
72,8476872,Scott Laughton,C,PHI,30,75,11,33,44
72,8477429,Andrew Copp,C,DET,30,77,8,36,44
72,8478055,Gustav Forsling,D,FLA,28,73,7,37,44
72,8476432,Boone Jenner,C,CBJ,31,73,25,18,43
72,8480871,Adam Boqvist,D,FLA,24,66,20,23,43
72,8474150,Mikael Backlund,C,CGY,35,73,19,24,43
72,8477998,Warren Foegele,L,LAK,28,80,19,24,43
72,8476869,Brady Skjei,D,NSH,30,77,16,27,43
72,8480185,Eetu Luostarinen,C,FLA,26,78,15,28,43
72,8480434,Sean Durzi,D,UTA,26,69,13,30,43
72,8482720,Matthew Knies,L,TOR,22,77,13,30,43
72,8479351,Sam Steel,C,DAL,26,82,10,33,43
72,8475764,Cam Fowler,D,ANA,33,74,5,38,43
72,8475314,Anders Lee,L,NYI,34,78,30,12,42
72,8476438,Brandon Saad,L,STL,32,71,22,20,42
72,8478046,Danton Heinen,L,VAN,29,71,19,23,42
72,8478498,Jake DeBrusk,L,VAN,28,73,16,26,42
72,8480028,Morgan Frost,C,PHI,25,69,16,26,42
72,8481581,Thomas Harley,D,DAL,23,74,13,29,42
72,8470613,Brent Burns,D,CAR,39,77,9,33,42
72,8478469,Thomas Chabot,D,OTT,27,75,8,34,42
72,8479410,Mikhail Sergachev,D,UTA,26,74,5,37,42
72,8478462,Nicolas Roy,C,VGK,27,75,16,25,41
72,8477932,Aaron Ekblad,D,FLA,28,71,11,30,41
72,8475191,Reilly Smith,R,NYR,33,73,16,24,40
72,8480188,Fabian Zetterlund,L,SJS,25,71,16,24,40
72,8471698,T.J. Oshie,R,WSH,38,64,16,24,40
72,8478472,Mathieu Joseph,R,STL,27,74,16,24,40
72,8478466,Daniel Sprong,R,VAN,27,71,14,26,40
72,8474563,Drew Doughty,D,LAK,35,72,13,27,40
72,8476979,Erik Gustafsson,D,DET,32,75,5,35,40
72,8479293,Brandon Tanev,L,SEA,33,62,23,16,39
72,8475714,Calle Jarnkrok,C,TOR,33,75,21,18,39
72,8475287,Erik Haula,L,NJD,33,74,19,20,39
72,8474641,Adam Henrique,C,EDM,34,78,18,21,39
72,8481618,Alex Newhook,C,MTL,23,75,17,22,39
72,8479992,Michael Rasmussen,C,DET,25,79,17,22,39
72,8481524,Bowen Byram,D,BUF,23,70,17,22,39
72,8476419,Jean-Gabriel Pageau,C,NYI,32,78,15,24,39
72,8476882,Teuvo Teravainen,C,CHI,30,65,12,27,39
72,8476461,Sean Couturier,C,PHI,32,71,12,27,39
72,8477447,Shea Theodore,D,VGK,29,50,9,30,39
72,8474565,Alex Pietrangelo,D,VGK,34,61,8,31,39
72,8481703,Valtteri Puustinen,R,PIT,25,61,8,31,39
72,8475799,Nino Niederreiter,R,WPG,32,72,22,16,38
72,8482055,Drew O'Connor,L,PIT,26,66,22,16,38
72,8481560,Arthur Kaliyev,R,LAK,23,78,17,21,38
72,8483808,Andrei Kuzmenko,L,CGY,28,76,16,22,38
72,8474149,Evgenii Dadonov,R,DAL,35,81,16,22,38
72,8477021,Alex Kerfoot,C,UTA,30,71,14,24,38
72,8475753,Justin Faulk,D,STL,32,71,11,27,38
72,8478396,Noah Hanifin,D,VGK,27,67,9,29,38
72,8476880,Tom Wilson,R,WSH,30,67,17,20,37
72,8480797,Joel Farabee,L,PHI,24,77,15,22,37
72,8477444,Andre Burakovsky,L,SEA,29,72,15,22,37
72,8478115,Pierre Engvall,L,NYI,28,78,15,22,37
72,8477953,Kasperi Kapanen,R,STL,28,69,15,22,37
72,8476458,Ryan Strome,C,ANA,31,69,11,26,37
72,8478500,Ivan Provorov,D,CBJ,27,78,10,27,37
72,8476885,Jacob Trouba,D,NYR,30,76,9,28,37
72,8478038,Devon Toews,D,COL,30,71,7,30,37
72,8482175,JJ Peterka,R,BUF,22,72,22,14,36
72,8477952,Robby Fabbri,C,ANA,28,64,17,19,36
72,8480829,Jesperi Kotkaniemi,C,CAR,24,66,16,20,36
72,8482092,Ridly Greig,C,OTT,22,80,16,20,36
72,8478057,Dakota Joshua,C,VAN,28,68,15,21,36
72,8480220,Noah Cates,L,PHI,25,72,14,22,36
72,8481577,Philip Tomasino,C,NSH,23,65,13,23,36
72,8480798,Philipp Kurashev,C,CHI,25,68,13,23,36
72,8479345,Jakob Chychrun,D,WSH,26,67,12,24,36
72,8478542,Evan Rodrigues,C,FLA,31,75,10,26,36
72,8477435,Ryan Graves,D,PIT,29,73,9,27,36
72,8475218,Mattias Ekholm,D,EDM,34,76,8,28,36
72,8477495,Seth Jones,D,CHI,30,68,7,29,36
72,8477346,MacKenzie Weegar,D,CGY,30,72,6,30,36
72,8478463,Anthony Beauvillier,L,PIT,27,66,15,20,35
72,8482149,Cole Perfetti,C,WPG,22,63,13,22,35
72,8477451,Ryan Hartman,R,MIN,30,67,13,22,35
72,8479339,Patrik Laine,L,CBJ,26,55,11,24,35
72,8476422,Mike Reilly,D,NYI,31,76,11,24,35
72,8482133,Thomas Bordeleau,C,SJS,22,64,9,26,35
72,8479425,Filip Hronek,D,VAN,27,72,8,27,35
72,8475200,Dmitry Orlov,D,CAR,33,76,8,27,35
72,8483490,Pavel Mintyukov,D,ANA,21,73,6,29,35
72,8482712,Oskar Olausson,R,COL,22,79,6,29,35
72,8482113,Anton Lundell,C,FLA,23,75,20,14,34
72,8476981,Josh Anderson,R,MTL,30,68,17,17,34
72,8475760,Nick Bjugstad,C,UTA,32,70,16,18,34
72,8476278,Colin Blackwell,C,DAL,31,74,15,19,34
72,8477839,Conor Sheary,L,TBL,32,80,15,19,34
72,8481656,Aliaksei Protas,C,WSH,23,67,14,20,34
72,8481523,Kirby Dach,C,MTL,23,66,13,21,34
72,8480144,David Kampf,C,TOR,29,72,13,21,34
72,8477948,Travis Sanheim,D,PHI,28,74,9,25,34
72,8476331,Dylan DeMelo,D,WPG,31,73,7,27,34
72,8480145,Neal Pionk,D,WPG,29,75,5,29,34
72,8478474,Lawson Crouse,L,UTA,27,73,20,13,33
72,8470621,Corey Perry,R,EDM,39,71,19,14,33
72,8481554,Kaapo Kakko,R,NYR,23,63,15,18,33
72,8482667,William Eklund,L,SJS,22,59,14,19,33
72,8479390,Taylor Raddysh,R,WSH,26,68,13,20,33
72,8475149,Marcus Johansson,L,MIN,34,64,12,21,33
72,8482660,Kent Johnson,C,CBJ,22,65,11,22,33
72,8477498,Darnell Nurse,D,EDM,29,70,11,22,33
72,8476292,Ondrej Palat,L,NJD,33,64,10,23,33
72,8476958,Jaccob Slavin,D,CAR,30,68,7,26,33
72,8475171,Oliver Ekman-Larsson,D,TOR,33,68,5,28,33
72,8480893,Kirill Marchenko,R,CBJ,24,62,20,12,32
72,8483468,Jiri Kulich,C,BUF,20,64,18,14,32
72,8478020,Michael Amadio,R,OTT,28,76,17,15,32
72,8481093,Rafael Harvey-Pinard,L,MTL,25,56,14,18,32
72,8475793,Ryan Johansen,C,PHI,32,72,13,19,32
72,8476897,Oskar Sundqvist,C,STL,30,67,11,21,32
72,8475848,Brendan Gallagher,R,MTL,32,77,10,22,32
72,8481546,Cam York,D,PHI,23,71,8,24,32
72,8482089,Jake Neighbours,L,STL,22,69,20,11,31
72,8476927,Teddy Blueger,C,VAN,30,67,16,15,31
72,8477989,Christian Dvorak,C,MTL,28,64,15,16,31
72,8477450,Jason Dickinson,C,CHI,29,59,15,16,31
72,8478413,Jordan Greenway,L,BUF,27,59,15,16,31
72,8476892,Colton Parayko,D,STL,31,68,11,20,31
72,8476474,Stefan Noesen,R,NJD,31,70,10,21,31
72,8480336,Sean Walker,D,CAR,30,73,9,22,31
72,8482101,Danil Gushchin,L,SJS,22,66,9,22,31
72,8483505,Matthew Poitras,C,BOS,20,73,8,23,31
72,8480891,Michael Kesselring,D,UTA,24,62,5,26,31
72,8477969,Marcus Pettersson,D,PIT,28,79,1,30,31
72,8481032,Paul Cotter,C,NJD,25,66,19,11,30
72,8482146,Luke Evangelista,R,NSH,22,67,16,14,30
72,8480068,Ryan Poehling,C,PHI,25,68,15,15,30
72,8483457,Lane Hutson,D,MTL,20,74,15,15,30
72,8482803,Olen Zellweger,D,ANA,21,72,13,17,30
72,8476856,Mathew Dumba,D,DAL,30,71,9,21,30
72,8482671,Owen Power,D,BUF,22,64,8,22,30
72,8480849,Barrett Hayton,C,UTA,24,68,15,14,29
72,8477425,Miles Wood,L,COL,29,78,14,15,29
72,8474053,Logan Couture,C,SJS,35,61,13,16,29
72,8477505,Alexander Wennberg,C,SJS,30,58,12,17,29
72,8478233,Andrew Mangiapane,L,WSH,28,72,12,17,29
72,8480813,Joe Veleno,C,DET,24,79,11,18,29
72,8481606,Jordan Spence,D,LAK,23,68,10,19,29
72,8484203,Bradly Nadeau,L,CAR,19,61,9,20,29
72,8478970,Jalen Chatfield,D,CAR,28,69,9,20,29
72,8476469,Joel Armia,R,MTL,31,73,14,14,28
72,8473533,Jordan Staal,C,CAR,36,69,12,16,28
72,8477987,Ryan Donato,C,CHI,28,63,12,16,28
72,8481624,Ilya Mikheyev,R,CHI,30,54,11,17,28
72,8480789,Oliver Wahlstrom,R,NYI,24,70,10,18,28
72,8476392,Adam Lowry,C,WPG,31,61,9,19,28
72,8480817,K'Andre Miller,D,NYR,24,71,9,19,28
72,8476462,Dougie Hamilton,D,NJD,31,75,8,20,28
72,8474189,Lars Eller,C,PIT,35,55,17,10,27
72,8476921,Jordan Martinook,L,CAR,32,60,15,12,27
72,8483482,Tristan Luneau,D,ANA,20,65,15,12,27
72,8482125,Alexander Holtz,R,VGK,22,74,14,13,27
72,8476918,Jimmy Vesey,L,NYR,31,74,12,15,27
72,8479661,Tanner Jeannot,L,LAK,27,77,11,16,27
72,8480802,Ryan McLeod,C,BUF,25,65,10,17,27
72,8475791,Taylor Hall,L,CHI,33,58,9,18,27
72,8477507,Nikita Zadorov,D,BOS,29,71,5,22,27
72,8480049,Dylan Samberg,D,WPG,25,70,4,23,27
72,8480205,Emil Bemstrom,C,PIT,25,54,16,10,26
72,8478569,Noel Acciari,C,PIT,33,64,15,11,26
72,8478432,Christian Fischer,R,DET,27,73,13,13,26
72,8478911,Matt Roy,D,WSH,29,66,9,17,26
72,8476878,Zemgus Girgensons,C,TBL,30,80,9,17,26
72,8482105,Jake Sanderson,D,OTT,22,76,7,19,26
72,8475233,David Savard,D,MTL,34,59,6,20,26
72,8477845,Trevor van Riemsdyk,D,WSH,33,61,2,24,26
72,8476917,Adam Pelech,D,NYI,30,79,1,25,26
72,8479996,Cody Glass,C,NSH,25,56,16,9,25
72,8480459,Pius Suter,C,VAN,28,72,14,11,25
72,8480113,Alex Iafallo,L,WPG,31,62,12,13,25
72,8482705,Cole Sillinger,C,CBJ,21,66,12,13,25
72,8480995,Pontus Holmberg,R,TOR,25,65,11,14,25
72,8478882,Vladislav Gavrikov,D,LAK,29,72,7,18,25
72,8479983,Mario Ferraro,D,SJS,26,75,4,21,25
72,8478840,Will Borgen,D,SEA,28,62,4,21,25
72,8476902,Esa Lindell,D,DAL,30,78,3,22,25
72,8477506,Ryan Pulock,D,NYI,30,78,2,23,25
72,8482079,Marco Rossi,C,MIN,23,59,16,8,24
72,8480980,Connor Dewar,C,TOR,25,62,13,11,24
72,8478013,Jake Walman,D,SJS,28,67,11,13,24
72,8475220,Marcus Foligno,L,MIN,33,58,10,14,24
72,8480748,Kiefer Sherwood,L,VAN,29,62,10,14,24
72,8473422,Nick Foligno,L,CHI,37,57,10,14,24
72,8480855,Jack McBain,C,UTA,24,71,10,14,24
72,8481601,Simon Holmstrom,R,NYI,23,65,9,15,24
72,8476925,Colton Sissons,C,NSH,31,66,8,16,24
72,8482122,Brock Faber,D,MIN,22,75,6,18,24
72,8476467,Jamie Oleksiak,D,SEA,32,69,6,18,24
72,8482624,Daniil Miromanov,D,CGY,27,67,5,19,24
72,8477220,Nate Schmidt,D,FLA,33,63,5,19,24
72,8474151,Ryan McDonagh,D,TBL,35,74,4,20,24
72,8476931,Jake McCabe,D,TOR,31,60,4,20,24
72,8479398,Samuel Girard,D,COL,26,62,3,21,24
72,8482655,Janis Moser,D,TBL,24,80,3,21,24
72,8476480,Vladislav Namestnikov,C,WPG,32,66,13,10,23
72,8474715,Cameron Atkinson,R,TBL,35,82,12,11,23
72,8481553,Bobby Brink,R,PHI,23,56,12,11,23
72,8478891,Mason Appleton,C,WPG,28,64,10,13,23
72,8476889,Radek Faksa,C,STL,30,60,10,13,23
72,8481716,Dmitri Voronkov,L,CBJ,24,48,10,13,23
72,8481014,Alexander Romanov,D,NYI,24,79,9,14,23
72,8477353,Tyler Motte,C,DET,29,71,9,14,23
72,8476873,Mark Jankowski,C,NSH,30,56,8,15,23
72,8478421,A.J. Greer,L,FLA,28,58,8,15,23
72,8476525,Colin Miller,D,WPG,32,61,6,17,23
72,8476463,Jonas Brodin,D,MIN,31,74,5,18,23
72,8475181,Nick Leddy,D,STL,33,71,4,19,23
72,8479324,Ryan Lindgren,D,NYR,26,63,4,19,23
72,8477478,William Carrier,L,CAR,30,57,13,9,22
72,8479619,Michael Carcone,L,UTA,28,62,12,10,22
72,8482749,Joshua Roy,R,MTL,21,62,11,11,22
72,8479414,Nathan Bastian,R,NJD,27,57,11,11,22
72,8482074,Connor Zary,C,CGY,23,65,10,12,22
72,8482062,Cole Smith,L,NSH,29,56,10,12,22
72,8482737,Zack Bolduc,C,STL,21,62,10,12,22
72,8481521,Ronnie Attard,D,PHI,25,56,9,13,22
72,8477488,Brett Pesce,D,NJD,30,69,8,14,22
72,8474716,Jared Spurgeon,D,MIN,35,72,7,15,22
72,8476312,Josh Manson,D,COL,33,68,7,15,22
72,8483524,Shane Wright,C,SEA,20,62,7,15,22
72,8480003,Jesper Boqvist,C,FLA,26,68,7,15,22
72,8483565,Nick Blankenburg,D,NSH,26,63,5,17,22
72,8482192,Isaak Phillips,D,CHI,23,59,5,17,22
72,8476429,Scott Mayfield,D,NYI,32,70,4,18,22
72,8479998,Mikey Anderson,D,LAK,25,63,4,18,22
72,8475462,Radko Gudas,D,ANA,34,68,3,19,22
72,8478851,Alexandre Carrier,D,NSH,28,66,3,19,22
72,8476457,Adam Larsson,D,SEA,32,69,1,21,22
72,8482077,Dylan Holloway,L,EDM,23,55,14,7,21
72,8481535,Nils Hoglander,L,VAN,24,67,13,8,21
72,8481580,Connor McMichael,C,WSH,23,54,10,11,21
72,8475343,Nic Dowd,C,WSH,34,64,9,12,21
72,8479066,Ryan Lomberg,L,CGY,30,67,9,12,21
72,8480078,Filip Chytil,C,NYR,25,66,8,13,21
72,8483495,Simon Nemec,D,NJD,20,58,8,13,21
72,8477979,Nicolas Aube-Kubel,R,BUF,28,59,7,14,21
72,8483499,Liam Ohgren,L,MIN,20,61,7,14,21
72,8478109,Victor Olofsson,L,VGK,29,72,6,15,21
72,8478133,Jake Evans,C,MTL,28,68,6,15,21
72,8482142,Jamie Drysdale,D,PHI,22,68,6,15,21
72,8477508,Curtis Lazar,C,NJD,29,64,6,15,21
72,8478136,Jake Middleton,D,MIN,28,70,3,18,21
72,8476891,Matthew Grzelcyk,D,PIT,30,75,3,18,21
72,8480222,Sebastian Aho,D,PIT,28,76,3,18,21
72,8479976,Juuso Valimaki,D,UTA,26,64,2,19,21
72,8480807,Mattias Samuelsson,D,BUF,24,58,1,20,21
72,8477947,Sonny Milano,L,WSH,28,59,11,9,20
72,8480835,Jack Drury,C,CAR,24,59,11,9,20
72,8482259,Bobby McMann,C,TOR,28,57,10,10,20
72,8479941,Justin Danforth,R,CBJ,31,62,10,10,20
72,8478585,Derek Ryan,C,EDM,38,63,10,10,20
72,8475193,Tomas Tatar,L,NJD,34,64,9,11,20
72,8482809,Jackson Blake,R,CAR,21,62,9,11,20
72,8473563,Nicklas Backstrom,C,WSH,37,60,8,12,20
72,8482111,Justin Barron,D,MTL,23,65,6,14,20
72,8480873,Rasmus Sandin,D,WSH,24,65,5,15,20
72,8483445,Cutter Gauthier,L,ANA,20,57,4,16,20
72,8482245,Artem Zub,D,OTT,29,70,3,17,20
72,8476329,Travis Boyd,C,MIN,31,58,3,17,20
72,8478507,John Marino,D,UTA,27,60,2,18,20
72,8473453,Trevor Lewis,C,LAK,37,72,11,8,19
72,8481641,Joel Kiviranta,L,COL,28,74,9,10,19
72,8477380,Jonny Brodzinski,C,NYR,31,52,9,10,19
72,8479591,Michael Eyssimont,C,TBL,28,80,7,12,19
72,8480806,Isac Lundestrom,C,ANA,25,58,7,12,19
72,8479369,Andrew Peeke,D,BOS,26,68,6,13,19
72,8476960,Andreas Athanasiou,C,CHI,30,48,5,14,19
72,8477365,Connor Clifton,D,BUF,29,55,5,14,19
72,8479639,Dylan Coghlan,D,WPG,26,63,4,15,19
72,8480878,Nils Lundkvist,D,DAL,24,63,3,16,19
72,8482148,Hendrix Lapierre,C,WSH,22,51,9,9,18
72,8482679,Matt Coronato,R,CGY,22,67,9,9,18
72,8477018,Ben Hutton,D,VGK,31,52,7,11,18
72,8477919,Frederick Gaudreau,C,MIN,31,59,6,12,18
72,8478043,Sam Lafferty,C,BUF,29,54,6,12,18
72,8477406,Mattias Janmark,C,EDM,32,67,6,12,18
72,8475231,Casey Cizikas,C,NYI,33,70,6,12,18
72,8477903,Garnet Hathaway,R,PHI,33,60,5,13,18
72,8481161,Jake Christiansen,D,CBJ,25,62,5,13,18
72,8477931,Tomas Nosek,L,FLA,32,54,5,13,18
72,8475279,Ben Chiarot,D,DET,33,71,4,14,18
72,8475179,Dmitry Kulikov,D,FLA,34,63,4,14,18
72,8478416,Erik Cernak,D,TBL,27,73,3,15,18
72,8480043,Timothy Liljegren,D,TOR,25,66,2,16,18
72,8475790,Erik Gudbranson,D,CBJ,32,79,1,17,18
72,8476879,Cody Ceci,D,EDM,31,72,1,17,18
72,8479980,Nicolas Hague,D,VGK,26,40,0,18,18
72,8478831,Kevin Stenlund,C,UTA,28,58,11,6,17
72,8479316,Luke Kunin,C,SJS,27,49,10,7,17
72,8482859,Zack Ostapchuk,C,OTT,21,60,7,10,17
72,8475855,Jesper Fast,R,CAR,33,53,6,11,17
72,8480246,Nick Perbix,D,TBL,26,70,6,11,17
72,8482157,Will Cuylle,L,NYR,22,62,5,12,17
72,8481441,Joe Snively,C,DET,28,64,5,12,17
72,8474574,Tyler Myers,D,VAN,34,70,5,12,17
72,8478399,Jonas Siegenthaler,D,NJD,27,52,5,12,17
72,8473507,Jeff Petry,D,DET,37,77,4,13,17
72,8475208,Brian Dumoulin,D,ANA,33,54,3,14,17
72,8480727,Zach Whitecloud,D,VGK,28,47,3,14,17
72,8482087,Kaiden Guhle,D,MTL,22,63,2,15,17
72,8478508,Yakov Trenin,C,MIN,27,57,9,7,16
72,8476822,Luke Glendening,C,TBL,35,79,9,7,16
72,8481522,Peyton Krebs,C,BUF,23,57,8,8,16
72,8482117,Lukas Reichel,L,CHI,22,62,7,9,16
72,8479315,Joey Anderson,R,CHI,26,49,7,9,16
72,8478178,Darren Raddysh,D,TBL,28,69,7,9,16
72,8479291,Kevin Rooney,C,CGY,31,50,7,9,16
72,8481028,Martin Pospisil,C,CGY,25,56,6,10,16
72,8479344,Jesse Puljujarvi,R,PIT,26,47,6,10,16
72,8481704,Juuso Parssinen,C,NSH,23,51,5,11,16
72,8482067,Connor Mackey,D,NYR,28,63,5,11,16
72,8482166,Shakir Mukhamadullin,D,SJS,22,54,5,11,16
72,8479328,Julien Gauthier,R,NYI,27,62,4,12,16
72,8480073,Erik Brannstrom,D,COL,25,56,3,13,16
72,8476967,Brett Kulak,D,EDM,30,66,3,13,16
72,8480172,Jan Rutta,D,SJS,34,61,2,14,16
72,8471709,Marc-Edouard Vlasic,D,SJS,37,63,2,14,16
72,8481708,Zac Jones,D,NYR,24,49,2,14,16
72,8480281,Alexey Toropchenko,R,STL,25,58,10,5,15
72,8478434,Keegan Kolesar,R,VGK,27,72,9,6,15
72,8476934,Brock McGinn,L,ANA,30,54,9,6,15
72,8480192,Johnathan Kovacevic,D,NJD,27,54,9,6,15
72,8481477,Nico Sturm,C,SJS,29,58,8,7,15
72,8483493,Frank Nazar,C,CHI,20,46,8,7,15
72,8479359,Beck Malenstyn,L,BUF,26,49,8,7,15
72,8479368,Max Jones,L,BOS,26,68,7,8,15
72,8481481,Blake Lizotte,C,PIT,27,61,7,8,15
72,8471817,Ryan Reaves,R,TOR,37,54,7,8,15
72,8480762,Eric Robinson,L,CAR,29,53,6,9,15
72,8481013,Jonatan Berggren,R,DET,24,61,6,9,15
72,8481751,Lukas Rousek,R,BUF,25,42,6,9,15
72,8481604,Pavel Dorofeyev,L,VGK,24,62,5,10,15
72,8481517,Brett Leason,R,ANA,25,55,5,10,15
72,8479982,Conor Timmins,D,TOR,26,57,5,10,15
72,8479353,Brett Howden,C,VGK,26,69,4,11,15
72,8481527,Kaedan Korczak,D,VGK,23,51,4,11,15
72,8475690,Chris Tanev,D,TOR,35,60,4,11,15
72,8477499,Rasmus Ristolainen,D,PHI,30,59,3,12,15
72,8476988,Matt Benning,D,SJS,30,66,2,13,15
72,8475324,Nick Jensen,D,OTT,34,67,2,13,15
72,8475455,Brenden Dillon,D,NJD,34,56,2,13,15
72,8476374,Sean Kuraly,C,CBJ,31,58,9,5,14
72,8480021,Jack Studnicka,C,LAK,25,59,9,5,14
72,8482762,Simon Edvinsson,D,DET,21,50,9,5,14
72,8483491,Ivan Miroshnichenko,L,WSH,20,55,7,7,14
72,8476442,Matt Nieto,L,PIT,32,46,7,7,14
72,8479393,Noah Gregor,L,OTT,26,72,6,8,14
72,8477446,Michael McCarron,R,NSH,29,64,5,9,14
72,8480860,Kevin Bahl,D,CGY,24,56,5,9,14
72,8477015,Connor Brown,R,EDM,30,71,5,9,14
72,8477369,Carson Soucy,D,VAN,30,64,5,9,14
72,8479402,Jake Bean,D,CGY,26,68,4,10,14
72,8475225,Craig Smith,C,CHI,35,53,4,10,14
72,8479543,Michael Pezzetta,L,MTL,26,56,4,10,14
72,8481567,Henry Thrun,D,SJS,23,49,3,11,14
72,8481059,Scott Perunovich,D,STL,26,61,3,11,14
72,8479372,Joshua Mahura,D,SEA,26,51,2,12,14
72,8480058,Pierre-Olivier Joseph,D,STL,25,55,2,12,14
72,8474568,Luke Schenn,D,NSH,35,54,2,12,14
72,8470600,Ryan Suter,D,STL,39,57,0,14,14
72,8480448,Parker Kelly,L,COL,25,76,9,4,13
72,8480011,Klim Kostin,C,SJS,25,58,9,4,13
72,8475842,Sam Carrick,C,NYR,32,55,8,5,13
72,8482155,Alex Laferriere,R,LAK,23,59,8,5,13
72,8480025,MacKenzie Entwistle,R,FLA,25,63,8,5,13
72,8480035,Henri Jokiharju,D,BUF,25,58,7,6,13
72,8482659,Josh Doan,R,UTA,22,55,7,6,13
72,8480252,Cole Guttman,C,CHI,25,38,6,7,13
72,8477392,Hudson Fasching,R,NYI,29,65,5,8,13
72,8480289,Morgan Barron,C,WPG,26,53,5,8,13
72,8479718,Alex Barré-Boulet,C,MTL,27,56,4,9,13
72,8474567,Zach Bogosian,D,MIN,34,64,4,9,13
72,8479026,Philippe Myers,D,TOR,27,57,4,9,13
72,8479336,Carl Grundstrom,R,SJS,27,51,3,10,13
72,8480796,Martin Fehervary,D,WSH,25,53,2,11,13
72,8479371,Dante Fabbro,D,NSH,26,61,1,12,13
72,8481537,Nikita Okhotiuk,D,CGY,24,45,1,12,13
72,8484149,Gavin Brindley,C,CBJ,20,47,8,4,12
72,8477482,Zachary Sanford,L,CHI,30,47,7,5,12
72,8474034,Patrick Maroon,L,CHI,36,49,6,6,12
72,8481679,Maxence Guenette,D,OTT,23,37,6,6,12
72,8479671,Mathieu Olivier,R,CBJ,27,46,4,8,12
72,8481617,Vasily Podkolzin,R,VAN,23,45,4,8,12
72,8479442,Troy Stecher,D,EDM,30,53,4,8,12
72,8483460,David Jiricek,D,CBJ,21,56,4,8,12
72,8477335,Kyle Burroughs,D,LAK,29,51,4,8,12
72,8474673,TJ Brodie,D,CHI,34,58,3,9,12
72,8480001,Urho Vaakanainen,D,ANA,25,54,2,10,12
72,8482073,Braden Schneider,D,NYR,23,64,1,11,12
72,8480887,Jordan Harris,D,MTL,24,51,1,11,12
72,8478211,Dryden Hunt,L,CGY,29,47,7,4,11
72,8477573,Nathan Walker,L,STL,30,43,5,6,11
72,8480007,Jonas Rondbjerg,R,VGK,25,36,5,6,11
72,8482713,Mackie Samoskevich,R,FLA,22,45,5,6,11
72,8476994,Vinnie Hinostroza,C,NSH,30,40,4,7,11
72,8482730,Brandt Clarke,D,LAK,21,46,4,7,11
72,8479370,Tyson Jost,C,CAR,26,51,4,7,11
72,8477034,Jaycob Megna,D,FLA,32,48,4,7,11
72,8482733,Logan Mailloux,D,MTL,31,38,4,7,11
72,8483466,Kevin Korchinski,D,CHI,20,43,4,7,11
72,8482807,Ethan Del Mastro,D,CHI,21,47,3,8,11
72,8477401,John Hayden,C,SEA,29,30,3,8,11
72,8475235,Nicolas Deslauriers,L,PHI,33,56,3,8,11
72,8483619,Filip Roos,D,OTT,25,33,3,8,11
72,8475188,Brayden McNabb,D,VGK,33,57,2,9,11
72,8478451,Ethan Bear,D,WSH,27,51,2,9,11
72,8480292,Carson Meyer,R,ANA,27,33,2,9,11
72,8482666,Scott Morrow,D,CAR,22,53,2,9,11
72,8478859,Niko Mikkola,D,FLA,28,56,2,9,11
72,8474013,Ian Cole,D,UTA,35,50,2,9,11
72,8482634,Alex Steeves,C,TOR,25,47,1,10,11
72,8475718,Justin Holl,D,DET,32,54,1,10,11
72,8481532,Alex Turcotte,C,LAK,23,52,6,4,10
72,8481056,Spencer Stastney,D,NSH,24,35,5,5,10
72,8482765,Isak Rosen,R,BUF,21,24,5,5,10
72,8480950,Ilya Lyubushkin,D,DAL,30,65,4,6,10
72,8481599,Victor Soderstrom,D,UTA,23,45,4,6,10
72,8481789,Tye Kartye,L,SEA,23,40,4,6,10
72,8481518,Nolan Foote,L,NJD,24,40,3,7,10
72,8482176,Wyatt Kaiser,D,CHI,22,51,3,7,10
72,8481550,Adam Beckman,L,NJD,23,38,3,7,10
72,8480157,Calle Rosen,D,COL,30,49,3,7,10
72,8477810,Joel Hanley,D,CGY,33,29,3,7,10
72,8480196,Jacob Bryson,D,BUF,27,38,2,8,10
72,8478443,Brandon Carlo,D,BOS,28,53,1,9,10
72,8481178,Egor Zamula,D,PHI,24,53,1,9,10
72,8478452,Caleb Jones,D,LAK,27,51,1,9,10
72,8482451,Mikael Pyyhtia,L,CBJ,23,47,1,9,10
72,8478450,Parker Wotherspoon,D,BOS,27,38,1,9,10
72,8478454,Noah Juulsen,D,VAN,27,39,0,10,10
72,8476858,Phillip Di Giuseppe,L,VAN,31,40,5,4,9
72,8481754,Nikita Nesterenko,C,ANA,23,38,5,4,9
72,8481609,Vladislav Kolyachonok,D,UTA,23,41,5,4,9
72,8480355,Mark Kastelic,C,BOS,25,53,4,5,9
72,8476624,Barclay Goodrow,C,SJS,31,46,4,5,9
72,8481598,Philip Broberg,D,EDM,23,39,4,5,9
72,8482744,James Malatesta,L,CBJ,21,39,4,5,9
72,8479638,Justin Brazeau,R,BOS,26,36,4,5,9
72,8477938,Haydn Fleury,D,WPG,28,45,3,6,9
72,8475177,Calvin de Haan,D,COL,33,48,3,6,9
72,8479348,Kale Clague,D,BUF,26,39,3,6,9
72,8477887,Patrick Brown,C,BOS,32,45,2,7,9
72,8481568,Alex Vlasic,D,CHI,23,60,2,7,9
72,8475750,Jon Merrill,D,MIN,32,62,2,7,9
72,8474090,Brendan Smith,D,DAL,35,56,2,7,9
72,8473446,Erik Johnson,D,PHI,36,40,1,8,9
72,8480845,Rasmus Kupari,C,WPG,24,36,1,8,9
72,8479972,Mason Shaw,C,WPG,26,50,0,9,9
72,8480074,Alexandre Texier,C,STL,25,51,6,2,8
72,8478424,Jansen Harkins,C,ANA,27,50,5,3,8
72,8478017,Mark Friedman,D,VAN,29,40,4,4,8
72,8479520,Brandon Duhaime,R,WSH,27,53,4,4,8
72,8477962,Brendan Lemieux,L,CAR,28,37,4,4,8
72,8476913,Devin Shore,C,MIN,30,31,4,4,8
72,8481019,David Gustafsson,C,WPG,24,38,3,5,8
72,8479986,Kole Lind,R,DAL,26,48,3,5,8
72,8479439,Jacob MacDonald,D,COL,31,50,3,5,8
72,8476952,Dominic Toninato,C,WPG,30,38,3,5,8
72,8479944,Zach Aston-Reese,C,VGK,30,44,2,6,8
72,8476473,Connor Murphy,D,CHI,31,37,2,6,8
72,8471677,Jack Johnson,D,CBJ,37,59,1,7,8
72,8480070,Ian Mitchell,D,BOS,25,46,0,8,8
72,8480879,Jacob Bernard-Docker,D,OTT,24,50,0,8,8
72,8482070,Mitchell Chaffee,R,TBL,26,48,5,2,7
72,8483012,Logan Morrison,C,SEA,22,34,5,2,7
72,8479968,Vinni Lettieri,C,BOS,29,53,4,3,7
72,8481592,Jakob Pelletier,L,CGY,23,44,4,3,7
72,8480844,Grigori Denisenko,L,VGK,24,30,4,3,7
72,8482652,Walker Duehr,R,CGY,27,39,3,4,7
72,8477462,Robert Hagg,D,VGK,29,37,3,4,7
72,8481030,Jack St. Ivany,D,PIT,25,16,3,4,7
72,8483397,Marc McLaughlin,C,BOS,25,22,2,5,7
72,8481122,Simon Benoit,D,TOR,26,35,2,5,7
72,8479772,Zack MacEwen,R,OTT,28,53,1,6,7
72,8479378,Logan Stanley,D,WPG,26,34,1,6,7
72,8474612,Travis Hamonic,D,OTT,34,48,1,6,7
72,8476441,Joel Edmundson,D,LAK,31,33,1,6,7
72,8475762,Derek Forbort,D,VAN,32,40,1,6,7
72,8482964,Arber Xhekaj,D,MTL,23,46,3,3,6
72,8480848,Ty Dellandrea,C,SJS,24,41,3,3,6
72,8482858,Ryker Evans,D,SEA,23,28,3,3,6
72,8481585,Egor Afanasyev,L,SJS,23,17,3,3,6
72,8476874,Olli Maatta,D,DET,30,64,2,4,6
72,8478146,Matthew Highmore,C,OTT,28,35,2,4,6
72,8482511,Mason Lohrei,D,BOS,23,30,2,4,6
72,8482751,Ryan Winterton,C,SEA,21,47,2,4,6
72,8482784,Zach Dean,C,STL,21,43,2,4,6
72,8481701,Santeri Hatakka,D,NJD,23,36,1,5,6
72,8474166,Alec Martinez,D,CHI,37,50,1,5,6
72,8481167,Brayden Pachal,D,CGY,25,46,1,5,6
72,8482095,Tyler Kleven,D,OTT,22,35,1,5,6
72,8480441,Trey Fix-Wolansky,R,CBJ,25,37,0,6,6
72,8479536,Axel Jonsson-Fjallby,L,WPG,26,30,4,1,5
72,8480870,Bo Groulx,C,NYR,24,32,4,1,5
72,8483549,Lucas Condotta,L,MTL,27,25,3,2,5
72,8480880,Jakub Lauko,C,MIN,24,42,3,2,5
72,8482141,Lukas Cormier,D,VGK,22,30,3,2,5
72,8479419,Brett Murray,L,BUF,26,18,3,2,5
72,8477971,Andreas Englund,D,LAK,28,28,3,2,5
72,8476372,Nick Seeler,D,PHI,31,38,2,3,5
72,8481147,Reese Johnson,C,MIN,26,39,2,3,5
72,8476867,Brendan Gaunce,C,MIN,30,29,2,3,5
72,8482153,Brendan Brisson,C,VGK,23,36,2,3,5
72,8477851,Jordan Oesterle,D,BOS,32,38,2,3,5
72,8480990,Declan Chisholm,D,MIN,24,42,2,3,5
72,8479991,Jake Leschyshyn,C,NYR,25,29,2,3,5
72,8477070,Liam O'Brien,C,UTA,30,54,1,4,5
72,8484911,Collin Graf,R,SJS,22,42,1,4,5
72,8478874,Adam Gaudette,R,OTT,28,29,1,4,5
72,8481605,Jackson LaCombe,D,ANA,23,32,1,4,5
72,8481564,Ryan Johnson,D,BUF,23,18,1,4,5
72,8479249,Andrew Poturalski,C,SJS,30,43,0,5,5
72,8480245,Olle Lycksell,R,PHI,25,31,0,5,5
72,8479576,Vincent Desharnais,D,VAN,28,39,0,5,5
72,8477384,Joshua Brown,D,EDM,30,40,0,5,5
72,8481006,Tyler Tucker,D,STL,24,18,0,5,5
72,8482172,Landon Slaggert,L,CHI,22,24,4,0,4
72,8479320,Maxime Lajoie,D,SEA,27,22,3,1,4
72,8479379,Givani Smith,R,SJS,26,27,3,1,4
72,8483630,Pavol Regenda,L,ANA,25,29,3,1,4
72,8481237,Kyle MacLean,C,NYI,25,22,3,1,4
72,8479362,Riley Tufte,L,BOS,26,21,3,1,4
72,8479994,Jaret Anderson-Dolan,C,WPG,25,33,2,2,4
72,8483570,Ben Meyers,C,SEA,26,32,2,2,4
72,8483763,Maksymilian Szuber,D,UTA,22,27,2,2,4
72,8483489,Fraser Minten,C,TOR,31,14,2,2,4
72,8480267,Sammy Walker,C,MIN,25,15,2,2,4
72,8481043,Cole Koepke,L,BOS,26,22,2,2,4
72,8484254,Akito Hirose,D,VAN,25,37,1,3,4
72,8481600,Tobias Bjornfot,D,FLA,23,43,1,3,4
72,8482861,Vincent Iorio,D,WSH,22,24,1,3,4
72,8480084,Nick DeSimone,D,NJD,30,18,1,3,4
72,8478409,Anthony Richard,C,PHI,28,28,1,3,4
72,8477320,Anton Blidh,L,NYR,29,22,1,3,4
72,8478051,Max Willman,C,NJD,29,17,1,3,4
72,8478468,Jeremy Lauzon,D,NSH,27,51,0,4,4
72,8482165,Yan Kuznetsov,D,CGY,22,15,0,4,4
72,8484258,Sam Malinski,D,COL,26,22,0,4,4
72,8480851,Akil Thomas,C,LAK,24,16,3,0,3
72,8482118,Sam Colangelo,R,ANA,23,15,3,0,3
72,8481422,Jake Lucchini,C,NSH,29,19,3,0,3
72,8482496,Nils Aman,C,VAN,24,38,2,1,3
72,8480890,Jan Jenik,C,OTT,24,21,2,1,3
72,8482145,Mavrik Bourque,C,DAL,22,50,2,1,3
72,8480874,Adam Ginning,D,PHI,24,14,2,1,3
72,8482747,Brennan Othmann,L,NYR,21,39,1,2,3
72,8479981,Jonah Gadjovich,L,FLA,26,42,1,2,3
72,8479985,Cale Fleury,D,SEA,26,23,1,2,3
72,8481556,John Beecher,C,BOS,23,30,1,2,3
72,8482929,Emil Lilleberg,D,TBL,23,24,1,2,3
72,8479587,Rhett Gardner,C,PHI,28,23,1,2,3
72,8482061,Brandon Biro,L,SEA,26,11,1,2,3
72,8477149,Scott Sabourin,R,SJS,32,16,1,2,3
72,8475958,Michael Sgarbossa,C,WSH,32,25,1,2,3
72,8481743,Marc Del Gaizo,D,NSH,25,15,1,2,3
72,8482144,Jack Thompson,D,SJS,22,28,0,3,3
72,8482516,Matthew Kessel,D,STL,24,20,0,3,3
72,8478021,William Lagesson,D,DET,28,26,0,3,3
72,8481806,Louis Crevier,D,CHI,23,19,0,3,3
72,8480468,James Hamblin,L,EDM,25,11,2,0,2
72,8483597,Milos Kelemen,L,UTA,25,15,2,0,2
72,8482470,Ilya Solovyov,D,CGY,24,21,2,0,2
72,8482177,Marat Khusnutdinov,C,MIN,22,35,2,0,2
72,8482162,Roby Jarventie,L,EDM,22,16,2,0,2
72,8477527,Ross Johnston,L,ANA,30,33,1,1,2
72,8477473,Justin Bailey,R,SJS,29,27,1,1,2
72,8479421,Jacob Moverare,D,LAK,26,8,1,1,2
72,8481462,Mason Morelli,L,VGK,28,9,1,1,2
72,8482201,Gage Goncalves,C,TBL,23,25,1,1,2
72,8483567,Georgii Merkulov,C,BOS,24,9,1,1,2
72,8482102,Vasily Ponomarev,C,PIT,22,23,1,1,2
72,8481024,Linus Karlsson,C,VAN,25,10,1,1,2
72,8479367,William Lockwood,R,FLA,26,26,0,2,2
72,8480834,Ty Emberson,D,SJS,24,29,0,2,2
72,8482088,Justin Sourdif,R,FLA,22,20,0,2,2
72,8477244,Chad Ruhwedel,D,NYR,34,25,0,2,2
72,8484325,Waltteri Merela,C,TBL,26,19,0,2,2
72,8477541,Dakota Mermis,D,TOR,30,15,0,2,2
72,8482460,Matt Rempe,C,NYR,22,12,0,2,2
72,8481206,John Ludvig,D,PIT,24,8,0,2,2
72,8483471,Brad Lambert,C,WPG,31,15,0,2,2
72,8480306,Grant Hutton,D,NYI,29,9,0,2,2
72,8481543,Nikita Alexandrov,C,STL,24,18,1,0,1
72,8484304,Uvis Balinskis,D,FLA,28,9,1,0,1
72,8478011,Louie Belpedio,D,PHI,28,12,1,0,1
72,8480032,Shane Bowers,C,NJD,25,9,1,0,1
72,8483398,Declan Carlile,D,TBL,31,6,1,0,1
72,8483512,Matthew Savoie,C,EDM,20,13,1,0,1
72,8481578,Graeme Clarke,R,MIN,23,13,1,0,1
72,8479330,Brandon Gignac,C,MTL,27,9,1,0,1
72,8480823,Alexander Alexeyev,D,WSH,25,18,1,0,1
72,8483407,Brandon Scanlin,D,NYR,25,4,1,0,1
72,8475755,Alexander Petrovic,D,DAL,32,7,1,0,1
72,8482126,Emil Andrae,D,PHI,31,7,1,0,1
72,8482147,Jean-Luc Foudy,C,COL,22,23,0,1,1
72,8484287,Cole McWard,D,VAN,23,15,0,1,1
72,8475413,Justin Dowling,C,NJD,34,10,0,1,1
72,8483395,Arshdeep Bains,L,VAN,23,10,0,1,1
72,8478502,Dennis Gilbert,D,BUF,28,19,0,1,1
72,8481699,Aku Raty,R,UTA,23,16,0,1,1
72,8475795,Dylan McIlrath,D,WSH,32,17,0,1,1
72,8482094,Daemon Hunt,D,MIN,22,26,0,1,1
72,8481593,Jayden Struble,D,MTL,23,22,0,1,1
72,8482787,Nikita Chibrikov,R,WPG,31,8,0,1,1
72,8481655,Cole Schwindt,R,CGY,23,7,0,1,1
72,8483546,Marshall Rifai,D,TOR,26,6,0,1,1
72,8479522,Hardy Haman Aktell,D,WSH,26,1,0,1,1
72,8480274,Philip Kemp,D,EDM,25,1,0,1,1
72,8478477,Mitchell Stephens,C,SEA,27,15,0,0,0
72,8477467,Gustav Olofsson,D,SEA,30,19,0,0,0
72,8478881,Brett Seney,L,CHI,28,12,0,0,0
72,8478854,Ryan Shea,D,PIT,27,7,0,0,0
72,8481719,Maxwell Crozier,D,TBL,24,14,0,0,0
72,8478446,Glenn Gawdin,C,LAK,27,9,0,0,0
72,8481065,Angus Crookshank,L,OTT,25,11,0,0,0
72,8481541,Samuel Bolduc,D,NYI,24,22,0,0,0
72,8482250,Callahan Burke,C,VGK,27,22,0,0,0
72,8474062,Riley Nash,C,NYR,35,14,0,0,0
72,8481726,Adam Edstrom,C,NYR,24,8,0,0,0
72,8477073,Kurtis MacDermid,L,NJD,30,33,0,0,0
72,8484255,Jason Polin,R,COL,25,2,0,0,0
72,8480075,Cameron Crotty,D,MIN,25,7,0,0,0
72,8477993,Justin Kirkland,C,CGY,28,6,0,0,0
72,8483609,Adam Klapka,R,CGY,24,2,0,0,0
72,8483432,Luca Del Bel Belluz,C,CBJ,31,4,0,0,0
72,8482197,Adam Raska,R,MIN,23,5,0,0,0
72,8483531,Brian Halonen,L,NJD,25,3,0,0,0
72,8476323,Max McCormick,L,SEA,32,2,0,0,0
72,8475780,Chris Wagner,R,COL,33,5,0,0,0
72,8481534,Raphael Lavoie,C,EDM,24,1,0,0,0
72,8483920,Pierrick Dube,R,WSH,23,5,0,0,0
72,8482476,Emil Heineman,L,MTL,23,5,0,0,0
72,8484326,Patrik Koch,D,UTA,28,0,0,0,0
72,8483401,Marc Johnstone,R,PIT,28,0,0,0,0
72,8478147,Bokondji Imama,L,PIT,28,7,0,0,0
72,8484259,Ondrej Pavel,C,COL,31,1,0,0,0
72,8484321,Nikolas Matinpalo,D,OTT,26,1,0,0,0
72,8470794,Joe Pavelski,C,,40,0,0,0,0
72,8479321,Lucas Johansen,D,,27,0,0,0,0
72,8477950,Tony DeAngelo,D,,29,0,0,0,0
72,8471218,Blake Wheeler,R,,38,0,0,0,0
72,8475197,Tyson Barrie,D,,33,0,0,0,0
72,8474157,Max Pacioretty,L,,36,0,0,0,0
72,8475744,Evgeny Kuznetsov,C,,32,0,0,0,0
72,8474037,James van Riemsdyk,L,,35,0,0,0,0
72,8476907,Mackenzie MacEachern,L,,30,0,0,0,0
72,8480216,Jacob Peterson,C,,25,0,0,0,0
72,8474602,Justin Schultz,D,,34,0,0,0,0
72,8482222,Alexander Barabanov,L,,30,0,0,0,0
72,8474031,Kevin Shattenkirk,D,,35,0,0,0,0
72,8477330,Dominik Kubalik,L,,29,0,0,0,0
72,8480884,Calen Addison,D,,24,0,0,0,0
72,8475906,John Klingberg,D,,32,0,0,0,0
72,8480008,Adam Ruzicka,C,,25,0,0,0,0
72,8476884,Derrick Pouliot,D,,30,0,0,0,0
72,8476919,Chris Tierney,C,,30,0,0,0,0
72,8479415,Michael McLeod,C,,26,0,0,0,0
72,8474870,Tyler Johnson,C,,34,0,0,0,0
72,8470604,Jeff Carter,C,,39,0,0,0,0
72,8478104,Sammy Blais,L,,28,0,0,0,0
72,8474884,Mike Hoffman,C,,35,0,0,0,0
72,8481591,Sam Poulin,R,,23,0,0,0,0
72,8471274,Alex Goligoski,D,,39,0,0,0,0
72,8476871,Tanner Pearson,L,,32,0,0,0,0
72,8476393,Nick Cousins,C,,31,0,0,0,0
72,8479977,Kailer Yamamoto,R,,26,0,0,0,0
72,8479346,Dillon Dube,C,,26,0,0,0,0
72,8480184,Gustav Lindstrom,D,,26,0,0,0,0
72,8479376,Victor Mete,D,,26,0,0,0,0
72,8473449,Kyle Okposo,R,,36,0,0,0,0
72,8481058,Jesse Ylonen,R,,25,0,0,0,0
72,8475752,Tyler Pitlick,C,,33,0,0,0,0
72,8481239,Samuel Fagemo,L,,24,0,0,0,0
72,8480821,Filip Zadina,R,,25,0,0,0,0
72,8470966,Mark Giordano,D,,41,0,0,0,0
72,8478495,Denis Gurianov,R,,27,0,0,0,0
72,8477464,Nic Petan,C,,29,0,0,0,0
72,8478099,Kevin Labanc,R,,29,0,0,0,0
72,8482241,Radim Zohorna,L,,28,0,0,0,0
72,8474040,Sam Gagner,C,,35,0,0,0,0
72,8479514,Rem Pitlick,C,,27,0,0,0,0
72,8478430,Oliver Kylington,D,,27,0,0,0,0
72,8479533,Joona Koppanen,L,,26,0,0,0,0
72,8479984,Cal Foote,D,,26,0,0,0,0
72,8477126,Jayson Megna,C,,34,0,0,0,0
72,8475164,Jakob Silfverberg,R,,34,0,0,0,0
72,8474009,Nick Bonino,C,,36,0,0,0,0
72,8479458,Nikita Zaitsev,D,,33,0,0,0,0
72,8477944,Jakub Vrana,L,,28,0,0,0,0
72,8471699,Andrew Cogliano,C,,37,0,0,0,0
72,8478067,Oskar Lindblom,L,,28,0,0,0,0
72,8471686,Marc Staal,D,,37,0,0,0,0
72,8470610,Zach Parise,L,,40,0,0,0,0
72,8478904,Steven Lorentz,C,,28,0,0,0,0
72,8473473,Milan Lucic,L,,36,0,0,0,0
72,8480031,Maxime Comtois,L,,25,0,0,0,0
72,8478512,Austin Czarnik,C,,32,0,0,0,0
72,8473504,Cal Clutterbuck,R,,37,0,0,0,0
72,8477454,Adam Erne,L,,29,0,0,0,0
72,8479383,Boris Katchouk,L,,26,0,0,0,0
72,8475825,Jani Hakanpää,D,,32,0,0,0,0
72,8477846,Ryan Carpenter,C,,33,0,0,0,0
72,8477930,Pierre-Edouard Bellemare,L,,39,0,0,0,0
72,8478400,Colin White,C,,27,0,0,0,0
72,8480226,Marián Studenic,R,,26,0,0,0,0
72,8480853,Liam Foudy,C,,24,0,0,0,0
72,8475797,Jarred Tinordi,D,,32,0,0,0,0
72,8479423,Alex Nylander,L,,26,0,0,0,0
72,8474618,Marco Scandella,D,,34,0,0,0,0
72,8478028,Fredrik Olofsson,L,,28,0,0,0,0
72,8474709,Matt Martin,L,,35,0,0,0,0
72,8481070,Hugh McGing,L,,26,0,0,0,0
72,8479546,Oskar Steen,C,,26,0,0,0,0
72,8474145,Robert Bortuzzo,D,,35,0,0,0,0
72,8476915,Jujhar Khaira,L,,30,0,0,0,0
72,8475278,Byron Froese,C,,33,0,0,0,0
72,8481812,Nikolai Knyzhov,D,,27,0,0,0,0
72,8478408,Travis Dermott,D,,28,0,0,0,0
72,8481077,John Leonard,L,,26,0,0,0,0
72,8479547,Matthew Phillips,R,,26,0,0,0,0
72,8480836,Jonathan Gruden,C,,24,0,0,0,0
72,8481690,Tyler Angle,C,,24,0,0,0,0
72,8475766,Austin Watson,L,,32,0,0,0,0
72,8481016,Ruslan Iskhakov,C,,24,0,0,0,0
72,8478078,Rourke Chartier,C,,28,0,0,0,0
72,8480776,Sheldon Rempal,R,,29,0,0,0,0
72,8478956,Samuel Laberge,L,NJD,27,2,0,0,0
72,8483045,Cameron Butler,R,CBJ,31,0,0,0,0
72,8484314,Jiri Smejkal,L,,28,0,0,0,0
73,8478402,Connor McDavid,C,EDM,27,78,47,115,162
73,8479318,Auston Matthews,C,TOR,27,80,66,66,132
73,8477939,William Nylander,R,TOR,28,80,54,67,121
73,8476453,Nikita Kucherov,R,TBL,31,82,42,78,120
73,8481559,Jack Hughes,C,NJD,23,74,46,71,117
73,8477492,Nathan MacKinnon,C,COL,29,81,50,62,112
73,8478483,Mitch Marner,R,TOR,27,81,31,81,112
73,8482116,Tim Stützle,C,OTT,22,79,44,66,110
73,8478550,Artemi Panarin,L,NYR,33,76,37,72,109
73,8480002,Nico Hischier,C,NJD,25,74,42,66,108
73,8478420,Mikko Rantanen,R,COL,28,82,42,66,108
73,8477956,David Pastrnak,R,BOS,28,77,45,54,99
73,8477934,Leon Draisaitl,C,EDM,29,74,41,56,97
73,8477933,Sam Reinhart,C,FLA,29,79,43,53,96
73,8480012,Elias Pettersson,C,VAN,26,78,42,54,96
73,8477942,Kevin Fiala,L,LAK,28,79,33,63,96
73,8477404,Jake Guentzel,C,TBL,30,82,43,52,95
73,8478427,Sebastian Aho,C,CAR,27,78,37,58,95
73,8476468,J.T. Miller,C,VAN,31,70,36,57,93
73,8479407,Jesper Bratt,L,NJD,26,75,37,55,92
73,8475166,John Tavares,C,TOR,34,79,31,60,91
73,8474600,Roman Josi,D,NSH,34,74,12,79,91
73,8477500,Bo Horvat,C,NYI,29,80,41,49,90
73,8475172,Nazem Kadri,C,CGY,34,80,38,50,88
73,8477946,Dylan Larkin,C,DET,28,80,37,50,87
73,8474564,Steven Stamkos,C,NSH,34,72,36,51,87
73,8474141,Patrick Kane,R,DET,36,79,28,58,86
73,8480023,Robert Thomas,C,STL,25,72,24,61,85
73,8478445,Mathew Barzal,C,NYI,27,80,24,61,85
73,8480800,Quinn Hughes,D,VAN,25,72,9,76,85
73,8476887,Filip Forsberg,L,NSH,30,74,38,45,83
73,8480027,Jason Robertson,L,DAL,25,82,30,53,83
73,8479323,Adam Fox,D,NYR,26,75,17,66,83
73,8475184,Chris Kreider,L,NYR,33,79,52,30,82
73,8479314,Matthew Tkachuk,L,FLA,27,77,27,55,82
73,8478440,Dylan Strome,C,WSH,27,77,27,54,81
73,8476454,Ryan Nugent-Hopkins,C,EDM,31,80,23,58,81
73,8478403,Jack Eichel,C,VGK,28,78,39,41,80
73,8471675,Sidney Crosby,C,PIT,37,72,36,44,80
73,8475913,Mark Stone,R,VGK,32,76,25,54,79
73,8476460,Mark Scheifele,C,WPG,31,73,29,49,78
73,8476853,Morgan Rielly,D,TOR,30,66,20,58,78
73,8480069,Cale Makar,D,COL,26,71,17,61,78
73,8478010,Brayden Point,C,TBL,28,82,39,38,77
73,8478493,Joel Eriksson Ek,C,MIN,27,77,27,50,77
73,8471685,Anze Kopitar,C,LAK,37,81,26,50,76
73,8477951,Nick Schmaltz,C,UTA,28,79,23,53,76
73,8477493,Aleksander Barkov,C,FLA,29,79,22,54,76
73,8478398,Kyle Connor,L,WPG,28,72,42,33,75
73,8478864,Kirill Kaprizov,L,MIN,27,74,35,40,75
73,8475786,Zach Hyman,L,EDM,32,77,39,35,74
73,8476456,Jonathan Huberdeau,C,CGY,31,76,16,58,74
73,8477402,Pavel Buchnevich,L,STL,29,71,33,40,73
73,8477409,Carter Verhaeghe,C,FLA,29,78,32,41,73
73,8477407,Anthony Duclair,L,NYI,29,78,32,41,73
73,8479542,Brandon Hagel,L,TBL,26,82,26,47,73
73,8478460,Zach Werenski,D,CBJ,27,82,21,52,73
73,8480036,Miro Heiskanen,D,DAL,25,78,16,57,73
73,8477501,Valeri Nichushkin,R,COL,29,81,40,32,72
73,8481068,Yegor Sharangovich,C,CGY,26,79,38,34,72
73,8484144,Connor Bedard,C,CHI,19,75,21,51,72
73,8475754,Brock Nelson,C,NYI,33,79,45,26,71
73,8477416,Oliver Bjorkstrand,R,SEA,29,75,37,34,71
73,8475168,Matt Duchene,C,DAL,33,79,33,38,71
73,8478439,Travis Konecny,R,PHI,27,75,26,45,71
73,8477940,Nikolaj Ehlers,L,WPG,28,73,31,39,70
73,8482740,Wyatt Johnston,C,DAL,21,81,29,41,70
73,8476389,Vincent Trocheck,C,NYR,31,78,28,42,70
73,8477503,Max Domi,C,TOR,29,81,20,50,70
73,8480865,Noah Dobson,D,NYI,24,79,13,57,70
73,8477960,Adrian Kempe,R,LAK,28,82,36,33,69
73,8478449,Roope Hintz,C,DAL,28,82,34,35,69
73,8482078,Lucas Raymond,L,DET,22,81,28,41,69
73,8482745,Mason McTavish,C,ANA,21,75,28,41,69
73,8484153,Leo Carlsson,C,ANA,20,74,28,41,69
73,8477496,Elias Lindholm,C,BOS,30,78,30,38,68
73,8480801,Brady Tkachuk,L,OTT,25,81,29,39,68
73,8475798,Mikael Granlund,C,SJS,32,73,16,52,68
73,8482684,Luke Hughes,D,NJD,21,76,9,59,68
73,8479385,Jordan Kyrou,C,STL,26,77,35,32,67
73,8480015,Owen Tippett,R,PHI,25,77,35,32,67
73,8480208,Drake Batherson,R,OTT,26,74,22,45,67
73,8474590,John Carlson,D,WSH,34,65,9,58,67
73,8476539,Jonathan Marchessault,R,NSH,34,78,38,28,66
73,8481528,Dylan Cozens,C,BUF,23,75,32,34,66
73,8476459,Mika Zibanejad,C,NYR,31,75,28,38,66
73,8481557,Matt Boldy,L,MIN,23,78,25,41,66
73,8482665,Matty Beniers,C,SEA,22,77,22,44,66
73,8477476,Artturi Lehkonen,L,COL,29,82,31,34,65
73,8482093,Seth Jarvis,C,CAR,22,73,30,35,65
73,8481540,Cole Caufield,R,MTL,23,77,34,30,64
73,8475765,Vladimir Tarasenko,R,DET,33,79,30,34,64
73,8480839,Rasmus Dahlin,D,BUF,24,74,18,46,64
73,8475692,Mats Zuccarello,R,MIN,37,74,15,49,64
73,8478397,Rasmus Andersson,D,CGY,28,76,15,49,64
73,8480064,Josh Norris,C,OTT,25,77,34,29,63
73,8478444,Brock Boeser,R,VAN,27,77,28,35,63
73,8471214,Alex Ovechkin,L,WSH,39,72,34,28,62
73,8479420,Tage Thompson,C,BUF,27,74,30,32,62
73,8478873,Troy Terry,R,ANA,27,74,29,33,62
73,8476479,Phillip Danault,C,LAK,31,80,25,37,62
73,8478366,Frank Vatrano,R,ANA,30,75,37,24,61
73,8480018,Nick Suzuki,C,MTL,25,72,29,32,61
73,8482109,Alexis Lafrenière,L,NYR,23,73,25,36,61
73,8479675,Trevor Moore,L,LAK,29,80,23,38,61
73,8479337,Alex DeBrincat,R,DET,27,81,26,34,60
73,8474586,Jordan Eberle,R,SEA,34,74,25,35,60
73,8473512,Claude Giroux,R,OTT,36,76,20,40,60
73,8476905,Chandler Stephenson,C,SEA,30,75,18,42,60
73,8476346,Johnny Gaudreau,L,CBJ,31,77,15,45,60
73,8476881,Tomas Hertl,C,VGK,31,77,28,31,59
73,8473419,Brad Marchand,L,BOS,36,80,24,35,59
73,8473994,Jamie Benn,L,DAL,35,81,19,40,59
73,8480803,Evan Bouchard,D,EDM,25,77,17,42,59
73,8471724,Kris Letang,D,PIT,37,81,15,44,59
73,8475167,Victor Hedman,D,TBL,34,76,12,47,59
73,8475151,Kyle Palmieri,C,NYI,33,81,23,35,58
73,8474679,Gustav Nyquist,C,NSH,35,72,17,41,58
73,8475726,Tyler Toffoli,C,SJS,32,73,30,27,57
73,8478233,Andrew Mangiapane,L,WSH,28,70,23,33,56
73,8478975,Mason Marchment,L,DAL,29,81,19,37,56
73,8478401,Pavel Zacha,C,BOS,27,77,18,38,56
73,8479999,Casey Mittelstadt,C,COL,26,80,16,40,56
73,8477986,Brandon Montour,D,SEA,30,73,10,46,56
73,8482159,Tyson Foerster,R,PHI,22,79,25,30,55
73,8475810,Bryan Rust,R,PIT,32,68,24,31,55
73,8471215,Evgeni Malkin,C,PIT,38,69,21,34,55
73,8475158,Ryan O'Reilly,C,NSH,33,71,20,35,55
73,8478407,Vince Dunn,D,SEA,28,79,12,43,55
73,8479343,Clayton Keller,R,UTA,26,72,25,29,54
73,8473986,Alex Killorn,L,ANA,35,70,23,31,54
73,8476826,Yanni Gourde,C,SEA,33,71,18,36,54
73,8481618,Alex Newhook,C,MTL,23,72,17,37,54
73,8476875,Mike Matheson,D,MTL,30,72,13,41,54
73,8476432,Boone Jenner,C,CBJ,31,70,33,20,53
73,8477955,Jared McCann,L,SEA,28,77,28,25,53
73,8477949,Alex Tuch,R,BUF,28,73,24,29,53
73,8476882,Teuvo Teravainen,C,CHI,30,63,24,29,53
73,8482124,Quinton Byfield,R,LAK,22,82,23,30,53
73,8480830,Andrei Svechnikov,R,CAR,24,70,21,32,53
73,8477494,Jonathan Drouin,L,COL,29,80,17,36,53
73,8481533,Trevor Zegras,C,ANA,23,78,13,40,53
73,8475764,Cam Fowler,D,ANA,33,75,4,49,53
73,8476880,Tom Wilson,R,WSH,30,69,26,26,52
73,8478414,Timo Meier,R,NJD,28,71,25,27,52
73,8481596,Shane Pinto,C,OTT,24,79,23,29,52
73,8474150,Mikael Backlund,C,CGY,35,78,19,33,52
73,8478038,Devon Toews,D,COL,30,69,11,41,52
73,8475784,Jeff Skinner,C,EDM,32,74,25,26,51
73,8477935,Sam Bennett,C,FLA,28,81,23,28,51
73,8478047,Michael Bunting,L,PIT,29,68,20,31,51
73,8481711,Matias Maccelli,L,UTA,24,76,17,34,51
73,8477447,Shea Theodore,D,VGK,29,55,9,42,51
73,8475794,Tyler Seguin,C,DAL,32,81,31,19,50
73,8471698,T.J. Oshie,R,WSH,38,69,28,22,50
73,8483515,Juraj Slafkovsky,L,MTL,20,77,18,32,50
73,8474578,Erik Karlsson,D,PIT,34,80,15,35,50
73,8477429,Andrew Copp,C,DET,30,80,15,35,50
73,8477504,Josh Morrissey,D,WPG,29,74,13,37,50
73,8470613,Brent Burns,D,CAR,39,78,12,38,50
73,8475169,Evander Kane,L,EDM,33,80,25,24,49
73,8482699,Dylan Guenther,R,UTA,21,75,24,25,49
73,8477456,J.T. Compher,L,DET,29,79,23,26,49
73,8481186,Logan O'Connor,R,COL,28,80,23,26,49
73,8478519,Anthony Cirelli,C,TBL,27,82,20,29,49
73,8478042,Viktor Arvidsson,L,EDM,31,73,17,32,49
73,8475191,Reilly Smith,R,NYR,33,69,16,33,49
73,8483505,Matthew Poitras,C,BOS,20,74,15,34,49
73,8481581,Thomas Harley,D,DAL,23,73,10,39,49
73,8478469,Thomas Chabot,D,OTT,27,74,10,39,49
73,8479525,Ross Colton,C,COL,28,78,30,18,48
73,8474102,David Perron,L,OTT,36,73,21,27,48
73,8476869,Brady Skjei,D,NSH,30,72,7,41,48
73,8477444,Andre Burakovsky,L,SEA,29,70,19,28,47
73,8478472,Mathieu Joseph,R,STL,27,68,18,29,47
73,8479992,Michael Rasmussen,C,DET,25,80,17,30,47
73,8479400,Pierre-Luc Dubois,L,WSH,26,72,16,31,47
73,8476462,Dougie Hamilton,D,NJD,31,74,14,33,47
73,8476906,Shayne Gostisbehere,D,CAR,31,76,9,38,47
73,8478498,Jake DeBrusk,L,VAN,28,75,17,29,46
73,8476419,Jean-Gabriel Pageau,C,NYI,32,70,17,29,46
73,8477021,Alex Kerfoot,C,UTA,30,70,15,31,46
73,8477495,Seth Jones,D,CHI,30,70,15,31,46
73,8477479,Tyler Bertuzzi,L,CHI,29,66,14,32,46
73,8478458,John (Jack) Roslovic,C,CAR,27,67,11,35,46
73,8481542,Moritz Seider,D,DET,23,76,9,37,46
73,8479325,Charlie McAvoy,D,BOS,27,70,5,41,46
73,8476448,William Karlsson,C,VGK,31,77,27,18,45
73,8476399,Blake Coleman,C,CGY,33,78,21,24,45
73,8475745,Charlie Coyle,C,BOS,32,76,16,29,45
73,8478856,Conor Garland,R,VAN,28,67,16,29,45
73,8476483,Rickard Rakell,R,PIT,31,74,24,20,44
73,8477511,Anthony Mantha,R,CGY,30,78,17,27,44
73,8480039,Martin Necas,C,CAR,25,68,14,30,44
73,8478396,Noah Hanifin,D,VGK,27,67,11,33,44
73,8480014,Gabriel Vilardi,C,WPG,25,69,31,12,43
73,8479393,Noah Gregor,L,OTT,26,73,23,20,43
73,8482475,Yegor Chinakhov,R,CBJ,23,66,22,21,43
73,8482097,Jack Quinn,R,BUF,23,64,18,25,43
73,8475170,Brayden Schenn,C,STL,33,67,16,27,43
73,8475722,Jason Zucker,L,BUF,32,69,16,27,43
73,8483490,Pavel Mintyukov,D,ANA,21,74,11,32,43
73,8479425,Filip Hronek,D,VAN,27,70,9,34,43
73,8479365,Trent Frederic,C,BOS,26,77,21,21,42
73,8478115,Pierre Engvall,L,NYI,28,76,18,24,42
73,8478462,Nicolas Roy,C,VGK,27,75,15,27,42
73,8476872,Scott Laughton,C,PHI,30,72,10,32,42
73,8482113,Anton Lundell,C,FLA,23,80,20,21,41
73,8482146,Luke Evangelista,R,NSH,22,68,19,22,41
73,8483431,Logan Cooley,C,UTA,20,76,18,23,41
73,8477998,Warren Foegele,L,LAK,28,77,18,23,41
73,8480028,Morgan Frost,C,PHI,25,75,13,28,41
73,8482705,Cole Sillinger,C,CBJ,21,62,24,16,40
73,8474641,Adam Henrique,C,EDM,34,75,21,19,40
73,8481604,Pavel Dorofeyev,L,VGK,24,70,19,21,40
73,8482110,Dawson Mercer,C,NJD,23,70,18,22,40
73,8477932,Aaron Ekblad,D,FLA,28,74,13,27,40
73,8482720,Matthew Knies,L,TOR,22,77,11,29,40
73,8475753,Justin Faulk,D,STL,32,73,9,31,40
73,8483808,Andrei Kuzmenko,L,CGY,28,72,18,21,39
73,8484145,Zach Benson,L,BUF,19,68,16,23,39
73,8478055,Gustav Forsling,D,FLA,28,69,7,32,39
73,8480817,K'Andre Miller,D,NYR,24,69,6,33,39
73,8482175,JJ Peterka,R,BUF,22,67,19,19,38
73,8475314,Anders Lee,L,NYI,34,81,18,20,38
73,8480188,Fabian Zetterlund,L,SJS,25,68,18,20,38
73,8475799,Nino Niederreiter,R,WPG,32,70,18,20,38
73,8481560,Arthur Kaliyev,R,LAK,23,77,17,21,38
73,8480797,Joel Farabee,L,PHI,24,76,14,24,38
73,8478438,Tommy Novak,C,NSH,27,71,13,25,38
73,8477964,Ivan Barbashev,C,VGK,29,72,12,26,38
73,8479345,Jakob Chychrun,D,WSH,26,66,12,26,38
73,8475218,Mattias Ekholm,D,EDM,34,70,8,30,38
73,8475714,Calle Jarnkrok,C,TOR,33,71,19,18,37
73,8475760,Nick Bjugstad,C,UTA,32,71,17,20,37
73,8475793,Ryan Johansen,C,PHI,32,72,17,20,37
73,8475768,Jaden Schwartz,C,SEA,32,70,16,21,37
73,8478542,Evan Rodrigues,C,FLA,31,74,14,23,37
73,8478413,Jordan Greenway,L,BUF,27,65,14,23,37
73,8474565,Alex Pietrangelo,D,VGK,34,67,7,30,37
73,8476958,Jaccob Slavin,D,CAR,30,75,7,30,37
73,8480145,Neal Pionk,D,WPG,29,69,6,31,37
73,8481703,Valtteri Puustinen,R,PIT,25,62,5,32,37
73,8475763,Kevin Hayes,R,PIT,32,69,17,19,36
73,8477451,Ryan Hartman,R,MIN,30,70,17,19,36
73,8477497,Sean Monahan,C,CBJ,30,69,15,21,36
73,8480009,Eeli Tolvanen,R,SEA,25,75,15,21,36
73,8476392,Adam Lowry,C,WPG,31,65,15,21,36
73,8480798,Philipp Kurashev,C,CHI,25,65,14,22,36
73,8482133,Thomas Bordeleau,C,SJS,22,67,12,24,36
73,8482105,Jake Sanderson,D,OTT,22,71,12,24,36
73,8479410,Mikhail Sergachev,D,UTA,26,62,10,26,36
73,8481524,Bowen Byram,D,BUF,23,63,10,26,36
73,8481656,Aliaksei Protas,C,WSH,23,66,9,27,36
73,8482259,Bobby McMann,C,TOR,28,68,19,16,35
73,8475287,Erik Haula,L,NJD,33,71,17,18,35
73,8480802,Ryan McLeod,C,BUF,25,66,16,19,35
73,8481523,Kirby Dach,C,MTL,23,66,15,20,35
73,8476792,Torey Krug,D,STL,33,75,7,28,35
73,8480434,Sean Durzi,D,UTA,26,70,6,29,35
73,8477498,Darnell Nurse,D,EDM,29,74,6,29,35
73,8482712,Oskar Olausson,R,COL,22,79,5,30,35
73,8475855,Jesper Fast,R,CAR,33,58,17,17,34
73,8484203,Bradly Nadeau,L,CAR,19,63,16,18,34
73,8480855,Jack McBain,C,UTA,24,69,16,18,34
73,8477839,Conor Sheary,L,TBL,32,82,13,21,34
73,8476292,Ondrej Palat,L,NJD,33,66,12,22,34
73,8476885,Jacob Trouba,D,NYR,30,68,6,28,34
73,8480980,Connor Dewar,C,TOR,25,66,19,14,33
73,8478020,Michael Amadio,R,OTT,28,69,17,16,33
73,8477953,Kasperi Kapanen,R,STL,28,70,15,18,33
73,8476925,Colton Sissons,C,NSH,31,68,15,18,33
73,8478133,Jake Evans,C,MTL,28,69,13,20,33
73,8476458,Ryan Strome,C,ANA,31,66,12,21,33
73,8480813,Joe Veleno,C,DET,24,75,12,21,33
73,8479339,Patrik Laine,L,CBJ,26,54,11,22,33
73,8477346,MacKenzie Weegar,D,CGY,30,68,10,23,33
73,8482624,Daniil Miromanov,D,CGY,27,68,9,24,33
73,8476854,Hampus Lindholm,D,BOS,30,70,8,25,33
73,8481535,Nils Hoglander,L,VAN,24,68,20,12,32
73,8478046,Danton Heinen,L,VAN,29,67,16,16,32
73,8477426,Nicholas Paul,L,TBL,29,81,14,18,32
73,8477952,Robby Fabbri,C,ANA,28,69,14,18,32
73,8476960,Andreas Athanasiou,C,CHI,30,53,14,18,32
73,8477505,Alexander Wennberg,C,SJS,30,66,11,21,32
73,8482092,Ridly Greig,C,OTT,22,76,6,26,32
73,8476438,Brandon Saad,L,STL,32,66,19,12,31
73,8478474,Lawson Crouse,L,UTA,27,75,19,12,31
73,8482667,William Eklund,L,SJS,22,64,17,14,31
73,8480849,Barrett Hayton,C,UTA,24,66,15,16,31
73,8480068,Ryan Poehling,C,PHI,25,74,14,17,31
73,8474149,Evgenii Dadonov,R,DAL,35,80,12,19,31
73,8480113,Alex Iafallo,L,WPG,31,67,10,21,31
73,8478911,Matt Roy,D,WSH,29,66,5,26,31
73,8476892,Colton Parayko,D,STL,31,68,2,29,31
73,8479661,Tanner Jeannot,L,LAK,27,75,15,15,30
73,8480871,Adam Boqvist,D,FLA,24,69,14,16,30
73,8475193,Tomas Tatar,L,NJD,34,65,14,16,30
73,8483445,Cutter Gauthier,L,ANA,20,64,14,16,30
73,8484166,Adam Fantilli,C,CBJ,20,66,13,17,30
73,8481582,Nicholas Robertson,L,TOR,23,63,13,17,30
73,8480185,Eetu Luostarinen,C,FLA,26,75,13,17,30
73,8479351,Sam Steel,C,DAL,26,80,12,18,30
73,8481577,Philip Tomasino,C,NSH,23,64,12,18,30
73,8475231,Casey Cizikas,C,NYI,33,75,11,19,30
73,8476461,Sean Couturier,C,PHI,32,63,9,21,30
73,8474053,Logan Couture,C,SJS,35,61,9,21,30
73,8482149,Cole Perfetti,C,WPG,22,70,6,24,30
73,8480873,Rasmus Sandin,D,WSH,24,69,5,25,30
73,8476979,Erik Gustafsson,D,DET,32,74,4,26,30
73,8477969,Marcus Pettersson,D,PIT,28,79,4,26,30
73,8478500,Ivan Provorov,D,CBJ,27,80,2,28,30
73,8482055,Drew O'Connor,L,PIT,26,62,19,10,29
73,8482702,Logan Stankoven,C,DAL,21,76,18,11,29
73,8480893,Kirill Marchenko,R,CBJ,24,56,16,13,29
73,8482074,Connor Zary,C,CGY,23,62,15,14,29
73,8479591,Michael Eyssimont,C,TBL,28,80,15,14,29
73,8477919,Frederick Gaudreau,C,MIN,31,63,15,14,29
73,8479316,Luke Kunin,C,SJS,27,59,15,14,29
73,8476278,Colin Blackwell,C,DAL,31,78,14,15,29
73,8480829,Jesperi Kotkaniemi,C,CAR,24,68,13,16,29
73,8480220,Noah Cates,L,PHI,25,66,12,17,29
73,8476474,Stefan Noesen,R,NJD,31,71,12,17,29
73,8480448,Parker Kelly,L,COL,25,72,11,18,29
73,8479987,Morgan Geekie,C,BOS,26,79,10,19,29
73,8475343,Nic Dowd,C,WSH,34,57,10,19,29
73,8479941,Justin Danforth,R,CBJ,31,62,10,19,29
73,8482660,Kent Johnson,C,CBJ,22,70,9,20,29
73,8481546,Cam York,D,PHI,23,66,7,22,29
73,8476917,Adam Pelech,D,NYI,30,78,3,26,29
73,8482111,Justin Barron,D,MTL,23,64,3,26,29
73,8470621,Corey Perry,R,EDM,39,70,14,14,28
73,8479293,Brandon Tanev,L,SEA,33,70,13,15,28
73,8475848,Brendan Gallagher,R,MTL,32,68,13,15,28
73,8476927,Teddy Blueger,C,VAN,30,70,12,16,28
73,8479353,Brett Howden,C,VGK,26,67,12,16,28
73,8477989,Christian Dvorak,C,MTL,28,68,10,18,28
73,8482117,Lukas Reichel,L,CHI,22,57,10,18,28
73,8475791,Taylor Hall,L,CHI,33,58,9,19,28
73,8478891,Mason Appleton,C,WPG,28,57,9,19,28
73,8482671,Owen Power,D,BUF,22,70,8,20,28
73,8475200,Dmitry Orlov,D,CAR,33,75,7,21,28
73,8480043,Timothy Liljegren,D,TOR,25,73,3,25,28
73,8478432,Christian Fischer,R,DET,27,74,10,17,27
73,8483468,Jiri Kulich,C,BUF,20,63,9,18,27
73,8479368,Max Jones,L,BOS,26,59,9,18,27
73,8477948,Travis Sanheim,D,PHI,28,69,8,19,27
73,8476902,Esa Lindell,D,DAL,30,73,7,20,27
73,8474151,Ryan McDonagh,D,TBL,35,74,3,24,27
73,8478463,Anthony Beauvillier,L,PIT,27,66,16,10,26
73,8474715,Cameron Atkinson,R,TBL,35,81,16,10,26
73,8477987,Ryan Donato,C,CHI,28,60,15,11,26
73,8482157,Will Cuylle,L,NYR,22,65,15,11,26
73,8473533,Jordan Staal,C,CAR,36,58,13,13,26
73,8481093,Rafael Harvey-Pinard,L,MTL,25,58,12,14,26
73,8481601,Simon Holmstrom,R,NYI,23,72,12,14,26
73,8476918,Jimmy Vesey,L,NYR,31,72,11,15,26
73,8480762,Eric Robinson,L,CAR,29,61,10,16,26
73,8476921,Jordan Martinook,L,CAR,32,66,9,17,26
73,8476422,Mike Reilly,D,NYI,31,77,8,18,26
73,8481553,Bobby Brink,R,PHI,23,59,8,18,26
73,8482809,Jackson Blake,R,CAR,21,54,8,18,26
73,8480003,Jesper Boqvist,C,FLA,26,64,7,19,26
73,8476923,Damon Severson,D,CBJ,30,82,5,21,26
73,8477506,Ryan Pulock,D,NYI,30,77,5,21,26
73,8474563,Drew Doughty,D,LAK,35,69,4,22,26
73,8480035,Henri Jokiharju,D,BUF,25,62,3,23,26
73,8480459,Pius Suter,C,VAN,28,73,13,12,25
73,8477488,Brett Pesce,D,NJD,30,73,10,15,25
73,8478057,Dakota Joshua,C,VAN,28,64,9,16,25
73,8477425,Miles Wood,L,COL,29,75,9,16,25
73,8480336,Sean Walker,D,CAR,30,74,7,18,25
73,8481441,Joe Snively,C,DET,28,63,5,20,25
73,8479976,Juuso Valimaki,D,UTA,26,60,2,23,25
73,8474673,TJ Brodie,D,CHI,34,61,1,24,25
73,8481704,Juuso Parssinen,C,NSH,23,59,14,10,24
73,8481624,Ilya Mikheyev,R,CHI,30,60,11,13,24
73,8479414,Nathan Bastian,R,NJD,27,60,11,13,24
73,8480878,Nils Lundkvist,D,DAL,24,71,10,14,24
73,8479324,Ryan Lindgren,D,NYR,26,64,6,18,24
73,8476856,Mathew Dumba,D,DAL,30,74,5,19,24
73,8476891,Matthew Grzelcyk,D,PIT,30,72,4,20,24
73,8481014,Alexander Romanov,D,NYI,24,77,3,21,24
73,8475181,Nick Leddy,D,STL,33,68,3,21,24
73,8473507,Jeff Petry,D,DET,37,71,3,21,24
73,8480807,Mattias Samuelsson,D,BUF,24,55,0,24,24
73,8477903,Garnet Hathaway,R,PHI,33,54,14,9,23
73,8477015,Connor Brown,R,EDM,30,63,13,10,23
73,8481554,Kaapo Kakko,R,NYR,23,64,12,11,23
73,8482749,Joshua Roy,R,MTL,21,64,12,11,23
73,8480078,Filip Chytil,C,NYR,25,67,12,11,23
73,8477947,Sonny Milano,L,WSH,28,60,12,11,23
73,8476480,Vladislav Namestnikov,C,WPG,32,69,11,12,23
73,8478013,Jake Walman,D,SJS,28,75,8,15,23
73,8482176,Wyatt Kaiser,D,CHI,22,55,8,15,23
73,8475171,Oliver Ekman-Larsson,D,TOR,33,66,6,17,23
73,8482122,Brock Faber,D,MIN,22,76,6,17,23
73,8480074,Alexandre Texier,C,STL,25,60,6,17,23
73,8475324,Nick Jensen,D,OTT,34,64,5,18,23
73,8479371,Dante Fabbro,D,NSH,26,65,5,18,23
73,8476994,Vinnie Hinostroza,C,NSH,30,52,5,18,23
73,8479998,Mikey Anderson,D,LAK,25,67,4,19,23
73,8478136,Jake Middleton,D,MIN,28,78,4,19,23
73,8476525,Colin Miller,D,WPG,32,63,3,20,23
73,8482089,Jake Neighbours,L,STL,22,66,16,6,22
73,8474716,Jared Spurgeon,D,MIN,35,77,11,11,22
73,8481580,Connor McMichael,C,WSH,23,63,11,11,22
73,8474189,Lars Eller,C,PIT,35,61,10,12,22
73,8476873,Mark Jankowski,C,NSH,30,55,10,12,22
73,8480806,Isac Lundestrom,C,ANA,25,57,10,12,22
73,8476981,Josh Anderson,R,MTL,30,73,7,15,22
73,8481481,Blake Lizotte,C,PIT,27,60,5,17,22
73,8478507,John Marino,D,UTA,27,62,4,18,22
73,8480073,Erik Brannstrom,D,COL,25,62,3,19,22
73,8478831,Kevin Stenlund,C,UTA,28,55,13,8,21
73,8482155,Alex Laferriere,R,LAK,23,69,13,8,21
73,8480355,Mark Kastelic,C,BOS,25,66,9,12,21
73,8478466,Daniel Sprong,R,VAN,27,68,6,15,21
73,8479026,Philippe Myers,D,TOR,27,57,6,15,21
73,8481527,Kaedan Korczak,D,VGK,23,47,5,16,21
73,8478882,Vladislav Gavrikov,D,LAK,29,67,4,17,21
73,8476331,Dylan DeMelo,D,WPG,31,70,3,18,21
73,8476463,Jonas Brodin,D,MIN,31,72,3,18,21
73,8476879,Cody Ceci,D,EDM,31,70,3,18,21
73,8482655,Janis Moser,D,TBL,24,73,2,19,21
73,8475790,Erik Gudbranson,D,CBJ,32,79,2,19,21
73,8481032,Paul Cotter,C,NJD,25,59,15,5,20
73,8480835,Jack Drury,C,CAR,24,56,14,6,20
73,8482062,Cole Smith,L,NSH,29,53,12,8,20
73,8480789,Oliver Wahlstrom,R,NYI,24,70,11,9,20
73,8476897,Oskar Sundqvist,C,STL,30,64,10,10,20
73,8477406,Mattias Janmark,C,EDM,32,65,10,10,20
73,8482079,Marco Rossi,C,MIN,23,60,9,11,20
73,8478109,Victor Olofsson,L,VGK,29,72,7,13,20
73,8482067,Connor Mackey,D,NYR,28,58,7,13,20
73,8477507,Nikita Zadorov,D,BOS,29,72,6,14,20
73,8480049,Dylan Samberg,D,WPG,25,67,5,15,20
73,8482101,Danil Gushchin,L,SJS,22,54,4,16,20
73,8477845,Trevor van Riemsdyk,D,WSH,33,67,4,16,20
73,8479639,Dylan Coghlan,D,WPG,26,61,4,16,20
73,8478178,Darren Raddysh,D,TBL,28,71,4,16,20
73,8479983,Mario Ferraro,D,SJS,26,72,2,18,20
73,8478840,Will Borgen,D,SEA,28,64,2,18,20
73,8480860,Kevin Bahl,D,CGY,24,65,1,19,20
73,8476822,Luke Glendening,C,TBL,35,79,12,7,19
73,8476469,Joel Armia,R,MTL,31,62,10,9,19
73,8482125,Alexander Holtz,R,VGK,22,67,10,9,19
73,8479718,Alex Barré-Boulet,C,MTL,27,45,10,9,19
73,8475220,Marcus Foligno,L,MIN,33,56,9,10,19
73,8480144,David Kampf,C,TOR,29,68,8,11,19
73,8479390,Taylor Raddysh,R,WSH,26,58,8,11,19
73,8478970,Jalen Chatfield,D,CAR,28,66,8,11,19
73,8477446,Michael McCarron,R,NSH,29,55,8,11,19
73,8482679,Matt Coronato,R,CGY,22,64,7,12,19
73,8478434,Keegan Kolesar,R,VGK,27,58,7,12,19
73,8480205,Emil Bemstrom,C,PIT,25,59,6,13,19
73,8483565,Nick Blankenburg,D,NSH,26,65,6,13,19
73,8479315,Joey Anderson,R,CHI,26,59,6,13,19
73,8481606,Jordan Spence,D,LAK,23,60,5,14,19
73,8479402,Jake Bean,D,CGY,26,67,5,14,19
73,8479398,Samuel Girard,D,COL,26,67,2,17,19
73,8482245,Artem Zub,D,OTT,29,71,2,17,19
73,8475455,Brenden Dillon,D,NJD,34,53,1,18,19
73,8473422,Nick Foligno,L,CHI,37,51,11,7,18
73,8481477,Nico Sturm,C,SJS,29,47,11,7,18
73,8482148,Hendrix Lapierre,C,WSH,22,54,10,8,18
73,8475149,Marcus Johansson,L,MIN,34,61,9,9,18
73,8473453,Trevor Lewis,C,LAK,37,73,8,10,18
73,8477573,Nathan Walker,L,STL,30,50,8,10,18
73,8477070,Liam O'Brien,C,UTA,30,63,8,10,18
73,8483491,Ivan Miroshnichenko,L,WSH,20,59,7,11,18
73,8481522,Peyton Krebs,C,BUF,23,50,5,13,18
73,8480796,Martin Fehervary,D,WSH,25,47,5,13,18
73,8482142,Jamie Drysdale,D,PHI,22,62,4,14,18
73,8476967,Brett Kulak,D,EDM,30,53,4,14,18
73,8480222,Sebastian Aho,D,PIT,28,72,3,15,18
73,8476988,Matt Benning,D,SJS,30,64,3,15,18
73,8470600,Ryan Suter,D,STL,39,65,3,15,18
73,8482087,Kaiden Guhle,D,MTL,22,69,2,16,18
73,8482073,Braden Schneider,D,NYR,23,65,2,16,18
73,8475233,David Savard,D,MTL,34,60,1,17,18
73,8480246,Nick Perbix,D,TBL,26,74,1,17,18
73,8478043,Sam Lafferty,C,BUF,29,54,12,5,17
73,8479336,Carl Grundstrom,R,SJS,27,52,12,5,17
73,8477478,William Carrier,L,CAR,30,54,8,9,17
73,8482737,Zack Bolduc,C,STL,21,56,8,9,17
73,8481641,Joel Kiviranta,L,COL,28,67,8,9,17
73,8476374,Sean Kuraly,C,CBJ,31,59,8,9,17
73,8477369,Carson Soucy,D,VAN,30,60,8,9,17
73,8483482,Tristan Luneau,D,ANA,20,61,7,10,17
73,8476878,Zemgus Girgensons,C,TBL,30,81,7,10,17
73,8476889,Radek Faksa,C,STL,30,66,7,10,17
73,8475225,Craig Smith,C,CHI,35,50,7,10,17
73,8477931,Tomas Nosek,L,FLA,32,63,6,11,17
73,8477392,Hudson Fasching,R,NYI,29,65,5,12,17
73,8479671,Mathieu Olivier,R,CBJ,27,44,5,12,17
73,8476931,Jake McCabe,D,TOR,31,62,3,14,17
73,8482451,Mikael Pyyhtia,L,CBJ,23,52,3,14,17
73,8477450,Jason Dickinson,C,CHI,29,54,8,8,16
73,8478569,Noel Acciari,C,PIT,33,54,8,8,16
73,8482077,Dylan Holloway,L,EDM,23,57,8,8,16
73,8479520,Brandon Duhaime,R,WSH,27,55,8,8,16
73,8479066,Ryan Lomberg,L,CGY,30,70,7,9,16
73,8480727,Zach Whitecloud,D,VGK,28,50,6,10,16
73,8475718,Justin Holl,D,DET,32,60,6,10,16
73,8479996,Cody Glass,C,NSH,25,55,5,11,16
73,8477220,Nate Schmidt,D,FLA,33,70,5,11,16
73,8476312,Josh Manson,D,COL,33,62,5,11,16
73,8481178,Egor Zamula,D,PHI,24,59,5,11,16
73,8476329,Travis Boyd,C,MIN,31,61,4,12,16
73,8483493,Frank Nazar,C,CHI,20,51,4,12,16
73,8480289,Morgan Barron,C,WPG,26,52,4,12,16
73,8475690,Chris Tanev,D,TOR,35,59,3,13,16
73,8476429,Scott Mayfield,D,NYI,32,76,2,14,16
73,8477499,Rasmus Ristolainen,D,PHI,30,64,2,14,16
73,8480950,Ilya Lyubushkin,D,DAL,30,66,2,14,16
73,8478452,Caleb Jones,D,LAK,27,58,2,14,16
73,8483524,Shane Wright,C,SEA,20,58,10,5,15
73,8481716,Dmitri Voronkov,L,CBJ,24,44,9,6,15
73,8477353,Tyler Motte,C,DET,29,72,9,6,15
73,8481028,Martin Pospisil,C,CGY,25,49,8,7,15
73,8479619,Michael Carcone,L,UTA,28,56,7,8,15
73,8477979,Nicolas Aube-Kubel,R,BUF,28,64,6,9,15
73,8473563,Nicklas Backstrom,C,WSH,37,55,6,9,15
73,8477435,Ryan Graves,D,PIT,29,74,5,10,15
73,8480021,Jack Studnicka,C,LAK,25,59,5,10,15
73,8480252,Cole Guttman,C,CHI,25,41,5,10,15
73,8483457,Lane Hutson,D,MTL,20,64,4,11,15
73,8476457,Adam Larsson,D,SEA,32,66,4,11,15
73,8477508,Curtis Lazar,C,NJD,29,63,4,11,15
73,8479369,Andrew Peeke,D,BOS,26,67,4,11,15
73,8477018,Ben Hutton,D,VGK,31,51,4,11,15
73,8481708,Zac Jones,D,NYR,24,56,4,11,15
73,8479982,Conor Timmins,D,TOR,26,57,4,11,15
73,8478211,Dryden Hunt,L,CGY,29,54,4,11,15
73,8475208,Brian Dumoulin,D,ANA,33,64,0,15,15
73,8480748,Kiefer Sherwood,L,VAN,29,53,9,5,14
73,8475842,Sam Carrick,C,NYR,32,56,9,5,14
73,8474034,Patrick Maroon,L,CHI,36,48,7,7,14
73,8480995,Pontus Holmberg,R,TOR,25,59,6,8,14
73,8478508,Yakov Trenin,C,MIN,27,58,6,8,14
73,8476624,Barclay Goodrow,C,SJS,31,48,6,8,14
73,8482859,Zack Ostapchuk,C,OTT,21,55,5,9,14
73,8475279,Ben Chiarot,D,DET,33,67,4,10,14
73,8481019,David Gustafsson,C,WPG,24,50,4,10,14
73,8483495,Simon Nemec,D,NJD,20,63,3,11,14
73,8478416,Erik Cernak,D,TBL,27,63,3,11,14
73,8479442,Troy Stecher,D,EDM,30,56,3,11,14
73,8480891,Michael Kesselring,D,UTA,24,58,2,12,14
73,8478399,Jonas Siegenthaler,D,NJD,27,59,2,12,14
73,8480058,Pierre-Olivier Joseph,D,STL,25,49,2,12,14
73,8479249,Andrew Poturalski,C,SJS,30,44,0,14,14
73,8478585,Derek Ryan,C,EDM,38,64,8,5,13
73,8481532,Alex Turcotte,C,LAK,23,39,8,5,13
73,8478421,A.J. Greer,L,FLA,28,58,7,6,13
73,8483499,Liam Ohgren,L,MIN,20,53,7,6,13
73,8479344,Jesse Puljujarvi,R,PIT,26,62,7,6,13
73,8483549,Lucas Condotta,L,MTL,27,41,7,6,13
73,8479291,Kevin Rooney,C,CGY,31,45,6,7,13
73,8481013,Jonatan Berggren,R,DET,24,61,5,8,13
73,8476467,Jamie Oleksiak,D,SEA,32,62,4,9,13
73,8481567,Henry Thrun,D,SJS,23,43,4,9,13
73,8479370,Tyson Jost,C,CAR,26,53,4,9,13
73,8478443,Brandon Carlo,D,BOS,28,67,4,9,13
73,8471677,Jack Johnson,D,CBJ,37,57,4,9,13
73,8478851,Alexandre Carrier,D,NSH,28,68,3,10,13
73,8479980,Nicolas Hague,D,VGK,26,55,3,10,13
73,8481568,Alex Vlasic,D,CHI,23,61,1,12,13
73,8481518,Nolan Foote,L,NJD,24,37,10,2,12
73,8482652,Walker Duehr,R,CGY,27,45,8,4,12
73,8482070,Mitchell Chaffee,R,TBL,26,55,6,6,12
73,8479359,Beck Malenstyn,L,BUF,26,46,5,7,12
73,8480157,Calle Rosen,D,COL,30,56,5,7,12
73,8481521,Ronnie Attard,D,PHI,25,57,4,8,12
73,8482166,Shakir Mukhamadullin,D,SJS,22,60,4,8,12
73,8482803,Olen Zellweger,D,ANA,21,63,3,9,12
73,8480172,Jan Rutta,D,SJS,34,59,3,9,12
73,8474568,Luke Schenn,D,NSH,35,59,3,9,12
73,8480001,Urho Vaakanainen,D,ANA,25,55,3,9,12
73,8482634,Alex Steeves,C,TOR,25,45,3,9,12
73,8474013,Ian Cole,D,UTA,35,54,2,10,12
73,8475188,Brayden McNabb,D,VGK,33,49,1,11,12
73,8482730,Brandt Clarke,D,LAK,21,56,0,12,12
73,8475235,Nicolas Deslauriers,L,PHI,33,58,9,2,11
73,8479968,Vinni Lettieri,C,BOS,29,45,8,3,11
73,8476858,Phillip Di Giuseppe,L,VAN,31,42,7,4,11
73,8482666,Scott Morrow,D,CAR,22,48,6,5,11
73,8480011,Klim Kostin,C,SJS,25,54,5,6,11
73,8481617,Vasily Podkolzin,R,VAN,23,53,5,6,11
73,8479328,Julien Gauthier,R,NYI,27,54,4,7,11
73,8482095,Tyler Kleven,D,OTT,22,41,4,7,11
73,8478468,Jeremy Lauzon,D,NSH,27,44,4,7,11
73,8474612,Travis Hamonic,D,OTT,34,54,3,8,11
73,8475179,Dmitry Kulikov,D,FLA,34,66,2,9,11
73,8474567,Zach Bogosian,D,MIN,34,60,2,9,11
73,8480245,Olle Lycksell,R,PHI,25,36,2,9,11
73,8481600,Tobias Bjornfot,D,FLA,23,35,2,9,11
73,8475177,Calvin de Haan,D,COL,33,46,1,10,11
73,8475462,Radko Gudas,D,ANA,34,64,0,11,11
73,8481517,Brett Leason,R,ANA,25,56,7,3,10
73,8481161,Jake Christiansen,D,CBJ,25,58,6,4,10
73,8481537,Nikita Okhotiuk,D,CGY,24,52,6,4,10
73,8480844,Grigori Denisenko,L,VGK,24,34,6,4,10
73,8482153,Brendan Brisson,C,VGK,23,31,6,4,10
73,8481556,John Beecher,C,BOS,23,33,6,4,10
73,8480281,Alexey Toropchenko,R,STL,25,53,5,5,10
73,8478424,Jansen Harkins,C,ANA,27,39,5,5,10
73,8483397,Marc McLaughlin,C,BOS,25,36,5,5,10
73,8482192,Isaak Phillips,D,CHI,23,46,4,6,10
73,8477380,Jonny Brodzinski,C,NYR,31,54,4,6,10
73,8476874,Olli Maatta,D,DET,30,63,4,6,10
73,8476473,Connor Murphy,D,CHI,31,37,3,7,10
73,8476442,Matt Nieto,L,PIT,32,47,2,8,10
73,8481059,Scott Perunovich,D,STL,26,57,1,9,10
73,8481550,Adam Beckman,L,NJD,23,46,1,9,10
73,8475750,Jon Merrill,D,MIN,32,68,1,9,10
73,8482762,Simon Edvinsson,D,DET,21,52,7,2,9
73,8471817,Ryan Reaves,R,TOR,37,58,6,3,9
73,8479994,Jaret Anderson-Dolan,C,WPG,25,34,6,3,9
73,8482496,Nils Aman,C,VAN,24,41,6,3,9
73,8482807,Ethan Del Mastro,D,CHI,21,46,5,4,9
73,8477887,Patrick Brown,C,BOS,32,45,5,4,9
73,8477938,Haydn Fleury,D,WPG,28,41,4,5,9
73,8479972,Mason Shaw,C,WPG,26,38,4,5,9
73,8480848,Ty Dellandrea,C,SJS,24,35,4,5,9
73,8479536,Axel Jonsson-Fjallby,L,WPG,26,37,4,5,9
73,8479320,Maxime Lajoie,D,SEA,27,25,4,5,9
73,8482145,Mavrik Bourque,C,DAL,22,53,4,5,9
73,8477365,Connor Clifton,D,BUF,29,53,3,6,9
73,8477482,Zachary Sanford,L,CHI,30,44,3,6,9
73,8476867,Brendan Gaunce,C,MIN,30,39,3,6,9
73,8481751,Lukas Rousek,R,BUF,25,42,2,7,9
73,8477401,John Hayden,C,SEA,29,28,2,7,9
73,8479986,Kole Lind,R,DAL,26,50,2,7,9
73,8481167,Brayden Pachal,D,CGY,25,35,2,7,9
73,8483460,David Jiricek,D,CBJ,21,54,1,8,9
73,8473446,Erik Johnson,D,PHI,36,50,1,8,9
73,8479348,Kale Clague,D,BUF,26,42,0,9,9
73,8479378,Logan Stanley,D,WPG,26,47,0,9,9
73,8481789,Tye Kartye,L,SEA,23,32,6,2,8
73,8483466,Kevin Korchinski,D,CHI,20,48,5,3,8
73,8481122,Simon Benoit,D,TOR,26,36,4,4,8
73,8482659,Josh Doan,R,UTA,22,51,3,5,8
73,8478451,Ethan Bear,D,WSH,27,50,3,5,8
73,8482751,Ryan Winterton,C,SEA,21,42,3,5,8
73,8479981,Jonah Gadjovich,L,FLA,26,38,3,5,8
73,8479543,Michael Pezzetta,L,MTL,26,59,2,6,8
73,8477034,Jaycob Megna,D,FLA,32,42,2,6,8
73,8481609,Vladislav Kolyachonok,D,UTA,23,38,2,6,8
73,8477462,Robert Hagg,D,VGK,29,27,2,6,8
73,8480887,Jordan Harris,D,MTL,24,59,1,7,8
73,8483619,Filip Roos,D,OTT,25,32,1,7,8
73,8480196,Jacob Bryson,D,BUF,27,36,1,7,8
73,8480879,Jacob Bernard-Docker,D,OTT,24,49,1,7,8
73,8476441,Joel Edmundson,D,LAK,31,44,1,7,8
73,8471709,Marc-Edouard Vlasic,D,SJS,37,58,0,8,8
73,8479944,Zach Aston-Reese,C,VGK,30,51,6,1,7
73,8476934,Brock McGinn,L,ANA,30,51,5,2,7
73,8481754,Nikita Nesterenko,C,ANA,23,34,4,3,7
73,8482744,James Malatesta,L,CBJ,21,46,4,3,7
73,8480070,Ian Mitchell,D,BOS,25,46,4,3,7
73,8480990,Declan Chisholm,D,MIN,24,38,4,3,7
73,8478409,Anthony Richard,C,PHI,28,27,4,3,7
73,8482747,Brennan Othmann,L,NYR,21,40,4,3,7
73,8482713,Mackie Samoskevich,R,FLA,22,45,3,4,7
73,8480845,Rasmus Kupari,C,WPG,24,48,3,4,7
73,8477962,Brendan Lemieux,L,CAR,28,37,3,4,7
73,8479439,Jacob MacDonald,D,COL,31,41,3,4,7
73,8474166,Alec Martinez,D,CHI,37,51,3,4,7
73,8481147,Reese Johnson,C,MIN,26,39,3,4,7
73,8477335,Kyle Burroughs,D,LAK,29,36,2,5,7
73,8478017,Mark Friedman,D,VAN,29,35,2,5,7
73,8483763,Maksymilian Szuber,D,UTA,22,36,2,5,7
73,8484149,Gavin Brindley,C,CBJ,20,48,1,6,7
73,8479576,Vincent Desharnais,D,VAN,28,44,1,6,7
73,8474574,Tyler Myers,D,VAN,34,65,0,7,7
73,8479372,Joshua Mahura,D,SEA,26,44,0,7,7
73,8478021,William Lagesson,D,DET,28,29,4,2,6
73,8481592,Jakob Pelletier,L,CGY,23,39,3,3,6
73,8480880,Jakub Lauko,C,MIN,24,29,3,3,6
73,8480834,Ty Emberson,D,SJS,24,37,3,3,6
73,8474090,Brendan Smith,D,DAL,35,48,2,4,6
73,8482964,Arber Xhekaj,D,MTL,23,47,2,4,6
73,8482784,Zach Dean,C,STL,21,49,2,4,6
73,8477851,Jordan Oesterle,D,BOS,32,32,2,4,6
73,8481543,Nikita Alexandrov,C,STL,24,29,2,4,6
73,8480192,Johnathan Kovacevic,D,NJD,27,51,1,5,6
73,8476913,Devin Shore,C,MIN,30,26,1,5,6
73,8476952,Dominic Toninato,C,WPG,30,31,1,5,6
73,8482511,Mason Lohrei,D,BOS,23,39,1,5,6
73,8476372,Nick Seeler,D,PHI,31,40,1,5,6
73,8481599,Victor Soderstrom,D,UTA,23,50,0,6,6
73,8481701,Santeri Hatakka,D,NJD,23,32,0,6,6
73,8480025,MacKenzie Entwistle,R,FLA,25,62,4,1,5
73,8481422,Jake Lucchini,C,NSH,29,17,4,1,5
73,8479772,Zack MacEwen,R,OTT,28,53,3,2,5
73,8484258,Sam Malinski,D,COL,26,18,3,2,5
73,8477473,Justin Bailey,R,SJS,29,23,3,2,5
73,8481056,Spencer Stastney,D,NSH,24,29,2,3,5
73,8482147,Jean-Luc Foudy,C,COL,22,29,2,3,5
73,8481598,Philip Broberg,D,EDM,23,41,1,4,5
73,8484911,Collin Graf,R,SJS,22,39,1,4,5
73,8478874,Adam Gaudette,R,OTT,28,40,1,4,5
73,8483630,Pavol Regenda,L,ANA,25,28,1,4,5
73,8483512,Matthew Savoie,C,EDM,20,21,1,4,5
73,8482733,Logan Mailloux,D,MTL,31,38,0,5,5
73,8482858,Ryker Evans,D,SEA,23,29,0,5,5
73,8477971,Andreas Englund,D,LAK,28,31,0,5,5
73,8484254,Akito Hirose,D,VAN,25,38,0,5,5
73,8477244,Chad Ruhwedel,D,NYR,34,28,0,5,5
73,8481679,Maxence Guenette,D,OTT,23,36,3,1,4
73,8480292,Carson Meyer,R,ANA,27,30,2,2,4
73,8479638,Justin Brazeau,R,BOS,26,38,2,2,4
73,8475762,Derek Forbort,D,VAN,32,49,2,2,4
73,8480874,Adam Ginning,D,PHI,24,10,2,2,4
73,8481030,Jack St. Ivany,D,PIT,25,17,1,3,4
73,8477384,Joshua Brown,D,EDM,30,49,1,3,4
73,8482861,Vincent Iorio,D,WSH,22,37,1,3,4
73,8478477,Mitchell Stephens,C,SEA,27,21,1,3,4
73,8477073,Kurtis MacDermid,L,NJD,30,29,1,3,4
73,8480007,Jonas Rondbjerg,R,VGK,25,38,0,4,4
73,8478450,Parker Wotherspoon,D,BOS,27,29,0,4,4
73,8480441,Trey Fix-Wolansky,R,CBJ,25,36,0,4,4
73,8480870,Bo Groulx,C,NYR,24,21,0,4,4
73,8482470,Ilya Solovyov,D,CGY,24,18,0,4,4
73,8478502,Dennis Gilbert,D,BUF,28,18,0,4,4
73,8481743,Marc Del Gaizo,D,NSH,25,16,3,0,3
73,8477541,Dakota Mermis,D,TOR,30,12,3,0,3
73,8475413,Justin Dowling,C,NJD,34,12,3,0,3
73,8481564,Ryan Johnson,D,BUF,23,19,2,1,3
73,8483567,Georgii Merkulov,C,BOS,24,8,2,1,3
73,8478859,Niko Mikkola,D,FLA,28,57,1,2,3
73,8479419,Brett Murray,L,BUF,26,16,1,2,3
73,8481605,Jackson LaCombe,D,ANA,23,36,1,2,3
73,8478051,Max Willman,C,NJD,29,23,1,2,3
73,8480468,James Hamblin,L,EDM,25,19,1,2,3
73,8481206,John Ludvig,D,PIT,24,10,1,2,3
73,8481065,Angus Crookshank,L,OTT,25,17,1,2,3
73,8474062,Riley Nash,C,NYR,35,20,1,2,3
73,8477810,Joel Hanley,D,CGY,33,27,0,3,3
73,8478454,Noah Juulsen,D,VAN,27,36,0,3,3
73,8482141,Lukas Cormier,D,VGK,22,24,0,3,3
73,8479379,Givani Smith,R,SJS,26,30,0,3,3
73,8482165,Yan Kuznetsov,D,CGY,22,16,0,3,3
73,8479985,Cale Fleury,D,SEA,26,27,0,3,3
73,8482516,Matthew Kessel,D,STL,24,18,0,3,3
73,8477527,Ross Johnston,L,ANA,30,32,0,3,3
73,8481541,Samuel Bolduc,D,NYI,24,20,0,3,3
73,8483489,Fraser Minten,C,TOR,31,8,2,0,2
73,8480851,Akil Thomas,C,LAK,24,22,2,0,2
73,8478146,Matthew Highmore,C,OTT,28,32,1,1,2
73,8482172,Landon Slaggert,L,CHI,22,19,1,1,2
73,8481237,Kyle MacLean,C,NYI,25,23,1,1,2
73,8480267,Sammy Walker,C,MIN,25,16,1,1,2
73,8481043,Cole Koepke,L,BOS,26,17,1,1,2
73,8475958,Michael Sgarbossa,C,WSH,32,27,1,1,2
73,8482177,Marat Khusnutdinov,C,MIN,22,34,1,1,2
73,8483407,Brandon Scanlin,D,NYR,25,9,1,1,2
73,8477467,Gustav Olofsson,D,SEA,30,23,1,1,2
73,8478881,Brett Seney,L,CHI,28,10,1,1,2
73,8480075,Cameron Crotty,D,MIN,25,10,1,1,2
73,8482476,Emil Heineman,L,MTL,23,5,1,1,2
73,8478147,Bokondji Imama,L,PIT,28,3,1,1,2
73,8482765,Isak Rosen,R,BUF,21,28,0,2,2
73,8479991,Jake Leschyshyn,C,NYR,25,23,0,2,2
73,8480890,Jan Jenik,C,OTT,24,30,0,2,2
73,8479587,Rhett Gardner,C,PHI,28,21,0,2,2
73,8482102,Vasily Ponomarev,C,PIT,22,28,0,2,2
73,8484287,Cole McWard,D,VAN,23,23,0,2,2
73,8475795,Dylan McIlrath,D,WSH,32,15,0,2,2
73,8478446,Glenn Gawdin,C,LAK,27,9,0,2,2
73,8482250,Callahan Burke,C,VGK,27,21,0,2,2
73,8483012,Logan Morrison,C,SEA,22,32,1,0,1
73,8479362,Riley Tufte,L,BOS,26,19,1,0,1
73,8477320,Anton Blidh,L,NYR,29,28,1,0,1
73,8482929,Emil Lilleberg,D,TBL,23,29,1,0,1
73,8477149,Scott Sabourin,R,SJS,32,15,1,0,1
73,8482162,Roby Jarventie,L,EDM,22,13,1,0,1
73,8481462,Mason Morelli,L,VGK,28,20,1,0,1
73,8479367,William Lockwood,R,FLA,26,19,1,0,1
73,8483471,Brad Lambert,C,WPG,31,5,1,0,1
73,8480306,Grant Hutton,D,NYI,29,8,1,0,1
73,8482094,Daemon Hunt,D,MIN,22,13,1,0,1
73,8478854,Ryan Shea,D,PIT,27,7,1,0,1
73,8481006,Tyler Tucker,D,STL,24,19,0,1,1
73,8483570,Ben Meyers,C,SEA,26,21,0,1,1
73,8480084,Nick DeSimone,D,NJD,30,11,0,1,1
73,8482144,Jack Thompson,D,SJS,22,24,0,1,1
73,8483597,Milos Kelemen,L,UTA,25,12,0,1,1
73,8482201,Gage Goncalves,C,TBL,23,15,0,1,1
73,8481024,Linus Karlsson,C,VAN,25,9,0,1,1
73,8484325,Waltteri Merela,C,TBL,26,20,0,1,1
73,8482460,Matt Rempe,C,NYR,22,19,0,1,1
73,8480032,Shane Bowers,C,NJD,25,16,0,1,1
73,8480823,Alexander Alexeyev,D,WSH,25,8,0,1,1
73,8483395,Arshdeep Bains,L,VAN,23,9,0,1,1
73,8481699,Aku Raty,R,UTA,23,18,0,1,1
73,8481655,Cole Schwindt,R,CGY,23,6,0,1,1
73,8482197,Adam Raska,R,MIN,23,6,0,1,1
73,8475780,Chris Wagner,R,COL,33,9,0,1,1
73,8481585,Egor Afanasyev,L,SJS,23,12,0,0,0
73,8482118,Sam Colangelo,R,ANA,23,12,0,0,0
73,8482061,Brandon Biro,L,SEA,26,11,0,0,0
73,8481806,Louis Crevier,D,CHI,23,17,0,0,0
73,8479421,Jacob Moverare,D,LAK,26,4,0,0,0
73,8482088,Justin Sourdif,R,FLA,22,12,0,0,0
73,8484304,Uvis Balinskis,D,FLA,28,10,0,0,0
73,8478011,Louie Belpedio,D,PHI,28,11,0,0,0
73,8483398,Declan Carlile,D,TBL,31,9,0,0,0
73,8481578,Graeme Clarke,R,MIN,23,10,0,0,0
73,8479330,Brandon Gignac,C,MTL,27,8,0,0,0
73,8475755,Alexander Petrovic,D,DAL,32,9,0,0,0
73,8482126,Emil Andrae,D,PHI,31,4,0,0,0
73,8481593,Jayden Struble,D,MTL,23,19,0,0,0
73,8482787,Nikita Chibrikov,R,WPG,31,4,0,0,0
73,8483546,Marshall Rifai,D,TOR,26,4,0,0,0
73,8479522,Hardy Haman Aktell,D,WSH,26,2,0,0,0
73,8480274,Philip Kemp,D,EDM,25,2,0,0,0
73,8481719,Maxwell Crozier,D,TBL,24,23,0,0,0
73,8481726,Adam Edstrom,C,NYR,24,5,0,0,0
73,8484255,Jason Polin,R,COL,25,6,0,0,0
73,8477993,Justin Kirkland,C,CGY,28,7,0,0,0
73,8483609,Adam Klapka,R,CGY,24,2,0,0,0
73,8483432,Luca Del Bel Belluz,C,CBJ,31,3,0,0,0
73,8483531,Brian Halonen,L,NJD,25,2,0,0,0
73,8476323,Max McCormick,L,SEA,32,5,0,0,0
73,8481534,Raphael Lavoie,C,EDM,24,1,0,0,0
73,8483920,Pierrick Dube,R,WSH,23,1,0,0,0
73,8484326,Patrik Koch,D,UTA,28,2,0,0,0
73,8483401,Marc Johnstone,R,PIT,28,0,0,0,0
73,8484259,Ondrej Pavel,C,COL,31,3,0,0,0
73,8484321,Nikolas Matinpalo,D,OTT,26,0,0,0,0
73,8470794,Joe Pavelski,C,,40,0,0,0,0
73,8479321,Lucas Johansen,D,,27,0,0,0,0
73,8477950,Tony DeAngelo,D,,29,0,0,0,0
73,8471218,Blake Wheeler,R,,38,0,0,0,0
73,8475197,Tyson Barrie,D,,33,0,0,0,0
73,8474157,Max Pacioretty,L,,36,0,0,0,0
73,8475744,Evgeny Kuznetsov,C,,32,0,0,0,0
73,8474037,James van Riemsdyk,L,,35,0,0,0,0
73,8476907,Mackenzie MacEachern,L,,30,0,0,0,0
73,8480216,Jacob Peterson,C,,25,0,0,0,0
73,8474602,Justin Schultz,D,,34,0,0,0,0
73,8482222,Alexander Barabanov,L,,30,0,0,0,0
73,8474031,Kevin Shattenkirk,D,,35,0,0,0,0
73,8477330,Dominik Kubalik,L,,29,0,0,0,0
73,8480884,Calen Addison,D,,24,0,0,0,0
73,8475906,John Klingberg,D,,32,0,0,0,0
73,8480008,Adam Ruzicka,C,,25,0,0,0,0
73,8476884,Derrick Pouliot,D,,30,0,0,0,0
73,8476919,Chris Tierney,C,,30,0,0,0,0
73,8479415,Michael McLeod,C,,26,0,0,0,0
73,8474870,Tyler Johnson,C,,34,0,0,0,0
73,8470604,Jeff Carter,C,,39,0,0,0,0
73,8478104,Sammy Blais,L,,28,0,0,0,0
73,8474884,Mike Hoffman,C,,35,0,0,0,0
73,8481591,Sam Poulin,R,,23,0,0,0,0
73,8471274,Alex Goligoski,D,,39,0,0,0,0
73,8476871,Tanner Pearson,L,,32,0,0,0,0
73,8476393,Nick Cousins,C,,31,0,0,0,0
73,8479977,Kailer Yamamoto,R,,26,0,0,0,0
73,8479346,Dillon Dube,C,,26,0,0,0,0
73,8480184,Gustav Lindstrom,D,,26,0,0,0,0
73,8479376,Victor Mete,D,,26,0,0,0,0
73,8473449,Kyle Okposo,R,,36,0,0,0,0
73,8481058,Jesse Ylonen,R,,25,0,0,0,0
73,8475752,Tyler Pitlick,C,,33,0,0,0,0
73,8481239,Samuel Fagemo,L,,24,0,0,0,0
73,8480821,Filip Zadina,R,,25,0,0,0,0
73,8470966,Mark Giordano,D,,41,0,0,0,0
73,8478495,Denis Gurianov,R,,27,0,0,0,0
73,8477464,Nic Petan,C,,29,0,0,0,0
73,8478099,Kevin Labanc,R,,29,0,0,0,0
73,8482241,Radim Zohorna,L,,28,0,0,0,0
73,8474040,Sam Gagner,C,,35,0,0,0,0
73,8479514,Rem Pitlick,C,,27,0,0,0,0
73,8478430,Oliver Kylington,D,,27,0,0,0,0
73,8479533,Joona Koppanen,L,,26,0,0,0,0
73,8479984,Cal Foote,D,,26,0,0,0,0
73,8477126,Jayson Megna,C,,34,0,0,0,0
73,8475164,Jakob Silfverberg,R,,34,0,0,0,0
73,8474009,Nick Bonino,C,,36,0,0,0,0
73,8479458,Nikita Zaitsev,D,,33,0,0,0,0
73,8477944,Jakub Vrana,L,,28,0,0,0,0
73,8471699,Andrew Cogliano,C,,37,0,0,0,0
73,8478067,Oskar Lindblom,L,,28,0,0,0,0
73,8471686,Marc Staal,D,,37,0,0,0,0
73,8470610,Zach Parise,L,,40,0,0,0,0
73,8478904,Steven Lorentz,C,,28,0,0,0,0
73,8473473,Milan Lucic,L,,36,0,0,0,0
73,8480031,Maxime Comtois,L,,25,0,0,0,0
73,8478512,Austin Czarnik,C,,32,0,0,0,0
73,8473504,Cal Clutterbuck,R,,37,0,0,0,0
73,8477454,Adam Erne,L,,29,0,0,0,0
73,8479383,Boris Katchouk,L,,26,0,0,0,0
73,8475825,Jani Hakanpää,D,,32,0,0,0,0
73,8477846,Ryan Carpenter,C,,33,0,0,0,0
73,8477930,Pierre-Edouard Bellemare,L,,39,0,0,0,0
73,8478400,Colin White,C,,27,0,0,0,0
73,8480226,Marián Studenic,R,,26,0,0,0,0
73,8480853,Liam Foudy,C,,24,0,0,0,0
73,8475797,Jarred Tinordi,D,,32,0,0,0,0
73,8479423,Alex Nylander,L,,26,0,0,0,0
73,8474618,Marco Scandella,D,,34,0,0,0,0
73,8478028,Fredrik Olofsson,L,,28,0,0,0,0
73,8474709,Matt Martin,L,,35,0,0,0,0
73,8481070,Hugh McGing,L,,26,0,0,0,0
73,8479546,Oskar Steen,C,,26,0,0,0,0
73,8474145,Robert Bortuzzo,D,,35,0,0,0,0
73,8476915,Jujhar Khaira,L,,30,0,0,0,0
73,8475278,Byron Froese,C,,33,0,0,0,0
73,8481812,Nikolai Knyzhov,D,,27,0,0,0,0
73,8478408,Travis Dermott,D,,28,0,0,0,0
73,8481077,John Leonard,L,,26,0,0,0,0
73,8479547,Matthew Phillips,R,,26,0,0,0,0
73,8480836,Jonathan Gruden,C,,24,0,0,0,0
73,8481690,Tyler Angle,C,,24,0,0,0,0
73,8475766,Austin Watson,L,,32,0,0,0,0
73,8481016,Ruslan Iskhakov,C,,24,0,0,0,0
73,8478078,Rourke Chartier,C,,28,0,0,0,0
73,8480776,Sheldon Rempal,R,,29,0,0,0,0
73,8478956,Samuel Laberge,L,NJD,27,0,0,0,0
73,8483045,Cameron Butler,R,CBJ,31,0,0,0,0
73,8484314,Jiri Smejkal,L,,28,0,0,0,0
74,8477492,Nathan MacKinnon,C,COL,29,82,45,100,145
74,8478402,Connor McDavid,C,EDM,27,79,44,94,138
74,8476453,Nikita Kucherov,R,TBL,31,82,49,87,136
74,8478550,Artemi Panarin,L,NYR,33,76,40,82,122
74,8479318,Auston Matthews,C,TOR,27,79,68,52,120
74,8477956,David Pastrnak,R,BOS,28,80,51,69,120
74,8478483,Mitch Marner,R,TOR,27,80,37,83,120
74,8477934,Leon Draisaitl,C,EDM,29,79,52,62,114
74,8477942,Kevin Fiala,L,LAK,28,80,45,69,114
74,8479314,Matthew Tkachuk,L,FLA,27,80,40,72,112
74,8481559,Jack Hughes,C,NJD,23,73,42,65,107
74,8476887,Filip Forsberg,L,NSH,30,75,46,55,101
74,8478864,Kirill Kaprizov,L,MIN,27,76,42,56,98
74,8476468,J.T. Miller,C,VAN,31,77,32,66,98
74,8478010,Brayden Point,C,TBL,28,81,46,50,96
74,8478420,Mikko Rantanen,R,COL,28,80,37,59,96
74,8476459,Mika Zibanejad,C,NYR,31,76,34,62,96
74,8477404,Jake Guentzel,C,TBL,30,82,38,57,95
74,8477493,Aleksander Barkov,C,FLA,29,77,26,69,95
74,8480012,Elias Pettersson,C,VAN,26,76,40,53,93
74,8480069,Cale Makar,D,COL,26,73,21,70,91
74,8480801,Brady Tkachuk,L,OTT,25,79,46,44,90
74,8479343,Clayton Keller,R,UTA,26,77,38,51,89
74,8477939,William Nylander,R,TOR,28,79,37,51,88
74,8477949,Alex Tuch,R,BUF,28,70,31,57,88
74,8473419,Brad Marchand,L,BOS,36,80,26,62,88
74,8479337,Alex DeBrincat,R,DET,27,79,36,51,87
74,8474600,Roman Josi,D,NSH,34,69,27,60,87
74,8477409,Carter Verhaeghe,C,FLA,29,77,44,42,86
74,8476389,Vincent Trocheck,C,NYR,31,77,38,48,86
74,8475166,John Tavares,C,TOR,34,78,31,55,86
74,8479323,Adam Fox,D,NYR,26,74,16,70,86
74,8471675,Sidney Crosby,C,PIT,37,73,38,47,85
74,8476454,Ryan Nugent-Hopkins,C,EDM,31,77,18,66,84
74,8477933,Sam Reinhart,C,FLA,29,78,40,43,83
74,8471215,Evgeni Malkin,C,PIT,38,78,38,45,83
74,8480023,Robert Thomas,C,STL,25,75,24,59,83
74,8480830,Andrei Svechnikov,R,CAR,24,73,32,50,82
74,8480002,Nico Hischier,C,NJD,25,76,31,50,81
74,8471685,Anze Kopitar,C,LAK,37,79,30,51,81
74,8475167,Victor Hedman,D,TBL,34,78,17,63,80
74,8479420,Tage Thompson,C,BUF,27,76,38,41,79
74,8475172,Nazem Kadri,C,CGY,34,80,28,51,79
74,8477935,Sam Bennett,C,FLA,28,79,36,42,78
74,8478439,Travis Konecny,R,PHI,27,76,29,48,77
74,8475913,Mark Stone,R,VGK,32,75,25,52,77
74,8478445,Mathew Barzal,C,NYI,27,81,18,59,77
74,8478398,Kyle Connor,L,WPG,28,67,40,36,76
74,8478403,Jack Eichel,C,VGK,28,81,35,41,76
74,8475168,Matt Duchene,C,DAL,33,82,30,46,76
74,8482116,Tim Stützle,C,OTT,22,79,26,50,76
74,8477946,Dylan Larkin,C,DET,28,79,41,34,75
74,8481557,Matt Boldy,L,MIN,23,74,37,37,74
74,8475786,Zach Hyman,L,EDM,32,76,41,32,73
74,8476460,Mark Scheifele,C,WPG,31,76,31,42,73
74,8482093,Seth Jarvis,C,CAR,22,73,31,42,73
74,8479675,Trevor Moore,L,LAK,29,80,29,44,73
74,8477416,Oliver Bjorkstrand,R,SEA,29,71,26,47,73
74,8475692,Mats Zuccarello,R,MIN,37,75,16,57,73
74,8480036,Miro Heiskanen,D,DAL,25,77,12,61,73
74,8477500,Bo Horvat,C,NYI,29,77,46,26,72
74,8475810,Bryan Rust,R,PIT,32,72,35,37,72
74,8476539,Jonathan Marchessault,R,NSH,34,70,33,39,72
74,8479407,Jesper Bratt,L,NJD,26,74,26,46,72
74,8471214,Alex Ovechkin,L,WSH,39,75,38,33,71
74,8477960,Adrian Kempe,R,LAK,28,81,27,43,70
74,8480027,Jason Robertson,L,DAL,25,80,23,47,70
74,8478414,Timo Meier,R,NJD,28,77,32,37,69
74,8477501,Valeri Nichushkin,R,COL,29,82,31,38,69
74,8480208,Drake Batherson,R,OTT,26,79,31,38,69
74,8477951,Nick Schmaltz,C,UTA,28,77,25,44,69
74,8476346,Johnny Gaudreau,L,CBJ,31,73,21,47,68
74,8482740,Wyatt Johnston,C,DAL,21,80,37,30,67
74,8477402,Pavel Buchnevich,L,STL,29,73,28,39,67
74,8474679,Gustav Nyquist,C,NSH,35,70,21,46,67
74,8478460,Zach Werenski,D,CBJ,27,79,17,50,67
74,8475184,Chris Kreider,L,NYR,33,76,35,31,66
74,8480015,Owen Tippett,R,PHI,25,75,34,32,66
74,8482078,Lucas Raymond,L,DET,22,80,27,39,66
74,8478401,Pavel Zacha,C,BOS,27,76,25,41,66
74,8473994,Jamie Benn,L,DAL,35,82,22,44,66
74,8474564,Steven Stamkos,C,NSH,34,73,35,30,65
74,8478427,Sebastian Aho,C,CAR,27,73,27,38,65
74,8479999,Casey Mittelstadt,C,COL,26,82,19,46,65
74,8480800,Quinn Hughes,D,VAN,25,73,12,53,65
74,8478449,Roope Hintz,C,DAL,28,82,37,27,64
74,8479542,Brandon Hagel,L,TBL,26,82,35,29,64
74,8477955,Jared McCann,L,SEA,28,77,28,36,64
74,8478493,Joel Eriksson Ek,C,MIN,27,70,26,38,64
74,8475754,Brock Nelson,C,NYI,33,80,25,39,64
74,8474141,Patrick Kane,R,DET,36,82,21,43,64
74,8482124,Quinton Byfield,R,LAK,22,79,21,43,64
74,8480014,Gabriel Vilardi,C,WPG,25,69,41,22,63
74,8475158,Ryan O'Reilly,C,NSH,33,75,23,40,63
74,8474578,Erik Karlsson,D,PIT,34,82,18,45,63
74,8482109,Alexis Lafrenière,L,NYR,23,76,35,27,62
74,8476399,Blake Coleman,C,CGY,33,77,33,29,62
74,8478444,Brock Boeser,R,VAN,27,76,25,37,62
74,8477940,Nikolaj Ehlers,L,WPG,28,71,23,39,62
74,8473512,Claude Giroux,R,OTT,36,78,20,42,62
74,8478440,Dylan Strome,C,WSH,27,72,19,43,62
74,8475191,Reilly Smith,R,NYR,33,77,17,45,62
74,8477504,Josh Morrissey,D,WPG,29,76,11,51,62
74,8480839,Rasmus Dahlin,D,BUF,24,67,9,53,62
74,8480865,Noah Dobson,D,NYI,24,81,6,56,62
74,8478975,Mason Marchment,L,DAL,29,80,26,35,61
74,8477494,Jonathan Drouin,L,COL,29,81,23,38,61
74,8476875,Mike Matheson,D,MTL,30,75,17,44,61
74,8475169,Evander Kane,L,EDM,33,72,32,28,60
74,8482745,Mason McTavish,C,ANA,21,66,28,32,60
74,8481533,Trevor Zegras,C,ANA,23,69,23,37,60
74,8476881,Tomas Hertl,C,VGK,31,76,22,38,60
74,8478438,Tommy Novak,C,NSH,27,71,20,40,60
74,8476456,Jonathan Huberdeau,C,CGY,31,77,14,46,60
74,8479325,Charlie McAvoy,D,BOS,27,76,11,48,59
74,8481068,Yegor Sharangovich,C,CGY,26,78,29,29,58
74,8474102,David Perron,L,OTT,36,79,20,38,58
74,8478856,Conor Garland,R,VAN,28,74,20,38,58
74,8477496,Elias Lindholm,C,BOS,30,79,29,28,57
74,8482159,Tyson Foerster,R,PHI,22,72,29,28,57
74,8475745,Charlie Coyle,C,BOS,32,78,29,28,57
74,8482699,Dylan Guenther,R,UTA,21,77,28,29,57
74,8481528,Dylan Cozens,C,BUF,23,74,26,31,57
74,8474150,Mikael Backlund,C,CGY,35,78,24,33,57
74,8475784,Jeff Skinner,C,EDM,32,76,24,33,57
74,8484144,Connor Bedard,C,CHI,19,67,20,37,57
74,8476906,Shayne Gostisbehere,D,CAR,31,72,11,46,57
74,8478047,Michael Bunting,L,PIT,29,71,24,32,56
74,8483431,Logan Cooley,C,UTA,20,74,24,32,56
74,8476479,Phillip Danault,C,LAK,31,79,20,36,56
74,8474590,John Carlson,D,WSH,34,71,18,38,56
74,8475794,Tyler Seguin,C,DAL,32,82,18,38,56
74,8475798,Mikael Granlund,C,SJS,32,75,8,48,56
74,8477476,Artturi Lehkonen,L,COL,29,78,24,31,55
74,8478873,Troy Terry,R,ANA,27,68,22,33,55
74,8477456,J.T. Compher,L,DET,29,79,29,25,54
74,8481560,Arthur Kaliyev,R,LAK,23,78,28,26,54
74,8476905,Chandler Stephenson,C,SEA,30,74,13,41,54
74,8478407,Vince Dunn,D,SEA,28,73,13,41,54
74,8476853,Morgan Rielly,D,TOR,30,69,8,46,54
74,8478366,Frank Vatrano,R,ANA,30,72,21,32,53
74,8482113,Anton Lundell,C,FLA,23,78,18,35,53
74,8481711,Matias Maccelli,L,UTA,24,76,17,36,53
74,8480803,Evan Bouchard,D,EDM,25,71,7,46,53
74,8475151,Kyle Palmieri,C,NYI,33,78,29,23,52
74,8482702,Logan Stankoven,C,DAL,21,81,28,24,52
74,8480039,Martin Necas,C,CAR,25,67,24,28,52
74,8479385,Jordan Kyrou,C,STL,26,69,22,30,52
74,8478038,Devon Toews,D,COL,30,68,15,37,52
74,8482684,Luke Hughes,D,NJD,21,76,9,43,52
74,8471724,Kris Letang,D,PIT,37,82,7,45,52
74,8478474,Lawson Crouse,L,UTA,27,79,27,24,51
74,8479400,Pierre-Luc Dubois,L,WSH,26,75,24,27,51
74,8474641,Adam Henrique,C,EDM,34,72,24,27,51
74,8475170,Brayden Schenn,C,STL,33,74,22,29,51
74,8476958,Jaccob Slavin,D,CAR,30,75,12,39,51
74,8476792,Torey Krug,D,STL,33,72,11,40,51
74,8477451,Ryan Hartman,R,MIN,30,66,25,25,50
74,8478462,Nicolas Roy,C,VGK,27,78,24,26,50
74,8481540,Cole Caufield,R,MTL,23,76,22,28,50
74,8478519,Anthony Cirelli,C,TBL,27,80,21,29,50
74,8479365,Trent Frederic,C,BOS,26,78,21,29,50
74,8478466,Daniel Sprong,R,VAN,27,69,16,34,50
74,8478469,Thomas Chabot,D,OTT,27,75,10,40,50
74,8482149,Cole Perfetti,C,WPG,22,66,28,21,49
74,8478498,Jake DeBrusk,L,VAN,28,72,26,23,49
74,8482110,Dawson Mercer,C,NJD,23,67,24,25,49
74,8481596,Shane Pinto,C,OTT,24,80,21,28,49
74,8473986,Alex Killorn,L,ANA,35,72,20,29,49
74,8478042,Viktor Arvidsson,L,EDM,31,70,19,30,49
74,8482720,Matthew Knies,L,TOR,22,77,19,30,49
74,8480797,Joel Farabee,L,PHI,24,75,18,31,49
74,8481618,Alex Newhook,C,MTL,23,75,16,33,49
74,8475765,Vladimir Tarasenko,R,DET,33,79,15,34,49
74,8480018,Nick Suzuki,C,MTL,25,79,15,34,49
74,8477346,MacKenzie Weegar,D,CGY,30,74,14,35,49
74,8477447,Shea Theodore,D,VGK,29,62,9,40,49
74,8470613,Brent Burns,D,CAR,39,73,7,42,49
74,8476432,Boone Jenner,C,CBJ,31,70,22,26,48
74,8474586,Jordan Eberle,R,SEA,34,75,21,27,48
74,8475768,Jaden Schwartz,C,SEA,32,69,19,29,48
74,8482665,Matty Beniers,C,SEA,22,77,16,32,48
74,8478397,Rasmus Andersson,D,CGY,28,74,6,42,48
74,8483515,Juraj Slafkovsky,L,MTL,20,73,22,25,47
74,8475753,Justin Faulk,D,STL,32,71,10,37,47
74,8474565,Alex Pietrangelo,D,VGK,34,64,10,37,47
74,8480434,Sean Durzi,D,UTA,26,64,8,39,47
74,8477407,Anthony Duclair,L,NYI,29,77,23,23,46
74,8477998,Warren Foegele,L,LAK,28,79,19,27,46
74,8477497,Sean Monahan,C,CBJ,30,73,14,32,46
74,8482175,JJ Peterka,R,BUF,22,66,22,23,45
74,8482097,Jack Quinn,R,BUF,23,66,20,25,45
74,8477986,Brandon Montour,D,SEA,30,74,16,29,45
74,8474563,Drew Doughty,D,LAK,35,67,8,37,45
74,8479410,Mikhail Sergachev,D,UTA,26,74,6,39,45
74,8476448,William Karlsson,C,VGK,31,77,21,23,44
74,8484166,Adam Fantilli,C,CBJ,20,69,21,23,44
74,8479525,Ross Colton,C,COL,28,81,18,26,44
74,8477503,Max Domi,C,TOR,29,77,12,32,44
74,8479987,Morgan Geekie,C,BOS,26,74,12,32,44
74,8476462,Dougie Hamilton,D,NJD,31,70,10,34,44
74,8478109,Victor Olofsson,L,VGK,29,75,25,18,43
74,8478472,Mathieu Joseph,R,STL,27,77,18,25,43
74,8475726,Tyler Toffoli,C,SJS,32,68,17,26,43
74,8481542,Moritz Seider,D,DET,23,77,10,33,43
74,8476438,Brandon Saad,L,STL,32,74,30,12,42
74,8479992,Michael Rasmussen,C,DET,25,81,21,21,42
74,8477964,Ivan Barbashev,C,VGK,29,75,20,22,42
74,8470621,Corey Perry,R,EDM,39,74,18,24,42
74,8474716,Jared Spurgeon,D,MIN,35,79,16,26,42
74,8481186,Logan O'Connor,R,COL,28,80,23,18,41
74,8476981,Josh Anderson,R,MTL,30,71,22,19,41
74,8477479,Tyler Bertuzzi,L,CHI,29,64,21,20,41
74,8482475,Yegor Chinakhov,R,CBJ,23,65,20,21,41
74,8478057,Dakota Joshua,C,VAN,28,64,18,23,41
74,8480064,Josh Norris,C,OTT,25,75,17,24,41
74,8483505,Matthew Poitras,C,BOS,20,76,16,25,41
74,8481524,Bowen Byram,D,BUF,23,69,11,30,41
74,8476869,Brady Skjei,D,NSH,30,71,9,32,41
74,8483490,Pavel Mintyukov,D,ANA,21,75,8,33,41
74,8475764,Cam Fowler,D,ANA,33,75,4,37,41
74,8474715,Cameron Atkinson,R,TBL,35,79,21,19,40
74,8479339,Patrik Laine,L,CBJ,26,58,16,24,40
74,8477495,Seth Jones,D,CHI,30,72,14,26,40
74,8480817,K'Andre Miller,D,NYR,24,71,9,31,40
74,8480145,Neal Pionk,D,WPG,29,75,6,34,40
74,8476880,Tom Wilson,R,WSH,30,72,20,19,39
74,8482146,Luke Evangelista,R,NSH,22,72,20,19,39
74,8476826,Yanni Gourde,C,SEA,33,75,18,21,39
74,8481604,Pavel Dorofeyev,L,VGK,24,66,17,22,39
74,8475760,Nick Bjugstad,C,UTA,32,67,17,22,39
74,8476292,Ondrej Palat,L,NJD,33,71,16,23,39
74,8480789,Oliver Wahlstrom,R,NYI,24,67,15,24,39
74,8476882,Teuvo Teravainen,C,CHI,30,66,11,28,39
74,8478055,Gustav Forsling,D,FLA,28,71,9,30,39
74,8477498,Darnell Nurse,D,EDM,29,76,8,31,39
74,8479425,Filip Hronek,D,VAN,27,77,7,32,39
74,8476923,Damon Severson,D,CBJ,30,77,7,32,39
74,8476483,Rickard Rakell,R,PIT,31,69,21,17,38
74,8475793,Ryan Johansen,C,PHI,32,74,17,21,38
74,8480028,Morgan Frost,C,PHI,25,72,15,23,38
74,8478233,Andrew Mangiapane,L,WSH,28,75,14,24,38
74,8482105,Jake Sanderson,D,OTT,22,76,14,24,38
74,8480185,Eetu Luostarinen,C,FLA,26,71,13,25,38
74,8477932,Aaron Ekblad,D,FLA,28,75,12,26,38
74,8482122,Brock Faber,D,MIN,22,78,10,28,38
74,8478396,Noah Hanifin,D,VGK,27,62,9,29,38
74,8476474,Stefan Noesen,R,NJD,31,73,21,16,37
74,8475714,Calle Jarnkrok,C,TOR,33,69,17,20,37
74,8476458,Ryan Strome,C,ANA,31,68,15,22,37
74,8484145,Zach Benson,L,BUF,19,67,14,23,37
74,8479345,Jakob Chychrun,D,WSH,26,66,14,23,37
74,8482712,Oskar Olausson,R,COL,22,79,8,29,37
74,8477969,Marcus Pettersson,D,PIT,28,78,5,32,37
74,8475799,Nino Niederreiter,R,WPG,32,65,20,16,36
74,8479996,Cody Glass,C,NSH,25,58,16,20,36
74,8480813,Joe Veleno,C,DET,24,74,14,22,36
74,8477426,Nicholas Paul,L,TBL,29,81,14,22,36
74,8481703,Valtteri Puustinen,R,PIT,25,61,9,27,36
74,8481535,Nils Hoglander,L,VAN,24,66,23,12,35
74,8475314,Anders Lee,L,NYI,34,78,19,16,35
74,8477952,Robby Fabbri,C,ANA,28,61,19,16,35
74,8477511,Anthony Mantha,R,CGY,30,74,18,17,35
74,8480078,Filip Chytil,C,NYR,25,71,15,20,35
74,8477444,Andre Burakovsky,L,SEA,29,70,14,21,35
74,8473563,Nicklas Backstrom,C,WSH,37,61,12,23,35
74,8483808,Andrei Kuzmenko,L,CGY,28,79,20,14,34
74,8479390,Taylor Raddysh,R,WSH,26,69,16,18,34
74,8476960,Andreas Athanasiou,C,CHI,30,55,15,19,34
74,8480871,Adam Boqvist,D,FLA,24,65,15,19,34
74,8477021,Alex Kerfoot,C,UTA,30,74,14,20,34
74,8482660,Kent Johnson,C,CBJ,22,67,14,20,34
74,8476461,Sean Couturier,C,PHI,32,70,12,22,34
74,8476392,Adam Lowry,C,WPG,31,63,11,23,34
74,8480798,Philipp Kurashev,C,CHI,25,63,8,26,34
74,8475171,Oliver Ekman-Larsson,D,TOR,33,67,5,29,34
74,8481582,Nicholas Robertson,L,TOR,23,70,26,7,33
74,8480829,Jesperi Kotkaniemi,C,CAR,24,67,18,15,33
74,8480459,Pius Suter,C,VAN,28,71,18,15,33
74,8479661,Tanner Jeannot,L,LAK,27,79,14,19,33
74,8482092,Ridly Greig,C,OTT,22,76,13,20,33
74,8475220,Marcus Foligno,L,MIN,33,66,13,20,33
74,8480220,Noah Cates,L,PHI,25,72,12,21,33
74,8475218,Mattias Ekholm,D,EDM,34,73,10,23,33
74,8476885,Jacob Trouba,D,NYR,30,72,7,26,33
74,8482671,Owen Power,D,BUF,22,68,7,26,33
74,8481606,Jordan Spence,D,LAK,23,66,4,29,33
74,8480009,Eeli Tolvanen,R,SEA,25,69,20,12,32
74,8477987,Ryan Donato,C,CHI,28,61,16,16,32
74,8475855,Jesper Fast,R,CAR,33,63,14,18,32
74,8475287,Erik Haula,L,NJD,33,62,12,20,32
74,8474149,Evgenii Dadonov,R,DAL,35,81,11,21,32
74,8476469,Joel Armia,R,MTL,31,70,11,21,32
74,8478046,Danton Heinen,L,VAN,29,70,10,22,32
74,8475200,Dmitry Orlov,D,CAR,33,77,9,23,32
74,8481178,Egor Zamula,D,PHI,24,66,4,28,32
74,8481554,Kaapo Kakko,R,NYR,23,72,16,15,31
74,8480188,Fabian Zetterlund,L,SJS,25,63,14,17,31
74,8475763,Kevin Hayes,R,PIT,32,65,13,18,31
74,8475149,Marcus Johansson,L,MIN,34,67,11,20,31
74,8476872,Scott Laughton,C,PHI,30,72,10,21,31
74,8484153,Leo Carlsson,C,ANA,20,75,8,23,31
74,8481581,Thomas Harley,D,DAL,23,79,7,24,31
74,8478542,Evan Rodrigues,C,FLA,31,71,6,25,31
74,8480021,Jack Studnicka,C,LAK,25,63,18,12,30
74,8475848,Brendan Gallagher,R,MTL,32,69,16,14,30
74,8477979,Nicolas Aube-Kubel,R,BUF,28,56,16,14,30
74,8473533,Jordan Staal,C,CAR,36,69,13,17,30
74,8476918,Jimmy Vesey,L,NYR,31,71,13,17,30
74,8476480,Vladislav Namestnikov,C,WPG,32,64,13,17,30
74,8477429,Andrew Copp,C,DET,30,79,12,18,30
74,8476925,Colton Sissons,C,NSH,31,64,8,22,30
74,8476854,Hampus Lindholm,D,BOS,30,72,6,24,30
74,8476463,Jonas Brodin,D,MIN,31,75,3,27,30
74,8480849,Barrett Hayton,C,UTA,24,69,17,12,29
74,8476921,Jordan Martinook,L,CAR,32,62,17,12,29
74,8481624,Ilya Mikheyev,R,CHI,30,61,15,14,29
74,8482089,Jake Neighbours,L,STL,22,63,15,14,29
74,8471698,T.J. Oshie,R,WSH,38,61,14,15,29
74,8475722,Jason Zucker,L,BUF,32,56,13,16,29
74,8473422,Nick Foligno,L,CHI,37,58,13,16,29
74,8476927,Teddy Blueger,C,VAN,30,69,12,17,29
74,8477989,Christian Dvorak,C,MTL,28,66,12,17,29
74,8474189,Lars Eller,C,PIT,35,66,12,17,29
74,8474053,Logan Couture,C,SJS,35,65,11,18,29
74,8480003,Jesper Boqvist,C,FLA,26,68,7,22,29
74,8477948,Travis Sanheim,D,PHI,28,71,3,26,29
74,8474151,Ryan McDonagh,D,TBL,35,80,2,27,29
74,8480873,Rasmus Sandin,D,WSH,24,67,1,28,29
74,8478020,Michael Amadio,R,OTT,28,71,16,12,28
74,8482667,William Eklund,L,SJS,22,60,15,13,28
74,8478463,Anthony Beauvillier,L,PIT,27,61,15,13,28
74,8477478,William Carrier,L,CAR,30,60,15,13,28
74,8480068,Ryan Poehling,C,PHI,25,71,14,14,28
74,8477353,Tyler Motte,C,DET,29,75,12,16,28
74,8478458,John (Jack) Roslovic,C,CAR,27,59,10,18,28
74,8477953,Kasperi Kapanen,R,STL,28,63,10,18,28
74,8478507,John Marino,D,UTA,27,69,9,19,28
74,8479398,Samuel Girard,D,COL,26,67,7,21,28
74,8481546,Cam York,D,PHI,23,67,5,23,28
74,8481577,Philip Tomasino,C,NSH,23,62,11,16,27
74,8481553,Bobby Brink,R,PHI,23,65,11,16,27
74,8480336,Sean Walker,D,CAR,30,72,8,19,27
74,8476917,Adam Pelech,D,NYI,30,77,1,26,27
74,8480893,Kirill Marchenko,R,CBJ,24,62,18,8,26
74,8482259,Bobby McMann,C,TOR,28,61,15,11,26
74,8482117,Lukas Reichel,L,CHI,22,65,15,11,26
74,8484203,Bradly Nadeau,L,CAR,19,55,12,14,26
74,8483445,Cutter Gauthier,L,ANA,20,67,11,15,26
74,8482705,Cole Sillinger,C,CBJ,21,61,10,16,26
74,8477919,Frederick Gaudreau,C,MIN,31,64,7,19,26
74,8482655,Janis Moser,D,TBL,24,70,7,19,26
74,8482624,Daniil Miromanov,D,CGY,27,68,6,20,26
74,8476979,Erik Gustafsson,D,DET,32,69,4,22,26
74,8480043,Timothy Liljegren,D,TOR,25,62,3,23,26
74,8480049,Dylan Samberg,D,WPG,25,65,2,24,26
74,8477845,Trevor van Riemsdyk,D,WSH,33,59,2,24,26
74,8480448,Parker Kelly,L,COL,25,77,19,6,25
74,8479941,Justin Danforth,R,CBJ,31,65,15,10,25
74,8480802,Ryan McLeod,C,BUF,25,66,12,13,25
74,8481704,Juuso Parssinen,C,NSH,23,58,12,13,25
74,8480205,Emil Bemstrom,C,PIT,25,60,12,13,25
74,8476419,Jean-Gabriel Pageau,C,NYI,32,75,10,15,25
74,8480806,Isac Lundestrom,C,ANA,25,63,10,15,25
74,8476878,Zemgus Girgensons,C,TBL,30,80,10,15,25
74,8481522,Peyton Krebs,C,BUF,23,63,9,16,25
74,8477450,Jason Dickinson,C,CHI,29,58,9,16,25
74,8477018,Ben Hutton,D,VGK,31,45,8,17,25
74,8477839,Conor Sheary,L,TBL,32,79,7,18,25
74,8479293,Brandon Tanev,L,SEA,33,65,12,12,24
74,8478413,Jordan Greenway,L,BUF,27,66,11,13,24
74,8480855,Jack McBain,C,UTA,24,63,11,13,24
74,8478115,Pierre Engvall,L,NYI,28,79,10,14,24
74,8482055,Drew O'Connor,L,PIT,26,61,10,14,24
74,8479368,Max Jones,L,BOS,26,69,9,15,24
74,8481521,Ronnie Attard,D,PHI,25,59,9,15,24
74,8481441,Joe Snively,C,DET,28,58,7,17,24
74,8479351,Sam Steel,C,DAL,26,77,6,18,24
74,8479402,Jake Bean,D,CGY,26,71,6,18,24
74,8475231,Casey Cizikas,C,NYI,33,73,5,19,24
74,8476331,Dylan DeMelo,D,WPG,31,70,5,19,24
74,8482067,Connor Mackey,D,NYR,28,64,5,19,24
74,8482087,Kaiden Guhle,D,MTL,22,64,5,19,24
74,8476422,Mike Reilly,D,NYI,31,76,4,20,24
74,8482073,Braden Schneider,D,NYR,23,68,4,20,24
74,8477506,Ryan Pulock,D,NYI,30,75,3,21,24
74,8477446,Michael McCarron,R,NSH,29,57,14,9,23
74,8478432,Christian Fischer,R,DET,27,74,12,11,23
74,8477425,Miles Wood,L,COL,29,76,12,11,23
74,8480835,Jack Drury,C,CAR,24,66,12,11,23
74,8475193,Tomas Tatar,L,NJD,34,67,11,12,23
74,8481093,Rafael Harvey-Pinard,L,MTL,25,56,11,12,23
74,8476873,Mark Jankowski,C,NSH,30,58,10,13,23
74,8478434,Keegan Kolesar,R,VGK,27,68,10,13,23
74,8476897,Oskar Sundqvist,C,STL,30,72,9,14,23
74,8483457,Lane Hutson,D,MTL,20,66,9,14,23
74,8476467,Jamie Oleksiak,D,SEA,32,68,7,16,23
74,8481527,Kaedan Korczak,D,VGK,23,46,5,18,23
74,8481014,Alexander Romanov,D,NYI,24,78,4,19,23
74,8480246,Nick Perbix,D,TBL,26,76,4,19,23
74,8480878,Nils Lundkvist,D,DAL,24,67,3,20,23
74,8476891,Matthew Grzelcyk,D,PIT,30,75,3,20,23
74,8480891,Michael Kesselring,D,UTA,24,59,1,22,23
74,8481601,Simon Holmstrom,R,NYI,23,71,16,6,22
74,8482125,Alexander Holtz,R,VGK,22,68,16,6,22
74,8478569,Noel Acciari,C,PIT,33,55,14,8,22
74,8479393,Noah Gregor,L,OTT,26,75,11,11,22
74,8482133,Thomas Bordeleau,C,SJS,22,58,11,11,22
74,8482749,Joshua Roy,R,MTL,21,68,11,11,22
74,8477392,Hudson Fasching,R,NYI,29,66,11,11,22
74,8478508,Yakov Trenin,C,MIN,27,56,11,11,22
74,8480113,Alex Iafallo,L,WPG,31,61,10,12,22
74,8482074,Connor Zary,C,CGY,23,62,9,13,22
74,8479591,Michael Eyssimont,C,TBL,28,81,9,13,22
74,8480025,MacKenzie Entwistle,R,FLA,25,61,9,13,22
74,8483468,Jiri Kulich,C,BUF,20,61,8,14,22
74,8476902,Esa Lindell,D,DAL,30,78,6,16,22
74,8478911,Matt Roy,D,WSH,29,67,5,17,22
74,8477220,Nate Schmidt,D,FLA,33,69,5,17,22
74,8477508,Curtis Lazar,C,NJD,29,68,5,17,22
74,8476892,Colton Parayko,D,STL,31,64,3,19,22
74,8477947,Sonny Milano,L,WSH,28,54,3,19,22
74,8481059,Scott Perunovich,D,STL,26,62,2,20,22
74,8482079,Marco Rossi,C,MIN,23,54,14,7,21
74,8480980,Connor Dewar,C,TOR,25,65,12,9,21
74,8479353,Brett Howden,C,VGK,26,69,12,9,21
74,8480995,Pontus Holmberg,R,TOR,25,58,12,9,21
74,8476278,Colin Blackwell,C,DAL,31,80,11,10,21
74,8482679,Matt Coronato,R,CGY,22,66,11,10,21
74,8480748,Kiefer Sherwood,L,VAN,29,54,11,10,21
74,8477505,Alexander Wennberg,C,SJS,30,72,10,11,21
74,8477488,Brett Pesce,D,NJD,30,71,8,13,21
74,8481656,Aliaksei Protas,C,WSH,23,62,7,14,21
74,8473453,Trevor Lewis,C,LAK,37,72,7,14,21
74,8474574,Tyler Myers,D,VAN,34,74,7,14,21
74,8475791,Taylor Hall,L,CHI,33,61,6,15,21
74,8482101,Danil Gushchin,L,SJS,22,60,6,15,21
74,8476457,Adam Larsson,D,SEA,32,63,6,15,21
74,8478882,Vladislav Gavrikov,D,LAK,29,71,5,16,21
74,8478970,Jalen Chatfield,D,CAR,28,73,5,16,21
74,8483565,Nick Blankenburg,D,NSH,26,63,5,16,21
74,8475179,Dmitry Kulikov,D,FLA,34,61,4,17,21
74,8478891,Mason Appleton,C,WPG,28,69,3,18,21
74,8476879,Cody Ceci,D,EDM,31,67,3,18,21
74,8482245,Artem Zub,D,OTT,29,66,3,18,21
74,8480058,Pierre-Olivier Joseph,D,STL,25,65,3,18,21
74,8476931,Jake McCabe,D,TOR,31,62,2,19,21
74,8477435,Ryan Graves,D,PIT,29,75,2,19,21
74,8481019,David Gustafsson,C,WPG,24,45,2,19,21
74,8481580,Connor McMichael,C,WSH,23,62,12,8,20
74,8479328,Julien Gauthier,R,NYI,27,58,11,9,20
74,8477903,Garnet Hathaway,R,PHI,33,63,9,11,20
74,8480074,Alexandre Texier,C,STL,25,54,9,11,20
74,8478043,Sam Lafferty,C,BUF,29,55,8,12,20
74,8477931,Tomas Nosek,L,FLA,32,60,8,12,20
74,8481523,Kirby Dach,C,MTL,23,60,7,13,20
74,8478133,Jake Evans,C,MTL,28,68,7,13,20
74,8478416,Erik Cernak,D,TBL,27,78,4,16,20
74,8478468,Jeremy Lauzon,D,NSH,27,61,4,16,20
74,8480073,Erik Brannstrom,D,COL,25,62,3,17,20
74,8475233,David Savard,D,MTL,34,60,2,18,20
74,8481568,Alex Vlasic,D,CHI,23,58,2,18,20
74,8481032,Paul Cotter,C,NJD,25,65,12,7,19
74,8483491,Ivan Miroshnichenko,L,WSH,20,60,11,8,19
74,8481641,Joel Kiviranta,L,COL,28,73,11,8,19
74,8476374,Sean Kuraly,C,CBJ,31,62,11,8,19
74,8479066,Ryan Lomberg,L,CGY,30,66,9,10,19
74,8479543,Michael Pezzetta,L,MTL,26,50,9,10,19
74,8481481,Blake Lizotte,C,PIT,27,64,8,11,19
74,8478211,Dryden Hunt,L,CGY,29,54,8,11,19
74,8479414,Nathan Bastian,R,NJD,27,64,7,12,19
74,8479315,Joey Anderson,R,CHI,26,47,6,13,19
74,8475188,Brayden McNabb,D,VGK,33,52,4,15,19
74,8478500,Ivan Provorov,D,CBJ,27,76,3,16,19
74,8478840,Will Borgen,D,SEA,28,67,3,16,19
74,8482155,Alex Laferriere,R,LAK,23,70,13,5,18
74,8479336,Carl Grundstrom,R,SJS,27,46,11,7,18
74,8477015,Connor Brown,R,EDM,30,65,9,9,18
74,8477507,Nikita Zadorov,D,BOS,29,68,8,10,18
74,8478013,Jake Walman,D,SJS,28,67,7,11,18
74,8482062,Cole Smith,L,NSH,29,51,7,11,18
74,8479619,Michael Carcone,L,UTA,28,68,7,11,18
74,8482809,Jackson Blake,R,CAR,21,52,5,13,18
74,8478443,Brandon Carlo,D,BOS,28,59,5,13,18
74,8481537,Nikita Okhotiuk,D,CGY,24,53,5,13,18
74,8482744,James Malatesta,L,CBJ,21,44,5,13,18
74,8470600,Ryan Suter,D,STL,39,54,4,14,18
74,8479639,Dylan Coghlan,D,WPG,26,58,2,16,18
74,8479983,Mario Ferraro,D,SJS,26,66,2,16,18
74,8479369,Andrew Peeke,D,BOS,26,68,2,16,18
74,8479976,Juuso Valimaki,D,UTA,26,67,1,17,18
74,8475181,Nick Leddy,D,STL,33,68,0,18,18
74,8476889,Radek Faksa,C,STL,30,68,11,6,17
74,8479316,Luke Kunin,C,SJS,27,55,10,7,17
74,8477406,Mattias Janmark,C,EDM,32,63,9,8,17
74,8475225,Craig Smith,C,CHI,35,48,9,8,17
74,8479370,Tyson Jost,C,CAR,26,49,9,8,17
74,8480281,Alexey Toropchenko,R,STL,25,53,8,9,17
74,8483482,Tristan Luneau,D,ANA,20,60,7,10,17
74,8482964,Arber Xhekaj,D,MTL,23,56,7,10,17
74,8476856,Mathew Dumba,D,DAL,30,70,4,13,17
74,8475790,Erik Gudbranson,D,CBJ,32,77,4,13,17
74,8478851,Alexandre Carrier,D,NSH,28,61,3,14,17
74,8481567,Henry Thrun,D,SJS,23,55,2,15,17
74,8480035,Henri Jokiharju,D,BUF,25,66,1,16,17
74,8478831,Kevin Stenlund,C,UTA,28,49,10,6,16
74,8480762,Eric Robinson,L,CAR,29,52,8,8,16
74,8484149,Gavin Brindley,C,CBJ,20,53,8,8,16
74,8476329,Travis Boyd,C,MIN,31,52,7,9,16
74,8481517,Brett Leason,R,ANA,25,61,6,10,16
74,8482148,Hendrix Lapierre,C,WSH,22,56,5,11,16
74,8481028,Martin Pospisil,C,CGY,25,52,5,11,16
74,8475324,Nick Jensen,D,OTT,34,68,4,12,16
74,8480144,David Kampf,C,TOR,29,73,4,12,16
74,8483495,Simon Nemec,D,NJD,20,53,4,12,16
74,8482176,Wyatt Kaiser,D,CHI,22,51,3,13,16
74,8473507,Jeff Petry,D,DET,37,74,2,14,16
74,8479998,Mikey Anderson,D,LAK,25,61,1,15,16
74,8475279,Ben Chiarot,D,DET,33,71,1,15,16
74,8471677,Jack Johnson,D,CBJ,37,63,1,15,16
74,8479344,Jesse Puljujarvi,R,PIT,26,51,0,16,16
74,8483524,Shane Wright,C,SEA,20,57,11,4,15
74,8482737,Zack Bolduc,C,STL,21,51,9,6,15
74,8481013,Jonatan Berggren,R,DET,24,65,8,7,15
74,8479520,Brandon Duhaime,R,WSH,27,47,7,8,15
74,8482803,Olen Zellweger,D,ANA,21,62,5,10,15
74,8474567,Zach Bogosian,D,MIN,34,58,5,10,15
74,8475455,Brenden Dillon,D,NJD,34,61,4,11,15
74,8477573,Nathan Walker,L,STL,30,51,4,11,15
74,8482730,Brandt Clarke,D,LAK,21,53,4,11,15
74,8478859,Niko Mikkola,D,FLA,28,55,4,11,15
74,8480355,Mark Kastelic,C,BOS,25,56,3,12,15
74,8476988,Matt Benning,D,SJS,30,64,3,12,15
74,8478136,Jake Middleton,D,MIN,28,74,2,13,15
74,8480001,Urho Vaakanainen,D,ANA,25,65,2,13,15
74,8480860,Kevin Bahl,D,CGY,24,43,1,14,15
74,8480727,Zach Whitecloud,D,VGK,28,56,0,15,15
74,8476934,Brock McGinn,L,ANA,30,49,10,4,14
74,8474034,Patrick Maroon,L,CHI,36,52,9,5,14
74,8481477,Nico Sturm,C,SJS,29,54,8,6,14
74,8481708,Zac Jones,D,NYR,24,42,8,6,14
74,8483499,Liam Ohgren,L,MIN,20,54,8,6,14
74,8482634,Alex Steeves,C,TOR,25,46,8,6,14
74,8478585,Derek Ryan,C,EDM,38,64,7,7,14
74,8479981,Jonah Gadjovich,L,FLA,26,41,7,7,14
74,8476429,Scott Mayfield,D,NYI,32,75,6,8,14
74,8479968,Vinni Lettieri,C,BOS,29,40,6,8,14
74,8476312,Josh Manson,D,COL,33,53,5,9,14
74,8482807,Ethan Del Mastro,D,CHI,21,44,5,9,14
74,8476994,Vinnie Hinostroza,C,NSH,30,49,4,10,14
74,8482142,Jamie Drysdale,D,PHI,22,60,4,10,14
74,8477887,Patrick Brown,C,BOS,32,52,4,10,14
74,8480007,Jonas Rondbjerg,R,VGK,25,33,4,10,14
74,8478451,Ethan Bear,D,WSH,27,50,3,11,14
74,8478017,Mark Friedman,D,VAN,29,37,3,11,14
74,8479026,Philippe Myers,D,TOR,27,48,2,12,14
74,8480796,Martin Fehervary,D,WSH,25,53,2,12,14
74,8479982,Conor Timmins,D,TOR,26,62,2,12,14
74,8479371,Dante Fabbro,D,NSH,26,53,1,13,14
74,8483493,Frank Nazar,C,CHI,20,49,1,13,14
74,8482659,Josh Doan,R,UTA,22,53,8,5,13
74,8479439,Jacob MacDonald,D,COL,31,49,8,5,13
74,8475842,Sam Carrick,C,NYR,32,62,7,6,13
74,8480070,Ian Mitchell,D,BOS,25,53,7,6,13
74,8475343,Nic Dowd,C,WSH,34,57,6,7,13
74,8482157,Will Cuylle,L,NYR,22,61,6,7,13
74,8479671,Mathieu Olivier,R,CBJ,27,46,6,7,13
74,8479249,Andrew Poturalski,C,SJS,30,46,5,8,13
74,8480157,Calle Rosen,D,COL,30,51,5,8,13
74,8482451,Mikael Pyyhtia,L,CBJ,23,43,4,9,13
74,8482192,Isaak Phillips,D,CHI,23,59,4,9,13
74,8479324,Ryan Lindgren,D,NYR,26,61,3,10,13
74,8479718,Alex Barré-Boulet,C,MTL,27,52,3,10,13
74,8476967,Brett Kulak,D,EDM,30,58,3,10,13
74,8475690,Chris Tanev,D,TOR,35,69,3,10,13
74,8477499,Rasmus Ristolainen,D,PHI,30,48,3,10,13
74,8481599,Victor Soderstrom,D,UTA,23,48,3,10,13
74,8478399,Jonas Siegenthaler,D,NJD,27,57,2,11,13
74,8477335,Kyle Burroughs,D,LAK,29,39,2,11,13
74,8475462,Radko Gudas,D,ANA,34,68,0,13,13
74,8481751,Lukas Rousek,R,BUF,25,44,8,4,12
74,8482666,Scott Morrow,D,CAR,22,50,6,6,12
74,8480289,Morgan Barron,C,WPG,26,57,5,7,12
74,8479291,Kevin Rooney,C,CGY,31,50,5,7,12
74,8479994,Jaret Anderson-Dolan,C,WPG,25,43,5,7,12
74,8476867,Brendan Gaunce,C,MIN,30,38,5,7,12
74,8476525,Colin Miller,D,WPG,32,64,4,8,12
74,8476624,Barclay Goodrow,C,SJS,31,51,4,8,12
74,8476442,Matt Nieto,L,PIT,32,54,4,8,12
74,8483466,Kevin Korchinski,D,CHI,20,52,4,8,12
74,8476441,Joel Edmundson,D,LAK,31,43,4,8,12
74,8474673,TJ Brodie,D,CHI,34,57,2,10,12
74,8481617,Vasily Podkolzin,R,VAN,23,47,2,10,12
74,8477938,Haydn Fleury,D,WPG,28,47,2,10,12
74,8474166,Alec Martinez,D,CHI,37,50,2,10,12
74,8479980,Nicolas Hague,D,VGK,26,56,1,11,12
74,8474612,Travis Hamonic,D,OTT,34,49,1,11,12
74,8479372,Joshua Mahura,D,SEA,26,52,1,11,12
74,8479944,Zach Aston-Reese,C,VGK,30,44,8,3,11
74,8476822,Luke Glendening,C,TBL,35,79,7,4,11
74,8481716,Dmitri Voronkov,L,CBJ,24,40,7,4,11
74,8481754,Nikita Nesterenko,C,ANA,23,43,7,4,11
74,8482111,Justin Barron,D,MTL,23,55,5,6,11
74,8478421,A.J. Greer,L,FLA,28,58,4,7,11
74,8474013,Ian Cole,D,UTA,35,50,4,7,11
74,8480848,Ty Dellandrea,C,SJS,24,43,4,7,11
74,8478178,Darren Raddysh,D,TBL,28,66,3,8,11
74,8482859,Zack Ostapchuk,C,OTT,21,52,3,8,11
74,8479536,Axel Jonsson-Fjallby,L,WPG,26,40,3,8,11
74,8471709,Marc-Edouard Vlasic,D,SJS,37,66,3,8,11
74,8476372,Nick Seeler,D,PHI,31,43,3,8,11
74,8475718,Justin Holl,D,DET,32,61,2,9,11
74,8480887,Jordan Harris,D,MTL,24,58,2,9,11
74,8480192,Johnathan Kovacevic,D,NJD,27,47,2,9,11
74,8480222,Sebastian Aho,D,PIT,28,73,1,10,11
74,8477369,Carson Soucy,D,VAN,30,66,1,10,11
74,8476874,Olli Maatta,D,DET,30,56,1,10,11
74,8480011,Klim Kostin,C,SJS,25,43,7,3,10
74,8481789,Tye Kartye,L,SEA,23,37,7,3,10
74,8475208,Brian Dumoulin,D,ANA,33,56,6,4,10
74,8477380,Jonny Brodzinski,C,NYR,31,54,6,4,10
74,8481532,Alex Turcotte,C,LAK,23,37,5,5,10
74,8479359,Beck Malenstyn,L,BUF,26,45,5,5,10
74,8482762,Simon Edvinsson,D,DET,21,55,4,6,10
74,8480870,Bo Groulx,C,NYR,24,27,4,6,10
74,8477365,Connor Clifton,D,BUF,29,50,3,7,10
74,8477962,Brendan Lemieux,L,CAR,28,44,3,7,10
74,8483012,Logan Morrison,C,SEA,22,47,3,7,10
74,8481167,Brayden Pachal,D,CGY,25,52,2,8,10
74,8480172,Jan Rutta,D,SJS,34,66,1,9,10
74,8478021,William Lagesson,D,DET,28,29,0,10,10
74,8481556,John Beecher,C,BOS,23,37,8,1,9
74,8482077,Dylan Holloway,L,EDM,23,50,7,2,9
74,8481679,Maxence Guenette,D,OTT,23,40,7,2,9
74,8477070,Liam O'Brien,C,UTA,30,54,5,4,9
74,8478424,Jansen Harkins,C,ANA,27,44,5,4,9
74,8480252,Cole Guttman,C,CHI,25,38,4,5,9
74,8482166,Shakir Mukhamadullin,D,SJS,22,53,4,5,9
74,8482733,Logan Mailloux,D,MTL,31,37,4,5,9
74,8475958,Michael Sgarbossa,C,WSH,32,23,4,5,9
74,8483460,David Jiricek,D,CBJ,21,66,3,6,9
74,8482784,Zach Dean,C,STL,21,40,2,7,9
74,8481701,Santeri Hatakka,D,NJD,23,47,2,7,9
74,8478452,Caleb Jones,D,LAK,27,62,1,8,9
74,8479986,Kole Lind,R,DAL,26,57,1,8,9
74,8477034,Jaycob Megna,D,FLA,32,43,1,8,9
74,8480196,Jacob Bryson,D,BUF,27,39,1,8,9
74,8478454,Noah Juulsen,D,VAN,27,36,1,8,9
74,8480880,Jakub Lauko,C,MIN,24,35,0,9,9
74,8476858,Phillip Di Giuseppe,L,VAN,31,37,6,2,8
74,8481543,Nikita Alexandrov,C,STL,24,27,5,3,8
74,8471817,Ryan Reaves,R,TOR,37,62,4,4,8
74,8480950,Ilya Lyubushkin,D,DAL,30,57,3,5,8
74,8475177,Calvin de Haan,D,COL,33,43,3,5,8
74,8480844,Grigori Denisenko,L,VGK,24,30,3,5,8
74,8482751,Ryan Winterton,C,SEA,21,31,3,5,8
74,8482747,Brennan Othmann,L,NYR,21,38,3,5,8
74,8474090,Brendan Smith,D,DAL,35,57,3,5,8
74,8483630,Pavol Regenda,L,ANA,25,29,3,5,8
74,8482070,Mitchell Chaffee,R,TBL,26,50,2,6,8
74,8479348,Kale Clague,D,BUF,26,47,2,6,8
74,8483619,Filip Roos,D,OTT,25,35,2,6,8
74,8480879,Jacob Bernard-Docker,D,OTT,24,40,2,6,8
74,8480292,Carson Meyer,R,ANA,27,34,2,6,8
74,8480807,Mattias Samuelsson,D,BUF,24,53,1,7,8
74,8474568,Luke Schenn,D,NSH,35,57,1,7,8
74,8482095,Tyler Kleven,D,OTT,22,40,1,7,8
74,8477851,Jordan Oesterle,D,BOS,32,41,1,7,8
74,8477384,Joshua Brown,D,EDM,30,46,1,7,8
74,8481147,Reese Johnson,C,MIN,26,41,0,8,8
74,8479638,Justin Brazeau,R,BOS,26,29,5,2,7
74,8480441,Trey Fix-Wolansky,R,CBJ,25,28,5,2,7
74,8480845,Rasmus Kupari,C,WPG,24,43,4,3,7
74,8481592,Jakob Pelletier,L,CGY,23,43,4,3,7
74,8481518,Nolan Foote,L,NJD,24,35,3,4,7
74,8477482,Zachary Sanford,L,CHI,30,39,3,4,7
74,8484911,Collin Graf,R,SJS,22,41,3,4,7
74,8483549,Lucas Condotta,L,MTL,27,36,2,5,7
74,8479442,Troy Stecher,D,EDM,30,58,1,6,7
74,8481600,Tobias Bjornfot,D,FLA,23,41,1,6,7
74,8481550,Adam Beckman,L,NJD,23,36,1,6,7
74,8475750,Jon Merrill,D,MIN,32,66,1,6,7
74,8476952,Dominic Toninato,C,WPG,30,32,1,6,7
74,8479367,William Lockwood,R,FLA,26,26,5,1,6
74,8480990,Declan Chisholm,D,MIN,24,36,3,3,6
74,8481161,Jake Christiansen,D,CBJ,25,54,2,4,6
74,8481598,Philip Broberg,D,EDM,23,43,2,4,6
74,8482929,Emil Lilleberg,D,TBL,23,20,2,4,6
74,8482153,Brendan Brisson,C,VGK,23,34,1,5,6
74,8476473,Connor Murphy,D,CHI,31,32,1,5,6
74,8478874,Adam Gaudette,R,OTT,28,31,1,5,6
74,8484254,Akito Hirose,D,VAN,25,42,1,5,6
74,8482861,Vincent Iorio,D,WSH,22,29,1,5,6
74,8473446,Erik Johnson,D,PHI,36,43,0,6,6
74,8481122,Simon Benoit,D,TOR,26,43,0,6,6
74,8479576,Vincent Desharnais,D,VAN,28,30,0,6,6
74,8482147,Jean-Luc Foudy,C,COL,22,20,5,0,5
74,8475235,Nicolas Deslauriers,L,PHI,33,45,4,1,5
74,8484258,Sam Malinski,D,COL,26,26,4,1,5
74,8480267,Sammy Walker,C,MIN,25,23,3,2,5
74,8483570,Ben Meyers,C,SEA,26,25,3,2,5
74,8483397,Marc McLaughlin,C,BOS,25,31,2,3,5
74,8482713,Mackie Samoskevich,R,FLA,22,38,2,3,5
74,8482141,Lukas Cormier,D,VGK,22,24,2,3,5
74,8479379,Givani Smith,R,SJS,26,31,2,3,5
74,8479972,Mason Shaw,C,WPG,26,40,1,4,5
74,8483512,Matthew Savoie,C,EDM,20,25,1,4,5
74,8475762,Derek Forbort,D,VAN,32,37,1,4,5
74,8482177,Marat Khusnutdinov,C,MIN,22,24,1,4,5
74,8482765,Isak Rosen,R,BUF,21,32,1,4,5
74,8484287,Cole McWard,D,VAN,23,20,4,0,4
74,8478409,Anthony Richard,C,PHI,28,31,3,1,4
74,8481043,Cole Koepke,L,BOS,26,19,3,1,4
74,8479991,Jake Leschyshyn,C,NYR,25,19,3,1,4
74,8482144,Jack Thompson,D,SJS,22,30,3,1,4
74,8480890,Jan Jenik,C,OTT,24,34,2,2,4
74,8478011,Louie Belpedio,D,PHI,28,22,2,2,4
74,8482496,Nils Aman,C,VAN,24,42,1,3,4
74,8479378,Logan Stanley,D,WPG,26,37,1,3,4
74,8482511,Mason Lohrei,D,BOS,23,26,1,3,4
74,8481056,Spencer Stastney,D,NSH,24,35,1,3,4
74,8478450,Parker Wotherspoon,D,BOS,27,29,1,3,4
74,8482088,Justin Sourdif,R,FLA,22,21,1,3,4
74,8482145,Mavrik Bourque,C,DAL,22,40,0,4,4
74,8480834,Ty Emberson,D,SJS,24,25,0,4,4
74,8476913,Devin Shore,C,MIN,30,37,0,4,4
74,8478051,Max Willman,C,NJD,29,18,0,4,4
74,8478146,Matthew Highmore,C,OTT,28,32,0,4,4
74,8482652,Walker Duehr,R,CGY,27,34,2,1,3
74,8477473,Justin Bailey,R,SJS,29,23,2,1,3
74,8477073,Kurtis MacDermid,L,NJD,30,27,2,1,3
74,8479419,Brett Murray,L,BUF,26,21,2,1,3
74,8480468,James Hamblin,L,EDM,25,21,2,1,3
74,8483395,Arshdeep Bains,L,VAN,23,11,2,1,3
74,8479320,Maxime Lajoie,D,SEA,27,23,1,2,3
74,8477401,John Hayden,C,SEA,29,40,1,2,3
74,8479772,Zack MacEwen,R,OTT,28,49,1,2,3
74,8482858,Ryker Evans,D,SEA,23,31,1,2,3
74,8481605,Jackson LaCombe,D,ANA,23,31,1,2,3
74,8477527,Ross Johnston,L,ANA,30,30,1,2,3
74,8480851,Akil Thomas,C,LAK,24,17,1,2,3
74,8482172,Landon Slaggert,L,CHI,22,18,1,2,3
74,8483407,Brandon Scanlin,D,NYR,25,7,1,2,3
74,8482162,Roby Jarventie,L,EDM,22,20,1,2,3
74,8481024,Linus Karlsson,C,VAN,25,9,1,2,3
74,8484304,Uvis Balinskis,D,FLA,28,12,1,2,3
74,8482470,Ilya Solovyov,D,CGY,24,19,0,3,3
74,8479985,Cale Fleury,D,SEA,26,30,0,3,3
74,8481593,Jayden Struble,D,MTL,23,21,0,3,3
74,8477810,Joel Hanley,D,CGY,33,21,2,0,2
74,8480032,Shane Bowers,C,NJD,25,14,2,0,2
74,8482118,Sam Colangelo,R,ANA,23,13,2,0,2
74,8477971,Andreas Englund,D,LAK,28,27,1,1,2
74,8482516,Matthew Kessel,D,STL,24,17,1,1,2
74,8482476,Emil Heineman,L,MTL,23,10,1,1,2
74,8481726,Adam Edstrom,C,NYR,24,9,1,1,2
74,8480245,Olle Lycksell,R,PHI,25,28,0,2,2
74,8481422,Jake Lucchini,C,NSH,29,21,0,2,2
74,8477244,Chad Ruhwedel,D,NYR,34,33,0,2,2
74,8478502,Dennis Gilbert,D,BUF,28,20,0,2,2
74,8482102,Vasily Ponomarev,C,PIT,22,22,0,2,2
74,8482250,Callahan Burke,C,VGK,27,23,0,2,2
74,8477149,Scott Sabourin,R,SJS,32,23,0,2,2
74,8482094,Daemon Hunt,D,MIN,22,13,0,2,2
74,8480084,Nick DeSimone,D,NJD,30,10,0,2,2
74,8482165,Yan Kuznetsov,D,CGY,22,17,1,0,1
74,8481541,Samuel Bolduc,D,NYI,24,25,1,0,1
74,8477467,Gustav Olofsson,D,SEA,30,11,1,0,1
74,8480075,Cameron Crotty,D,MIN,25,13,1,0,1
74,8477320,Anton Blidh,L,NYR,29,19,1,0,1
74,8483597,Milos Kelemen,L,UTA,25,10,1,0,1
74,8482201,Gage Goncalves,C,TBL,23,25,1,0,1
74,8484325,Waltteri Merela,C,TBL,26,23,1,0,1
74,8480823,Alexander Alexeyev,D,WSH,25,16,1,0,1
74,8475780,Chris Wagner,R,COL,33,7,1,0,1
74,8479421,Jacob Moverare,D,LAK,26,3,1,0,1
74,8475755,Alexander Petrovic,D,DAL,32,7,1,0,1
74,8483432,Luca Del Bel Belluz,C,CBJ,31,5,1,0,1
74,8483920,Pierrick Dube,R,WSH,23,3,1,0,1
74,8481609,Vladislav Kolyachonok,D,UTA,23,28,0,1,1
74,8483763,Maksymilian Szuber,D,UTA,22,32,0,1,1
74,8481743,Marc Del Gaizo,D,NSH,25,22,0,1,1
74,8477541,Dakota Mermis,D,TOR,30,4,0,1,1
74,8475413,Justin Dowling,C,NJD,34,14,0,1,1
74,8481206,John Ludvig,D,PIT,24,11,0,1,1
74,8481237,Kyle MacLean,C,NYI,25,24,0,1,1
74,8478881,Brett Seney,L,CHI,28,14,0,1,1
74,8479587,Rhett Gardner,C,PHI,28,23,0,1,1
74,8475795,Dylan McIlrath,D,WSH,32,10,0,1,1
74,8483471,Brad Lambert,C,WPG,31,9,0,1,1
74,8481006,Tyler Tucker,D,STL,24,19,0,1,1
74,8481699,Aku Raty,R,UTA,23,17,0,1,1
74,8481655,Cole Schwindt,R,CGY,23,4,0,1,1
74,8481585,Egor Afanasyev,L,SJS,23,7,0,1,1
74,8482061,Brandon Biro,L,SEA,26,10,0,1,1
74,8479522,Hardy Haman Aktell,D,WSH,26,4,0,1,1
74,8481719,Maxwell Crozier,D,TBL,24,12,0,1,1
74,8477462,Robert Hagg,D,VGK,29,25,0,0,0
74,8480874,Adam Ginning,D,PHI,24,10,0,0,0
74,8481030,Jack St. Ivany,D,PIT,25,10,0,0,0
74,8478477,Mitchell Stephens,C,SEA,27,15,0,0,0
74,8481564,Ryan Johnson,D,BUF,23,13,0,0,0
74,8483567,Georgii Merkulov,C,BOS,24,10,0,0,0
74,8481065,Angus Crookshank,L,OTT,25,15,0,0,0
74,8474062,Riley Nash,C,NYR,35,16,0,0,0
74,8483489,Fraser Minten,C,TOR,31,10,0,0,0
74,8478147,Bokondji Imama,L,PIT,28,1,0,0,0
74,8478446,Glenn Gawdin,C,LAK,27,11,0,0,0
74,8479362,Riley Tufte,L,BOS,26,20,0,0,0
74,8481462,Mason Morelli,L,VGK,28,12,0,0,0
74,8480306,Grant Hutton,D,NYI,29,5,0,0,0
74,8478854,Ryan Shea,D,PIT,27,6,0,0,0
74,8482460,Matt Rempe,C,NYR,22,7,0,0,0
74,8482197,Adam Raska,R,MIN,23,7,0,0,0
74,8481806,Louis Crevier,D,CHI,23,17,0,0,0
74,8483398,Declan Carlile,D,TBL,31,12,0,0,0
74,8481578,Graeme Clarke,R,MIN,23,5,0,0,0
74,8479330,Brandon Gignac,C,MTL,27,5,0,0,0
74,8482126,Emil Andrae,D,PHI,31,3,0,0,0
74,8482787,Nikita Chibrikov,R,WPG,31,4,0,0,0
74,8483546,Marshall Rifai,D,TOR,26,6,0,0,0
74,8480274,Philip Kemp,D,EDM,25,0,0,0,0
74,8484255,Jason Polin,R,COL,25,3,0,0,0
74,8477993,Justin Kirkland,C,CGY,28,6,0,0,0
74,8483609,Adam Klapka,R,CGY,24,4,0,0,0
74,8483531,Brian Halonen,L,NJD,25,2,0,0,0
74,8476323,Max McCormick,L,SEA,32,0,0,0,0
74,8481534,Raphael Lavoie,C,EDM,24,1,0,0,0
74,8484326,Patrik Koch,D,UTA,28,1,0,0,0
74,8483401,Marc Johnstone,R,PIT,28,0,0,0,0
74,8484259,Ondrej Pavel,C,COL,31,3,0,0,0
74,8484321,Nikolas Matinpalo,D,OTT,26,3,0,0,0
74,8470794,Joe Pavelski,C,,40,0,0,0,0
74,8479321,Lucas Johansen,D,,27,0,0,0,0
74,8477950,Tony DeAngelo,D,,29,0,0,0,0
74,8471218,Blake Wheeler,R,,38,0,0,0,0
74,8475197,Tyson Barrie,D,,33,0,0,0,0
74,8474157,Max Pacioretty,L,,36,0,0,0,0
74,8475744,Evgeny Kuznetsov,C,,32,0,0,0,0
74,8474037,James van Riemsdyk,L,,35,0,0,0,0
74,8476907,Mackenzie MacEachern,L,,30,0,0,0,0
74,8480216,Jacob Peterson,C,,25,0,0,0,0
74,8474602,Justin Schultz,D,,34,0,0,0,0
74,8482222,Alexander Barabanov,L,,30,0,0,0,0
74,8474031,Kevin Shattenkirk,D,,35,0,0,0,0
74,8477330,Dominik Kubalik,L,,29,0,0,0,0
74,8480884,Calen Addison,D,,24,0,0,0,0
74,8475906,John Klingberg,D,,32,0,0,0,0
74,8480008,Adam Ruzicka,C,,25,0,0,0,0
74,8476884,Derrick Pouliot,D,,30,0,0,0,0
74,8476919,Chris Tierney,C,,30,0,0,0,0
74,8479415,Michael McLeod,C,,26,0,0,0,0
74,8474870,Tyler Johnson,C,,34,0,0,0,0
74,8470604,Jeff Carter,C,,39,0,0,0,0
74,8478104,Sammy Blais,L,,28,0,0,0,0
74,8474884,Mike Hoffman,C,,35,0,0,0,0
74,8481591,Sam Poulin,R,,23,0,0,0,0
74,8471274,Alex Goligoski,D,,39,0,0,0,0
74,8476871,Tanner Pearson,L,,32,0,0,0,0
74,8476393,Nick Cousins,C,,31,0,0,0,0
74,8479977,Kailer Yamamoto,R,,26,0,0,0,0
74,8479346,Dillon Dube,C,,26,0,0,0,0
74,8480184,Gustav Lindstrom,D,,26,0,0,0,0
74,8479376,Victor Mete,D,,26,0,0,0,0
74,8473449,Kyle Okposo,R,,36,0,0,0,0
74,8481058,Jesse Ylonen,R,,25,0,0,0,0
74,8475752,Tyler Pitlick,C,,33,0,0,0,0
74,8481239,Samuel Fagemo,L,,24,0,0,0,0
74,8480821,Filip Zadina,R,,25,0,0,0,0
74,8470966,Mark Giordano,D,,41,0,0,0,0
74,8478495,Denis Gurianov,R,,27,0,0,0,0
74,8477464,Nic Petan,C,,29,0,0,0,0
74,8478099,Kevin Labanc,R,,29,0,0,0,0
74,8482241,Radim Zohorna,L,,28,0,0,0,0
74,8474040,Sam Gagner,C,,35,0,0,0,0
74,8479514,Rem Pitlick,C,,27,0,0,0,0
74,8478430,Oliver Kylington,D,,27,0,0,0,0
74,8479533,Joona Koppanen,L,,26,0,0,0,0
74,8479984,Cal Foote,D,,26,0,0,0,0
74,8477126,Jayson Megna,C,,34,0,0,0,0
74,8475164,Jakob Silfverberg,R,,34,0,0,0,0
74,8474009,Nick Bonino,C,,36,0,0,0,0
74,8479458,Nikita Zaitsev,D,,33,0,0,0,0
74,8477944,Jakub Vrana,L,,28,0,0,0,0
74,8471699,Andrew Cogliano,C,,37,0,0,0,0
74,8478067,Oskar Lindblom,L,,28,0,0,0,0
74,8471686,Marc Staal,D,,37,0,0,0,0
74,8470610,Zach Parise,L,,40,0,0,0,0
74,8478904,Steven Lorentz,C,,28,0,0,0,0
74,8473473,Milan Lucic,L,,36,0,0,0,0
74,8480031,Maxime Comtois,L,,25,0,0,0,0
74,8478512,Austin Czarnik,C,,32,0,0,0,0
74,8473504,Cal Clutterbuck,R,,37,0,0,0,0
74,8477454,Adam Erne,L,,29,0,0,0,0
74,8479383,Boris Katchouk,L,,26,0,0,0,0
74,8475825,Jani Hakanpää,D,,32,0,0,0,0
74,8477846,Ryan Carpenter,C,,33,0,0,0,0
74,8477930,Pierre-Edouard Bellemare,L,,39,0,0,0,0
74,8478400,Colin White,C,,27,0,0,0,0
74,8480226,Marián Studenic,R,,26,0,0,0,0
74,8480853,Liam Foudy,C,,24,0,0,0,0
74,8475797,Jarred Tinordi,D,,32,0,0,0,0
74,8479423,Alex Nylander,L,,26,0,0,0,0
74,8474618,Marco Scandella,D,,34,0,0,0,0
74,8478028,Fredrik Olofsson,L,,28,0,0,0,0
74,8474709,Matt Martin,L,,35,0,0,0,0
74,8481070,Hugh McGing,L,,26,0,0,0,0
74,8479546,Oskar Steen,C,,26,0,0,0,0
74,8474145,Robert Bortuzzo,D,,35,0,0,0,0
74,8476915,Jujhar Khaira,L,,30,0,0,0,0
74,8475278,Byron Froese,C,,33,0,0,0,0
74,8481812,Nikolai Knyzhov,D,,27,0,0,0,0
74,8478408,Travis Dermott,D,,28,0,0,0,0
74,8481077,John Leonard,L,,26,0,0,0,0
74,8479547,Matthew Phillips,R,,26,0,0,0,0
74,8480836,Jonathan Gruden,C,,24,0,0,0,0
74,8481690,Tyler Angle,C,,24,0,0,0,0
74,8475766,Austin Watson,L,,32,0,0,0,0
74,8481016,Ruslan Iskhakov,C,,24,0,0,0,0
74,8478078,Rourke Chartier,C,,28,0,0,0,0
74,8480776,Sheldon Rempal,R,,29,0,0,0,0
74,8478956,Samuel Laberge,L,NJD,27,1,0,0,0
74,8483045,Cameron Butler,R,CBJ,31,0,0,0,0
74,8484314,Jiri Smejkal,L,,28,0,0,0,0
75,8478483,Mitch Marner,R,TOR,27,82,29,114,143
75,8477492,Nathan MacKinnon,C,COL,29,82,51,91,142
75,8476453,Nikita Kucherov,R,TBL,31,81,40,91,131
75,8479318,Auston Matthews,C,TOR,27,81,66,63,129
75,8478402,Connor McDavid,C,EDM,27,77,38,85,123
75,8478550,Artemi Panarin,L,NYR,33,78,35,78,113
75,8471675,Sidney Crosby,C,PIT,37,72,39,72,111
75,8479314,Matthew Tkachuk,L,FLA,27,76,28,83,111
75,8477956,David Pastrnak,R,BOS,28,80,51,59,110
75,8477939,William Nylander,R,TOR,28,74,46,62,108
75,8480027,Jason Robertson,L,DAL,25,81,39,67,106
75,8481559,Jack Hughes,C,NJD,23,71,33,72,105
75,8477493,Aleksander Barkov,C,FLA,29,80,33,72,105
75,8477934,Leon Draisaitl,C,EDM,29,76,34,69,103
75,8477404,Jake Guentzel,C,TBL,30,81,37,62,99
75,8478420,Mikko Rantanen,R,COL,28,81,52,45,97
75,8477942,Kevin Fiala,L,LAK,28,80,34,63,97
75,8476456,Jonathan Huberdeau,C,CGY,31,80,25,72,97
75,8476887,Filip Forsberg,L,NSH,30,75,43,52,95
75,8477933,Sam Reinhart,C,FLA,29,77,47,47,94
75,8480012,Elias Pettersson,C,VAN,26,79,39,54,93
75,8480800,Quinn Hughes,D,VAN,25,72,19,74,93
75,8478864,Kirill Kaprizov,L,MIN,27,70,42,50,92
75,8477501,Valeri Nichushkin,R,COL,29,80,38,53,91
75,8478010,Brayden Point,C,TBL,28,82,45,44,89
75,8481557,Matt Boldy,L,MIN,23,75,33,55,88
75,8480036,Miro Heiskanen,D,DAL,25,78,21,67,88
75,8479407,Jesper Bratt,L,NJD,26,82,35,52,87
75,8476389,Vincent Trocheck,C,NYR,31,76,30,57,87
75,8475913,Mark Stone,R,VGK,32,81,28,58,86
75,8475166,John Tavares,C,TOR,34,77,33,51,84
75,8480023,Robert Thomas,C,STL,25,77,19,65,84
75,8479343,Clayton Keller,R,UTA,26,74,36,47,83
75,8478439,Travis Konecny,R,PHI,27,75,32,51,83
75,8478427,Sebastian Aho,C,CAR,27,74,25,57,82
75,8476468,J.T. Miller,C,VAN,31,77,29,52,81
75,8482116,Tim Stützle,C,OTT,22,79,27,54,81
75,8474600,Roman Josi,D,NSH,34,73,24,57,81
75,8478403,Jack Eichel,C,VGK,28,75,31,49,80
75,8475692,Mats Zuccarello,R,MIN,37,76,31,49,80
75,8479323,Adam Fox,D,NYR,26,75,23,57,80
75,8475172,Nazem Kadri,C,CGY,34,80,23,57,80
75,8479542,Brandon Hagel,L,TBL,26,82,32,47,79
75,8473419,Brad Marchand,L,BOS,36,81,31,48,79
75,8477402,Pavel Buchnevich,L,STL,29,71,31,48,79
75,8474564,Steven Stamkos,C,NSH,34,75,31,47,78
75,8479675,Trevor Moore,L,LAK,29,78,40,37,77
75,8480801,Brady Tkachuk,L,OTT,25,79,34,43,77
75,8480002,Nico Hischier,C,NJD,25,77,33,44,77
75,8478449,Roope Hintz,C,DAL,28,82,30,46,76
75,8476454,Ryan Nugent-Hopkins,C,EDM,31,81,27,49,76
75,8480830,Andrei Svechnikov,R,CAR,24,66,34,41,75
75,8479420,Tage Thompson,C,BUF,27,75,42,32,74
75,8477949,Alex Tuch,R,BUF,28,73,25,49,74
75,8478445,Mathew Barzal,C,NYI,27,79,23,51,74
75,8477409,Carter Verhaeghe,C,FLA,29,80,45,28,73
75,8484144,Connor Bedard,C,CHI,19,64,19,54,73
75,8477960,Adrian Kempe,R,LAK,28,81,33,39,72
75,8477500,Bo Horvat,C,NYI,29,79,31,41,72
75,8480018,Nick Suzuki,C,MTL,25,75,32,39,71
75,8473512,Claude Giroux,R,OTT,36,78,26,45,71
75,8482078,Lucas Raymond,L,DET,22,82,36,34,70
75,8479385,Jordan Kyrou,C,STL,26,74,33,36,69
75,8478398,Kyle Connor,L,WPG,28,70,30,39,69
75,8480069,Cale Makar,D,COL,26,71,18,51,69
75,8482740,Wyatt Johnston,C,DAL,21,80,33,35,68
75,8475765,Vladimir Tarasenko,R,DET,33,80,30,38,68
75,8477496,Elias Lindholm,C,BOS,30,79,26,42,68
75,8476460,Mark Scheifele,C,WPG,31,71,37,30,67
75,8480064,Josh Norris,C,OTT,25,79,29,38,67
75,8476881,Tomas Hertl,C,VGK,31,81,28,39,67
75,8471214,Alex Ovechkin,L,WSH,39,74,27,40,67
75,8477951,Nick Schmaltz,C,UTA,28,76,21,46,67
75,8475786,Zach Hyman,L,EDM,32,79,33,33,66
75,8482699,Dylan Guenther,R,UTA,21,76,29,37,66
75,8477416,Oliver Bjorkstrand,R,SEA,29,78,28,38,66
75,8479337,Alex DeBrincat,R,DET,27,81,27,39,66
75,8474578,Erik Karlsson,D,PIT,34,76,19,47,66
75,8482159,Tyson Foerster,R,PHI,22,79,28,37,65
75,8478873,Troy Terry,R,ANA,27,72,27,38,65
75,8477946,Dylan Larkin,C,DET,28,81,26,39,65
75,8476905,Chandler Stephenson,C,SEA,30,73,16,49,65
75,8478414,Timo Meier,R,NJD,28,76,30,34,64
75,8474141,Patrick Kane,R,DET,36,79,29,35,64
75,8476459,Mika Zibanejad,C,NYR,31,80,24,40,64
75,8484166,Adam Fantilli,C,CBJ,20,71,36,27,63
75,8476539,Jonathan Marchessault,R,NSH,34,73,32,31,63
75,8473994,Jamie Benn,L,DAL,35,80,25,38,63
75,8480208,Drake Batherson,R,OTT,26,76,23,40,63
75,8475798,Mikael Granlund,C,SJS,32,68,23,40,63
75,8471685,Anze Kopitar,C,LAK,37,82,22,41,63
75,8476399,Blake Coleman,C,CGY,33,80,36,26,62
75,8482093,Seth Jarvis,C,CAR,22,74,34,28,62
75,8478444,Brock Boeser,R,VAN,27,79,28,34,62
75,8475754,Brock Nelson,C,NYI,33,81,27,35,62
75,8482665,Matty Beniers,C,SEA,22,74,25,37,62
75,8480803,Evan Bouchard,D,EDM,25,75,13,49,62
75,8477935,Sam Bennett,C,FLA,28,78,30,31,61
75,8477497,Sean Monahan,C,CBJ,30,72,28,33,61
75,8475168,Matt Duchene,C,DAL,33,81,27,34,61
75,8478975,Mason Marchment,L,DAL,29,80,25,36,61
75,8477021,Alex Kerfoot,C,UTA,30,77,17,44,61
75,8475167,Victor Hedman,D,TBL,34,77,14,47,61
75,8478401,Pavel Zacha,C,BOS,27,81,26,34,60
75,8480185,Eetu Luostarinen,C,FLA,26,78,25,35,60
75,8476346,Johnny Gaudreau,L,CBJ,31,69,17,42,59
75,8475184,Chris Kreider,L,NYR,33,76,38,20,58
75,8482113,Anton Lundell,C,FLA,23,79,22,36,58
75,8476479,Phillip Danault,C,LAK,31,78,19,39,58
75,8477503,Max Domi,C,TOR,29,77,18,40,58
75,8477932,Aaron Ekblad,D,FLA,28,76,17,41,58
75,8471215,Evgeni Malkin,C,PIT,38,70,16,42,58
75,8477447,Shea Theodore,D,VGK,29,62,16,42,58
75,8477504,Josh Morrissey,D,WPG,29,77,12,46,58
75,8482124,Quinton Byfield,R,LAK,22,80,11,47,58
75,8475726,Tyler Toffoli,C,SJS,32,67,28,29,57
75,8477986,Brandon Montour,D,SEA,30,79,21,36,57
75,8471724,Kris Letang,D,PIT,37,81,16,41,57
75,8480839,Rasmus Dahlin,D,BUF,24,70,12,45,57
75,8480014,Gabriel Vilardi,C,WPG,25,64,30,26,56
75,8480039,Martin Necas,C,CAR,25,70,26,30,56
75,8476448,William Karlsson,C,VGK,31,78,23,33,56
75,8477940,Nikolaj Ehlers,L,WPG,28,70,18,38,56
75,8478440,Dylan Strome,C,WSH,27,71,16,40,56
75,8475169,Evander Kane,L,EDM,33,72,28,27,55
75,8483431,Logan Cooley,C,UTA,20,73,24,31,55
75,8476853,Morgan Rielly,D,TOR,30,71,11,43,54
75,8478460,Zach Werenski,D,CBJ,27,78,10,44,54
75,8481540,Cole Caufield,R,MTL,23,76,31,22,53
75,8477476,Artturi Lehkonen,L,COL,29,81,30,23,53
75,8479999,Casey Mittelstadt,C,COL,26,79,21,32,53
75,8474586,Jordan Eberle,R,SEA,34,69,19,34,53
75,8481528,Dylan Cozens,C,BUF,23,70,18,35,53
75,8476854,Hampus Lindholm,D,BOS,30,75,12,41,53
75,8483515,Juraj Slafkovsky,L,MTL,20,75,32,20,52
75,8481604,Pavel Dorofeyev,L,VGK,24,70,25,27,52
75,8475784,Jeff Skinner,C,EDM,32,76,23,29,52
75,8480798,Philipp Kurashev,C,CHI,25,67,20,32,52
75,8477955,Jared McCann,L,SEA,28,70,26,25,51
75,8474102,David Perron,L,OTT,36,77,23,28,51
75,8475158,Ryan O'Reilly,C,NSH,33,75,22,29,51
75,8478498,Jake DeBrusk,L,VAN,28,71,18,33,51
75,8477444,Andre Burakovsky,L,SEA,29,68,18,33,51
75,8478542,Evan Rodrigues,C,FLA,31,77,18,33,51
75,8481524,Bowen Byram,D,BUF,23,60,17,34,51
75,8474590,John Carlson,D,WSH,34,68,13,38,51
75,8480865,Noah Dobson,D,NYI,24,80,9,42,51
75,8478038,Devon Toews,D,COL,30,69,8,43,51
75,8480015,Owen Tippett,R,PHI,25,75,32,18,50
75,8478519,Anthony Cirelli,C,TBL,27,82,26,24,50
75,8476483,Rickard Rakell,R,PIT,31,71,26,24,50
75,8477407,Anthony Duclair,L,NYI,29,78,24,26,50
75,8475745,Charlie Coyle,C,BOS,32,80,19,31,50
75,8477494,Jonathan Drouin,L,COL,29,81,18,32,50
75,8483808,Andrei Kuzmenko,L,CGY,28,76,18,32,50
75,8478438,Tommy Novak,C,NSH,27,70,14,36,50
75,8481711,Matias Maccelli,L,UTA,24,72,14,36,50
75,8478407,Vince Dunn,D,SEA,28,71,4,46,50
75,8482109,Alexis Lafrenière,L,NYR,23,79,27,22,49
75,8475794,Tyler Seguin,C,DAL,32,81,27,22,49
75,8482092,Ridly Greig,C,OTT,22,77,25,24,49
75,8478047,Michael Bunting,L,PIT,29,75,23,26,49
75,8475170,Brayden Schenn,C,STL,33,76,22,26,48
75,8479987,Morgan Geekie,C,BOS,26,79,20,28,48
75,8481533,Trevor Zegras,C,ANA,23,70,19,29,48
75,8474150,Mikael Backlund,C,CGY,35,75,17,31,48
75,8482684,Luke Hughes,D,NJD,21,75,12,36,48
75,8478397,Rasmus Andersson,D,CGY,28,75,11,37,48
75,8474563,Drew Doughty,D,LAK,35,76,9,39,48
75,8479325,Charlie McAvoy,D,BOS,27,74,6,42,48
75,8477451,Ryan Hartman,R,MIN,30,62,24,23,47
75,8477998,Warren Foegele,L,LAK,28,80,23,24,47
75,8475151,Kyle Palmieri,C,NYI,33,75,18,29,47
75,8476872,Scott Laughton,C,PHI,30,72,16,31,47
75,8474679,Gustav Nyquist,C,NSH,35,67,13,34,47
75,8476792,Torey Krug,D,STL,33,69,11,36,47
75,8475760,Nick Bjugstad,C,UTA,32,72,25,21,46
75,8481068,Yegor Sharangovich,C,CGY,26,76,24,22,46
75,8479400,Pierre-Luc Dubois,L,WSH,26,73,23,23,46
75,8475810,Bryan Rust,R,PIT,32,70,22,24,46
75,8478493,Joel Eriksson Ek,C,MIN,27,75,18,28,46
75,8474053,Logan Couture,C,SJS,35,63,15,31,46
75,8482720,Matthew Knies,L,TOR,22,72,16,29,45
75,8477505,Alexander Wennberg,C,SJS,30,65,16,29,45
75,8478055,Gustav Forsling,D,FLA,28,77,15,30,45
75,8477511,Anthony Mantha,R,CGY,30,75,23,21,44
75,8474149,Evgenii Dadonov,R,DAL,35,81,23,21,44
75,8480797,Joel Farabee,L,PHI,24,71,22,22,44
75,8474641,Adam Henrique,C,EDM,34,77,19,25,44
75,8478462,Nicolas Roy,C,VGK,27,74,18,26,44
75,8475768,Jaden Schwartz,C,SEA,32,72,16,28,44
75,8478469,Thomas Chabot,D,OTT,27,69,12,32,44
75,8479410,Mikhail Sergachev,D,UTA,26,68,9,35,44
75,8476923,Damon Severson,D,CBJ,30,80,6,38,44
75,8477479,Tyler Bertuzzi,L,CHI,29,61,21,22,43
75,8478856,Conor Garland,R,VAN,28,70,20,23,43
75,8476474,Stefan Noesen,R,NJD,31,65,20,23,43
75,8471698,T.J. Oshie,R,WSH,38,65,20,23,43
75,8477456,J.T. Compher,L,DET,29,81,16,27,43
75,8482149,Cole Perfetti,C,WPG,22,68,15,28,43
75,8482097,Jack Quinn,R,BUF,23,64,14,29,43
75,8481703,Valtteri Puustinen,R,PIT,25,65,14,29,43
75,8476869,Brady Skjei,D,NSH,30,74,10,33,43
75,8476875,Mike Matheson,D,MTL,30,71,5,38,43
75,8482110,Dawson Mercer,C,NJD,23,77,24,18,42
75,8478366,Frank Vatrano,R,ANA,30,77,21,21,42
75,8484153,Leo Carlsson,C,ANA,20,74,21,21,42
75,8481560,Arthur Kaliyev,R,LAK,23,78,18,24,42
75,8480188,Fabian Zetterlund,L,SJS,25,65,18,24,42
75,8474565,Alex Pietrangelo,D,VGK,34,55,14,28,42
75,8477429,Andrew Copp,C,DET,30,81,13,29,42
75,8481581,Thomas Harley,D,DAL,23,74,10,32,42
75,8476462,Dougie Hamilton,D,NJD,31,76,9,33,42
75,8482175,JJ Peterka,R,BUF,22,72,24,17,41
75,8477964,Ivan Barbashev,C,VGK,29,75,23,18,41
75,8476432,Boone Jenner,C,CBJ,31,67,20,21,41
75,8478233,Andrew Mangiapane,L,WSH,28,76,19,22,41
75,8478466,Daniel Sprong,R,VAN,27,70,17,24,41
75,8476461,Sean Couturier,C,PHI,32,71,13,28,41
75,8477346,MacKenzie Weegar,D,CGY,30,74,12,29,41
75,8474716,Jared Spurgeon,D,MIN,35,81,11,30,41
75,8475191,Reilly Smith,R,NYR,33,75,6,35,41
75,8482745,Mason McTavish,C,ANA,21,65,18,22,40
75,8478472,Mathieu Joseph,R,STL,27,68,18,22,40
75,8476880,Tom Wilson,R,WSH,30,71,17,23,40
75,8480849,Barrett Hayton,C,UTA,24,62,14,26,40
75,8479591,Michael Eyssimont,C,TBL,28,82,14,26,40
75,8479365,Trent Frederic,C,BOS,26,76,13,27,40
75,8477495,Seth Jones,D,CHI,30,72,8,32,40
75,8475714,Calle Jarnkrok,C,TOR,33,72,21,18,39
75,8476826,Yanni Gourde,C,SEA,33,70,18,21,39
75,8481596,Shane Pinto,C,OTT,24,78,16,23,39
75,8478458,John (Jack) Roslovic,C,CAR,27,68,14,25,39
75,8477426,Nicholas Paul,L,TBL,29,82,21,17,38
75,8475793,Ryan Johansen,C,PHI,32,73,20,18,38
75,8480817,K'Andre Miller,D,NYR,24,74,14,24,38
75,8484145,Zach Benson,L,BUF,19,68,14,24,38
75,8476458,Ryan Strome,C,ANA,31,72,12,26,38
75,8476906,Shayne Gostisbehere,D,CAR,31,77,11,27,38
75,8479425,Filip Hronek,D,VAN,27,73,5,33,38
75,8475314,Anders Lee,L,NYI,34,79,21,16,37
75,8475799,Nino Niederreiter,R,WPG,32,68,20,17,37
75,8482667,William Eklund,L,SJS,22,68,18,19,37
75,8476882,Teuvo Teravainen,C,CHI,30,64,17,20,37
75,8480078,Filip Chytil,C,NYR,25,70,17,20,37
75,8480459,Pius Suter,C,VAN,28,72,16,21,37
75,8476885,Jacob Trouba,D,NYR,30,73,13,24,37
75,8482660,Kent Johnson,C,CBJ,22,71,9,28,37
75,8481523,Kirby Dach,C,MTL,23,62,8,29,37
75,8480893,Kirill Marchenko,R,CBJ,24,61,21,15,36
75,8479339,Patrik Laine,L,CBJ,26,60,20,16,36
75,8479336,Carl Grundstrom,R,SJS,27,63,20,16,36
75,8476438,Brandon Saad,L,STL,32,67,18,18,36
75,8475287,Erik Haula,L,NJD,33,68,17,19,36
75,8480855,Jack McBain,C,UTA,24,72,17,19,36
75,8478042,Viktor Arvidsson,L,EDM,31,77,14,22,36
75,8483505,Matthew Poitras,C,BOS,20,73,11,25,36
75,8481656,Aliaksei Protas,C,WSH,23,64,10,26,36
75,8482105,Jake Sanderson,D,OTT,22,75,9,27,36
75,8482671,Owen Power,D,BUF,22,69,3,33,36
75,8478463,Anthony Beauvillier,L,PIT,27,65,21,14,35
75,8481554,Kaapo Kakko,R,NYR,23,71,18,17,35
75,8479390,Taylor Raddysh,R,WSH,26,65,17,18,35
75,8480028,Morgan Frost,C,PHI,25,68,12,23,35
75,8481546,Cam York,D,PHI,23,73,12,23,35
75,8480220,Noah Cates,L,PHI,25,71,10,25,35
75,8475171,Oliver Ekman-Larsson,D,TOR,33,72,9,26,35
75,8482712,Oskar Olausson,R,COL,22,79,7,28,35
75,8483490,Pavel Mintyukov,D,ANA,21,70,6,29,35
75,8481542,Moritz Seider,D,DET,23,77,3,32,35
75,8476958,Jaccob Slavin,D,CAR,30,73,2,33,35
75,8478115,Pierre Engvall,L,NYI,28,75,20,14,34
75,8480009,Eeli Tolvanen,R,SEA,25,71,18,16,34
75,8482475,Yegor Chinakhov,R,CBJ,23,65,17,17,34
75,8470613,Brent Burns,D,CAR,39,80,8,26,34
75,8479398,Samuel Girard,D,COL,26,68,3,31,34
75,8482705,Cole Sillinger,C,CBJ,21,62,20,13,33
75,8480113,Alex Iafallo,L,WPG,31,66,16,17,33
75,8476927,Teddy Blueger,C,VAN,30,65,15,18,33
75,8473986,Alex Killorn,L,ANA,35,73,14,19,33
75,8480871,Adam Boqvist,D,FLA,24,69,9,24,33
75,8478396,Noah Hanifin,D,VGK,27,61,3,30,33
75,8482146,Luke Evangelista,R,NSH,22,70,16,16,32
75,8482702,Logan Stankoven,C,DAL,21,81,14,18,32
75,8481186,Logan O'Connor,R,COL,28,79,14,18,32
75,8479661,Tanner Jeannot,L,LAK,27,74,12,20,32
75,8475763,Kevin Hayes,R,PIT,32,68,12,20,32
75,8481577,Philip Tomasino,C,NSH,23,59,8,24,32
75,8480434,Sean Durzi,D,UTA,26,66,6,26,32
75,8476419,Jean-Gabriel Pageau,C,NYI,32,80,16,15,31
75,8478057,Dakota Joshua,C,VAN,28,65,15,16,31
75,8482117,Lukas Reichel,L,CHI,22,58,15,16,31
75,8482055,Drew O'Connor,L,PIT,26,68,14,17,31
75,8479996,Cody Glass,C,NSH,25,69,13,18,31
75,8479345,Jakob Chychrun,D,WSH,26,64,10,21,31
75,8480878,Nils Lundkvist,D,DAL,24,74,9,22,31
75,8475764,Cam Fowler,D,ANA,33,74,4,27,31
75,8476292,Ondrej Palat,L,NJD,33,73,4,27,31
75,8478474,Lawson Crouse,L,UTA,27,75,21,9,30
75,8481535,Nils Hoglander,L,VAN,24,65,13,17,30
75,8477839,Conor Sheary,L,TBL,32,79,13,17,30
75,8478434,Keegan Kolesar,R,VGK,27,67,13,17,30
75,8480336,Sean Walker,D,CAR,30,74,11,19,30
75,8476480,Vladislav Namestnikov,C,WPG,32,64,9,21,30
75,8475848,Brendan Gallagher,R,MTL,32,71,8,22,30
75,8480145,Neal Pionk,D,WPG,29,71,6,24,30
75,8477948,Travis Sanheim,D,PHI,28,72,4,26,30
75,8478507,John Marino,D,UTA,27,68,4,26,30
75,8474189,Lars Eller,C,PIT,35,61,16,13,29
75,8480806,Isac Lundestrom,C,ANA,25,55,12,17,29
75,8480068,Ryan Poehling,C,PHI,25,70,11,18,29
75,8475218,Mattias Ekholm,D,EDM,34,69,10,19,29
75,8478891,Mason Appleton,C,WPG,28,68,10,19,29
75,8474715,Cameron Atkinson,R,TBL,35,82,9,20,29
75,8473422,Nick Foligno,L,CHI,37,64,9,20,29
75,8482133,Thomas Bordeleau,C,SJS,22,60,9,20,29
75,8478413,Jordan Greenway,L,BUF,27,66,8,21,29
75,8475753,Justin Faulk,D,STL,32,67,6,23,29
75,8479983,Mario Ferraro,D,SJS,26,67,5,24,29
75,8473507,Jeff Petry,D,DET,37,72,5,24,29
75,8477969,Marcus Pettersson,D,PIT,28,76,4,25,29
75,8474151,Ryan McDonagh,D,TBL,35,77,4,25,29
75,8478500,Ivan Provorov,D,CBJ,27,79,3,26,29
75,8481618,Alex Newhook,C,MTL,23,72,14,14,28
75,8477953,Kasperi Kapanen,R,STL,28,65,12,16,28
75,8481624,Ilya Mikheyev,R,CHI,30,64,11,17,28
75,8475791,Taylor Hall,L,CHI,33,57,8,20,28
75,8478882,Vladislav Gavrikov,D,LAK,29,70,8,20,28
75,8479976,Juuso Valimaki,D,UTA,26,67,6,22,28
75,8482079,Marco Rossi,C,MIN,23,58,17,10,27
75,8480813,Joe Veleno,C,DET,24,75,16,11,27
75,8476925,Colton Sissons,C,NSH,31,60,16,11,27
75,8473533,Jordan Staal,C,CAR,36,65,15,12,27
75,8478046,Danton Heinen,L,VAN,29,62,13,14,27
75,8475722,Jason Zucker,L,BUF,32,61,10,17,27
75,8479351,Sam Steel,C,DAL,26,78,10,17,27
75,8477498,Darnell Nurse,D,EDM,29,76,8,19,27
75,8482122,Brock Faber,D,MIN,22,77,7,20,27
75,8482749,Joshua Roy,R,MTL,21,59,6,21,27
75,8482655,Janis Moser,D,TBL,24,78,5,22,27
75,8475790,Erik Gudbranson,D,CBJ,32,77,3,24,27
75,8479619,Michael Carcone,L,UTA,28,64,19,7,26
75,8479941,Justin Danforth,R,CBJ,31,52,15,11,26
75,8483491,Ivan Miroshnichenko,L,WSH,20,57,14,12,26
75,8480802,Ryan McLeod,C,BUF,25,65,13,13,26
75,8481093,Rafael Harvey-Pinard,L,MTL,25,62,13,13,26
75,8483524,Shane Wright,C,SEA,20,62,13,13,26
75,8478020,Michael Amadio,R,OTT,28,74,11,15,26
75,8476921,Jordan Martinook,L,CAR,32,66,10,16,26
75,8482624,Daniil Miromanov,D,CGY,27,66,8,18,26
75,8476892,Colton Parayko,D,STL,31,75,5,21,26
75,8480043,Timothy Liljegren,D,TOR,25,65,2,24,26
75,8481582,Nicholas Robertson,L,TOR,23,70,18,7,25
75,8476960,Andreas Athanasiou,C,CHI,30,56,17,8,25
75,8482074,Connor Zary,C,CGY,23,64,17,8,25
75,8479525,Ross Colton,C,COL,28,76,15,10,25
75,8476981,Josh Anderson,R,MTL,30,70,15,10,25
75,8479393,Noah Gregor,L,OTT,26,69,14,11,25
75,8482125,Alexander Holtz,R,VGK,22,70,12,13,25
75,8473453,Trevor Lewis,C,LAK,37,73,12,13,25
75,8476422,Mike Reilly,D,NYI,31,79,6,19,25
75,8479402,Jake Bean,D,CGY,26,65,1,24,25
75,8477987,Ryan Donato,C,CHI,28,64,15,9,24
75,8479992,Michael Rasmussen,C,DET,25,79,11,13,24
75,8482089,Jake Neighbours,L,STL,22,67,11,13,24
75,8481553,Bobby Brink,R,PHI,23,61,9,15,24
75,8476624,Barclay Goodrow,C,SJS,31,55,9,15,24
75,8478911,Matt Roy,D,WSH,29,61,5,19,24
75,8479980,Nicolas Hague,D,VGK,26,63,5,19,24
75,8482067,Connor Mackey,D,NYR,28,65,4,20,24
75,8478133,Jake Evans,C,MTL,28,70,2,22,24
75,8476902,Esa Lindell,D,DAL,30,73,1,23,24
75,8481032,Paul Cotter,C,NJD,25,60,14,9,23
75,8480762,Eric Robinson,L,CAR,29,54,12,11,23
75,8476392,Adam Lowry,C,WPG,31,62,11,12,23
75,8475343,Nic Dowd,C,WSH,34,65,11,12,23
75,8480829,Jesperi Kotkaniemi,C,CAR,24,68,9,14,23
75,8484203,Bradly Nadeau,L,CAR,19,59,9,14,23
75,8477435,Ryan Graves,D,PIT,29,77,9,14,23
75,8476931,Jake McCabe,D,TOR,31,69,8,15,23
75,8478013,Jake Walman,D,SJS,28,67,8,15,23
75,8482809,Jackson Blake,R,CAR,21,54,8,15,23
75,8475200,Dmitry Orlov,D,CAR,33,76,5,18,23
75,8476463,Jonas Brodin,D,MIN,31,76,5,18,23
75,8476979,Erik Gustafsson,D,DET,32,73,3,20,23
75,8475324,Nick Jensen,D,OTT,34,71,3,20,23
75,8470621,Corey Perry,R,EDM,39,69,14,8,22
75,8482259,Bobby McMann,C,TOR,28,65,14,8,22
75,8477952,Robby Fabbri,C,ANA,28,69,13,9,22
75,8480980,Connor Dewar,C,TOR,25,69,12,10,22
75,8476889,Radek Faksa,C,STL,30,67,11,11,22
75,8476469,Joel Armia,R,MTL,31,60,10,12,22
75,8476878,Zemgus Girgensons,C,TBL,30,77,10,12,22
75,8482111,Justin Barron,D,MTL,23,68,10,12,22
75,8477353,Tyler Motte,C,DET,29,74,9,13,22
75,8476873,Mark Jankowski,C,NSH,30,48,9,13,22
75,8480748,Kiefer Sherwood,L,VAN,29,63,9,13,22
75,8479315,Joey Anderson,R,CHI,26,52,9,13,22
75,8480003,Jesper Boqvist,C,FLA,26,62,8,14,22
75,8477488,Brett Pesce,D,NJD,30,65,7,15,22
75,8475220,Marcus Foligno,L,MIN,33,64,6,16,22
75,8483565,Nick Blankenburg,D,NSH,26,61,6,16,22
75,8473563,Nicklas Backstrom,C,WSH,37,54,5,17,22
75,8481527,Kaedan Korczak,D,VGK,23,54,5,17,22
75,8477506,Ryan Pulock,D,NYI,30,78,4,18,22
75,8480049,Dylan Samberg,D,WPG,25,65,2,20,22
75,8482245,Artem Zub,D,OTT,29,67,2,20,22
75,8474673,TJ Brodie,D,CHI,34,65,2,20,22
75,8481059,Scott Perunovich,D,STL,26,69,1,21,22
75,8478136,Jake Middleton,D,MIN,28,69,1,21,22
75,8482155,Alex Laferriere,R,LAK,23,60,15,6,21
75,8480074,Alexandre Texier,C,STL,25,61,11,10,21
75,8476278,Colin Blackwell,C,DAL,31,77,10,11,21
75,8477979,Nicolas Aube-Kubel,R,BUF,28,59,9,12,21
75,8480144,David Kampf,C,TOR,29,71,9,12,21
75,8477989,Christian Dvorak,C,MTL,28,73,8,13,21
75,8477508,Curtis Lazar,C,NJD,29,60,8,13,21
75,8481580,Connor McMichael,C,WSH,23,63,8,13,21
75,8481606,Jordan Spence,D,LAK,23,61,7,14,21
75,8475193,Tomas Tatar,L,NJD,34,69,7,14,21
75,8476457,Adam Larsson,D,SEA,32,70,7,14,21
75,8476856,Mathew Dumba,D,DAL,30,68,7,14,21
75,8479324,Ryan Lindgren,D,NYR,26,67,6,15,21
75,8478017,Mark Friedman,D,VAN,29,49,5,16,21
75,8480873,Rasmus Sandin,D,WSH,24,63,3,18,21
75,8477446,Michael McCarron,R,NSH,29,56,14,6,20
75,8477478,William Carrier,L,CAR,30,54,11,9,20
75,8480448,Parker Kelly,L,COL,25,70,11,9,20
75,8483468,Jiri Kulich,C,BUF,20,57,11,9,20
75,8476467,Jamie Oleksiak,D,SEA,32,67,10,10,20
75,8477406,Mattias Janmark,C,EDM,32,66,10,10,20
75,8476822,Luke Glendening,C,TBL,35,77,10,10,20
75,8481704,Juuso Parssinen,C,NSH,23,57,8,12,20
75,8481019,David Gustafsson,C,WPG,24,53,8,12,20
75,8476312,Josh Manson,D,COL,33,67,7,13,20
75,8482451,Mikael Pyyhtia,L,CBJ,23,49,7,13,20
75,8476374,Sean Kuraly,C,CBJ,31,56,6,14,20
75,8480246,Nick Perbix,D,TBL,26,73,5,15,20
75,8477507,Nikita Zadorov,D,BOS,29,68,5,15,20
75,8475455,Brenden Dillon,D,NJD,34,61,5,15,20
75,8481521,Ronnie Attard,D,PHI,25,59,4,16,20
75,8476897,Oskar Sundqvist,C,STL,30,66,10,9,19
75,8483495,Simon Nemec,D,NJD,20,55,9,10,19
75,8479353,Brett Howden,C,VGK,26,70,8,11,19
75,8478970,Jalen Chatfield,D,CAR,28,73,8,11,19
75,8481481,Blake Lizotte,C,PIT,27,60,8,11,19
75,8477573,Nathan Walker,L,STL,30,52,8,11,19
75,8477018,Ben Hutton,D,VGK,31,42,7,12,19
75,8480835,Jack Drury,C,CAR,24,61,7,12,19
75,8477947,Sonny Milano,L,WSH,28,59,7,12,19
75,8477499,Rasmus Ristolainen,D,PHI,30,57,7,12,19
75,8478109,Victor Olofsson,L,VGK,29,62,6,13,19
75,8482062,Cole Smith,L,NSH,29,55,6,13,19
75,8482659,Josh Doan,R,UTA,22,55,5,14,19
75,8476891,Matthew Grzelcyk,D,PIT,30,77,2,17,19
75,8476917,Adam Pelech,D,NYI,30,77,1,18,19
75,8478851,Alexandre Carrier,D,NSH,28,59,1,18,19
75,8477450,Jason Dickinson,C,CHI,29,46,9,9,18
75,8478508,Yakov Trenin,C,MIN,27,56,9,9,18
75,8482737,Zack Bolduc,C,STL,21,55,9,9,18
75,8477425,Miles Wood,L,COL,29,73,8,10,18
75,8480025,MacKenzie Entwistle,R,FLA,25,63,8,10,18
75,8482679,Matt Coronato,R,CGY,22,60,8,10,18
75,8477903,Garnet Hathaway,R,PHI,33,61,8,10,18
75,8477392,Hudson Fasching,R,NYI,29,61,7,11,18
75,8479066,Ryan Lomberg,L,CGY,30,63,7,11,18
75,8482803,Olen Zellweger,D,ANA,21,68,7,11,18
75,8482634,Alex Steeves,C,TOR,25,44,7,11,18
75,8480289,Morgan Barron,C,WPG,26,59,7,11,18
75,8475231,Casey Cizikas,C,NYI,33,73,6,12,18
75,8483457,Lane Hutson,D,MTL,20,65,6,12,18
75,8474034,Patrick Maroon,L,CHI,36,52,6,12,18
75,8475855,Jesper Fast,R,CAR,33,62,5,13,18
75,8475149,Marcus Johansson,L,MIN,34,66,5,13,18
75,8478569,Noel Acciari,C,PIT,33,47,5,13,18
75,8475188,Brayden McNabb,D,VGK,33,55,5,13,18
75,8481014,Alexander Romanov,D,NYI,24,76,3,15,18
75,8480891,Michael Kesselring,D,UTA,24,51,3,15,18
75,8477220,Nate Schmidt,D,FLA,33,68,3,15,18
75,8479982,Conor Timmins,D,TOR,26,61,3,15,18
75,8478443,Brandon Carlo,D,BOS,28,67,2,16,18
75,8480001,Urho Vaakanainen,D,ANA,25,58,1,17,18
75,8481641,Joel Kiviranta,L,COL,28,73,10,7,17
75,8478432,Christian Fischer,R,DET,27,72,9,8,17
75,8479316,Luke Kunin,C,SJS,27,50,9,8,17
75,8482730,Brandt Clarke,D,LAK,21,52,9,8,17
75,8480355,Mark Kastelic,C,BOS,25,65,9,8,17
75,8480252,Cole Guttman,C,CHI,25,45,9,8,17
75,8481028,Martin Pospisil,C,CGY,25,53,8,9,17
75,8479370,Tyson Jost,C,CAR,26,51,7,10,17
75,8483445,Cutter Gauthier,L,ANA,20,66,5,12,17
75,8479414,Nathan Bastian,R,NJD,27,54,5,12,17
75,8477015,Connor Brown,R,EDM,30,57,5,12,17
75,8476331,Dylan DeMelo,D,WPG,31,63,4,13,17
75,8474574,Tyler Myers,D,VAN,34,63,4,13,17
75,8483482,Tristan Luneau,D,ANA,20,64,4,13,17
75,8476429,Scott Mayfield,D,NYI,32,75,4,13,17
75,8479026,Philippe Myers,D,TOR,27,46,4,13,17
75,8475233,David Savard,D,MTL,34,66,3,14,17
75,8476879,Cody Ceci,D,EDM,31,74,2,15,17
75,8479369,Andrew Peeke,D,BOS,26,58,2,15,17
75,8476918,Jimmy Vesey,L,NYR,31,64,8,8,16
75,8478211,Dryden Hunt,L,CGY,29,49,7,9,16
75,8481477,Nico Sturm,C,SJS,29,52,7,9,16
75,8481751,Lukas Rousek,R,BUF,25,44,7,9,16
75,8479359,Beck Malenstyn,L,BUF,26,42,7,9,16
75,8481441,Joe Snively,C,DET,28,66,5,11,16
75,8482101,Danil Gushchin,L,SJS,22,51,5,11,16
75,8479671,Mathieu Olivier,R,CBJ,27,54,5,11,16
75,8476988,Matt Benning,D,SJS,30,62,4,12,16
75,8475279,Ben Chiarot,D,DET,33,62,3,13,16
75,8480950,Ilya Lyubushkin,D,DAL,30,67,3,13,16
75,8482087,Kaiden Guhle,D,MTL,22,68,2,14,16
75,8479639,Dylan Coghlan,D,WPG,26,67,2,14,16
75,8479998,Mikey Anderson,D,LAK,25,66,2,14,16
75,8482192,Isaak Phillips,D,CHI,23,49,2,14,16
75,8475179,Dmitry Kulikov,D,FLA,34,57,1,15,16
75,8480281,Alexey Toropchenko,R,STL,25,57,11,4,15
75,8481789,Tye Kartye,L,SEA,23,44,11,4,15
75,8476934,Brock McGinn,L,ANA,30,47,10,5,15
75,8478043,Sam Lafferty,C,BUF,29,59,9,6,15
75,8479368,Max Jones,L,BOS,26,58,8,7,15
75,8481601,Simon Holmstrom,R,NYI,23,64,8,7,15
75,8480995,Pontus Holmberg,R,TOR,25,61,7,8,15
75,8481013,Jonatan Berggren,R,DET,24,53,7,8,15
75,8477931,Tomas Nosek,L,FLA,32,53,6,9,15
75,8482859,Zack Ostapchuk,C,OTT,21,49,6,9,15
75,8481567,Henry Thrun,D,SJS,23,45,5,10,15
75,8482157,Will Cuylle,L,NYR,22,60,5,10,15
75,8483466,Kevin Korchinski,D,CHI,20,47,5,10,15
75,8480848,Ty Dellandrea,C,SJS,24,44,5,10,15
75,8483460,David Jiricek,D,CBJ,21,63,5,10,15
75,8478416,Erik Cernak,D,TBL,27,79,4,11,15
75,8479344,Jesse Puljujarvi,R,PIT,26,46,4,11,15
75,8478178,Darren Raddysh,D,TBL,28,70,4,11,15
75,8482176,Wyatt Kaiser,D,CHI,22,57,3,12,15
75,8481178,Egor Zamula,D,PHI,24,55,2,13,15
75,8480073,Erik Brannstrom,D,COL,25,56,2,13,15
75,8475181,Nick Leddy,D,STL,33,63,2,13,15
75,8478859,Niko Mikkola,D,FLA,28,52,1,14,15
75,8479371,Dante Fabbro,D,NSH,26,61,1,14,15
75,8475718,Justin Holl,D,DET,32,64,1,14,15
75,8483763,Maksymilian Szuber,D,UTA,22,40,9,5,14
75,8478421,A.J. Greer,L,FLA,28,56,8,6,14
75,8480205,Emil Bemstrom,C,PIT,25,63,7,7,14
75,8479291,Kevin Rooney,C,CGY,31,49,7,7,14
75,8478831,Kevin Stenlund,C,UTA,28,50,6,8,14
75,8476329,Travis Boyd,C,MIN,31,54,6,8,14
75,8480011,Klim Kostin,C,SJS,25,51,6,8,14
75,8479293,Brandon Tanev,L,SEA,33,59,5,9,14
75,8476994,Vinnie Hinostroza,C,NSH,30,54,5,9,14
75,8482142,Jamie Drysdale,D,PHI,22,62,5,9,14
75,8480807,Mattias Samuelsson,D,BUF,24,58,5,9,14
75,8479372,Joshua Mahura,D,SEA,26,53,4,10,14
75,8480172,Jan Rutta,D,SJS,34,66,4,10,14
75,8474612,Travis Hamonic,D,OTT,34,44,3,11,14
75,8471709,Marc-Edouard Vlasic,D,SJS,37,58,3,11,14
75,8479378,Logan Stanley,D,WPG,26,39,3,11,14
75,8475208,Brian Dumoulin,D,ANA,33,61,1,13,14
75,8484149,Gavin Brindley,C,CBJ,20,47,0,14,14
75,8480796,Martin Fehervary,D,WSH,25,61,6,7,13
75,8484911,Collin Graf,R,SJS,22,42,6,7,13
75,8480789,Oliver Wahlstrom,R,NYI,24,73,5,8,13
75,8481522,Peyton Krebs,C,BUF,23,56,5,8,13
75,8483499,Liam Ohgren,L,MIN,20,57,5,8,13
75,8476442,Matt Nieto,L,PIT,32,54,5,8,13
75,8479543,Michael Pezzetta,L,MTL,26,52,4,9,13
75,8481517,Brett Leason,R,ANA,25,53,4,9,13
75,8480727,Zach Whitecloud,D,VGK,28,49,3,10,13
75,8480070,Ian Mitchell,D,BOS,25,47,3,10,13
75,8475690,Chris Tanev,D,TOR,35,63,3,10,13
75,8481167,Brayden Pachal,D,CGY,25,42,3,10,13
75,8479249,Andrew Poturalski,C,SJS,30,36,1,12,13
75,8474166,Alec Martinez,D,CHI,37,48,1,12,13
75,8477845,Trevor van Riemsdyk,D,WSH,33,56,0,13,13
75,8478840,Will Borgen,D,SEA,28,58,0,13,13
75,8479968,Vinni Lettieri,C,BOS,29,47,10,2,12
75,8475225,Craig Smith,C,CHI,35,48,8,4,12
75,8482148,Hendrix Lapierre,C,WSH,22,46,8,4,12
75,8478585,Derek Ryan,C,EDM,38,64,7,5,12
75,8479718,Alex Barré-Boulet,C,MTL,27,53,7,5,12
75,8481617,Vasily Podkolzin,R,VAN,23,46,7,5,12
75,8477919,Frederick Gaudreau,C,MIN,31,61,5,7,12
75,8483493,Frank Nazar,C,CHI,20,47,5,7,12
75,8481532,Alex Turcotte,C,LAK,23,54,5,7,12
75,8478452,Caleb Jones,D,LAK,27,52,5,7,12
75,8480222,Sebastian Aho,D,PIT,28,75,4,8,12
75,8482166,Shakir Mukhamadullin,D,SJS,22,58,4,8,12
75,8480035,Henri Jokiharju,D,BUF,25,56,3,9,12
75,8476967,Brett Kulak,D,EDM,30,57,3,9,12
75,8482751,Ryan Winterton,C,SEA,21,38,3,9,12
75,8479972,Mason Shaw,C,WPG,26,33,3,9,12
75,8475462,Radko Gudas,D,ANA,34,65,1,11,12
75,8474090,Brendan Smith,D,DAL,35,49,1,11,12
75,8471817,Ryan Reaves,R,TOR,37,55,6,5,11
75,8482747,Brennan Othmann,L,NYR,21,35,6,5,11
75,8479439,Jacob MacDonald,D,COL,31,48,4,7,11
75,8476952,Dominic Toninato,C,WPG,30,37,3,8,11
75,8481701,Santeri Hatakka,D,NJD,23,41,2,9,11
75,8480870,Bo Groulx,C,NYR,24,32,1,10,11
75,8477482,Zachary Sanford,L,CHI,30,42,7,3,10
75,8477380,Jonny Brodzinski,C,NYR,31,49,6,4,10
75,8482762,Simon Edvinsson,D,DET,21,53,6,4,10
75,8481537,Nikita Okhotiuk,D,CGY,24,45,5,5,10
75,8481147,Reese Johnson,C,MIN,26,37,5,5,10
75,8480845,Rasmus Kupari,C,WPG,24,40,5,5,10
75,8479981,Jonah Gadjovich,L,FLA,26,51,4,6,10
75,8480021,Jack Studnicka,C,LAK,25,59,3,7,10
75,8470600,Ryan Suter,D,STL,39,61,3,7,10
75,8475235,Nicolas Deslauriers,L,PHI,33,51,3,7,10
75,8476441,Joel Edmundson,D,LAK,31,43,2,8,10
75,8482077,Dylan Holloway,L,EDM,23,47,2,8,10
75,8479348,Kale Clague,D,BUF,26,47,2,8,10
75,8481598,Philip Broberg,D,EDM,23,43,2,8,10
75,8481708,Zac Jones,D,NYR,24,42,1,9,10
75,8481599,Victor Soderstrom,D,UTA,23,41,1,9,10
75,8476525,Colin Miller,D,WPG,32,63,1,9,10
75,8476874,Olli Maatta,D,DET,30,66,1,9,10
75,8483397,Marc McLaughlin,C,BOS,25,34,6,3,9
75,8483570,Ben Meyers,C,SEA,26,28,5,4,9
75,8482744,James Malatesta,L,CBJ,21,41,4,5,9
75,8481716,Dmitri Voronkov,L,CBJ,24,39,4,5,9
75,8476372,Nick Seeler,D,PHI,31,47,4,5,9
75,8480292,Carson Meyer,R,ANA,27,33,4,5,9
75,8478146,Matthew Highmore,C,OTT,28,37,4,5,9
75,8479944,Zach Aston-Reese,C,VGK,30,42,3,6,9
75,8471677,Jack Johnson,D,CBJ,37,65,2,7,9
75,8480860,Kevin Bahl,D,CGY,24,55,2,7,9
75,8477369,Carson Soucy,D,VAN,30,64,2,7,9
75,8474013,Ian Cole,D,UTA,35,52,1,8,9
75,8473446,Erik Johnson,D,PHI,36,41,1,8,9
75,8475750,Jon Merrill,D,MIN,32,63,0,9,9
75,8476858,Phillip Di Giuseppe,L,VAN,31,38,6,2,8
75,8481609,Vladislav Kolyachonok,D,UTA,23,37,6,2,8
75,8480844,Grigori Denisenko,L,VGK,24,32,4,4,8
75,8478874,Adam Gaudette,R,OTT,28,36,4,4,8
75,8479379,Givani Smith,R,SJS,26,25,4,4,8
75,8478468,Jeremy Lauzon,D,NSH,27,62,3,5,8
75,8482964,Arber Xhekaj,D,MTL,23,48,3,5,8
75,8482807,Ethan Del Mastro,D,CHI,21,58,3,5,8
75,8479986,Kole Lind,R,DAL,26,55,3,5,8
75,8479442,Troy Stecher,D,EDM,30,51,3,5,8
75,8480058,Pierre-Olivier Joseph,D,STL,25,49,2,6,8
75,8482666,Scott Morrow,D,CAR,22,39,2,6,8
75,8477938,Haydn Fleury,D,WPG,28,47,2,6,8
75,8483619,Filip Roos,D,OTT,25,30,2,6,8
75,8482145,Mavrik Bourque,C,DAL,22,47,2,6,8
75,8479419,Brett Murray,L,BUF,26,26,2,6,8
75,8478399,Jonas Siegenthaler,D,NJD,27,58,1,7,8
75,8482861,Vincent Iorio,D,WSH,22,32,1,7,8
75,8480157,Calle Rosen,D,COL,30,48,0,8,8
75,8475177,Calvin de Haan,D,COL,33,43,0,8,8
75,8477467,Gustav Olofsson,D,SEA,30,22,6,1,7
75,8477401,John Hayden,C,SEA,29,37,5,2,7
75,8481518,Nolan Foote,L,NJD,24,46,3,4,7
75,8478450,Parker Wotherspoon,D,BOS,27,32,3,4,7
75,8481605,Jackson LaCombe,D,ANA,23,32,3,4,7
75,8477070,Liam O'Brien,C,UTA,30,57,2,5,7
75,8482784,Zach Dean,C,STL,21,37,2,5,7
75,8474568,Luke Schenn,D,NSH,35,53,2,5,7
75,8481592,Jakob Pelletier,L,CGY,23,46,2,5,7
75,8481550,Adam Beckman,L,NJD,23,35,2,5,7
75,8482153,Brendan Brisson,C,VGK,23,33,2,5,7
75,8479576,Vincent Desharnais,D,VAN,28,33,2,5,7
75,8475762,Derek Forbort,D,VAN,32,41,2,5,7
75,8477527,Ross Johnston,L,ANA,30,39,2,5,7
75,8481568,Alex Vlasic,D,CHI,23,48,1,6,7
75,8480879,Jacob Bernard-Docker,D,OTT,24,52,1,6,7
75,8477384,Joshua Brown,D,EDM,30,47,1,6,7
75,8484254,Akito Hirose,D,VAN,25,37,1,6,7
75,8484287,Cole McWard,D,VAN,23,23,1,6,7
75,8478409,Anthony Richard,C,PHI,28,35,1,6,7
75,8480834,Ty Emberson,D,SJS,24,45,0,7,7
75,8479520,Brandon Duhaime,R,WSH,27,49,5,1,6
75,8481754,Nikita Nesterenko,C,ANA,23,33,5,1,6
75,8480441,Trey Fix-Wolansky,R,CBJ,25,39,5,1,6
75,8479362,Riley Tufte,L,BOS,26,16,5,1,6
75,8476867,Brendan Gaunce,C,MIN,30,33,4,2,6
75,8479328,Julien Gauthier,R,NYI,27,60,3,3,6
75,8477365,Connor Clifton,D,BUF,29,54,3,3,6
75,8481679,Maxence Guenette,D,OTT,23,34,3,3,6
75,8482652,Walker Duehr,R,CGY,27,36,3,3,6
75,8474567,Zach Bogosian,D,MIN,34,53,2,4,6
75,8478451,Ethan Bear,D,WSH,27,53,2,4,6
75,8477034,Jaycob Megna,D,FLA,32,42,2,4,6
75,8479772,Zack MacEwen,R,OTT,28,48,2,4,6
75,8475795,Dylan McIlrath,D,WSH,32,23,2,4,6
75,8480887,Jordan Harris,D,MTL,24,55,1,5,6
75,8477851,Jordan Oesterle,D,BOS,32,42,1,5,6
75,8479985,Cale Fleury,D,SEA,26,30,1,5,6
75,8477971,Andreas Englund,D,LAK,28,28,1,5,6
75,8481161,Jake Christiansen,D,CBJ,25,50,0,6,6
75,8478502,Dennis Gilbert,D,BUF,28,19,0,6,6
75,8482496,Nils Aman,C,VAN,24,40,5,0,5
75,8482141,Lukas Cormier,D,VGK,22,28,4,1,5
75,8477887,Patrick Brown,C,BOS,32,51,3,2,5
75,8480192,Johnathan Kovacevic,D,NJD,27,47,3,2,5
75,8475958,Michael Sgarbossa,C,WSH,32,26,3,2,5
75,8480990,Declan Chisholm,D,MIN,24,38,3,2,5
75,8483549,Lucas Condotta,L,MTL,27,39,2,3,5
75,8479320,Maxime Lajoie,D,SEA,27,18,2,3,5
75,8481719,Maxwell Crozier,D,TBL,24,19,2,3,5
75,8482073,Braden Schneider,D,NYR,23,57,1,4,5
75,8478424,Jansen Harkins,C,ANA,27,43,1,4,5
75,8480196,Jacob Bryson,D,BUF,27,39,1,4,5
75,8482511,Mason Lohrei,D,BOS,23,29,1,4,5
75,8480245,Olle Lycksell,R,PHI,25,30,1,4,5
75,8477462,Robert Hagg,D,VGK,29,23,1,4,5
75,8482733,Logan Mailloux,D,MTL,31,28,0,5,5
75,8482095,Tyler Kleven,D,OTT,22,47,0,5,5
75,8476913,Devin Shore,C,MIN,30,28,0,5,5
75,8481556,John Beecher,C,BOS,23,31,4,0,4
75,8482177,Marat Khusnutdinov,C,MIN,22,33,3,1,4
75,8480851,Akil Thomas,C,LAK,24,18,3,1,4
75,8480007,Jonas Rondbjerg,R,VGK,25,29,2,2,4
75,8479536,Axel Jonsson-Fjallby,L,WPG,26,38,2,2,4
75,8480880,Jakub Lauko,C,MIN,24,39,2,2,4
75,8483630,Pavol Regenda,L,ANA,25,23,2,2,4
75,8481600,Tobias Bjornfot,D,FLA,23,41,2,2,4
75,8481593,Jayden Struble,D,MTL,23,23,2,2,4
75,8482250,Callahan Burke,C,VGK,27,29,2,2,4
75,8477962,Brendan Lemieux,L,CAR,28,38,1,3,4
75,8478454,Noah Juulsen,D,VAN,27,37,1,3,4
75,8482144,Jack Thompson,D,SJS,22,24,1,3,4
75,8477473,Justin Bailey,R,SJS,29,26,1,3,4
75,8475842,Sam Carrick,C,NYR,32,53,0,4,4
75,8482172,Landon Slaggert,L,CHI,22,25,0,4,4
75,8482165,Yan Kuznetsov,D,CGY,22,23,0,4,4
75,8477320,Anton Blidh,L,NYR,29,25,0,4,4
75,8479638,Justin Brazeau,R,BOS,26,31,3,0,3
75,8477993,Justin Kirkland,C,CGY,28,8,3,0,3
75,8479994,Jaret Anderson-Dolan,C,WPG,25,39,2,1,3
75,8482147,Jean-Luc Foudy,C,COL,22,31,2,1,3
75,8482765,Isak Rosen,R,BUF,21,27,2,1,3
75,8482088,Justin Sourdif,R,FLA,22,14,2,1,3
75,8481422,Jake Lucchini,C,NSH,29,21,2,1,3
75,8478011,Louie Belpedio,D,PHI,28,17,1,2,3
75,8482102,Vasily Ponomarev,C,PIT,22,23,1,2,3
75,8481006,Tyler Tucker,D,STL,24,18,1,2,3
75,8479330,Brandon Gignac,C,MTL,27,9,1,2,3
75,8477335,Kyle Burroughs,D,LAK,29,41,0,3,3
75,8484258,Sam Malinski,D,COL,26,22,0,3,3
75,8480267,Sammy Walker,C,MIN,25,23,0,3,3
75,8480890,Jan Jenik,C,OTT,24,28,0,3,3
75,8481056,Spencer Stastney,D,NSH,24,30,0,3,3
75,8477810,Joel Hanley,D,CGY,33,28,0,3,3
75,8482516,Matthew Kessel,D,STL,24,21,0,3,3
75,8481743,Marc Del Gaizo,D,NSH,25,19,0,3,3
75,8478477,Mitchell Stephens,C,SEA,27,20,0,3,3
75,8481543,Nikita Alexandrov,C,STL,24,24,2,0,2
75,8481043,Cole Koepke,L,BOS,26,18,2,0,2
75,8478051,Max Willman,C,NJD,29,21,2,0,2
75,8482118,Sam Colangelo,R,ANA,23,20,2,0,2
75,8481726,Adam Edstrom,C,NYR,24,8,2,0,2
75,8482094,Daemon Hunt,D,MIN,22,22,2,0,2
75,8484325,Waltteri Merela,C,TBL,26,20,2,0,2
75,8477541,Dakota Mermis,D,TOR,30,13,2,0,2
75,8482061,Brandon Biro,L,SEA,26,15,2,0,2
75,8482460,Matt Rempe,C,NYR,22,9,2,0,2
75,8483012,Logan Morrison,C,SEA,22,32,1,1,2
75,8482070,Mitchell Chaffee,R,TBL,26,43,1,1,2
75,8481122,Simon Benoit,D,TOR,26,28,1,1,2
75,8482713,Mackie Samoskevich,R,FLA,22,40,1,1,2
75,8480468,James Hamblin,L,EDM,25,23,1,1,2
75,8482858,Ryker Evans,D,SEA,23,24,1,1,2
75,8482162,Roby Jarventie,L,EDM,22,19,1,1,2
75,8480032,Shane Bowers,C,NJD,25,14,1,1,2
75,8481237,Kyle MacLean,C,NYI,25,27,1,1,2
75,8482126,Emil Andrae,D,PHI,31,2,1,1,2
75,8478021,William Lagesson,D,DET,28,25,0,2,2
75,8482929,Emil Lilleberg,D,TBL,23,16,0,2,2
75,8476473,Connor Murphy,D,CHI,31,28,0,2,2
75,8483512,Matthew Savoie,C,EDM,20,21,0,2,2
75,8479991,Jake Leschyshyn,C,NYR,25,21,0,2,2
75,8482201,Gage Goncalves,C,TBL,23,34,0,2,2
75,8480823,Alexander Alexeyev,D,WSH,25,8,0,2,2
75,8475755,Alexander Petrovic,D,DAL,32,9,0,2,2
75,8479587,Rhett Gardner,C,PHI,28,21,0,2,2
75,8481699,Aku Raty,R,UTA,23,15,0,2,2
75,8481578,Graeme Clarke,R,MIN,23,10,0,2,2
75,8477073,Kurtis MacDermid,L,NJD,30,24,1,0,1
75,8482476,Emil Heineman,L,MTL,23,6,1,0,1
75,8477244,Chad Ruhwedel,D,NYR,34,37,1,0,1
75,8477149,Scott Sabourin,R,SJS,32,13,1,0,1
75,8481206,John Ludvig,D,PIT,24,8,1,0,1
75,8483471,Brad Lambert,C,WPG,31,7,1,0,1
75,8478446,Glenn Gawdin,C,LAK,27,9,1,0,1
75,8481462,Mason Morelli,L,VGK,28,16,1,0,1
75,8483546,Marshall Rifai,D,TOR,26,4,1,0,1
75,8479367,William Lockwood,R,FLA,26,20,0,1,1
75,8482470,Ilya Solovyov,D,CGY,24,19,0,1,1
75,8481541,Samuel Bolduc,D,NYI,24,22,0,1,1
75,8480075,Cameron Crotty,D,MIN,25,13,0,1,1
75,8483597,Milos Kelemen,L,UTA,25,14,0,1,1
75,8479421,Jacob Moverare,D,LAK,26,3,0,1,1
75,8481564,Ryan Johnson,D,BUF,23,20,0,1,1
75,8474062,Riley Nash,C,NYR,35,23,0,1,1
75,8480306,Grant Hutton,D,NYI,29,5,0,1,1
75,8478854,Ryan Shea,D,PIT,27,7,0,1,1
75,8482787,Nikita Chibrikov,R,WPG,31,7,0,1,1
75,8484326,Patrik Koch,D,UTA,28,2,0,1,1
75,8483395,Arshdeep Bains,L,VAN,23,12,0,0,0
75,8483407,Brandon Scanlin,D,NYR,25,2,0,0,0
75,8481024,Linus Karlsson,C,VAN,25,10,0,0,0
75,8484304,Uvis Balinskis,D,FLA,28,10,0,0,0
75,8480084,Nick DeSimone,D,NJD,30,14,0,0,0
75,8475780,Chris Wagner,R,COL,33,11,0,0,0
75,8483432,Luca Del Bel Belluz,C,CBJ,31,9,0,0,0
75,8483920,Pierrick Dube,R,WSH,23,6,0,0,0
75,8475413,Justin Dowling,C,NJD,34,10,0,0,0
75,8478881,Brett Seney,L,CHI,28,8,0,0,0
75,8481655,Cole Schwindt,R,CGY,23,12,0,0,0
75,8481585,Egor Afanasyev,L,SJS,23,20,0,0,0
75,8479522,Hardy Haman Aktell,D,WSH,26,3,0,0,0
75,8480874,Adam Ginning,D,PHI,24,7,0,0,0
75,8481030,Jack St. Ivany,D,PIT,25,15,0,0,0
75,8483567,Georgii Merkulov,C,BOS,24,4,0,0,0
75,8481065,Angus Crookshank,L,OTT,25,20,0,0,0
75,8483489,Fraser Minten,C,TOR,31,14,0,0,0
75,8478147,Bokondji Imama,L,PIT,28,5,0,0,0
75,8482197,Adam Raska,R,MIN,23,7,0,0,0
75,8481806,Louis Crevier,D,CHI,23,20,0,0,0
75,8483398,Declan Carlile,D,TBL,31,3,0,0,0
75,8480274,Philip Kemp,D,EDM,25,0,0,0,0
75,8484255,Jason Polin,R,COL,25,7,0,0,0
75,8483609,Adam Klapka,R,CGY,24,2,0,0,0
75,8483531,Brian Halonen,L,NJD,25,1,0,0,0
75,8476323,Max McCormick,L,SEA,32,4,0,0,0
75,8481534,Raphael Lavoie,C,EDM,24,3,0,0,0
75,8483401,Marc Johnstone,R,PIT,28,1,0,0,0
75,8484259,Ondrej Pavel,C,COL,31,1,0,0,0
75,8484321,Nikolas Matinpalo,D,OTT,26,3,0,0,0
75,8470794,Joe Pavelski,C,,40,0,0,0,0
75,8479321,Lucas Johansen,D,,27,0,0,0,0
75,8477950,Tony DeAngelo,D,,29,0,0,0,0
75,8471218,Blake Wheeler,R,,38,0,0,0,0
75,8475197,Tyson Barrie,D,,33,0,0,0,0
75,8474157,Max Pacioretty,L,,36,0,0,0,0
75,8475744,Evgeny Kuznetsov,C,,32,0,0,0,0
75,8474037,James van Riemsdyk,L,,35,0,0,0,0
75,8476907,Mackenzie MacEachern,L,,30,0,0,0,0
75,8480216,Jacob Peterson,C,,25,0,0,0,0
75,8474602,Justin Schultz,D,,34,0,0,0,0
75,8482222,Alexander Barabanov,L,,30,0,0,0,0
75,8474031,Kevin Shattenkirk,D,,35,0,0,0,0
75,8477330,Dominik Kubalik,L,,29,0,0,0,0
75,8480884,Calen Addison,D,,24,0,0,0,0
75,8475906,John Klingberg,D,,32,0,0,0,0
75,8480008,Adam Ruzicka,C,,25,0,0,0,0
75,8476884,Derrick Pouliot,D,,30,0,0,0,0
75,8476919,Chris Tierney,C,,30,0,0,0,0
75,8479415,Michael McLeod,C,,26,0,0,0,0
75,8474870,Tyler Johnson,C,,34,0,0,0,0
75,8470604,Jeff Carter,C,,39,0,0,0,0
75,8478104,Sammy Blais,L,,28,0,0,0,0
75,8474884,Mike Hoffman,C,,35,0,0,0,0
75,8481591,Sam Poulin,R,,23,0,0,0,0
75,8471274,Alex Goligoski,D,,39,0,0,0,0
75,8476871,Tanner Pearson,L,,32,0,0,0,0
75,8476393,Nick Cousins,C,,31,0,0,0,0
75,8479977,Kailer Yamamoto,R,,26,0,0,0,0
75,8479346,Dillon Dube,C,,26,0,0,0,0
75,8480184,Gustav Lindstrom,D,,26,0,0,0,0
75,8479376,Victor Mete,D,,26,0,0,0,0
75,8473449,Kyle Okposo,R,,36,0,0,0,0
75,8481058,Jesse Ylonen,R,,25,0,0,0,0
75,8475752,Tyler Pitlick,C,,33,0,0,0,0
75,8481239,Samuel Fagemo,L,,24,0,0,0,0
75,8480821,Filip Zadina,R,,25,0,0,0,0
75,8470966,Mark Giordano,D,,41,0,0,0,0
75,8478495,Denis Gurianov,R,,27,0,0,0,0
75,8477464,Nic Petan,C,,29,0,0,0,0
75,8478099,Kevin Labanc,R,,29,0,0,0,0
75,8482241,Radim Zohorna,L,,28,0,0,0,0
75,8474040,Sam Gagner,C,,35,0,0,0,0
75,8479514,Rem Pitlick,C,,27,0,0,0,0
75,8478430,Oliver Kylington,D,,27,0,0,0,0
75,8479533,Joona Koppanen,L,,26,0,0,0,0
75,8479984,Cal Foote,D,,26,0,0,0,0
75,8477126,Jayson Megna,C,,34,0,0,0,0
75,8475164,Jakob Silfverberg,R,,34,0,0,0,0
75,8474009,Nick Bonino,C,,36,0,0,0,0
75,8479458,Nikita Zaitsev,D,,33,0,0,0,0
75,8477944,Jakub Vrana,L,,28,0,0,0,0
75,8471699,Andrew Cogliano,C,,37,0,0,0,0
75,8478067,Oskar Lindblom,L,,28,0,0,0,0
75,8471686,Marc Staal,D,,37,0,0,0,0
75,8470610,Zach Parise,L,,40,0,0,0,0
75,8478904,Steven Lorentz,C,,28,0,0,0,0
75,8473473,Milan Lucic,L,,36,0,0,0,0
75,8480031,Maxime Comtois,L,,25,0,0,0,0
75,8478512,Austin Czarnik,C,,32,0,0,0,0
75,8473504,Cal Clutterbuck,R,,37,0,0,0,0
75,8477454,Adam Erne,L,,29,0,0,0,0
75,8479383,Boris Katchouk,L,,26,0,0,0,0
75,8475825,Jani Hakanpää,D,,32,0,0,0,0
75,8477846,Ryan Carpenter,C,,33,0,0,0,0
75,8477930,Pierre-Edouard Bellemare,L,,39,0,0,0,0
75,8478400,Colin White,C,,27,0,0,0,0
75,8480226,Marián Studenic,R,,26,0,0,0,0
75,8480853,Liam Foudy,C,,24,0,0,0,0
75,8475797,Jarred Tinordi,D,,32,0,0,0,0
75,8479423,Alex Nylander,L,,26,0,0,0,0
75,8474618,Marco Scandella,D,,34,0,0,0,0
75,8478028,Fredrik Olofsson,L,,28,0,0,0,0
75,8474709,Matt Martin,L,,35,0,0,0,0
75,8481070,Hugh McGing,L,,26,0,0,0,0
75,8479546,Oskar Steen,C,,26,0,0,0,0
75,8474145,Robert Bortuzzo,D,,35,0,0,0,0
75,8476915,Jujhar Khaira,L,,30,0,0,0,0
75,8475278,Byron Froese,C,,33,0,0,0,0
75,8481812,Nikolai Knyzhov,D,,27,0,0,0,0
75,8478408,Travis Dermott,D,,28,0,0,0,0
75,8481077,John Leonard,L,,26,0,0,0,0
75,8479547,Matthew Phillips,R,,26,0,0,0,0
75,8480836,Jonathan Gruden,C,,24,0,0,0,0
75,8481690,Tyler Angle,C,,24,0,0,0,0
75,8475766,Austin Watson,L,,32,0,0,0,0
75,8481016,Ruslan Iskhakov,C,,24,0,0,0,0
75,8478078,Rourke Chartier,C,,28,0,0,0,0
75,8480776,Sheldon Rempal,R,,29,0,0,0,0
75,8478956,Samuel Laberge,L,NJD,27,1,0,0,0
75,8483045,Cameron Butler,R,CBJ,31,0,0,0,0
75,8484314,Jiri Smejkal,L,,28,0,0,0,0
76,8477492,Nathan MacKinnon,C,COL,29,82,60,86,146
76,8478402,Connor McDavid,C,EDM,27,80,44,94,138
76,8476453,Nikita Kucherov,R,TBL,31,81,40,92,132
76,8481559,Jack Hughes,C,NJD,23,77,48,83,131
76,8478420,Mikko Rantanen,R,COL,28,81,40,68,108
76,8478550,Artemi Panarin,L,NYR,33,78,29,79,108
76,8479318,Auston Matthews,C,TOR,27,75,55,51,106
76,8478483,Mitch Marner,R,TOR,27,77,30,75,105
76,8479314,Matthew Tkachuk,L,FLA,27,80,35,68,103
76,8476468,J.T. Miller,C,VAN,31,74,34,69,103
76,8477939,William Nylander,R,TOR,28,81,50,52,102
76,8477956,David Pastrnak,R,BOS,28,82,41,59,100
76,8480800,Quinn Hughes,D,VAN,25,76,13,86,99
76,8477493,Aleksander Barkov,C,FLA,29,78,32,66,98
76,8477409,Carter Verhaeghe,C,FLA,29,77,44,53,97
76,8471675,Sidney Crosby,C,PIT,37,76,45,50,95
76,8477934,Leon Draisaitl,C,EDM,29,78,35,60,95
76,8480801,Brady Tkachuk,L,OTT,25,78,43,50,93
76,8478445,Mathew Barzal,C,NYI,27,80,23,70,93
76,8478403,Jack Eichel,C,VGK,28,78,47,45,92
76,8478864,Kirill Kaprizov,L,MIN,27,71,38,53,91
76,8477501,Valeri Nichushkin,R,COL,29,81,45,45,90
76,8476887,Filip Forsberg,L,NSH,30,78,43,47,90
76,8477942,Kevin Fiala,L,LAK,28,79,34,56,90
76,8482116,Tim Stützle,C,OTT,22,80,33,57,90
76,8478010,Brayden Point,C,TBL,28,80,48,41,89
76,8479542,Brandon Hagel,L,TBL,26,82,40,49,89
76,8477404,Jake Guentzel,C,TBL,30,82,37,52,89
76,8480012,Elias Pettersson,C,VAN,26,74,30,58,88
76,8474564,Steven Stamkos,C,NSH,34,75,48,37,85
76,8479407,Jesper Bratt,L,NJD,26,74,28,57,85
76,8477933,Sam Reinhart,C,FLA,29,79,41,43,84
76,8475913,Mark Stone,R,VGK,32,73,30,54,84
76,8478449,Roope Hintz,C,DAL,28,82,40,43,83
76,8476389,Vincent Trocheck,C,NYR,31,74,38,45,83
76,8480069,Cale Makar,D,COL,26,68,23,59,82
76,8475167,Victor Hedman,D,TBL,34,80,8,74,82
76,8471685,Anze Kopitar,C,LAK,37,80,28,52,80
76,8477949,Alex Tuch,R,BUF,28,74,24,56,80
76,8477946,Dylan Larkin,C,DET,28,81,35,44,79
76,8476459,Mika Zibanejad,C,NYR,31,76,31,48,79
76,8479343,Clayton Keller,R,UTA,26,77,29,50,79
76,8480027,Jason Robertson,L,DAL,25,81,26,53,79
76,8475166,John Tavares,C,TOR,34,81,21,58,79
76,8480039,Martin Necas,C,CAR,25,77,37,41,78
76,8478398,Kyle Connor,L,WPG,28,77,35,43,78
76,8484144,Connor Bedard,C,CHI,19,69,32,45,77
76,8480002,Nico Hischier,C,NJD,25,74,29,48,77
76,8478414,Timo Meier,R,NJD,28,77,42,34,76
76,8475172,Nazem Kadri,C,CGY,34,79,28,48,76
76,8480023,Robert Thomas,C,STL,25,74,20,56,76
76,8477960,Adrian Kempe,R,LAK,28,80,39,36,75
76,8473512,Claude Giroux,R,OTT,36,79,21,54,75
76,8475184,Chris Kreider,L,NYR,33,76,40,34,74
76,8478439,Travis Konecny,R,PHI,27,75,23,51,74
76,8478427,Sebastian Aho,C,CAR,27,70,29,42,71
76,8476460,Mark Scheifele,C,WPG,31,66,30,40,70
76,8477940,Nikolaj Ehlers,L,WPG,28,75,30,40,70
76,8480208,Drake Batherson,R,OTT,26,78,27,43,70
76,8474600,Roman Josi,D,NSH,34,77,18,52,70
76,8479323,Adam Fox,D,NYR,26,73,12,58,70
76,8482078,Lucas Raymond,L,DET,22,82,31,38,69
76,8480015,Owen Tippett,R,PHI,25,73,26,43,69
76,8479999,Casey Mittelstadt,C,COL,26,80,23,46,69
76,8475786,Zach Hyman,L,EDM,32,81,37,31,68
76,8478440,Dylan Strome,C,WSH,27,74,27,41,68
76,8471215,Evgeni Malkin,C,PIT,38,73,21,47,68
76,8474141,Patrick Kane,R,DET,36,82,24,43,67
76,8476454,Ryan Nugent-Hopkins,C,EDM,31,76,23,44,67
76,8480803,Evan Bouchard,D,EDM,25,73,14,53,67
76,8480865,Noah Dobson,D,NYI,24,79,12,55,67
76,8475692,Mats Zuccarello,R,MIN,37,66,9,58,67
76,8473419,Brad Marchand,L,BOS,36,82,25,41,66
76,8482124,Quinton Byfield,R,LAK,22,80,21,45,66
76,8477504,Josh Morrissey,D,WPG,29,78,16,50,66
76,8476539,Jonathan Marchessault,R,NSH,34,73,33,32,65
76,8476905,Chandler Stephenson,C,SEA,30,75,18,47,65
76,8477500,Bo Horvat,C,NYI,29,80,32,32,64
76,8478493,Joel Eriksson Ek,C,MIN,27,74,31,33,64
76,8475754,Brock Nelson,C,NYI,33,79,29,35,64
76,8476456,Jonathan Huberdeau,C,CGY,31,80,19,45,64
76,8479420,Tage Thompson,C,BUF,27,73,34,29,63
76,8479337,Alex DeBrincat,R,DET,27,82,30,33,63
76,8476479,Phillip Danault,C,LAK,31,79,23,40,63
76,8478975,Mason Marchment,L,DAL,29,81,22,41,63
76,8475810,Bryan Rust,R,PIT,32,69,22,41,63
76,8476448,William Karlsson,C,VGK,31,77,27,35,62
76,8480839,Rasmus Dahlin,D,BUF,24,76,18,44,62
76,8474679,Gustav Nyquist,C,NSH,35,68,11,51,62
76,8477951,Nick Schmaltz,C,UTA,28,76,28,33,61
76,8483515,Juraj Slafkovsky,L,MTL,20,76,26,35,61
76,8475765,Vladimir Tarasenko,R,DET,33,81,23,38,61
76,8478460,Zach Werenski,D,CBJ,27,82,16,45,61
76,8482684,Luke Hughes,D,NJD,21,70,11,50,61
76,8482109,Alexis Lafrenière,L,NYR,23,70,32,28,60
76,8479385,Jordan Kyrou,C,STL,26,68,29,31,60
76,8482740,Wyatt Johnston,C,DAL,21,81,27,33,60
76,8476346,Johnny Gaudreau,L,CBJ,31,71,17,43,60
76,8480036,Miro Heiskanen,D,DAL,25,80,12,48,60
76,8478444,Brock Boeser,R,VAN,27,76,35,24,59
76,8477407,Anthony Duclair,L,NYI,29,77,31,28,59
76,8481557,Matt Boldy,L,MIN,23,66,28,31,59
76,8482159,Tyson Foerster,R,PHI,22,73,28,31,59
76,8475168,Matt Duchene,C,DAL,33,81,24,35,59
76,8478873,Troy Terry,R,ANA,27,74,22,37,59
76,8480018,Nick Suzuki,C,MTL,25,76,21,38,59
76,8474578,Erik Karlsson,D,PIT,34,79,16,42,58
76,8481596,Shane Pinto,C,OTT,24,71,22,35,57
76,8480830,Andrei Svechnikov,R,CAR,24,69,21,36,57
76,8477494,Jonathan Drouin,L,COL,29,81,21,36,57
76,8477402,Pavel Buchnevich,L,STL,29,75,20,37,57
76,8476881,Tomas Hertl,C,VGK,31,77,19,38,57
76,8475798,Mikael Granlund,C,SJS,32,74,17,40,57
76,8478366,Frank Vatrano,R,ANA,30,76,34,22,56
76,8477476,Artturi Lehkonen,L,COL,29,82,24,32,56
76,8481528,Dylan Cozens,C,BUF,23,73,24,32,56
76,8474102,David Perron,L,OTT,36,81,21,35,56
76,8473994,Jamie Benn,L,DAL,35,80,20,36,56
76,8477935,Sam Bennett,C,FLA,28,76,28,27,55
76,8482745,Mason McTavish,C,ANA,21,68,25,30,55
76,8480064,Josh Norris,C,OTT,25,76,27,27,54
76,8476880,Tom Wilson,R,WSH,30,70,26,28,54
76,8477496,Elias Lindholm,C,BOS,30,77,16,38,54
76,8478396,Noah Hanifin,D,VGK,27,65,12,42,54
76,8479675,Trevor Moore,L,LAK,29,79,22,31,53
76,8474586,Jordan Eberle,R,SEA,34,75,22,31,53
76,8475745,Charlie Coyle,C,BOS,32,80,19,34,53
76,8478397,Rasmus Andersson,D,CGY,28,74,12,41,53
76,8481540,Cole Caufield,R,MTL,23,77,35,17,52
76,8477955,Jared McCann,L,SEA,28,79,32,20,52
76,8480014,Gabriel Vilardi,C,WPG,25,59,30,22,52
76,8475726,Tyler Toffoli,C,SJS,32,68,28,24,52
76,8475191,Reilly Smith,R,NYR,33,79,21,31,52
76,8480028,Morgan Frost,C,PHI,25,73,21,31,52
76,8477986,Brandon Montour,D,SEA,30,71,15,37,52
76,8478469,Thomas Chabot,D,OTT,27,70,12,40,52
76,8475314,Anders Lee,L,NYI,34,79,28,23,51
76,8475170,Brayden Schenn,C,STL,33,72,24,27,51
76,8470613,Brent Burns,D,CAR,39,77,11,40,51
76,8476399,Blake Coleman,C,CGY,33,79,27,23,50
76,8480797,Joel Farabee,L,PHI,24,73,22,28,50
76,8477416,Oliver Bjorkstrand,R,SEA,29,74,17,33,50
76,8479325,Charlie McAvoy,D,BOS,27,78,12,38,50
76,8477948,Travis Sanheim,D,PHI,28,74,9,41,50
76,8478498,Jake DeBrusk,L,VAN,28,70,30,19,49
76,8482665,Matty Beniers,C,SEA,22,73,28,21,49
76,8476483,Rickard Rakell,R,PIT,31,70,26,23,49
76,8481711,Matias Maccelli,L,UTA,24,75,20,29,49
76,8478407,Vince Dunn,D,SEA,28,73,8,41,49
76,8476432,Boone Jenner,C,CBJ,31,73,31,17,48
76,8475799,Nino Niederreiter,R,WPG,32,70,28,20,48
76,8481068,Yegor Sharangovich,C,CGY,26,80,24,24,48
76,8477998,Warren Foegele,L,LAK,28,79,21,27,48
76,8477456,J.T. Compher,L,DET,29,80,21,27,48
76,8482092,Ridly Greig,C,OTT,22,73,20,28,48
76,8477932,Aaron Ekblad,D,FLA,28,75,13,35,48
76,8471724,Kris Letang,D,PIT,37,78,11,37,48
76,8476853,Morgan Rielly,D,TOR,30,67,8,40,48
76,8478519,Anthony Cirelli,C,TBL,27,81,26,21,47
76,8476872,Scott Laughton,C,PHI,30,74,25,22,47
76,8478401,Pavel Zacha,C,BOS,27,80,22,25,47
76,8478466,Daniel Sprong,R,VAN,27,75,22,25,47
76,8478047,Michael Bunting,L,PIT,29,72,20,27,47
76,8482699,Dylan Guenther,R,UTA,21,76,19,28,47
76,8476854,Hampus Lindholm,D,BOS,30,73,12,35,47
76,8481604,Pavel Dorofeyev,L,VGK,24,73,20,26,46
76,8479365,Trent Frederic,C,BOS,26,77,20,26,46
76,8478038,Devon Toews,D,COL,30,68,19,27,46
76,8477503,Max Domi,C,TOR,29,78,18,28,46
76,8476882,Teuvo Teravainen,C,CHI,30,68,13,33,46
76,8475794,Tyler Seguin,C,DAL,32,78,23,22,45
76,8480798,Philipp Kurashev,C,CHI,25,64,22,23,45
76,8481560,Arthur Kaliyev,R,LAK,23,81,22,23,45
76,8471214,Alex Ovechkin,L,WSH,39,66,20,25,45
76,8481533,Trevor Zegras,C,ANA,23,70,20,25,45
76,8474150,Mikael Backlund,C,CGY,35,67,19,26,45
76,8482093,Seth Jarvis,C,CAR,22,68,17,28,45
76,8482113,Anton Lundell,C,FLA,23,72,17,28,45
76,8478438,Tommy Novak,C,NSH,27,70,14,31,45
76,8475784,Jeff Skinner,C,EDM,32,72,20,24,44
76,8475287,Erik Haula,L,NJD,33,66,18,26,44
76,8478856,Conor Garland,R,VAN,28,70,16,28,44
76,8476927,Teddy Blueger,C,VAN,30,71,16,28,44
76,8477495,Seth Jones,D,CHI,30,72,13,31,44
76,8476462,Dougie Hamilton,D,NJD,31,74,12,32,44
76,8484145,Zach Benson,L,BUF,19,66,9,35,44
76,8475169,Evander Kane,L,EDM,33,74,23,20,43
76,8475158,Ryan O'Reilly,C,NSH,33,67,19,24,43
76,8479400,Pierre-Luc Dubois,L,WSH,26,72,18,25,43
76,8475768,Jaden Schwartz,C,SEA,32,73,17,26,43
76,8479987,Morgan Geekie,C,BOS,26,80,15,28,43
76,8483808,Andrei Kuzmenko,L,CGY,28,76,12,31,43
76,8482122,Brock Faber,D,MIN,22,77,12,31,43
76,8473986,Alex Killorn,L,ANA,35,73,11,32,43
76,8479425,Filip Hronek,D,VAN,27,73,10,33,43
76,8477021,Alex Kerfoot,C,UTA,30,73,8,35,43
76,8484153,Leo Carlsson,C,ANA,20,70,15,27,42
76,8476792,Torey Krug,D,STL,33,72,14,28,42
76,8482110,Dawson Mercer,C,NJD,23,72,24,17,41
76,8482175,JJ Peterka,R,BUF,22,68,24,17,41
76,8482055,Drew O'Connor,L,PIT,26,63,23,18,41
76,8479525,Ross Colton,C,COL,28,81,22,19,41
76,8481554,Kaapo Kakko,R,NYR,23,74,19,22,41
76,8480871,Adam Boqvist,D,FLA,24,72,19,22,41
76,8476458,Ryan Strome,C,ANA,31,70,10,31,41
76,8478115,Pierre Engvall,L,NYI,28,77,10,31,41
76,8480188,Fabian Zetterlund,L,SJS,25,68,9,32,41
76,8476292,Ondrej Palat,L,NJD,33,71,9,32,41
76,8475753,Justin Faulk,D,STL,32,73,8,33,41
76,8477447,Shea Theodore,D,VGK,29,70,7,34,41
76,8474565,Alex Pietrangelo,D,VGK,34,63,6,35,41
76,8483431,Logan Cooley,C,UTA,20,75,23,17,40
76,8475722,Jason Zucker,L,BUF,32,70,21,19,40
76,8478462,Nicolas Roy,C,VGK,27,75,15,25,40
76,8474715,Cameron Atkinson,R,TBL,35,79,23,16,39
76,8477964,Ivan Barbashev,C,VGK,29,73,18,21,39
76,8480893,Kirill Marchenko,R,CBJ,24,61,16,23,39
76,8479339,Patrik Laine,L,CBJ,26,70,14,25,39
76,8480835,Jack Drury,C,CAR,24,62,12,27,39
76,8477346,MacKenzie Weegar,D,CGY,30,71,11,28,39
76,8474563,Drew Doughty,D,LAK,35,74,7,32,39
76,8474590,John Carlson,D,WSH,34,67,6,33,39
76,8477451,Ryan Hartman,R,MIN,30,70,19,19,38
76,8482705,Cole Sillinger,C,CBJ,21,66,18,20,38
76,8482702,Logan Stankoven,C,DAL,21,78,16,22,38
76,8478042,Viktor Arvidsson,L,EDM,31,75,15,23,38
76,8476826,Yanni Gourde,C,SEA,33,71,13,25,38
76,8478542,Evan Rodrigues,C,FLA,31,78,10,28,38
76,8482660,Kent Johnson,C,CBJ,22,64,10,28,38
76,8482146,Luke Evangelista,R,NSH,22,64,10,28,38
76,8477511,Anthony Mantha,R,CGY,30,73,18,19,37
76,8475793,Ryan Johansen,C,PHI,32,72,15,22,37
76,8478233,Andrew Mangiapane,L,WSH,28,61,14,23,37
76,8481186,Logan O'Connor,R,COL,28,78,14,23,37
76,8475151,Kyle Palmieri,C,NYI,33,78,13,24,37
76,8477429,Andrew Copp,C,DET,30,78,9,28,37
76,8476958,Jaccob Slavin,D,CAR,30,80,7,30,37
76,8478133,Jake Evans,C,MTL,28,73,7,30,37
76,8475764,Cam Fowler,D,ANA,33,76,2,35,37
76,8481032,Paul Cotter,C,NJD,25,57,21,15,36
76,8475760,Nick Bjugstad,C,UTA,32,75,18,18,36
76,8481535,Nils Hoglander,L,VAN,24,67,15,21,36
76,8478472,Mathieu Joseph,R,STL,27,69,10,26,36
76,8476875,Mike Matheson,D,MTL,30,72,9,27,36
76,8476869,Brady Skjei,D,NSH,30,74,8,28,36
76,8476923,Damon Severson,D,CBJ,30,77,6,30,36
76,8479410,Mikhail Sergachev,D,UTA,26,71,5,31,36
76,8478474,Lawson Crouse,L,UTA,27,71,19,16,35
76,8481524,Bowen Byram,D,BUF,23,65,18,17,35
76,8482475,Yegor Chinakhov,R,CBJ,23,69,17,18,35
76,8484166,Adam Fantilli,C,CBJ,20,65,16,19,35
76,8482097,Jack Quinn,R,BUF,23,62,13,22,35
76,8479345,Jakob Chychrun,D,WSH,26,69,12,23,35
76,8475193,Tomas Tatar,L,NJD,34,68,10,25,35
76,8481546,Cam York,D,PHI,23,68,5,30,35
76,8480113,Alex Iafallo,L,WPG,31,71,17,17,34
76,8477497,Sean Monahan,C,CBJ,30,65,13,21,34
76,8482720,Matthew Knies,L,TOR,22,75,13,21,34
76,8480220,Noah Cates,L,PHI,25,65,13,21,34
76,8478458,John (Jack) Roslovic,C,CAR,27,72,12,22,34
76,8473422,Nick Foligno,L,CHI,37,60,12,22,34
76,8482133,Thomas Bordeleau,C,SJS,22,67,10,24,34
76,8476463,Jonas Brodin,D,MIN,31,78,9,25,34
76,8482667,William Eklund,L,SJS,22,65,8,26,34
76,8476885,Jacob Trouba,D,NYR,30,72,7,27,34
76,8478046,Danton Heinen,L,VAN,29,71,20,13,33
76,8482125,Alexander Holtz,R,VGK,22,68,19,14,33
76,8477426,Nicholas Paul,L,TBL,29,81,17,16,33
76,8477479,Tyler Bertuzzi,L,CHI,29,66,15,18,33
76,8475791,Taylor Hall,L,CHI,33,52,15,18,33
76,8470621,Corey Perry,R,EDM,39,75,15,18,33
76,8477444,Andre Burakovsky,L,SEA,29,65,13,20,33
76,8479591,Michael Eyssimont,C,TBL,28,80,13,20,33
76,8475714,Calle Jarnkrok,C,TOR,33,76,13,20,33
76,8480748,Kiefer Sherwood,L,VAN,29,65,13,20,33
76,8481577,Philip Tomasino,C,NSH,23,68,10,23,33
76,8476906,Shayne Gostisbehere,D,CAR,31,74,9,24,33
76,8482149,Cole Perfetti,C,WPG,22,68,8,25,33
76,8482712,Oskar Olausson,R,COL,22,79,6,27,33
76,8478055,Gustav Forsling,D,FLA,28,70,4,29,33
76,8477969,Marcus Pettersson,D,PIT,28,76,4,29,33
76,8477478,William Carrier,L,CAR,30,61,20,12,32
76,8476925,Colton Sissons,C,NSH,31,68,16,16,32
76,8476474,Stefan Noesen,R,NJD,31,70,15,17,32
76,8481618,Alex Newhook,C,MTL,23,73,14,18,32
76,8477947,Sonny Milano,L,WSH,28,66,13,19,32
76,8478463,Anthony Beauvillier,L,PIT,27,64,9,23,32
76,8481542,Moritz Seider,D,DET,23,77,7,25,32
76,8480336,Sean Walker,D,CAR,30,70,7,25,32
76,8482105,Jake Sanderson,D,OTT,22,73,6,26,32
76,8479619,Michael Carcone,L,UTA,28,66,19,12,31
76,8477952,Robby Fabbri,C,ANA,28,59,18,13,31
76,8478020,Michael Amadio,R,OTT,28,78,15,16,31
76,8476480,Vladislav Namestnikov,C,WPG,32,67,14,17,31
76,8478413,Jordan Greenway,L,BUF,27,66,13,18,31
76,8483505,Matthew Poitras,C,BOS,20,74,12,19,31
76,8475218,Mattias Ekholm,D,EDM,34,79,12,19,31
76,8475149,Marcus Johansson,L,MIN,34,63,12,19,31
76,8476921,Jordan Martinook,L,CAR,32,64,10,21,31
76,8474716,Jared Spurgeon,D,MIN,35,79,7,24,31
76,8483490,Pavel Mintyukov,D,ANA,21,71,5,26,31
76,8474151,Ryan McDonagh,D,TBL,35,79,3,28,31
76,8477506,Ryan Pulock,D,NYI,30,80,3,28,31
76,8476981,Josh Anderson,R,MTL,30,67,15,15,30
76,8480813,Joe Veleno,C,DET,24,76,14,16,30
76,8477987,Ryan Donato,C,CHI,28,62,14,16,30
76,8479992,Michael Rasmussen,C,DET,25,80,14,16,30
76,8471698,T.J. Oshie,R,WSH,38,71,11,19,30
76,8482671,Owen Power,D,BUF,22,68,10,20,30
76,8480817,K'Andre Miller,D,NYR,24,72,4,26,30
76,8482117,Lukas Reichel,L,CHI,22,61,14,15,29
76,8480849,Barrett Hayton,C,UTA,24,66,13,16,29
76,8476438,Brandon Saad,L,STL,32,63,13,16,29
76,8480009,Eeli Tolvanen,R,SEA,25,66,13,16,29
76,8480185,Eetu Luostarinen,C,FLA,26,72,12,17,29
76,8482142,Jamie Drysdale,D,PHI,22,62,11,18,29
76,8474053,Logan Couture,C,SJS,35,58,10,19,29
76,8481581,Thomas Harley,D,DAL,23,71,10,19,29
76,8476902,Esa Lindell,D,DAL,30,79,7,22,29
76,8475220,Marcus Foligno,L,MIN,33,60,18,10,28
76,8479390,Taylor Raddysh,R,WSH,26,62,16,12,28
76,8476278,Colin Blackwell,C,DAL,31,75,15,13,28
76,8479393,Noah Gregor,L,OTT,26,74,13,15,28
76,8474149,Evgenii Dadonov,R,DAL,35,82,12,16,28
76,8479351,Sam Steel,C,DAL,26,82,10,18,28
76,8478911,Matt Roy,D,WSH,29,66,9,19,28
76,8476931,Jake McCabe,D,TOR,31,72,9,19,28
76,8478416,Erik Cernak,D,TBL,27,77,8,20,28
76,8481656,Aliaksei Protas,C,WSH,23,66,5,23,28
76,8480434,Sean Durzi,D,UTA,26,65,4,24,28
76,8481582,Nicholas Robertson,L,TOR,23,69,17,10,27
76,8473533,Jordan Staal,C,CAR,36,63,15,12,27
76,8474641,Adam Henrique,C,EDM,34,69,13,14,27
76,8480289,Morgan Barron,C,WPG,26,55,10,17,27
76,8482079,Marco Rossi,C,MIN,23,57,9,18,27
76,8476461,Sean Couturier,C,PHI,32,67,8,19,27
76,8475763,Kevin Hayes,R,PIT,32,67,8,19,27
76,8478136,Jake Middleton,D,MIN,28,75,8,19,27
76,8475171,Oliver Ekman-Larsson,D,TOR,33,71,4,23,27
76,8479398,Samuel Girard,D,COL,26,67,3,24,27
76,8482089,Jake Neighbours,L,STL,22,73,17,9,26
76,8477953,Kasperi Kapanen,R,STL,28,77,15,11,26
76,8477505,Alexander Wennberg,C,SJS,30,65,13,13,26
76,8483457,Lane Hutson,D,MTL,20,66,13,13,26
76,8480205,Emil Bemstrom,C,PIT,25,53,12,14,26
76,8476419,Jean-Gabriel Pageau,C,NYI,32,75,9,17,26
76,8478500,Ivan Provorov,D,CBJ,27,80,4,22,26
76,8481703,Valtteri Puustinen,R,PIT,25,63,3,23,26
76,8481580,Connor McMichael,C,WSH,23,62,14,11,25
76,8477989,Christian Dvorak,C,MTL,28,64,13,12,25
76,8477839,Conor Sheary,L,TBL,32,82,12,13,25
76,8484203,Bradly Nadeau,L,CAR,19,58,12,13,25
76,8479368,Max Jones,L,BOS,26,69,12,13,25
76,8480829,Jesperi Kotkaniemi,C,CAR,24,62,11,14,25
76,8480025,MacKenzie Entwistle,R,FLA,25,59,11,14,25
76,8478891,Mason Appleton,C,WPG,28,58,10,15,25
76,8479996,Cody Glass,C,NSH,25,58,9,16,25
76,8476392,Adam Lowry,C,WPG,31,64,9,16,25
76,8477499,Rasmus Ristolainen,D,PHI,30,64,8,17,25
76,8482101,Danil Gushchin,L,SJS,22,52,7,18,25
76,8479983,Mario Ferraro,D,SJS,26,72,4,21,25
76,8475343,Nic Dowd,C,WSH,34,62,12,12,24
76,8480459,Pius Suter,C,VAN,28,68,11,13,24
76,8476329,Travis Boyd,C,MIN,31,56,9,15,24
76,8477498,Darnell Nurse,D,EDM,29,68,7,17,24
76,8482624,Daniil Miromanov,D,CGY,27,71,5,19,24
76,8476979,Erik Gustafsson,D,DET,32,75,5,19,24
76,8476312,Josh Manson,D,COL,33,64,5,19,24
76,8480873,Rasmus Sandin,D,WSH,24,57,4,20,24
76,8476429,Scott Mayfield,D,NYI,32,71,4,20,24
76,8475179,Dmitry Kulikov,D,FLA,34,61,3,21,24
76,8474574,Tyler Myers,D,VAN,34,68,2,22,24
76,8479336,Carl Grundstrom,R,SJS,27,50,14,9,23
76,8477425,Miles Wood,L,COL,29,77,13,10,23
76,8477392,Hudson Fasching,R,NYI,29,70,12,11,23
76,8480003,Jesper Boqvist,C,FLA,26,68,11,12,23
76,8480078,Filip Chytil,C,NYR,25,71,10,13,23
76,8477507,Nikita Zadorov,D,BOS,29,68,9,14,23
76,8477450,Jason Dickinson,C,CHI,29,56,9,14,23
76,8483482,Tristan Luneau,D,ANA,20,59,8,15,23
76,8481477,Nico Sturm,C,SJS,29,58,8,15,23
76,8478211,Dryden Hunt,L,CGY,29,56,7,16,23
76,8481441,Joe Snively,C,DET,28,64,7,16,23
76,8476856,Mathew Dumba,D,DAL,30,77,6,17,23
76,8479353,Brett Howden,C,VGK,26,71,6,17,23
76,8476917,Adam Pelech,D,NYI,30,78,5,18,23
76,8482073,Braden Schneider,D,NYR,23,66,5,18,23
76,8480145,Neal Pionk,D,WPG,29,69,4,19,23
76,8480073,Erik Brannstrom,D,COL,25,62,4,19,23
76,8477488,Brett Pesce,D,NJD,30,67,3,20,23
76,8480035,Henri Jokiharju,D,BUF,25,63,2,21,23
76,8474673,TJ Brodie,D,CHI,34,61,0,23,23
76,8480806,Isac Lundestrom,C,ANA,25,54,13,9,22
76,8479414,Nathan Bastian,R,NJD,27,57,12,10,22
76,8478057,Dakota Joshua,C,VAN,28,71,10,12,22
76,8476897,Oskar Sundqvist,C,STL,30,67,10,12,22
76,8477369,Carson Soucy,D,VAN,30,64,9,13,22
76,8483565,Nick Blankenburg,D,NSH,26,60,8,14,22
76,8477446,Michael McCarron,R,NSH,29,60,8,14,22
76,8481521,Ronnie Attard,D,PHI,25,56,8,14,22
76,8481523,Kirby Dach,C,MTL,23,65,7,15,22
76,8482062,Cole Smith,L,NSH,29,56,7,15,22
76,8475848,Brendan Gallagher,R,MTL,32,65,6,16,22
76,8478882,Vladislav Gavrikov,D,LAK,29,66,5,17,22
76,8482067,Connor Mackey,D,NYR,28,65,3,19,22
76,8480049,Dylan Samberg,D,WPG,25,67,3,19,22
76,8476879,Cody Ceci,D,EDM,31,70,3,19,22
76,8479998,Mikey Anderson,D,LAK,25,58,2,20,22
76,8482655,Janis Moser,D,TBL,24,74,0,22,22
76,8481481,Blake Lizotte,C,PIT,27,67,15,6,21
76,8482074,Connor Zary,C,CGY,23,60,10,11,21
76,8483524,Shane Wright,C,SEA,20,64,9,12,21
76,8482809,Jackson Blake,R,CAR,21,58,9,12,21
76,8484149,Gavin Brindley,C,CBJ,20,49,9,12,21
76,8480855,Jack McBain,C,UTA,24,67,7,14,21
76,8477435,Ryan Graves,D,PIT,29,76,6,15,21
76,8479324,Ryan Lindgren,D,NYR,26,62,6,15,21
76,8480802,Ryan McLeod,C,BUF,25,64,5,16,21
76,8476891,Matthew Grzelcyk,D,PIT,30,72,4,17,21
76,8475200,Dmitry Orlov,D,CAR,33,71,3,18,21
76,8478851,Alexandre Carrier,D,NSH,28,59,3,18,21
76,8476892,Colton Parayko,D,STL,31,71,2,19,21
76,8480043,Timothy Liljegren,D,TOR,25,71,2,19,21
76,8476457,Adam Larsson,D,SEA,32,68,2,19,21
76,8475181,Nick Leddy,D,STL,33,68,2,19,21
76,8477015,Connor Brown,R,EDM,30,62,11,9,20
76,8476918,Jimmy Vesey,L,NYR,31,66,11,9,20
76,8478109,Victor Olofsson,L,VGK,29,67,10,10,20
76,8482737,Zack Bolduc,C,STL,21,57,10,10,20
76,8476878,Zemgus Girgensons,C,TBL,30,82,9,11,20
76,8477979,Nicolas Aube-Kubel,R,BUF,28,60,8,12,20
76,8474189,Lars Eller,C,PIT,35,65,7,13,20
76,8476467,Jamie Oleksiak,D,SEA,32,63,6,14,20
76,8476988,Matt Benning,D,SJS,30,62,6,14,20
76,8478013,Jake Walman,D,SJS,28,71,5,15,20
76,8476331,Dylan DeMelo,D,WPG,31,68,5,15,20
76,8481599,Victor Soderstrom,D,UTA,23,47,5,15,20
76,8480878,Nils Lundkvist,D,DAL,24,72,4,16,20
76,8473507,Jeff Petry,D,DET,37,69,4,16,20
76,8473563,Nicklas Backstrom,C,WSH,37,59,4,16,20
76,8478507,John Marino,D,UTA,27,65,3,17,20
76,8480789,Oliver Wahlstrom,R,NYI,24,71,13,6,19
76,8481624,Ilya Mikheyev,R,CHI,30,64,11,8,19
76,8476469,Joel Armia,R,MTL,31,68,11,8,19
76,8476442,Matt Nieto,L,PIT,32,54,11,8,19
76,8478569,Noel Acciari,C,PIT,33,57,10,9,19
76,8481553,Bobby Brink,R,PHI,23,59,9,10,19
76,8480980,Connor Dewar,C,TOR,25,63,9,10,19
76,8477508,Curtis Lazar,C,NJD,29,59,9,10,19
76,8477903,Garnet Hathaway,R,PHI,33,62,9,10,19
76,8479066,Ryan Lomberg,L,CGY,30,67,9,10,19
76,8481617,Vasily Podkolzin,R,VAN,23,48,9,10,19
76,8476374,Sean Kuraly,C,CBJ,31,53,8,11,19
76,8478970,Jalen Chatfield,D,CAR,28,69,7,12,19
76,8475231,Casey Cizikas,C,NYI,33,72,7,12,19
76,8483445,Cutter Gauthier,L,ANA,20,61,6,13,19
76,8481093,Rafael Harvey-Pinard,L,MTL,25,57,5,14,19
76,8474034,Patrick Maroon,L,CHI,36,46,5,14,19
76,8482634,Alex Steeves,C,TOR,25,51,4,15,19
76,8479639,Dylan Coghlan,D,WPG,26,57,4,15,19
76,8477220,Nate Schmidt,D,FLA,33,61,1,18,19
76,8480281,Alexey Toropchenko,R,STL,25,56,12,6,18
76,8479316,Luke Kunin,C,SJS,27,51,11,7,18
76,8480068,Ryan Poehling,C,PHI,25,70,9,9,18
76,8479661,Tanner Jeannot,L,LAK,27,76,8,10,18
76,8473453,Trevor Lewis,C,LAK,37,76,8,10,18
76,8479718,Alex Barré-Boulet,C,MTL,27,51,8,10,18
76,8479976,Juuso Valimaki,D,UTA,26,69,5,13,18
76,8483491,Ivan Miroshnichenko,L,WSH,20,57,5,13,18
76,8479986,Kole Lind,R,DAL,26,49,5,13,18
76,8483468,Jiri Kulich,C,BUF,20,58,4,14,18
76,8476960,Andreas Athanasiou,C,CHI,30,48,3,15,18
76,8481606,Jordan Spence,D,LAK,23,66,3,15,18
76,8481019,David Gustafsson,C,WPG,24,44,3,15,18
76,8475455,Brenden Dillon,D,NJD,34,55,3,15,18
76,8476525,Colin Miller,D,WPG,32,65,3,15,18
76,8480246,Nick Perbix,D,TBL,26,75,2,16,18
76,8475233,David Savard,D,MTL,34,62,2,16,18
76,8478452,Caleb Jones,D,LAK,27,53,1,17,18
76,8481028,Martin Pospisil,C,CGY,25,62,12,5,17
76,8481601,Simon Holmstrom,R,NYI,23,62,11,6,17
76,8483493,Frank Nazar,C,CHI,20,57,11,6,17
76,8479344,Jesse Puljujarvi,R,PIT,26,44,10,7,17
76,8479293,Brandon Tanev,L,SEA,33,65,10,7,17
76,8475855,Jesper Fast,R,CAR,33,57,9,8,17
76,8482157,Will Cuylle,L,NYR,22,61,9,8,17
76,8482749,Joshua Roy,R,MTL,21,67,8,9,17
76,8477919,Frederick Gaudreau,C,MIN,31,60,8,9,17
76,8481537,Nikita Okhotiuk,D,CGY,24,55,8,9,17
76,8480074,Alexandre Texier,C,STL,25,57,7,10,17
76,8483499,Liam Ohgren,L,MIN,20,50,7,10,17
76,8478432,Christian Fischer,R,DET,27,70,6,11,17
76,8478585,Derek Ryan,C,EDM,38,66,6,11,17
76,8480157,Calle Rosen,D,COL,30,46,6,11,17
76,8479026,Philippe Myers,D,TOR,27,53,4,13,17
76,8475225,Craig Smith,C,CHI,35,49,4,13,17
76,8482111,Justin Barron,D,MTL,23,66,3,14,17
76,8475279,Ben Chiarot,D,DET,33,65,3,14,17
76,8475690,Chris Tanev,D,TOR,35,60,3,14,17
76,8479315,Joey Anderson,R,CHI,26,50,2,15,17
76,8479941,Justin Danforth,R,CBJ,31,50,12,4,16
76,8480021,Jack Studnicka,C,LAK,25,55,11,5,16
76,8482166,Shakir Mukhamadullin,D,SJS,22,64,10,6,16
76,8476822,Luke Glendening,C,TBL,35,80,9,7,16
76,8478508,Yakov Trenin,C,MIN,27,64,9,7,16
76,8477070,Liam O'Brien,C,UTA,30,55,9,7,16
76,8476873,Mark Jankowski,C,NSH,30,54,8,8,16
76,8481517,Brett Leason,R,ANA,25,54,8,8,16
76,8482784,Zach Dean,C,STL,21,50,8,8,16
76,8481013,Jonatan Berggren,R,DET,24,59,7,9,16
76,8482807,Ethan Del Mastro,D,CHI,21,51,7,9,16
76,8480441,Trey Fix-Wolansky,R,CBJ,25,38,6,10,16
76,8478434,Keegan Kolesar,R,VGK,27,68,5,11,16
76,8479982,Conor Timmins,D,TOR,26,51,5,11,16
76,8476422,Mike Reilly,D,NYI,31,77,4,12,16
76,8481704,Juuso Parssinen,C,NSH,23,53,3,13,16
76,8480727,Zach Whitecloud,D,VGK,28,50,3,13,16
76,8477938,Haydn Fleury,D,WPG,28,52,3,13,16
76,8478840,Will Borgen,D,SEA,28,61,2,14,16
76,8477845,Trevor van Riemsdyk,D,WSH,33,66,1,15,16
76,8482148,Hendrix Lapierre,C,WSH,22,43,10,5,15
76,8478451,Ethan Bear,D,WSH,27,52,7,8,15
76,8477573,Nathan Walker,L,STL,30,46,6,9,15
76,8476994,Vinnie Hinostroza,C,NSH,30,55,5,10,15
76,8478178,Darren Raddysh,D,TBL,28,65,4,11,15
76,8481014,Alexander Romanov,D,NYI,24,76,2,13,15
76,8481522,Peyton Krebs,C,BUF,23,63,2,13,15
76,8475790,Erik Gudbranson,D,CBJ,32,76,1,14,15
76,8482087,Kaiden Guhle,D,MTL,22,63,1,14,15
76,8481178,Egor Zamula,D,PHI,24,54,1,14,15
76,8476624,Barclay Goodrow,C,SJS,31,50,9,5,14
76,8480448,Parker Kelly,L,COL,25,69,9,5,14
76,8478421,A.J. Greer,L,FLA,28,62,8,6,14
76,8482762,Simon Edvinsson,D,DET,21,52,7,7,14
76,8478043,Sam Lafferty,C,BUF,29,58,6,8,14
76,8481527,Kaedan Korczak,D,VGK,23,48,5,9,14
76,8479369,Andrew Peeke,D,BOS,26,57,4,10,14
76,8477931,Tomas Nosek,L,FLA,32,62,4,10,14
76,8479543,Michael Pezzetta,L,MTL,26,56,4,10,14
76,8480807,Mattias Samuelsson,D,BUF,24,46,3,11,14
76,8474568,Luke Schenn,D,NSH,35,48,3,11,14
76,8481161,Jake Christiansen,D,CBJ,25,58,3,11,14
76,8477365,Connor Clifton,D,BUF,29,59,2,12,14
76,8480891,Michael Kesselring,D,UTA,24,59,1,13,14
76,8479371,Dante Fabbro,D,NSH,26,62,1,13,14
76,8476967,Brett Kulak,D,EDM,30,61,1,13,14
76,8476874,Olli Maatta,D,DET,30,63,1,13,14
76,8478399,Jonas Siegenthaler,D,NJD,27,63,1,13,14
76,8479328,Julien Gauthier,R,NYI,27,66,8,5,13
76,8477353,Tyler Motte,C,DET,29,69,6,7,13
76,8477406,Mattias Janmark,C,EDM,32,65,6,7,13
76,8483466,Kevin Korchinski,D,CHI,20,57,6,7,13
76,8482176,Wyatt Kaiser,D,CHI,22,51,6,7,13
76,8479981,Jonah Gadjovich,L,FLA,26,50,6,7,13
76,8482744,James Malatesta,L,CBJ,21,50,6,7,13
76,8476889,Radek Faksa,C,STL,30,60,5,8,13
76,8480848,Ty Dellandrea,C,SJS,24,48,5,8,13
76,8475462,Radko Gudas,D,ANA,34,63,3,10,13
76,8475177,Calvin de Haan,D,COL,33,42,3,10,13
76,8482192,Isaak Phillips,D,CHI,23,48,2,11,13
76,8480860,Kevin Bahl,D,CGY,24,52,2,11,13
76,8478859,Niko Mikkola,D,FLA,28,54,1,12,13
76,8480222,Sebastian Aho,D,PIT,28,68,1,12,13
76,8481059,Scott Perunovich,D,STL,26,62,0,13,13
76,8480001,Urho Vaakanainen,D,ANA,25,65,0,13,13
76,8481716,Dmitri Voronkov,L,CBJ,24,45,9,3,12
76,8476934,Brock McGinn,L,ANA,30,54,8,4,12
76,8476372,Nick Seeler,D,PHI,31,46,7,5,12
76,8481518,Nolan Foote,L,NJD,24,41,6,6,12
76,8481598,Philip Broberg,D,EDM,23,39,5,7,12
76,8476867,Brendan Gaunce,C,MIN,30,44,5,7,12
76,8480845,Rasmus Kupari,C,WPG,24,47,4,8,12
76,8482245,Artem Zub,D,OTT,29,70,3,9,12
76,8480144,David Kampf,C,TOR,29,71,3,9,12
76,8471709,Marc-Edouard Vlasic,D,SJS,37,62,3,9,12
76,8475208,Brian Dumoulin,D,ANA,33,62,3,9,12
76,8470600,Ryan Suter,D,STL,39,58,3,9,12
76,8482077,Dylan Holloway,L,EDM,23,49,3,9,12
76,8479402,Jake Bean,D,CGY,26,65,2,10,12
76,8475324,Nick Jensen,D,OTT,34,62,2,10,12
76,8475718,Justin Holl,D,DET,32,64,2,10,12
76,8479348,Kale Clague,D,BUF,26,35,2,10,12
76,8480887,Jordan Harris,D,MTL,24,57,2,10,12
76,8482095,Tyler Kleven,D,OTT,22,46,2,10,12
76,8481701,Santeri Hatakka,D,NJD,23,47,1,11,12
76,8482803,Olen Zellweger,D,ANA,21,62,6,5,11
76,8480252,Cole Guttman,C,CHI,25,39,6,5,11
76,8477380,Jonny Brodzinski,C,NYR,31,48,6,5,11
76,8480355,Mark Kastelic,C,BOS,25,58,5,6,11
76,8481592,Jakob Pelletier,L,CGY,23,38,5,6,11
76,8482155,Alex Laferriere,R,LAK,23,60,4,7,11
76,8479439,Jacob MacDonald,D,COL,31,50,4,7,11
76,8480870,Bo Groulx,C,NYR,24,35,4,7,11
76,8482659,Josh Doan,R,UTA,22,53,3,8,11
76,8480058,Pierre-Olivier Joseph,D,STL,25,53,3,8,11
76,8477851,Jordan Oesterle,D,BOS,32,45,3,8,11
76,8479994,Jaret Anderson-Dolan,C,WPG,25,29,3,8,11
76,8481167,Brayden Pachal,D,CGY,25,45,2,9,11
76,8479372,Joshua Mahura,D,SEA,26,51,1,10,11
76,8479359,Beck Malenstyn,L,BUF,26,43,7,3,10
76,8480995,Pontus Holmberg,R,TOR,25,58,7,3,10
76,8481754,Nikita Nesterenko,C,ANA,23,45,7,3,10
76,8483495,Simon Nemec,D,NJD,20,49,6,4,10
76,8482679,Matt Coronato,R,CGY,22,59,5,5,10
76,8479370,Tyson Jost,C,CAR,26,54,5,5,10
76,8480011,Klim Kostin,C,SJS,25,41,5,5,10
76,8480762,Eric Robinson,L,CAR,29,52,4,6,10
76,8482451,Mikael Pyyhtia,L,CBJ,23,41,4,6,10
76,8471817,Ryan Reaves,R,TOR,37,56,4,6,10
76,8482861,Vincent Iorio,D,WSH,22,42,4,6,10
76,8480192,Johnathan Kovacevic,D,NJD,27,50,4,6,10
76,8480796,Martin Fehervary,D,WSH,25,44,3,7,10
76,8478443,Brandon Carlo,D,BOS,28,54,2,8,10
76,8483460,David Jiricek,D,CBJ,21,55,2,8,10
76,8481568,Alex Vlasic,D,CHI,23,45,2,8,10
76,8484254,Akito Hirose,D,VAN,25,43,2,8,10
76,8474567,Zach Bogosian,D,MIN,34,58,2,8,10
76,8479536,Axel Jonsson-Fjallby,L,WPG,26,36,2,8,10
76,8479249,Andrew Poturalski,C,SJS,30,35,1,9,10
76,8482259,Bobby McMann,C,TOR,28,60,6,3,9
76,8482496,Nils Aman,C,VAN,24,29,6,3,9
76,8481789,Tye Kartye,L,SEA,23,40,5,4,9
76,8479442,Troy Stecher,D,EDM,30,50,5,4,9
76,8477887,Patrick Brown,C,BOS,32,38,5,4,9
76,8480844,Grigori Denisenko,L,VGK,24,27,4,5,9
76,8481679,Maxence Guenette,D,OTT,23,37,4,5,9
76,8479291,Kevin Rooney,C,CGY,31,54,3,6,9
76,8476952,Dominic Toninato,C,WPG,30,46,3,6,9
76,8477482,Zachary Sanford,L,CHI,30,42,3,6,9
76,8481708,Zac Jones,D,NYR,24,46,3,6,9
76,8471677,Jack Johnson,D,CBJ,37,64,3,6,9
76,8481550,Adam Beckman,L,NJD,23,38,3,6,9
76,8480990,Declan Chisholm,D,MIN,24,30,3,6,9
76,8477962,Brendan Lemieux,L,CAR,28,37,3,6,9
76,8482144,Jack Thompson,D,SJS,22,29,3,6,9
76,8481567,Henry Thrun,D,SJS,23,46,2,7,9
76,8478468,Jeremy Lauzon,D,NSH,27,57,2,7,9
76,8477384,Joshua Brown,D,EDM,30,52,2,7,9
76,8474166,Alec Martinez,D,CHI,37,49,1,8,9
76,8474013,Ian Cole,D,UTA,35,52,1,8,9
76,8482964,Arber Xhekaj,D,MTL,23,53,1,8,9
76,8481600,Tobias Bjornfot,D,FLA,23,42,1,8,9
76,8478450,Parker Wotherspoon,D,BOS,27,30,0,9,9
76,8476858,Phillip Di Giuseppe,L,VAN,31,40,6,2,8
76,8480880,Jakub Lauko,C,MIN,24,37,5,3,8
76,8481751,Lukas Rousek,R,BUF,25,42,4,4,8
76,8480172,Jan Rutta,D,SJS,34,66,4,4,8
76,8479379,Givani Smith,R,SJS,26,35,4,4,8
76,8478017,Mark Friedman,D,VAN,29,35,3,5,8
76,8481641,Joel Kiviranta,L,COL,28,71,3,5,8
76,8484911,Collin Graf,R,SJS,22,36,3,5,8
76,8481122,Simon Benoit,D,TOR,26,37,3,5,8
76,8481147,Reese Johnson,C,MIN,26,35,2,6,8
76,8473446,Erik Johnson,D,PHI,36,44,2,6,8
76,8482141,Lukas Cormier,D,VGK,22,29,2,6,8
76,8478454,Noah Juulsen,D,VAN,27,44,2,6,8
76,8476473,Connor Murphy,D,CHI,31,46,2,6,8
76,8474090,Brendan Smith,D,DAL,35,48,1,7,8
76,8475762,Derek Forbort,D,VAN,32,42,1,7,8
76,8480196,Jacob Bryson,D,BUF,27,43,1,7,8
76,8475842,Sam Carrick,C,NYR,32,57,1,7,8
76,8479980,Nicolas Hague,D,VGK,26,45,0,8,8
76,8483619,Filip Roos,D,OTT,25,42,0,8,8
76,8479968,Vinni Lettieri,C,BOS,29,48,5,2,7
76,8479638,Justin Brazeau,R,BOS,26,36,5,2,7
76,8483397,Marc McLaughlin,C,BOS,25,27,4,3,7
76,8483570,Ben Meyers,C,SEA,26,29,4,3,7
76,8482165,Yan Kuznetsov,D,CGY,22,15,4,3,7
76,8481056,Spencer Stastney,D,NSH,24,41,4,3,7
76,8482859,Zack Ostapchuk,C,OTT,21,55,3,4,7
76,8482747,Brennan Othmann,L,NYR,21,38,3,4,7
76,8481719,Maxwell Crozier,D,TBL,24,15,3,4,7
76,8483630,Pavol Regenda,L,ANA,25,36,3,4,7
76,8482145,Mavrik Bourque,C,DAL,22,54,2,5,7
76,8479520,Brandon Duhaime,R,WSH,27,56,2,5,7
76,8480292,Carson Meyer,R,ANA,27,29,1,6,7
76,8476913,Devin Shore,C,MIN,30,32,1,6,7
76,8475188,Brayden McNabb,D,VGK,33,53,0,7,7
76,8480950,Ilya Lyubushkin,D,DAL,30,62,0,7,7
76,8478831,Kevin Stenlund,C,UTA,28,58,6,0,6
76,8479944,Zach Aston-Reese,C,VGK,30,51,5,1,6
76,8481532,Alex Turcotte,C,LAK,23,52,4,2,6
76,8482177,Marat Khusnutdinov,C,MIN,22,41,4,2,6
76,8479671,Mathieu Olivier,R,CBJ,27,50,3,3,6
76,8482751,Ryan Winterton,C,SEA,21,29,3,3,6
76,8478146,Matthew Highmore,C,OTT,28,33,3,3,6
76,8482666,Scott Morrow,D,CAR,22,51,3,3,6
76,8478409,Anthony Richard,C,PHI,28,34,3,3,6
76,8479985,Cale Fleury,D,SEA,26,32,3,3,6
76,8477462,Robert Hagg,D,VGK,29,27,3,3,6
76,8482765,Isak Rosen,R,BUF,21,26,3,3,6
76,8480070,Ian Mitchell,D,BOS,25,57,2,4,6
76,8477335,Kyle Burroughs,D,LAK,29,38,2,4,6
76,8480890,Jan Jenik,C,OTT,24,25,2,4,6
76,8482730,Brandt Clarke,D,LAK,21,49,1,5,6
76,8481609,Vladislav Kolyachonok,D,UTA,23,36,1,5,6
76,8479576,Vincent Desharnais,D,VAN,28,30,1,5,6
76,8478502,Dennis Gilbert,D,BUF,28,23,1,5,6
76,8480007,Jonas Rondbjerg,R,VGK,25,42,1,5,6
76,8482094,Daemon Hunt,D,MIN,22,22,1,5,6
76,8474062,Riley Nash,C,NYR,35,16,1,5,6
76,8478874,Adam Gaudette,R,OTT,28,42,0,6,6
76,8477018,Ben Hutton,D,VGK,31,42,3,2,5
76,8477401,John Hayden,C,SEA,29,36,3,2,5
76,8477034,Jaycob Megna,D,FLA,32,42,3,2,5
76,8479320,Maxime Lajoie,D,SEA,27,29,3,2,5
76,8478424,Jansen Harkins,C,ANA,27,44,3,2,5
76,8482652,Walker Duehr,R,CGY,27,36,2,3,5
76,8479772,Zack MacEwen,R,OTT,28,46,2,3,5
76,8483549,Lucas Condotta,L,MTL,27,33,2,3,5
76,8480245,Olle Lycksell,R,PHI,25,30,2,3,5
76,8482172,Landon Slaggert,L,CHI,22,22,2,3,5
76,8474612,Travis Hamonic,D,OTT,34,49,1,4,5
76,8476441,Joel Edmundson,D,LAK,31,50,1,4,5
76,8480879,Jacob Bernard-Docker,D,OTT,24,42,1,4,5
76,8480834,Ty Emberson,D,SJS,24,20,1,4,5
76,8482733,Logan Mailloux,D,MTL,31,34,1,4,5
76,8482858,Ryker Evans,D,SEA,23,23,1,4,5
76,8482460,Matt Rempe,C,NYR,22,14,4,0,4
76,8482511,Mason Lohrei,D,BOS,23,30,3,1,4
76,8483012,Logan Morrison,C,SEA,22,36,3,1,4
76,8482070,Mitchell Chaffee,R,TBL,26,46,3,1,4
76,8480468,James Hamblin,L,EDM,25,23,3,1,4
76,8479991,Jake Leschyshyn,C,NYR,25,29,3,1,4
76,8479378,Logan Stanley,D,WPG,26,36,2,2,4
76,8479419,Brett Murray,L,BUF,26,18,2,2,4
76,8475795,Dylan McIlrath,D,WSH,32,16,2,2,4
76,8475958,Michael Sgarbossa,C,WSH,32,31,2,2,4
76,8481006,Tyler Tucker,D,STL,24,17,2,2,4
76,8484304,Uvis Balinskis,D,FLA,28,15,2,2,4
76,8475750,Jon Merrill,D,MIN,32,62,1,3,4
76,8482153,Brendan Brisson,C,VGK,23,36,1,3,4
76,8481593,Jayden Struble,D,MTL,23,19,1,3,4
76,8482102,Vasily Ponomarev,C,PIT,22,20,1,3,4
76,8480267,Sammy Walker,C,MIN,25,21,0,4,4
76,8479587,Rhett Gardner,C,PHI,28,28,0,4,4
76,8480306,Grant Hutton,D,NYI,29,8,3,0,3
76,8480851,Akil Thomas,C,LAK,24,19,2,1,3
76,8478477,Mitchell Stephens,C,SEA,27,15,2,1,3
76,8482713,Mackie Samoskevich,R,FLA,22,30,2,1,3
76,8478881,Brett Seney,L,CHI,28,9,2,1,3
76,8483763,Maksymilian Szuber,D,UTA,22,24,1,2,3
76,8479972,Mason Shaw,C,WPG,26,36,1,2,3
76,8475235,Nicolas Deslauriers,L,PHI,33,56,1,2,3
76,8479362,Riley Tufte,L,BOS,26,20,1,2,3
76,8484258,Sam Malinski,D,COL,26,25,1,2,3
76,8478051,Max Willman,C,NJD,29,17,1,2,3
76,8483512,Matthew Savoie,C,EDM,20,25,1,2,3
76,8481462,Mason Morelli,L,VGK,28,7,1,2,3
76,8479367,William Lockwood,R,FLA,26,27,1,2,3
76,8482787,Nikita Chibrikov,R,WPG,31,6,1,2,3
76,8481585,Egor Afanasyev,L,SJS,23,17,1,2,3
76,8481605,Jackson LaCombe,D,ANA,23,34,0,3,3
76,8478021,William Lagesson,D,DET,28,27,0,3,3
76,8482470,Ilya Solovyov,D,CGY,24,17,0,3,3
76,8477527,Ross Johnston,L,ANA,30,35,2,0,2
76,8481556,John Beecher,C,BOS,23,33,2,0,2
76,8481422,Jake Lucchini,C,NSH,29,17,2,0,2
76,8481237,Kyle MacLean,C,NYI,25,18,2,0,2
76,8477149,Scott Sabourin,R,SJS,32,19,2,0,2
76,8481564,Ryan Johnson,D,BUF,23,14,2,0,2
76,8483567,Georgii Merkulov,C,BOS,24,6,2,0,2
76,8481065,Angus Crookshank,L,OTT,25,15,2,0,2
76,8483489,Fraser Minten,C,TOR,31,13,2,0,2
76,8477971,Andreas Englund,D,LAK,28,28,1,1,2
76,8477473,Justin Bailey,R,SJS,29,27,1,1,2
76,8482147,Jean-Luc Foudy,C,COL,22,26,1,1,2
76,8484325,Waltteri Merela,C,TBL,26,23,1,1,2
76,8482929,Emil Lilleberg,D,TBL,23,22,1,1,2
76,8481699,Aku Raty,R,UTA,23,12,1,1,2
76,8481541,Samuel Bolduc,D,NYI,24,23,1,1,2
76,8481806,Louis Crevier,D,CHI,23,12,1,1,2
76,8477320,Anton Blidh,L,NYR,29,17,0,2,2
76,8477810,Joel Hanley,D,CGY,33,27,0,2,2
76,8482201,Gage Goncalves,C,TBL,23,25,0,2,2
76,8481578,Graeme Clarke,R,MIN,23,9,0,2,2
76,8477073,Kurtis MacDermid,L,NJD,30,27,0,2,2
76,8477244,Chad Ruhwedel,D,NYR,34,27,0,2,2
76,8481206,John Ludvig,D,PIT,24,20,0,2,2
76,8480075,Cameron Crotty,D,MIN,25,11,0,2,2
76,8481030,Jack St. Ivany,D,PIT,25,16,0,2,2
76,8476323,Max McCormick,L,SEA,32,6,0,2,2
76,8484287,Cole McWard,D,VAN,23,17,1,0,1
76,8482088,Justin Sourdif,R,FLA,22,14,1,0,1
76,8481743,Marc Del Gaizo,D,NSH,25,14,1,0,1
76,8481726,Adam Edstrom,C,NYR,24,5,1,0,1
76,8480032,Shane Bowers,C,NJD,25,17,1,0,1
76,8482126,Emil Andrae,D,PHI,31,2,1,0,1
76,8475780,Chris Wagner,R,COL,33,8,1,0,1
76,8480874,Adam Ginning,D,PHI,24,13,1,0,1
76,8478147,Bokondji Imama,L,PIT,28,7,1,0,1
76,8483531,Brian Halonen,L,NJD,25,5,1,0,1
76,8482516,Matthew Kessel,D,STL,24,18,0,1,1
76,8481543,Nikita Alexandrov,C,STL,24,20,0,1,1
76,8482118,Sam Colangelo,R,ANA,23,12,0,1,1
76,8475755,Alexander Petrovic,D,DAL,32,3,0,1,1
76,8482476,Emil Heineman,L,MTL,23,7,0,1,1
76,8478446,Glenn Gawdin,C,LAK,27,9,0,1,1
76,8483395,Arshdeep Bains,L,VAN,23,8,0,1,1
76,8483432,Luca Del Bel Belluz,C,CBJ,31,1,0,1,1
76,8475413,Justin Dowling,C,NJD,34,17,0,1,1
76,8482197,Adam Raska,R,MIN,23,8,0,1,1
76,8483398,Declan Carlile,D,TBL,31,5,0,1,1
76,8477467,Gustav Olofsson,D,SEA,30,21,0,0,0
76,8482250,Callahan Burke,C,VGK,27,21,0,0,0
76,8477993,Justin Kirkland,C,CGY,28,8,0,0,0
76,8478011,Louie Belpedio,D,PHI,28,9,0,0,0
76,8479330,Brandon Gignac,C,MTL,27,9,0,0,0
76,8481043,Cole Koepke,L,BOS,26,17,0,0,0
76,8477541,Dakota Mermis,D,TOR,30,9,0,0,0
76,8482061,Brandon Biro,L,SEA,26,13,0,0,0
76,8482162,Roby Jarventie,L,EDM,22,12,0,0,0
76,8480823,Alexander Alexeyev,D,WSH,25,8,0,0,0
76,8483471,Brad Lambert,C,WPG,31,10,0,0,0
76,8483546,Marshall Rifai,D,TOR,26,1,0,0,0
76,8483597,Milos Kelemen,L,UTA,25,9,0,0,0
76,8479421,Jacob Moverare,D,LAK,26,10,0,0,0
76,8478854,Ryan Shea,D,PIT,27,7,0,0,0
76,8484326,Patrik Koch,D,UTA,28,4,0,0,0
76,8483407,Brandon Scanlin,D,NYR,25,9,0,0,0
76,8481024,Linus Karlsson,C,VAN,25,7,0,0,0
76,8480084,Nick DeSimone,D,NJD,30,17,0,0,0
76,8483920,Pierrick Dube,R,WSH,23,6,0,0,0
76,8481655,Cole Schwindt,R,CGY,23,6,0,0,0
76,8479522,Hardy Haman Aktell,D,WSH,26,5,0,0,0
76,8480274,Philip Kemp,D,EDM,25,0,0,0,0
76,8484255,Jason Polin,R,COL,25,5,0,0,0
76,8483609,Adam Klapka,R,CGY,24,4,0,0,0
76,8481534,Raphael Lavoie,C,EDM,24,2,0,0,0
76,8483401,Marc Johnstone,R,PIT,28,0,0,0,0
76,8484259,Ondrej Pavel,C,COL,31,3,0,0,0
76,8484321,Nikolas Matinpalo,D,OTT,26,1,0,0,0
76,8470794,Joe Pavelski,C,,40,0,0,0,0
76,8479321,Lucas Johansen,D,,27,0,0,0,0
76,8477950,Tony DeAngelo,D,,29,0,0,0,0
76,8471218,Blake Wheeler,R,,38,0,0,0,0
76,8475197,Tyson Barrie,D,,33,0,0,0,0
76,8474157,Max Pacioretty,L,,36,0,0,0,0
76,8475744,Evgeny Kuznetsov,C,,32,0,0,0,0
76,8474037,James van Riemsdyk,L,,35,0,0,0,0
76,8476907,Mackenzie MacEachern,L,,30,0,0,0,0
76,8480216,Jacob Peterson,C,,25,0,0,0,0
76,8474602,Justin Schultz,D,,34,0,0,0,0
76,8482222,Alexander Barabanov,L,,30,0,0,0,0
76,8474031,Kevin Shattenkirk,D,,35,0,0,0,0
76,8477330,Dominik Kubalik,L,,29,0,0,0,0
76,8480884,Calen Addison,D,,24,0,0,0,0
76,8475906,John Klingberg,D,,32,0,0,0,0
76,8480008,Adam Ruzicka,C,,25,0,0,0,0
76,8476884,Derrick Pouliot,D,,30,0,0,0,0
76,8476919,Chris Tierney,C,,30,0,0,0,0
76,8479415,Michael McLeod,C,,26,0,0,0,0
76,8474870,Tyler Johnson,C,,34,0,0,0,0
76,8470604,Jeff Carter,C,,39,0,0,0,0
76,8478104,Sammy Blais,L,,28,0,0,0,0
76,8474884,Mike Hoffman,C,,35,0,0,0,0
76,8481591,Sam Poulin,R,,23,0,0,0,0
76,8471274,Alex Goligoski,D,,39,0,0,0,0
76,8476871,Tanner Pearson,L,,32,0,0,0,0
76,8476393,Nick Cousins,C,,31,0,0,0,0
76,8479977,Kailer Yamamoto,R,,26,0,0,0,0
76,8479346,Dillon Dube,C,,26,0,0,0,0
76,8480184,Gustav Lindstrom,D,,26,0,0,0,0
76,8479376,Victor Mete,D,,26,0,0,0,0
76,8473449,Kyle Okposo,R,,36,0,0,0,0
76,8481058,Jesse Ylonen,R,,25,0,0,0,0
76,8475752,Tyler Pitlick,C,,33,0,0,0,0
76,8481239,Samuel Fagemo,L,,24,0,0,0,0
76,8480821,Filip Zadina,R,,25,0,0,0,0
76,8470966,Mark Giordano,D,,41,0,0,0,0
76,8478495,Denis Gurianov,R,,27,0,0,0,0
76,8477464,Nic Petan,C,,29,0,0,0,0
76,8478099,Kevin Labanc,R,,29,0,0,0,0
76,8482241,Radim Zohorna,L,,28,0,0,0,0
76,8474040,Sam Gagner,C,,35,0,0,0,0
76,8479514,Rem Pitlick,C,,27,0,0,0,0
76,8478430,Oliver Kylington,D,,27,0,0,0,0
76,8479533,Joona Koppanen,L,,26,0,0,0,0
76,8479984,Cal Foote,D,,26,0,0,0,0
76,8477126,Jayson Megna,C,,34,0,0,0,0
76,8475164,Jakob Silfverberg,R,,34,0,0,0,0
76,8474009,Nick Bonino,C,,36,0,0,0,0
76,8479458,Nikita Zaitsev,D,,33,0,0,0,0
76,8477944,Jakub Vrana,L,,28,0,0,0,0
76,8471699,Andrew Cogliano,C,,37,0,0,0,0
76,8478067,Oskar Lindblom,L,,28,0,0,0,0
76,8471686,Marc Staal,D,,37,0,0,0,0
76,8470610,Zach Parise,L,,40,0,0,0,0
76,8478904,Steven Lorentz,C,,28,0,0,0,0
76,8473473,Milan Lucic,L,,36,0,0,0,0
76,8480031,Maxime Comtois,L,,25,0,0,0,0
76,8478512,Austin Czarnik,C,,32,0,0,0,0
76,8473504,Cal Clutterbuck,R,,37,0,0,0,0
76,8477454,Adam Erne,L,,29,0,0,0,0
76,8479383,Boris Katchouk,L,,26,0,0,0,0
76,8475825,Jani Hakanpää,D,,32,0,0,0,0
76,8477846,Ryan Carpenter,C,,33,0,0,0,0
76,8477930,Pierre-Edouard Bellemare,L,,39,0,0,0,0
76,8478400,Colin White,C,,27,0,0,0,0
76,8480226,Marián Studenic,R,,26,0,0,0,0
76,8480853,Liam Foudy,C,,24,0,0,0,0
76,8475797,Jarred Tinordi,D,,32,0,0,0,0
76,8479423,Alex Nylander,L,,26,0,0,0,0
76,8474618,Marco Scandella,D,,34,0,0,0,0
76,8478028,Fredrik Olofsson,L,,28,0,0,0,0
76,8474709,Matt Martin,L,,35,0,0,0,0
76,8481070,Hugh McGing,L,,26,0,0,0,0
76,8479546,Oskar Steen,C,,26,0,0,0,0
76,8474145,Robert Bortuzzo,D,,35,0,0,0,0
76,8476915,Jujhar Khaira,L,,30,0,0,0,0
76,8475278,Byron Froese,C,,33,0,0,0,0
76,8481812,Nikolai Knyzhov,D,,27,0,0,0,0
76,8478408,Travis Dermott,D,,28,0,0,0,0
76,8481077,John Leonard,L,,26,0,0,0,0
76,8479547,Matthew Phillips,R,,26,0,0,0,0
76,8480836,Jonathan Gruden,C,,24,0,0,0,0
76,8481690,Tyler Angle,C,,24,0,0,0,0
76,8475766,Austin Watson,L,,32,0,0,0,0
76,8481016,Ruslan Iskhakov,C,,24,0,0,0,0
76,8478078,Rourke Chartier,C,,28,0,0,0,0
76,8480776,Sheldon Rempal,R,,29,0,0,0,0
76,8478956,Samuel Laberge,L,NJD,27,0,0,0,0
76,8483045,Cameron Butler,R,CBJ,31,3,0,0,0
76,8484314,Jiri Smejkal,L,,28,0,0,0,0
77,8478402,Connor McDavid,C,EDM,27,79,44,112,156
77,8477492,Nathan MacKinnon,C,COL,29,81,58,89,147
77,8476453,Nikita Kucherov,R,TBL,31,81,35,90,125
77,8477934,Leon Draisaitl,C,EDM,29,74,37,75,112
77,8477956,David Pastrnak,R,BOS,28,79,50,57,107
77,8479318,Auston Matthews,C,TOR,27,78,52,54,106
77,8477493,Aleksander Barkov,C,FLA,29,80,28,78,106
77,8481559,Jack Hughes,C,NJD,23,76,46,59,105
77,8478420,Mikko Rantanen,R,COL,28,79,43,59,102
77,8478483,Mitch Marner,R,TOR,27,76,34,67,101
77,8478010,Brayden Point,C,TBL,28,81,46,53,99
77,8477404,Jake Guentzel,C,TBL,30,82,48,50,98
77,8478550,Artemi Panarin,L,NYR,33,76,38,59,97
77,8478864,Kirill Kaprizov,L,MIN,27,68,36,61,97
77,8475166,John Tavares,C,TOR,34,81,37,59,96
77,8480027,Jason Robertson,L,DAL,25,81,29,67,96
77,8480801,Brady Tkachuk,L,OTT,25,80,42,53,95
77,8477940,Nikolaj Ehlers,L,WPG,28,71,40,55,95
77,8479314,Matthew Tkachuk,L,FLA,27,77,27,68,95
77,8479343,Clayton Keller,R,UTA,26,76,37,57,94
77,8477942,Kevin Fiala,L,LAK,28,81,38,55,93
77,8479385,Jordan Kyrou,C,STL,26,76,44,48,92
77,8476468,J.T. Miller,C,VAN,31,73,38,54,92
77,8479407,Jesper Bratt,L,NJD,26,77,29,63,92
77,8478439,Travis Konecny,R,PHI,27,78,37,50,87
77,8476887,Filip Forsberg,L,NSH,30,75,36,51,87
77,8480800,Quinn Hughes,D,VAN,25,77,6,81,87
77,8477960,Adrian Kempe,R,LAK,28,80,40,46,86
77,8476459,Mika Zibanejad,C,NYR,31,78,34,52,86
77,8478873,Troy Terry,R,ANA,27,74,26,59,85
77,8480865,Noah Dobson,D,NYI,24,80,11,74,85
77,8478398,Kyle Connor,L,WPG,28,71,41,43,84
77,8477500,Bo Horvat,C,NYI,29,80,39,45,84
77,8480012,Elias Pettersson,C,VAN,26,78,31,53,84
77,8477933,Sam Reinhart,C,FLA,29,79,37,46,83
77,8480023,Robert Thomas,C,STL,25,77,26,57,83
77,8479420,Tage Thompson,C,BUF,27,76,41,41,82
77,8477946,Dylan Larkin,C,DET,28,82,40,42,82
77,8475913,Mark Stone,R,VGK,32,75,32,50,82
77,8478445,Mathew Barzal,C,NYI,27,78,25,57,82
77,8477504,Josh Morrissey,D,WPG,29,77,19,63,82
77,8475810,Bryan Rust,R,PIT,32,75,37,44,81
77,8476346,Johnny Gaudreau,L,CBJ,31,75,21,60,81
77,8478444,Brock Boeser,R,VAN,27,76,36,44,80
77,8476389,Vincent Trocheck,C,NYR,31,79,29,51,80
77,8478403,Jack Eichel,C,VGK,28,80,37,42,79
77,8480018,Nick Suzuki,C,MTL,25,76,34,45,79
77,8471214,Alex Ovechkin,L,WSH,39,76,41,37,78
77,8477939,William Nylander,R,TOR,28,80,40,37,77
77,8478427,Sebastian Aho,C,CAR,27,73,27,50,77
77,8480069,Cale Makar,D,COL,26,62,21,56,77
77,8477409,Carter Verhaeghe,C,FLA,29,76,35,41,76
77,8471215,Evgeni Malkin,C,PIT,38,70,30,46,76
77,8474141,Patrick Kane,R,DET,36,80,25,51,76
77,8476460,Mark Scheifele,C,WPG,31,75,34,41,75
77,8473419,Brad Marchand,L,BOS,36,82,28,47,75
77,8480002,Nico Hischier,C,NJD,25,72,26,49,75
77,8478401,Pavel Zacha,C,BOS,27,79,24,50,74
77,8480036,Miro Heiskanen,D,DAL,25,78,16,58,74
77,8473994,Jamie Benn,L,DAL,35,80,32,41,73
77,8475172,Nazem Kadri,C,CGY,34,78,25,47,72
77,8482078,Lucas Raymond,L,DET,22,79,23,49,72
77,8476454,Ryan Nugent-Hopkins,C,EDM,31,75,23,49,72
77,8478414,Timo Meier,R,NJD,28,76,35,36,71
77,8475754,Brock Nelson,C,NYI,33,80,32,39,71
77,8477496,Elias Lindholm,C,BOS,30,79,27,44,71
77,8475786,Zach Hyman,L,EDM,32,80,41,29,70
77,8474641,Adam Henrique,C,EDM,34,75,38,32,70
77,8478047,Michael Bunting,L,PIT,29,79,35,35,70
77,8481557,Matt Boldy,L,MIN,23,67,36,33,69
77,8478449,Roope Hintz,C,DAL,28,82,34,35,69
77,8479542,Brandon Hagel,L,TBL,26,82,30,39,69
77,8480803,Evan Bouchard,D,EDM,25,75,23,46,69
77,8473512,Claude Giroux,R,OTT,36,79,20,49,69
77,8478460,Zach Werenski,D,CBJ,27,77,20,49,69
77,8475184,Chris Kreider,L,NYR,33,79,36,32,68
77,8476881,Tomas Hertl,C,VGK,31,79,30,38,68
77,8481540,Cole Caufield,R,MTL,23,77,30,38,68
77,8481068,Yegor Sharangovich,C,CGY,26,81,30,38,68
77,8476448,William Karlsson,C,VGK,31,81,28,40,68
77,8479337,Alex DeBrincat,R,DET,27,81,26,42,68
77,8471675,Sidney Crosby,C,PIT,37,73,23,45,68
77,8475167,Victor Hedman,D,TBL,34,78,11,57,68
77,8477501,Valeri Nichushkin,R,COL,29,80,30,37,67
77,8480830,Andrei Svechnikov,R,CAR,24,75,29,38,67
77,8484144,Connor Bedard,C,CHI,19,66,24,43,67
77,8474578,Erik Karlsson,D,PIT,34,78,10,57,67
77,8475692,Mats Zuccarello,R,MIN,37,73,21,45,66
77,8482745,Mason McTavish,C,ANA,21,76,28,37,65
77,8478440,Dylan Strome,C,WSH,27,74,22,43,65
77,8476456,Jonathan Huberdeau,C,CGY,31,74,14,51,65
77,8479323,Adam Fox,D,NYR,26,74,10,55,65
77,8474564,Steven Stamkos,C,NSH,34,70,31,33,64
77,8477951,Nick Schmaltz,C,UTA,28,77,29,35,64
77,8476483,Rickard Rakell,R,PIT,31,72,27,37,64
77,8478493,Joel Eriksson Ek,C,MIN,27,71,26,38,64
77,8477949,Alex Tuch,R,BUF,28,71,25,39,64
77,8477402,Pavel Buchnevich,L,STL,29,69,16,48,64
77,8479675,Trevor Moore,L,LAK,29,78,28,35,63
77,8482116,Tim Stützle,C,OTT,22,78,21,42,63
77,8475158,Ryan O'Reilly,C,NSH,33,69,21,42,63
77,8476905,Chandler Stephenson,C,SEA,30,72,20,43,63
77,8477935,Sam Bennett,C,FLA,28,75,31,29,60
77,8482699,Dylan Guenther,R,UTA,21,75,29,31,60
77,8477955,Jared McCann,L,SEA,28,73,28,32,60
77,8475784,Jeff Skinner,C,EDM,32,73,27,33,60
77,8479999,Casey Mittelstadt,C,COL,26,82,21,39,60
77,8475168,Matt Duchene,C,DAL,33,82,19,41,60
77,8481542,Moritz Seider,D,DET,23,71,13,47,60
77,8480015,Owen Tippett,R,PHI,25,72,28,31,59
77,8474586,Jordan Eberle,R,SEA,34,73,19,40,59
77,8476875,Mike Matheson,D,MTL,30,79,5,54,59
77,8477494,Jonathan Drouin,L,COL,29,80,18,40,58
77,8475170,Brayden Schenn,C,STL,33,76,29,28,57
77,8476539,Jonathan Marchessault,R,NSH,34,75,26,31,57
77,8482149,Cole Perfetti,C,WPG,22,72,22,35,57
77,8482159,Tyson Foerster,R,PHI,22,73,29,27,56
77,8477497,Sean Monahan,C,CBJ,30,70,24,32,56
77,8480208,Drake Batherson,R,OTT,26,80,23,33,56
77,8474102,David Perron,L,OTT,36,78,23,33,56
77,8475765,Vladimir Tarasenko,R,DET,33,76,22,34,56
77,8481528,Dylan Cozens,C,BUF,23,67,21,35,56
77,8478366,Frank Vatrano,R,ANA,30,74,32,23,55
77,8477407,Anthony Duclair,L,NYI,29,77,26,29,55
77,8471685,Anze Kopitar,C,LAK,37,81,22,33,55
77,8479400,Pierre-Luc Dubois,L,WSH,26,68,21,34,55
77,8482665,Matty Beniers,C,SEA,22,72,18,37,55
77,8474563,Drew Doughty,D,LAK,35,76,12,43,55
77,8477447,Shea Theodore,D,VGK,29,67,10,45,55
77,8475314,Anders Lee,L,NYI,34,78,32,22,54
77,8479365,Trent Frederic,C,BOS,26,77,28,26,54
77,8482093,Seth Jarvis,C,CAR,22,64,24,30,54
77,8475745,Charlie Coyle,C,BOS,32,74,21,33,54
77,8474600,Roman Josi,D,NSH,34,73,17,37,54
77,8482124,Quinton Byfield,R,LAK,22,81,15,39,54
77,8482110,Dawson Mercer,C,NJD,23,68,28,25,53
77,8480039,Martin Necas,C,CAR,25,69,18,35,53
77,8476479,Phillip Danault,C,LAK,31,77,18,35,53
77,8484166,Adam Fantilli,C,CBJ,20,70,26,26,52
77,8481618,Alex Newhook,C,MTL,23,75,24,28,52
77,8483515,Juraj Slafkovsky,L,MTL,20,77,22,30,52
77,8477511,Anthony Mantha,R,CGY,30,75,25,26,51
77,8482740,Wyatt Johnston,C,DAL,21,81,23,28,51
77,8477476,Artturi Lehkonen,L,COL,29,82,23,28,51
77,8479345,Jakob Chychrun,D,WSH,26,70,19,32,51
77,8475191,Reilly Smith,R,NYR,33,72,17,34,51
77,8477503,Max Domi,C,TOR,29,77,17,34,51
77,8480839,Rasmus Dahlin,D,BUF,24,65,15,36,51
77,8478407,Vince Dunn,D,SEA,28,73,15,36,51
77,8479987,Morgan Geekie,C,BOS,26,73,15,36,51
77,8477495,Seth Jones,D,CHI,30,69,13,38,51
77,8479425,Filip Hronek,D,VAN,27,74,10,41,51
77,8478519,Anthony Cirelli,C,TBL,27,82,24,26,50
77,8479992,Michael Rasmussen,C,DET,25,80,23,27,50
77,8475151,Kyle Palmieri,C,NYI,33,79,21,29,50
77,8478856,Conor Garland,R,VAN,28,77,18,32,50
77,8476792,Torey Krug,D,STL,33,76,8,42,50
77,8482113,Anton Lundell,C,FLA,23,79,23,26,49
77,8484145,Zach Benson,L,BUF,19,69,22,27,49
77,8477986,Brandon Montour,D,SEA,30,78,19,30,49
77,8478042,Viktor Arvidsson,L,EDM,31,77,16,33,49
77,8476906,Shayne Gostisbehere,D,CAR,31,75,14,35,49
77,8478397,Rasmus Andersson,D,CGY,28,74,12,37,49
77,8481711,Matias Maccelli,L,UTA,24,75,12,37,49
77,8475794,Tyler Seguin,C,DAL,32,82,25,23,48
77,8477964,Ivan Barbashev,C,VGK,29,77,22,26,48
77,8478975,Mason Marchment,L,DAL,29,80,20,28,48
77,8477346,MacKenzie Weegar,D,CGY,30,71,12,36,48
77,8471724,Kris Letang,D,PIT,37,79,10,38,48
77,8475726,Tyler Toffoli,C,SJS,32,72,29,18,47
77,8479525,Ross Colton,C,COL,28,80,25,22,47
77,8471698,T.J. Oshie,R,WSH,38,64,25,22,47
77,8482175,JJ Peterka,R,BUF,22,71,21,26,47
77,8480220,Noah Cates,L,PHI,25,77,18,29,47
77,8480028,Morgan Frost,C,PHI,25,74,16,31,47
77,8482720,Matthew Knies,L,TOR,22,75,15,32,47
77,8474590,John Carlson,D,WSH,34,62,13,34,47
77,8479325,Charlie McAvoy,D,BOS,27,72,11,36,47
77,8476853,Morgan Rielly,D,TOR,30,64,5,42,47
77,8476432,Boone Jenner,C,CBJ,31,66,23,23,46
77,8477456,J.T. Compher,L,DET,29,81,18,28,46
77,8477416,Oliver Bjorkstrand,R,SEA,29,75,17,29,46
77,8477021,Alex Kerfoot,C,UTA,30,74,15,31,46
77,8481524,Bowen Byram,D,BUF,23,66,15,31,46
77,8478469,Thomas Chabot,D,OTT,27,75,14,32,46
77,8478542,Evan Rodrigues,C,FLA,31,75,22,23,45
77,8481596,Shane Pinto,C,OTT,24,73,16,29,45
77,8482097,Jack Quinn,R,BUF,23,74,16,29,45
77,8478115,Pierre Engvall,L,NYI,28,76,14,31,45
77,8475753,Justin Faulk,D,STL,32,73,11,34,45
77,8477948,Travis Sanheim,D,PHI,28,71,7,38,45
77,8481581,Thomas Harley,D,DAL,23,76,6,39,45
77,8477451,Ryan Hartman,R,MIN,30,70,21,23,44
77,8481523,Kirby Dach,C,MTL,23,68,16,28,44
77,8470613,Brent Burns,D,CAR,39,73,14,30,44
77,8476958,Jaccob Slavin,D,CAR,30,75,9,35,44
77,8479410,Mikhail Sergachev,D,UTA,26,69,8,36,44
77,8482109,Alexis Lafrenière,L,NYR,23,73,26,17,43
77,8473986,Alex Killorn,L,ANA,35,73,26,17,43
77,8475793,Ryan Johansen,C,PHI,32,75,24,19,43
77,8478466,Daniel Sprong,R,VAN,27,71,20,23,43
77,8476882,Teuvo Teravainen,C,CHI,30,67,12,31,43
77,8481577,Philip Tomasino,C,NSH,23,69,12,31,43
77,8476419,Jean-Gabriel Pageau,C,NYI,32,79,12,31,43
77,8482684,Luke Hughes,D,NJD,21,62,11,32,43
77,8477998,Warren Foegele,L,LAK,28,82,19,23,42
77,8482475,Yegor Chinakhov,R,CBJ,23,68,19,23,42
77,8477947,Sonny Milano,L,WSH,28,65,18,24,42
77,8475798,Mikael Granlund,C,SJS,32,69,14,28,42
77,8477429,Andrew Copp,C,DET,30,77,14,28,42
77,8476462,Dougie Hamilton,D,NJD,31,72,13,29,42
77,8478038,Devon Toews,D,COL,30,73,8,34,42
77,8478233,Andrew Mangiapane,L,WSH,28,70,8,34,42
77,8483505,Matthew Poitras,C,BOS,20,70,15,26,41
77,8484153,Leo Carlsson,C,ANA,20,74,12,29,41
77,8478458,John (Jack) Roslovic,C,CAR,27,66,12,29,41
77,8474679,Gustav Nyquist,C,NSH,35,73,11,30,41
77,8481533,Trevor Zegras,C,ANA,23,67,11,30,41
77,8480014,Gabriel Vilardi,C,WPG,25,69,22,18,40
77,8480849,Barrett Hayton,C,UTA,24,73,21,19,40
77,8480789,Oliver Wahlstrom,R,NYI,24,71,21,19,40
77,8480064,Josh Norris,C,OTT,25,75,20,20,40
77,8483431,Logan Cooley,C,UTA,20,72,16,24,40
77,8480078,Filip Chytil,C,NYR,25,67,16,24,40
77,8475218,Mattias Ekholm,D,EDM,34,76,13,27,40
77,8478438,Tommy Novak,C,NSH,27,70,12,28,40
77,8483490,Pavel Mintyukov,D,ANA,21,73,12,28,40
77,8476438,Brandon Saad,L,STL,32,66,21,18,39
77,8483808,Andrei Kuzmenko,L,CGY,28,75,18,21,39
77,8479339,Patrik Laine,L,CBJ,26,64,17,22,39
77,8482667,William Eklund,L,SJS,22,63,17,22,39
77,8474565,Alex Pietrangelo,D,VGK,34,58,16,23,39
77,8476880,Tom Wilson,R,WSH,30,67,12,27,39
77,8477987,Ryan Donato,C,CHI,28,61,10,29,39
77,8475799,Nino Niederreiter,R,WPG,32,62,23,15,38
77,8475791,Taylor Hall,L,CHI,33,62,22,16,38
77,8477479,Tyler Bertuzzi,L,CHI,29,60,20,18,38
77,8480459,Pius Suter,C,VAN,28,70,19,19,38
77,8475768,Jaden Schwartz,C,SEA,32,66,17,21,38
77,8480797,Joel Farabee,L,PHI,24,72,16,22,38
77,8477444,Andre Burakovsky,L,SEA,29,72,15,23,38
77,8482122,Brock Faber,D,MIN,22,79,10,28,38
77,8476869,Brady Skjei,D,NSH,30,76,9,29,38
77,8482089,Jake Neighbours,L,STL,22,67,25,12,37
77,8474715,Cameron Atkinson,R,TBL,35,81,21,16,37
77,8476399,Blake Coleman,C,CGY,33,77,19,18,37
77,8481554,Kaapo Kakko,R,NYR,23,68,18,19,37
77,8476826,Yanni Gourde,C,SEA,33,69,16,21,37
77,8474150,Mikael Backlund,C,CGY,35,78,15,22,37
77,8477498,Darnell Nurse,D,EDM,29,73,13,24,37
77,8480009,Eeli Tolvanen,R,SEA,25,71,12,25,37
77,8477505,Alexander Wennberg,C,SJS,30,63,11,26,37
77,8482671,Owen Power,D,BUF,22,69,10,27,37
77,8481656,Aliaksei Protas,C,WSH,23,65,10,27,37
77,8475200,Dmitry Orlov,D,CAR,33,78,9,28,37
77,8481535,Nils Hoglander,L,VAN,24,66,24,12,36
77,8477426,Nicholas Paul,L,TBL,29,81,22,14,36
77,8476278,Colin Blackwell,C,DAL,31,79,22,14,36
77,8480893,Kirill Marchenko,R,CBJ,24,56,21,15,36
77,8474149,Evgenii Dadonov,R,DAL,35,79,21,15,36
77,8478498,Jake DeBrusk,L,VAN,28,70,20,16,36
77,8480798,Philipp Kurashev,C,CHI,25,58,14,22,36
77,8480185,Eetu Luostarinen,C,FLA,26,73,14,22,36
77,8482133,Thomas Bordeleau,C,SJS,22,62,12,24,36
77,8473422,Nick Foligno,L,CHI,37,68,11,25,36
77,8480145,Neal Pionk,D,WPG,29,72,9,27,36
77,8476923,Damon Severson,D,CBJ,30,79,7,29,36
77,8474189,Lars Eller,C,PIT,35,67,19,16,35
77,8479996,Cody Glass,C,NSH,25,63,18,17,35
77,8481560,Arthur Kaliyev,R,LAK,23,76,17,18,35
77,8482055,Drew O'Connor,L,PIT,26,65,17,18,35
77,8480188,Fabian Zetterlund,L,SJS,25,65,14,21,35
77,8475343,Nic Dowd,C,WSH,34,63,14,21,35
77,8475722,Jason Zucker,L,BUF,32,70,13,22,35
77,8475193,Tomas Tatar,L,NJD,34,65,12,23,35
77,8478462,Nicolas Roy,C,VGK,27,73,9,26,35
77,8482105,Jake Sanderson,D,OTT,22,75,8,27,35
77,8480434,Sean Durzi,D,UTA,26,68,6,29,35
77,8475764,Cam Fowler,D,ANA,33,73,3,32,35
77,8477969,Marcus Pettersson,D,PIT,28,79,2,33,35
77,8480336,Sean Walker,D,CAR,30,73,14,20,34
77,8482092,Ridly Greig,C,OTT,22,77,13,21,34
77,8476458,Ryan Strome,C,ANA,31,72,13,21,34
77,8475287,Erik Haula,L,NJD,33,70,12,22,34
77,8478396,Noah Hanifin,D,VGK,27,65,10,24,34
77,8476392,Adam Lowry,C,WPG,31,65,9,25,34
77,8481703,Valtteri Puustinen,R,PIT,25,55,5,29,34
77,8476854,Hampus Lindholm,D,BOS,30,70,4,30,34
77,8476331,Dylan DeMelo,D,WPG,31,67,3,31,34
77,8479390,Taylor Raddysh,R,WSH,26,57,17,16,33
77,8478133,Jake Evans,C,MTL,28,70,16,17,33
77,8481604,Pavel Dorofeyev,L,VGK,24,68,15,18,33
77,8478046,Danton Heinen,L,VAN,29,70,13,20,33
77,8481553,Bobby Brink,R,PHI,23,63,11,22,33
77,8476979,Erik Gustafsson,D,DET,32,77,9,24,33
77,8475760,Nick Bjugstad,C,UTA,32,70,19,13,32
77,8481580,Connor McMichael,C,WSH,23,71,17,15,32
77,8479591,Michael Eyssimont,C,TBL,28,80,16,16,32
77,8476921,Jordan Martinook,L,CAR,32,65,15,17,32
77,8478472,Mathieu Joseph,R,STL,27,70,14,18,32
77,8476474,Stefan Noesen,R,NJD,31,64,13,19,32
77,8482702,Logan Stankoven,C,DAL,21,79,12,20,32
77,8480144,David Kampf,C,TOR,29,68,12,20,32
77,8480817,K'Andre Miller,D,NYR,24,71,4,28,32
77,8476463,Jonas Brodin,D,MIN,31,78,3,29,32
77,8478474,Lawson Crouse,L,UTA,27,71,16,15,31
77,8477425,Miles Wood,L,COL,29,75,16,15,31
77,8478109,Victor Olofsson,L,VGK,29,66,16,15,31
77,8478413,Jordan Greenway,L,BUF,27,57,14,17,31
77,8476461,Sean Couturier,C,PHI,32,63,14,17,31
77,8482157,Will Cuylle,L,NYR,22,69,14,17,31
77,8476872,Scott Laughton,C,PHI,30,69,13,18,31
77,8475763,Kevin Hayes,R,PIT,32,61,13,18,31
77,8478013,Jake Walman,D,SJS,28,72,11,20,31
77,8473533,Jordan Staal,C,CAR,36,65,10,21,31
77,8481606,Jordan Spence,D,LAK,23,65,5,26,31
77,8474151,Ryan McDonagh,D,TBL,35,78,3,28,31
77,8477506,Ryan Pulock,D,NYI,30,74,2,29,31
77,8475169,Evander Kane,L,EDM,33,73,19,11,30
77,8482705,Cole Sillinger,C,CBJ,21,73,11,19,30
77,8479368,Max Jones,L,BOS,26,66,11,19,30
77,8474053,Logan Couture,C,SJS,35,53,10,20,30
77,8478891,Mason Appleton,C,WPG,28,65,10,20,30
77,8480035,Henri Jokiharju,D,BUF,25,69,8,22,30
77,8477932,Aaron Ekblad,D,FLA,28,73,7,23,30
77,8482660,Kent Johnson,C,CBJ,22,61,6,24,30
77,8474673,TJ Brodie,D,CHI,34,65,5,25,30
77,8477488,Brett Pesce,D,NJD,30,68,3,27,30
77,8480835,Jack Drury,C,CAR,24,64,19,10,29
77,8478057,Dakota Joshua,C,VAN,28,69,16,13,29
77,8481186,Logan O'Connor,R,COL,28,80,15,14,29
77,8475848,Brendan Gallagher,R,MTL,32,65,14,15,29
77,8480813,Joe Veleno,C,DET,24,77,12,17,29
77,8484203,Bradly Nadeau,L,CAR,19,70,11,18,29
77,8483445,Cutter Gauthier,L,ANA,20,64,10,19,29
77,8480873,Rasmus Sandin,D,WSH,24,67,7,22,29
77,8482809,Jackson Blake,R,CAR,21,63,7,22,29
77,8477220,Nate Schmidt,D,FLA,33,68,6,23,29
77,8479982,Conor Timmins,D,TOR,26,65,3,26,29
77,8482125,Alexander Holtz,R,VGK,22,72,17,11,28
77,8478020,Michael Amadio,R,OTT,28,75,17,11,28
77,8480829,Jesperi Kotkaniemi,C,CAR,24,65,16,12,28
77,8477953,Kasperi Kapanen,R,STL,28,65,15,13,28
77,8482146,Luke Evangelista,R,NSH,22,68,13,15,28
77,8476480,Vladislav Namestnikov,C,WPG,32,63,13,15,28
77,8476981,Josh Anderson,R,MTL,30,67,12,16,28
77,8470621,Corey Perry,R,EDM,39,70,11,17,28
77,8477392,Hudson Fasching,R,NYI,29,64,11,17,28
77,8477435,Ryan Graves,D,PIT,29,78,11,17,28
77,8483491,Ivan Miroshnichenko,L,WSH,20,61,11,17,28
77,8479351,Sam Steel,C,DAL,26,80,10,18,28
77,8480003,Jesper Boqvist,C,FLA,26,71,10,18,28
77,8482111,Justin Barron,D,MTL,23,66,10,18,28
77,8476927,Teddy Blueger,C,VAN,30,63,8,20,28
77,8475231,Casey Cizikas,C,NYI,33,76,17,10,27
77,8481032,Paul Cotter,C,NJD,25,62,16,11,27
77,8482259,Bobby McMann,C,TOR,28,62,16,11,27
77,8479393,Noah Gregor,L,OTT,26,68,15,12,27
77,8478463,Anthony Beauvillier,L,PIT,27,63,14,13,27
77,8475714,Calle Jarnkrok,C,TOR,33,77,11,16,27
77,8480802,Ryan McLeod,C,BUF,25,71,9,18,27
77,8478970,Jalen Chatfield,D,CAR,28,65,9,18,27
77,8482749,Joshua Roy,R,MTL,21,66,8,19,27
77,8476292,Ondrej Palat,L,NJD,33,69,7,20,27
77,8476917,Adam Pelech,D,NYI,30,75,4,23,27
77,8475462,Radko Gudas,D,ANA,34,65,4,23,27
77,8480995,Pontus Holmberg,R,TOR,25,59,11,15,26
77,8481481,Blake Lizotte,C,PIT,27,63,10,16,26
77,8477989,Christian Dvorak,C,MTL,28,69,9,17,26
77,8477507,Nikita Zadorov,D,BOS,29,68,9,17,26
77,8481521,Ronnie Attard,D,PHI,25,62,7,19,26
77,8476885,Jacob Trouba,D,NYR,30,59,6,20,26
77,8477369,Carson Soucy,D,VAN,30,63,5,21,26
77,8476457,Adam Larsson,D,SEA,32,64,4,22,26
77,8479316,Luke Kunin,C,SJS,27,54,17,8,25
77,8475220,Marcus Foligno,L,MIN,33,63,13,12,25
77,8477952,Robby Fabbri,C,ANA,28,64,12,13,25
77,8482074,Connor Zary,C,CGY,23,64,11,14,25
77,8483524,Shane Wright,C,SEA,20,62,11,14,25
77,8481093,Rafael Harvey-Pinard,L,MTL,25,54,11,14,25
77,8482712,Oskar Olausson,R,COL,22,80,10,15,25
77,8481522,Peyton Krebs,C,BUF,23,58,10,15,25
77,8480068,Ryan Poehling,C,PHI,25,69,8,17,25
77,8478055,Gustav Forsling,D,FLA,28,70,7,18,25
77,8475149,Marcus Johansson,L,MIN,34,69,7,18,25
77,8482624,Daniil Miromanov,D,CGY,27,58,6,19,25
77,8479639,Dylan Coghlan,D,WPG,26,63,4,21,25
77,8476892,Colton Parayko,D,STL,31,69,3,22,25
77,8478500,Ivan Provorov,D,CBJ,27,81,1,24,25
77,8482737,Zack Bolduc,C,STL,21,55,17,7,24
77,8481624,Ilya Mikheyev,R,CHI,30,56,14,10,24
77,8476897,Oskar Sundqvist,C,STL,30,70,12,12,24
77,8479315,Joey Anderson,R,CHI,26,50,12,12,24
77,8477931,Tomas Nosek,L,FLA,32,63,10,14,24
77,8476925,Colton Sissons,C,NSH,31,64,9,15,24
77,8480025,MacKenzie Entwistle,R,FLA,25,62,9,15,24
77,8480855,Jack McBain,C,UTA,24,71,8,16,24
77,8480871,Adam Boqvist,D,FLA,24,72,7,17,24
77,8476960,Andreas Athanasiou,C,CHI,30,53,7,17,24
77,8480887,Jordan Harris,D,MTL,24,61,6,18,24
77,8481546,Cam York,D,PHI,23,64,5,19,24
77,8480073,Erik Brannstrom,D,COL,25,72,5,19,24
77,8480891,Michael Kesselring,D,UTA,24,59,3,21,24
77,8482117,Lukas Reichel,L,CHI,22,52,11,12,23
77,8479353,Brett Howden,C,VGK,26,70,11,12,23
77,8478421,A.J. Greer,L,FLA,28,54,11,12,23
77,8481518,Nolan Foote,L,NJD,24,47,11,12,23
77,8483482,Tristan Luneau,D,ANA,20,59,9,14,23
77,8481441,Joe Snively,C,DET,28,67,7,16,23
77,8474716,Jared Spurgeon,D,MIN,35,78,6,17,23
77,8479976,Juuso Valimaki,D,UTA,26,66,5,18,23
77,8479369,Andrew Peeke,D,BOS,26,67,4,19,23
77,8478882,Vladislav Gavrikov,D,LAK,29,68,1,22,23
77,8482679,Matt Coronato,R,CGY,22,68,14,8,22
77,8482077,Dylan Holloway,L,EDM,23,55,13,9,22
77,8481582,Nicholas Robertson,L,TOR,23,70,11,11,22
77,8477919,Frederick Gaudreau,C,MIN,31,65,11,11,22
77,8478508,Yakov Trenin,C,MIN,27,57,11,11,22
77,8478911,Matt Roy,D,WSH,29,64,7,15,22
77,8482101,Danil Gushchin,L,SJS,22,59,7,15,22
77,8477839,Conor Sheary,L,TBL,32,80,6,16,22
77,8483565,Nick Blankenburg,D,NSH,26,67,5,17,22
77,8476422,Mike Reilly,D,NYI,31,75,5,17,22
77,8480043,Timothy Liljegren,D,TOR,25,67,4,18,22
77,8479398,Samuel Girard,D,COL,26,64,3,19,22
77,8482655,Janis Moser,D,TBL,24,79,3,19,22
77,8475181,Nick Leddy,D,STL,33,67,3,19,22
77,8475455,Brenden Dillon,D,NJD,34,57,3,19,22
77,8478136,Jake Middleton,D,MIN,28,78,2,20,22
77,8475171,Oliver Ekman-Larsson,D,TOR,33,68,2,20,22
77,8478507,John Marino,D,UTA,27,69,2,20,22
77,8479661,Tanner Jeannot,L,LAK,27,74,12,9,21
77,8479619,Michael Carcone,L,UTA,28,65,11,10,21
77,8480806,Isac Lundestrom,C,ANA,25,63,11,10,21
77,8476889,Radek Faksa,C,STL,30,55,10,11,21
77,8480252,Cole Guttman,C,CHI,25,44,8,13,21
77,8482062,Cole Smith,L,NSH,29,61,6,15,21
77,8478434,Keegan Kolesar,R,VGK,27,68,6,15,21
77,8481568,Alex Vlasic,D,CHI,23,49,6,15,21
77,8476931,Jake McCabe,D,TOR,31,66,5,16,21
77,8480246,Nick Perbix,D,TBL,26,73,5,16,21
77,8478452,Caleb Jones,D,LAK,27,61,5,16,21
77,8480049,Dylan Samberg,D,WPG,25,66,4,17,21
77,8476891,Matthew Grzelcyk,D,PIT,30,72,4,17,21
77,8475233,David Savard,D,MTL,34,64,4,17,21
77,8479402,Jake Bean,D,CGY,26,68,4,17,21
77,8476469,Joel Armia,R,MTL,31,58,11,9,20
77,8480748,Kiefer Sherwood,L,VAN,29,55,10,10,20
77,8481601,Simon Holmstrom,R,NYI,23,65,10,10,20
77,8479941,Justin Danforth,R,CBJ,31,61,10,10,20
77,8480289,Morgan Barron,C,WPG,26,51,9,11,20
77,8476525,Colin Miller,D,WPG,32,64,8,12,20
77,8479718,Alex Barré-Boulet,C,MTL,27,51,7,13,20
77,8474034,Patrick Maroon,L,CHI,36,59,5,15,20
77,8482730,Brandt Clarke,D,LAK,21,50,5,15,20
77,8479324,Ryan Lindgren,D,NYR,26,67,4,16,20
77,8470600,Ryan Suter,D,STL,39,63,4,16,20
77,8478840,Will Borgen,D,SEA,28,70,3,17,20
77,8481178,Egor Zamula,D,PHI,24,58,2,18,20
77,8481704,Juuso Parssinen,C,NSH,23,62,12,7,19
77,8477903,Garnet Hathaway,R,PHI,33,59,11,8,19
77,8478569,Noel Acciari,C,PIT,33,60,10,9,19
77,8476873,Mark Jankowski,C,NSH,30,51,10,9,19
77,8477450,Jason Dickinson,C,CHI,29,62,8,11,19
77,8479344,Jesse Puljujarvi,R,PIT,26,53,8,11,19
77,8475855,Jesper Fast,R,CAR,33,54,8,11,19
77,8476856,Mathew Dumba,D,DAL,30,66,7,12,19
77,8479026,Philippe Myers,D,TOR,27,54,7,12,19
77,8477353,Tyler Motte,C,DET,29,72,7,12,19
77,8482142,Jamie Drysdale,D,PHI,22,62,6,13,19
77,8483468,Jiri Kulich,C,BUF,20,60,6,13,19
77,8476994,Vinnie Hinostroza,C,NSH,30,40,6,13,19
77,8477499,Rasmus Ristolainen,D,PHI,30,54,5,14,19
77,8474574,Tyler Myers,D,VAN,34,66,4,15,19
77,8477365,Connor Clifton,D,BUF,29,53,4,15,19
77,8477406,Mattias Janmark,C,EDM,32,72,4,15,19
77,8479983,Mario Ferraro,D,SJS,26,70,3,16,19
77,8476879,Cody Ceci,D,EDM,31,71,3,16,19
77,8481527,Kaedan Korczak,D,VGK,23,44,3,16,19
77,8480860,Kevin Bahl,D,CGY,24,60,3,16,19
77,8476902,Esa Lindell,D,DAL,30,73,2,17,19
77,8481059,Scott Perunovich,D,STL,26,59,2,17,19
77,8482079,Marco Rossi,C,MIN,23,52,10,8,18
77,8483457,Lane Hutson,D,MTL,20,66,10,8,18
77,8479293,Brandon Tanev,L,SEA,33,60,10,8,18
77,8479328,Julien Gauthier,R,NYI,27,59,10,8,18
77,8483493,Frank Nazar,C,CHI,20,47,9,9,18
77,8476918,Jimmy Vesey,L,NYR,31,63,8,10,18
77,8480205,Emil Bemstrom,C,PIT,25,59,7,11,18
77,8477015,Connor Brown,R,EDM,30,60,7,11,18
77,8476878,Zemgus Girgensons,C,TBL,30,80,7,11,18
77,8480021,Jack Studnicka,C,LAK,25,61,7,11,18
77,8482073,Braden Schneider,D,NYR,23,67,6,12,18
77,8478178,Darren Raddysh,D,TBL,28,72,6,12,18
77,8476467,Jamie Oleksiak,D,SEA,32,66,5,13,18
77,8481014,Alexander Romanov,D,NYI,24,79,5,13,18
77,8480113,Alex Iafallo,L,WPG,31,61,4,14,18
77,8482067,Connor Mackey,D,NYR,28,56,4,14,18
77,8476988,Matt Benning,D,SJS,30,66,4,14,18
77,8473507,Jeff Petry,D,DET,37,75,3,15,18
77,8477845,Trevor van Riemsdyk,D,WSH,33,58,3,15,18
77,8479249,Andrew Poturalski,C,SJS,30,40,3,15,18
77,8479998,Mikey Anderson,D,LAK,25,57,2,16,18
77,8482087,Kaiden Guhle,D,MTL,22,60,2,16,18
77,8477478,William Carrier,L,CAR,30,61,8,9,17
77,8480448,Parker Kelly,L,COL,25,77,8,9,17
77,8475324,Nick Jensen,D,OTT,34,68,8,9,17
77,8481599,Victor Soderstrom,D,UTA,23,51,7,10,17
77,8479066,Ryan Lomberg,L,CGY,30,62,6,11,17
77,8478416,Erik Cernak,D,TBL,27,70,5,12,17
77,8479370,Tyson Jost,C,CAR,26,53,5,12,17
77,8477018,Ben Hutton,D,VGK,31,50,5,12,17
77,8477887,Patrick Brown,C,BOS,32,37,4,13,17
77,8480192,Johnathan Kovacevic,D,NJD,27,63,3,14,17
77,8482245,Artem Zub,D,OTT,29,69,2,15,17
77,8481477,Nico Sturm,C,SJS,29,57,8,8,16
77,8477979,Nicolas Aube-Kubel,R,BUF,28,52,8,8,16
77,8480281,Alexey Toropchenko,R,STL,25,56,6,10,16
77,8481537,Nikita Okhotiuk,D,CGY,24,57,6,10,16
77,8482803,Olen Zellweger,D,ANA,21,64,6,10,16
77,8484149,Gavin Brindley,C,CBJ,20,43,4,12,16
77,8476329,Travis Boyd,C,MIN,31,56,3,13,16
77,8481708,Zac Jones,D,NYR,24,59,3,13,16
77,8475208,Brian Dumoulin,D,ANA,33,64,1,15,16
77,8481517,Brett Leason,R,ANA,25,49,10,5,15
77,8480762,Eric Robinson,L,CAR,29,49,9,6,15
77,8476934,Brock McGinn,L,ANA,30,55,8,7,15
77,8476822,Luke Glendening,C,TBL,35,76,7,8,15
77,8478585,Derek Ryan,C,EDM,38,65,6,9,15
77,8479414,Nathan Bastian,R,NJD,27,59,5,10,15
77,8480807,Mattias Samuelsson,D,BUF,24,52,5,10,15
77,8482964,Arber Xhekaj,D,MTL,23,46,5,10,15
77,8477335,Kyle Burroughs,D,LAK,29,43,5,10,15
77,8476312,Josh Manson,D,COL,33,53,4,11,15
77,8475690,Chris Tanev,D,TOR,35,61,4,11,15
77,8478043,Sam Lafferty,C,BUF,29,58,4,11,15
77,8482176,Wyatt Kaiser,D,CHI,22,56,4,11,15
77,8477482,Zachary Sanford,L,CHI,30,45,4,11,15
77,8476952,Dominic Toninato,C,WPG,30,41,3,12,15
77,8478399,Jonas Siegenthaler,D,NJD,27,59,1,14,15
77,8475225,Craig Smith,C,CHI,35,43,9,5,14
77,8481789,Tye Kartye,L,SEA,23,48,9,5,14
77,8478432,Christian Fischer,R,DET,27,70,8,6,14
77,8482166,Shakir Mukhamadullin,D,SJS,22,54,8,6,14
77,8479543,Michael Pezzetta,L,MTL,26,58,7,7,14
77,8481161,Jake Christiansen,D,CBJ,25,56,6,8,14
77,8477380,Jonny Brodzinski,C,NYR,31,49,6,8,14
77,8480355,Mark Kastelic,C,BOS,25,65,6,8,14
77,8482451,Mikael Pyyhtia,L,CBJ,23,43,5,9,14
77,8481641,Joel Kiviranta,L,COL,28,71,5,9,14
77,8481550,Adam Beckman,L,NJD,23,38,4,10,14
77,8480878,Nils Lundkvist,D,DAL,24,73,3,11,14
77,8480796,Martin Fehervary,D,WSH,25,47,3,11,14
77,8476429,Scott Mayfield,D,NYI,32,67,2,12,14
77,8475179,Dmitry Kulikov,D,FLA,34,60,2,12,14
77,8480074,Alexandre Texier,C,STL,25,58,2,12,14
77,8478451,Ethan Bear,D,WSH,27,55,2,12,14
77,8483460,David Jiricek,D,CBJ,21,57,2,12,14
77,8478851,Alexandre Carrier,D,NSH,28,63,1,13,14
77,8475188,Brayden McNabb,D,VGK,33,51,0,14,14
77,8481532,Alex Turcotte,C,LAK,23,52,10,3,13
77,8482155,Alex Laferriere,R,LAK,23,65,9,4,13
77,8477446,Michael McCarron,R,NSH,29,55,8,5,13
77,8481013,Jonatan Berggren,R,DET,24,62,8,5,13
77,8481716,Dmitri Voronkov,L,CBJ,24,45,8,5,13
77,8475842,Sam Carrick,C,NYR,32,60,8,5,13
77,8477508,Curtis Lazar,C,NJD,29,61,7,6,13
77,8479981,Jonah Gadjovich,L,FLA,26,42,7,6,13
77,8483499,Liam Ohgren,L,MIN,20,54,6,7,13
77,8475762,Derek Forbort,D,VAN,32,50,6,7,13
77,8480848,Ty Dellandrea,C,SJS,24,44,5,8,13
77,8478831,Kevin Stenlund,C,UTA,28,52,5,8,13
77,8480157,Calle Rosen,D,COL,30,48,4,9,13
77,8480441,Trey Fix-Wolansky,R,CBJ,25,38,4,9,13
77,8483466,Kevin Korchinski,D,CHI,20,46,4,9,13
77,8476867,Brendan Gaunce,C,MIN,30,49,4,9,13
77,8479439,Jacob MacDonald,D,COL,31,55,4,9,13
77,8479671,Mathieu Olivier,R,CBJ,27,48,3,10,13
77,8480727,Zach Whitecloud,D,VGK,28,54,2,11,13
77,8475790,Erik Gudbranson,D,CBJ,32,75,2,11,13
77,8479348,Kale Clague,D,BUF,26,46,2,11,13
77,8476967,Brett Kulak,D,EDM,30,63,0,13,13
77,8479520,Brandon Duhaime,R,WSH,27,55,10,2,12
77,8479359,Beck Malenstyn,L,BUF,26,43,8,4,12
77,8481028,Martin Pospisil,C,CGY,25,54,7,5,12
77,8479968,Vinni Lettieri,C,BOS,29,52,7,5,12
77,8479772,Zack MacEwen,R,OTT,28,46,7,5,12
77,8477573,Nathan Walker,L,STL,30,59,5,7,12
77,8482666,Scott Morrow,D,CAR,22,53,5,7,12
77,8478424,Jansen Harkins,C,ANA,27,40,5,7,12
77,8478450,Parker Wotherspoon,D,BOS,27,41,4,8,12
77,8473563,Nicklas Backstrom,C,WSH,37,46,2,10,12
77,8480001,Urho Vaakanainen,D,ANA,25,59,2,10,12
77,8480058,Pierre-Olivier Joseph,D,STL,25,55,2,10,12
77,8471709,Marc-Edouard Vlasic,D,SJS,37,60,1,11,12
77,8480879,Jacob Bernard-Docker,D,OTT,24,49,1,11,12
77,8476858,Phillip Di Giuseppe,L,VAN,31,40,8,3,11
77,8480980,Connor Dewar,C,TOR,25,69,7,4,11
77,8479994,Jaret Anderson-Dolan,C,WPG,25,39,7,4,11
77,8479336,Carl Grundstrom,R,SJS,27,57,6,5,11
77,8482807,Ethan Del Mastro,D,CHI,21,44,6,5,11
77,8482744,James Malatesta,L,CBJ,21,42,6,5,11
77,8482659,Josh Doan,R,UTA,22,52,6,5,11
77,8479378,Logan Stanley,D,WPG,26,43,6,5,11
77,8477034,Jaycob Megna,D,FLA,32,47,5,6,11
77,8483763,Maksymilian Szuber,D,UTA,22,34,5,6,11
77,8475235,Nicolas Deslauriers,L,PHI,33,53,5,6,11
77,8475177,Calvin de Haan,D,COL,33,47,4,7,11
77,8481751,Lukas Rousek,R,BUF,25,39,4,7,11
77,8480292,Carson Meyer,R,ANA,27,32,4,7,11
77,8479972,Mason Shaw,C,WPG,26,40,4,7,11
77,8482070,Mitchell Chaffee,R,TBL,26,50,3,8,11
77,8475279,Ben Chiarot,D,DET,33,70,2,9,11
77,8475718,Justin Holl,D,DET,32,54,2,9,11
77,8480172,Jan Rutta,D,SJS,34,66,2,9,11
77,8481567,Henry Thrun,D,SJS,23,44,1,10,11
77,8473446,Erik Johnson,D,PHI,36,50,1,10,11
77,8480950,Ilya Lyubushkin,D,DAL,30,60,0,11,11
77,8473453,Trevor Lewis,C,LAK,37,67,6,4,10
77,8482148,Hendrix Lapierre,C,WSH,22,49,6,4,10
77,8482762,Simon Edvinsson,D,DET,21,58,6,4,10
77,8480990,Declan Chisholm,D,MIN,24,39,6,4,10
77,8483570,Ben Meyers,C,SEA,26,32,6,4,10
77,8481592,Jakob Pelletier,L,CGY,23,46,5,5,10
77,8483495,Simon Nemec,D,NJD,20,56,5,5,10
77,8479985,Cale Fleury,D,SEA,26,23,5,5,10
77,8478211,Dryden Hunt,L,CGY,29,55,4,6,10
77,8477070,Liam O'Brien,C,UTA,30,51,4,6,10
77,8479980,Nicolas Hague,D,VGK,26,57,4,6,10
77,8481598,Philip Broberg,D,EDM,23,43,3,7,10
77,8481167,Brayden Pachal,D,CGY,25,41,3,7,10
77,8480011,Klim Kostin,C,SJS,25,51,3,7,10
77,8479442,Troy Stecher,D,EDM,30,51,3,7,10
77,8482177,Marat Khusnutdinov,C,MIN,22,36,3,7,10
77,8484287,Cole McWard,D,VAN,23,20,3,7,10
77,8478859,Niko Mikkola,D,FLA,28,49,2,8,10
77,8482095,Tyler Kleven,D,OTT,22,47,2,8,10
77,8482861,Vincent Iorio,D,WSH,22,37,2,8,10
77,8480834,Ty Emberson,D,SJS,24,34,2,8,10
77,8476372,Nick Seeler,D,PHI,31,43,1,9,10
77,8482859,Zack Ostapchuk,C,OTT,21,55,1,9,10
77,8480070,Ian Mitchell,D,BOS,25,50,1,9,10
77,8482733,Logan Mailloux,D,MTL,31,35,1,9,10
77,8479638,Justin Brazeau,R,BOS,26,36,8,1,9
77,8476442,Matt Nieto,L,PIT,32,49,6,3,9
77,8471817,Ryan Reaves,R,TOR,37,52,6,3,9
77,8479371,Dante Fabbro,D,NSH,26,63,4,5,9
77,8471677,Jack Johnson,D,CBJ,37,67,4,5,9
77,8481701,Santeri Hatakka,D,NJD,23,42,3,6,9
77,8477851,Jordan Oesterle,D,BOS,32,37,3,6,9
77,8481122,Simon Benoit,D,TOR,26,36,3,6,9
77,8475958,Michael Sgarbossa,C,WSH,32,29,3,6,9
77,8481019,David Gustafsson,C,WPG,24,47,2,7,9
77,8479372,Joshua Mahura,D,SEA,26,49,2,7,9
77,8481600,Tobias Bjornfot,D,FLA,23,45,2,7,9
77,8474090,Brendan Smith,D,DAL,35,58,2,7,9
77,8474568,Luke Schenn,D,NSH,35,53,1,8,9
77,8483630,Pavol Regenda,L,ANA,25,37,1,8,9
77,8474567,Zach Bogosian,D,MIN,34,61,0,9,9
77,8476374,Sean Kuraly,C,CBJ,31,52,5,3,8
77,8476624,Barclay Goodrow,C,SJS,31,49,5,3,8
77,8479536,Axel Jonsson-Fjallby,L,WPG,26,38,4,4,8
77,8481679,Maxence Guenette,D,OTT,23,34,4,4,8
77,8478017,Mark Friedman,D,VAN,29,42,4,4,8
77,8482652,Walker Duehr,R,CGY,27,41,4,4,8
77,8483549,Lucas Condotta,L,MTL,27,36,4,4,8
77,8480222,Sebastian Aho,D,PIT,28,72,3,5,8
77,8481754,Nikita Nesterenko,C,ANA,23,29,3,5,8
77,8474013,Ian Cole,D,UTA,35,51,3,5,8
77,8476874,Olli Maatta,D,DET,30,59,2,6,8
77,8484254,Akito Hirose,D,VAN,25,35,2,6,8
77,8480196,Jacob Bryson,D,BUF,27,48,1,7,8
77,8479291,Kevin Rooney,C,CGY,31,45,4,3,7
77,8479986,Kole Lind,R,DAL,26,53,3,4,7
77,8477962,Brendan Lemieux,L,CAR,28,28,3,4,7
77,8484911,Collin Graf,R,SJS,22,43,3,4,7
77,8475750,Jon Merrill,D,MIN,32,58,3,4,7
77,8481543,Nikita Alexandrov,C,STL,24,24,3,4,7
77,8482192,Isaak Phillips,D,CHI,23,55,2,5,7
77,8478443,Brandon Carlo,D,BOS,28,58,2,5,7
77,8478468,Jeremy Lauzon,D,NSH,27,53,2,5,7
77,8478146,Matthew Highmore,C,OTT,28,50,2,5,7
77,8478409,Anthony Richard,C,PHI,28,31,2,5,7
77,8482511,Mason Lohrei,D,BOS,23,29,2,5,7
77,8482784,Zach Dean,C,STL,21,41,1,6,7
77,8474166,Alec Martinez,D,CHI,37,47,1,6,7
77,8482153,Brendan Brisson,C,VGK,23,32,1,6,7
77,8481605,Jackson LaCombe,D,ANA,23,35,1,6,7
77,8478454,Noah Juulsen,D,VAN,27,39,0,7,7
77,8480007,Jonas Rondbjerg,R,VGK,25,39,0,7,7
77,8477938,Haydn Fleury,D,WPG,28,40,3,3,6
77,8477384,Joshua Brown,D,EDM,30,40,3,3,6
77,8476913,Devin Shore,C,MIN,30,31,3,3,6
77,8481617,Vasily Podkolzin,R,VAN,23,45,2,4,6
77,8482634,Alex Steeves,C,TOR,25,48,2,4,6
77,8482496,Nils Aman,C,VAN,24,38,2,4,6
77,8480844,Grigori Denisenko,L,VGK,24,25,2,4,6
77,8481743,Marc Del Gaizo,D,NSH,25,19,2,4,6
77,8476473,Connor Murphy,D,CHI,31,47,1,5,6
77,8476441,Joel Edmundson,D,LAK,31,41,1,5,6
77,8482250,Callahan Burke,C,VGK,27,29,1,5,6
77,8479587,Rhett Gardner,C,PHI,28,26,0,6,6
77,8480468,James Hamblin,L,EDM,25,22,4,1,5
77,8479991,Jake Leschyshyn,C,NYR,25,28,4,1,5
77,8482145,Mavrik Bourque,C,DAL,22,46,3,2,5
77,8478874,Adam Gaudette,R,OTT,28,29,3,2,5
77,8481056,Spencer Stastney,D,NSH,24,25,2,3,5
77,8482751,Ryan Winterton,C,SEA,21,33,2,3,5
77,8477401,John Hayden,C,SEA,29,32,2,3,5
77,8479419,Brett Murray,L,BUF,26,21,2,3,5
77,8481541,Samuel Bolduc,D,NYI,24,28,2,3,5
77,8480845,Rasmus Kupari,C,WPG,24,42,1,4,5
77,8482144,Jack Thompson,D,SJS,22,26,1,4,5
77,8483397,Marc McLaughlin,C,BOS,25,32,1,4,5
77,8482747,Brennan Othmann,L,NYR,21,35,1,4,5
77,8482765,Isak Rosen,R,BUF,21,27,1,4,5
77,8479576,Vincent Desharnais,D,VAN,28,26,1,4,5
77,8480245,Olle Lycksell,R,PHI,25,30,1,4,5
77,8474612,Travis Hamonic,D,OTT,34,47,1,4,5
77,8477473,Justin Bailey,R,SJS,29,23,1,4,5
77,8477320,Anton Blidh,L,NYR,29,18,1,4,5
77,8482118,Sam Colangelo,R,ANA,23,12,1,4,5
77,8480880,Jakub Lauko,C,MIN,24,28,3,1,4
77,8481030,Jack St. Ivany,D,PIT,25,18,3,1,4
77,8481147,Reese Johnson,C,MIN,26,37,2,2,4
77,8474062,Riley Nash,C,NYR,35,17,2,2,4
77,8483012,Logan Morrison,C,SEA,22,29,2,2,4
77,8478477,Mitchell Stephens,C,SEA,27,20,2,2,4
77,8478051,Max Willman,C,NJD,29,24,2,2,4
77,8482201,Gage Goncalves,C,TBL,23,23,2,2,4
77,8479379,Givani Smith,R,SJS,26,30,1,3,4
77,8479944,Zach Aston-Reese,C,VGK,30,39,1,3,4
77,8478502,Dennis Gilbert,D,BUF,28,13,1,3,4
77,8484304,Uvis Balinskis,D,FLA,28,8,1,3,4
77,8482713,Mackie Samoskevich,R,FLA,22,35,1,3,4
77,8482172,Landon Slaggert,L,CHI,22,20,0,4,4
77,8475795,Dylan McIlrath,D,WSH,32,22,0,4,4
77,8482470,Ilya Solovyov,D,CGY,24,19,0,4,4
77,8477244,Chad Ruhwedel,D,NYR,34,30,0,4,4
77,8481585,Egor Afanasyev,L,SJS,23,18,3,0,3
77,8480032,Shane Bowers,C,NJD,25,11,3,0,3
77,8482858,Ryker Evans,D,SEA,23,17,2,1,3
77,8480851,Akil Thomas,C,LAK,24,21,2,1,3
77,8481024,Linus Karlsson,C,VAN,25,13,2,1,3
77,8482165,Yan Kuznetsov,D,CGY,22,20,1,2,3
77,8481719,Maxwell Crozier,D,TBL,24,22,1,2,3
77,8477462,Robert Hagg,D,VGK,29,25,1,2,3
77,8481609,Vladislav Kolyachonok,D,UTA,23,22,1,2,3
77,8480267,Sammy Walker,C,MIN,25,20,1,2,3
77,8483567,Georgii Merkulov,C,BOS,24,10,1,2,3
77,8481065,Angus Crookshank,L,OTT,25,17,1,2,3
77,8477073,Kurtis MacDermid,L,NJD,30,27,1,2,3
77,8482141,Lukas Cormier,D,VGK,22,21,0,3,3
77,8479320,Maxime Lajoie,D,SEA,27,31,2,0,2
77,8481593,Jayden Struble,D,MTL,23,15,2,0,2
77,8479367,William Lockwood,R,FLA,26,26,2,0,2
77,8481556,John Beecher,C,BOS,23,41,2,0,2
77,8482147,Jean-Luc Foudy,C,COL,22,24,2,0,2
77,8483619,Filip Roos,D,OTT,25,25,1,1,2
77,8479362,Riley Tufte,L,BOS,26,15,1,1,2
77,8477810,Joel Hanley,D,CGY,33,24,1,1,2
77,8482088,Justin Sourdif,R,FLA,22,17,1,1,2
77,8480874,Adam Ginning,D,PHI,24,15,1,1,2
77,8482516,Matthew Kessel,D,STL,24,14,1,1,2
77,8483395,Arshdeep Bains,L,VAN,23,10,1,1,2
77,8475413,Justin Dowling,C,NJD,34,16,1,1,2
77,8477993,Justin Kirkland,C,CGY,28,8,1,1,2
77,8478011,Louie Belpedio,D,PHI,28,8,1,1,2
77,8477541,Dakota Mermis,D,TOR,30,7,1,1,2
77,8482162,Roby Jarventie,L,EDM,22,13,1,1,2
77,8483597,Milos Kelemen,L,UTA,25,7,1,1,2
77,8480306,Grant Hutton,D,NYI,29,14,0,2,2
77,8484258,Sam Malinski,D,COL,26,18,0,2,2
77,8478021,William Lagesson,D,DET,28,28,0,2,2
77,8477527,Ross Johnston,L,ANA,30,29,0,2,2
77,8481237,Kyle MacLean,C,NYI,25,22,0,2,2
77,8481699,Aku Raty,R,UTA,23,23,0,2,2
77,8482197,Adam Raska,R,MIN,23,8,0,2,2
77,8477467,Gustav Olofsson,D,SEA,30,21,0,2,2
77,8480890,Jan Jenik,C,OTT,24,24,1,0,1
77,8482094,Daemon Hunt,D,MIN,22,16,1,0,1
77,8482102,Vasily Ponomarev,C,PIT,22,14,1,0,1
77,8478881,Brett Seney,L,CHI,28,11,1,0,1
77,8481422,Jake Lucchini,C,NSH,29,19,1,0,1
77,8483489,Fraser Minten,C,TOR,31,12,1,0,1
77,8482126,Emil Andrae,D,PHI,31,5,1,0,1
77,8481043,Cole Koepke,L,BOS,26,17,1,0,1
77,8482061,Brandon Biro,L,SEA,26,18,1,0,1
77,8480870,Bo Groulx,C,NYR,24,29,0,1,1
77,8483512,Matthew Savoie,C,EDM,20,21,0,1,1
77,8484325,Waltteri Merela,C,TBL,26,25,0,1,1
77,8481806,Louis Crevier,D,CHI,23,14,0,1,1
77,8481578,Graeme Clarke,R,MIN,23,10,0,1,1
77,8481206,John Ludvig,D,PIT,24,9,0,1,1
77,8479330,Brandon Gignac,C,MTL,27,12,0,1,1
77,8480823,Alexander Alexeyev,D,WSH,25,7,0,1,1
77,8478854,Ryan Shea,D,PIT,27,7,0,1,1
77,8480084,Nick DeSimone,D,NJD,30,13,0,1,1
77,8482460,Matt Rempe,C,NYR,22,13,0,0,0
77,8481006,Tyler Tucker,D,STL,24,16,0,0,0
77,8481462,Mason Morelli,L,VGK,28,11,0,0,0
77,8482787,Nikita Chibrikov,R,WPG,31,5,0,0,0
77,8477149,Scott Sabourin,R,SJS,32,12,0,0,0
77,8481564,Ryan Johnson,D,BUF,23,11,0,0,0
77,8477971,Andreas Englund,D,LAK,28,24,0,0,0
77,8482929,Emil Lilleberg,D,TBL,23,16,0,0,0
77,8480075,Cameron Crotty,D,MIN,25,5,0,0,0
77,8476323,Max McCormick,L,SEA,32,7,0,0,0
77,8481726,Adam Edstrom,C,NYR,24,11,0,0,0
77,8475780,Chris Wagner,R,COL,33,7,0,0,0
77,8478147,Bokondji Imama,L,PIT,28,5,0,0,0
77,8483531,Brian Halonen,L,NJD,25,2,0,0,0
77,8475755,Alexander Petrovic,D,DAL,32,8,0,0,0
77,8482476,Emil Heineman,L,MTL,23,5,0,0,0
77,8478446,Glenn Gawdin,C,LAK,27,8,0,0,0
77,8483432,Luca Del Bel Belluz,C,CBJ,31,9,0,0,0
77,8483398,Declan Carlile,D,TBL,31,4,0,0,0
77,8483471,Brad Lambert,C,WPG,31,7,0,0,0
77,8483546,Marshall Rifai,D,TOR,26,4,0,0,0
77,8479421,Jacob Moverare,D,LAK,26,7,0,0,0
77,8484326,Patrik Koch,D,UTA,28,3,0,0,0
77,8483407,Brandon Scanlin,D,NYR,25,9,0,0,0
77,8483920,Pierrick Dube,R,WSH,23,4,0,0,0
77,8481655,Cole Schwindt,R,CGY,23,3,0,0,0
77,8479522,Hardy Haman Aktell,D,WSH,26,3,0,0,0
77,8480274,Philip Kemp,D,EDM,25,0,0,0,0
77,8484255,Jason Polin,R,COL,25,4,0,0,0
77,8483609,Adam Klapka,R,CGY,24,0,0,0,0
77,8481534,Raphael Lavoie,C,EDM,24,0,0,0,0
77,8483401,Marc Johnstone,R,PIT,28,1,0,0,0
77,8484259,Ondrej Pavel,C,COL,31,2,0,0,0
77,8484321,Nikolas Matinpalo,D,OTT,26,3,0,0,0
77,8470794,Joe Pavelski,C,,40,0,0,0,0
77,8479321,Lucas Johansen,D,,27,0,0,0,0
77,8477950,Tony DeAngelo,D,,29,0,0,0,0
77,8471218,Blake Wheeler,R,,38,0,0,0,0
77,8475197,Tyson Barrie,D,,33,0,0,0,0
77,8474157,Max Pacioretty,L,,36,0,0,0,0
77,8475744,Evgeny Kuznetsov,C,,32,0,0,0,0
77,8474037,James van Riemsdyk,L,,35,0,0,0,0
77,8476907,Mackenzie MacEachern,L,,30,0,0,0,0
77,8480216,Jacob Peterson,C,,25,0,0,0,0
77,8474602,Justin Schultz,D,,34,0,0,0,0
77,8482222,Alexander Barabanov,L,,30,0,0,0,0
77,8474031,Kevin Shattenkirk,D,,35,0,0,0,0
77,8477330,Dominik Kubalik,L,,29,0,0,0,0
77,8480884,Calen Addison,D,,24,0,0,0,0
77,8475906,John Klingberg,D,,32,0,0,0,0
77,8480008,Adam Ruzicka,C,,25,0,0,0,0
77,8476884,Derrick Pouliot,D,,30,0,0,0,0
77,8476919,Chris Tierney,C,,30,0,0,0,0
77,8479415,Michael McLeod,C,,26,0,0,0,0
77,8474870,Tyler Johnson,C,,34,0,0,0,0
77,8470604,Jeff Carter,C,,39,0,0,0,0
77,8478104,Sammy Blais,L,,28,0,0,0,0
77,8474884,Mike Hoffman,C,,35,0,0,0,0
77,8481591,Sam Poulin,R,,23,0,0,0,0
77,8471274,Alex Goligoski,D,,39,0,0,0,0
77,8476871,Tanner Pearson,L,,32,0,0,0,0
77,8476393,Nick Cousins,C,,31,0,0,0,0
77,8479977,Kailer Yamamoto,R,,26,0,0,0,0
77,8479346,Dillon Dube,C,,26,0,0,0,0
77,8480184,Gustav Lindstrom,D,,26,0,0,0,0
77,8479376,Victor Mete,D,,26,0,0,0,0
77,8473449,Kyle Okposo,R,,36,0,0,0,0
77,8481058,Jesse Ylonen,R,,25,0,0,0,0
77,8475752,Tyler Pitlick,C,,33,0,0,0,0
77,8481239,Samuel Fagemo,L,,24,0,0,0,0
77,8480821,Filip Zadina,R,,25,0,0,0,0
77,8470966,Mark Giordano,D,,41,0,0,0,0
77,8478495,Denis Gurianov,R,,27,0,0,0,0
77,8477464,Nic Petan,C,,29,0,0,0,0
77,8478099,Kevin Labanc,R,,29,0,0,0,0
77,8482241,Radim Zohorna,L,,28,0,0,0,0
77,8474040,Sam Gagner,C,,35,0,0,0,0
77,8479514,Rem Pitlick,C,,27,0,0,0,0
77,8478430,Oliver Kylington,D,,27,0,0,0,0
77,8479533,Joona Koppanen,L,,26,0,0,0,0
77,8479984,Cal Foote,D,,26,0,0,0,0
77,8477126,Jayson Megna,C,,34,0,0,0,0
77,8475164,Jakob Silfverberg,R,,34,0,0,0,0
77,8474009,Nick Bonino,C,,36,0,0,0,0
77,8479458,Nikita Zaitsev,D,,33,0,0,0,0
77,8477944,Jakub Vrana,L,,28,0,0,0,0
77,8471699,Andrew Cogliano,C,,37,0,0,0,0
77,8478067,Oskar Lindblom,L,,28,0,0,0,0
77,8471686,Marc Staal,D,,37,0,0,0,0
77,8470610,Zach Parise,L,,40,0,0,0,0
77,8478904,Steven Lorentz,C,,28,0,0,0,0
77,8473473,Milan Lucic,L,,36,0,0,0,0
77,8480031,Maxime Comtois,L,,25,0,0,0,0
77,8478512,Austin Czarnik,C,,32,0,0,0,0
77,8473504,Cal Clutterbuck,R,,37,0,0,0,0
77,8477454,Adam Erne,L,,29,0,0,0,0
77,8479383,Boris Katchouk,L,,26,0,0,0,0
77,8475825,Jani Hakanpää,D,,32,0,0,0,0
77,8477846,Ryan Carpenter,C,,33,0,0,0,0
77,8477930,Pierre-Edouard Bellemare,L,,39,0,0,0,0
77,8478400,Colin White,C,,27,0,0,0,0
77,8480226,Marián Studenic,R,,26,0,0,0,0
77,8480853,Liam Foudy,C,,24,0,0,0,0
77,8475797,Jarred Tinordi,D,,32,0,0,0,0
77,8479423,Alex Nylander,L,,26,0,0,0,0
77,8474618,Marco Scandella,D,,34,0,0,0,0
77,8478028,Fredrik Olofsson,L,,28,0,0,0,0
77,8474709,Matt Martin,L,,35,0,0,0,0
77,8481070,Hugh McGing,L,,26,0,0,0,0
77,8479546,Oskar Steen,C,,26,0,0,0,0
77,8474145,Robert Bortuzzo,D,,35,0,0,0,0
77,8476915,Jujhar Khaira,L,,30,0,0,0,0
77,8475278,Byron Froese,C,,33,0,0,0,0
77,8481812,Nikolai Knyzhov,D,,27,0,0,0,0
77,8478408,Travis Dermott,D,,28,0,0,0,0
77,8481077,John Leonard,L,,26,0,0,0,0
77,8479547,Matthew Phillips,R,,26,0,0,0,0
77,8480836,Jonathan Gruden,C,,24,0,0,0,0
77,8481690,Tyler Angle,C,,24,0,0,0,0
77,8475766,Austin Watson,L,,32,0,0,0,0
77,8481016,Ruslan Iskhakov,C,,24,0,0,0,0
77,8478078,Rourke Chartier,C,,28,0,0,0,0
77,8480776,Sheldon Rempal,R,,29,0,0,0,0
77,8478956,Samuel Laberge,L,NJD,27,0,0,0,0
77,8483045,Cameron Butler,R,CBJ,31,0,0,0,0
77,8484314,Jiri Smejkal,L,,28,0,0,0,0
78,8477492,Nathan MacKinnon,C,COL,29,81,47,98,145
78,8478402,Connor McDavid,C,EDM,27,79,32,102,134
78,8476453,Nikita Kucherov,R,TBL,31,82,44,85,129
78,8479318,Auston Matthews,C,TOR,27,77,71,51,122
78,8477934,Leon Draisaitl,C,EDM,29,76,39,81,120
78,8477956,David Pastrnak,R,BOS,28,81,58,58,116
78,8478483,Mitch Marner,R,TOR,27,81,27,89,116
78,8478864,Kirill Kaprizov,L,MIN,27,75,48,66,114
78,8478420,Mikko Rantanen,R,COL,28,81,47,65,112
78,8477404,Jake Guentzel,C,TBL,30,82,40,62,102
78,8479314,Matthew Tkachuk,L,FLA,27,76,32,69,101
78,8480012,Elias Pettersson,C,VAN,26,75,44,56,100
78,8481559,Jack Hughes,C,NJD,23,77,42,58,100
78,8482116,Tim Stützle,C,OTT,22,80,28,71,99
78,8477939,William Nylander,R,TOR,28,78,43,55,98
78,8477946,Dylan Larkin,C,DET,28,82,45,52,97
78,8471675,Sidney Crosby,C,PIT,37,72,45,52,97
78,8480801,Brady Tkachuk,L,OTT,25,77,51,44,95
78,8477493,Aleksander Barkov,C,FLA,29,80,38,57,95
78,8478403,Jack Eichel,C,VGK,28,76,49,45,94
78,8476468,J.T. Miller,C,VAN,31,77,30,61,91
78,8478445,Mathew Barzal,C,NYI,27,79,29,62,91
78,8477501,Valeri Nichushkin,R,COL,29,81,43,47,90
78,8478439,Travis Konecny,R,PHI,27,76,40,50,90
78,8477942,Kevin Fiala,L,LAK,28,81,35,55,90
78,8480800,Quinn Hughes,D,VAN,25,79,10,79,89
78,8477409,Carter Verhaeghe,C,FLA,29,81,57,31,88
78,8480023,Robert Thomas,C,STL,25,77,30,58,88
78,8479323,Adam Fox,D,NYR,26,74,17,69,86
78,8478550,Artemi Panarin,L,NYR,33,77,25,60,85
78,8478010,Brayden Point,C,TBL,28,82,43,41,84
78,8474141,Patrick Kane,R,DET,36,76,32,51,83
78,8475172,Nazem Kadri,C,CGY,34,78,31,52,83
78,8475167,Victor Hedman,D,TBL,34,79,11,72,83
78,8480036,Miro Heiskanen,D,DAL,25,78,15,67,82
78,8475913,Mark Stone,R,VGK,32,79,32,49,81
78,8482078,Lucas Raymond,L,DET,22,80,32,47,79
78,8475168,Matt Duchene,C,DAL,33,82,32,47,79
78,8477933,Sam Reinhart,C,FLA,29,80,26,53,79
78,8480865,Noah Dobson,D,NYI,24,79,17,62,79
78,8480069,Cale Makar,D,COL,26,63,17,62,79
78,8478449,Roope Hintz,C,DAL,28,81,37,41,78
78,8479337,Alex DeBrincat,R,DET,27,81,37,41,78
78,8479542,Brandon Hagel,L,TBL,26,82,34,44,78
78,8476459,Mika Zibanejad,C,NYR,31,74,33,45,78
78,8479407,Jesper Bratt,L,NJD,26,74,30,48,78
78,8477402,Pavel Buchnevich,L,STL,29,71,29,49,78
78,8477951,Nick Schmaltz,C,UTA,28,78,21,57,78
78,8474600,Roman Josi,D,NSH,34,72,19,59,78
78,8478444,Brock Boeser,R,VAN,27,77,38,39,77
78,8478398,Kyle Connor,L,WPG,28,74,41,35,76
78,8480208,Drake Batherson,R,OTT,26,80,33,43,76
78,8476389,Vincent Trocheck,C,NYR,31,77,31,44,75
78,8476454,Ryan Nugent-Hopkins,C,EDM,31,82,22,52,74
78,8476456,Jonathan Huberdeau,C,CGY,31,79,21,53,74
78,8479385,Jordan Kyrou,C,STL,26,72,31,42,73
78,8481557,Matt Boldy,L,MIN,23,66,29,44,73
78,8480002,Nico Hischier,C,NJD,25,71,23,50,73
78,8475166,John Tavares,C,TOR,34,79,30,42,72
78,8480830,Andrei Svechnikov,R,CAR,24,69,23,49,72
78,8475810,Bryan Rust,R,PIT,32,67,38,33,71
78,8476887,Filip Forsberg,L,NSH,30,73,37,34,71
78,8479420,Tage Thompson,C,BUF,27,73,35,36,71
78,8476346,Johnny Gaudreau,L,CBJ,31,71,24,47,71
78,8478519,Anthony Cirelli,C,TBL,27,81,32,38,70
78,8471215,Evgeni Malkin,C,PIT,38,78,24,46,70
78,8479325,Charlie McAvoy,D,BOS,27,76,7,63,70
78,8477500,Bo Horvat,C,NYI,29,80,38,31,69
78,8475151,Kyle Palmieri,C,NYI,33,80,31,38,69
78,8478427,Sebastian Aho,C,CAR,27,74,29,40,69
78,8480027,Jason Robertson,L,DAL,25,81,19,50,69
78,8477504,Josh Morrissey,D,WPG,29,78,16,53,69
78,8474578,Erik Karlsson,D,PIT,34,79,14,55,69
78,8475184,Chris Kreider,L,NYR,33,78,42,26,68
78,8479343,Clayton Keller,R,UTA,26,76,34,34,68
78,8476460,Mark Scheifele,C,WPG,31,75,31,37,68
78,8474102,David Perron,L,OTT,36,82,25,43,68
78,8484144,Connor Bedard,C,CHI,19,65,29,38,67
78,8478975,Mason Marchment,L,DAL,29,81,25,42,67
78,8473512,Claude Giroux,R,OTT,36,77,21,46,67
78,8477960,Adrian Kempe,R,LAK,28,81,39,27,66
78,8474564,Steven Stamkos,C,NSH,34,63,31,35,66
78,8475692,Mats Zuccarello,R,MIN,37,69,17,49,66
78,8478460,Zach Werenski,D,CBJ,27,80,16,50,66
78,8482684,Luke Hughes,D,NJD,21,76,8,58,66
78,8477940,Nikolaj Ehlers,L,WPG,28,69,22,43,65
78,8475765,Vladimir Tarasenko,R,DET,33,80,20,45,65
78,8476881,Tomas Hertl,C,VGK,31,77,19,46,65
78,8475784,Jeff Skinner,C,EDM,32,74,35,29,64
78,8476905,Chandler Stephenson,C,SEA,30,73,15,49,64
78,8476853,Morgan Rielly,D,TOR,30,73,14,50,64
78,8471685,Anze Kopitar,C,LAK,37,81,13,51,64
78,8480803,Evan Bouchard,D,EDM,25,75,10,54,64
78,8471214,Alex Ovechkin,L,WSH,39,72,34,28,62
78,8476448,William Karlsson,C,VGK,31,80,30,32,62
78,8484153,Leo Carlsson,C,ANA,20,73,28,33,61
78,8478493,Joel Eriksson Ek,C,MIN,27,71,26,35,61
78,8477949,Alex Tuch,R,BUF,28,73,26,35,61
78,8480839,Rasmus Dahlin,D,BUF,24,70,17,44,61
78,8478414,Timo Meier,R,NJD,28,77,28,32,60
78,8479999,Casey Mittelstadt,C,COL,26,79,19,41,60
78,8475798,Mikael Granlund,C,SJS,32,74,16,44,60
78,8480015,Owen Tippett,R,PHI,25,78,22,37,59
78,8477511,Anthony Mantha,R,CGY,30,79,22,37,59
78,8477503,Max Domi,C,TOR,29,77,19,40,59
78,8475786,Zach Hyman,L,EDM,32,76,32,26,58
78,8477476,Artturi Lehkonen,L,COL,29,82,30,28,58
78,8476539,Jonathan Marchessault,R,NSH,34,73,27,31,58
78,8473994,Jamie Benn,L,DAL,35,79,24,34,58
78,8478047,Michael Bunting,L,PIT,29,74,24,34,58
78,8480064,Josh Norris,C,OTT,25,76,24,34,58
78,8482124,Quinton Byfield,R,LAK,22,80,21,37,58
78,8480028,Morgan Frost,C,PHI,25,71,21,37,58
78,8473419,Brad Marchand,L,BOS,36,80,18,40,58
78,8482665,Matty Beniers,C,SEA,22,69,17,41,58
78,8482740,Wyatt Johnston,C,DAL,21,81,34,23,57
78,8475158,Ryan O'Reilly,C,NSH,33,70,26,31,57
78,8475794,Tyler Seguin,C,DAL,32,82,26,31,57
78,8477494,Jonathan Drouin,L,COL,29,78,22,35,57
78,8478873,Troy Terry,R,ANA,27,76,19,38,57
78,8482720,Matthew Knies,L,TOR,22,77,26,30,56
78,8478042,Viktor Arvidsson,L,EDM,31,73,25,31,56
78,8474150,Mikael Backlund,C,CGY,35,77,23,33,56
78,8478401,Pavel Zacha,C,BOS,27,82,18,38,56
78,8476875,Mike Matheson,D,MTL,30,78,7,49,56
78,8481068,Yegor Sharangovich,C,CGY,26,72,28,27,55
78,8477935,Sam Bennett,C,FLA,28,77,25,30,55
78,8482702,Logan Stankoven,C,DAL,21,80,25,30,55
78,8475191,Reilly Smith,R,NYR,33,72,23,32,55
78,8471724,Kris Letang,D,PIT,37,79,11,44,55
78,8478407,Vince Dunn,D,SEA,28,76,9,46,55
78,8476483,Rickard Rakell,R,PIT,31,74,28,26,54
78,8479987,Morgan Geekie,C,BOS,26,76,26,28,54
78,8481540,Cole Caufield,R,MTL,23,73,25,29,54
78,8482745,Mason McTavish,C,ANA,21,70,24,30,54
78,8481533,Trevor Zegras,C,ANA,23,76,24,30,54
78,8480039,Martin Necas,C,CAR,25,70,23,31,54
78,8482113,Anton Lundell,C,FLA,23,78,23,31,54
78,8478856,Conor Garland,R,VAN,28,71,12,42,54
78,8475754,Brock Nelson,C,NYI,33,80,24,29,53
78,8477021,Alex Kerfoot,C,UTA,30,71,17,36,53
78,8477498,Darnell Nurse,D,EDM,29,74,14,39,53
78,8474679,Gustav Nyquist,C,NSH,35,69,13,40,53
78,8476792,Torey Krug,D,STL,33,69,12,41,53
78,8478474,Lawson Crouse,L,UTA,27,74,26,26,52
78,8477416,Oliver Bjorkstrand,R,SEA,29,77,23,29,52
78,8474641,Adam Henrique,C,EDM,34,74,21,31,52
78,8478233,Andrew Mangiapane,L,WSH,28,69,20,32,52
78,8476292,Ondrej Palat,L,NJD,33,71,20,32,52
78,8476399,Blake Coleman,C,CGY,33,74,25,26,51
78,8480797,Joel Farabee,L,PHI,24,74,23,28,51
78,8477964,Ivan Barbashev,C,VGK,29,80,22,29,51
78,8475726,Tyler Toffoli,C,SJS,32,71,22,29,51
78,8477407,Anthony Duclair,L,NYI,29,80,18,33,51
78,8481711,Matias Maccelli,L,UTA,24,77,15,36,51
78,8476432,Boone Jenner,C,CBJ,31,68,29,21,50
78,8482109,Alexis Lafrenière,L,NYR,23,74,26,24,50
78,8479675,Trevor Moore,L,LAK,29,82,19,31,50
78,8477447,Shea Theodore,D,VGK,29,66,10,40,50
78,8475314,Anders Lee,L,NYI,34,79,31,18,49
78,8477955,Jared McCann,L,SEA,28,74,28,21,49
78,8483515,Juraj Slafkovsky,L,MTL,20,74,22,27,49
78,8478440,Dylan Strome,C,WSH,27,75,20,29,49
78,8481528,Dylan Cozens,C,BUF,23,69,16,33,49
78,8481542,Moritz Seider,D,DET,23,74,10,39,49
78,8482159,Tyson Foerster,R,PHI,22,78,21,27,48
78,8476826,Yanni Gourde,C,SEA,33,71,20,28,48
78,8475169,Evander Kane,L,EDM,33,77,20,28,48
78,8473986,Alex Killorn,L,ANA,35,69,19,29,48
78,8479345,Jakob Chychrun,D,WSH,26,71,15,33,48
78,8476872,Scott Laughton,C,PHI,30,79,14,34,48
78,8478396,Noah Hanifin,D,VGK,27,62,12,36,48
78,8477495,Seth Jones,D,CHI,30,71,11,37,48
78,8477426,Nicholas Paul,L,TBL,29,80,26,21,47
78,8478498,Jake DeBrusk,L,VAN,28,71,26,21,47
78,8477998,Warren Foegele,L,LAK,28,80,23,24,47
78,8477479,Tyler Bertuzzi,L,CHI,29,59,17,30,47
78,8481596,Shane Pinto,C,OTT,24,77,14,33,47
78,8477932,Aaron Ekblad,D,FLA,28,70,11,36,47
78,8479410,Mikhail Sergachev,D,UTA,26,66,9,38,47
78,8479992,Michael Rasmussen,C,DET,25,80,29,17,46
78,8479400,Pierre-Luc Dubois,L,WSH,26,71,24,22,46
78,8477456,J.T. Compher,L,DET,29,79,24,22,46
78,8480018,Nick Suzuki,C,MTL,25,75,17,29,46
78,8476479,Phillip Danault,C,LAK,31,79,17,29,46
78,8475170,Brayden Schenn,C,STL,33,73,23,22,45
78,8484166,Adam Fantilli,C,CBJ,20,75,18,27,45
78,8475745,Charlie Coyle,C,BOS,32,74,17,28,45
78,8478469,Thomas Chabot,D,OTT,27,79,16,29,45
78,8478462,Nicolas Roy,C,VGK,27,76,14,31,45
78,8481604,Pavel Dorofeyev,L,VGK,24,69,26,18,44
78,8475768,Jaden Schwartz,C,SEA,32,66,21,23,44
78,8481186,Logan O'Connor,R,COL,28,80,21,23,44
78,8477451,Ryan Hartman,R,MIN,30,67,17,27,44
78,8478466,Daniel Sprong,R,VAN,27,69,17,27,44
78,8476458,Ryan Strome,C,ANA,31,67,13,31,44
78,8474590,John Carlson,D,WSH,34,70,9,35,44
78,8477346,MacKenzie Weegar,D,CGY,30,71,7,37,44
78,8480009,Eeli Tolvanen,R,SEA,25,64,27,16,43
78,8483431,Logan Cooley,C,UTA,20,74,21,22,43
78,8483808,Andrei Kuzmenko,L,CGY,28,72,18,25,43
78,8474716,Jared Spurgeon,D,MIN,35,75,14,29,43
78,8479425,Filip Hronek,D,VAN,27,74,11,32,43
78,8478038,Devon Toews,D,COL,30,70,6,37,43
78,8478366,Frank Vatrano,R,ANA,30,70,20,22,42
78,8483505,Matthew Poitras,C,BOS,20,74,20,22,42
78,8480220,Noah Cates,L,PHI,25,72,19,23,42
78,8481581,Thomas Harley,D,DAL,23,75,8,34,42
78,8477429,Andrew Copp,C,DET,30,77,7,35,42
78,8476923,Damon Severson,D,CBJ,30,79,5,37,42
78,8482110,Dawson Mercer,C,NJD,23,74,23,18,41
78,8479365,Trent Frederic,C,BOS,26,79,21,20,41
78,8475793,Ryan Johansen,C,PHI,32,71,18,23,41
78,8479351,Sam Steel,C,DAL,26,79,15,26,41
78,8477497,Sean Monahan,C,CBJ,30,68,14,27,41
78,8475218,Mattias Ekholm,D,EDM,34,76,12,29,41
78,8477986,Brandon Montour,D,SEA,30,68,11,30,41
78,8482105,Jake Sanderson,D,OTT,22,75,8,33,41
78,8477496,Elias Lindholm,C,BOS,30,78,23,17,40
78,8482093,Seth Jarvis,C,CAR,22,68,23,17,40
78,8476419,Jean-Gabriel Pageau,C,NYI,32,79,12,28,40
78,8474563,Drew Doughty,D,LAK,35,69,7,33,40
78,8480014,Gabriel Vilardi,C,WPG,25,68,24,15,39
78,8474586,Jordan Eberle,R,SEA,34,73,16,23,39
78,8476906,Shayne Gostisbehere,D,CAR,31,77,12,27,39
78,8476882,Teuvo Teravainen,C,CHI,30,63,12,27,39
78,8470613,Brent Burns,D,CAR,39,76,8,31,39
78,8476854,Hampus Lindholm,D,BOS,30,76,3,36,39
78,8475764,Cam Fowler,D,ANA,33,71,1,38,39
78,8482699,Dylan Guenther,R,UTA,21,75,17,21,38
78,8479591,Michael Eyssimont,C,TBL,28,82,17,21,38
78,8475760,Nick Bjugstad,C,UTA,32,73,15,23,38
78,8481618,Alex Newhook,C,MTL,23,76,14,24,38
78,8482097,Jack Quinn,R,BUF,23,64,14,24,38
78,8480798,Philipp Kurashev,C,CHI,25,65,13,25,38
78,8482122,Brock Faber,D,MIN,22,77,7,31,38
78,8474715,Cameron Atkinson,R,TBL,35,81,22,15,37
78,8479525,Ross Colton,C,COL,28,82,21,16,37
78,8474149,Evgenii Dadonov,R,DAL,35,82,19,18,37
78,8482175,JJ Peterka,R,BUF,22,69,15,22,37
78,8481523,Kirby Dach,C,MTL,23,64,13,24,37
78,8480185,Eetu Luostarinen,C,FLA,26,79,12,25,37
78,8482149,Cole Perfetti,C,WPG,22,70,11,26,37
78,8476925,Colton Sissons,C,NSH,31,70,11,26,37
78,8476869,Brady Skjei,D,NSH,30,75,10,27,37
78,8479339,Patrik Laine,L,CBJ,26,63,9,28,37
78,8478458,John (Jack) Roslovic,C,CAR,27,68,7,30,37
78,8478438,Tommy Novak,C,NSH,27,77,7,30,37
78,8477444,Andre Burakovsky,L,SEA,29,67,19,17,36
78,8480188,Fabian Zetterlund,L,SJS,25,70,19,17,36
78,8480802,Ryan McLeod,C,BUF,25,65,19,17,36
78,8481560,Arthur Kaliyev,R,LAK,23,79,18,18,36
78,8480849,Barrett Hayton,C,UTA,24,70,16,20,36
78,8482092,Ridly Greig,C,OTT,22,78,13,23,36
78,8482146,Luke Evangelista,R,NSH,22,61,13,23,36
78,8477919,Frederick Gaudreau,C,MIN,31,60,12,24,36
78,8477948,Travis Sanheim,D,PHI,28,76,10,26,36
78,8482712,Oskar Olausson,R,COL,22,77,10,26,36
78,8477488,Brett Pesce,D,NJD,30,70,7,29,36
78,8481606,Jordan Spence,D,LAK,23,65,3,33,36
78,8476880,Tom Wilson,R,WSH,30,68,20,15,35
78,8479393,Noah Gregor,L,OTT,26,70,15,20,35
78,8477839,Conor Sheary,L,TBL,32,80,14,21,35
78,8478397,Rasmus Andersson,D,CGY,28,73,8,27,35
78,8482089,Jake Neighbours,L,STL,22,66,24,10,34
78,8478020,Michael Amadio,R,OTT,28,77,22,12,34
78,8478542,Evan Rodrigues,C,FLA,31,74,13,21,34
78,8484145,Zach Benson,L,BUF,19,68,12,22,34
78,8475753,Justin Faulk,D,STL,32,64,6,28,34
78,8474151,Ryan McDonagh,D,TBL,35,81,2,32,34
78,8478046,Danton Heinen,L,VAN,29,75,20,13,33
78,8480459,Pius Suter,C,VAN,28,70,18,15,33
78,8480113,Alex Iafallo,L,WPG,31,67,17,16,33
78,8478109,Victor Olofsson,L,VGK,29,71,15,18,33
78,8482475,Yegor Chinakhov,R,CBJ,23,58,14,19,33
78,8470621,Corey Perry,R,EDM,39,71,14,19,33
78,8480205,Emil Bemstrom,C,PIT,25,64,14,19,33
78,8476462,Dougie Hamilton,D,NJD,31,63,13,20,33
78,8481656,Aliaksei Protas,C,WSH,23,64,12,21,33
78,8481524,Bowen Byram,D,BUF,23,71,10,23,33
78,8476958,Jaccob Slavin,D,CAR,30,77,7,26,33
78,8480043,Timothy Liljegren,D,TOR,25,71,1,32,33
78,8482259,Bobby McMann,C,TOR,28,58,19,13,32
78,8481582,Nicholas Robertson,L,TOR,23,67,19,13,32
78,8481535,Nils Hoglander,L,VAN,24,66,17,15,32
78,8475763,Kevin Hayes,R,PIT,32,70,15,17,32
78,8481032,Paul Cotter,C,NJD,25,67,12,20,32
78,8477505,Alexander Wennberg,C,SJS,30,59,9,23,32
78,8475200,Dmitry Orlov,D,CAR,33,71,9,23,32
78,8477506,Ryan Pulock,D,NYI,30,79,8,24,32
78,8482133,Thomas Bordeleau,C,SJS,22,62,7,25,32
78,8475799,Nino Niederreiter,R,WPG,32,70,21,10,31
78,8481554,Kaapo Kakko,R,NYR,23,70,15,16,31
78,8482055,Drew O'Connor,L,PIT,26,62,14,17,31
78,8478891,Mason Appleton,C,WPG,28,64,12,19,31
78,8480434,Sean Durzi,D,UTA,26,68,9,22,31
78,8476927,Teddy Blueger,C,VAN,30,64,9,22,31
78,8480817,K'Andre Miller,D,NYR,24,71,8,23,31
78,8475171,Oliver Ekman-Larsson,D,TOR,33,68,8,23,31
78,8474565,Alex Pietrangelo,D,VGK,34,61,6,25,31
78,8482655,Janis Moser,D,TBL,24,76,5,26,31
78,8474574,Tyler Myers,D,VAN,34,66,3,28,31
78,8473507,Jeff Petry,D,DET,37,75,3,28,31
78,8473533,Jordan Staal,C,CAR,36,66,16,14,30
78,8477406,Mattias Janmark,C,EDM,32,65,14,16,30
78,8480855,Jack McBain,C,UTA,24,71,13,17,30
78,8483491,Ivan Miroshnichenko,L,WSH,20,56,12,18,30
78,8478115,Pierre Engvall,L,NYI,28,75,11,19,30
78,8477987,Ryan Donato,C,CHI,28,60,11,19,30
78,8482125,Alexander Holtz,R,VGK,22,67,11,19,30
78,8477953,Kasperi Kapanen,R,STL,28,72,10,20,30
78,8476892,Colton Parayko,D,STL,31,70,8,22,30
78,8479353,Brett Howden,C,VGK,26,73,8,22,30
78,8477969,Marcus Pettersson,D,PIT,28,80,6,24,30
78,8476463,Jonas Brodin,D,MIN,31,76,4,26,30
78,8475848,Brendan Gallagher,R,MTL,32,71,15,14,29
78,8481580,Connor McMichael,C,WSH,23,68,14,15,29
78,8479941,Justin Danforth,R,CBJ,31,65,14,15,29
78,8476438,Brandon Saad,L,STL,32,69,13,16,29
78,8478057,Dakota Joshua,C,VAN,28,65,13,16,29
78,8481577,Philip Tomasino,C,NSH,23,71,12,17,29
78,8480893,Kirill Marchenko,R,CBJ,24,64,12,17,29
78,8475714,Calle Jarnkrok,C,TOR,33,73,12,17,29
78,8480336,Sean Walker,D,CAR,30,75,9,20,29
78,8484203,Bradly Nadeau,L,CAR,19,66,9,20,29
78,8480871,Adam Boqvist,D,FLA,24,67,9,20,29
78,8483490,Pavel Mintyukov,D,ANA,21,70,8,21,29
78,8482671,Owen Power,D,BUF,22,69,6,23,29
78,8476902,Esa Lindell,D,DAL,30,73,5,24,29
78,8481703,Valtteri Puustinen,R,PIT,25,56,4,25,29
78,8476879,Cody Ceci,D,EDM,31,66,4,25,29
78,8475193,Tomas Tatar,L,NJD,34,68,14,14,28
78,8480074,Alexandre Texier,C,STL,25,62,14,14,28
78,8480068,Ryan Poehling,C,PHI,25,72,13,15,28
78,8483468,Jiri Kulich,C,BUF,20,54,12,16,28
78,8476278,Colin Blackwell,C,DAL,31,79,9,19,28
78,8481441,Joe Snively,C,DET,28,69,8,20,28
78,8473563,Nicklas Backstrom,C,WSH,37,61,7,21,28
78,8478133,Jake Evans,C,MTL,28,72,6,22,28
78,8478055,Gustav Forsling,D,FLA,28,74,5,23,28
78,8481546,Cam York,D,PHI,23,63,5,23,28
78,8482079,Marco Rossi,C,MIN,23,52,19,8,27
78,8479390,Taylor Raddysh,R,WSH,26,73,14,13,27
78,8478463,Anthony Beauvillier,L,PIT,27,66,13,14,27
78,8477947,Sonny Milano,L,WSH,28,55,12,15,27
78,8475287,Erik Haula,L,NJD,33,71,12,15,27
78,8478413,Jordan Greenway,L,BUF,27,66,11,16,27
78,8482749,Joshua Roy,R,MTL,21,63,10,17,27
78,8478421,A.J. Greer,L,FLA,28,58,9,18,27
78,8474189,Lars Eller,C,PIT,35,61,8,19,27
78,8479996,Cody Glass,C,NSH,25,67,8,19,27
78,8475220,Marcus Foligno,L,MIN,33,64,8,19,27
78,8476422,Mike Reilly,D,NYI,31,72,6,21,27
78,8476331,Dylan DeMelo,D,WPG,31,73,2,25,27
78,8479336,Carl Grundstrom,R,SJS,27,56,16,10,26
78,8480829,Jesperi Kotkaniemi,C,CAR,24,65,15,11,26
78,8482705,Cole Sillinger,C,CBJ,21,64,14,12,26
78,8481624,Ilya Mikheyev,R,CHI,30,65,14,12,26
78,8480748,Kiefer Sherwood,L,VAN,29,64,14,12,26
78,8484149,Gavin Brindley,C,CBJ,20,47,13,13,26
78,8471698,T.J. Oshie,R,WSH,38,64,12,14,26
78,8476461,Sean Couturier,C,PHI,32,61,11,15,26
78,8476480,Vladislav Namestnikov,C,WPG,32,62,11,15,26
78,8475722,Jason Zucker,L,BUF,32,66,9,17,26
78,8478472,Mathieu Joseph,R,STL,27,71,9,17,26
78,8482667,William Eklund,L,SJS,22,62,7,19,26
78,8476885,Jacob Trouba,D,NYR,30,69,6,20,26
78,8477220,Nate Schmidt,D,FLA,33,69,4,22,26
78,8478911,Matt Roy,D,WSH,29,64,3,23,26
78,8482737,Zack Bolduc,C,STL,21,56,16,9,25
78,8480835,Jack Drury,C,CAR,24,61,15,10,25
78,8477450,Jason Dickinson,C,CHI,29,61,14,11,25
78,8477425,Miles Wood,L,COL,29,78,13,12,25
78,8476981,Josh Anderson,R,MTL,30,72,12,13,25
78,8479293,Brandon Tanev,L,SEA,33,71,11,14,25
78,8482101,Danil Gushchin,L,SJS,22,57,6,19,25
78,8477507,Nikita Zadorov,D,BOS,29,72,4,21,25
78,8476429,Scott Mayfield,D,NYI,32,76,4,21,25
78,8480873,Rasmus Sandin,D,WSH,24,66,3,22,25
78,8479398,Samuel Girard,D,COL,26,67,3,22,25
78,8480058,Pierre-Olivier Joseph,D,STL,25,59,2,23,25
78,8476917,Adam Pelech,D,NYI,30,74,1,24,25
78,8480049,Dylan Samberg,D,WPG,25,66,1,24,25
78,8476474,Stefan Noesen,R,NJD,31,65,15,9,24
78,8476889,Radek Faksa,C,STL,30,64,15,9,24
78,8473422,Nick Foligno,L,CHI,37,64,11,13,24
78,8476921,Jordan Martinook,L,CAR,32,57,11,13,24
78,8474053,Logan Couture,C,SJS,35,64,11,13,24
78,8483482,Tristan Luneau,D,ANA,20,63,9,15,24
78,8477499,Rasmus Ristolainen,D,PHI,30,61,8,16,24
78,8479026,Philippe Myers,D,TOR,27,49,7,17,24
78,8480145,Neal Pionk,D,WPG,29,70,6,18,24
78,8482624,Daniil Miromanov,D,CGY,27,63,6,18,24
78,8481014,Alexander Romanov,D,NYI,24,78,6,18,24
78,8476329,Travis Boyd,C,MIN,31,58,5,19,24
78,8477435,Ryan Graves,D,PIT,29,75,3,21,24
78,8482245,Artem Zub,D,OTT,29,64,2,22,24
78,8475149,Marcus Johansson,L,MIN,34,63,15,8,23
78,8481704,Juuso Parssinen,C,NSH,23,58,10,13,23
78,8480448,Parker Kelly,L,COL,25,72,10,13,23
78,8483493,Frank Nazar,C,CHI,20,54,9,14,23
78,8480878,Nils Lundkvist,D,DAL,24,72,8,15,23
78,8480246,Nick Perbix,D,TBL,26,73,7,16,23
78,8478882,Vladislav Gavrikov,D,LAK,29,71,4,19,23
78,8479369,Andrew Peeke,D,BOS,26,55,3,20,23
78,8481093,Rafael Harvey-Pinard,L,MTL,25,62,17,5,22
78,8477952,Robby Fabbri,C,ANA,28,63,15,7,22
78,8478585,Derek Ryan,C,EDM,38,64,14,8,22
78,8480289,Morgan Barron,C,WPG,26,62,12,10,22
78,8480813,Joe Veleno,C,DET,24,78,11,11,22
78,8477446,Michael McCarron,R,NSH,29,59,11,11,22
78,8475231,Casey Cizikas,C,NYI,33,73,10,12,22
78,8482117,Lukas Reichel,L,CHI,22,60,9,13,22
78,8480035,Henri Jokiharju,D,BUF,25,56,8,14,22
78,8480980,Connor Dewar,C,TOR,25,70,8,14,22
78,8483445,Cutter Gauthier,L,ANA,20,66,7,15,22
78,8476960,Andreas Athanasiou,C,CHI,30,52,6,16,22
78,8480887,Jordan Harris,D,MTL,24,63,5,17,22
78,8476467,Jamie Oleksiak,D,SEA,32,65,5,17,22
78,8482660,Kent Johnson,C,CBJ,22,64,3,19,22
78,8476457,Adam Larsson,D,SEA,32,73,3,19,22
78,8476979,Erik Gustafsson,D,DET,32,70,2,20,22
78,8478840,Will Borgen,D,SEA,28,57,2,20,22
78,8476374,Sean Kuraly,C,CBJ,31,56,15,6,21
78,8480144,David Kampf,C,TOR,29,70,10,11,21
78,8478432,Christian Fischer,R,DET,27,74,10,11,21
78,8480995,Pontus Holmberg,R,TOR,25,67,9,12,21
78,8475855,Jesper Fast,R,CAR,33,57,8,13,21
78,8481553,Bobby Brink,R,PHI,23,63,7,14,21
78,8477989,Christian Dvorak,C,MTL,28,64,7,14,21
78,8478970,Jalen Chatfield,D,CAR,28,72,6,15,21
78,8478507,John Marino,D,UTA,27,73,4,17,21
78,8478416,Erik Cernak,D,TBL,27,74,4,17,21
78,8478500,Ivan Provorov,D,CBJ,27,76,3,18,21
78,8482074,Connor Zary,C,CGY,23,63,12,8,20
78,8477353,Tyler Motte,C,DET,29,76,12,8,20
78,8481481,Blake Lizotte,C,PIT,27,58,11,9,20
78,8480078,Filip Chytil,C,NYR,25,58,9,11,20
78,8476392,Adam Lowry,C,WPG,31,63,8,12,20
78,8476878,Zemgus Girgensons,C,TBL,30,79,8,12,20
78,8475791,Taylor Hall,L,CHI,33,55,7,13,20
78,8478013,Jake Walman,D,SJS,28,71,7,13,20
78,8477979,Nicolas Aube-Kubel,R,BUF,28,60,7,13,20
78,8482067,Connor Mackey,D,NYR,28,60,6,14,20
78,8479983,Mario Ferraro,D,SJS,26,72,5,15,20
78,8478178,Darren Raddysh,D,TBL,28,66,5,15,20
78,8480789,Oliver Wahlstrom,R,NYI,24,69,4,16,20
78,8475462,Radko Gudas,D,ANA,34,67,3,17,20
78,8479982,Conor Timmins,D,TOR,26,60,1,19,20
78,8475188,Brayden McNabb,D,VGK,33,42,1,19,20
78,8475181,Nick Leddy,D,STL,33,74,0,20,20
78,8480001,Urho Vaakanainen,D,ANA,25,64,0,20,20
78,8478569,Noel Acciari,C,PIT,33,52,10,9,19
78,8477478,William Carrier,L,CAR,30,60,10,9,19
78,8483524,Shane Wright,C,SEA,20,65,8,11,19
78,8477369,Carson Soucy,D,VAN,30,61,7,12,19
78,8475842,Sam Carrick,C,NYR,32,62,6,13,19
78,8481521,Ronnie Attard,D,PHI,25,57,5,14,19
78,8480073,Erik Brannstrom,D,COL,25,66,5,14,19
78,8482087,Kaiden Guhle,D,MTL,22,62,5,14,19
78,8480003,Jesper Boqvist,C,FLA,26,64,4,15,19
78,8475279,Ben Chiarot,D,DET,33,70,3,16,19
78,8481059,Scott Perunovich,D,STL,26,62,2,17,19
78,8474673,TJ Brodie,D,CHI,34,63,1,18,19
78,8475455,Brenden Dillon,D,NJD,34,61,1,18,19
78,8481601,Simon Holmstrom,R,NYI,23,63,16,2,18
78,8479619,Michael Carcone,L,UTA,28,65,12,6,18
78,8479315,Joey Anderson,R,CHI,26,51,10,8,18
78,8479368,Max Jones,L,BOS,26,63,9,9,18
78,8477392,Hudson Fasching,R,NYI,29,66,9,9,18
78,8479414,Nathan Bastian,R,NJD,27,59,9,9,18
78,8475225,Craig Smith,C,CHI,35,61,9,9,18
78,8482111,Justin Barron,D,MTL,23,65,8,10,18
78,8482142,Jamie Drysdale,D,PHI,22,65,8,10,18
78,8477573,Nathan Walker,L,STL,30,43,8,10,18
78,8481522,Peyton Krebs,C,BUF,23,57,7,11,18
78,8478434,Keegan Kolesar,R,VGK,27,63,7,11,18
78,8480025,MacKenzie Entwistle,R,FLA,25,68,6,12,18
78,8476897,Oskar Sundqvist,C,STL,30,62,5,13,18
78,8480222,Sebastian Aho,D,PIT,28,72,5,13,18
78,8478452,Caleb Jones,D,LAK,27,58,4,14,18
78,8479976,Juuso Valimaki,D,UTA,26,64,2,16,18
78,8476931,Jake McCabe,D,TOR,31,63,2,16,18
78,8476891,Matthew Grzelcyk,D,PIT,30,70,2,16,18
78,8479402,Jake Bean,D,CGY,26,62,2,16,18
78,8475324,Nick Jensen,D,OTT,34,71,2,16,18
78,8480860,Kevin Bahl,D,CGY,24,60,1,17,18
78,8477903,Garnet Hathaway,R,PHI,33,63,12,5,17
78,8480355,Mark Kastelic,C,BOS,25,66,10,7,17
78,8482679,Matt Coronato,R,CGY,22,70,9,8,17
78,8482157,Will Cuylle,L,NYR,22,62,8,9,17
78,8479661,Tanner Jeannot,L,LAK,27,70,8,9,17
78,8476469,Joel Armia,R,MTL,31,56,8,9,17
78,8479718,Alex Barré-Boulet,C,MTL,27,59,6,11,17
78,8476988,Matt Benning,D,SJS,30,65,6,11,17
78,8474567,Zach Bogosian,D,MIN,34,62,6,11,17
78,8479370,Tyson Jost,C,CAR,26,58,5,12,17
78,8479998,Mikey Anderson,D,LAK,25,57,3,14,17
78,8478851,Alexandre Carrier,D,NSH,28,66,3,14,17
78,8476873,Mark Jankowski,C,NSH,30,48,10,6,16
78,8477887,Patrick Brown,C,BOS,32,44,10,6,16
78,8479344,Jesse Puljujarvi,R,PIT,26,51,9,7,16
78,8479439,Jacob MacDonald,D,COL,31,56,9,7,16
78,8479328,Julien Gauthier,R,NYI,27,61,8,8,16
78,8477070,Liam O'Brien,C,UTA,30,51,8,8,16
78,8474034,Patrick Maroon,L,CHI,36,53,6,10,16
78,8476856,Mathew Dumba,D,DAL,30,69,6,10,16
78,8476994,Vinnie Hinostroza,C,NSH,30,56,6,10,16
78,8481028,Martin Pospisil,C,CGY,25,58,6,10,16
78,8478443,Brandon Carlo,D,BOS,28,58,6,10,16
78,8479639,Dylan Coghlan,D,WPG,26,60,5,11,16
78,8483457,Lane Hutson,D,MTL,20,59,5,11,16
78,8475690,Chris Tanev,D,TOR,35,57,5,11,16
78,8476822,Luke Glendening,C,TBL,35,75,4,12,16
78,8479543,Michael Pezzetta,L,MTL,26,49,4,12,16
78,8479980,Nicolas Hague,D,VGK,26,61,4,12,16
78,8474612,Travis Hamonic,D,OTT,34,53,4,12,16
78,8475233,David Savard,D,MTL,34,64,3,13,16
78,8477015,Connor Brown,R,EDM,30,63,3,13,16
78,8475750,Jon Merrill,D,MIN,32,64,3,13,16
78,8478136,Jake Middleton,D,MIN,28,76,2,14,16
78,8478399,Jonas Siegenthaler,D,NJD,27,66,2,14,16
78,8480796,Martin Fehervary,D,WSH,25,55,0,16,16
78,8481019,David Gustafsson,C,WPG,24,50,0,16,16
78,8480762,Eric Robinson,L,CAR,29,53,11,4,15
78,8482155,Alex Laferriere,R,LAK,23,66,11,4,15
78,8481517,Brett Leason,R,ANA,25,55,10,5,15
78,8481147,Reese Johnson,C,MIN,26,46,8,7,15
78,8478468,Jeremy Lauzon,D,NSH,27,53,6,9,15
78,8481617,Vasily Podkolzin,R,VAN,23,41,6,9,15
78,8479324,Ryan Lindgren,D,NYR,26,66,5,10,15
78,8480807,Mattias Samuelsson,D,BUF,24,47,5,10,15
78,8479371,Dante Fabbro,D,NSH,26,67,5,10,15
78,8476918,Jimmy Vesey,L,NYR,31,66,4,11,15
78,8482148,Hendrix Lapierre,C,WSH,22,53,4,11,15
78,8481708,Zac Jones,D,NYR,24,48,3,12,15
78,8480727,Zach Whitecloud,D,VGK,28,54,2,13,15
78,8482073,Braden Schneider,D,NYR,23,62,1,14,15
78,8475718,Justin Holl,D,DET,32,60,1,14,15
78,8477508,Curtis Lazar,C,NJD,29,54,10,4,14
78,8479066,Ryan Lomberg,L,CGY,30,62,8,6,14
78,8473453,Trevor Lewis,C,LAK,37,71,8,6,14
78,8478211,Dryden Hunt,L,CGY,29,57,8,6,14
78,8478508,Yakov Trenin,C,MIN,27,58,7,7,14
78,8482062,Cole Smith,L,NSH,29,57,7,7,14
78,8481477,Nico Sturm,C,SJS,29,58,7,7,14
78,8482803,Olen Zellweger,D,ANA,21,64,7,7,14
78,8483499,Liam Ohgren,L,MIN,20,58,7,7,14
78,8478831,Kevin Stenlund,C,UTA,28,60,7,7,14
78,8480806,Isac Lundestrom,C,ANA,25,57,6,8,14
78,8481161,Jake Christiansen,D,CBJ,25,56,6,8,14
78,8479359,Beck Malenstyn,L,BUF,26,44,6,8,14
78,8477931,Tomas Nosek,L,FLA,32,50,5,9,14
78,8481568,Alex Vlasic,D,CHI,23,55,5,9,14
78,8482166,Shakir Mukhamadullin,D,SJS,22,52,5,9,14
78,8475343,Nic Dowd,C,WSH,34,51,4,10,14
78,8481527,Kaedan Korczak,D,VGK,23,46,3,11,14
78,8477845,Trevor van Riemsdyk,D,WSH,33,56,3,11,14
78,8480950,Ilya Lyubushkin,D,DAL,30,60,3,11,14
78,8480891,Michael Kesselring,D,UTA,24,53,2,12,14
78,8482809,Jackson Blake,R,CAR,21,55,6,7,13
78,8476312,Josh Manson,D,COL,33,58,6,7,13
78,8481751,Lukas Rousek,R,BUF,25,43,6,7,13
78,8477365,Connor Clifton,D,BUF,29,61,5,8,13
78,8476442,Matt Nieto,L,PIT,32,57,4,9,13
78,8482176,Wyatt Kaiser,D,CHI,22,53,3,10,13
78,8477380,Jonny Brodzinski,C,NYR,31,52,3,10,13
78,8482634,Alex Steeves,C,TOR,25,50,1,12,13
78,8481716,Dmitri Voronkov,L,CBJ,24,43,8,4,12
78,8478043,Sam Lafferty,C,BUF,29,57,5,7,12
78,8483466,Kevin Korchinski,D,CHI,20,55,5,7,12
78,8482141,Lukas Cormier,D,VGK,22,28,5,7,12
78,8479316,Luke Kunin,C,SJS,27,50,4,8,12
78,8482744,James Malatesta,L,CBJ,21,43,3,9,12
78,8478859,Niko Mikkola,D,FLA,28,55,3,9,12
78,8483565,Nick Blankenburg,D,NSH,26,59,1,11,12
78,8475208,Brian Dumoulin,D,ANA,33,53,0,12,12
78,8482762,Simon Edvinsson,D,DET,21,52,8,3,11
78,8481641,Joel Kiviranta,L,COL,28,74,7,4,11
78,8476624,Barclay Goodrow,C,SJS,31,51,7,4,11
78,8481599,Victor Soderstrom,D,UTA,23,46,6,5,11
78,8476934,Brock McGinn,L,ANA,30,52,5,6,11
78,8475179,Dmitry Kulikov,D,FLA,34,63,5,6,11
78,8479968,Vinni Lettieri,C,BOS,29,44,5,6,11
78,8479442,Troy Stecher,D,EDM,30,50,5,6,11
78,8478017,Mark Friedman,D,VAN,29,40,5,6,11
78,8483549,Lucas Condotta,L,MTL,27,38,5,6,11
78,8480848,Ty Dellandrea,C,SJS,24,33,4,7,11
78,8475790,Erik Gudbranson,D,CBJ,32,79,4,7,11
78,8482807,Ethan Del Mastro,D,CHI,21,52,4,7,11
78,8482747,Brennan Othmann,L,NYR,21,41,4,7,11
78,8482666,Scott Morrow,D,CAR,22,44,3,8,11
78,8482192,Isaak Phillips,D,CHI,23,54,3,8,11
78,8475177,Calvin de Haan,D,COL,33,42,2,9,11
78,8480292,Carson Meyer,R,ANA,27,36,2,9,11
78,8480070,Ian Mitchell,D,BOS,25,44,2,9,11
78,8476874,Olli Maatta,D,DET,30,64,2,9,11
78,8473446,Erik Johnson,D,PHI,36,50,1,10,11
78,8481754,Nikita Nesterenko,C,ANA,23,36,9,1,10
78,8482077,Dylan Holloway,L,EDM,23,50,7,3,10
78,8479291,Kevin Rooney,C,CGY,31,49,7,3,10
78,8480011,Klim Kostin,C,SJS,25,47,6,4,10
78,8481789,Tye Kartye,L,SEA,23,46,5,5,10
78,8481550,Adam Beckman,L,NJD,23,37,5,5,10
78,8481532,Alex Turcotte,C,LAK,23,53,5,5,10
78,8476867,Brendan Gaunce,C,MIN,30,32,5,5,10
78,8476913,Devin Shore,C,MIN,30,38,5,5,10
78,8477384,Joshua Brown,D,EDM,30,45,4,6,10
78,8480157,Calle Rosen,D,COL,30,52,3,7,10
78,8479520,Brandon Duhaime,R,WSH,27,51,3,7,10
78,8471677,Jack Johnson,D,CBJ,37,69,3,7,10
78,8481122,Simon Benoit,D,TOR,26,39,3,7,10
78,8481178,Egor Zamula,D,PHI,24,54,2,8,10
78,8477018,Ben Hutton,D,VGK,31,42,2,8,10
78,8483460,David Jiricek,D,CBJ,21,53,2,8,10
78,8480172,Jan Rutta,D,SJS,34,66,2,8,10
78,8470600,Ryan Suter,D,STL,39,62,1,9,10
78,8474090,Brendan Smith,D,DAL,35,55,1,9,10
78,8481592,Jakob Pelletier,L,CGY,23,37,7,2,9
78,8471817,Ryan Reaves,R,TOR,37,50,7,2,9
78,8481518,Nolan Foote,L,NJD,24,34,6,3,9
78,8480021,Jack Studnicka,C,LAK,25,56,5,4,9
78,8479671,Mathieu Olivier,R,CBJ,27,45,5,4,9
78,8479944,Zach Aston-Reese,C,VGK,30,50,5,4,9
78,8482964,Arber Xhekaj,D,MTL,23,48,4,5,9
78,8475235,Nicolas Deslauriers,L,PHI,33,55,4,5,9
78,8482784,Zach Dean,C,STL,21,47,4,5,9
78,8480007,Jonas Rondbjerg,R,VGK,25,36,4,5,9
78,8480441,Trey Fix-Wolansky,R,CBJ,25,38,3,6,9
78,8482659,Josh Doan,R,UTA,22,44,3,6,9
78,8482859,Zack Ostapchuk,C,OTT,21,48,3,6,9
78,8476525,Colin Miller,D,WPG,32,48,2,7,9
78,8478409,Anthony Richard,C,PHI,28,31,2,7,9
78,8481609,Vladislav Kolyachonok,D,UTA,23,34,2,7,9
78,8476967,Brett Kulak,D,EDM,30,65,1,8,9
78,8482095,Tyler Kleven,D,OTT,22,42,1,8,9
78,8479348,Kale Clague,D,BUF,26,44,0,9,9
78,8474166,Alec Martinez,D,CHI,37,44,0,9,9
78,8480281,Alexey Toropchenko,R,STL,25,57,5,3,8
78,8479772,Zack MacEwen,R,OTT,28,48,4,4,8
78,8479985,Cale Fleury,D,SEA,26,35,4,4,8
78,8479536,Axel Jonsson-Fjallby,L,WPG,26,40,4,4,8
78,8478451,Ethan Bear,D,WSH,27,43,3,5,8
78,8476372,Nick Seeler,D,PHI,31,37,3,5,8
78,8475958,Michael Sgarbossa,C,WSH,32,29,3,5,8
78,8484911,Collin Graf,R,SJS,22,46,3,5,8
78,8483619,Filip Roos,D,OTT,25,39,3,5,8
78,8482451,Mikael Pyyhtia,L,CBJ,23,43,2,6,8
78,8471709,Marc-Edouard Vlasic,D,SJS,37,63,2,6,8
78,8476441,Joel Edmundson,D,LAK,31,42,2,6,8
78,8480245,Olle Lycksell,R,PHI,25,23,2,6,8
78,8481013,Jonatan Berggren,R,DET,24,52,1,7,8
78,8479372,Joshua Mahura,D,SEA,26,53,1,7,8
78,8476473,Connor Murphy,D,CHI,31,34,1,7,8
78,8479986,Kole Lind,R,DAL,26,51,5,2,7
78,8481567,Henry Thrun,D,SJS,23,43,4,3,7
78,8481537,Nikita Okhotiuk,D,CGY,24,55,2,5,7
78,8475762,Derek Forbort,D,VAN,32,42,2,5,7
78,8476858,Phillip Di Giuseppe,L,VAN,31,45,2,5,7
78,8482496,Nils Aman,C,VAN,24,35,2,5,7
78,8481056,Spencer Stastney,D,NSH,24,36,2,5,7
78,8482144,Jack Thompson,D,SJS,22,29,2,5,7
78,8482730,Brandt Clarke,D,LAK,21,52,1,6,7
78,8479249,Andrew Poturalski,C,SJS,30,30,1,6,7
78,8479972,Mason Shaw,C,WPG,26,36,1,6,7
78,8477851,Jordan Oesterle,D,BOS,32,48,1,6,7
78,8474013,Ian Cole,D,UTA,35,50,1,6,7
78,8477962,Brendan Lemieux,L,CAR,28,37,4,2,6
78,8478146,Matthew Highmore,C,OTT,28,33,4,2,6
78,8478424,Jansen Harkins,C,ANA,27,42,3,3,6
78,8482733,Logan Mailloux,D,MTL,31,29,3,3,6
78,8481679,Maxence Guenette,D,OTT,23,24,3,3,6
78,8482511,Mason Lohrei,D,BOS,23,31,3,3,6
78,8482145,Mavrik Bourque,C,DAL,22,46,3,3,6
78,8477527,Ross Johnston,L,ANA,30,37,3,3,6
78,8480834,Ty Emberson,D,SJS,24,31,2,4,6
78,8481600,Tobias Bjornfot,D,FLA,23,38,2,4,6
78,8478454,Noah Juulsen,D,VAN,27,35,2,4,6
78,8477401,John Hayden,C,SEA,29,30,2,4,6
78,8476952,Dominic Toninato,C,WPG,30,25,1,5,6
78,8480879,Jacob Bernard-Docker,D,OTT,24,42,1,5,6
78,8479378,Logan Stanley,D,WPG,26,49,1,5,6
78,8477034,Jaycob Megna,D,FLA,32,45,1,5,6
78,8481541,Samuel Bolduc,D,NYI,24,29,1,5,6
78,8480845,Rasmus Kupari,C,WPG,24,39,1,5,6
78,8482201,Gage Goncalves,C,TBL,23,27,1,5,6
78,8481237,Kyle MacLean,C,NYI,25,20,1,5,6
78,8478450,Parker Wotherspoon,D,BOS,27,32,0,6,6
78,8480196,Jacob Bryson,D,BUF,27,38,0,6,6
78,8477938,Haydn Fleury,D,WPG,28,48,0,6,6
78,8482713,Mackie Samoskevich,R,FLA,22,36,0,6,6
78,8480990,Declan Chisholm,D,MIN,24,37,5,0,5
78,8480468,James Hamblin,L,EDM,25,22,5,0,5
78,8481598,Philip Broberg,D,EDM,23,40,4,1,5
78,8480880,Jakub Lauko,C,MIN,24,31,3,2,5
78,8481701,Santeri Hatakka,D,NJD,23,42,2,3,5
78,8482652,Walker Duehr,R,CGY,27,45,2,3,5
78,8482751,Ryan Winterton,C,SEA,21,39,2,3,5
78,8482172,Landon Slaggert,L,CHI,22,24,2,3,5
78,8480870,Bo Groulx,C,NYR,24,35,2,3,5
78,8480192,Johnathan Kovacevic,D,NJD,27,44,1,4,5
78,8482861,Vincent Iorio,D,WSH,22,39,1,4,5
78,8482765,Isak Rosen,R,BUF,21,33,1,4,5
78,8477482,Zachary Sanford,L,CHI,30,32,0,5,5
78,8483495,Simon Nemec,D,NJD,20,52,0,5,5
78,8477320,Anton Blidh,L,NYR,29,29,0,5,5
78,8479981,Jonah Gadjovich,L,FLA,26,38,3,1,4
78,8481585,Egor Afanasyev,L,SJS,23,20,3,1,4
78,8477462,Robert Hagg,D,VGK,29,30,3,1,4
78,8481578,Graeme Clarke,R,MIN,23,13,3,1,4
78,8479994,Jaret Anderson-Dolan,C,WPG,25,31,2,2,4
78,8482177,Marat Khusnutdinov,C,MIN,22,33,2,2,4
78,8482153,Brendan Brisson,C,VGK,23,28,2,2,4
78,8481605,Jackson LaCombe,D,ANA,23,40,2,2,4
78,8478874,Adam Gaudette,R,OTT,28,36,2,2,4
78,8479320,Maxime Lajoie,D,SEA,27,22,2,2,4
78,8481556,John Beecher,C,BOS,23,31,2,2,4
78,8482147,Jean-Luc Foudy,C,COL,22,28,2,2,4
78,8477810,Joel Hanley,D,CGY,33,21,2,2,4
78,8482061,Brandon Biro,L,SEA,26,13,2,2,4
78,8484325,Waltteri Merela,C,TBL,26,23,2,2,4
78,8474568,Luke Schenn,D,NSH,35,49,1,3,4
78,8480844,Grigori Denisenko,L,VGK,24,27,1,3,4
78,8482858,Ryker Evans,D,SEA,23,24,1,3,4
78,8477149,Scott Sabourin,R,SJS,32,18,1,3,4
78,8484254,Akito Hirose,D,VAN,25,43,0,4,4
78,8479576,Vincent Desharnais,D,VAN,28,38,0,4,4
78,8481593,Jayden Struble,D,MTL,23,24,0,4,4
78,8482070,Mitchell Chaffee,R,TBL,26,48,3,0,3
78,8483570,Ben Meyers,C,SEA,26,32,3,0,3
78,8479362,Riley Tufte,L,BOS,26,19,3,0,3
78,8482162,Roby Jarventie,L,EDM,22,15,3,0,3
78,8480890,Jan Jenik,C,OTT,24,26,3,0,3
78,8478881,Brett Seney,L,CHI,28,8,3,0,3
78,8480252,Cole Guttman,C,CHI,25,32,2,1,3
78,8481543,Nikita Alexandrov,C,STL,24,22,2,1,3
78,8483512,Matthew Savoie,C,EDM,20,18,2,1,3
78,8481806,Louis Crevier,D,CHI,23,11,2,1,3
78,8483763,Maksymilian Szuber,D,UTA,22,35,1,2,3
78,8479638,Justin Brazeau,R,BOS,26,37,1,2,3
78,8483630,Pavol Regenda,L,ANA,25,24,1,2,3
78,8479419,Brett Murray,L,BUF,26,23,1,2,3
78,8483012,Logan Morrison,C,SEA,22,33,1,2,3
78,8479379,Givani Smith,R,SJS,26,28,1,2,3
78,8482470,Ilya Solovyov,D,CGY,24,25,1,2,3
78,8477244,Chad Ruhwedel,D,NYR,34,35,1,2,3
78,8480874,Adam Ginning,D,PHI,24,15,1,2,3
78,8484258,Sam Malinski,D,COL,26,18,1,2,3
78,8477467,Gustav Olofsson,D,SEA,30,19,1,2,3
78,8482094,Daemon Hunt,D,MIN,22,13,1,2,3
78,8479587,Rhett Gardner,C,PHI,28,17,0,3,3
78,8479991,Jake Leschyshyn,C,NYR,25,18,0,3,3
78,8477073,Kurtis MacDermid,L,NJD,30,27,0,3,3
78,8480084,Nick DeSimone,D,NJD,30,18,0,3,3
78,8482460,Matt Rempe,C,NYR,22,20,0,3,3
78,8484287,Cole McWard,D,VAN,23,14,2,0,2
78,8482118,Sam Colangelo,R,ANA,23,15,2,0,2
78,8478051,Max Willman,C,NJD,29,22,2,0,2
78,8479367,William Lockwood,R,FLA,26,31,2,0,2
78,8481699,Aku Raty,R,UTA,23,11,2,0,2
78,8481006,Tyler Tucker,D,STL,24,12,2,0,2
78,8475755,Alexander Petrovic,D,DAL,32,10,2,0,2
78,8482476,Emil Heineman,L,MTL,23,7,2,0,2
78,8482250,Callahan Burke,C,VGK,27,16,1,1,2
78,8481030,Jack St. Ivany,D,PIT,25,16,1,1,2
78,8480851,Akil Thomas,C,LAK,24,17,1,1,2
78,8483597,Milos Kelemen,L,UTA,25,14,1,1,2
78,8482197,Adam Raska,R,MIN,23,10,1,1,2
78,8483489,Fraser Minten,C,TOR,31,10,1,1,2
78,8477971,Andreas Englund,D,LAK,28,27,1,1,2
78,8482929,Emil Lilleberg,D,TBL,23,26,1,1,2
78,8483546,Marshall Rifai,D,TOR,26,5,1,1,2
78,8477335,Kyle Burroughs,D,LAK,29,43,0,2,2
78,8481167,Brayden Pachal,D,CGY,25,46,0,2,2
78,8481743,Marc Del Gaizo,D,NSH,25,15,0,2,2
78,8474062,Riley Nash,C,NYR,35,14,0,2,2
78,8478502,Dennis Gilbert,D,BUF,28,20,0,2,2
78,8482165,Yan Kuznetsov,D,CGY,22,16,0,2,2
78,8482088,Justin Sourdif,R,FLA,22,14,0,2,2
78,8483395,Arshdeep Bains,L,VAN,23,8,0,2,2
78,8478011,Louie Belpedio,D,PHI,28,8,0,2,2
78,8477541,Dakota Mermis,D,TOR,30,7,0,2,2
78,8478021,William Lagesson,D,DET,28,27,0,2,2
78,8481422,Jake Lucchini,C,NSH,29,12,0,2,2
78,8478854,Ryan Shea,D,PIT,27,10,0,2,2
78,8481564,Ryan Johnson,D,BUF,23,16,0,2,2
78,8483397,Marc McLaughlin,C,BOS,25,29,1,0,1
78,8477473,Justin Bailey,R,SJS,29,28,1,0,1
78,8484304,Uvis Balinskis,D,FLA,28,11,1,0,1
78,8483531,Brian Halonen,L,NJD,25,5,1,0,1
78,8483920,Pierrick Dube,R,WSH,23,4,1,0,1
78,8478477,Mitchell Stephens,C,SEA,27,19,0,1,1
78,8475795,Dylan McIlrath,D,WSH,32,14,0,1,1
78,8480267,Sammy Walker,C,MIN,25,20,0,1,1
78,8481065,Angus Crookshank,L,OTT,25,19,0,1,1
78,8482516,Matthew Kessel,D,STL,24,20,0,1,1
78,8475413,Justin Dowling,C,NJD,34,15,0,1,1
78,8482126,Emil Andrae,D,PHI,31,6,0,1,1
78,8479330,Brandon Gignac,C,MTL,27,9,0,1,1
78,8483471,Brad Lambert,C,WPG,31,13,0,1,1
78,8480032,Shane Bowers,C,NJD,25,14,0,0,0
78,8481024,Linus Karlsson,C,VAN,25,11,0,0,0
78,8481719,Maxwell Crozier,D,TBL,24,15,0,0,0
78,8483567,Georgii Merkulov,C,BOS,24,6,0,0,0
78,8477993,Justin Kirkland,C,CGY,28,4,0,0,0
78,8480306,Grant Hutton,D,NYI,29,5,0,0,0
78,8482102,Vasily Ponomarev,C,PIT,22,16,0,0,0
78,8481043,Cole Koepke,L,BOS,26,21,0,0,0
78,8481206,John Ludvig,D,PIT,24,11,0,0,0
78,8480823,Alexander Alexeyev,D,WSH,25,10,0,0,0
78,8481462,Mason Morelli,L,VGK,28,16,0,0,0
78,8482787,Nikita Chibrikov,R,WPG,31,6,0,0,0
78,8480075,Cameron Crotty,D,MIN,25,12,0,0,0
78,8476323,Max McCormick,L,SEA,32,2,0,0,0
78,8481726,Adam Edstrom,C,NYR,24,5,0,0,0
78,8475780,Chris Wagner,R,COL,33,3,0,0,0
78,8478147,Bokondji Imama,L,PIT,28,3,0,0,0
78,8478446,Glenn Gawdin,C,LAK,27,8,0,0,0
78,8483432,Luca Del Bel Belluz,C,CBJ,31,7,0,0,0
78,8483398,Declan Carlile,D,TBL,31,2,0,0,0
78,8479421,Jacob Moverare,D,LAK,26,8,0,0,0
78,8484326,Patrik Koch,D,UTA,28,3,0,0,0
78,8483407,Brandon Scanlin,D,NYR,25,7,0,0,0
78,8481655,Cole Schwindt,R,CGY,23,8,0,0,0
78,8479522,Hardy Haman Aktell,D,WSH,26,4,0,0,0
78,8480274,Philip Kemp,D,EDM,25,1,0,0,0
78,8484255,Jason Polin,R,COL,25,5,0,0,0
78,8483609,Adam Klapka,R,CGY,24,0,0,0,0
78,8481534,Raphael Lavoie,C,EDM,24,5,0,0,0
78,8483401,Marc Johnstone,R,PIT,28,3,0,0,0
78,8484259,Ondrej Pavel,C,COL,31,3,0,0,0
78,8484321,Nikolas Matinpalo,D,OTT,26,3,0,0,0
78,8470794,Joe Pavelski,C,,40,0,0,0,0
78,8479321,Lucas Johansen,D,,27,0,0,0,0
78,8477950,Tony DeAngelo,D,,29,0,0,0,0
78,8471218,Blake Wheeler,R,,38,0,0,0,0
78,8475197,Tyson Barrie,D,,33,0,0,0,0
78,8474157,Max Pacioretty,L,,36,0,0,0,0
78,8475744,Evgeny Kuznetsov,C,,32,0,0,0,0
78,8474037,James van Riemsdyk,L,,35,0,0,0,0
78,8476907,Mackenzie MacEachern,L,,30,0,0,0,0
78,8480216,Jacob Peterson,C,,25,0,0,0,0
78,8474602,Justin Schultz,D,,34,0,0,0,0
78,8482222,Alexander Barabanov,L,,30,0,0,0,0
78,8474031,Kevin Shattenkirk,D,,35,0,0,0,0
78,8477330,Dominik Kubalik,L,,29,0,0,0,0
78,8480884,Calen Addison,D,,24,0,0,0,0
78,8475906,John Klingberg,D,,32,0,0,0,0
78,8480008,Adam Ruzicka,C,,25,0,0,0,0
78,8476884,Derrick Pouliot,D,,30,0,0,0,0
78,8476919,Chris Tierney,C,,30,0,0,0,0
78,8479415,Michael McLeod,C,,26,0,0,0,0
78,8474870,Tyler Johnson,C,,34,0,0,0,0
78,8470604,Jeff Carter,C,,39,0,0,0,0
78,8478104,Sammy Blais,L,,28,0,0,0,0
78,8474884,Mike Hoffman,C,,35,0,0,0,0
78,8481591,Sam Poulin,R,,23,0,0,0,0
78,8471274,Alex Goligoski,D,,39,0,0,0,0
78,8476871,Tanner Pearson,L,,32,0,0,0,0
78,8476393,Nick Cousins,C,,31,0,0,0,0
78,8479977,Kailer Yamamoto,R,,26,0,0,0,0
78,8479346,Dillon Dube,C,,26,0,0,0,0
78,8480184,Gustav Lindstrom,D,,26,0,0,0,0
78,8479376,Victor Mete,D,,26,0,0,0,0
78,8473449,Kyle Okposo,R,,36,0,0,0,0
78,8481058,Jesse Ylonen,R,,25,0,0,0,0
78,8475752,Tyler Pitlick,C,,33,0,0,0,0
78,8481239,Samuel Fagemo,L,,24,0,0,0,0
78,8480821,Filip Zadina,R,,25,0,0,0,0
78,8470966,Mark Giordano,D,,41,0,0,0,0
78,8478495,Denis Gurianov,R,,27,0,0,0,0
78,8477464,Nic Petan,C,,29,0,0,0,0
78,8478099,Kevin Labanc,R,,29,0,0,0,0
78,8482241,Radim Zohorna,L,,28,0,0,0,0
78,8474040,Sam Gagner,C,,35,0,0,0,0
78,8479514,Rem Pitlick,C,,27,0,0,0,0
78,8478430,Oliver Kylington,D,,27,0,0,0,0
78,8479533,Joona Koppanen,L,,26,0,0,0,0
78,8479984,Cal Foote,D,,26,0,0,0,0
78,8477126,Jayson Megna,C,,34,0,0,0,0
78,8475164,Jakob Silfverberg,R,,34,0,0,0,0
78,8474009,Nick Bonino,C,,36,0,0,0,0
78,8479458,Nikita Zaitsev,D,,33,0,0,0,0
78,8477944,Jakub Vrana,L,,28,0,0,0,0
78,8471699,Andrew Cogliano,C,,37,0,0,0,0
78,8478067,Oskar Lindblom,L,,28,0,0,0,0
78,8471686,Marc Staal,D,,37,0,0,0,0
78,8470610,Zach Parise,L,,40,0,0,0,0
78,8478904,Steven Lorentz,C,,28,0,0,0,0
78,8473473,Milan Lucic,L,,36,0,0,0,0
78,8480031,Maxime Comtois,L,,25,0,0,0,0
78,8478512,Austin Czarnik,C,,32,0,0,0,0
78,8473504,Cal Clutterbuck,R,,37,0,0,0,0
78,8477454,Adam Erne,L,,29,0,0,0,0
78,8479383,Boris Katchouk,L,,26,0,0,0,0
78,8475825,Jani Hakanpää,D,,32,0,0,0,0
78,8477846,Ryan Carpenter,C,,33,0,0,0,0
78,8477930,Pierre-Edouard Bellemare,L,,39,0,0,0,0
78,8478400,Colin White,C,,27,0,0,0,0
78,8480226,Marián Studenic,R,,26,0,0,0,0
78,8480853,Liam Foudy,C,,24,0,0,0,0
78,8475797,Jarred Tinordi,D,,32,0,0,0,0
78,8479423,Alex Nylander,L,,26,0,0,0,0
78,8474618,Marco Scandella,D,,34,0,0,0,0
78,8478028,Fredrik Olofsson,L,,28,0,0,0,0
78,8474709,Matt Martin,L,,35,0,0,0,0
78,8481070,Hugh McGing,L,,26,0,0,0,0
78,8479546,Oskar Steen,C,,26,0,0,0,0
78,8474145,Robert Bortuzzo,D,,35,0,0,0,0
78,8476915,Jujhar Khaira,L,,30,0,0,0,0
78,8475278,Byron Froese,C,,33,0,0,0,0
78,8481812,Nikolai Knyzhov,D,,27,0,0,0,0
78,8478408,Travis Dermott,D,,28,0,0,0,0
78,8481077,John Leonard,L,,26,0,0,0,0
78,8479547,Matthew Phillips,R,,26,0,0,0,0
78,8480836,Jonathan Gruden,C,,24,0,0,0,0
78,8481690,Tyler Angle,C,,24,0,0,0,0
78,8475766,Austin Watson,L,,32,0,0,0,0
78,8481016,Ruslan Iskhakov,C,,24,0,0,0,0
78,8478078,Rourke Chartier,C,,28,0,0,0,0
78,8480776,Sheldon Rempal,R,,29,0,0,0,0
78,8478956,Samuel Laberge,L,NJD,27,2,0,0,0
78,8483045,Cameron Butler,R,CBJ,31,2,0,0,0
78,8484314,Jiri Smejkal,L,,28,0,0,0,0
79,8477492,Nathan MacKinnon,C,COL,29,81,64,92,156
79,8476453,Nikita Kucherov,R,TBL,31,82,55,100,155
79,8478402,Connor McDavid,C,EDM,27,80,43,102,145
79,8478483,Mitch Marner,R,TOR,27,77,36,93,129
79,8479314,Matthew Tkachuk,L,FLA,27,81,33,90,123
79,8479318,Auston Matthews,C,TOR,27,81,77,45,122
79,8477934,Leon Draisaitl,C,EDM,29,78,39,81,120
79,8481559,Jack Hughes,C,NJD,23,78,42,71,113
79,8477493,Aleksander Barkov,C,FLA,29,77,36,71,107
79,8484144,Connor Bedard,C,CHI,19,73,35,72,107
79,8477956,David Pastrnak,R,BOS,28,82,45,61,106
79,8478864,Kirill Kaprizov,L,MIN,27,75,36,66,102
79,8478550,Artemi Panarin,L,NYR,33,80,31,71,102
79,8478010,Brayden Point,C,TBL,28,82,49,50,99
79,8477409,Carter Verhaeghe,C,FLA,29,79,49,48,97
79,8480012,Elias Pettersson,C,VAN,26,75,41,52,93
79,8480830,Andrei Svechnikov,R,CAR,24,70,35,58,93
79,8479407,Jesper Bratt,L,NJD,26,78,34,59,93
79,8480027,Jason Robertson,L,DAL,25,81,35,57,92
79,8476468,J.T. Miller,C,VAN,31,70,32,60,92
79,8478398,Kyle Connor,L,WPG,28,72,43,47,90
79,8477939,William Nylander,R,TOR,28,82,37,53,90
79,8475166,John Tavares,C,TOR,34,80,34,56,90
79,8477933,Sam Reinhart,C,FLA,29,78,49,39,88
79,8480839,Rasmus Dahlin,D,BUF,24,70,25,63,88
79,8478403,Jack Eichel,C,VGK,28,78,38,49,87
79,8471675,Sidney Crosby,C,PIT,37,77,35,51,86
79,8480036,Miro Heiskanen,D,DAL,25,79,15,71,86
79,8476456,Jonathan Huberdeau,C,CGY,31,80,18,67,85
79,8478420,Mikko Rantanen,R,COL,28,82,30,54,84
79,8478445,Mathew Barzal,C,NYI,27,81,16,67,83
79,8477404,Jake Guentzel,C,TBL,30,81,29,53,82
79,8475172,Nazem Kadri,C,CGY,34,76,25,57,82
79,8480002,Nico Hischier,C,NJD,25,74,37,44,81
79,8480023,Robert Thomas,C,STL,25,70,20,61,81
79,8473419,Brad Marchand,L,BOS,36,80,37,43,80
79,8478427,Sebastian Aho,C,CAR,27,71,34,46,80
79,8477946,Dylan Larkin,C,DET,28,82,29,51,80
79,8474578,Erik Karlsson,D,PIT,34,79,14,65,79
79,8480801,Brady Tkachuk,L,OTT,25,77,37,41,78
79,8480069,Cale Makar,D,COL,26,69,14,64,78
79,8471215,Evgeni Malkin,C,PIT,38,80,33,44,77
79,8477960,Adrian Kempe,R,LAK,28,80,33,44,77
79,8477942,Kevin Fiala,L,LAK,28,81,29,48,77
79,8474141,Patrick Kane,R,DET,36,81,25,52,77
79,8479323,Adam Fox,D,NYR,26,73,16,61,77
79,8475913,Mark Stone,R,VGK,32,77,28,48,76
79,8479420,Tage Thompson,C,BUF,27,76,44,31,75
79,8479343,Clayton Keller,R,UTA,26,82,38,37,75
79,8478439,Travis Konecny,R,PHI,27,75,35,40,75
79,8479542,Brandon Hagel,L,TBL,26,82,35,39,74
79,8476454,Ryan Nugent-Hopkins,C,EDM,31,78,28,46,74
79,8471214,Alex Ovechkin,L,WSH,39,69,28,45,73
79,8476346,Johnny Gaudreau,L,CBJ,31,70,23,50,73
79,8477504,Josh Morrissey,D,WPG,29,71,20,53,73
79,8480800,Quinn Hughes,D,VAN,25,74,8,65,73
79,8478414,Timo Meier,R,NJD,28,70,36,36,72
79,8476459,Mika Zibanejad,C,NYR,31,77,24,48,72
79,8477496,Elias Lindholm,C,BOS,30,79,24,48,72
79,8478460,Zach Werenski,D,CBJ,27,77,16,56,72
79,8482740,Wyatt Johnston,C,DAL,21,79,37,34,71
79,8475754,Brock Nelson,C,NYI,33,80,30,41,71
79,8482665,Matty Beniers,C,SEA,22,73,24,47,71
79,8477500,Bo Horvat,C,NYI,29,79,35,35,70
79,8474564,Steven Stamkos,C,NSH,34,73,27,43,70
79,8482116,Tim Stützle,C,OTT,22,82,25,45,70
79,8476389,Vincent Trocheck,C,NYR,31,73,25,45,70
79,8476399,Blake Coleman,C,CGY,33,75,39,30,69
79,8475158,Ryan O'Reilly,C,NSH,33,74,37,32,69
79,8476887,Filip Forsberg,L,NSH,30,76,27,42,69
79,8478873,Troy Terry,R,ANA,27,74,26,43,69
79,8480018,Nick Suzuki,C,MTL,25,80,26,43,69
79,8480039,Martin Necas,C,CAR,25,73,18,51,69
79,8482093,Seth Jarvis,C,CAR,22,69,37,31,68
79,8475168,Matt Duchene,C,DAL,33,81,24,44,68
79,8479999,Casey Mittelstadt,C,COL,26,82,24,44,68
79,8471685,Anze Kopitar,C,LAK,37,78,23,45,68
79,8477935,Sam Bennett,C,FLA,28,76,33,34,67
79,8477951,Nick Schmaltz,C,UTA,28,77,26,41,67
79,8474600,Roman Josi,D,NSH,34,75,18,49,67
79,8475184,Chris Kreider,L,NYR,33,72,43,23,66
79,8476539,Jonathan Marchessault,R,NSH,34,77,36,30,66
79,8479400,Pierre-Luc Dubois,L,WSH,26,70,31,35,66
79,8474150,Mikael Backlund,C,CGY,35,76,22,44,66
79,8480803,Evan Bouchard,D,EDM,25,68,11,55,66
79,8480208,Drake Batherson,R,OTT,26,78,27,38,65
79,8480865,Noah Dobson,D,NYI,24,81,9,56,65
79,8478449,Roope Hintz,C,DAL,28,82,32,32,64
79,8481557,Matt Boldy,L,MIN,23,72,28,36,64
79,8476853,Morgan Rielly,D,TOR,30,73,12,52,64
79,8475167,Victor Hedman,D,TBL,34,80,9,55,64
79,8475765,Vladimir Tarasenko,R,DET,33,80,28,35,63
79,8474590,John Carlson,D,WSH,34,73,15,48,63
79,8482109,Alexis Lafrenière,L,NYR,23,74,28,34,62
79,8479385,Jordan Kyrou,C,STL,26,73,26,36,62
79,8479525,Ross Colton,C,COL,28,76,26,36,62
79,8478401,Pavel Zacha,C,BOS,27,80,25,37,62
79,8475692,Mats Zuccarello,R,MIN,37,72,20,42,62
79,8475798,Mikael Granlund,C,SJS,32,70,16,46,62
79,8484145,Zach Benson,L,BUF,19,72,16,46,62
79,8481068,Yegor Sharangovich,C,CGY,26,75,32,29,61
79,8477402,Pavel Buchnevich,L,STL,29,73,24,37,61
79,8477949,Alex Tuch,R,BUF,28,71,22,39,61
79,8476479,Phillip Danault,C,LAK,31,79,21,40,61
79,8475810,Bryan Rust,R,PIT,32,71,31,29,60
79,8476460,Mark Scheifele,C,WPG,31,73,31,29,60
79,8475784,Jeff Skinner,C,EDM,32,79,30,30,60
79,8478047,Michael Bunting,L,PIT,29,70,28,32,60
79,8482110,Dawson Mercer,C,NJD,23,75,28,32,60
79,8477476,Artturi Lehkonen,L,COL,29,82,31,28,59
79,8476881,Tomas Hertl,C,VGK,31,78,27,32,59
79,8478975,Mason Marchment,L,DAL,29,82,26,33,59
79,8475745,Charlie Coyle,C,BOS,32,76,23,36,59
79,8477503,Max Domi,C,TOR,29,80,15,44,59
79,8482684,Luke Hughes,D,NJD,21,71,9,50,59
79,8478519,Anthony Cirelli,C,TBL,27,81,24,34,58
79,8473512,Claude Giroux,R,OTT,36,78,18,40,58
79,8473994,Jamie Benn,L,DAL,35,80,16,42,58
79,8477346,MacKenzie Weegar,D,CGY,30,75,14,44,58
79,8479325,Charlie McAvoy,D,BOS,27,80,11,47,58
79,8475786,Zach Hyman,L,EDM,32,76,29,28,57
79,8477407,Anthony Duclair,L,NYI,29,81,23,34,57
79,8477940,Nikolaj Ehlers,L,WPG,28,70,22,35,57
79,8482113,Anton Lundell,C,FLA,23,80,14,43,57
79,8477501,Valeri Nichushkin,R,COL,29,82,34,22,56
79,8482078,Lucas Raymond,L,DET,22,81,21,35,56
79,8482699,Dylan Guenther,R,UTA,21,77,20,36,56
79,8477416,Oliver Bjorkstrand,R,SEA,29,69,19,37,56
79,8476448,William Karlsson,C,VGK,31,77,23,32,55
79,8478440,Dylan Strome,C,WSH,27,72,20,35,55
79,8483808,Andrei Kuzmenko,L,CGY,28,74,27,27,54
79,8479337,Alex DeBrincat,R,DET,27,82,24,30,54
79,8478444,Brock Boeser,R,VAN,27,76,24,30,54
79,8474586,Jordan Eberle,R,SEA,34,69,24,30,54
79,8482702,Logan Stankoven,C,DAL,21,79,18,36,54
79,8475170,Brayden Schenn,C,STL,33,76,16,38,54
79,8476432,Boone Jenner,C,CBJ,31,72,31,22,53
79,8481540,Cole Caufield,R,MTL,23,75,27,26,53
79,8474641,Adam Henrique,C,EDM,34,79,25,28,53
79,8475726,Tyler Toffoli,C,SJS,32,65,23,30,53
79,8481528,Dylan Cozens,C,BUF,23,70,23,30,53
79,8477955,Jared McCann,L,SEA,28,73,22,31,53
79,8480798,Philipp Kurashev,C,CHI,25,69,18,35,53
79,8479425,Filip Hronek,D,VAN,27,73,13,40,53
79,8471698,T.J. Oshie,R,WSH,38,66,28,24,52
79,8482159,Tyson Foerster,R,PHI,22,75,26,26,52
79,8478493,Joel Eriksson Ek,C,MIN,27,73,25,27,52
79,8476483,Rickard Rakell,R,PIT,31,67,23,29,52
79,8477986,Brandon Montour,D,SEA,30,68,17,35,52
79,8476906,Shayne Gostisbehere,D,CAR,31,77,7,45,52
79,8475799,Nino Niederreiter,R,WPG,32,69,27,24,51
79,8477497,Sean Monahan,C,CBJ,30,70,18,33,51
79,8478407,Vince Dunn,D,SEA,28,80,6,45,51
79,8478046,Danton Heinen,L,VAN,29,71,21,29,50
79,8479591,Michael Eyssimont,C,TBL,28,81,20,30,50
79,8482667,William Eklund,L,SJS,22,71,19,31,50
79,8477494,Jonathan Drouin,L,COL,29,81,16,34,50
79,8477447,Shea Theodore,D,VGK,29,63,5,45,50
79,8475794,Tyler Seguin,C,DAL,32,82,27,22,49
79,8476923,Damon Severson,D,CBJ,30,78,18,31,49
79,8479345,Jakob Chychrun,D,WSH,26,61,16,33,49
79,8481581,Thomas Harley,D,DAL,23,78,15,34,49
79,8482124,Quinton Byfield,R,LAK,22,79,13,36,49
79,8475151,Kyle Palmieri,C,NYI,33,75,23,25,48
79,8477429,Andrew Copp,C,DET,30,80,23,25,48
79,8478856,Conor Garland,R,VAN,28,75,21,27,48
79,8483515,Juraj Slafkovsky,L,MTL,20,76,18,30,48
79,8476462,Dougie Hamilton,D,NJD,31,68,14,34,48
79,8476882,Teuvo Teravainen,C,CHI,30,65,12,36,48
79,8471724,Kris Letang,D,PIT,37,79,10,38,48
79,8479675,Trevor Moore,L,LAK,29,81,28,19,47
79,8480014,Gabriel Vilardi,C,WPG,25,64,26,21,47
79,8477511,Anthony Mantha,R,CGY,30,79,23,24,47
79,8478462,Nicolas Roy,C,VGK,27,77,23,24,47
79,8477479,Tyler Bertuzzi,L,CHI,29,65,22,25,47
79,8484166,Adam Fantilli,C,CBJ,20,69,22,25,47
79,8478498,Jake DeBrusk,L,VAN,28,78,20,27,47
79,8480220,Noah Cates,L,PHI,25,70,18,29,47
79,8474102,David Perron,L,OTT,36,79,17,30,47
79,8474679,Gustav Nyquist,C,NSH,35,70,15,32,47
79,8477932,Aaron Ekblad,D,FLA,28,70,12,35,47
79,8478438,Tommy Novak,C,NSH,27,73,11,36,47
79,8478397,Rasmus Andersson,D,CGY,28,75,4,43,47
79,8478366,Frank Vatrano,R,ANA,30,71,25,21,46
79,8477839,Conor Sheary,L,TBL,32,81,21,25,46
79,8478042,Viktor Arvidsson,L,EDM,31,71,18,28,46
79,8473986,Alex Killorn,L,ANA,35,74,18,28,46
79,8470613,Brent Burns,D,CAR,39,75,14,32,46
79,8476292,Ondrej Palat,L,NJD,33,73,12,34,46
79,8478038,Devon Toews,D,COL,30,70,12,34,46
79,8475191,Reilly Smith,R,NYR,33,72,23,22,45
79,8480835,Jack Drury,C,CAR,24,70,23,22,45
79,8482745,Mason McTavish,C,ANA,21,74,22,23,45
79,8481596,Shane Pinto,C,OTT,24,77,21,24,45
79,8480185,Eetu Luostarinen,C,FLA,26,73,19,26,45
79,8484153,Leo Carlsson,C,ANA,20,73,15,30,45
79,8478458,John (Jack) Roslovic,C,CAR,27,69,8,37,45
79,8480015,Owen Tippett,R,PHI,25,75,23,21,44
79,8480009,Eeli Tolvanen,R,SEA,25,71,23,21,44
79,8482133,Thomas Bordeleau,C,SJS,22,65,23,21,44
79,8475287,Erik Haula,L,NJD,33,70,19,25,44
79,8476792,Torey Krug,D,STL,33,71,16,28,44
79,8481524,Bowen Byram,D,BUF,23,71,16,28,44
79,8477998,Warren Foegele,L,LAK,28,80,14,30,44
79,8474565,Alex Pietrangelo,D,VGK,34,56,14,30,44
79,8481542,Moritz Seider,D,DET,23,79,12,32,44
79,8475768,Jaden Schwartz,C,SEA,32,68,22,21,43
79,8480188,Fabian Zetterlund,L,SJS,25,71,19,24,43
79,8476880,Tom Wilson,R,WSH,30,71,18,25,43
79,8475149,Marcus Johansson,L,MIN,34,65,18,25,43
79,8476826,Yanni Gourde,C,SEA,33,73,15,28,43
79,8476458,Ryan Strome,C,ANA,31,65,13,30,43
79,8477456,J.T. Compher,L,DET,29,80,19,23,42
79,8480797,Joel Farabee,L,PHI,24,76,15,27,42
79,8475753,Justin Faulk,D,STL,32,74,11,31,42
79,8482089,Jake Neighbours,L,STL,22,73,29,12,41
79,8476419,Jean-Gabriel Pageau,C,NYI,32,78,20,21,41
79,8474716,Jared Spurgeon,D,MIN,35,76,15,26,41
79,8480434,Sean Durzi,D,UTA,26,70,13,28,41
79,8477021,Alex Kerfoot,C,UTA,30,76,12,29,41
79,8479410,Mikhail Sergachev,D,UTA,26,68,10,31,41
79,8480145,Neal Pionk,D,WPG,29,71,10,31,41
79,8481711,Matias Maccelli,L,UTA,24,73,9,32,41
79,8481604,Pavel Dorofeyev,L,VGK,24,72,22,18,40
79,8481560,Arthur Kaliyev,R,LAK,23,78,22,18,40
79,8475314,Anders Lee,L,NYI,34,79,21,19,40
79,8482720,Matthew Knies,L,TOR,22,74,19,21,40
79,8477426,Nicholas Paul,L,TBL,29,82,19,21,40
79,8474149,Evgenii Dadonov,R,DAL,35,82,19,21,40
79,8478542,Evan Rodrigues,C,FLA,31,76,14,26,40
79,8480064,Josh Norris,C,OTT,25,72,24,15,39
79,8476438,Brandon Saad,L,STL,32,70,22,17,39
79,8476392,Adam Lowry,C,WPG,31,64,21,18,39
79,8479339,Patrik Laine,L,CBJ,26,62,13,26,39
79,8482712,Oskar Olausson,R,COL,22,77,7,32,39
79,8474563,Drew Doughty,D,LAK,35,70,6,33,39
79,8480459,Pius Suter,C,VAN,28,61,20,18,38
79,8483431,Logan Cooley,C,UTA,20,72,15,23,38
79,8477953,Kasperi Kapanen,R,STL,28,66,15,23,38
79,8476905,Chandler Stephenson,C,SEA,30,70,14,24,38
79,8475218,Mattias Ekholm,D,EDM,34,75,12,26,38
79,8476854,Hampus Lindholm,D,BOS,30,72,10,28,38
79,8482122,Brock Faber,D,MIN,22,76,10,28,38
79,8476869,Brady Skjei,D,NSH,30,71,9,29,38
79,8477948,Travis Sanheim,D,PHI,28,64,8,30,38
79,8475169,Evander Kane,L,EDM,33,75,20,17,37
79,8481618,Alex Newhook,C,MTL,23,72,20,17,37
79,8478115,Pierre Engvall,L,NYI,28,79,20,17,37
79,8480893,Kirill Marchenko,R,CBJ,24,66,19,18,37
79,8477989,Christian Dvorak,C,MTL,28,70,14,23,37
79,8483505,Matthew Poitras,C,BOS,20,79,13,24,37
79,8475714,Calle Jarnkrok,C,TOR,33,74,13,24,37
79,8482671,Owen Power,D,BUF,22,68,9,28,37
79,8481186,Logan O'Connor,R,COL,28,80,23,13,36
79,8479365,Trent Frederic,C,BOS,26,81,22,14,36
79,8477952,Robby Fabbri,C,ANA,28,67,20,16,36
79,8475722,Jason Zucker,L,BUF,32,65,18,18,36
79,8480078,Filip Chytil,C,NYR,25,68,17,19,36
79,8475763,Kevin Hayes,R,PIT,32,72,16,20,36
79,8473533,Jordan Staal,C,CAR,36,66,15,21,36
79,8480336,Sean Walker,D,CAR,30,73,15,21,36
79,8476875,Mike Matheson,D,MTL,30,72,6,30,36
79,8474673,TJ Brodie,D,CHI,34,65,4,32,36
79,8474715,Cameron Atkinson,R,TBL,35,81,20,15,35
79,8476872,Scott Laughton,C,PHI,30,67,15,20,35
79,8478413,Jordan Greenway,L,BUF,27,66,14,21,35
79,8477498,Darnell Nurse,D,EDM,29,75,13,22,35
79,8477495,Seth Jones,D,CHI,30,65,6,29,35
79,8480849,Barrett Hayton,C,UTA,24,72,21,13,34
79,8482125,Alexander Holtz,R,VGK,22,70,21,13,34
79,8481535,Nils Hoglander,L,VAN,24,73,18,16,34
79,8481533,Trevor Zegras,C,ANA,23,65,17,17,34
79,8482146,Luke Evangelista,R,NSH,22,66,16,18,34
79,8482705,Cole Sillinger,C,CBJ,21,68,16,18,34
79,8476474,Stefan Noesen,R,NJD,31,69,15,19,34
79,8478466,Daniel Sprong,R,VAN,27,72,14,20,34
79,8475760,Nick Bjugstad,C,UTA,32,74,14,20,34
79,8477987,Ryan Donato,C,CHI,28,56,14,20,34
79,8480813,Joe Veleno,C,DET,24,79,14,20,34
79,8482111,Justin Barron,D,MTL,23,61,14,20,34
79,8480028,Morgan Frost,C,PHI,25,71,13,21,34
79,8482149,Cole Perfetti,C,WPG,22,72,11,23,34
79,8474053,Logan Couture,C,SJS,35,60,10,24,34
79,8478469,Thomas Chabot,D,OTT,27,78,8,26,34
79,8481606,Jordan Spence,D,LAK,23,66,7,27,34
79,8481703,Valtteri Puustinen,R,PIT,25,62,7,27,34
79,8478055,Gustav Forsling,D,FLA,28,72,6,28,34
79,8482175,JJ Peterka,R,BUF,22,71,22,11,33
79,8479987,Morgan Geekie,C,BOS,26,78,15,18,33
79,8482475,Yegor Chinakhov,R,CBJ,23,58,15,18,33
79,8478472,Mathieu Joseph,R,STL,27,69,12,21,33
79,8476902,Esa Lindell,D,DAL,30,72,9,24,33
79,8480802,Ryan McLeod,C,BUF,25,66,8,25,33
79,8475764,Cam Fowler,D,ANA,33,76,3,30,33
79,8482097,Jack Quinn,R,BUF,23,64,15,17,32
79,8478233,Andrew Mangiapane,L,WSH,28,73,14,18,32
79,8480113,Alex Iafallo,L,WPG,31,64,14,18,32
79,8481032,Paul Cotter,C,NJD,25,65,13,19,32
79,8482660,Kent Johnson,C,CBJ,22,61,13,19,32
79,8480871,Adam Boqvist,D,FLA,24,62,11,21,32
79,8477947,Sonny Milano,L,WSH,28,58,11,21,32
79,8482101,Danil Gushchin,L,SJS,22,64,8,24,32
79,8476917,Adam Pelech,D,NYI,30,78,5,27,32
79,8479992,Michael Rasmussen,C,DET,25,77,17,14,31
79,8482055,Drew O'Connor,L,PIT,26,62,17,14,31
79,8477451,Ryan Hartman,R,MIN,30,71,16,15,31
79,8475231,Casey Cizikas,C,NYI,33,76,15,16,31
79,8477444,Andre Burakovsky,L,SEA,29,74,14,17,31
79,8482624,Daniil Miromanov,D,CGY,27,66,14,17,31
79,8480205,Emil Bemstrom,C,PIT,25,55,13,18,31
79,8480748,Kiefer Sherwood,L,VAN,29,58,13,18,31
79,8481481,Blake Lizotte,C,PIT,27,67,13,18,31
79,8477964,Ivan Barbashev,C,VGK,29,74,10,21,31
79,8475171,Oliver Ekman-Larsson,D,TOR,33,72,7,24,31
79,8476461,Sean Couturier,C,PHI,32,60,7,24,31
79,8476958,Jaccob Slavin,D,CAR,30,77,6,25,31
79,8477969,Marcus Pettersson,D,PIT,28,80,4,27,31
79,8476979,Erik Gustafsson,D,DET,32,70,4,27,31
79,8478474,Lawson Crouse,L,UTA,27,71,16,14,30
79,8480789,Oliver Wahlstrom,R,NYI,24,72,14,16,30
79,8481577,Philip Tomasino,C,NSH,23,68,11,19,30
79,8477425,Miles Wood,L,COL,29,77,11,19,30
79,8477505,Alexander Wennberg,C,SJS,30,59,10,20,30
79,8476480,Vladislav Namestnikov,C,WPG,32,66,8,22,30
79,8480817,K'Andre Miller,D,NYR,24,68,6,24,30
79,8478500,Ivan Provorov,D,CBJ,27,75,4,26,30
79,8481624,Ilya Mikheyev,R,CHI,30,50,17,12,29
79,8475855,Jesper Fast,R,CAR,33,58,17,12,29
79,8478013,Jake Walman,D,SJS,28,72,17,12,29
79,8482679,Matt Coronato,R,CGY,22,72,14,15,29
79,8477392,Hudson Fasching,R,NYI,29,64,13,16,29
79,8479351,Sam Steel,C,DAL,26,79,12,17,29
79,8482074,Connor Zary,C,CGY,23,58,12,17,29
79,8480073,Erik Brannstrom,D,COL,25,59,9,20,29
79,8482105,Jake Sanderson,D,OTT,22,75,8,21,29
79,8479976,Juuso Valimaki,D,UTA,26,67,7,22,29
79,8480873,Rasmus Sandin,D,WSH,24,65,4,25,29
79,8470621,Corey Perry,R,EDM,39,71,15,13,28
79,8476897,Oskar Sundqvist,C,STL,30,62,15,13,28
79,8478020,Michael Amadio,R,OTT,28,77,14,14,28
79,8478057,Dakota Joshua,C,VAN,28,67,14,14,28
79,8479661,Tanner Jeannot,L,LAK,27,77,12,16,28
79,8480068,Ryan Poehling,C,PHI,25,71,11,17,28
79,8476927,Teddy Blueger,C,VAN,30,65,10,18,28
79,8475200,Dmitry Orlov,D,CAR,33,74,8,20,28
79,8478891,Mason Appleton,C,WPG,28,57,8,20,28
79,8479315,Joey Anderson,R,CHI,26,58,7,21,28
79,8481546,Cam York,D,PHI,23,61,6,22,28
79,8477488,Brett Pesce,D,NJD,30,70,5,23,28
79,8476278,Colin Blackwell,C,DAL,31,79,18,9,27
79,8476918,Jimmy Vesey,L,NYR,31,67,14,13,27
79,8478911,Matt Roy,D,WSH,29,65,12,15,27
79,8482092,Ridly Greig,C,OTT,22,77,11,16,27
79,8481523,Kirby Dach,C,MTL,23,67,10,17,27
79,8474189,Lars Eller,C,PIT,35,60,10,17,27
79,8480289,Morgan Barron,C,WPG,26,63,10,17,27
79,8479639,Dylan Coghlan,D,WPG,26,61,9,18,27
79,8478133,Jake Evans,C,MTL,28,71,8,19,27
79,8475848,Brendan Gallagher,R,MTL,32,71,7,20,27
79,8476885,Jacob Trouba,D,NYR,30,69,7,20,27
79,8481014,Alexander Romanov,D,NYI,24,79,6,21,27
79,8480049,Dylan Samberg,D,WPG,25,68,2,25,27
79,8474151,Ryan McDonagh,D,TBL,35,76,1,26,27
79,8481656,Aliaksei Protas,C,WSH,23,67,14,12,26
79,8476925,Colton Sissons,C,NSH,31,64,13,13,26
79,8477450,Jason Dickinson,C,CHI,29,54,12,14,26
79,8479368,Max Jones,L,BOS,26,67,8,18,26
79,8482809,Jackson Blake,R,CAR,21,57,8,18,26
79,8477506,Ryan Pulock,D,NYI,30,79,4,22,26
79,8480878,Nils Lundkvist,D,DAL,24,71,4,22,26
79,8478851,Alexandre Carrier,D,NSH,28,75,2,24,26
79,8475225,Craig Smith,C,CHI,35,55,20,5,25
79,8481554,Kaapo Kakko,R,NYR,23,72,17,8,25
79,8475193,Tomas Tatar,L,NJD,34,63,16,9,25
79,8477919,Frederick Gaudreau,C,MIN,31,57,12,13,25
79,8477508,Curtis Lazar,C,NJD,29,58,12,13,25
79,8479941,Justin Danforth,R,CBJ,31,57,11,14,25
79,8477015,Connor Brown,R,EDM,30,60,11,14,25
79,8478109,Victor Olofsson,L,VGK,29,67,10,15,25
79,8480980,Connor Dewar,C,TOR,25,66,10,15,25
79,8483491,Ivan Miroshnichenko,L,WSH,20,62,7,18,25
79,8481704,Juuso Parssinen,C,NSH,23,50,7,18,25
79,8479414,Nathan Bastian,R,NJD,27,57,7,18,25
79,8478396,Noah Hanifin,D,VGK,27,58,6,19,25
79,8475790,Erik Gudbranson,D,CBJ,32,79,4,21,25
79,8473507,Jeff Petry,D,DET,37,74,2,23,25
79,8481178,Egor Zamula,D,PHI,24,63,2,23,25
79,8479619,Michael Carcone,L,UTA,28,66,15,9,24
79,8481580,Connor McMichael,C,WSH,23,65,11,13,24
79,8481441,Joe Snively,C,DET,28,64,11,13,24
79,8475793,Ryan Johansen,C,PHI,32,71,10,14,24
79,8473563,Nicklas Backstrom,C,WSH,37,55,10,14,24
79,8475791,Taylor Hall,L,CHI,33,56,9,15,24
79,8480806,Isac Lundestrom,C,ANA,25,58,9,15,24
79,8483457,Lane Hutson,D,MTL,20,65,8,16,24
79,8476457,Adam Larsson,D,SEA,32,64,7,17,24
79,8476892,Colton Parayko,D,STL,31,71,6,18,24
79,8484203,Bradly Nadeau,L,CAR,19,64,5,19,24
79,8479402,Jake Bean,D,CGY,26,64,5,19,24
79,8480891,Michael Kesselring,D,UTA,24,57,4,20,24
79,8483490,Pavel Mintyukov,D,ANA,21,73,3,21,24
79,8475179,Dmitry Kulikov,D,FLA,34,69,3,21,24
79,8482259,Bobby McMann,C,TOR,28,66,15,8,23
79,8483524,Shane Wright,C,SEA,20,63,15,8,23
79,8473422,Nick Foligno,L,CHI,37,51,14,9,23
79,8482079,Marco Rossi,C,MIN,23,60,13,10,23
79,8476921,Jordan Martinook,L,CAR,32,64,12,11,23
79,8475220,Marcus Foligno,L,MIN,33,62,11,12,23
79,8482737,Zack Bolduc,C,STL,21,60,11,12,23
79,8480855,Jack McBain,C,UTA,24,63,9,14,23
79,8481553,Bobby Brink,R,PHI,23,67,7,16,23
79,8484149,Gavin Brindley,C,CBJ,20,57,5,18,23
79,8478507,John Marino,D,UTA,27,66,4,19,23
79,8479324,Ryan Lindgren,D,NYR,26,65,4,19,23
79,8481059,Scott Perunovich,D,STL,26,60,2,21,23
79,8482073,Braden Schneider,D,NYR,23,63,2,21,23
79,8480281,Alexey Toropchenko,R,STL,25,53,15,7,22
79,8482117,Lukas Reichel,L,CHI,22,55,13,9,22
79,8479520,Brandon Duhaime,R,WSH,27,58,13,9,22
79,8478463,Anthony Beauvillier,L,PIT,27,58,12,10,22
79,8483468,Jiri Kulich,C,BUF,20,59,9,13,22
79,8476981,Josh Anderson,R,MTL,30,71,9,13,22
79,8483499,Liam Ohgren,L,MIN,20,52,6,16,22
79,8478970,Jalen Chatfield,D,CAR,28,71,5,17,22
79,8482655,Janis Moser,D,TBL,24,78,4,18,22
79,8476329,Travis Boyd,C,MIN,31,62,4,18,22
79,8476856,Mathew Dumba,D,DAL,30,74,4,18,22
79,8476463,Jonas Brodin,D,MIN,31,76,3,19,22
79,8476988,Matt Benning,D,SJS,30,65,2,20,22
79,8481601,Simon Holmstrom,R,NYI,23,65,12,9,21
79,8481537,Nikita Okhotiuk,D,CGY,24,54,10,11,21
79,8476873,Mark Jankowski,C,NSH,30,58,9,12,21
79,8476889,Radek Faksa,C,STL,30,62,8,13,21
79,8479293,Brandon Tanev,L,SEA,33,63,7,14,21
79,8477435,Ryan Graves,D,PIT,29,77,4,17,21
79,8478416,Erik Cernak,D,TBL,27,75,3,18,21
79,8478178,Darren Raddysh,D,TBL,28,65,2,19,21
79,8480043,Timothy Liljegren,D,TOR,25,70,1,20,21
79,8476331,Dylan DeMelo,D,WPG,31,68,1,20,21
79,8482245,Artem Zub,D,OTT,29,68,1,20,21
79,8475324,Nick Jensen,D,OTT,34,68,0,21,21
79,8480829,Jesperi Kotkaniemi,C,CAR,24,58,10,10,20
79,8478569,Noel Acciari,C,PIT,33,56,10,10,20
79,8477979,Nicolas Aube-Kubel,R,BUF,28,54,9,11,20
79,8477478,William Carrier,L,CAR,30,52,9,11,20
79,8483565,Nick Blankenburg,D,NSH,26,63,9,11,20
79,8480011,Klim Kostin,C,SJS,25,52,9,11,20
79,8481013,Jonatan Berggren,R,DET,24,55,9,11,20
79,8479316,Luke Kunin,C,SJS,27,54,8,12,20
79,8478585,Derek Ryan,C,EDM,38,63,6,14,20
79,8477507,Nikita Zadorov,D,BOS,29,64,5,15,20
79,8478882,Vladislav Gavrikov,D,LAK,29,65,5,15,20
79,8478432,Christian Fischer,R,DET,27,71,5,15,20
79,8482087,Kaiden Guhle,D,MTL,22,69,5,15,20
79,8475279,Ben Chiarot,D,DET,33,75,5,15,20
79,8477220,Nate Schmidt,D,FLA,33,68,4,16,20
79,8474574,Tyler Myers,D,VAN,34,68,3,17,20
79,8476967,Brett Kulak,D,EDM,30,57,2,18,20
79,8481093,Rafael Harvey-Pinard,L,MTL,25,57,10,9,19
79,8473453,Trevor Lewis,C,LAK,37,73,10,9,19
79,8476867,Brendan Gaunce,C,MIN,30,37,10,9,19
79,8480762,Eric Robinson,L,CAR,29,59,9,10,19
79,8478508,Yakov Trenin,C,MIN,27,61,9,10,19
79,8479996,Cody Glass,C,NSH,25,56,8,11,19
79,8474034,Patrick Maroon,L,CHI,36,50,8,11,19
79,8478043,Sam Lafferty,C,BUF,29,61,8,11,19
79,8475181,Nick Leddy,D,STL,33,72,7,12,19
79,8476469,Joel Armia,R,MTL,31,72,7,12,19
79,8479066,Ryan Lomberg,L,CGY,30,66,7,12,19
79,8483445,Cutter Gauthier,L,ANA,20,63,5,14,19
79,8480860,Kevin Bahl,D,CGY,24,64,5,14,19
79,8482192,Isaak Phillips,D,CHI,23,55,5,14,19
79,8480246,Nick Perbix,D,TBL,26,68,4,15,19
79,8481019,David Gustafsson,C,WPG,24,54,4,15,19
79,8481521,Ronnie Attard,D,PHI,25,59,3,16,19
79,8479371,Dante Fabbro,D,NSH,26,65,3,16,19
79,8481568,Alex Vlasic,D,CHI,23,53,3,16,19
79,8475462,Radko Gudas,D,ANA,34,65,2,17,19
79,8479336,Carl Grundstrom,R,SJS,27,55,15,3,18
79,8477903,Garnet Hathaway,R,PHI,33,55,13,5,18
79,8481582,Nicholas Robertson,L,TOR,23,69,12,6,18
79,8477446,Michael McCarron,R,NSH,29,61,11,7,18
79,8476960,Andreas Athanasiou,C,CHI,30,54,10,8,18
79,8479393,Noah Gregor,L,OTT,26,69,7,11,18
79,8480144,David Kampf,C,TOR,29,61,7,11,18
79,8481517,Brett Leason,R,ANA,25,50,7,11,18
79,8482062,Cole Smith,L,NSH,29,57,6,12,18
79,8482744,James Malatesta,L,CBJ,21,47,6,12,18
79,8480074,Alexandre Texier,C,STL,25,51,5,13,18
79,8479982,Conor Timmins,D,TOR,26,50,4,14,18
79,8479998,Mikey Anderson,D,LAK,25,65,4,14,18
79,8475233,David Savard,D,MTL,34,65,4,14,18
79,8480070,Ian Mitchell,D,BOS,25,56,4,14,18
79,8476429,Scott Mayfield,D,NYI,32,69,3,15,18
79,8482451,Mikael Pyyhtia,L,CBJ,23,44,3,15,18
79,8478136,Jake Middleton,D,MIN,28,71,2,16,18
79,8479398,Samuel Girard,D,COL,26,61,1,17,18
79,8475188,Brayden McNabb,D,VGK,33,57,1,17,18
79,8476374,Sean Kuraly,C,CBJ,31,56,9,8,17
79,8479390,Taylor Raddysh,R,WSH,26,59,7,10,17
79,8479353,Brett Howden,C,VGK,26,64,6,11,17
79,8476422,Mike Reilly,D,NYI,31,73,6,11,17
79,8480995,Pontus Holmberg,R,TOR,25,55,6,11,17
79,8478434,Keegan Kolesar,R,VGK,27,65,6,11,17
79,8475343,Nic Dowd,C,WSH,34,54,6,11,17
79,8476525,Colin Miller,D,WPG,32,63,5,12,17
79,8482067,Connor Mackey,D,NYR,28,62,4,13,17
79,8479980,Nicolas Hague,D,VGK,26,54,4,13,17
79,8481477,Nico Sturm,C,SJS,29,56,4,13,17
79,8476467,Jamie Oleksiak,D,SEA,32,65,3,14,17
79,8481708,Zac Jones,D,NYR,24,57,3,14,17
79,8480035,Henri Jokiharju,D,BUF,25,62,2,15,17
79,8475455,Brenden Dillon,D,NJD,34,61,2,15,17
79,8475690,Chris Tanev,D,TOR,35,55,2,15,17
79,8480796,Martin Fehervary,D,WSH,25,51,2,15,17
79,8480157,Calle Rosen,D,COL,30,55,2,15,17
79,8481641,Joel Kiviranta,L,COL,28,69,12,4,16
79,8476994,Vinnie Hinostroza,C,NSH,30,48,9,7,16
79,8478421,A.J. Greer,L,FLA,28,58,8,8,16
79,8479994,Jaret Anderson-Dolan,C,WPG,25,43,8,8,16
79,8483493,Frank Nazar,C,CHI,20,52,7,9,16
79,8479370,Tyson Jost,C,CAR,26,49,7,9,16
79,8477018,Ben Hutton,D,VGK,31,54,6,10,16
79,8481592,Jakob Pelletier,L,CGY,23,46,6,10,16
79,8478840,Will Borgen,D,SEA,28,71,4,12,16
79,8482803,Olen Zellweger,D,ANA,21,64,4,12,16
79,8481550,Adam Beckman,L,NJD,23,44,4,12,16
79,8482964,Arber Xhekaj,D,MTL,23,49,4,12,16
79,8481028,Martin Pospisil,C,CGY,25,50,3,13,16
79,8483460,David Jiricek,D,CBJ,21,67,3,13,16
79,8480222,Sebastian Aho,D,PIT,28,68,2,14,16
79,8477931,Tomas Nosek,L,FLA,32,52,8,7,15
79,8482142,Jamie Drysdale,D,PHI,22,62,6,9,15
79,8479439,Jacob MacDonald,D,COL,31,47,5,10,15
79,8479328,Julien Gauthier,R,NYI,27,60,5,10,15
79,8481161,Jake Christiansen,D,CBJ,25,55,5,10,15
79,8480448,Parker Kelly,L,COL,25,74,4,11,15
79,8476879,Cody Ceci,D,EDM,31,71,3,12,15
79,8476891,Matthew Grzelcyk,D,PIT,30,74,2,13,15
79,8477845,Trevor van Riemsdyk,D,WSH,33,58,2,13,15
79,8477365,Connor Clifton,D,BUF,29,59,2,13,15
79,8480172,Jan Rutta,D,SJS,34,65,2,13,15
79,8478451,Ethan Bear,D,WSH,27,49,1,14,15
79,8482155,Alex Laferriere,R,LAK,23,54,11,3,14
79,8481679,Maxence Guenette,D,OTT,23,37,9,5,14
79,8476878,Zemgus Girgensons,C,TBL,30,79,8,6,14
79,8476934,Brock McGinn,L,ANA,30,57,8,6,14
79,8480025,MacKenzie Entwistle,R,FLA,25,60,7,7,14
79,8479718,Alex Barré-Boulet,C,MTL,27,45,7,7,14
79,8478211,Dryden Hunt,L,CGY,29,56,7,7,14
79,8480848,Ty Dellandrea,C,SJS,24,39,7,7,14
79,8482077,Dylan Holloway,L,EDM,23,48,7,7,14
79,8477406,Mattias Janmark,C,EDM,32,69,6,8,14
79,8479369,Andrew Peeke,D,BOS,26,59,6,8,14
79,8475842,Sam Carrick,C,NYR,32,62,6,8,14
79,8476822,Luke Glendening,C,TBL,35,78,6,8,14
79,8481527,Kaedan Korczak,D,VGK,23,54,6,8,14
79,8482749,Joshua Roy,R,MTL,21,63,5,9,14
79,8483482,Tristan Luneau,D,ANA,20,64,5,9,14
79,8480003,Jesper Boqvist,C,FLA,26,63,5,9,14
79,8477499,Rasmus Ristolainen,D,PHI,30,57,4,10,14
79,8481167,Brayden Pachal,D,CGY,25,43,4,10,14
79,8479983,Mario Ferraro,D,SJS,26,70,3,11,14
79,8478452,Caleb Jones,D,LAK,27,60,3,11,14
79,8478859,Niko Mikkola,D,FLA,28,57,2,12,14
79,8478443,Brandon Carlo,D,BOS,28,62,0,14,14
79,8483763,Maksymilian Szuber,D,UTA,22,37,8,5,13
79,8479291,Kevin Rooney,C,CGY,31,47,7,6,13
79,8479671,Mathieu Olivier,R,CBJ,27,49,7,6,13
79,8480252,Cole Guttman,C,CHI,25,40,7,6,13
79,8477353,Tyler Motte,C,DET,29,72,6,7,13
79,8481522,Peyton Krebs,C,BUF,23,49,6,7,13
79,8482157,Will Cuylle,L,NYR,22,62,6,7,13
79,8476624,Barclay Goodrow,C,SJS,31,56,5,8,13
79,8480887,Jordan Harris,D,MTL,24,49,4,9,13
79,8477369,Carson Soucy,D,VAN,30,63,4,9,13
79,8482148,Hendrix Lapierre,C,WSH,22,52,3,10,13
79,8473446,Erik Johnson,D,PHI,36,57,3,10,13
79,8476874,Olli Maatta,D,DET,30,61,2,11,13
79,8481617,Vasily Podkolzin,R,VAN,23,50,8,4,12
79,8478831,Kevin Stenlund,C,UTA,28,57,6,6,12
79,8480021,Jack Studnicka,C,LAK,25,65,6,6,12
79,8483466,Kevin Korchinski,D,CHI,20,48,5,7,12
79,8479968,Vinni Lettieri,C,BOS,29,45,4,8,12
79,8470600,Ryan Suter,D,STL,39,63,4,8,12
79,8480192,Johnathan Kovacevic,D,NJD,27,54,4,8,12
79,8482095,Tyler Kleven,D,OTT,22,43,3,9,12
79,8482730,Brandt Clarke,D,LAK,21,52,3,9,12
79,8476931,Jake McCabe,D,TOR,31,64,2,10,12
79,8482176,Wyatt Kaiser,D,CHI,22,60,2,10,12
79,8475750,Jon Merrill,D,MIN,32,57,1,11,12
79,8471709,Marc-Edouard Vlasic,D,SJS,37,60,1,11,12
79,8479972,Mason Shaw,C,WPG,26,40,1,11,12
79,8484254,Akito Hirose,D,VAN,25,40,1,11,12
79,8476442,Matt Nieto,L,PIT,32,50,8,3,11
79,8482747,Brennan Othmann,L,NYR,21,41,6,5,11
79,8477573,Nathan Walker,L,STL,30,58,4,7,11
79,8477380,Jonny Brodzinski,C,NYR,31,50,4,7,11
79,8482784,Zach Dean,C,STL,21,42,4,7,11
79,8480001,Urho Vaakanainen,D,ANA,25,57,3,8,11
79,8479344,Jesse Puljujarvi,R,PIT,26,52,3,8,11
79,8481599,Victor Soderstrom,D,UTA,23,40,3,8,11
79,8480845,Rasmus Kupari,C,WPG,24,33,3,8,11
79,8478399,Jonas Siegenthaler,D,NJD,27,53,2,9,11
79,8474166,Alec Martinez,D,CHI,37,49,2,9,11
79,8480807,Mattias Samuelsson,D,BUF,24,58,1,10,11
79,8480950,Ilya Lyubushkin,D,DAL,30,56,1,10,11
79,8479348,Kale Clague,D,BUF,26,40,1,10,11
79,8478424,Jansen Harkins,C,ANA,27,44,8,2,10
79,8481716,Dmitri Voronkov,L,CBJ,24,38,6,4,10
79,8479442,Troy Stecher,D,EDM,30,54,5,5,10
79,8483012,Logan Morrison,C,SEA,22,40,5,5,10
79,8477335,Kyle Burroughs,D,LAK,29,41,5,5,10
79,8481147,Reese Johnson,C,MIN,26,43,4,6,10
79,8481751,Lukas Rousek,R,BUF,25,44,4,6,10
79,8482666,Scott Morrow,D,CAR,22,45,4,6,10
79,8479543,Michael Pezzetta,L,MTL,26,50,2,8,10
79,8475177,Calvin de Haan,D,COL,33,45,2,8,10
79,8476441,Joel Edmundson,D,LAK,31,36,2,8,10
79,8478454,Noah Juulsen,D,VAN,27,31,2,8,10
79,8476312,Josh Manson,D,COL,33,67,1,9,10
79,8482634,Alex Steeves,C,TOR,25,48,1,9,10
79,8479372,Joshua Mahura,D,SEA,26,51,1,9,10
79,8477482,Zachary Sanford,L,CHI,30,43,1,9,10
79,8482166,Shakir Mukhamadullin,D,SJS,22,53,6,3,9
79,8480245,Olle Lycksell,R,PHI,25,42,5,4,9
79,8479026,Philippe Myers,D,TOR,27,53,4,5,9
79,8477070,Liam O'Brien,C,UTA,30,57,4,5,9
79,8482141,Lukas Cormier,D,VGK,22,25,4,5,9
79,8471677,Jack Johnson,D,CBJ,37,61,4,5,9
79,8479536,Axel Jonsson-Fjallby,L,WPG,26,37,4,5,9
79,8482659,Josh Doan,R,UTA,22,44,3,6,9
79,8482859,Zack Ostapchuk,C,OTT,21,51,3,6,9
79,8482733,Logan Mailloux,D,MTL,31,41,3,6,9
79,8477401,John Hayden,C,SEA,29,42,3,6,9
79,8480879,Jacob Bernard-Docker,D,OTT,24,48,3,6,9
79,8481701,Santeri Hatakka,D,NJD,23,47,3,6,9
79,8479986,Kole Lind,R,DAL,26,45,2,7,9
79,8475762,Derek Forbort,D,VAN,32,49,2,7,9
79,8475718,Justin Holl,D,DET,32,56,1,8,9
79,8480196,Jacob Bryson,D,BUF,27,40,1,8,9
79,8475208,Brian Dumoulin,D,ANA,33,59,0,9,9
79,8482762,Simon Edvinsson,D,DET,21,46,5,3,8
79,8480441,Trey Fix-Wolansky,R,CBJ,25,35,5,3,8
79,8479367,William Lockwood,R,FLA,26,32,5,3,8
79,8479359,Beck Malenstyn,L,BUF,26,42,4,4,8
79,8475958,Michael Sgarbossa,C,WSH,32,29,4,4,8
79,8476952,Dominic Toninato,C,WPG,30,37,4,4,8
79,8479981,Jonah Gadjovich,L,FLA,26,48,4,4,8
79,8480355,Mark Kastelic,C,BOS,25,58,3,5,8
79,8483495,Simon Nemec,D,NJD,20,45,3,5,8
79,8481567,Henry Thrun,D,SJS,23,53,2,6,8
79,8477320,Anton Blidh,L,NYR,29,24,2,6,8
79,8474567,Zach Bogosian,D,MIN,34,64,1,7,8
79,8474612,Travis Hamonic,D,OTT,34,43,1,7,8
79,8481600,Tobias Bjornfot,D,FLA,23,43,1,7,8
79,8477034,Jaycob Megna,D,FLA,32,45,1,7,8
79,8482751,Ryan Winterton,C,SEA,21,37,1,7,8
79,8477887,Patrick Brown,C,BOS,32,37,5,2,7
79,8471817,Ryan Reaves,R,TOR,37,62,4,3,7
79,8483570,Ben Meyers,C,SEA,26,28,4,3,7
79,8480292,Carson Meyer,R,ANA,27,30,3,4,7
79,8481754,Nikita Nesterenko,C,ANA,23,36,3,4,7
79,8479772,Zack MacEwen,R,OTT,28,49,3,4,7
79,8482145,Mavrik Bourque,C,DAL,22,53,3,4,7
79,8477527,Ross Johnston,L,ANA,30,39,3,4,7
79,8480834,Ty Emberson,D,SJS,24,36,3,4,7
79,8482861,Vincent Iorio,D,WSH,22,32,3,4,7
79,8482765,Isak Rosen,R,BUF,21,32,3,4,7
79,8474568,Luke Schenn,D,NSH,35,50,3,4,7
79,8483549,Lucas Condotta,L,MTL,27,32,2,5,7
79,8479944,Zach Aston-Reese,C,VGK,30,51,2,5,7
79,8482652,Walker Duehr,R,CGY,27,41,2,5,7
79,8480844,Grigori Denisenko,L,VGK,24,30,2,5,7
79,8483619,Filip Roos,D,OTT,25,29,1,6,7
79,8476473,Connor Murphy,D,CHI,31,42,1,6,7
79,8481605,Jackson LaCombe,D,ANA,23,34,1,6,7
79,8480058,Pierre-Olivier Joseph,D,STL,25,52,0,7,7
79,8474013,Ian Cole,D,UTA,35,53,0,7,7
79,8482070,Mitchell Chaffee,R,TBL,26,51,6,0,6
79,8478409,Anthony Richard,C,PHI,28,38,4,2,6
79,8479638,Justin Brazeau,R,BOS,26,35,4,2,6
79,8483397,Marc McLaughlin,C,BOS,25,33,4,2,6
79,8477473,Justin Bailey,R,SJS,29,24,3,3,6
79,8478468,Jeremy Lauzon,D,NSH,27,48,2,4,6
79,8482807,Ethan Del Mastro,D,CHI,21,41,2,4,6
79,8481532,Alex Turcotte,C,LAK,23,48,2,4,6
79,8480007,Jonas Rondbjerg,R,VGK,25,43,2,4,6
79,8480880,Jakub Lauko,C,MIN,24,30,2,4,6
79,8480870,Bo Groulx,C,NYR,24,30,2,4,6
79,8482858,Ryker Evans,D,SEA,23,28,2,4,6
79,8481518,Nolan Foote,L,NJD,24,37,1,5,6
79,8476858,Phillip Di Giuseppe,L,VAN,31,35,5,0,5
79,8480990,Declan Chisholm,D,MIN,24,45,4,1,5
79,8480468,James Hamblin,L,EDM,25,20,4,1,5
79,8478874,Adam Gaudette,R,OTT,28,35,3,2,5
79,8475235,Nicolas Deslauriers,L,PHI,33,49,2,3,5
79,8481609,Vladislav Kolyachonok,D,UTA,23,30,2,3,5
79,8482177,Marat Khusnutdinov,C,MIN,22,31,2,3,5
79,8484258,Sam Malinski,D,COL,26,19,2,3,5
79,8475795,Dylan McIlrath,D,WSH,32,22,2,3,5
79,8480267,Sammy Walker,C,MIN,25,24,2,3,5
79,8481789,Tye Kartye,L,SEA,23,38,1,4,5
79,8476913,Devin Shore,C,MIN,30,28,1,4,5
79,8474090,Brendan Smith,D,DAL,35,52,1,4,5
79,8484911,Collin Graf,R,SJS,22,39,1,4,5
79,8482929,Emil Lilleberg,D,TBL,23,24,1,4,5
79,8480727,Zach Whitecloud,D,VGK,28,50,0,5,5
79,8479249,Andrew Poturalski,C,SJS,30,27,0,5,5
79,8477938,Haydn Fleury,D,WPG,28,44,0,5,5
79,8481543,Nikita Alexandrov,C,STL,24,26,0,5,5
79,8481743,Marc Del Gaizo,D,NSH,25,15,0,5,5
79,8481122,Simon Benoit,D,TOR,26,40,3,1,4
79,8482511,Mason Lohrei,D,BOS,23,29,3,1,4
79,8477962,Brendan Lemieux,L,CAR,28,35,2,2,4
79,8478146,Matthew Highmore,C,OTT,28,37,2,2,4
79,8482713,Mackie Samoskevich,R,FLA,22,39,2,2,4
79,8482147,Jean-Luc Foudy,C,COL,22,30,2,2,4
79,8479576,Vincent Desharnais,D,VAN,28,34,2,2,4
79,8481593,Jayden Struble,D,MTL,23,21,2,2,4
79,8479362,Riley Tufte,L,BOS,26,20,2,2,4
79,8477244,Chad Ruhwedel,D,NYR,34,33,2,2,4
79,8481056,Spencer Stastney,D,NSH,24,30,1,3,4
79,8477851,Jordan Oesterle,D,BOS,32,37,1,3,4
79,8482201,Gage Goncalves,C,TBL,23,21,1,3,4
79,8481598,Philip Broberg,D,EDM,23,43,1,3,4
79,8479320,Maxime Lajoie,D,SEA,27,20,1,3,4
79,8481556,John Beecher,C,BOS,23,29,1,3,4
79,8483512,Matthew Savoie,C,EDM,20,25,1,3,4
79,8477073,Kurtis MacDermid,L,NJD,30,27,1,3,4
79,8481719,Maxwell Crozier,D,TBL,24,18,1,3,4
79,8482496,Nils Aman,C,VAN,24,45,0,4,4
79,8479379,Givani Smith,R,SJS,26,30,0,4,4
79,8477971,Andreas Englund,D,LAK,28,24,0,4,4
79,8480032,Shane Bowers,C,NJD,25,11,3,0,3
79,8478017,Mark Friedman,D,VAN,29,40,2,1,3
79,8482061,Brandon Biro,L,SEA,26,12,2,1,3
79,8483630,Pavol Regenda,L,ANA,25,29,2,1,3
79,8481065,Angus Crookshank,L,OTT,25,17,2,1,3
79,8477462,Robert Hagg,D,VGK,29,21,1,2,3
79,8477810,Joel Hanley,D,CGY,33,22,1,2,3
79,8479419,Brett Murray,L,BUF,26,22,1,2,3
79,8479991,Jake Leschyshyn,C,NYR,25,34,1,2,3
79,8484287,Cole McWard,D,VAN,23,20,1,2,3
79,8476372,Nick Seeler,D,PHI,31,43,0,3,3
79,8478450,Parker Wotherspoon,D,BOS,27,33,0,3,3
79,8482094,Daemon Hunt,D,MIN,22,17,0,3,3
79,8481030,Jack St. Ivany,D,PIT,25,15,0,3,3
79,8478021,William Lagesson,D,DET,28,31,0,3,3
79,8479985,Cale Fleury,D,SEA,26,26,2,0,2
79,8482144,Jack Thompson,D,SJS,22,18,2,0,2
79,8481585,Egor Afanasyev,L,SJS,23,12,2,0,2
79,8482153,Brendan Brisson,C,VGK,23,27,2,0,2
79,8483489,Fraser Minten,C,TOR,31,9,2,0,2
79,8481541,Samuel Bolduc,D,NYI,24,26,1,1,2
79,8481578,Graeme Clarke,R,MIN,23,9,1,1,2
79,8482162,Roby Jarventie,L,EDM,22,9,1,1,2
79,8480890,Jan Jenik,C,OTT,24,29,1,1,2
79,8482470,Ilya Solovyov,D,CGY,24,23,1,1,2
79,8477467,Gustav Olofsson,D,SEA,30,19,1,1,2
79,8480851,Akil Thomas,C,LAK,24,13,1,1,2
79,8483597,Milos Kelemen,L,UTA,25,11,1,1,2
79,8478446,Glenn Gawdin,C,LAK,27,18,1,1,2
79,8479378,Logan Stanley,D,WPG,26,46,0,2,2
79,8481237,Kyle MacLean,C,NYI,25,15,0,2,2
79,8481806,Louis Crevier,D,CHI,23,14,0,2,2
79,8479587,Rhett Gardner,C,PHI,28,22,0,2,2
79,8480084,Nick DeSimone,D,NJD,30,23,0,2,2
79,8475755,Alexander Petrovic,D,DAL,32,10,0,2,2
79,8478477,Mitchell Stephens,C,SEA,27,16,0,2,2
79,8482126,Emil Andrae,D,PHI,31,5,0,2,2
79,8484321,Nikolas Matinpalo,D,OTT,26,3,0,2,2
79,8482172,Landon Slaggert,L,CHI,22,24,1,0,1
79,8478881,Brett Seney,L,CHI,28,14,1,0,1
79,8478051,Max Willman,C,NJD,29,17,1,0,1
79,8481699,Aku Raty,R,UTA,23,12,1,0,1
79,8482476,Emil Heineman,L,MTL,23,6,1,0,1
79,8482165,Yan Kuznetsov,D,CGY,22,6,1,0,1
79,8475413,Justin Dowling,C,NJD,34,14,1,0,1
79,8481024,Linus Karlsson,C,VAN,25,6,1,0,1
79,8480823,Alexander Alexeyev,D,WSH,25,13,1,0,1
79,8480075,Cameron Crotty,D,MIN,25,10,1,0,1
79,8478147,Bokondji Imama,L,PIT,28,1,1,0,1
79,8479522,Hardy Haman Aktell,D,WSH,26,3,1,0,1
79,8477384,Joshua Brown,D,EDM,30,47,0,1,1
79,8477149,Scott Sabourin,R,SJS,32,15,0,1,1
79,8480874,Adam Ginning,D,PHI,24,9,0,1,1
79,8481006,Tyler Tucker,D,STL,24,14,0,1,1
79,8478502,Dennis Gilbert,D,BUF,28,14,0,1,1
79,8483395,Arshdeep Bains,L,VAN,23,7,0,1,1
79,8478011,Louie Belpedio,D,PHI,28,12,0,1,1
79,8481422,Jake Lucchini,C,NSH,29,13,0,1,1
79,8478854,Ryan Shea,D,PIT,27,8,0,1,1
79,8482516,Matthew Kessel,D,STL,24,15,0,1,1
79,8483567,Georgii Merkulov,C,BOS,24,7,0,1,1
79,8482102,Vasily Ponomarev,C,PIT,22,23,0,1,1
79,8481043,Cole Koepke,L,BOS,26,18,0,1,1
79,8483432,Luca Del Bel Belluz,C,CBJ,31,5,0,1,1
79,8478956,Samuel Laberge,L,NJD,27,3,0,1,1
79,8484325,Waltteri Merela,C,TBL,26,22,0,0,0
79,8482460,Matt Rempe,C,NYR,22,7,0,0,0
79,8482118,Sam Colangelo,R,ANA,23,15,0,0,0
79,8482250,Callahan Burke,C,VGK,27,17,0,0,0
79,8482197,Adam Raska,R,MIN,23,0,0,0,0
79,8483546,Marshall Rifai,D,TOR,26,3,0,0,0
79,8474062,Riley Nash,C,NYR,35,14,0,0,0
79,8482088,Justin Sourdif,R,FLA,22,12,0,0,0
79,8477541,Dakota Mermis,D,TOR,30,12,0,0,0
79,8481564,Ryan Johnson,D,BUF,23,10,0,0,0
79,8484304,Uvis Balinskis,D,FLA,28,6,0,0,0
79,8483531,Brian Halonen,L,NJD,25,1,0,0,0
79,8483920,Pierrick Dube,R,WSH,23,4,0,0,0
79,8479330,Brandon Gignac,C,MTL,27,6,0,0,0
79,8483471,Brad Lambert,C,WPG,31,3,0,0,0
79,8477993,Justin Kirkland,C,CGY,28,5,0,0,0
79,8480306,Grant Hutton,D,NYI,29,7,0,0,0
79,8481206,John Ludvig,D,PIT,24,12,0,0,0
79,8481462,Mason Morelli,L,VGK,28,17,0,0,0
79,8482787,Nikita Chibrikov,R,WPG,31,3,0,0,0
79,8476323,Max McCormick,L,SEA,32,5,0,0,0
79,8481726,Adam Edstrom,C,NYR,24,5,0,0,0
79,8475780,Chris Wagner,R,COL,33,5,0,0,0
79,8483398,Declan Carlile,D,TBL,31,8,0,0,0
79,8479421,Jacob Moverare,D,LAK,26,13,0,0,0
79,8484326,Patrik Koch,D,UTA,28,4,0,0,0
79,8483407,Brandon Scanlin,D,NYR,25,2,0,0,0
79,8481655,Cole Schwindt,R,CGY,23,5,0,0,0
79,8480274,Philip Kemp,D,EDM,25,2,0,0,0
79,8484255,Jason Polin,R,COL,25,4,0,0,0
79,8483609,Adam Klapka,R,CGY,24,3,0,0,0
79,8481534,Raphael Lavoie,C,EDM,24,3,0,0,0
79,8483401,Marc Johnstone,R,PIT,28,1,0,0,0
79,8484259,Ondrej Pavel,C,COL,31,2,0,0,0
79,8470794,Joe Pavelski,C,,40,0,0,0,0
79,8479321,Lucas Johansen,D,,27,0,0,0,0
79,8477950,Tony DeAngelo,D,,29,0,0,0,0
79,8471218,Blake Wheeler,R,,38,0,0,0,0
79,8475197,Tyson Barrie,D,,33,0,0,0,0
79,8474157,Max Pacioretty,L,,36,0,0,0,0
79,8475744,Evgeny Kuznetsov,C,,32,0,0,0,0
79,8474037,James van Riemsdyk,L,,35,0,0,0,0
79,8476907,Mackenzie MacEachern,L,,30,0,0,0,0
79,8480216,Jacob Peterson,C,,25,0,0,0,0
79,8474602,Justin Schultz,D,,34,0,0,0,0
79,8482222,Alexander Barabanov,L,,30,0,0,0,0
79,8474031,Kevin Shattenkirk,D,,35,0,0,0,0
79,8477330,Dominik Kubalik,L,,29,0,0,0,0
79,8480884,Calen Addison,D,,24,0,0,0,0
79,8475906,John Klingberg,D,,32,0,0,0,0
79,8480008,Adam Ruzicka,C,,25,0,0,0,0
79,8476884,Derrick Pouliot,D,,30,0,0,0,0
79,8476919,Chris Tierney,C,,30,0,0,0,0
79,8479415,Michael McLeod,C,,26,0,0,0,0
79,8474870,Tyler Johnson,C,,34,0,0,0,0
79,8470604,Jeff Carter,C,,39,0,0,0,0
79,8478104,Sammy Blais,L,,28,0,0,0,0
79,8474884,Mike Hoffman,C,,35,0,0,0,0
79,8481591,Sam Poulin,R,,23,0,0,0,0
79,8471274,Alex Goligoski,D,,39,0,0,0,0
79,8476871,Tanner Pearson,L,,32,0,0,0,0
79,8476393,Nick Cousins,C,,31,0,0,0,0
79,8479977,Kailer Yamamoto,R,,26,0,0,0,0
79,8479346,Dillon Dube,C,,26,0,0,0,0
79,8480184,Gustav Lindstrom,D,,26,0,0,0,0
79,8479376,Victor Mete,D,,26,0,0,0,0
79,8473449,Kyle Okposo,R,,36,0,0,0,0
79,8481058,Jesse Ylonen,R,,25,0,0,0,0
79,8475752,Tyler Pitlick,C,,33,0,0,0,0
79,8481239,Samuel Fagemo,L,,24,0,0,0,0
79,8480821,Filip Zadina,R,,25,0,0,0,0
79,8470966,Mark Giordano,D,,41,0,0,0,0
79,8478495,Denis Gurianov,R,,27,0,0,0,0
79,8477464,Nic Petan,C,,29,0,0,0,0
79,8478099,Kevin Labanc,R,,29,0,0,0,0
79,8482241,Radim Zohorna,L,,28,0,0,0,0
79,8474040,Sam Gagner,C,,35,0,0,0,0
79,8479514,Rem Pitlick,C,,27,0,0,0,0
79,8478430,Oliver Kylington,D,,27,0,0,0,0
79,8479533,Joona Koppanen,L,,26,0,0,0,0
79,8479984,Cal Foote,D,,26,0,0,0,0
79,8477126,Jayson Megna,C,,34,0,0,0,0
79,8475164,Jakob Silfverberg,R,,34,0,0,0,0
79,8474009,Nick Bonino,C,,36,0,0,0,0
79,8479458,Nikita Zaitsev,D,,33,0,0,0,0
79,8477944,Jakub Vrana,L,,28,0,0,0,0
79,8471699,Andrew Cogliano,C,,37,0,0,0,0
79,8478067,Oskar Lindblom,L,,28,0,0,0,0
79,8471686,Marc Staal,D,,37,0,0,0,0
79,8470610,Zach Parise,L,,40,0,0,0,0
79,8478904,Steven Lorentz,C,,28,0,0,0,0
79,8473473,Milan Lucic,L,,36,0,0,0,0
79,8480031,Maxime Comtois,L,,25,0,0,0,0
79,8478512,Austin Czarnik,C,,32,0,0,0,0
79,8473504,Cal Clutterbuck,R,,37,0,0,0,0
79,8477454,Adam Erne,L,,29,0,0,0,0
79,8479383,Boris Katchouk,L,,26,0,0,0,0
79,8475825,Jani Hakanpää,D,,32,0,0,0,0
79,8477846,Ryan Carpenter,C,,33,0,0,0,0
79,8477930,Pierre-Edouard Bellemare,L,,39,0,0,0,0
79,8478400,Colin White,C,,27,0,0,0,0
79,8480226,Marián Studenic,R,,26,0,0,0,0
79,8480853,Liam Foudy,C,,24,0,0,0,0
79,8475797,Jarred Tinordi,D,,32,0,0,0,0
79,8479423,Alex Nylander,L,,26,0,0,0,0
79,8474618,Marco Scandella,D,,34,0,0,0,0
79,8478028,Fredrik Olofsson,L,,28,0,0,0,0
79,8474709,Matt Martin,L,,35,0,0,0,0
79,8481070,Hugh McGing,L,,26,0,0,0,0
79,8479546,Oskar Steen,C,,26,0,0,0,0
79,8474145,Robert Bortuzzo,D,,35,0,0,0,0
79,8476915,Jujhar Khaira,L,,30,0,0,0,0
79,8475278,Byron Froese,C,,33,0,0,0,0
79,8481812,Nikolai Knyzhov,D,,27,0,0,0,0
79,8478408,Travis Dermott,D,,28,0,0,0,0
79,8481077,John Leonard,L,,26,0,0,0,0
79,8479547,Matthew Phillips,R,,26,0,0,0,0
79,8480836,Jonathan Gruden,C,,24,0,0,0,0
79,8481690,Tyler Angle,C,,24,0,0,0,0
79,8475766,Austin Watson,L,,32,0,0,0,0
79,8481016,Ruslan Iskhakov,C,,24,0,0,0,0
79,8478078,Rourke Chartier,C,,28,0,0,0,0
79,8480776,Sheldon Rempal,R,,29,0,0,0,0
79,8483045,Cameron Butler,R,CBJ,31,0,0,0,0
79,8484314,Jiri Smejkal,L,,28,0,0,0,0
80,8477492,Nathan MacKinnon,C,COL,29,81,61,116,177
80,8476453,Nikita Kucherov,R,TBL,31,82,43,104,147
80,8478402,Connor McDavid,C,EDM,27,77,33,105,138
80,8478483,Mitch Marner,R,TOR,27,82,34,99,133
80,8477956,David Pastrnak,R,BOS,28,79,51,72,123
80,8479318,Auston Matthews,C,TOR,27,80,68,49,117
80,8478420,Mikko Rantanen,R,COL,28,80,47,65,112
80,8481559,Jack Hughes,C,NJD,23,77,38,74,112
80,8477404,Jake Guentzel,C,TBL,30,82,57,54,111
80,8479314,Matthew Tkachuk,L,FLA,27,82,40,71,111
80,8476468,J.T. Miller,C,VAN,31,76,40,70,110
80,8477934,Leon Draisaitl,C,EDM,29,78,34,66,100
80,8477946,Dylan Larkin,C,DET,28,79,44,54,98
80,8480012,Elias Pettersson,C,VAN,26,75,42,56,98
80,8478398,Kyle Connor,L,WPG,28,75,42,56,98
80,8478403,Jack Eichel,C,VGK,28,79,51,46,97
80,8477933,Sam Reinhart,C,FLA,29,79,47,50,97
80,8477939,William Nylander,R,TOR,28,78,41,54,95
80,8477942,Kevin Fiala,L,LAK,28,82,31,64,95
80,8478550,Artemi Panarin,L,NYR,33,78,23,72,95
80,8478439,Travis Konecny,R,PHI,27,77,44,50,94
80,8474564,Steven Stamkos,C,NSH,34,74,42,52,94
80,8480023,Robert Thomas,C,STL,25,77,29,65,94
80,8477493,Aleksander Barkov,C,FLA,29,81,23,70,93
80,8478864,Kirill Kaprizov,L,MIN,27,72,38,54,92
80,8478010,Brayden Point,C,TBL,28,82,42,48,90
80,8480027,Jason Robertson,L,DAL,25,82,33,56,89
80,8480800,Quinn Hughes,D,VAN,25,71,9,80,89
80,8480069,Cale Makar,D,COL,26,75,17,71,88
80,8478427,Sebastian Aho,C,CAR,27,68,33,54,87
80,8474600,Roman Josi,D,NSH,34,74,28,59,87
80,8484144,Connor Bedard,C,CHI,19,74,34,51,85
80,8477402,Pavel Buchnevich,L,STL,29,76,33,52,85
80,8479343,Clayton Keller,R,UTA,26,77,38,46,84
80,8477409,Carter Verhaeghe,C,FLA,29,80,44,39,83
80,8477501,Valeri Nichushkin,R,COL,29,80,38,45,83
80,8482116,Tim Stützle,C,OTT,22,76,26,57,83
80,8478445,Mathew Barzal,C,NYI,27,78,16,67,83
80,8471675,Sidney Crosby,C,PIT,37,73,36,46,82
80,8480002,Nico Hischier,C,NJD,25,75,28,53,81
80,8480801,Brady Tkachuk,L,OTT,25,82,37,43,80
80,8479542,Brandon Hagel,L,TBL,26,81,30,50,80
80,8475166,John Tavares,C,TOR,34,78,36,42,78
80,8476456,Jonathan Huberdeau,C,CGY,31,80,17,61,78
80,8476459,Mika Zibanejad,C,NYR,31,78,32,45,77
80,8478449,Roope Hintz,C,DAL,28,80,32,45,77
80,8477960,Adrian Kempe,R,LAK,28,81,30,47,77
80,8471215,Evgeni Malkin,C,PIT,38,73,27,50,77
80,8479385,Jordan Kyrou,C,STL,26,78,38,38,76
80,8480830,Andrei Svechnikov,R,CAR,24,70,36,40,76
80,8480036,Miro Heiskanen,D,DAL,25,77,7,69,76
80,8476389,Vincent Trocheck,C,NYR,31,74,31,44,75
80,8482740,Wyatt Johnston,C,DAL,21,82,44,30,74
80,8481557,Matt Boldy,L,MIN,23,71,26,48,74
80,8478414,Timo Meier,R,NJD,28,75,32,40,72
80,8477951,Nick Schmaltz,C,UTA,28,78,25,47,72
80,8476346,Johnny Gaudreau,L,CBJ,31,71,12,60,72
80,8476448,William Karlsson,C,VGK,31,75,35,36,71
80,8479675,Trevor Moore,L,LAK,29,80,31,40,71
80,8476887,Filip Forsberg,L,NSH,30,79,30,41,71
80,8473512,Claude Giroux,R,OTT,36,80,26,45,71
80,8482078,Lucas Raymond,L,DET,22,80,25,46,71
80,8479407,Jesper Bratt,L,NJD,26,77,24,47,71
80,8475172,Nazem Kadri,C,CGY,34,74,27,43,70
80,8476539,Jonathan Marchessault,R,NSH,34,71,34,35,69
80,8476460,Mark Scheifele,C,WPG,31,74,29,39,68
80,8476881,Tomas Hertl,C,VGK,31,72,28,40,68
80,8482745,Mason McTavish,C,ANA,21,76,22,46,68
80,8479323,Adam Fox,D,NYR,26,71,14,54,68
80,8482699,Dylan Guenther,R,UTA,21,74,29,38,67
80,8477496,Elias Lindholm,C,BOS,30,77,27,39,66
80,8477949,Alex Tuch,R,BUF,28,74,27,39,66
80,8478493,Joel Eriksson Ek,C,MIN,27,76,27,39,66
80,8471685,Anze Kopitar,C,LAK,37,80,21,45,66
80,8480803,Evan Bouchard,D,EDM,25,76,13,53,66
80,8475786,Zach Hyman,L,EDM,32,78,37,28,65
80,8471214,Alex Ovechkin,L,WSH,39,66,34,31,65
80,8479337,Alex DeBrincat,R,DET,27,80,32,33,65
80,8480039,Martin Necas,C,CAR,25,70,31,34,65
80,8473994,Jamie Benn,L,DAL,35,82,31,34,65
80,8474141,Patrick Kane,R,DET,36,81,23,42,65
80,8475692,Mats Zuccarello,R,MIN,37,73,13,52,65
80,8479420,Tage Thompson,C,BUF,27,66,37,27,64
80,8476454,Ryan Nugent-Hopkins,C,EDM,31,77,23,41,64
80,8478401,Pavel Zacha,C,BOS,27,80,23,41,64
80,8478460,Zach Werenski,D,CBJ,27,78,18,46,64
80,8475798,Mikael Granlund,C,SJS,32,68,15,49,64
80,8477497,Sean Monahan,C,CBJ,30,71,27,36,63
80,8478462,Nicolas Roy,C,VGK,27,76,24,39,63
80,8475784,Jeff Skinner,C,EDM,32,77,23,40,63
80,8475167,Victor Hedman,D,TBL,34,77,17,46,63
80,8475754,Brock Nelson,C,NYI,33,75,28,34,62
80,8477935,Sam Bennett,C,FLA,28,76,27,35,62
80,8483515,Juraj Slafkovsky,L,MTL,20,79,23,39,62
80,8482665,Matty Beniers,C,SEA,22,79,18,44,62
80,8478407,Vince Dunn,D,SEA,28,79,14,48,62
80,8475184,Chris Kreider,L,NYR,33,74,35,26,61
80,8478975,Mason Marchment,L,DAL,29,82,26,35,61
80,8477964,Ivan Barbashev,C,VGK,29,74,26,35,61
80,8480015,Owen Tippett,R,PHI,25,76,24,37,61
80,8477955,Jared McCann,L,SEA,28,72,29,31,60
80,8480208,Drake Batherson,R,OTT,26,77,25,35,60
80,8478444,Brock Boeser,R,VAN,27,73,25,35,60
80,8480018,Nick Suzuki,C,MTL,25,77,20,40,60
80,8475913,Mark Stone,R,VGK,32,76,23,36,59
80,8474102,David Perron,L,OTT,36,81,18,41,59
80,8477021,Alex Kerfoot,C,UTA,30,76,14,45,59
80,8473419,Brad Marchand,L,BOS,36,79,30,28,58
80,8477494,Jonathan Drouin,L,COL,29,81,16,42,58
80,8478873,Troy Terry,R,ANA,27,78,30,27,57
80,8475170,Brayden Schenn,C,STL,33,73,26,31,57
80,8477940,Nikolaj Ehlers,L,WPG,28,67,25,32,57
80,8478047,Michael Bunting,L,PIT,29,71,24,33,57
80,8475745,Charlie Coyle,C,BOS,32,79,21,36,57
80,8476875,Mike Matheson,D,MTL,30,77,14,43,57
80,8477503,Max Domi,C,TOR,29,78,11,46,57
80,8483431,Logan Cooley,C,UTA,20,77,30,26,56
80,8481068,Yegor Sharangovich,C,CGY,26,78,29,27,56
80,8477451,Ryan Hartman,R,MIN,30,72,25,31,56
80,8477416,Oliver Bjorkstrand,R,SEA,29,70,24,32,56
80,8475158,Ryan O'Reilly,C,NSH,33,72,20,36,56
80,8479325,Charlie McAvoy,D,BOS,27,77,11,45,56
80,8480009,Eeli Tolvanen,R,SEA,25,73,27,28,55
80,8476905,Chandler Stephenson,C,SEA,30,74,18,37,55
80,8475765,Vladimir Tarasenko,R,DET,33,81,17,38,55
80,8477986,Brandon Montour,D,SEA,30,69,16,39,55
80,8476399,Blake Coleman,C,CGY,33,79,28,26,54
80,8478519,Anthony Cirelli,C,TBL,27,82,28,26,54
80,8475168,Matt Duchene,C,DAL,33,81,24,30,54
80,8474150,Mikael Backlund,C,CGY,35,78,20,34,54
80,8478469,Thomas Chabot,D,OTT,27,78,15,39,54
80,8477476,Artturi Lehkonen,L,COL,29,78,31,22,53
80,8480014,Gabriel Vilardi,C,WPG,25,70,28,25,53
80,8475151,Kyle Palmieri,C,NYI,33,78,22,31,53
80,8476479,Phillip Danault,C,LAK,31,82,18,35,53
80,8480839,Rasmus Dahlin,D,BUF,24,69,16,37,53
80,8477932,Aaron Ekblad,D,FLA,28,69,11,42,53
80,8480064,Josh Norris,C,OTT,25,78,29,23,52
80,8475794,Tyler Seguin,C,DAL,32,82,24,28,52
80,8476880,Tom Wilson,R,WSH,30,71,23,29,52
80,8478856,Conor Garland,R,VAN,28,77,17,35,52
80,8478440,Dylan Strome,C,WSH,27,74,13,39,52
80,8474565,Alex Pietrangelo,D,VGK,34,65,8,44,52
80,8481604,Pavel Dorofeyev,L,VGK,24,68,22,29,51
80,8474590,John Carlson,D,WSH,34,69,13,38,51
80,8478397,Rasmus Andersson,D,CGY,28,74,11,40,51
80,8477500,Bo Horvat,C,NYI,29,82,28,22,50
80,8475810,Bryan Rust,R,PIT,32,68,24,26,50
80,8477426,Nicholas Paul,L,TBL,29,81,22,28,50
80,8477495,Seth Jones,D,CHI,30,69,15,35,50
80,8477504,Josh Morrissey,D,WPG,29,71,12,38,50
80,8478396,Noah Hanifin,D,VGK,27,63,12,38,50
80,8480865,Noah Dobson,D,NYI,24,81,10,40,50
80,8470613,Brent Burns,D,CAR,39,77,10,40,50
80,8477479,Tyler Bertuzzi,L,CHI,29,65,18,31,49
80,8476826,Yanni Gourde,C,SEA,33,69,18,31,49
80,8482113,Anton Lundell,C,FLA,23,79,21,27,48
80,8478042,Viktor Arvidsson,L,EDM,31,74,20,28,48
80,8475768,Jaden Schwartz,C,SEA,32,73,17,31,48
80,8478458,John (Jack) Roslovic,C,CAR,27,61,16,32,48
80,8481528,Dylan Cozens,C,BUF,23,70,15,33,48
80,8477444,Andre Burakovsky,L,SEA,29,72,15,33,48
80,8474679,Gustav Nyquist,C,NSH,35,70,14,34,48
80,8476853,Morgan Rielly,D,TOR,30,70,10,38,48
80,8474578,Erik Karlsson,D,PIT,34,77,8,40,48
80,8480188,Fabian Zetterlund,L,SJS,25,64,26,21,47
80,8478466,Daniel Sprong,R,VAN,27,76,19,28,47
80,8478542,Evan Rodrigues,C,FLA,31,73,17,30,47
80,8481533,Trevor Zegras,C,ANA,23,75,17,30,47
80,8474586,Jordan Eberle,R,SEA,34,70,16,31,47
80,8484153,Leo Carlsson,C,ANA,20,71,15,32,47
80,8483808,Andrei Kuzmenko,L,CGY,28,80,21,25,46
80,8479999,Casey Mittelstadt,C,COL,26,82,18,28,46
80,8482149,Cole Perfetti,C,WPG,22,68,17,29,46
80,8476958,Jaccob Slavin,D,CAR,30,74,6,40,46
80,8479525,Ross Colton,C,COL,28,80,23,22,45
80,8475169,Evander Kane,L,EDM,33,76,17,28,45
80,8476292,Ondrej Palat,L,NJD,33,62,16,29,45
80,8477456,J.T. Compher,L,DET,29,76,16,29,45
80,8482684,Luke Hughes,D,NJD,21,72,8,37,45
80,8476792,Torey Krug,D,STL,33,68,7,38,45
80,8476438,Brandon Saad,L,STL,32,71,21,23,44
80,8482109,Alexis Lafrenière,L,NYR,23,75,19,25,44
80,8482110,Dawson Mercer,C,NJD,23,68,19,25,44
80,8481596,Shane Pinto,C,OTT,24,80,16,28,44
80,8474563,Drew Doughty,D,LAK,35,71,8,36,44
80,8481186,Logan O'Connor,R,COL,28,80,23,20,43
80,8482093,Seth Jarvis,C,CAR,22,67,21,22,43
80,8479339,Patrik Laine,L,CBJ,26,66,21,22,43
80,8476882,Teuvo Teravainen,C,CHI,30,63,18,25,43
80,8481523,Kirby Dach,C,MTL,23,67,18,25,43
80,8478046,Danton Heinen,L,VAN,29,66,17,26,43
80,8478233,Andrew Mangiapane,L,WSH,28,75,17,26,43
80,8479425,Filip Hronek,D,VAN,27,78,12,31,43
80,8477948,Travis Sanheim,D,PHI,28,70,11,32,43
80,8478038,Devon Toews,D,COL,30,71,7,36,43
80,8482124,Quinton Byfield,R,LAK,22,79,22,20,42
80,8475191,Reilly Smith,R,NYR,33,75,18,24,42
80,8482159,Tyson Foerster,R,PHI,22,69,17,25,42
80,8480797,Joel Farabee,L,PHI,24,76,15,27,42
80,8482720,Matthew Knies,L,TOR,22,74,12,30,42
80,8476869,Brady Skjei,D,NSH,30,71,12,30,42
80,8481711,Matias Maccelli,L,UTA,24,73,11,31,42
80,8478472,Mathieu Joseph,R,STL,27,64,10,32,42
80,8471724,Kris Letang,D,PIT,37,78,8,34,42
80,8476463,Jonas Brodin,D,MIN,31,79,8,34,42
80,8479400,Pierre-Luc Dubois,L,WSH,26,68,17,24,41
80,8481540,Cole Caufield,R,MTL,23,74,17,24,41
80,8481560,Arthur Kaliyev,R,LAK,23,78,17,24,41
80,8476872,Scott Laughton,C,PHI,30,67,17,24,41
80,8476885,Jacob Trouba,D,NYR,30,74,16,25,41
80,8476906,Shayne Gostisbehere,D,CAR,31,71,14,27,41
80,8477447,Shea Theodore,D,VGK,29,57,5,36,41
80,8476483,Rickard Rakell,R,PIT,31,63,25,15,40
80,8475726,Tyler Toffoli,C,SJS,32,67,21,19,40
80,8477998,Warren Foegele,L,LAK,28,79,21,19,40
80,8480185,Eetu Luostarinen,C,FLA,26,77,17,23,40
80,8480028,Morgan Frost,C,PHI,25,71,14,26,40
80,8477346,MacKenzie Weegar,D,CGY,30,72,12,28,40
80,8482702,Logan Stankoven,C,DAL,21,78,12,28,40
80,8479410,Mikhail Sergachev,D,UTA,26,73,4,36,40
80,8477407,Anthony Duclair,L,NYI,29,78,22,17,39
80,8478366,Frank Vatrano,R,ANA,30,70,21,18,39
80,8482146,Luke Evangelista,R,NSH,22,69,21,18,39
80,8471698,T.J. Oshie,R,WSH,38,65,16,23,39
80,8478055,Gustav Forsling,D,FLA,28,72,14,25,39
80,8480798,Philipp Kurashev,C,CHI,25,65,9,30,39
80,8481618,Alex Newhook,C,MTL,23,72,22,16,38
80,8479293,Brandon Tanev,L,SEA,33,68,21,17,38
80,8479992,Michael Rasmussen,C,DET,25,80,19,19,38
80,8481554,Kaapo Kakko,R,NYR,23,71,18,20,38
80,8473986,Alex Killorn,L,ANA,35,70,16,22,38
80,8478438,Tommy Novak,C,NSH,27,68,15,23,38
80,8484166,Adam Fantilli,C,CBJ,20,64,14,24,38
80,8482667,William Eklund,L,SJS,22,65,11,27,38
80,8476923,Damon Severson,D,CBJ,30,78,8,30,38
80,8478498,Jake DeBrusk,L,VAN,28,67,19,18,37
80,8474641,Adam Henrique,C,EDM,34,77,18,19,37
80,8482125,Alexander Holtz,R,VGK,22,76,18,19,37
80,8477505,Alexander Wennberg,C,SJS,30,65,18,19,37
80,8482475,Yegor Chinakhov,R,CBJ,23,62,17,20,37
80,8474053,Logan Couture,C,SJS,35,66,15,22,37
80,8483505,Matthew Poitras,C,BOS,20,78,10,27,37
80,8481581,Thomas Harley,D,DAL,23,74,6,31,37
80,8475799,Nino Niederreiter,R,WPG,32,66,20,16,36
80,8481535,Nils Hoglander,L,VAN,24,66,20,16,36
80,8475714,Calle Jarnkrok,C,TOR,33,74,19,17,36
80,8481624,Ilya Mikheyev,R,CHI,30,58,19,17,36
80,8478891,Mason Appleton,C,WPG,28,62,18,18,36
80,8479393,Noah Gregor,L,OTT,26,72,14,22,36
80,8481524,Bowen Byram,D,BUF,23,69,11,25,36
80,8477429,Andrew Copp,C,DET,30,80,10,26,36
80,8475753,Justin Faulk,D,STL,32,70,8,28,36
80,8477969,Marcus Pettersson,D,PIT,28,80,7,29,36
80,8481542,Moritz Seider,D,DET,23,73,3,33,36
80,8478474,Lawson Crouse,L,UTA,27,74,21,14,35
80,8477425,Miles Wood,L,COL,29,80,19,16,35
80,8481582,Nicholas Robertson,L,TOR,23,67,19,16,35
80,8477511,Anthony Mantha,R,CGY,30,73,18,17,35
80,8482055,Drew O'Connor,L,PIT,26,66,18,17,35
80,8476925,Colton Sissons,C,NSH,31,66,17,18,35
80,8474716,Jared Spurgeon,D,MIN,35,75,12,23,35
80,8481577,Philip Tomasino,C,NSH,23,64,11,24,35
80,8484145,Zach Benson,L,BUF,19,65,10,25,35
80,8482712,Oskar Olausson,R,COL,22,76,5,30,35
80,8480748,Kiefer Sherwood,L,VAN,29,59,16,18,34
80,8476461,Sean Couturier,C,PHI,32,70,14,20,34
80,8474715,Cameron Atkinson,R,TBL,35,79,13,21,34
80,8479353,Brett Howden,C,VGK,26,73,13,21,34
80,8479987,Morgan Geekie,C,BOS,26,72,11,23,34
80,8479345,Jakob Chychrun,D,WSH,26,67,10,24,34
80,8476854,Hampus Lindholm,D,BOS,30,76,5,29,34
80,8478020,Michael Amadio,R,OTT,28,72,25,8,33
80,8482705,Cole Sillinger,C,CBJ,21,66,21,12,33
80,8480113,Alex Iafallo,L,WPG,31,65,17,16,33
80,8475287,Erik Haula,L,NJD,33,68,16,17,33
80,8479365,Trent Frederic,C,BOS,26,76,14,19,33
80,8475793,Ryan Johansen,C,PHI,32,71,14,19,33
80,8474149,Evgenii Dadonov,R,DAL,35,81,13,20,33
80,8473533,Jordan Staal,C,CAR,36,66,13,20,33
80,8482660,Kent Johnson,C,CBJ,22,63,12,21,33
80,8476921,Jordan Martinook,L,CAR,32,63,12,21,33
80,8478463,Anthony Beauvillier,L,PIT,27,69,7,26,33
80,8482122,Brock Faber,D,MIN,22,76,6,27,33
80,8483490,Pavel Mintyukov,D,ANA,21,73,5,28,33
80,8482175,JJ Peterka,R,BUF,22,72,20,12,32
80,8478057,Dakota Joshua,C,VAN,28,66,17,15,32
80,8476927,Teddy Blueger,C,VAN,30,66,17,15,32
80,8483524,Shane Wright,C,SEA,20,66,16,16,32
80,8475848,Brendan Gallagher,R,MTL,32,69,15,17,32
80,8482809,Jackson Blake,R,CAR,21,59,12,20,32
80,8479591,Michael Eyssimont,C,TBL,28,80,9,23,32
80,8476462,Dougie Hamilton,D,NJD,31,71,7,25,32
80,8474189,Lars Eller,C,PIT,35,64,19,12,31
80,8476432,Boone Jenner,C,CBJ,31,68,17,14,31
80,8479661,Tanner Jeannot,L,LAK,27,81,15,16,31
80,8476392,Adam Lowry,C,WPG,31,61,14,17,31
80,8477839,Conor Sheary,L,TBL,32,79,12,19,31
80,8480813,Joe Veleno,C,DET,24,75,10,21,31
80,8475760,Nick Bjugstad,C,UTA,32,72,17,13,30
80,8475149,Marcus Johansson,L,MIN,34,66,16,14,30
80,8482079,Marco Rossi,C,MIN,23,60,16,14,30
80,8477478,William Carrier,L,CAR,30,54,12,18,30
80,8475218,Mattias Ekholm,D,EDM,34,73,11,19,30
80,8480336,Sean Walker,D,CAR,30,70,11,19,30
80,8477987,Ryan Donato,C,CHI,28,67,11,19,30
80,8481703,Valtteri Puustinen,R,PIT,25,64,9,21,30
80,8482105,Jake Sanderson,D,OTT,22,72,8,22,30
80,8480849,Barrett Hayton,C,UTA,24,71,15,14,29
80,8480829,Jesperi Kotkaniemi,C,CAR,24,63,15,14,29
80,8482133,Thomas Bordeleau,C,SJS,22,65,13,16,29
80,8476419,Jean-Gabriel Pageau,C,NYI,32,79,13,16,29
80,8478115,Pierre Engvall,L,NYI,28,75,13,16,29
80,8482111,Justin Barron,D,MTL,23,67,13,16,29
80,8484203,Bradly Nadeau,L,CAR,19,68,13,16,29
80,8480448,Parker Kelly,L,COL,25,77,11,18,29
80,8477989,Christian Dvorak,C,MTL,28,62,9,20,29
80,8476458,Ryan Strome,C,ANA,31,69,7,22,29
80,8475200,Dmitry Orlov,D,CAR,33,75,7,22,29
80,8474574,Tyler Myers,D,VAN,34,70,2,27,29
80,8479976,Juuso Valimaki,D,UTA,26,66,1,28,29
80,8475314,Anders Lee,L,NYI,34,78,15,13,28
80,8482092,Ridly Greig,C,OTT,22,74,13,15,28
80,8479368,Max Jones,L,BOS,26,68,13,15,28
80,8475193,Tomas Tatar,L,NJD,34,74,12,16,28
80,8475763,Kevin Hayes,R,PIT,32,66,9,19,28
80,8483565,Nick Blankenburg,D,NSH,26,64,9,19,28
80,8480144,David Kampf,C,TOR,29,71,9,19,28
80,8480835,Jack Drury,C,CAR,24,64,7,21,28
80,8481606,Jordan Spence,D,LAK,23,69,7,21,28
80,8480434,Sean Durzi,D,UTA,26,67,5,23,28
80,8482624,Daniil Miromanov,D,CGY,27,64,3,25,28
80,8474151,Ryan McDonagh,D,TBL,35,81,2,26,28
80,8477953,Kasperi Kapanen,R,STL,28,64,13,14,27
80,8480220,Noah Cates,L,PHI,25,72,12,15,27
80,8480068,Ryan Poehling,C,PHI,25,66,12,15,27
80,8476981,Josh Anderson,R,MTL,30,71,12,15,27
80,8476480,Vladislav Namestnikov,C,WPG,32,61,11,16,27
80,8482097,Jack Quinn,R,BUF,23,62,10,17,27
80,8478109,Victor Olofsson,L,VGK,29,69,10,17,27
80,8480078,Filip Chytil,C,NYR,25,68,8,19,27
80,8476931,Jake McCabe,D,TOR,31,69,8,19,27
80,8475181,Nick Leddy,D,STL,33,70,5,22,27
80,8480003,Jesper Boqvist,C,FLA,26,64,15,11,26
80,8481032,Paul Cotter,C,NJD,25,61,14,12,26
80,8475722,Jason Zucker,L,BUF,32,66,13,13,26
80,8478413,Jordan Greenway,L,BUF,27,65,8,18,26
80,8480871,Adam Boqvist,D,FLA,24,71,6,20,26
80,8481656,Aliaksei Protas,C,WSH,23,66,6,20,26
80,8478133,Jake Evans,C,MTL,28,73,5,21,26
80,8480043,Timothy Liljegren,D,TOR,25,64,3,23,26
80,8476278,Colin Blackwell,C,DAL,31,79,14,11,25
80,8480893,Kirill Marchenko,R,CBJ,24,64,13,12,25
80,8478970,Jalen Chatfield,D,CAR,28,75,13,12,25
80,8475791,Taylor Hall,L,CHI,33,54,12,13,25
80,8481093,Rafael Harvey-Pinard,L,MTL,25,64,12,13,25
80,8481546,Cam York,D,PHI,23,67,9,16,25
80,8478569,Noel Acciari,C,PIT,33,56,9,16,25
80,8475343,Nic Dowd,C,WSH,34,59,9,16,25
80,8476457,Adam Larsson,D,SEA,32,69,8,17,25
80,8482671,Owen Power,D,BUF,22,65,6,19,25
80,8478911,Matt Roy,D,WSH,29,59,6,19,25
80,8480145,Neal Pionk,D,WPG,29,70,4,21,25
80,8477498,Darnell Nurse,D,EDM,29,72,4,21,25
80,8475764,Cam Fowler,D,ANA,33,67,4,21,25
80,8478851,Alexandre Carrier,D,NSH,28,71,4,21,25
80,8478178,Darren Raddysh,D,TBL,28,72,4,21,25
80,8476892,Colton Parayko,D,STL,31,70,2,23,25
80,8480459,Pius Suter,C,VAN,28,70,14,10,24
80,8473422,Nick Foligno,L,CHI,37,59,12,12,24
80,8476878,Zemgus Girgensons,C,TBL,30,82,12,12,24
80,8478013,Jake Walman,D,SJS,28,72,11,13,24
80,8480762,Eric Robinson,L,CAR,29,53,10,14,24
80,8480855,Jack McBain,C,UTA,24,74,8,16,24
80,8480817,K'Andre Miller,D,NYR,24,74,7,17,24
80,8476902,Esa Lindell,D,DAL,30,68,6,18,24
80,8477450,Jason Dickinson,C,CHI,29,55,6,18,24
80,8475855,Jesper Fast,R,CAR,33,64,4,20,24
80,8479639,Dylan Coghlan,D,WPG,26,65,4,20,24
80,8478507,John Marino,D,UTA,27,56,3,21,24
80,8478882,Vladislav Gavrikov,D,LAK,29,72,3,21,24
80,8482259,Bobby McMann,C,TOR,28,65,18,5,23
80,8477952,Robby Fabbri,C,ANA,28,64,14,9,23
80,8476918,Jimmy Vesey,L,NYR,31,62,12,11,23
80,8479941,Justin Danforth,R,CBJ,31,59,12,11,23
80,8480205,Emil Bemstrom,C,PIT,25,66,11,12,23
80,8479390,Taylor Raddysh,R,WSH,26,61,11,12,23
80,8476374,Sean Kuraly,C,CBJ,31,58,10,13,23
80,8473507,Jeff Petry,D,DET,37,72,9,14,23
80,8482117,Lukas Reichel,L,CHI,22,61,9,14,23
80,8479316,Luke Kunin,C,SJS,27,59,9,14,23
80,8476988,Matt Benning,D,SJS,30,69,8,15,23
80,8479996,Cody Glass,C,NSH,25,52,7,16,23
80,8475188,Brayden McNabb,D,VGK,33,62,7,16,23
80,8480873,Rasmus Sandin,D,WSH,24,65,6,17,23
80,8481441,Joe Snively,C,DET,28,66,6,17,23
80,8477220,Nate Schmidt,D,FLA,33,65,4,19,23
80,8482067,Connor Mackey,D,NYR,28,61,4,19,23
80,8476331,Dylan DeMelo,D,WPG,31,67,3,20,23
80,8482655,Janis Moser,D,TBL,24,80,2,21,23
80,8482074,Connor Zary,C,CGY,23,64,12,10,22
80,8470621,Corey Perry,R,EDM,39,74,12,10,22
80,8482803,Olen Zellweger,D,ANA,21,67,12,10,22
80,8482737,Zack Bolduc,C,STL,21,55,11,11,22
80,8480074,Alexandre Texier,C,STL,25,55,10,12,22
80,8476422,Mike Reilly,D,NYI,31,73,10,12,22
80,8480995,Pontus Holmberg,R,TOR,25,58,10,12,22
80,8483468,Jiri Kulich,C,BUF,20,64,9,13,22
80,8478500,Ivan Provorov,D,CBJ,27,78,8,14,22
80,8476329,Travis Boyd,C,MIN,31,56,7,15,22
80,8475171,Oliver Ekman-Larsson,D,TOR,33,64,6,16,22
80,8480802,Ryan McLeod,C,BUF,25,66,5,17,22
80,8482142,Jamie Drysdale,D,PHI,22,65,3,19,22
80,8477499,Rasmus Ristolainen,D,PHI,30,63,3,19,22
80,8475790,Erik Gudbranson,D,CBJ,32,74,2,20,22
80,8480073,Erik Brannstrom,D,COL,25,58,1,21,22
80,8482089,Jake Neighbours,L,STL,22,71,13,8,21
80,8476897,Oskar Sundqvist,C,STL,30,59,13,8,21
80,8476474,Stefan Noesen,R,NJD,31,65,11,10,21
80,8477947,Sonny Milano,L,WSH,28,67,11,10,21
80,8480980,Connor Dewar,C,TOR,25,65,11,10,21
80,8477353,Tyler Motte,C,DET,29,74,10,11,21
80,8481580,Connor McMichael,C,WSH,23,63,9,12,21
80,8475220,Marcus Foligno,L,MIN,33,63,9,12,21
80,8483457,Lane Hutson,D,MTL,20,60,8,13,21
80,8476960,Andreas Athanasiou,C,CHI,30,55,8,13,21
80,8473563,Nicklas Backstrom,C,WSH,37,55,5,16,21
80,8479398,Samuel Girard,D,COL,26,63,5,16,21
80,8480035,Henri Jokiharju,D,BUF,25,65,5,16,21
80,8482245,Artem Zub,D,OTT,29,62,4,17,21
80,8476429,Scott Mayfield,D,NYI,32,76,3,18,21
80,8476467,Jamie Oleksiak,D,SEA,32,65,3,18,21
80,8480049,Dylan Samberg,D,WPG,25,67,2,19,21
80,8481527,Kaedan Korczak,D,VGK,23,47,2,19,21
80,8474673,TJ Brodie,D,CHI,34,68,1,20,21
80,8475324,Nick Jensen,D,OTT,34,71,1,20,21
80,8475233,David Savard,D,MTL,34,66,1,20,21
80,8477506,Ryan Pulock,D,NYI,30,76,0,21,21
80,8478432,Christian Fischer,R,DET,27,76,14,6,20
80,8479351,Sam Steel,C,DAL,26,79,11,9,20
80,8479066,Ryan Lomberg,L,CGY,30,63,11,9,20
80,8481704,Juuso Parssinen,C,NSH,23,64,10,10,20
80,8481477,Nico Sturm,C,SJS,29,54,9,11,20
80,8483499,Liam Ohgren,L,MIN,20,53,8,12,20
80,8477919,Frederick Gaudreau,C,MIN,31,65,5,15,20
80,8481178,Egor Zamula,D,PHI,24,62,3,17,20
80,8479402,Jake Bean,D,CGY,26,68,3,17,20
80,8478840,Will Borgen,D,SEA,28,65,2,18,20
80,8476469,Joel Armia,R,MTL,31,60,12,7,19
80,8481716,Dmitri Voronkov,L,CBJ,24,50,12,7,19
80,8482157,Will Cuylle,L,NYR,22,69,11,8,19
80,8482148,Hendrix Lapierre,C,WSH,22,58,9,10,19
80,8483495,Simon Nemec,D,NJD,20,53,9,10,19
80,8477931,Tomas Nosek,L,FLA,32,66,6,13,19
80,8480246,Nick Perbix,D,TBL,26,75,4,15,19
80,8476917,Adam Pelech,D,NYI,30,76,3,16,19
80,8480878,Nils Lundkvist,D,DAL,24,75,1,18,19
80,8482679,Matt Coronato,R,CGY,22,70,12,6,18
80,8482807,Ethan Del Mastro,D,CHI,21,51,10,8,18
80,8480289,Morgan Barron,C,WPG,26,58,9,9,18
80,8481161,Jake Christiansen,D,CBJ,25,60,8,10,18
80,8480891,Michael Kesselring,D,UTA,24,56,7,11,18
80,8477446,Michael McCarron,R,NSH,29,58,7,11,18
80,8483493,Frank Nazar,C,CHI,20,59,7,11,18
80,8481751,Lukas Rousek,R,BUF,25,38,7,11,18
80,8478452,Caleb Jones,D,LAK,27,59,6,12,18
80,8476979,Erik Gustafsson,D,DET,32,70,5,13,18
80,8479324,Ryan Lindgren,D,NYR,26,66,5,13,18
80,8479982,Conor Timmins,D,TOR,26,58,5,13,18
80,8476879,Cody Ceci,D,EDM,31,77,5,13,18
80,8481521,Ronnie Attard,D,PHI,25,51,4,14,18
80,8471817,Ryan Reaves,R,TOR,37,60,4,14,18
80,8476856,Mathew Dumba,D,DAL,30,70,2,16,18
80,8479371,Dante Fabbro,D,NSH,26,64,1,17,18
80,8475462,Radko Gudas,D,ANA,34,65,1,17,18
80,8481641,Joel Kiviranta,L,COL,28,73,11,6,17
80,8476889,Radek Faksa,C,STL,30,56,9,8,17
80,8482155,Alex Laferriere,R,LAK,23,62,9,8,17
80,8478211,Dryden Hunt,L,CGY,29,64,9,8,17
80,8481517,Brett Leason,R,ANA,25,55,7,10,17
80,8481522,Peyton Krebs,C,BUF,23,59,7,10,17
80,8476934,Brock McGinn,L,ANA,30,56,6,11,17
80,8475231,Casey Cizikas,C,NYI,33,74,5,12,17
80,8476312,Josh Manson,D,COL,33,63,5,12,17
80,8471709,Marc-Edouard Vlasic,D,SJS,37,57,4,13,17
80,8479983,Mario Ferraro,D,SJS,26,67,3,14,17
80,8481601,Simon Holmstrom,R,NYI,23,65,14,2,16
80,8478831,Kevin Stenlund,C,UTA,28,47,12,4,16
80,8479359,Beck Malenstyn,L,BUF,26,57,11,5,16
80,8481553,Bobby Brink,R,PHI,23,56,9,7,16
80,8482749,Joshua Roy,R,MTL,21,60,9,7,16
80,8479520,Brandon Duhaime,R,WSH,27,58,8,8,16
80,8477979,Nicolas Aube-Kubel,R,BUF,28,53,8,8,16
80,8478043,Sam Lafferty,C,BUF,29,55,8,8,16
80,8477903,Garnet Hathaway,R,PHI,33,59,8,8,16
80,8480789,Oliver Wahlstrom,R,NYI,24,67,7,9,16
80,8482666,Scott Morrow,D,CAR,22,50,7,9,16
80,8482101,Danil Gushchin,L,SJS,22,61,6,10,16
80,8481481,Blake Lizotte,C,PIT,27,62,6,10,16
80,8482496,Nils Aman,C,VAN,24,46,6,10,16
80,8478585,Derek Ryan,C,EDM,38,52,5,11,16
80,8481568,Alex Vlasic,D,CHI,23,54,4,12,16
80,8482744,James Malatesta,L,CBJ,21,43,4,12,16
80,8480001,Urho Vaakanainen,D,ANA,25,59,4,12,16
80,8476525,Colin Miller,D,WPG,32,58,3,13,16
80,8480172,Jan Rutta,D,SJS,34,58,3,13,16
80,8481567,Henry Thrun,D,SJS,23,50,3,13,16
80,8477015,Connor Brown,R,EDM,30,65,12,3,15
80,8478508,Yakov Trenin,C,MIN,27,54,9,6,15
80,8480806,Isac Lundestrom,C,ANA,25,58,7,8,15
80,8480011,Klim Kostin,C,SJS,25,50,5,10,15
80,8477380,Jonny Brodzinski,C,NYR,31,45,5,10,15
80,8477488,Brett Pesce,D,NJD,30,67,4,11,15
80,8479372,Joshua Mahura,D,SEA,26,56,3,12,15
80,8481059,Scott Perunovich,D,STL,26,67,2,13,15
80,8479980,Nicolas Hague,D,VGK,26,53,2,13,15
80,8481708,Zac Jones,D,NYR,24,55,2,13,15
80,8475690,Chris Tanev,D,TOR,35,66,2,13,15
80,8480727,Zach Whitecloud,D,VGK,28,51,2,13,15
80,8481014,Alexander Romanov,D,NYI,24,78,1,14,15
80,8480887,Jordan Harris,D,MTL,24,58,1,14,15
80,8479336,Carl Grundstrom,R,SJS,27,48,10,4,14
80,8479315,Joey Anderson,R,CHI,26,46,8,6,14
80,8477406,Mattias Janmark,C,EDM,32,64,8,6,14
80,8476858,Phillip Di Giuseppe,L,VAN,31,42,8,6,14
80,8477392,Hudson Fasching,R,NYI,29,61,7,7,14
80,8475225,Craig Smith,C,CHI,35,49,7,7,14
80,8480848,Ty Dellandrea,C,SJS,24,43,7,7,14
80,8479543,Michael Pezzetta,L,MTL,26,59,7,7,14
80,8473453,Trevor Lewis,C,LAK,37,67,6,8,14
80,8476624,Barclay Goodrow,C,SJS,31,50,6,8,14
80,8477018,Ben Hutton,D,VGK,31,43,5,9,14
80,8478468,Jeremy Lauzon,D,NSH,27,57,5,9,14
80,8482087,Kaiden Guhle,D,MTL,22,63,4,10,14
80,8483445,Cutter Gauthier,L,ANA,20,64,3,11,14
80,8478136,Jake Middleton,D,MIN,28,76,3,11,14
80,8476442,Matt Nieto,L,PIT,32,49,3,11,14
80,8478017,Mark Friedman,D,VAN,29,44,3,11,14
80,8470600,Ryan Suter,D,STL,39,59,2,12,14
80,8478416,Erik Cernak,D,TBL,27,73,0,14,14
80,8475842,Sam Carrick,C,NYR,32,57,9,4,13
80,8477573,Nathan Walker,L,STL,30,55,9,4,13
80,8476994,Vinnie Hinostroza,C,NSH,30,44,8,5,13
80,8482659,Josh Doan,R,UTA,22,53,8,5,13
80,8483491,Ivan Miroshnichenko,L,WSH,20,49,7,6,13
80,8476873,Mark Jankowski,C,NSH,30,55,7,6,13
80,8474034,Patrick Maroon,L,CHI,36,47,7,6,13
80,8479439,Jacob MacDonald,D,COL,31,54,7,6,13
80,8484149,Gavin Brindley,C,CBJ,20,49,6,7,13
80,8479370,Tyson Jost,C,CAR,26,51,6,7,13
80,8476822,Luke Glendening,C,TBL,35,78,6,7,13
80,8477845,Trevor van Riemsdyk,D,WSH,33,64,5,8,13
80,8483482,Tristan Luneau,D,ANA,20,72,5,8,13
80,8479972,Mason Shaw,C,WPG,26,45,5,8,13
80,8480222,Sebastian Aho,D,PIT,28,75,4,9,13
80,8476967,Brett Kulak,D,EDM,30,59,3,10,13
80,8482634,Alex Steeves,C,TOR,25,45,3,10,13
80,8479998,Mikey Anderson,D,LAK,25,60,2,11,13
80,8476952,Dominic Toninato,C,WPG,30,31,2,11,13
80,8482070,Mitchell Chaffee,R,TBL,26,50,10,2,12
80,8482077,Dylan Holloway,L,EDM,23,54,7,5,12
80,8479671,Mathieu Olivier,R,CBJ,27,44,7,5,12
80,8482762,Simon Edvinsson,D,DET,21,56,7,5,12
80,8479328,Julien Gauthier,R,NYI,27,69,6,6,12
80,8477938,Haydn Fleury,D,WPG,28,45,6,6,12
80,8481537,Nikita Okhotiuk,D,CGY,24,52,5,7,12
80,8477435,Ryan Graves,D,PIT,29,75,5,7,12
80,8477507,Nikita Zadorov,D,BOS,29,63,5,7,12
80,8479718,Alex Barré-Boulet,C,MTL,27,50,5,7,12
80,8482176,Wyatt Kaiser,D,CHI,22,46,4,8,12
80,8482784,Zach Dean,C,STL,21,49,4,8,12
80,8479981,Jonah Gadjovich,L,FLA,26,41,4,8,12
80,8477962,Brendan Lemieux,L,CAR,28,43,4,8,12
80,8481598,Philip Broberg,D,EDM,23,40,4,8,12
80,8482451,Mikael Pyyhtia,L,CBJ,23,45,3,9,12
80,8479994,Jaret Anderson-Dolan,C,WPG,25,37,3,9,12
80,8481167,Brayden Pachal,D,CGY,25,45,3,9,12
80,8478399,Jonas Siegenthaler,D,NJD,27,53,3,9,12
80,8480807,Mattias Samuelsson,D,BUF,24,55,2,10,12
80,8480950,Ilya Lyubushkin,D,DAL,30,61,2,10,12
80,8475718,Justin Holl,D,DET,32,61,2,10,12
80,8481019,David Gustafsson,C,WPG,24,43,1,11,12
80,8476874,Olli Maatta,D,DET,30,59,1,11,12
80,8479638,Justin Brazeau,R,BOS,26,33,10,1,11
80,8479414,Nathan Bastian,R,NJD,27,59,5,6,11
80,8479291,Kevin Rooney,C,CGY,31,48,5,6,11
80,8475762,Derek Forbort,D,VAN,32,44,5,6,11
80,8480355,Mark Kastelic,C,BOS,25,66,5,6,11
80,8477887,Patrick Brown,C,BOS,32,48,5,6,11
80,8481013,Jonatan Berggren,R,DET,24,56,4,7,11
80,8482964,Arber Xhekaj,D,MTL,23,55,4,7,11
80,8482095,Tyler Kleven,D,OTT,22,49,4,7,11
80,8475179,Dmitry Kulikov,D,FLA,34,62,3,8,11
80,8474166,Alec Martinez,D,CHI,37,45,3,8,11
80,8480880,Jakub Lauko,C,MIN,24,32,3,8,11
80,8475279,Ben Chiarot,D,DET,33,68,2,9,11
80,8479369,Andrew Peeke,D,BOS,26,55,2,9,11
80,8471677,Jack Johnson,D,CBJ,37,64,2,9,11
80,8477365,Connor Clifton,D,BUF,29,60,1,10,11
80,8474090,Brendan Smith,D,DAL,35,59,1,10,11
80,8479249,Andrew Poturalski,C,SJS,30,37,1,10,11
80,8473446,Erik Johnson,D,PHI,36,40,0,11,11
80,8480879,Jacob Bernard-Docker,D,OTT,24,43,0,11,11
80,8480157,Calle Rosen,D,COL,30,43,7,3,10
80,8479619,Michael Carcone,L,UTA,28,63,6,4,10
80,8480252,Cole Guttman,C,CHI,25,40,5,5,10
80,8481532,Alex Turcotte,C,LAK,23,42,5,5,10
80,8481028,Martin Pospisil,C,CGY,25,46,4,6,10
80,8483763,Maksymilian Szuber,D,UTA,22,39,4,6,10
80,8482730,Brandt Clarke,D,LAK,21,41,3,7,10
80,8479348,Kale Clague,D,BUF,26,42,3,7,10
80,8481701,Santeri Hatakka,D,NJD,23,45,3,7,10
80,8482250,Callahan Burke,C,VGK,27,26,3,7,10
80,8478443,Brandon Carlo,D,BOS,28,69,2,8,10
80,8476441,Joel Edmundson,D,LAK,31,42,2,8,10
80,8474013,Ian Cole,D,UTA,35,49,2,8,10
80,8476891,Matthew Grzelcyk,D,PIT,30,75,1,9,10
80,8475208,Brian Dumoulin,D,ANA,33,65,1,9,10
80,8474568,Luke Schenn,D,NSH,35,49,1,9,10
80,8480281,Alexey Toropchenko,R,STL,25,55,5,4,9
80,8481617,Vasily Podkolzin,R,VAN,23,40,5,4,9
80,8479344,Jesse Puljujarvi,R,PIT,26,54,5,4,9
80,8481518,Nolan Foote,L,NJD,24,40,5,4,9
80,8478421,A.J. Greer,L,FLA,28,48,4,5,9
80,8480192,Johnathan Kovacevic,D,NJD,27,54,4,5,9
80,8481599,Victor Soderstrom,D,UTA,23,50,4,5,9
80,8477369,Carson Soucy,D,VAN,30,63,3,6,9
80,8475177,Calvin de Haan,D,COL,33,42,3,6,9
80,8479026,Philippe Myers,D,TOR,27,52,3,6,9
80,8475455,Brenden Dillon,D,NJD,34,61,2,7,9
80,8478451,Ethan Bear,D,WSH,27,52,2,7,9
80,8482859,Zack Ostapchuk,C,OTT,21,52,2,7,9
80,8474612,Travis Hamonic,D,OTT,34,48,1,8,9
80,8476473,Connor Murphy,D,CHI,31,38,1,8,9
80,8479378,Logan Stanley,D,WPG,26,49,1,8,9
80,8481556,John Beecher,C,BOS,23,30,7,1,8
80,8483466,Kevin Korchinski,D,CHI,20,56,5,3,8
80,8481754,Nikita Nesterenko,C,ANA,23,31,5,3,8
80,8481789,Tye Kartye,L,SEA,23,42,5,3,8
80,8482166,Shakir Mukhamadullin,D,SJS,22,57,4,4,8
80,8477401,John Hayden,C,SEA,29,28,4,4,8
80,8474567,Zach Bogosian,D,MIN,34,65,4,4,8
80,8479944,Zach Aston-Reese,C,VGK,30,48,4,4,8
80,8479968,Vinni Lettieri,C,BOS,29,41,3,5,8
80,8478450,Parker Wotherspoon,D,BOS,27,29,3,5,8
80,8480845,Rasmus Kupari,C,WPG,24,46,2,6,8
80,8481122,Simon Benoit,D,TOR,26,37,2,6,8
80,8483460,David Jiricek,D,CBJ,21,60,1,7,8
80,8481600,Tobias Bjornfot,D,FLA,23,44,1,7,8
80,8480025,MacKenzie Entwistle,R,FLA,25,56,5,2,7
80,8482713,Mackie Samoskevich,R,FLA,22,43,5,2,7
80,8482747,Brennan Othmann,L,NYR,21,38,4,3,7
80,8482751,Ryan Winterton,C,SEA,21,39,4,3,7
80,8478434,Keegan Kolesar,R,VGK,27,58,3,4,7
80,8481550,Adam Beckman,L,NJD,23,39,3,4,7
80,8480245,Olle Lycksell,R,PHI,25,35,3,4,7
80,8483397,Marc McLaughlin,C,BOS,25,30,3,4,7
80,8478021,William Lagesson,D,DET,28,33,3,4,7
80,8476867,Brendan Gaunce,C,MIN,30,33,2,5,7
80,8480860,Kevin Bahl,D,CGY,24,56,2,5,7
80,8477335,Kyle Burroughs,D,LAK,29,42,2,5,7
80,8480441,Trey Fix-Wolansky,R,CBJ,25,36,2,5,7
80,8477384,Joshua Brown,D,EDM,30,44,2,5,7
80,8482192,Isaak Phillips,D,CHI,23,50,1,6,7
80,8480196,Jacob Bryson,D,BUF,27,33,1,6,7
80,8477034,Jaycob Megna,D,FLA,32,42,0,7,7
80,8483619,Filip Roos,D,OTT,25,35,0,7,7
80,8480021,Jack Studnicka,C,LAK,25,61,4,2,6
80,8477482,Zachary Sanford,L,CHI,30,35,4,2,6
80,8475958,Michael Sgarbossa,C,WSH,32,25,4,2,6
80,8480844,Grigori Denisenko,L,VGK,24,28,4,2,6
80,8478424,Jansen Harkins,C,ANA,27,40,3,3,6
80,8480292,Carson Meyer,R,ANA,27,33,3,3,6
80,8479772,Zack MacEwen,R,OTT,28,56,3,3,6
80,8480990,Declan Chisholm,D,MIN,24,37,3,3,6
80,8478874,Adam Gaudette,R,OTT,28,29,3,3,6
80,8483630,Pavol Regenda,L,ANA,25,30,3,3,6
80,8480890,Jan Jenik,C,OTT,24,32,3,3,6
80,8477508,Curtis Lazar,C,NJD,29,53,2,4,6
80,8482062,Cole Smith,L,NSH,29,54,2,4,6
80,8479986,Kole Lind,R,DAL,26,42,2,4,6
80,8480007,Jonas Rondbjerg,R,VGK,25,39,2,4,6
80,8475235,Nicolas Deslauriers,L,PHI,33,59,2,4,6
80,8484287,Cole McWard,D,VAN,23,21,2,4,6
80,8480070,Ian Mitchell,D,BOS,25,53,1,5,6
80,8481679,Maxence Guenette,D,OTT,23,33,1,5,6
80,8477070,Liam O'Brien,C,UTA,30,52,1,5,6
80,8484911,Collin Graf,R,SJS,22,39,1,5,6
80,8478146,Matthew Highmore,C,OTT,28,34,1,5,6
80,8482516,Matthew Kessel,D,STL,24,22,1,5,6
80,8480834,Ty Emberson,D,SJS,24,34,0,6,6
80,8482511,Mason Lohrei,D,BOS,23,30,0,6,6
80,8477527,Ross Johnston,L,ANA,30,31,3,2,5
80,8480267,Sammy Walker,C,MIN,25,20,3,2,5
80,8479379,Givani Smith,R,SJS,26,32,3,2,5
80,8479985,Cale Fleury,D,SEA,26,27,3,2,5
80,8484325,Waltteri Merela,C,TBL,26,24,3,2,5
80,8484254,Akito Hirose,D,VAN,25,35,2,3,5
80,8482145,Mavrik Bourque,C,DAL,22,54,2,3,5
80,8482765,Isak Rosen,R,BUF,21,32,2,3,5
80,8480058,Pierre-Olivier Joseph,D,STL,25,50,2,3,5
80,8481609,Vladislav Kolyachonok,D,UTA,23,33,2,3,5
80,8483512,Matthew Savoie,C,EDM,20,23,2,3,5
80,8481237,Kyle MacLean,C,NYI,25,25,2,3,5
80,8482073,Braden Schneider,D,NYR,23,52,1,4,5
80,8480796,Martin Fehervary,D,WSH,25,52,1,4,5
80,8475750,Jon Merrill,D,MIN,32,64,1,4,5
80,8479442,Troy Stecher,D,EDM,30,50,1,4,5
80,8478454,Noah Juulsen,D,VAN,27,32,1,4,5
80,8479536,Axel Jonsson-Fjallby,L,WPG,26,34,1,4,5
80,8482861,Vincent Iorio,D,WSH,22,32,1,4,5
80,8482177,Marat Khusnutdinov,C,MIN,22,30,1,4,5
80,8479576,Vincent Desharnais,D,VAN,28,34,1,4,5
80,8477244,Chad Ruhwedel,D,NYR,34,34,1,4,5
80,8483549,Lucas Condotta,L,MTL,27,35,0,5,5
80,8481462,Mason Morelli,L,VGK,28,18,4,0,4
80,8478409,Anthony Richard,C,PHI,28,34,3,1,4
80,8481147,Reese Johnson,C,MIN,26,38,2,2,4
80,8482141,Lukas Cormier,D,VGK,22,23,2,2,4
80,8479367,William Lockwood,R,FLA,26,16,2,2,4
80,8480870,Bo Groulx,C,NYR,24,33,2,2,4
80,8482061,Brandon Biro,L,SEA,26,13,2,2,4
80,8477810,Joel Hanley,D,CGY,33,21,2,2,4
80,8481605,Jackson LaCombe,D,ANA,23,24,1,3,4
80,8477851,Jordan Oesterle,D,BOS,32,40,1,3,4
80,8479991,Jake Leschyshyn,C,NYR,25,28,1,3,4
80,8482153,Brendan Brisson,C,VGK,23,29,1,3,4
80,8480851,Akil Thomas,C,LAK,24,18,1,3,4
80,8478859,Niko Mikkola,D,FLA,28,58,0,4,4
80,8476372,Nick Seeler,D,PHI,31,44,0,4,4
80,8482144,Jack Thompson,D,SJS,22,28,0,4,4
80,8481699,Aku Raty,R,UTA,23,15,0,4,4
80,8479522,Hardy Haman Aktell,D,WSH,26,6,0,4,4
80,8481043,Cole Koepke,L,BOS,26,16,3,0,3
80,8482652,Walker Duehr,R,CGY,27,41,2,1,3
80,8480468,James Hamblin,L,EDM,25,22,2,1,3
80,8476913,Devin Shore,C,MIN,30,32,2,1,3
80,8479362,Riley Tufte,L,BOS,26,20,2,1,3
80,8482162,Roby Jarventie,L,EDM,22,15,2,1,3
80,8481592,Jakob Pelletier,L,CGY,23,40,1,2,3
80,8481543,Nikita Alexandrov,C,STL,24,26,1,2,3
80,8481056,Spencer Stastney,D,NSH,24,25,1,2,3
80,8479320,Maxime Lajoie,D,SEA,27,28,1,2,3
80,8477073,Kurtis MacDermid,L,NJD,30,34,1,2,3
80,8481719,Maxwell Crozier,D,TBL,24,13,1,2,3
80,8483489,Fraser Minten,C,TOR,31,9,1,2,3
80,8482470,Ilya Solovyov,D,CGY,24,19,1,2,3
80,8482172,Landon Slaggert,L,CHI,22,20,1,2,3
80,8482088,Justin Sourdif,R,FLA,22,23,1,2,3
80,8483012,Logan Morrison,C,SEA,22,33,0,3,3
80,8477473,Justin Bailey,R,SJS,29,23,0,3,3
80,8481743,Marc Del Gaizo,D,NSH,25,17,0,3,3
80,8477462,Robert Hagg,D,VGK,29,28,0,3,3
80,8479419,Brett Murray,L,BUF,26,20,0,3,3
80,8479587,Rhett Gardner,C,PHI,28,26,0,3,3
80,8478051,Max Willman,C,NJD,29,19,0,3,3
80,8482147,Jean-Luc Foudy,C,COL,22,21,2,0,2
80,8480032,Shane Bowers,C,NJD,25,16,2,0,2
80,8482102,Vasily Ponomarev,C,PIT,22,17,2,0,2
80,8482197,Adam Raska,R,MIN,23,10,2,0,2
80,8482733,Logan Mailloux,D,MTL,31,29,1,1,2
80,8483570,Ben Meyers,C,SEA,26,27,1,1,2
80,8481578,Graeme Clarke,R,MIN,23,8,1,1,2
80,8477467,Gustav Olofsson,D,SEA,30,15,1,1,2
80,8481024,Linus Karlsson,C,VAN,25,8,1,1,2
80,8483395,Arshdeep Bains,L,VAN,23,11,1,1,2
80,8483471,Brad Lambert,C,WPG,31,8,1,1,2
80,8483398,Declan Carlile,D,TBL,31,3,1,1,2
80,8475795,Dylan McIlrath,D,WSH,32,16,0,2,2
80,8481593,Jayden Struble,D,MTL,23,17,0,2,2
80,8482201,Gage Goncalves,C,TBL,23,22,0,2,2
80,8481806,Louis Crevier,D,CHI,23,15,0,2,2
80,8478881,Brett Seney,L,CHI,28,12,0,2,2
80,8482165,Yan Kuznetsov,D,CGY,22,21,0,2,2
80,8477149,Scott Sabourin,R,SJS,32,12,0,2,2
80,8481422,Jake Lucchini,C,NSH,29,24,0,2,2
80,8474062,Riley Nash,C,NYR,35,15,0,2,2
80,8482929,Emil Lilleberg,D,TBL,23,18,1,0,1
80,8482094,Daemon Hunt,D,MIN,22,11,1,0,1
80,8478446,Glenn Gawdin,C,LAK,27,12,1,0,1
80,8478147,Bokondji Imama,L,PIT,28,3,1,0,1
80,8478502,Dennis Gilbert,D,BUF,28,25,1,0,1
80,8478854,Ryan Shea,D,PIT,27,6,1,0,1
80,8482460,Matt Rempe,C,NYR,22,18,1,0,1
80,8482118,Sam Colangelo,R,ANA,23,13,1,0,1
80,8483546,Marshall Rifai,D,TOR,26,3,1,0,1
80,8483531,Brian Halonen,L,NJD,25,1,1,0,1
80,8481206,John Ludvig,D,PIT,24,14,1,0,1
80,8482787,Nikita Chibrikov,R,WPG,31,13,1,0,1
80,8475780,Chris Wagner,R,COL,33,7,1,0,1
80,8482858,Ryker Evans,D,SEA,23,19,0,1,1
80,8484258,Sam Malinski,D,COL,26,23,0,1,1
80,8477971,Andreas Englund,D,LAK,28,32,0,1,1
80,8481541,Samuel Bolduc,D,NYI,24,31,0,1,1
80,8480084,Nick DeSimone,D,NJD,30,16,0,1,1
80,8475755,Alexander Petrovic,D,DAL,32,8,0,1,1
80,8478477,Mitchell Stephens,C,SEA,27,16,0,1,1
80,8475413,Justin Dowling,C,NJD,34,18,0,1,1
80,8480823,Alexander Alexeyev,D,WSH,25,10,0,1,1
80,8480874,Adam Ginning,D,PHI,24,14,0,1,1
80,8481006,Tyler Tucker,D,STL,24,16,0,1,1
80,8477541,Dakota Mermis,D,TOR,30,9,0,1,1
80,8479330,Brandon Gignac,C,MTL,27,7,0,1,1
80,8479421,Jacob Moverare,D,LAK,26,4,0,1,1
80,8483407,Brandon Scanlin,D,NYR,25,5,0,1,1
80,8483609,Adam Klapka,R,CGY,24,1,0,1,1
80,8477320,Anton Blidh,L,NYR,29,16,0,0,0
80,8481065,Angus Crookshank,L,OTT,25,9,0,0,0
80,8481030,Jack St. Ivany,D,PIT,25,12,0,0,0
80,8481585,Egor Afanasyev,L,SJS,23,16,0,0,0
80,8483597,Milos Kelemen,L,UTA,25,8,0,0,0
80,8482126,Emil Andrae,D,PHI,31,2,0,0,0
80,8484321,Nikolas Matinpalo,D,OTT,26,1,0,0,0
80,8482476,Emil Heineman,L,MTL,23,5,0,0,0
80,8480075,Cameron Crotty,D,MIN,25,9,0,0,0
80,8478011,Louie Belpedio,D,PHI,28,14,0,0,0
80,8483567,Georgii Merkulov,C,BOS,24,12,0,0,0
80,8483432,Luca Del Bel Belluz,C,CBJ,31,5,0,0,0
80,8478956,Samuel Laberge,L,NJD,27,3,0,0,0
80,8481564,Ryan Johnson,D,BUF,23,9,0,0,0
80,8484304,Uvis Balinskis,D,FLA,28,9,0,0,0
80,8483920,Pierrick Dube,R,WSH,23,4,0,0,0
80,8477993,Justin Kirkland,C,CGY,28,2,0,0,0
80,8480306,Grant Hutton,D,NYI,29,1,0,0,0
80,8476323,Max McCormick,L,SEA,32,0,0,0,0
80,8481726,Adam Edstrom,C,NYR,24,10,0,0,0
80,8484326,Patrik Koch,D,UTA,28,3,0,0,0
80,8481655,Cole Schwindt,R,CGY,23,3,0,0,0
80,8480274,Philip Kemp,D,EDM,25,1,0,0,0
80,8484255,Jason Polin,R,COL,25,5,0,0,0
80,8481534,Raphael Lavoie,C,EDM,24,1,0,0,0
80,8483401,Marc Johnstone,R,PIT,28,0,0,0,0
80,8484259,Ondrej Pavel,C,COL,31,3,0,0,0
80,8470794,Joe Pavelski,C,,40,0,0,0,0
80,8479321,Lucas Johansen,D,,27,0,0,0,0
80,8477950,Tony DeAngelo,D,,29,0,0,0,0
80,8471218,Blake Wheeler,R,,38,0,0,0,0
80,8475197,Tyson Barrie,D,,33,0,0,0,0
80,8474157,Max Pacioretty,L,,36,0,0,0,0
80,8475744,Evgeny Kuznetsov,C,,32,0,0,0,0
80,8474037,James van Riemsdyk,L,,35,0,0,0,0
80,8476907,Mackenzie MacEachern,L,,30,0,0,0,0
80,8480216,Jacob Peterson,C,,25,0,0,0,0
80,8474602,Justin Schultz,D,,34,0,0,0,0
80,8482222,Alexander Barabanov,L,,30,0,0,0,0
80,8474031,Kevin Shattenkirk,D,,35,0,0,0,0
80,8477330,Dominik Kubalik,L,,29,0,0,0,0
80,8480884,Calen Addison,D,,24,0,0,0,0
80,8475906,John Klingberg,D,,32,0,0,0,0
80,8480008,Adam Ruzicka,C,,25,0,0,0,0
80,8476884,Derrick Pouliot,D,,30,0,0,0,0
80,8476919,Chris Tierney,C,,30,0,0,0,0
80,8479415,Michael McLeod,C,,26,0,0,0,0
80,8474870,Tyler Johnson,C,,34,0,0,0,0
80,8470604,Jeff Carter,C,,39,0,0,0,0
80,8478104,Sammy Blais,L,,28,0,0,0,0
80,8474884,Mike Hoffman,C,,35,0,0,0,0
80,8481591,Sam Poulin,R,,23,0,0,0,0
80,8471274,Alex Goligoski,D,,39,0,0,0,0
80,8476871,Tanner Pearson,L,,32,0,0,0,0
80,8476393,Nick Cousins,C,,31,0,0,0,0
80,8479977,Kailer Yamamoto,R,,26,0,0,0,0
80,8479346,Dillon Dube,C,,26,0,0,0,0
80,8480184,Gustav Lindstrom,D,,26,0,0,0,0
80,8479376,Victor Mete,D,,26,0,0,0,0
80,8473449,Kyle Okposo,R,,36,0,0,0,0
80,8481058,Jesse Ylonen,R,,25,0,0,0,0
80,8475752,Tyler Pitlick,C,,33,0,0,0,0
80,8481239,Samuel Fagemo,L,,24,0,0,0,0
80,8480821,Filip Zadina,R,,25,0,0,0,0
80,8470966,Mark Giordano,D,,41,0,0,0,0
80,8478495,Denis Gurianov,R,,27,0,0,0,0
80,8477464,Nic Petan,C,,29,0,0,0,0
80,8478099,Kevin Labanc,R,,29,0,0,0,0
80,8482241,Radim Zohorna,L,,28,0,0,0,0
80,8474040,Sam Gagner,C,,35,0,0,0,0
80,8479514,Rem Pitlick,C,,27,0,0,0,0
80,8478430,Oliver Kylington,D,,27,0,0,0,0
80,8479533,Joona Koppanen,L,,26,0,0,0,0
80,8479984,Cal Foote,D,,26,0,0,0,0
80,8477126,Jayson Megna,C,,34,0,0,0,0
80,8475164,Jakob Silfverberg,R,,34,0,0,0,0
80,8474009,Nick Bonino,C,,36,0,0,0,0
80,8479458,Nikita Zaitsev,D,,33,0,0,0,0
80,8477944,Jakub Vrana,L,,28,0,0,0,0
80,8471699,Andrew Cogliano,C,,37,0,0,0,0
80,8478067,Oskar Lindblom,L,,28,0,0,0,0
80,8471686,Marc Staal,D,,37,0,0,0,0
80,8470610,Zach Parise,L,,40,0,0,0,0
80,8478904,Steven Lorentz,C,,28,0,0,0,0
80,8473473,Milan Lucic,L,,36,0,0,0,0
80,8480031,Maxime Comtois,L,,25,0,0,0,0
80,8478512,Austin Czarnik,C,,32,0,0,0,0
80,8473504,Cal Clutterbuck,R,,37,0,0,0,0
80,8477454,Adam Erne,L,,29,0,0,0,0
80,8479383,Boris Katchouk,L,,26,0,0,0,0
80,8475825,Jani Hakanpää,D,,32,0,0,0,0
80,8477846,Ryan Carpenter,C,,33,0,0,0,0
80,8477930,Pierre-Edouard Bellemare,L,,39,0,0,0,0
80,8478400,Colin White,C,,27,0,0,0,0
80,8480226,Marián Studenic,R,,26,0,0,0,0
80,8480853,Liam Foudy,C,,24,0,0,0,0
80,8475797,Jarred Tinordi,D,,32,0,0,0,0
80,8479423,Alex Nylander,L,,26,0,0,0,0
80,8474618,Marco Scandella,D,,34,0,0,0,0
80,8478028,Fredrik Olofsson,L,,28,0,0,0,0
80,8474709,Matt Martin,L,,35,0,0,0,0
80,8481070,Hugh McGing,L,,26,0,0,0,0
80,8479546,Oskar Steen,C,,26,0,0,0,0
80,8474145,Robert Bortuzzo,D,,35,0,0,0,0
80,8476915,Jujhar Khaira,L,,30,0,0,0,0
80,8475278,Byron Froese,C,,33,0,0,0,0
80,8481812,Nikolai Knyzhov,D,,27,0,0,0,0
80,8478408,Travis Dermott,D,,28,0,0,0,0
80,8481077,John Leonard,L,,26,0,0,0,0
80,8479547,Matthew Phillips,R,,26,0,0,0,0
80,8480836,Jonathan Gruden,C,,24,0,0,0,0
80,8481690,Tyler Angle,C,,24,0,0,0,0
80,8475766,Austin Watson,L,,32,0,0,0,0
80,8481016,Ruslan Iskhakov,C,,24,0,0,0,0
80,8478078,Rourke Chartier,C,,28,0,0,0,0
80,8480776,Sheldon Rempal,R,,29,0,0,0,0
80,8483045,Cameron Butler,R,CBJ,31,0,0,0,0
80,8484314,Jiri Smejkal,L,,28,0,0,0,0
81,8476453,Nikita Kucherov,R,TBL,31,82,39,108,147
81,8479318,Auston Matthews,C,TOR,27,81,75,62,137
81,8478402,Connor McDavid,C,EDM,27,78,28,97,125
81,8477956,David Pastrnak,R,BOS,28,81,55,64,119
81,8478483,Mitch Marner,R,TOR,27,78,26,93,119
81,8477492,Nathan MacKinnon,C,COL,29,82,47,71,118
81,8478420,Mikko Rantanen,R,COL,28,82,55,59,114
81,8479314,Matthew Tkachuk,L,FLA,27,76,35,77,112
81,8471675,Sidney Crosby,C,PIT,37,76,52,58,110
81,8477934,Leon Draisaitl,C,EDM,29,76,50,58,108
81,8477939,William Nylander,R,TOR,28,79,47,61,108
81,8478864,Kirill Kaprizov,L,MIN,27,75,35,73,108
81,8478550,Artemi Panarin,L,NYR,33,79,34,72,106
81,8474564,Steven Stamkos,C,NSH,34,75,37,66,103
81,8476468,J.T. Miller,C,VAN,31,74,38,62,100
81,8480027,Jason Robertson,L,DAL,25,82,34,63,97
81,8476887,Filip Forsberg,L,NSH,30,76,48,46,94
81,8477404,Jake Guentzel,C,TBL,30,82,41,53,94
81,8471215,Evgeni Malkin,C,PIT,38,77,40,54,94
81,8481559,Jack Hughes,C,NJD,23,77,39,55,94
81,8477942,Kevin Fiala,L,LAK,28,81,35,59,94
81,8480069,Cale Makar,D,COL,26,72,31,63,94
81,8480801,Brady Tkachuk,L,OTT,25,78,35,56,91
81,8475913,Mark Stone,R,VGK,32,80,25,66,91
81,8475166,John Tavares,C,TOR,34,78,40,50,90
81,8482116,Tim Stützle,C,OTT,22,80,33,56,89
81,8480800,Quinn Hughes,D,VAN,25,77,5,84,89
81,8478445,Mathew Barzal,C,NYI,27,80,29,59,88
81,8477946,Dylan Larkin,C,DET,28,82,43,44,87
81,8480023,Robert Thomas,C,STL,25,74,30,57,87
81,8478010,Brayden Point,C,TBL,28,82,48,38,86
81,8475172,Nazem Kadri,C,CGY,34,77,40,46,86
81,8478439,Travis Konecny,R,PHI,27,78,41,44,85
81,8479343,Clayton Keller,R,UTA,26,77,36,49,85
81,8476459,Mika Zibanejad,C,NYR,31,78,26,59,85
81,8481557,Matt Boldy,L,MIN,23,76,38,46,84
81,8480012,Elias Pettersson,C,VAN,26,73,36,48,84
81,8471685,Anze Kopitar,C,LAK,37,81,27,56,83
81,8478403,Jack Eichel,C,VGK,28,78,41,41,82
81,8479385,Jordan Kyrou,C,STL,26,73,37,45,82
81,8484144,Connor Bedard,C,CHI,19,69,24,58,82
81,8478449,Roope Hintz,C,DAL,28,82,39,42,81
81,8478427,Sebastian Aho,C,CAR,27,72,31,50,81
81,8477493,Aleksander Barkov,C,FLA,29,76,23,58,81
81,8477409,Carter Verhaeghe,C,FLA,29,80,41,37,78
81,8475692,Mats Zuccarello,R,MIN,37,75,24,54,78
81,8474600,Roman Josi,D,NSH,34,73,22,56,78
81,8480036,Miro Heiskanen,D,DAL,25,77,19,59,78
81,8479542,Brandon Hagel,L,TBL,26,82,33,44,77
81,8480018,Nick Suzuki,C,MTL,25,79,27,50,77
81,8477933,Sam Reinhart,C,FLA,29,78,34,42,76
81,8476460,Mark Scheifele,C,WPG,31,74,32,43,75
81,8476539,Jonathan Marchessault,R,NSH,34,70,36,38,74
81,8478398,Kyle Connor,L,WPG,28,73,35,39,74
81,8475754,Brock Nelson,C,NYI,33,81,34,40,74
81,8479337,Alex DeBrincat,R,DET,27,81,28,46,74
81,8476456,Jonathan Huberdeau,C,CGY,31,80,22,52,74
81,8476346,Johnny Gaudreau,L,CBJ,31,70,21,53,74
81,8477402,Pavel Buchnevich,L,STL,29,74,20,54,74
81,8479323,Adam Fox,D,NYR,26,75,12,60,72
81,8478444,Brock Boeser,R,VAN,27,71,30,41,71
81,8473419,Brad Marchand,L,BOS,36,80,27,44,71
81,8479407,Jesper Bratt,L,NJD,26,68,24,47,71
81,8480865,Noah Dobson,D,NYI,24,80,13,58,71
81,8479420,Tage Thompson,C,BUF,27,68,36,34,70
81,8477496,Elias Lindholm,C,BOS,30,78,24,46,70
81,8480208,Drake Batherson,R,OTT,26,77,28,41,69
81,8477960,Adrian Kempe,R,LAK,28,81,27,42,69
81,8473512,Claude Giroux,R,OTT,36,79,25,44,69
81,8477951,Nick Schmaltz,C,UTA,28,76,32,36,68
81,8478519,Anthony Cirelli,C,TBL,27,81,28,40,68
81,8478047,Michael Bunting,L,PIT,29,76,25,43,68
81,8475798,Mikael Granlund,C,SJS,32,73,23,45,68
81,8477503,Max Domi,C,TOR,29,79,20,48,68
81,8482740,Wyatt Johnston,C,DAL,21,82,31,36,67
81,8477504,Josh Morrissey,D,WPG,29,71,17,50,67
81,8474578,Erik Karlsson,D,PIT,34,81,16,51,67
81,8476389,Vincent Trocheck,C,NYR,31,75,36,30,66
81,8477501,Valeri Nichushkin,R,COL,29,81,34,32,66
81,8477495,Seth Jones,D,CHI,30,74,17,49,66
81,8477500,Bo Horvat,C,NYI,29,81,37,28,65
81,8480830,Andrei Svechnikov,R,CAR,24,75,26,39,65
81,8475168,Matt Duchene,C,DAL,33,80,24,41,65
81,8482699,Dylan Guenther,R,UTA,21,80,23,42,65
81,8474679,Gustav Nyquist,C,NSH,35,71,21,44,65
81,8475184,Chris Kreider,L,NYR,33,77,40,24,64
81,8477416,Oliver Bjorkstrand,R,SEA,29,76,29,35,64
81,8478414,Timo Meier,R,NJD,28,75,27,37,64
81,8473994,Jamie Benn,L,DAL,35,81,23,41,64
81,8476905,Chandler Stephenson,C,SEA,30,76,19,45,64
81,8475810,Bryan Rust,R,PIT,32,70,29,34,63
81,8478401,Pavel Zacha,C,BOS,27,79,28,35,63
81,8480015,Owen Tippett,R,PHI,25,78,28,34,62
81,8477955,Jared McCann,L,SEA,28,75,28,34,62
81,8480039,Martin Necas,C,CAR,25,67,23,39,62
81,8477949,Alex Tuch,R,BUF,28,73,20,42,62
81,8476399,Blake Coleman,C,CGY,33,78,32,29,61
81,8476483,Rickard Rakell,R,PIT,31,72,30,31,61
81,8483515,Juraj Slafkovsky,L,MTL,20,77,28,33,61
81,8475765,Vladimir Tarasenko,R,DET,33,79,25,36,61
81,8480839,Rasmus Dahlin,D,BUF,24,68,19,42,61
81,8476454,Ryan Nugent-Hopkins,C,EDM,31,80,14,47,61
81,8475169,Evander Kane,L,EDM,33,74,39,21,60
81,8480002,Nico Hischier,C,NJD,25,74,27,33,60
81,8475794,Tyler Seguin,C,DAL,32,82,27,33,60
81,8479675,Trevor Moore,L,LAK,29,79,25,35,60
81,8475158,Ryan O'Reilly,C,NSH,33,70,21,39,60
81,8480803,Evan Bouchard,D,EDM,25,75,16,44,60
81,8479999,Casey Mittelstadt,C,COL,26,81,16,44,60
81,8478460,Zach Werenski,D,CBJ,27,82,15,45,60
81,8476853,Morgan Rielly,D,TOR,30,73,12,48,60
81,8476875,Mike Matheson,D,MTL,30,75,9,51,60
81,8475784,Jeff Skinner,C,EDM,32,78,35,24,59
81,8476448,William Karlsson,C,VGK,31,78,27,32,59
81,8478542,Evan Rodrigues,C,FLA,31,78,25,34,59
81,8477476,Artturi Lehkonen,L,COL,29,81,24,35,59
81,8482093,Seth Jarvis,C,CAR,22,70,24,35,59
81,8471214,Alex Ovechkin,L,WSH,39,76,23,36,59
81,8478438,Tommy Novak,C,NSH,27,69,19,40,59
81,8475786,Zach Hyman,L,EDM,32,79,35,23,58
81,8482109,Alexis Lafrenière,L,NYR,23,74,35,23,58
81,8480014,Gabriel Vilardi,C,WPG,25,73,32,26,58
81,8477935,Sam Bennett,C,FLA,28,78,28,30,58
81,8475167,Victor Hedman,D,TBL,34,81,21,37,58
81,8476882,Teuvo Teravainen,C,CHI,30,66,20,38,58
81,8483808,Andrei Kuzmenko,L,CGY,28,76,28,29,57
81,8482665,Matty Beniers,C,SEA,22,74,17,40,57
81,8476881,Tomas Hertl,C,VGK,31,73,26,30,56
81,8474586,Jordan Eberle,R,SEA,34,70,22,34,56
81,8481528,Dylan Cozens,C,BUF,23,73,19,37,56
81,8477494,Jonathan Drouin,L,COL,29,81,18,38,56
81,8477447,Shea Theodore,D,VGK,29,70,7,49,56
81,8478233,Andrew Mangiapane,L,WSH,28,67,26,29,55
81,8477021,Alex Kerfoot,C,UTA,30,75,23,32,55
81,8475745,Charlie Coyle,C,BOS,32,80,23,32,55
81,8481540,Cole Caufield,R,MTL,23,76,21,34,55
81,8478975,Mason Marchment,L,DAL,29,80,20,35,55
81,8478856,Conor Garland,R,VAN,28,71,18,37,55
81,8477940,Nikolaj Ehlers,L,WPG,28,72,17,38,55
81,8479325,Charlie McAvoy,D,BOS,27,73,7,48,55
81,8483431,Logan Cooley,C,UTA,20,73,26,28,54
81,8477346,MacKenzie Weegar,D,CGY,30,71,13,41,54
81,8476432,Boone Jenner,C,CBJ,31,74,32,21,53
81,8482078,Lucas Raymond,L,DET,22,79,29,24,53
81,8478493,Joel Eriksson Ek,C,MIN,27,72,22,31,53
81,8481703,Valtteri Puustinen,R,PIT,25,65,16,37,53
81,8474590,John Carlson,D,WSH,34,72,13,40,53
81,8475753,Justin Faulk,D,STL,32,76,13,40,53
81,8481068,Yegor Sharangovich,C,CGY,26,77,27,25,52
81,8475170,Brayden Schenn,C,STL,33,73,20,32,52
81,8482124,Quinton Byfield,R,LAK,22,81,19,33,52
81,8481711,Matias Maccelli,L,UTA,24,72,13,39,52
81,8478397,Rasmus Andersson,D,CGY,28,72,10,42,52
81,8482684,Luke Hughes,D,NJD,21,75,6,46,52
81,8475799,Nino Niederreiter,R,WPG,32,72,31,20,51
81,8478466,Daniel Sprong,R,VAN,27,73,24,27,51
81,8477426,Nicholas Paul,L,TBL,29,82,23,28,51
81,8479525,Ross Colton,C,COL,28,77,22,29,51
81,8484145,Zach Benson,L,BUF,19,76,22,29,51
81,8482097,Jack Quinn,R,BUF,23,64,15,36,51
81,8471724,Kris Letang,D,PIT,37,80,11,40,51
81,8479400,Pierre-Luc Dubois,L,WSH,26,73,22,28,50
81,8478440,Dylan Strome,C,WSH,27,67,19,31,50
81,8478407,Vince Dunn,D,SEA,28,70,13,37,50
81,8478469,Thomas Chabot,D,OTT,27,73,12,38,50
81,8481577,Philip Tomasino,C,NSH,23,75,11,39,50
81,8479425,Filip Hronek,D,VAN,27,72,6,44,50
81,8474141,Patrick Kane,R,DET,36,81,23,26,49
81,8476479,Phillip Danault,C,LAK,31,82,20,29,49
81,8480797,Joel Farabee,L,PHI,24,74,19,30,49
81,8483490,Pavel Mintyukov,D,ANA,21,75,17,32,49
81,8476792,Torey Krug,D,STL,33,78,10,39,49
81,8475764,Cam Fowler,D,ANA,33,71,7,42,49
81,8478366,Frank Vatrano,R,ANA,30,69,25,23,48
81,8482745,Mason McTavish,C,ANA,21,74,22,26,48
81,8475726,Tyler Toffoli,C,SJS,32,68,27,20,47
81,8475314,Anders Lee,L,NYI,34,80,26,21,47
81,8480064,Josh Norris,C,OTT,25,77,25,22,47
81,8478498,Jake DeBrusk,L,VAN,28,72,25,22,47
81,8478038,Devon Toews,D,COL,30,72,8,39,47
81,8482113,Anton Lundell,C,FLA,23,76,26,20,46
81,8475151,Kyle Palmieri,C,NYI,33,81,23,23,46
81,8477964,Ivan Barbashev,C,VGK,29,77,21,25,46
81,8478472,Mathieu Joseph,R,STL,27,70,21,25,46
81,8482159,Tyson Foerster,R,PHI,22,76,20,26,46
81,8477456,J.T. Compher,L,DET,29,79,18,28,46
81,8474150,Mikael Backlund,C,CGY,35,75,13,33,46
81,8478396,Noah Hanifin,D,VGK,27,60,10,36,46
81,8481542,Moritz Seider,D,DET,23,78,3,43,46
81,8484153,Leo Carlsson,C,ANA,20,67,24,21,45
81,8475191,Reilly Smith,R,NYR,33,75,20,25,45
81,8473422,Nick Foligno,L,CHI,37,58,17,28,45
81,8474102,David Perron,L,OTT,36,80,14,31,45
81,8473986,Alex Killorn,L,ANA,35,75,12,33,45
81,8480028,Morgan Frost,C,PHI,25,71,11,34,45
81,8476885,Jacob Trouba,D,NYR,30,71,9,36,45
81,8475760,Nick Bjugstad,C,UTA,32,72,26,18,44
81,8476461,Sean Couturier,C,PHI,32,68,19,25,44
81,8480145,Neal Pionk,D,WPG,29,76,15,29,44
81,8477511,Anthony Mantha,R,CGY,30,75,13,31,44
81,8480459,Pius Suter,C,VAN,28,75,20,23,43
81,8479591,Michael Eyssimont,C,TBL,28,81,19,24,43
81,8482702,Logan Stankoven,C,DAL,21,81,18,25,43
81,8476854,Hampus Lindholm,D,BOS,30,76,6,37,43
81,8478873,Troy Terry,R,ANA,27,71,24,18,42
81,8480188,Fabian Zetterlund,L,SJS,25,71,22,20,42
81,8478462,Nicolas Roy,C,VGK,27,75,20,22,42
81,8480009,Eeli Tolvanen,R,SEA,25,70,20,22,42
81,8477407,Anthony Duclair,L,NYI,29,79,19,23,42
81,8475722,Jason Zucker,L,BUF,32,66,17,25,42
81,8481560,Arthur Kaliyev,R,LAK,23,78,16,26,42
81,8477986,Brandon Montour,D,SEA,30,70,15,27,42
81,8475218,Mattias Ekholm,D,EDM,34,73,10,32,42
81,8479410,Mikhail Sergachev,D,UTA,26,64,8,34,42
81,8476880,Tom Wilson,R,WSH,30,75,22,19,41
81,8476438,Brandon Saad,L,STL,32,68,20,21,41
81,8477479,Tyler Bertuzzi,L,CHI,29,70,19,22,41
81,8477998,Warren Foegele,L,LAK,28,79,19,22,41
81,8477451,Ryan Hartman,R,MIN,30,65,15,26,41
81,8480798,Philipp Kurashev,C,CHI,25,60,15,26,41
81,8476419,Jean-Gabriel Pageau,C,NYI,32,78,15,26,41
81,8475287,Erik Haula,L,NJD,33,76,14,27,41
81,8475763,Kevin Hayes,R,PIT,32,67,14,27,41
81,8478911,Matt Roy,D,WSH,29,72,9,32,41
81,8470613,Brent Burns,D,CAR,39,74,8,33,41
81,8482175,JJ Peterka,R,BUF,22,65,24,16,40
81,8475768,Jaden Schwartz,C,SEA,32,70,22,18,40
81,8482110,Dawson Mercer,C,NJD,23,74,21,19,40
81,8482146,Luke Evangelista,R,NSH,22,62,21,19,40
81,8478046,Danton Heinen,L,VAN,29,69,18,22,40
81,8482720,Matthew Knies,L,TOR,22,75,18,22,40
81,8481618,Alex Newhook,C,MTL,23,64,16,24,40
81,8476872,Scott Laughton,C,PHI,30,75,15,25,40
81,8477498,Darnell Nurse,D,EDM,29,78,11,29,40
81,8478474,Lawson Crouse,L,UTA,27,74,22,17,39
81,8476474,Stefan Noesen,R,NJD,31,61,19,20,39
81,8477425,Miles Wood,L,COL,29,77,18,21,39
81,8481533,Trevor Zegras,C,ANA,23,69,13,26,39
81,8483505,Matthew Poitras,C,BOS,20,73,13,26,39
81,8482105,Jake Sanderson,D,OTT,22,77,10,29,39
81,8477932,Aaron Ekblad,D,FLA,28,64,8,31,39
81,8482655,Janis Moser,D,TBL,24,74,5,34,39
81,8476958,Jaccob Slavin,D,CAR,30,77,2,37,39
81,8480829,Jesperi Kotkaniemi,C,CAR,24,63,20,18,38
81,8481186,Logan O'Connor,R,COL,28,78,18,20,38
81,8479992,Michael Rasmussen,C,DET,25,77,16,22,38
81,8475714,Calle Jarnkrok,C,TOR,33,74,16,22,38
81,8481596,Shane Pinto,C,OTT,24,78,14,24,38
81,8474716,Jared Spurgeon,D,MIN,35,75,14,24,38
81,8481524,Bowen Byram,D,BUF,23,71,11,27,38
81,8477948,Travis Sanheim,D,PHI,28,75,8,30,38
81,8479345,Jakob Chychrun,D,WSH,26,67,8,30,38
81,8478055,Gustav Forsling,D,FLA,28,70,6,32,38
81,8476981,Josh Anderson,R,MTL,30,69,23,14,37
81,8481604,Pavel Dorofeyev,L,VGK,24,71,21,16,37
81,8484166,Adam Fantilli,C,CBJ,20,67,20,17,37
81,8478458,John (Jack) Roslovic,C,CAR,27,65,15,22,37
81,8474641,Adam Henrique,C,EDM,34,75,15,22,37
81,8479351,Sam Steel,C,DAL,26,80,14,23,37
81,8481554,Kaapo Kakko,R,NYR,23,65,13,24,37
81,8475791,Taylor Hall,L,CHI,33,53,13,24,37
81,8478042,Viktor Arvidsson,L,EDM,31,72,12,25,37
81,8477444,Andre Burakovsky,L,SEA,29,71,12,25,37
81,8476458,Ryan Strome,C,ANA,31,72,9,28,37
81,8476826,Yanni Gourde,C,SEA,33,74,15,21,36
81,8477497,Sean Monahan,C,CBJ,30,66,14,22,36
81,8482149,Cole Perfetti,C,WPG,22,67,13,23,36
81,8480078,Filip Chytil,C,NYR,25,60,13,23,36
81,8484203,Bradly Nadeau,L,CAR,19,65,17,18,35
81,8482705,Cole Sillinger,C,CBJ,21,69,16,19,35
81,8475848,Brendan Gallagher,R,MTL,32,65,16,19,35
81,8480802,Ryan McLeod,C,BUF,25,66,15,20,35
81,8479339,Patrik Laine,L,CBJ,26,58,14,21,35
81,8481553,Bobby Brink,R,PHI,23,59,14,21,35
81,8480220,Noah Cates,L,PHI,25,71,12,23,35
81,8477429,Andrew Copp,C,DET,30,79,11,24,35
81,8476906,Shayne Gostisbehere,D,CAR,31,73,7,28,35
81,8482089,Jake Neighbours,L,STL,22,65,22,12,34
81,8477839,Conor Sheary,L,TBL,32,81,15,19,34
81,8479987,Morgan Geekie,C,BOS,26,76,13,21,34
81,8480185,Eetu Luostarinen,C,FLA,26,74,12,22,34
81,8476462,Dougie Hamilton,D,NJD,31,70,12,22,34
81,8482671,Owen Power,D,BUF,22,70,10,24,34
81,8482712,Oskar Olausson,R,COL,22,79,8,26,34
81,8482122,Brock Faber,D,MIN,22,78,6,28,34
81,8480893,Kirill Marchenko,R,CBJ,24,60,18,15,33
81,8470621,Corey Perry,R,EDM,39,72,16,17,33
81,8482055,Drew O'Connor,L,PIT,26,66,15,18,33
81,8479353,Brett Howden,C,VGK,26,71,14,19,33
81,8481581,Thomas Harley,D,DAL,23,74,7,26,33
81,8477969,Marcus Pettersson,D,PIT,28,76,5,28,33
81,8482259,Bobby McMann,C,TOR,28,70,20,12,32
81,8474149,Evgenii Dadonov,R,DAL,35,80,16,16,32
81,8479365,Trent Frederic,C,BOS,26,72,14,18,32
81,8476392,Adam Lowry,C,WPG,31,68,10,22,32
81,8475200,Dmitry Orlov,D,CAR,33,77,7,25,32
81,8478133,Jake Evans,C,MTL,28,71,7,25,32
81,8476892,Colton Parayko,D,STL,31,74,7,25,32
81,8474565,Alex Pietrangelo,D,VGK,34,65,6,26,32
81,8480434,Sean Durzi,D,UTA,26,73,6,26,32
81,8478500,Ivan Provorov,D,CBJ,27,81,3,29,32
81,8475149,Marcus Johansson,L,MIN,34,66,15,16,31
81,8482660,Kent Johnson,C,CBJ,22,62,12,19,31
81,8474715,Cameron Atkinson,R,TBL,35,79,11,20,31
81,8480336,Sean Walker,D,CAR,30,74,8,23,31
81,8476463,Jonas Brodin,D,MIN,31,77,7,24,31
81,8482624,Daniil Miromanov,D,CGY,27,66,7,24,31
81,8476979,Erik Gustafsson,D,DET,32,72,6,25,31
81,8477506,Ryan Pulock,D,NYI,30,75,4,27,31
81,8474151,Ryan McDonagh,D,TBL,35,77,3,28,31
81,8480873,Rasmus Sandin,D,WSH,24,68,3,28,31
81,8481535,Nils Hoglander,L,VAN,24,64,21,9,30
81,8480003,Jesper Boqvist,C,FLA,26,66,17,13,30
81,8482667,William Eklund,L,SJS,22,60,11,19,30
81,8477953,Kasperi Kapanen,R,STL,28,72,11,19,30
81,8480113,Alex Iafallo,L,WPG,31,65,9,21,30
81,8473533,Jordan Staal,C,CAR,36,57,9,21,30
81,8476927,Teddy Blueger,C,VAN,30,71,9,21,30
81,8479639,Dylan Coghlan,D,WPG,26,67,7,23,30
81,8480043,Timothy Liljegren,D,TOR,25,68,6,24,30
81,8481546,Cam York,D,PHI,23,73,6,24,30
81,8476923,Damon Severson,D,CBJ,30,82,4,26,30
81,8476897,Oskar Sundqvist,C,STL,30,61,16,13,29
81,8476469,Joel Armia,R,MTL,31,59,16,13,29
81,8475793,Ryan Johansen,C,PHI,32,68,15,14,29
81,8481523,Kirby Dach,C,MTL,23,69,14,15,29
81,8482749,Joshua Roy,R,MTL,21,67,14,15,29
81,8477952,Robby Fabbri,C,ANA,28,63,13,16,29
81,8480813,Joe Veleno,C,DET,24,72,12,17,29
81,8478115,Pierre Engvall,L,NYI,28,77,12,17,29
81,8476921,Jordan Martinook,L,CAR,32,66,11,18,29
81,8477947,Sonny Milano,L,WSH,28,67,11,18,29
81,8480849,Barrett Hayton,C,UTA,24,64,10,19,29
81,8476480,Vladislav Namestnikov,C,WPG,32,69,10,19,29
81,8482117,Lukas Reichel,L,CHI,22,51,9,20,29
81,8481624,Ilya Mikheyev,R,CHI,30,68,8,21,29
81,8476292,Ondrej Palat,L,NJD,33,72,7,22,29
81,8480817,K'Andre Miller,D,NYR,24,72,6,23,29
81,8476917,Adam Pelech,D,NYI,30,79,3,26,29
81,8471698,T.J. Oshie,R,WSH,38,61,19,9,28
81,8482092,Ridly Greig,C,OTT,22,67,16,12,28
81,8479390,Taylor Raddysh,R,WSH,26,60,16,12,28
81,8478020,Michael Amadio,R,OTT,28,70,13,15,28
81,8475193,Tomas Tatar,L,NJD,34,69,10,18,28
81,8478109,Victor Olofsson,L,VGK,29,69,10,18,28
81,8477919,Frederick Gaudreau,C,MIN,31,65,10,18,28
81,8474563,Drew Doughty,D,LAK,35,74,9,19,28
81,8477505,Alexander Wennberg,C,SJS,30,56,9,19,28
81,8477220,Nate Schmidt,D,FLA,33,71,6,22,28
81,8481606,Jordan Spence,D,LAK,23,67,4,24,28
81,8480891,Michael Kesselring,D,UTA,24,59,3,25,28
81,8479393,Noah Gregor,L,OTT,26,77,14,13,27
81,8478463,Anthony Beauvillier,L,PIT,27,69,12,15,27
81,8477353,Tyler Motte,C,DET,29,76,12,15,27
81,8480748,Kiefer Sherwood,L,VAN,29,59,11,16,27
81,8482133,Thomas Bordeleau,C,SJS,22,54,11,16,27
81,8480049,Dylan Samberg,D,WPG,25,65,8,19,27
81,8475171,Oliver Ekman-Larsson,D,TOR,33,66,6,21,27
81,8476869,Brady Skjei,D,NSH,30,66,4,23,27
81,8478507,John Marino,D,UTA,27,67,2,25,27
81,8482079,Marco Rossi,C,MIN,23,57,17,9,26
81,8480762,Eric Robinson,L,CAR,29,56,17,9,26
81,8480835,Jack Drury,C,CAR,24,60,16,10,26
81,8476878,Zemgus Girgensons,C,TBL,30,82,15,11,26
81,8482074,Connor Zary,C,CGY,23,63,15,11,26
81,8477987,Ryan Donato,C,CHI,28,58,12,14,26
81,8478413,Jordan Greenway,L,BUF,27,63,11,15,26
81,8481580,Connor McMichael,C,WSH,23,61,11,15,26
81,8480068,Ryan Poehling,C,PHI,25,72,9,17,26
81,8477499,Rasmus Ristolainen,D,PHI,30,65,8,18,26
81,8479982,Conor Timmins,D,TOR,26,60,6,20,26
81,8478013,Jake Walman,D,SJS,28,70,5,21,26
81,8482142,Jamie Drysdale,D,PHI,22,67,5,21,26
81,8476278,Colin Blackwell,C,DAL,31,77,15,10,25
81,8476918,Jimmy Vesey,L,NYR,31,67,13,12,25
81,8482125,Alexander Holtz,R,VGK,22,72,12,13,25
81,8481704,Juuso Parssinen,C,NSH,23,55,11,14,25
81,8479316,Luke Kunin,C,SJS,27,60,10,15,25
81,8476889,Radek Faksa,C,STL,30,64,10,15,25
81,8481522,Peyton Krebs,C,BUF,23,61,7,18,25
81,8480878,Nils Lundkvist,D,DAL,24,71,4,21,25
81,8479066,Ryan Lomberg,L,CGY,30,61,17,7,24
81,8478057,Dakota Joshua,C,VAN,28,61,15,9,24
81,8480995,Pontus Holmberg,R,TOR,25,60,14,10,24
81,8481032,Paul Cotter,C,NJD,25,56,13,11,24
81,8477507,Nikita Zadorov,D,BOS,29,64,12,12,24
81,8483457,Lane Hutson,D,MTL,20,64,11,13,24
81,8480035,Henri Jokiharju,D,BUF,25,62,10,14,24
81,8477979,Nicolas Aube-Kubel,R,BUF,28,60,10,14,24
81,8482475,Yegor Chinakhov,R,CBJ,23,59,9,15,24
81,8482062,Cole Smith,L,NSH,29,56,9,15,24
81,8477488,Brett Pesce,D,NJD,30,73,8,16,24
81,8474053,Logan Couture,C,SJS,35,63,7,17,24
81,8480855,Jack McBain,C,UTA,24,67,7,17,24
81,8476422,Mike Reilly,D,NYI,31,73,7,17,24
81,8476429,Scott Mayfield,D,NYI,32,71,7,17,24
81,8474574,Tyler Myers,D,VAN,34,66,4,20,24
81,8482067,Connor Mackey,D,NYR,28,59,4,20,24
81,8481014,Alexander Romanov,D,NYI,24,72,2,22,24
81,8474189,Lars Eller,C,PIT,35,63,13,10,23
81,8481582,Nicholas Robertson,L,TOR,23,66,12,11,23
81,8483524,Shane Wright,C,SEA,20,66,10,13,23
81,8475343,Nic Dowd,C,WSH,34,62,10,13,23
81,8479661,Tanner Jeannot,L,LAK,27,75,9,14,23
81,8478891,Mason Appleton,C,WPG,28,55,8,15,23
81,8480871,Adam Boqvist,D,FLA,24,66,8,15,23
81,8478970,Jalen Chatfield,D,CAR,28,69,8,15,23
81,8473563,Nicklas Backstrom,C,WSH,37,56,6,17,23
81,8475231,Casey Cizikas,C,NYI,33,74,6,17,23
81,8477478,William Carrier,L,CAR,30,49,13,9,22
81,8476960,Andreas Athanasiou,C,CHI,30,51,12,10,22
81,8476925,Colton Sissons,C,NSH,31,66,11,11,22
81,8482157,Will Cuylle,L,NYR,22,71,10,12,22
81,8482679,Matt Coronato,R,CGY,22,62,10,12,22
81,8477989,Christian Dvorak,C,MTL,28,68,8,14,22
81,8479996,Cody Glass,C,NSH,25,57,8,14,22
81,8477508,Curtis Lazar,C,NJD,29,56,7,15,22
81,8481019,David Gustafsson,C,WPG,24,54,6,16,22
81,8483491,Ivan Miroshnichenko,L,WSH,20,62,5,17,22
81,8478508,Yakov Trenin,C,MIN,27,56,12,9,21
81,8480448,Parker Kelly,L,COL,25,76,11,10,21
81,8477903,Garnet Hathaway,R,PHI,33,67,10,11,21
81,8480806,Isac Lundestrom,C,ANA,25,61,10,11,21
81,8478585,Derek Ryan,C,EDM,38,63,9,12,21
81,8481656,Aliaksei Protas,C,WSH,23,59,8,13,21
81,8478136,Jake Middleton,D,MIN,28,79,7,14,21
81,8480144,David Kampf,C,TOR,29,70,6,15,21
81,8482192,Isaak Phillips,D,CHI,23,50,6,15,21
81,8478178,Darren Raddysh,D,TBL,28,75,4,17,21
81,8479402,Jake Bean,D,CGY,26,68,4,17,21
81,8476902,Esa Lindell,D,DAL,30,78,3,18,21
81,8479324,Ryan Lindgren,D,NYR,26,61,3,18,21
81,8475179,Dmitry Kulikov,D,FLA,34,69,3,18,21
81,8476879,Cody Ceci,D,EDM,31,62,1,20,21
81,8478569,Noel Acciari,C,PIT,33,51,13,7,20
81,8478831,Kevin Stenlund,C,UTA,28,54,13,7,20
81,8483493,Frank Nazar,C,CHI,20,57,12,8,20
81,8477450,Jason Dickinson,C,CHI,29,55,11,9,20
81,8475220,Marcus Foligno,L,MIN,33,57,11,9,20
81,8479336,Carl Grundstrom,R,SJS,27,53,11,9,20
81,8475225,Craig Smith,C,CHI,35,55,11,9,20
81,8473453,Trevor Lewis,C,LAK,37,68,10,10,20
81,8480021,Jack Studnicka,C,LAK,25,60,10,10,20
81,8483445,Cutter Gauthier,L,ANA,20,62,7,13,20
81,8477070,Liam O'Brien,C,UTA,30,62,7,13,20
81,8476329,Travis Boyd,C,MIN,31,58,6,14,20
81,8481641,Joel Kiviranta,L,COL,28,74,6,14,20
81,8482101,Danil Gushchin,L,SJS,22,54,6,14,20
81,8479998,Mikey Anderson,D,LAK,25,62,6,14,20
81,8479291,Kevin Rooney,C,CGY,31,47,6,14,20
81,8476312,Josh Manson,D,COL,33,69,5,15,20
81,8479372,Joshua Mahura,D,SEA,26,62,5,15,20
81,8478851,Alexandre Carrier,D,NSH,28,59,3,17,20
81,8473507,Jeff Petry,D,DET,37,77,3,17,20
81,8476331,Dylan DeMelo,D,WPG,31,73,3,17,20
81,8478399,Jonas Siegenthaler,D,NJD,27,57,2,18,20
81,8479371,Dante Fabbro,D,NSH,26,68,1,19,20
81,8475842,Sam Carrick,C,NYR,32,51,15,4,19
81,8479293,Brandon Tanev,L,SEA,33,63,12,7,19
81,8479941,Justin Danforth,R,CBJ,31,56,10,9,19
81,8479315,Joey Anderson,R,CHI,26,49,9,10,19
81,8481093,Rafael Harvey-Pinard,L,MTL,25,60,8,11,19
81,8482737,Zack Bolduc,C,STL,21,56,8,11,19
81,8483565,Nick Blankenburg,D,NSH,26,64,7,12,19
81,8476931,Jake McCabe,D,TOR,31,59,6,13,19
81,8475855,Jesper Fast,R,CAR,33,59,6,13,19
81,8477406,Mattias Janmark,C,EDM,32,67,6,13,19
81,8479026,Philippe Myers,D,TOR,27,57,6,13,19
81,8482964,Arber Xhekaj,D,MTL,23,48,5,14,19
81,8476891,Matthew Grzelcyk,D,PIT,30,76,4,15,19
81,8477845,Trevor van Riemsdyk,D,WSH,33,56,3,16,19
81,8479398,Samuel Girard,D,COL,26,56,2,17,19
81,8475233,David Savard,D,MTL,34,66,2,17,19
81,8475462,Radko Gudas,D,ANA,34,65,1,18,19
81,8476457,Adam Larsson,D,SEA,32,67,0,19,19
81,8477435,Ryan Graves,D,PIT,29,72,0,19,19
81,8477446,Michael McCarron,R,NSH,29,55,12,6,18
81,8477392,Hudson Fasching,R,NYI,29,65,8,10,18
81,8476873,Mark Jankowski,C,NSH,30,51,8,10,18
81,8483482,Tristan Luneau,D,ANA,20,66,8,10,18
81,8478432,Christian Fischer,R,DET,27,73,6,12,18
81,8481521,Ronnie Attard,D,PHI,25,52,6,12,18
81,8480789,Oliver Wahlstrom,R,NYI,24,65,6,12,18
81,8476988,Matt Benning,D,SJS,30,65,5,13,18
81,8481568,Alex Vlasic,D,CHI,23,47,3,15,18
81,8481441,Joe Snively,C,DET,28,67,2,16,18
81,8478840,Will Borgen,D,SEA,28,67,1,17,18
81,8480281,Alexey Toropchenko,R,STL,25,58,11,6,17
81,8480205,Emil Bemstrom,C,PIT,25,59,10,7,17
81,8479439,Jacob MacDonald,D,COL,31,53,10,7,17
81,8479368,Max Jones,L,BOS,26,66,9,8,17
81,8482807,Ethan Del Mastro,D,CHI,21,56,8,9,17
81,8482111,Justin Barron,D,MTL,23,61,7,10,17
81,8481013,Jonatan Berggren,R,DET,24,59,7,10,17
81,8478451,Ethan Bear,D,WSH,27,56,7,10,17
81,8482809,Jackson Blake,R,CAR,21,60,6,11,17
81,8474034,Patrick Maroon,L,CHI,36,51,5,12,17
81,8475279,Ben Chiarot,D,DET,33,67,5,12,17
81,8479976,Juuso Valimaki,D,UTA,26,61,4,13,17
81,8481751,Lukas Rousek,R,BUF,25,36,4,13,17
81,8476856,Mathew Dumba,D,DAL,30,68,4,13,17
81,8480073,Erik Brannstrom,D,COL,25,55,3,14,17
81,8470600,Ryan Suter,D,STL,39,59,3,14,17
81,8475790,Erik Gudbranson,D,CBJ,32,72,2,15,17
81,8481178,Egor Zamula,D,PHI,24,48,2,15,17
81,8481708,Zac Jones,D,NYR,24,48,2,15,17
81,8482087,Kaiden Guhle,D,MTL,22,66,2,15,17
81,8475181,Nick Leddy,D,STL,33,67,1,16,17
81,8475690,Chris Tanev,D,TOR,35,54,1,16,17
81,8481601,Simon Holmstrom,R,NYI,23,64,11,5,16
81,8476822,Luke Glendening,C,TBL,35,77,10,6,16
81,8479370,Tyson Jost,C,CAR,26,53,8,8,16
81,8479619,Michael Carcone,L,UTA,28,65,8,8,16
81,8476624,Barclay Goodrow,C,SJS,31,48,7,9,16
81,8478452,Caleb Jones,D,LAK,27,54,6,10,16
81,8481481,Blake Lizotte,C,PIT,27,61,6,10,16
81,8477369,Carson Soucy,D,VAN,30,55,6,10,16
81,8480980,Connor Dewar,C,TOR,25,63,5,11,16
81,8477015,Connor Brown,R,EDM,30,58,5,11,16
81,8480192,Johnathan Kovacevic,D,NJD,27,52,5,11,16
81,8482245,Artem Zub,D,OTT,29,74,4,12,16
81,8482496,Nils Aman,C,VAN,24,47,4,12,16
81,8482451,Mikael Pyyhtia,L,CBJ,23,43,4,12,16
81,8475208,Brian Dumoulin,D,ANA,33,65,4,12,16
81,8482073,Braden Schneider,D,NYR,23,70,4,12,16
81,8475324,Nick Jensen,D,OTT,34,63,3,13,16
81,8480246,Nick Perbix,D,TBL,26,71,3,13,16
81,8479369,Andrew Peeke,D,BOS,26,60,2,14,16
81,8474673,TJ Brodie,D,CHI,34,65,1,15,16
81,8478416,Erik Cernak,D,TBL,27,69,1,15,16
81,8482659,Josh Doan,R,UTA,22,47,7,8,15
81,8478043,Sam Lafferty,C,BUF,29,63,6,9,15
81,8476467,Jamie Oleksiak,D,SEA,32,63,5,10,15
81,8481028,Martin Pospisil,C,CGY,25,56,5,10,15
81,8480807,Mattias Samuelsson,D,BUF,24,51,4,11,15
81,8480796,Martin Fehervary,D,WSH,25,52,4,11,15
81,8478882,Vladislav Gavrikov,D,LAK,29,72,3,12,15
81,8479980,Nicolas Hague,D,VGK,26,53,3,12,15
81,8476525,Colin Miller,D,WPG,32,58,2,13,15
81,8480222,Sebastian Aho,D,PIT,28,73,1,14,15
81,8479414,Nathan Bastian,R,NJD,27,58,10,4,14
81,8481716,Dmitri Voronkov,L,CBJ,24,44,9,5,14
81,8484149,Gavin Brindley,C,CBJ,20,54,8,6,14
81,8480355,Mark Kastelic,C,BOS,25,63,8,6,14
81,8476858,Phillip Di Giuseppe,L,VAN,31,41,7,7,14
81,8479543,Michael Pezzetta,L,MTL,26,63,7,7,14
81,8476994,Vinnie Hinostroza,C,NSH,30,53,6,8,14
81,8482859,Zack Ostapchuk,C,OTT,21,55,6,8,14
81,8480025,MacKenzie Entwistle,R,FLA,25,67,6,8,14
81,8480007,Jonas Rondbjerg,R,VGK,25,42,6,8,14
81,8482634,Alex Steeves,C,TOR,25,52,5,9,14
81,8478443,Brandon Carlo,D,BOS,28,58,5,9,14
81,8483495,Simon Nemec,D,NJD,20,56,4,10,14
81,8476967,Brett Kulak,D,EDM,30,58,4,10,14
81,8476952,Dominic Toninato,C,WPG,30,40,4,10,14
81,8479983,Mario Ferraro,D,SJS,26,71,3,11,14
81,8481537,Nikita Okhotiuk,D,CGY,24,57,3,11,14
81,8477851,Jordan Oesterle,D,BOS,32,40,3,11,14
81,8474166,Alec Martinez,D,CHI,37,48,2,12,14
81,8480860,Kevin Bahl,D,CGY,24,58,2,12,14
81,8475188,Brayden McNabb,D,VGK,33,52,1,13,14
81,8480001,Urho Vaakanainen,D,ANA,25,56,1,13,14
81,8473446,Erik Johnson,D,PHI,36,42,1,13,14
81,8480289,Morgan Barron,C,WPG,26,48,9,4,13
81,8482155,Alex Laferriere,R,LAK,23,63,8,5,13
81,8482148,Hendrix Lapierre,C,WSH,22,54,7,6,13
81,8479520,Brandon Duhaime,R,WSH,27,54,7,6,13
81,8480848,Ty Dellandrea,C,SJS,24,52,6,7,13
81,8482176,Wyatt Kaiser,D,CHI,22,51,6,7,13
81,8481518,Nolan Foote,L,NJD,24,41,6,7,13
81,8482803,Olen Zellweger,D,ANA,21,64,5,8,13
81,8482095,Tyler Kleven,D,OTT,22,48,5,8,13
81,8480157,Calle Rosen,D,COL,30,46,5,8,13
81,8481517,Brett Leason,R,ANA,25,57,4,9,13
81,8477380,Jonny Brodzinski,C,NYR,31,50,4,9,13
81,8481059,Scott Perunovich,D,STL,26,55,3,10,13
81,8477365,Connor Clifton,D,BUF,29,58,3,10,13
81,8478859,Niko Mikkola,D,FLA,28,57,2,11,13
81,8480844,Grigori Denisenko,L,VGK,24,32,6,6,12
81,8479359,Beck Malenstyn,L,BUF,26,51,5,7,12
81,8477018,Ben Hutton,D,VGK,31,44,4,8,12
81,8479536,Axel Jonsson-Fjallby,L,WPG,26,40,4,8,12
81,8471709,Marc-Edouard Vlasic,D,SJS,37,56,3,9,12
81,8480172,Jan Rutta,D,SJS,34,63,3,9,12
81,8479344,Jesse Puljujarvi,R,PIT,26,47,3,9,12
81,8479986,Kole Lind,R,DAL,26,40,3,9,12
81,8480070,Ian Mitchell,D,BOS,25,48,3,9,12
81,8480887,Jordan Harris,D,MTL,24,62,2,10,12
81,8478468,Jeremy Lauzon,D,NSH,27,53,2,10,12
81,8479348,Kale Clague,D,BUF,26,40,2,10,12
81,8478434,Keegan Kolesar,R,VGK,27,62,2,10,12
81,8483460,David Jiricek,D,CBJ,21,50,1,11,12
81,8480950,Ilya Lyubushkin,D,DAL,30,66,0,12,12
81,8483570,Ben Meyers,C,SEA,26,31,9,2,11
81,8471817,Ryan Reaves,R,TOR,37,50,7,4,11
81,8479671,Mathieu Olivier,R,CBJ,27,44,7,4,11
81,8481550,Adam Beckman,L,NJD,23,38,6,5,11
81,8479772,Zack MacEwen,R,OTT,28,51,6,5,11
81,8475235,Nicolas Deslauriers,L,PHI,33,52,6,5,11
81,8481161,Jake Christiansen,D,CBJ,25,58,5,6,11
81,8480011,Klim Kostin,C,SJS,25,52,5,6,11
81,8480880,Jakub Lauko,C,MIN,24,37,5,6,11
81,8480074,Alexandre Texier,C,STL,25,51,4,7,11
81,8478421,A.J. Greer,L,FLA,28,63,4,7,11
81,8477482,Zachary Sanford,L,CHI,30,39,4,7,11
81,8477938,Haydn Fleury,D,WPG,28,41,3,8,11
81,8482730,Brandt Clarke,D,LAK,21,47,3,8,11
81,8480834,Ty Emberson,D,SJS,24,38,3,8,11
81,8480058,Pierre-Olivier Joseph,D,STL,25,54,2,9,11
81,8480879,Jacob Bernard-Docker,D,OTT,24,46,1,10,11
81,8478454,Noah Juulsen,D,VAN,27,41,1,10,11
81,8483763,Maksymilian Szuber,D,UTA,22,39,0,11,11
81,8479968,Vinni Lettieri,C,BOS,29,49,6,4,10
81,8482784,Zach Dean,C,STL,21,51,5,5,10
81,8481754,Nikita Nesterenko,C,ANA,23,43,5,5,10
81,8476867,Brendan Gaunce,C,MIN,30,39,5,5,10
81,8480441,Trey Fix-Wolansky,R,CBJ,25,42,5,5,10
81,8483499,Liam Ohgren,L,MIN,20,51,4,6,10
81,8481617,Vasily Podkolzin,R,VAN,23,47,4,6,10
81,8480990,Declan Chisholm,D,MIN,24,44,4,6,10
81,8481527,Kaedan Korczak,D,VGK,23,50,3,7,10
81,8479718,Alex Barré-Boulet,C,MTL,27,48,3,7,10
81,8477962,Brendan Lemieux,L,CAR,28,47,3,7,10
81,8477931,Tomas Nosek,L,FLA,32,60,1,9,10
81,8471677,Jack Johnson,D,CBJ,37,67,1,9,10
81,8477034,Jaycob Megna,D,FLA,32,49,1,9,10
81,8479442,Troy Stecher,D,EDM,30,52,1,9,10
81,8476374,Sean Kuraly,C,CBJ,31,61,6,3,9
81,8477573,Nathan Walker,L,STL,30,48,6,3,9
81,8482077,Dylan Holloway,L,EDM,23,53,6,3,9
81,8476934,Brock McGinn,L,ANA,30,47,5,4,9
81,8478424,Jansen Harkins,C,ANA,27,51,5,4,9
81,8484911,Collin Graf,R,SJS,22,38,5,4,9
81,8482145,Mavrik Bourque,C,DAL,22,57,5,4,9
81,8479981,Jonah Gadjovich,L,FLA,26,39,4,5,9
81,8481532,Alex Turcotte,C,LAK,23,44,4,5,9
81,8474568,Luke Schenn,D,NSH,35,55,4,5,9
81,8479378,Logan Stanley,D,WPG,26,41,4,5,9
81,8479944,Zach Aston-Reese,C,VGK,30,41,4,5,9
81,8482511,Mason Lohrei,D,BOS,23,44,4,5,9
81,8477887,Patrick Brown,C,BOS,32,44,3,6,9
81,8480252,Cole Guttman,C,CHI,25,33,3,6,9
81,8474013,Ian Cole,D,UTA,35,51,3,6,9
81,8479249,Andrew Poturalski,C,SJS,30,31,2,7,9
81,8481609,Vladislav Kolyachonok,D,UTA,23,31,1,8,9
81,8481056,Spencer Stastney,D,NSH,24,37,1,8,9
81,8480727,Zach Whitecloud,D,VGK,28,52,0,9,9
81,8475750,Jon Merrill,D,MIN,32,57,0,9,9
81,8479638,Justin Brazeau,R,BOS,26,41,7,1,8
81,8482747,Brennan Othmann,L,NYR,21,44,7,1,8
81,8481422,Jake Lucchini,C,NSH,29,23,7,1,8
81,8479328,Julien Gauthier,R,NYI,27,54,6,2,8
81,8482153,Brendan Brisson,C,VGK,23,36,5,3,8
81,8481599,Victor Soderstrom,D,UTA,23,45,4,4,8
81,8483466,Kevin Korchinski,D,CHI,20,45,4,4,8
81,8478409,Anthony Richard,C,PHI,28,29,4,4,8
81,8482652,Walker Duehr,R,CGY,27,42,4,4,8
81,8481477,Nico Sturm,C,SJS,29,54,3,5,8
81,8478017,Mark Friedman,D,VAN,29,40,3,5,8
81,8476874,Olli Maatta,D,DET,30,63,3,5,8
81,8482166,Shakir Mukhamadullin,D,SJS,22,51,3,5,8
81,8481701,Santeri Hatakka,D,NJD,23,36,2,6,8
81,8475177,Calvin de Haan,D,COL,33,46,2,6,8
81,8474612,Travis Hamonic,D,OTT,34,43,2,6,8
81,8476473,Connor Murphy,D,CHI,31,41,2,6,8
81,8482751,Ryan Winterton,C,SEA,21,32,2,6,8
81,8481567,Henry Thrun,D,SJS,23,48,1,7,8
81,8481598,Philip Broberg,D,EDM,23,44,1,7,8
81,8475455,Brenden Dillon,D,NJD,34,56,1,7,8
81,8477335,Kyle Burroughs,D,LAK,29,45,1,7,8
81,8477384,Joshua Brown,D,EDM,30,48,1,7,8
81,8481605,Jackson LaCombe,D,ANA,23,30,1,7,8
81,8474567,Zach Bogosian,D,MIN,34,56,0,8,8
81,8484254,Akito Hirose,D,VAN,25,44,0,8,8
81,8482762,Simon Edvinsson,D,DET,21,55,5,2,7
81,8479994,Jaret Anderson-Dolan,C,WPG,25,33,4,3,7
81,8483630,Pavol Regenda,L,ANA,25,23,4,3,7
81,8483468,Jiri Kulich,C,BUF,20,48,3,4,7
81,8482744,James Malatesta,L,CBJ,21,50,3,4,7
81,8481600,Tobias Bjornfot,D,FLA,23,40,3,4,7
81,8483397,Marc McLaughlin,C,BOS,25,32,3,4,7
81,8479379,Givani Smith,R,SJS,26,42,3,4,7
81,8483549,Lucas Condotta,L,MTL,27,31,3,4,7
81,8481147,Reese Johnson,C,MIN,26,36,3,4,7
81,8482858,Ryker Evans,D,SEA,23,25,3,4,7
81,8476442,Matt Nieto,L,PIT,32,35,2,5,7
81,8474090,Brendan Smith,D,DAL,35,55,2,5,7
81,8481592,Jakob Pelletier,L,CGY,23,43,2,5,7
81,8482733,Logan Mailloux,D,MTL,31,32,2,5,7
81,8478211,Dryden Hunt,L,CGY,29,55,1,6,7
81,8480845,Rasmus Kupari,C,WPG,24,33,1,6,7
81,8482765,Isak Rosen,R,BUF,21,30,1,6,7
81,8477810,Joel Hanley,D,CGY,33,27,1,6,7
81,8475718,Justin Holl,D,DET,32,56,0,7,7
81,8477320,Anton Blidh,L,NYR,29,18,0,7,7
81,8477401,John Hayden,C,SEA,29,28,3,3,6
81,8480870,Bo Groulx,C,NYR,24,34,3,3,6
81,8482666,Scott Morrow,D,CAR,22,48,2,4,6
81,8481167,Brayden Pachal,D,CGY,25,32,2,4,6
81,8481789,Tye Kartye,L,SEA,23,36,2,4,6
81,8475762,Derek Forbort,D,VAN,32,41,1,5,6
81,8475958,Michael Sgarbossa,C,WSH,32,26,1,5,6
81,8478146,Matthew Highmore,C,OTT,28,35,1,5,6
81,8481543,Nikita Alexandrov,C,STL,24,26,1,5,6
81,8482141,Lukas Cormier,D,VGK,22,20,3,2,5
81,8477473,Justin Bailey,R,SJS,29,22,3,2,5
81,8481237,Kyle MacLean,C,NYI,25,25,2,3,5
81,8479972,Mason Shaw,C,WPG,26,36,1,4,5
81,8481556,John Beecher,C,BOS,23,38,1,4,5
81,8483512,Matthew Savoie,C,EDM,20,25,1,4,5
81,8477244,Chad Ruhwedel,D,NYR,34,30,1,4,5
81,8482144,Jack Thompson,D,SJS,22,30,1,4,5
81,8481541,Samuel Bolduc,D,NYI,24,34,1,4,5
81,8478450,Parker Wotherspoon,D,BOS,27,29,0,5,5
81,8481122,Simon Benoit,D,TOR,26,35,0,5,5
81,8478874,Adam Gaudette,R,OTT,28,42,0,5,5
81,8479985,Cale Fleury,D,SEA,26,30,3,1,4
81,8478881,Brett Seney,L,CHI,28,9,3,1,4
81,8477527,Ross Johnston,L,ANA,30,34,2,2,4
81,8480468,James Hamblin,L,EDM,25,23,2,2,4
81,8476913,Devin Shore,C,MIN,30,30,2,2,4
81,8477462,Robert Hagg,D,VGK,29,26,2,2,4
81,8482102,Vasily Ponomarev,C,PIT,22,18,2,2,4
81,8475413,Justin Dowling,C,NJD,34,19,2,2,4
81,8481585,Egor Afanasyev,L,SJS,23,18,2,2,4
81,8482713,Mackie Samoskevich,R,FLA,22,37,1,3,4
81,8480245,Olle Lycksell,R,PHI,25,26,1,3,4
81,8483619,Filip Roos,D,OTT,25,35,1,3,4
81,8479576,Vincent Desharnais,D,VAN,28,38,1,3,4
81,8476372,Nick Seeler,D,PHI,31,38,1,3,4
81,8482929,Emil Lilleberg,D,TBL,23,24,1,3,4
81,8479587,Rhett Gardner,C,PHI,28,20,0,4,4
81,8481593,Jayden Struble,D,MTL,23,18,0,4,4
81,8481564,Ryan Johnson,D,BUF,23,11,0,4,4
81,8484287,Cole McWard,D,VAN,23,18,3,0,3
81,8482172,Landon Slaggert,L,CHI,22,32,3,0,3
81,8484258,Sam Malinski,D,COL,26,23,3,0,3
81,8481679,Maxence Guenette,D,OTT,23,31,2,1,3
81,8480267,Sammy Walker,C,MIN,25,17,2,1,3
81,8481719,Maxwell Crozier,D,TBL,24,18,2,1,3
81,8479419,Brett Murray,L,BUF,26,21,2,1,3
81,8482460,Matt Rempe,C,NYR,22,12,2,1,3
81,8481065,Angus Crookshank,L,OTT,25,14,2,1,3
81,8476441,Joel Edmundson,D,LAK,31,41,1,2,3
81,8480890,Jan Jenik,C,OTT,24,24,1,2,3
81,8479367,William Lockwood,R,FLA,26,22,1,2,3
81,8482470,Ilya Solovyov,D,CGY,24,24,1,2,3
81,8482118,Sam Colangelo,R,ANA,23,15,1,2,3
81,8478021,William Lagesson,D,DET,28,24,0,3,3
81,8480196,Jacob Bryson,D,BUF,27,39,0,3,3
81,8482177,Marat Khusnutdinov,C,MIN,22,34,0,3,3
81,8483012,Logan Morrison,C,SEA,22,40,0,3,3
81,8481743,Marc Del Gaizo,D,NSH,25,17,0,3,3
81,8478051,Max Willman,C,NJD,29,14,0,3,3
81,8475795,Dylan McIlrath,D,WSH,32,15,0,3,3
81,8478502,Dennis Gilbert,D,BUF,28,22,0,3,3
81,8478477,Mitchell Stephens,C,SEA,27,19,0,3,3
81,8481030,Jack St. Ivany,D,PIT,25,15,0,3,3
81,8481462,Mason Morelli,L,VGK,28,9,2,0,2
81,8480851,Akil Thomas,C,LAK,24,22,2,0,2
81,8481024,Linus Karlsson,C,VAN,25,6,2,0,2
81,8483471,Brad Lambert,C,WPG,31,8,2,0,2
81,8475780,Chris Wagner,R,COL,33,8,2,0,2
81,8480292,Carson Meyer,R,ANA,27,31,1,1,2
81,8482516,Matthew Kessel,D,STL,24,13,1,1,2
81,8482061,Brandon Biro,L,SEA,26,9,1,1,2
81,8481806,Louis Crevier,D,CHI,23,15,1,1,2
81,8477149,Scott Sabourin,R,SJS,32,15,1,1,2
81,8480084,Nick DeSimone,D,NJD,30,17,1,1,2
81,8483597,Milos Kelemen,L,UTA,25,15,1,1,2
81,8482250,Callahan Burke,C,VGK,27,18,0,2,2
81,8484325,Waltteri Merela,C,TBL,26,24,0,2,2
81,8482861,Vincent Iorio,D,WSH,22,24,0,2,2
81,8479991,Jake Leschyshyn,C,NYR,25,30,0,2,2
81,8477073,Kurtis MacDermid,L,NJD,30,30,0,2,2
81,8477467,Gustav Olofsson,D,SEA,30,17,0,2,2
81,8482201,Gage Goncalves,C,TBL,23,28,0,2,2
81,8474062,Riley Nash,C,NYR,35,18,0,2,2
81,8483546,Marshall Rifai,D,TOR,26,6,0,2,2
81,8477971,Andreas Englund,D,LAK,28,23,0,2,2
81,8483407,Brandon Scanlin,D,NYR,25,6,0,2,2
81,8482070,Mitchell Chaffee,R,TBL,26,41,1,0,1
81,8479362,Riley Tufte,L,BOS,26,15,1,0,1
81,8482088,Justin Sourdif,R,FLA,22,14,1,0,1
81,8482147,Jean-Luc Foudy,C,COL,22,17,1,0,1
81,8478446,Glenn Gawdin,C,LAK,27,10,1,0,1
81,8481206,John Ludvig,D,PIT,24,13,1,0,1
81,8480874,Adam Ginning,D,PHI,24,14,1,0,1
81,8481006,Tyler Tucker,D,STL,24,16,1,0,1
81,8478011,Louie Belpedio,D,PHI,28,17,1,0,1
81,8483401,Marc Johnstone,R,PIT,28,2,1,0,1
81,8481043,Cole Koepke,L,BOS,26,11,0,1,1
81,8483489,Fraser Minten,C,TOR,31,9,0,1,1
81,8482197,Adam Raska,R,MIN,23,8,0,1,1
81,8482165,Yan Kuznetsov,D,CGY,22,17,0,1,1
81,8482094,Daemon Hunt,D,MIN,22,13,0,1,1
81,8478854,Ryan Shea,D,PIT,27,6,0,1,1
81,8480823,Alexander Alexeyev,D,WSH,25,8,0,1,1
81,8482476,Emil Heineman,L,MTL,23,12,0,1,1
81,8480306,Grant Hutton,D,NYI,29,8,0,1,1
81,8484326,Patrik Koch,D,UTA,28,2,0,1,1
81,8481699,Aku Raty,R,UTA,23,11,0,0,0
81,8479522,Hardy Haman Aktell,D,WSH,26,2,0,0,0
81,8482162,Roby Jarventie,L,EDM,22,8,0,0,0
81,8479320,Maxime Lajoie,D,SEA,27,21,0,0,0
81,8480032,Shane Bowers,C,NJD,25,19,0,0,0
81,8481578,Graeme Clarke,R,MIN,23,10,0,0,0
81,8483395,Arshdeep Bains,L,VAN,23,10,0,0,0
81,8483398,Declan Carlile,D,TBL,31,3,0,0,0
81,8478147,Bokondji Imama,L,PIT,28,10,0,0,0
81,8483531,Brian Halonen,L,NJD,25,5,0,0,0
81,8482787,Nikita Chibrikov,R,WPG,31,4,0,0,0
81,8475755,Alexander Petrovic,D,DAL,32,3,0,0,0
81,8477541,Dakota Mermis,D,TOR,30,14,0,0,0
81,8479330,Brandon Gignac,C,MTL,27,6,0,0,0
81,8479421,Jacob Moverare,D,LAK,26,7,0,0,0
81,8483609,Adam Klapka,R,CGY,24,5,0,0,0
81,8482126,Emil Andrae,D,PHI,31,1,0,0,0
81,8484321,Nikolas Matinpalo,D,OTT,26,2,0,0,0
81,8480075,Cameron Crotty,D,MIN,25,13,0,0,0
81,8483567,Georgii Merkulov,C,BOS,24,6,0,0,0
81,8483432,Luca Del Bel Belluz,C,CBJ,31,4,0,0,0
81,8478956,Samuel Laberge,L,NJD,27,2,0,0,0
81,8484304,Uvis Balinskis,D,FLA,28,6,0,0,0
81,8483920,Pierrick Dube,R,WSH,23,4,0,0,0
81,8477993,Justin Kirkland,C,CGY,28,7,0,0,0
81,8476323,Max McCormick,L,SEA,32,4,0,0,0
81,8481726,Adam Edstrom,C,NYR,24,6,0,0,0
81,8481655,Cole Schwindt,R,CGY,23,5,0,0,0
81,8480274,Philip Kemp,D,EDM,25,2,0,0,0
81,8484255,Jason Polin,R,COL,25,5,0,0,0
81,8481534,Raphael Lavoie,C,EDM,24,3,0,0,0
81,8484259,Ondrej Pavel,C,COL,31,5,0,0,0
81,8470794,Joe Pavelski,C,,40,0,0,0,0
81,8479321,Lucas Johansen,D,,27,0,0,0,0
81,8477950,Tony DeAngelo,D,,29,0,0,0,0
81,8471218,Blake Wheeler,R,,38,0,0,0,0
81,8475197,Tyson Barrie,D,,33,0,0,0,0
81,8474157,Max Pacioretty,L,,36,0,0,0,0
81,8475744,Evgeny Kuznetsov,C,,32,0,0,0,0
81,8474037,James van Riemsdyk,L,,35,0,0,0,0
81,8476907,Mackenzie MacEachern,L,,30,0,0,0,0
81,8480216,Jacob Peterson,C,,25,0,0,0,0
81,8474602,Justin Schultz,D,,34,0,0,0,0
81,8482222,Alexander Barabanov,L,,30,0,0,0,0
81,8474031,Kevin Shattenkirk,D,,35,0,0,0,0
81,8477330,Dominik Kubalik,L,,29,0,0,0,0
81,8480884,Calen Addison,D,,24,0,0,0,0
81,8475906,John Klingberg,D,,32,0,0,0,0
81,8480008,Adam Ruzicka,C,,25,0,0,0,0
81,8476884,Derrick Pouliot,D,,30,0,0,0,0
81,8476919,Chris Tierney,C,,30,0,0,0,0
81,8479415,Michael McLeod,C,,26,0,0,0,0
81,8474870,Tyler Johnson,C,,34,0,0,0,0
81,8470604,Jeff Carter,C,,39,0,0,0,0
81,8478104,Sammy Blais,L,,28,0,0,0,0
81,8474884,Mike Hoffman,C,,35,0,0,0,0
81,8481591,Sam Poulin,R,,23,0,0,0,0
81,8471274,Alex Goligoski,D,,39,0,0,0,0
81,8476871,Tanner Pearson,L,,32,0,0,0,0
81,8476393,Nick Cousins,C,,31,0,0,0,0
81,8479977,Kailer Yamamoto,R,,26,0,0,0,0
81,8479346,Dillon Dube,C,,26,0,0,0,0
81,8480184,Gustav Lindstrom,D,,26,0,0,0,0
81,8479376,Victor Mete,D,,26,0,0,0,0
81,8473449,Kyle Okposo,R,,36,0,0,0,0
81,8481058,Jesse Ylonen,R,,25,0,0,0,0
81,8475752,Tyler Pitlick,C,,33,0,0,0,0
81,8481239,Samuel Fagemo,L,,24,0,0,0,0
81,8480821,Filip Zadina,R,,25,0,0,0,0
81,8470966,Mark Giordano,D,,41,0,0,0,0
81,8478495,Denis Gurianov,R,,27,0,0,0,0
81,8477464,Nic Petan,C,,29,0,0,0,0
81,8478099,Kevin Labanc,R,,29,0,0,0,0
81,8482241,Radim Zohorna,L,,28,0,0,0,0
81,8474040,Sam Gagner,C,,35,0,0,0,0
81,8479514,Rem Pitlick,C,,27,0,0,0,0
81,8478430,Oliver Kylington,D,,27,0,0,0,0
81,8479533,Joona Koppanen,L,,26,0,0,0,0
81,8479984,Cal Foote,D,,26,0,0,0,0
81,8477126,Jayson Megna,C,,34,0,0,0,0
81,8475164,Jakob Silfverberg,R,,34,0,0,0,0
81,8474009,Nick Bonino,C,,36,0,0,0,0
81,8479458,Nikita Zaitsev,D,,33,0,0,0,0
81,8477944,Jakub Vrana,L,,28,0,0,0,0
81,8471699,Andrew Cogliano,C,,37,0,0,0,0
81,8478067,Oskar Lindblom,L,,28,0,0,0,0
81,8471686,Marc Staal,D,,37,0,0,0,0
81,8470610,Zach Parise,L,,40,0,0,0,0
81,8478904,Steven Lorentz,C,,28,0,0,0,0
81,8473473,Milan Lucic,L,,36,0,0,0,0
81,8480031,Maxime Comtois,L,,25,0,0,0,0
81,8478512,Austin Czarnik,C,,32,0,0,0,0
81,8473504,Cal Clutterbuck,R,,37,0,0,0,0
81,8477454,Adam Erne,L,,29,0,0,0,0
81,8479383,Boris Katchouk,L,,26,0,0,0,0
81,8475825,Jani Hakanpää,D,,32,0,0,0,0
81,8477846,Ryan Carpenter,C,,33,0,0,0,0
81,8477930,Pierre-Edouard Bellemare,L,,39,0,0,0,0
81,8478400,Colin White,C,,27,0,0,0,0
81,8480226,Marián Studenic,R,,26,0,0,0,0
81,8480853,Liam Foudy,C,,24,0,0,0,0
81,8475797,Jarred Tinordi,D,,32,0,0,0,0
81,8479423,Alex Nylander,L,,26,0,0,0,0
81,8474618,Marco Scandella,D,,34,0,0,0,0
81,8478028,Fredrik Olofsson,L,,28,0,0,0,0
81,8474709,Matt Martin,L,,35,0,0,0,0
81,8481070,Hugh McGing,L,,26,0,0,0,0
81,8479546,Oskar Steen,C,,26,0,0,0,0
81,8474145,Robert Bortuzzo,D,,35,0,0,0,0
81,8476915,Jujhar Khaira,L,,30,0,0,0,0
81,8475278,Byron Froese,C,,33,0,0,0,0
81,8481812,Nikolai Knyzhov,D,,27,0,0,0,0
81,8478408,Travis Dermott,D,,28,0,0,0,0
81,8481077,John Leonard,L,,26,0,0,0,0
81,8479547,Matthew Phillips,R,,26,0,0,0,0
81,8480836,Jonathan Gruden,C,,24,0,0,0,0
81,8481690,Tyler Angle,C,,24,0,0,0,0
81,8475766,Austin Watson,L,,32,0,0,0,0
81,8481016,Ruslan Iskhakov,C,,24,0,0,0,0
81,8478078,Rourke Chartier,C,,28,0,0,0,0
81,8480776,Sheldon Rempal,R,,29,0,0,0,0
81,8483045,Cameron Butler,R,CBJ,31,1,0,0,0
81,8484314,Jiri Smejkal,L,,28,0,0,0,0
82,8477492,Nathan MacKinnon,C,COL,29,82,59,93,152
82,8478402,Connor McDavid,C,EDM,27,80,46,97,143
82,8476453,Nikita Kucherov,R,TBL,31,82,45,82,127
82,8477493,Aleksander Barkov,C,FLA,29,81,36,75,111
82,8476887,Filip Forsberg,L,NSH,30,77,45,65,110
82,8479314,Matthew Tkachuk,L,FLA,27,77,31,79,110
82,8481559,Jack Hughes,C,NJD,23,77,41,65,106
82,8477939,William Nylander,R,TOR,28,80,40,66,106
82,8477956,David Pastrnak,R,BOS,28,79,50,55,105
82,8478550,Artemi Panarin,L,NYR,33,79,41,64,105
82,8479318,Auston Matthews,C,TOR,27,79,61,43,104
82,8478864,Kirill Kaprizov,L,MIN,27,71,56,47,103
82,8480012,Elias Pettersson,C,VAN,26,79,42,61,103
82,8476468,J.T. Miller,C,VAN,31,79,36,67,103
82,8478445,Mathew Barzal,C,NYI,27,81,31,72,103
82,8479407,Jesper Bratt,L,NJD,26,74,38,62,100
82,8477934,Leon Draisaitl,C,EDM,29,79,36,63,99
82,8478420,Mikko Rantanen,R,COL,28,81,44,53,97
82,8477942,Kevin Fiala,L,LAK,28,80,35,62,97
82,8478398,Kyle Connor,L,WPG,28,70,42,53,95
82,8482116,Tim Stützle,C,OTT,22,76,37,58,95
82,8478483,Mitch Marner,R,TOR,27,77,31,64,95
82,8481557,Matt Boldy,L,MIN,23,77,38,55,93
82,8477946,Dylan Larkin,C,DET,28,82,39,52,91
82,8477404,Jake Guentzel,C,TBL,30,82,41,48,89
82,8484144,Connor Bedard,C,CHI,19,75,32,57,89
82,8480023,Robert Thomas,C,STL,25,75,27,61,88
82,8479323,Adam Fox,D,NYR,26,77,19,69,88
82,8479385,Jordan Kyrou,C,STL,26,77,43,44,87
82,8480801,Brady Tkachuk,L,OTT,25,80,28,59,87
82,8475167,Victor Hedman,D,TBL,34,82,16,71,87
82,8480800,Quinn Hughes,D,VAN,25,76,11,76,87
82,8474564,Steven Stamkos,C,NSH,34,75,38,48,86
82,8478010,Brayden Point,C,TBL,28,82,34,51,85
82,8476456,Jonathan Huberdeau,C,CGY,31,76,25,60,85
82,8480069,Cale Makar,D,COL,26,72,19,65,84
82,8471675,Sidney Crosby,C,PIT,37,73,32,51,83
82,8480027,Jason Robertson,L,DAL,25,82,32,51,83
82,8477933,Sam Reinhart,C,FLA,29,79,41,41,82
82,8480002,Nico Hischier,C,NJD,25,71,23,59,82
82,8480865,Noah Dobson,D,NYI,24,81,13,69,82
82,8477501,Valeri Nichushkin,R,COL,29,81,47,34,81
82,8475166,John Tavares,C,TOR,34,78,29,52,81
82,8479343,Clayton Keller,R,UTA,26,72,34,46,80
82,8476346,Johnny Gaudreau,L,CBJ,31,69,24,55,79
82,8477940,Nikolaj Ehlers,L,WPG,28,73,29,49,78
82,8477409,Carter Verhaeghe,C,FLA,29,80,42,35,77
82,8478427,Sebastian Aho,C,CAR,27,76,28,49,77
82,8478439,Travis Konecny,R,PHI,27,73,26,51,77
82,8471214,Alex Ovechkin,L,WSH,39,73,42,34,76
82,8478460,Zach Werenski,D,CBJ,27,80,14,62,76
82,8478047,Michael Bunting,L,PIT,29,75,35,40,75
82,8475810,Bryan Rust,R,PIT,32,77,32,43,75
82,8473512,Claude Giroux,R,OTT,36,81,24,51,75
82,8478403,Jack Eichel,C,VGK,28,75,36,38,74
82,8480208,Drake Batherson,R,OTT,26,81,34,40,74
82,8475786,Zach Hyman,L,EDM,32,76,33,41,74
82,8474141,Patrick Kane,R,DET,36,78,30,44,74
82,8474600,Roman Josi,D,NSH,34,73,23,51,74
82,8480830,Andrei Svechnikov,R,CAR,24,77,35,38,73
82,8475168,Matt Duchene,C,DAL,33,81,33,40,73
82,8477960,Adrian Kempe,R,LAK,28,82,32,41,73
82,8477951,Nick Schmaltz,C,UTA,28,77,29,44,73
82,8476454,Ryan Nugent-Hopkins,C,EDM,31,80,25,48,73
82,8474578,Erik Karlsson,D,PIT,34,80,16,57,73
82,8474102,David Perron,L,OTT,36,79,30,42,72
82,8475692,Mats Zuccarello,R,MIN,37,74,19,53,72
82,8477500,Bo Horvat,C,NYI,29,78,36,35,71
82,8476459,Mika Zibanejad,C,NYR,31,76,30,41,71
82,8476881,Tomas Hertl,C,VGK,31,78,30,41,71
82,8475184,Chris Kreider,L,NYR,33,76,44,26,70
82,8476460,Mark Scheifele,C,WPG,31,73,34,36,70
82,8475754,Brock Nelson,C,NYI,33,82,35,34,69
82,8476539,Jonathan Marchessault,R,NSH,34,76,33,36,69
82,8473419,Brad Marchand,L,BOS,36,80,25,44,69
82,8477416,Oliver Bjorkstrand,R,SEA,29,75,22,47,69
82,8471685,Anze Kopitar,C,LAK,37,81,21,48,69
82,8475913,Mark Stone,R,VGK,32,75,18,51,69
82,8477402,Pavel Buchnevich,L,STL,29,78,32,36,68
82,8479420,Tage Thompson,C,BUF,27,75,31,37,68
82,8477496,Elias Lindholm,C,BOS,30,80,32,35,67
82,8479542,Brandon Hagel,L,TBL,26,82,28,39,67
82,8475158,Ryan O'Reilly,C,NSH,33,71,25,42,67
82,8477955,Jared McCann,L,SEA,28,76,30,36,66
82,8482159,Tyson Foerster,R,PHI,22,75,28,38,66
82,8482665,Matty Beniers,C,SEA,22,77,27,39,66
82,8480036,Miro Heiskanen,D,DAL,25,77,13,53,66
82,8477504,Josh Morrissey,D,WPG,29,73,13,53,66
82,8476853,Morgan Rielly,D,TOR,30,72,11,55,66
82,8477949,Alex Tuch,R,BUF,28,70,20,45,65
82,8481528,Dylan Cozens,C,BUF,23,74,31,33,64
82,8475170,Brayden Schenn,C,STL,33,79,25,39,64
82,8479337,Alex DeBrincat,R,DET,27,81,23,41,64
82,8480014,Gabriel Vilardi,C,WPG,25,70,34,29,63
82,8481068,Yegor Sharangovich,C,CGY,26,78,29,34,63
82,8476389,Vincent Trocheck,C,NYR,31,77,23,40,63
82,8479675,Trevor Moore,L,LAK,29,81,23,40,63
82,8478401,Pavel Zacha,C,BOS,27,75,22,41,63
82,8473994,Jamie Benn,L,DAL,35,81,15,48,63
82,8474590,John Carlson,D,WSH,34,70,10,53,63
82,8482699,Dylan Guenther,R,UTA,21,78,30,32,62
82,8476880,Tom Wilson,R,WSH,30,70,27,35,62
82,8478542,Evan Rodrigues,C,FLA,31,77,22,40,62
82,8478440,Dylan Strome,C,WSH,27,71,21,41,62
82,8475784,Jeff Skinner,C,EDM,32,78,30,31,61
82,8477964,Ivan Barbashev,C,VGK,29,80,30,31,61
82,8475172,Nazem Kadri,C,CGY,34,75,24,37,61
82,8478873,Troy Terry,R,ANA,27,75,21,40,61
82,8476438,Brandon Saad,L,STL,32,75,34,26,60
82,8478493,Joel Eriksson Ek,C,MIN,27,72,28,32,60
82,8475726,Tyler Toffoli,C,SJS,32,73,27,33,60
82,8477935,Sam Bennett,C,FLA,28,79,26,34,60
82,8480018,Nick Suzuki,C,MTL,25,78,13,47,60
82,8482740,Wyatt Johnston,C,DAL,21,80,37,22,59
82,8478414,Timo Meier,R,NJD,28,74,33,26,59
82,8475765,Vladimir Tarasenko,R,DET,33,80,25,34,59
82,8480839,Rasmus Dahlin,D,BUF,24,76,18,41,59
82,8477503,Max Domi,C,TOR,29,77,17,42,59
82,8477986,Brandon Montour,D,SEA,30,75,14,45,59
82,8476906,Shayne Gostisbehere,D,CAR,31,78,14,45,59
82,8481540,Cole Caufield,R,MTL,23,78,35,23,58
82,8475799,Nino Niederreiter,R,WPG,32,69,26,32,58
82,8471215,Evgeni Malkin,C,PIT,38,74,25,33,58
82,8482093,Seth Jarvis,C,CAR,22,69,22,36,58
82,8474679,Gustav Nyquist,C,NSH,35,74,16,42,58
82,8475798,Mikael Granlund,C,SJS,32,71,11,47,58
82,8484166,Adam Fantilli,C,CBJ,20,68,30,27,57
82,8480015,Owen Tippett,R,PHI,25,77,26,31,57
82,8475794,Tyler Seguin,C,DAL,32,81,23,34,57
82,8477426,Nicholas Paul,L,TBL,29,82,29,27,56
82,8478519,Anthony Cirelli,C,TBL,27,81,24,32,56
82,8478449,Roope Hintz,C,DAL,28,80,23,33,56
82,8478366,Frank Vatrano,R,ANA,30,71,30,25,55
82,8471724,Kris Letang,D,PIT,37,77,15,40,55
82,8477447,Shea Theodore,D,VGK,29,62,13,42,55
82,8483431,Logan Cooley,C,UTA,20,76,24,30,54
82,8482078,Lucas Raymond,L,DET,22,81,22,32,54
82,8482475,Yegor Chinakhov,R,CBJ,23,66,29,24,53
82,8476399,Blake Coleman,C,CGY,33,75,27,26,53
82,8477511,Anthony Mantha,R,CGY,30,78,22,31,53
82,8482113,Anton Lundell,C,FLA,23,78,21,32,53
82,8477407,Anthony Duclair,L,NYI,29,78,18,35,53
82,8480039,Martin Necas,C,CAR,25,71,19,33,52
82,8482092,Ridly Greig,C,OTT,22,71,18,34,52
82,8477494,Jonathan Drouin,L,COL,29,79,14,38,52
82,8482089,Jake Neighbours,L,STL,22,69,26,25,51
82,8474586,Jordan Eberle,R,SEA,34,71,24,27,51
82,8482720,Matthew Knies,L,TOR,22,76,24,27,51
82,8477497,Sean Monahan,C,CBJ,30,66,22,29,51
82,8476448,William Karlsson,C,VGK,31,78,21,30,51
82,8475745,Charlie Coyle,C,BOS,32,81,18,33,51
82,8477346,MacKenzie Weegar,D,CGY,30,74,17,34,51
82,8479339,Patrik Laine,L,CBJ,26,65,16,35,51
82,8476792,Torey Krug,D,STL,33,75,15,36,51
82,8479999,Casey Mittelstadt,C,COL,26,82,10,41,51
82,8478407,Vince Dunn,D,SEA,28,73,7,44,51
82,8477998,Warren Foegele,L,LAK,28,79,30,20,50
82,8475151,Kyle Palmieri,C,NYI,33,80,29,21,50
82,8477476,Artturi Lehkonen,L,COL,29,81,24,26,50
82,8483515,Juraj Slafkovsky,L,MTL,20,73,21,29,50
82,8478038,Devon Toews,D,COL,30,68,20,30,50
82,8478462,Nicolas Roy,C,VGK,27,76,18,32,50
82,8481596,Shane Pinto,C,OTT,24,74,18,32,50
82,8481711,Matias Maccelli,L,UTA,24,77,11,39,50
82,8478498,Jake DeBrusk,L,VAN,28,73,25,24,49
82,8474641,Adam Henrique,C,EDM,34,73,23,26,49
82,8475793,Ryan Johansen,C,PHI,32,72,18,31,49
82,8481533,Trevor Zegras,C,ANA,23,71,17,32,49
82,8478438,Tommy Novak,C,NSH,27,69,15,34,49
82,8476905,Chandler Stephenson,C,SEA,30,76,12,37,49
82,8482684,Luke Hughes,D,NJD,21,70,11,38,49
82,8478397,Rasmus Andersson,D,CGY,28,75,9,40,49
82,8480064,Josh Norris,C,OTT,25,75,29,19,48
82,8476432,Boone Jenner,C,CBJ,31,64,28,20,48
82,8484153,Leo Carlsson,C,ANA,20,73,26,22,48
82,8478444,Brock Boeser,R,VAN,27,73,21,27,48
82,8476875,Mike Matheson,D,MTL,30,68,10,38,48
82,8478856,Conor Garland,R,VAN,28,70,19,28,47
82,8482149,Cole Perfetti,C,WPG,22,66,19,28,47
82,8478975,Mason Marchment,L,DAL,29,81,18,29,47
82,8476479,Phillip Danault,C,LAK,31,77,17,30,47
82,8477932,Aaron Ekblad,D,FLA,28,68,17,30,47
82,8478458,John (Jack) Roslovic,C,CAR,27,68,17,30,47
82,8477456,J.T. Compher,L,DET,29,77,15,32,47
82,8480798,Philipp Kurashev,C,CHI,25,64,12,35,47
82,8481560,Arthur Kaliyev,R,LAK,23,77,24,22,46
82,8477451,Ryan Hartman,R,MIN,30,70,23,23,46
82,8477021,Alex Kerfoot,C,UTA,30,75,17,29,46
82,8476869,Brady Skjei,D,NSH,30,72,13,33,46
82,8478055,Gustav Forsling,D,FLA,28,72,7,39,46
82,8477444,Andre Burakovsky,L,SEA,29,71,23,22,45
82,8475169,Evander Kane,L,EDM,33,76,19,26,45
82,8482110,Dawson Mercer,C,NJD,23,74,19,26,45
82,8482124,Quinton Byfield,R,LAK,22,77,18,27,45
82,8482745,Mason McTavish,C,ANA,21,72,15,30,45
82,8480803,Evan Bouchard,D,EDM,25,80,12,33,45
82,8479345,Jakob Chychrun,D,WSH,26,66,12,33,45
82,8479425,Filip Hronek,D,VAN,27,72,11,34,45
82,8476419,Jean-Gabriel Pageau,C,NYI,32,80,26,18,44
82,8473986,Alex Killorn,L,ANA,35,80,18,26,44
82,8475191,Reilly Smith,R,NYR,33,78,16,28,44
82,8476826,Yanni Gourde,C,SEA,33,76,13,31,44
82,8481542,Moritz Seider,D,DET,23,77,9,35,44
82,8482146,Luke Evangelista,R,NSH,22,70,23,20,43
82,8482109,Alexis Lafrenière,L,NYR,23,70,22,21,43
82,8476480,Vladislav Namestnikov,C,WPG,32,67,22,21,43
82,8475287,Erik Haula,L,NJD,33,71,16,27,43
82,8470613,Brent Burns,D,CAR,39,76,14,29,43
82,8475218,Mattias Ekholm,D,EDM,34,78,13,30,43
82,8476458,Ryan Strome,C,ANA,31,67,11,32,43
82,8479325,Charlie McAvoy,D,BOS,27,75,8,35,43
82,8482705,Cole Sillinger,C,CBJ,21,68,18,24,42
82,8477953,Kasperi Kapanen,R,STL,28,72,16,26,42
82,8480797,Joel Farabee,L,PHI,24,74,13,29,42
82,8483505,Matthew Poitras,C,BOS,20,77,11,31,42
82,8478466,Daniel Sprong,R,VAN,27,69,20,21,41
82,8479400,Pierre-Luc Dubois,L,WSH,26,72,17,24,41
82,8475714,Calle Jarnkrok,C,TOR,33,73,16,25,41
82,8481703,Valtteri Puustinen,R,PIT,25,67,15,26,41
82,8476462,Dougie Hamilton,D,NJD,31,72,12,29,41
82,8479410,Mikhail Sergachev,D,UTA,26,64,6,35,41
82,8475768,Jaden Schwartz,C,SEA,32,71,26,14,40
82,8471698,T.J. Oshie,R,WSH,38,68,21,19,40
82,8476927,Teddy Blueger,C,VAN,30,65,15,25,40
82,8482667,William Eklund,L,SJS,22,65,11,29,40
82,8480185,Eetu Luostarinen,C,FLA,26,74,10,30,40
82,8482671,Owen Power,D,BUF,22,68,10,30,40
82,8481604,Pavel Dorofeyev,L,VGK,24,71,20,19,39
82,8474150,Mikael Backlund,C,CGY,35,72,18,21,39
82,8479525,Ross Colton,C,COL,28,79,17,22,39
82,8478474,Lawson Crouse,L,UTA,27,72,17,22,39
82,8478042,Viktor Arvidsson,L,EDM,31,68,16,23,39
82,8477839,Conor Sheary,L,TBL,32,81,16,23,39
82,8483808,Andrei Kuzmenko,L,CGY,28,77,15,24,39
82,8481618,Alex Newhook,C,MTL,23,77,15,24,39
82,8474565,Alex Pietrangelo,D,VGK,34,67,10,29,39
82,8475753,Justin Faulk,D,STL,32,73,8,31,39
82,8480145,Neal Pionk,D,WPG,29,70,6,33,39
82,8475181,Nick Leddy,D,STL,33,75,3,36,39
82,8477479,Tyler Bertuzzi,L,CHI,29,64,21,17,38
82,8479992,Michael Rasmussen,C,DET,25,81,19,19,38
82,8475760,Nick Bjugstad,C,UTA,32,73,18,20,38
82,8481524,Bowen Byram,D,BUF,23,66,14,24,38
82,8476392,Adam Lowry,C,WPG,31,68,14,24,38
82,8476292,Ondrej Palat,L,NJD,33,66,13,25,38
82,8476897,Oskar Sundqvist,C,STL,30,70,11,27,38
82,8480434,Sean Durzi,D,UTA,26,64,6,32,38
82,8475763,Kevin Hayes,R,PIT,32,69,19,18,37
82,8482702,Logan Stankoven,C,DAL,21,81,18,19,37
82,8476925,Colton Sissons,C,NSH,31,64,16,21,37
82,8480009,Eeli Tolvanen,R,SEA,25,64,12,25,37
82,8475764,Cam Fowler,D,ANA,33,78,5,32,37
82,8477425,Miles Wood,L,COL,29,73,22,14,36
82,8480028,Morgan Frost,C,PHI,25,74,16,20,36
82,8483445,Cutter Gauthier,L,ANA,20,64,12,24,36
82,8477495,Seth Jones,D,CHI,30,68,9,27,36
82,8478396,Noah Hanifin,D,VGK,27,58,9,27,36
82,8476979,Erik Gustafsson,D,DET,32,75,8,28,36
82,8481581,Thomas Harley,D,DAL,23,72,7,29,36
82,8476923,Damon Severson,D,CBJ,30,78,5,31,36
82,8481554,Kaapo Kakko,R,NYR,23,73,19,16,35
82,8480893,Kirill Marchenko,R,CBJ,24,56,18,17,35
82,8478057,Dakota Joshua,C,VAN,28,66,17,18,35
82,8482055,Drew O'Connor,L,PIT,26,68,16,19,35
82,8482097,Jack Quinn,R,BUF,23,67,15,20,35
82,8478046,Danton Heinen,L,VAN,29,70,15,20,35
82,8484145,Zach Benson,L,BUF,19,67,14,21,35
82,8480220,Noah Cates,L,PHI,25,70,14,21,35
82,8478463,Anthony Beauvillier,L,PIT,27,69,14,21,35
82,8482125,Alexander Holtz,R,VGK,22,71,12,23,35
82,8481577,Philip Tomasino,C,NSH,23,72,10,25,35
82,8477498,Darnell Nurse,D,EDM,29,70,10,25,35
82,8477429,Andrew Copp,C,DET,30,78,9,26,35
82,8476885,Jacob Trouba,D,NYR,30,70,7,28,35
82,8474715,Cameron Atkinson,R,TBL,35,82,22,12,34
82,8475722,Jason Zucker,L,BUF,32,67,20,14,34
82,8476872,Scott Laughton,C,PHI,30,66,15,19,34
82,8475314,Anders Lee,L,NYI,34,82,14,20,34
82,8478013,Jake Walman,D,SJS,28,70,14,20,34
82,8475149,Marcus Johansson,L,MIN,34,67,13,21,34
82,8480849,Barrett Hayton,C,UTA,24,74,13,21,34
82,8478233,Andrew Mangiapane,L,WSH,28,70,11,23,34
82,8482079,Marco Rossi,C,MIN,23,66,11,23,34
82,8476854,Hampus Lindholm,D,BOS,30,72,8,26,34
82,8481606,Jordan Spence,D,LAK,23,68,6,28,34
82,8476469,Joel Armia,R,MTL,31,65,19,14,33
82,8480188,Fabian Zetterlund,L,SJS,25,64,16,17,33
82,8477947,Sonny Milano,L,WSH,28,63,16,17,33
82,8476483,Rickard Rakell,R,PIT,31,65,13,20,33
82,8475848,Brendan Gallagher,R,MTL,32,69,13,20,33
82,8482712,Oskar Olausson,R,COL,22,81,9,24,33
82,8474563,Drew Doughty,D,LAK,35,72,9,24,33
82,8479591,Michael Eyssimont,C,TBL,28,82,8,25,33
82,8483490,Pavel Mintyukov,D,ANA,21,68,6,27,33
82,8476958,Jaccob Slavin,D,CAR,30,77,5,28,33
82,8479393,Noah Gregor,L,OTT,26,73,20,12,32
82,8481580,Connor McMichael,C,WSH,23,64,17,15,32
82,8479941,Justin Danforth,R,CBJ,31,55,17,15,32
82,8477505,Alexander Wennberg,C,SJS,30,62,16,16,32
82,8473422,Nick Foligno,L,CHI,37,60,15,17,32
82,8480113,Alex Iafallo,L,WPG,31,68,13,19,32
82,8482101,Danil Gushchin,L,SJS,22,55,12,20,32
82,8476474,Stefan Noesen,R,NJD,31,72,11,21,32
82,8482660,Kent Johnson,C,CBJ,22,70,11,21,32
82,8482624,Daniil Miromanov,D,CGY,27,64,8,24,32
82,8482105,Jake Sanderson,D,OTT,22,68,6,26,32
82,8478469,Thomas Chabot,D,OTT,27,73,4,28,32
82,8476331,Dylan DeMelo,D,WPG,31,70,4,28,32
82,8479390,Taylor Raddysh,R,WSH,26,70,14,17,31
82,8474149,Evgenii Dadonov,R,DAL,35,79,13,18,31
82,8480871,Adam Boqvist,D,FLA,24,70,13,18,31
82,8476882,Teuvo Teravainen,C,CHI,30,67,12,19,31
82,8479351,Sam Steel,C,DAL,26,81,12,19,31
82,8480835,Jack Drury,C,CAR,24,62,12,19,31
82,8479365,Trent Frederic,C,BOS,26,79,11,20,31
82,8474053,Logan Couture,C,SJS,35,61,11,20,31
82,8480802,Ryan McLeod,C,BUF,25,65,8,23,31
82,8476917,Adam Pelech,D,NYI,30,81,4,27,31
82,8477969,Marcus Pettersson,D,PIT,28,75,3,28,31
82,8479398,Samuel Girard,D,COL,26,67,3,28,31
82,8478500,Ivan Provorov,D,CBJ,27,78,2,29,31
82,8478020,Michael Amadio,R,OTT,28,77,17,13,30
82,8476921,Jordan Martinook,L,CAR,32,63,16,14,30
82,8481093,Rafael Harvey-Pinard,L,MTL,25,58,15,15,30
82,8476981,Josh Anderson,R,MTL,30,68,14,16,30
82,8478472,Mathieu Joseph,R,STL,27,74,7,23,30
82,8475171,Oliver Ekman-Larsson,D,TOR,33,61,6,24,30
82,8478970,Jalen Chatfield,D,CAR,28,72,6,24,30
82,8477506,Ryan Pulock,D,NYI,30,79,1,29,30
82,8478109,Victor Olofsson,L,VGK,29,75,17,12,29
82,8480813,Joe Veleno,C,DET,24,78,16,13,29
82,8479987,Morgan Geekie,C,BOS,26,74,13,16,29
82,8473533,Jordan Staal,C,CAR,36,61,13,16,29
82,8478434,Keegan Kolesar,R,VGK,27,66,13,16,29
82,8476960,Andreas Athanasiou,C,CHI,30,51,10,19,29
82,8481656,Aliaksei Protas,C,WSH,23,58,10,19,29
82,8478115,Pierre Engvall,L,NYI,28,76,9,20,29
82,8477948,Travis Sanheim,D,PHI,28,72,5,24,29
82,8480035,Henri Jokiharju,D,BUF,25,63,3,26,29
82,8479976,Juuso Valimaki,D,UTA,26,66,2,27,29
82,8481582,Nicholas Robertson,L,TOR,23,60,17,11,28
82,8482175,JJ Peterka,R,BUF,22,68,13,15,28
82,8478891,Mason Appleton,C,WPG,28,57,11,17,28
82,8475220,Marcus Foligno,L,MIN,33,60,10,18,28
82,8481527,Kaedan Korczak,D,VGK,23,50,10,18,28
82,8478133,Jake Evans,C,MTL,28,71,5,23,28
82,8482122,Brock Faber,D,MIN,22,79,4,24,28
82,8474574,Tyler Myers,D,VAN,34,70,3,25,28
82,8480459,Pius Suter,C,VAN,28,66,14,13,27
82,8475791,Taylor Hall,L,CHI,33,57,14,13,27
82,8475193,Tomas Tatar,L,NJD,34,70,12,15,27
82,8476278,Colin Blackwell,C,DAL,31,79,12,15,27
82,8481186,Logan O'Connor,R,COL,28,82,9,18,27
82,8481546,Cam York,D,PHI,23,66,7,20,27
82,8481019,David Gustafsson,C,WPG,24,60,7,20,27
82,8474151,Ryan McDonagh,D,TBL,35,80,4,23,27
82,8477987,Ryan Donato,C,CHI,28,62,16,10,26
82,8481553,Bobby Brink,R,PHI,23,68,15,11,26
82,8481535,Nils Hoglander,L,VAN,24,67,14,12,26
82,8477392,Hudson Fasching,R,NYI,29,58,11,15,26
82,8481523,Kirby Dach,C,MTL,23,65,10,16,26
82,8475343,Nic Dowd,C,WSH,34,60,10,16,26
82,8476422,Mike Reilly,D,NYI,31,76,7,19,26
82,8480043,Timothy Liljegren,D,TOR,25,60,4,22,26
82,8480873,Rasmus Sandin,D,WSH,24,68,1,25,26
82,8474189,Lars Eller,C,PIT,35,64,15,10,25
82,8477446,Michael McCarron,R,NSH,29,54,15,10,25
82,8480289,Morgan Barron,C,WPG,26,48,13,12,25
82,8480855,Jack McBain,C,UTA,24,65,12,13,25
82,8476329,Travis Boyd,C,MIN,31,55,11,14,25
82,8479353,Brett Howden,C,VGK,26,67,10,15,25
82,8475231,Casey Cizikas,C,NYI,33,77,10,15,25
82,8478507,John Marino,D,UTA,27,64,5,20,25
82,8482259,Bobby McMann,C,TOR,28,67,18,6,24
82,8481032,Paul Cotter,C,NJD,25,62,15,9,24
82,8479619,Michael Carcone,L,UTA,28,56,15,9,24
82,8481704,Juuso Parssinen,C,NSH,23,52,12,12,24
82,8475855,Jesper Fast,R,CAR,33,59,12,12,24
82,8483468,Jiri Kulich,C,BUF,20,67,12,12,24
82,8479996,Cody Glass,C,NSH,25,53,11,13,24
82,8484203,Bradly Nadeau,L,CAR,19,60,8,16,24
82,8482133,Thomas Bordeleau,C,SJS,22,61,8,16,24
82,8480172,Jan Rutta,D,SJS,34,67,8,16,24
82,8476461,Sean Couturier,C,PHI,32,62,7,17,24
82,8479639,Dylan Coghlan,D,WPG,26,63,6,18,24
82,8477919,Frederick Gaudreau,C,MIN,31,63,6,18,24
82,8477952,Robby Fabbri,C,ANA,28,67,16,7,23
82,8480068,Ryan Poehling,C,PHI,25,70,13,10,23
82,8475200,Dmitry Orlov,D,CAR,33,75,11,12,23
82,8482117,Lukas Reichel,L,CHI,22,63,11,12,23
82,8480829,Jesperi Kotkaniemi,C,CAR,24,67,10,13,23
82,8480144,David Kampf,C,TOR,29,74,10,13,23
82,8476457,Adam Larsson,D,SEA,32,68,10,13,23
82,8476918,Jimmy Vesey,L,NYR,31,63,9,14,23
82,8483491,Ivan Miroshnichenko,L,WSH,20,51,7,16,23
82,8477478,William Carrier,L,CAR,30,57,6,17,23
82,8478882,Vladislav Gavrikov,D,LAK,29,68,5,18,23
82,8477507,Nikita Zadorov,D,BOS,29,73,4,19,23
82,8476892,Colton Parayko,D,STL,31,69,3,20,23
82,8480817,K'Andre Miller,D,NYR,24,70,2,21,23
82,8475179,Dmitry Kulikov,D,FLA,34,61,2,21,23
82,8479371,Dante Fabbro,D,NSH,26,70,2,21,23
82,8475324,Nick Jensen,D,OTT,34,68,2,21,23
82,8480003,Jesper Boqvist,C,FLA,26,68,10,12,22
82,8477989,Christian Dvorak,C,MTL,28,68,10,12,22
82,8481477,Nico Sturm,C,SJS,29,54,10,12,22
82,8481481,Blake Lizotte,C,PIT,27,58,8,14,22
82,8480748,Kiefer Sherwood,L,VAN,29,67,7,15,22
82,8473507,Jeff Petry,D,DET,37,75,6,16,22
82,8480078,Filip Chytil,C,NYR,25,65,5,17,22
82,8476879,Cody Ceci,D,EDM,31,64,3,19,22
82,8470621,Corey Perry,R,EDM,39,67,11,10,21
82,8481624,Ilya Mikheyev,R,CHI,30,54,10,11,21
82,8481441,Joe Snively,C,DET,28,62,9,12,21
82,8477015,Connor Brown,R,EDM,30,68,9,12,21
82,8480995,Pontus Holmberg,R,TOR,25,67,7,14,21
82,8477406,Mattias Janmark,C,EDM,32,62,6,15,21
82,8474716,Jared Spurgeon,D,MIN,35,79,4,17,21
82,8482067,Connor Mackey,D,NYR,28,65,4,17,21
82,8481014,Alexander Romanov,D,NYI,24,79,3,18,21
82,8473563,Nicklas Backstrom,C,WSH,37,51,3,18,21
82,8480878,Nils Lundkvist,D,DAL,24,73,2,19,21
82,8477488,Brett Pesce,D,NJD,30,65,2,19,21
82,8476902,Esa Lindell,D,DAL,30,77,2,19,21
82,8476891,Matthew Grzelcyk,D,PIT,30,73,2,19,21
82,8476931,Jake McCabe,D,TOR,31,65,1,20,21
82,8481517,Brett Leason,R,ANA,25,58,13,7,20
82,8480448,Parker Kelly,L,COL,25,77,12,8,20
82,8477353,Tyler Motte,C,DET,29,76,11,9,20
82,8482074,Connor Zary,C,CGY,23,64,11,9,20
82,8476822,Luke Glendening,C,TBL,35,80,10,10,20
82,8481537,Nikita Okhotiuk,D,CGY,24,61,7,13,20
82,8483457,Lane Hutson,D,MTL,20,72,6,14,20
82,8483565,Nick Blankenburg,D,NSH,26,60,6,14,20
82,8477220,Nate Schmidt,D,FLA,33,67,4,16,20
82,8479980,Nicolas Hague,D,VGK,26,58,3,17,20
82,8480891,Michael Kesselring,D,UTA,24,63,2,18,20
82,8474673,TJ Brodie,D,CHI,34,59,2,18,20
82,8476463,Jonas Brodin,D,MIN,31,75,1,19,20
82,8479414,Nathan Bastian,R,NJD,27,60,12,7,19
82,8480980,Connor Dewar,C,TOR,25,71,10,9,19
82,8478413,Jordan Greenway,L,BUF,27,62,9,10,19
82,8477508,Curtis Lazar,C,NJD,29,57,8,11,19
82,8483493,Frank Nazar,C,CHI,20,57,8,11,19
82,8476624,Barclay Goodrow,C,SJS,31,51,8,11,19
82,8480074,Alexandre Texier,C,STL,25,52,8,11,19
82,8479982,Conor Timmins,D,TOR,26,58,5,14,19
82,8477931,Tomas Nosek,L,FLA,32,58,5,14,19
82,8482809,Jackson Blake,R,CAR,21,63,4,15,19
82,8475462,Radko Gudas,D,ANA,34,60,3,16,19
82,8481521,Ronnie Attard,D,PHI,25,56,3,16,19
82,8478840,Will Borgen,D,SEA,28,68,3,16,19
82,8481059,Scott Perunovich,D,STL,26,63,3,16,19
82,8480073,Erik Brannstrom,D,COL,25,70,1,18,19
82,8482155,Alex Laferriere,R,LAK,23,64,12,6,18
82,8479293,Brandon Tanev,L,SEA,33,65,10,8,18
82,8479359,Beck Malenstyn,L,BUF,26,42,10,8,18
82,8476873,Mark Jankowski,C,NSH,30,50,9,9,18
82,8480205,Emil Bemstrom,C,PIT,25,54,9,9,18
82,8477380,Jonny Brodzinski,C,NYR,31,52,9,9,18
82,8477979,Nicolas Aube-Kubel,R,BUF,28,52,8,10,18
82,8479661,Tanner Jeannot,L,LAK,27,77,8,10,18
82,8478569,Noel Acciari,C,PIT,33,54,8,10,18
82,8482659,Josh Doan,R,UTA,22,55,8,10,18
82,8482176,Wyatt Kaiser,D,CHI,22,53,8,10,18
82,8476889,Radek Faksa,C,STL,30,56,7,11,18
82,8478043,Sam Lafferty,C,BUF,29,63,7,11,18
82,8479344,Jesse Puljujarvi,R,PIT,26,49,7,11,18
82,8482062,Cole Smith,L,NSH,29,55,6,12,18
82,8476856,Mathew Dumba,D,DAL,30,75,6,12,18
82,8478911,Matt Roy,D,WSH,29,66,5,13,18
82,8477369,Carson Soucy,D,VAN,30,68,5,13,18
82,8475233,David Savard,D,MTL,34,62,4,14,18
82,8477435,Ryan Graves,D,PIT,29,76,4,14,18
82,8478452,Caleb Jones,D,LAK,27,58,4,14,18
82,8482192,Isaak Phillips,D,CHI,23,57,2,16,18
82,8478851,Alexandre Carrier,D,NSH,28,65,2,16,18
82,8482245,Artem Zub,D,OTT,29,67,2,16,18
82,8481568,Alex Vlasic,D,CHI,23,61,1,17,18
82,8481601,Simon Holmstrom,R,NYI,23,69,12,5,17
82,8483482,Tristan Luneau,D,ANA,20,65,10,7,17
82,8482111,Justin Barron,D,MTL,23,68,6,11,17
82,8478451,Ethan Bear,D,WSH,27,55,6,11,17
82,8476467,Jamie Oleksiak,D,SEA,32,65,6,11,17
82,8478178,Darren Raddysh,D,TBL,28,69,5,12,17
82,8475279,Ben Chiarot,D,DET,33,66,5,12,17
82,8479543,Michael Pezzetta,L,MTL,26,62,5,12,17
82,8482142,Jamie Drysdale,D,PHI,22,61,4,13,17
82,8481522,Peyton Krebs,C,BUF,23,57,4,13,17
82,8477845,Trevor van Riemsdyk,D,WSH,33,63,4,13,17
82,8477365,Connor Clifton,D,BUF,29,60,4,13,17
82,8481178,Egor Zamula,D,PHI,24,60,2,15,17
82,8475690,Chris Tanev,D,TOR,35,61,2,15,17
82,8475188,Brayden McNabb,D,VGK,33,54,2,15,17
82,8475790,Erik Gudbranson,D,CBJ,32,78,1,16,17
82,8480789,Oliver Wahlstrom,R,NYI,24,68,10,6,16
82,8484149,Gavin Brindley,C,CBJ,20,50,9,7,16
82,8481161,Jake Christiansen,D,CBJ,25,57,9,7,16
82,8482077,Dylan Holloway,L,EDM,23,53,9,7,16
82,8479315,Joey Anderson,R,CHI,26,52,8,8,16
82,8482737,Zack Bolduc,C,STL,21,52,8,8,16
82,8481716,Dmitri Voronkov,L,CBJ,24,50,7,9,16
82,8478211,Dryden Hunt,L,CGY,29,56,6,10,16
82,8479372,Joshua Mahura,D,SEA,26,44,5,11,16
82,8480021,Jack Studnicka,C,LAK,25,66,4,12,16
82,8475208,Brian Dumoulin,D,ANA,33,61,4,12,16
82,8479324,Ryan Lindgren,D,NYR,26,64,3,13,16
82,8476374,Sean Kuraly,C,CBJ,31,61,3,13,16
82,8482073,Braden Schneider,D,NYR,23,56,2,14,16
82,8480246,Nick Perbix,D,TBL,26,76,2,14,16
82,8480807,Mattias Samuelsson,D,BUF,24,54,2,14,16
82,8479983,Mario Ferraro,D,SJS,26,67,2,14,16
82,8482655,Janis Moser,D,TBL,24,79,1,15,16
82,8481518,Nolan Foote,L,NJD,24,35,12,3,15
82,8477070,Liam O'Brien,C,UTA,30,58,10,5,15
82,8477903,Garnet Hathaway,R,PHI,33,60,9,6,15
82,8480762,Eric Robinson,L,CAR,29,53,8,7,15
82,8479439,Jacob MacDonald,D,COL,31,44,8,7,15
82,8476878,Zemgus Girgensons,C,TBL,30,78,7,8,15
82,8478508,Yakov Trenin,C,MIN,27,62,7,8,15
82,8473453,Trevor Lewis,C,LAK,37,71,7,8,15
82,8480950,Ilya Lyubushkin,D,DAL,30,64,7,8,15
82,8480727,Zach Whitecloud,D,VGK,28,48,7,8,15
82,8480336,Sean Walker,D,CAR,30,66,6,9,15
82,8477450,Jason Dickinson,C,CHI,29,47,6,9,15
82,8474034,Patrick Maroon,L,CHI,36,49,6,9,15
82,8482095,Tyler Kleven,D,OTT,22,47,6,9,15
82,8482807,Ethan Del Mastro,D,CHI,21,55,5,10,15
82,8479370,Tyson Jost,C,CAR,26,49,5,10,15
82,8482451,Mikael Pyyhtia,L,CBJ,23,41,5,10,15
82,8480001,Urho Vaakanainen,D,ANA,25,65,5,10,15
82,8479369,Andrew Peeke,D,BOS,26,52,4,11,15
82,8481028,Martin Pospisil,C,CGY,25,53,4,11,15
82,8478468,Jeremy Lauzon,D,NSH,27,51,4,11,15
82,8482679,Matt Coronato,R,CGY,22,60,2,13,15
82,8475455,Brenden Dillon,D,NJD,34,53,1,14,15
82,8478831,Kevin Stenlund,C,UTA,28,56,10,4,14
82,8480281,Alexey Toropchenko,R,STL,25,56,8,6,14
82,8482148,Hendrix Lapierre,C,WSH,22,59,8,6,14
82,8476934,Brock McGinn,L,ANA,30,49,7,7,14
82,8481641,Joel Kiviranta,L,COL,28,73,6,8,14
82,8476312,Josh Manson,D,COL,33,60,6,8,14
82,8480058,Pierre-Olivier Joseph,D,STL,25,44,6,8,14
82,8478859,Niko Mikkola,D,FLA,28,57,5,9,14
82,8479536,Axel Jonsson-Fjallby,L,WPG,26,39,5,9,14
82,8478421,A.J. Greer,L,FLA,28,56,5,9,14
82,8482859,Zack Ostapchuk,C,OTT,21,54,4,10,14
82,8479348,Kale Clague,D,BUF,26,43,4,10,14
82,8477499,Rasmus Ristolainen,D,PHI,30,64,3,11,14
82,8480049,Dylan Samberg,D,WPG,25,61,2,12,14
82,8480860,Kevin Bahl,D,CGY,24,50,2,12,14
82,8478399,Jonas Siegenthaler,D,NJD,27,63,1,13,14
82,8476988,Matt Benning,D,SJS,30,57,1,13,14
82,8480796,Martin Fehervary,D,WSH,25,49,1,13,14
82,8479066,Ryan Lomberg,L,CGY,30,64,8,5,13
82,8479336,Carl Grundstrom,R,SJS,27,49,8,5,13
82,8482964,Arber Xhekaj,D,MTL,23,57,7,6,13
82,8479520,Brandon Duhaime,R,WSH,27,51,7,6,13
82,8479328,Julien Gauthier,R,NYI,27,52,7,6,13
82,8479316,Luke Kunin,C,SJS,27,58,6,7,13
82,8480192,Johnathan Kovacevic,D,NJD,27,55,6,7,13
82,8482749,Joshua Roy,R,MTL,21,53,4,9,13
82,8483524,Shane Wright,C,SEA,20,60,4,9,13
82,8478136,Jake Middleton,D,MIN,28,68,4,9,13
82,8478432,Christian Fischer,R,DET,27,73,4,9,13
82,8480222,Sebastian Aho,D,PIT,28,71,3,10,13
82,8482803,Olen Zellweger,D,ANA,21,68,3,10,13
82,8479378,Logan Stanley,D,WPG,26,51,3,10,13
82,8476429,Scott Mayfield,D,NYI,32,72,1,12,13
82,8479291,Kevin Rooney,C,CGY,31,45,8,4,12
82,8476858,Phillip Di Giuseppe,L,VAN,31,43,7,5,12
82,8477573,Nathan Walker,L,STL,30,44,7,5,12
82,8482496,Nils Aman,C,VAN,24,35,6,6,12
82,8477962,Brendan Lemieux,L,CAR,28,29,6,6,12
82,8481013,Jonatan Berggren,R,DET,24,57,5,7,12
82,8480011,Klim Kostin,C,SJS,25,53,5,7,12
82,8483495,Simon Nemec,D,NJD,20,58,4,8,12
82,8480880,Jakub Lauko,C,MIN,24,38,4,8,12
82,8480845,Rasmus Kupari,C,WPG,24,36,4,8,12
82,8478416,Erik Cernak,D,TBL,27,74,3,9,12
82,8480441,Trey Fix-Wolansky,R,CBJ,25,33,3,9,12
82,8480806,Isac Lundestrom,C,ANA,25,58,2,10,12
82,8482087,Kaiden Guhle,D,MTL,22,62,2,10,12
82,8479998,Mikey Anderson,D,LAK,25,63,1,11,12
82,8481708,Zac Jones,D,NYR,24,53,1,11,12
82,8476525,Colin Miller,D,WPG,32,57,1,11,12
82,8476994,Vinnie Hinostroza,C,NSH,30,49,1,11,12
82,8480355,Mark Kastelic,C,BOS,25,56,8,3,11
82,8480025,MacKenzie Entwistle,R,FLA,25,62,8,3,11
82,8479368,Max Jones,L,BOS,26,64,7,4,11
82,8482145,Mavrik Bourque,C,DAL,22,51,7,4,11
82,8477938,Haydn Fleury,D,WPG,28,47,5,6,11
82,8482666,Scott Morrow,D,CAR,22,48,5,6,11
82,8483499,Liam Ohgren,L,MIN,20,56,4,7,11
82,8480252,Cole Guttman,C,CHI,25,44,4,7,11
82,8481550,Adam Beckman,L,NJD,23,36,3,8,11
82,8474568,Luke Schenn,D,NSH,35,42,3,8,11
82,8474013,Ian Cole,D,UTA,35,58,3,8,11
82,8481122,Simon Benoit,D,TOR,26,43,3,8,11
82,8470600,Ryan Suter,D,STL,39,59,2,9,11
82,8474090,Brendan Smith,D,DAL,35,51,2,9,11
82,8479026,Philippe Myers,D,TOR,27,56,1,10,11
82,8483460,David Jiricek,D,CBJ,21,58,1,10,11
82,8483466,Kevin Korchinski,D,CHI,20,49,1,10,11
82,8480848,Ty Dellandrea,C,SJS,24,46,8,2,10
82,8481592,Jakob Pelletier,L,CGY,23,49,8,2,10
82,8475225,Craig Smith,C,CHI,35,52,7,3,10
82,8482157,Will Cuylle,L,NYR,22,61,5,5,10
82,8481751,Lukas Rousek,R,BUF,25,41,5,5,10
82,8478443,Brandon Carlo,D,BOS,28,61,3,7,10
82,8479671,Mathieu Olivier,R,CBJ,27,48,3,7,10
82,8482730,Brandt Clarke,D,LAK,21,48,3,7,10
82,8480292,Carson Meyer,R,ANA,27,28,3,7,10
82,8480879,Jacob Bernard-Docker,D,OTT,24,49,2,8,10
82,8481567,Henry Thrun,D,SJS,23,50,2,8,10
82,8481598,Philip Broberg,D,EDM,23,51,2,8,10
82,8477018,Ben Hutton,D,VGK,31,32,1,9,10
82,8482762,Simon Edvinsson,D,DET,21,49,6,3,9
82,8481789,Tye Kartye,L,SEA,23,34,6,3,9
82,8471817,Ryan Reaves,R,TOR,37,51,5,4,9
82,8482784,Zach Dean,C,STL,21,33,5,4,9
82,8478409,Anthony Richard,C,PHI,28,39,5,4,9
82,8482652,Walker Duehr,R,CGY,27,44,5,4,9
82,8478585,Derek Ryan,C,EDM,38,58,4,5,9
82,8482744,James Malatesta,L,CBJ,21,48,4,5,9
82,8476442,Matt Nieto,L,PIT,32,43,4,5,9
82,8478874,Adam Gaudette,R,OTT,28,34,4,5,9
82,8480157,Calle Rosen,D,COL,30,43,3,6,9
82,8479718,Alex Barré-Boulet,C,MTL,27,51,3,6,9
82,8476967,Brett Kulak,D,EDM,30,60,2,7,9
82,8480070,Ian Mitchell,D,BOS,25,46,2,7,9
82,8480887,Jordan Harris,D,MTL,24,49,2,7,9
82,8476952,Dominic Toninato,C,WPG,30,27,1,8,9
82,8483630,Pavol Regenda,L,ANA,25,39,1,8,9
82,8481167,Brayden Pachal,D,CGY,25,44,1,8,9
82,8478146,Matthew Highmore,C,OTT,28,38,1,8,9
82,8480196,Jacob Bryson,D,BUF,27,40,1,8,9
82,8479402,Jake Bean,D,CGY,26,61,0,9,9
82,8483397,Marc McLaughlin,C,BOS,25,32,7,1,8
82,8475842,Sam Carrick,C,NYR,32,64,5,3,8
82,8483570,Ben Meyers,C,SEA,26,31,5,3,8
82,8481617,Vasily Podkolzin,R,VAN,23,47,5,3,8
82,8479981,Jonah Gadjovich,L,FLA,26,41,5,3,8
82,8480834,Ty Emberson,D,SJS,24,35,4,4,8
82,8479968,Vinni Lettieri,C,BOS,29,49,4,4,8
82,8481600,Tobias Bjornfot,D,FLA,23,41,4,4,8
82,8474166,Alec Martinez,D,CHI,37,48,3,5,8
82,8471709,Marc-Edouard Vlasic,D,SJS,37,61,3,5,8
82,8475750,Jon Merrill,D,MIN,32,61,3,5,8
82,8475718,Justin Holl,D,DET,32,57,3,5,8
82,8475762,Derek Forbort,D,VAN,32,43,3,5,8
82,8477851,Jordan Oesterle,D,BOS,32,39,2,6,8
82,8480990,Declan Chisholm,D,MIN,24,39,2,6,8
82,8471677,Jack Johnson,D,CBJ,37,63,2,6,8
82,8479442,Troy Stecher,D,EDM,30,51,2,6,8
82,8476372,Nick Seeler,D,PHI,31,42,2,6,8
82,8483012,Logan Morrison,C,SEA,22,43,2,6,8
82,8478450,Parker Wotherspoon,D,BOS,27,38,1,7,8
82,8475177,Calvin de Haan,D,COL,33,44,0,8,8
82,8482713,Mackie Samoskevich,R,FLA,22,37,5,2,7
82,8476867,Brendan Gaunce,C,MIN,30,25,4,3,7
82,8478424,Jansen Harkins,C,ANA,27,35,4,3,7
82,8481532,Alex Turcotte,C,LAK,23,45,4,3,7
82,8481609,Vladislav Kolyachonok,D,UTA,23,44,4,3,7
82,8482153,Brendan Brisson,C,VGK,23,36,4,3,7
82,8477467,Gustav Olofsson,D,SEA,30,21,4,3,7
82,8480007,Jonas Rondbjerg,R,VGK,25,30,3,4,7
82,8481599,Victor Soderstrom,D,UTA,23,45,2,5,7
82,8474567,Zach Bogosian,D,MIN,34,65,2,5,7
82,8479972,Mason Shaw,C,WPG,26,39,2,5,7
82,8484254,Akito Hirose,D,VAN,25,33,1,6,7
82,8481056,Spencer Stastney,D,NSH,24,37,0,7,7
82,8475235,Nicolas Deslauriers,L,PHI,33,51,5,1,6
82,8482144,Jack Thompson,D,SJS,22,30,4,2,6
82,8479944,Zach Aston-Reese,C,VGK,30,37,3,3,6
82,8482747,Brennan Othmann,L,NYR,21,38,3,3,6
82,8482166,Shakir Mukhamadullin,D,SJS,22,55,3,3,6
82,8481679,Maxence Guenette,D,OTT,23,32,3,3,6
82,8479991,Jake Leschyshyn,C,NYR,25,33,3,3,6
82,8480844,Grigori Denisenko,L,VGK,24,35,2,4,6
82,8477887,Patrick Brown,C,BOS,32,44,2,4,6
82,8474612,Travis Hamonic,D,OTT,34,47,2,4,6
82,8479994,Jaret Anderson-Dolan,C,WPG,25,35,2,4,6
82,8482733,Logan Mailloux,D,MTL,31,29,2,4,6
82,8480245,Olle Lycksell,R,PHI,25,32,2,4,6
82,8482634,Alex Steeves,C,TOR,25,47,1,5,6
82,8476874,Olli Maatta,D,DET,30,66,1,5,6
82,8477384,Joshua Brown,D,EDM,30,38,1,5,6
82,8483619,Filip Roos,D,OTT,25,38,1,5,6
82,8473446,Erik Johnson,D,PHI,36,42,0,6,6
82,8477335,Kyle Burroughs,D,LAK,29,41,0,6,6
82,8477482,Zachary Sanford,L,CHI,30,34,3,2,5
82,8477810,Joel Hanley,D,CGY,33,33,3,2,5
82,8477401,John Hayden,C,SEA,29,34,3,2,5
82,8482070,Mitchell Chaffee,R,TBL,26,50,3,2,5
82,8476473,Connor Murphy,D,CHI,31,31,2,3,5
82,8479379,Givani Smith,R,SJS,26,27,2,3,5
82,8482147,Jean-Luc Foudy,C,COL,22,18,2,3,5
82,8478454,Noah Juulsen,D,VAN,27,41,1,4,5
82,8478017,Mark Friedman,D,VAN,29,34,1,4,5
82,8481701,Santeri Hatakka,D,NJD,23,41,1,4,5
82,8481147,Reese Johnson,C,MIN,26,38,1,4,5
82,8482858,Ryker Evans,D,SEA,23,33,1,4,5
82,8476913,Devin Shore,C,MIN,30,34,1,4,5
82,8484258,Sam Malinski,D,COL,26,24,1,4,5
82,8476441,Joel Edmundson,D,LAK,31,39,1,4,5
82,8478021,William Lagesson,D,DET,28,27,1,4,5
82,8477034,Jaycob Megna,D,FLA,32,44,0,5,5
82,8479249,Andrew Poturalski,C,SJS,30,32,0,5,5
82,8477244,Chad Ruhwedel,D,NYR,34,31,0,5,5
82,8480468,James Hamblin,L,EDM,25,20,4,0,4
82,8483763,Maksymilian Szuber,D,UTA,22,24,3,1,4
82,8477473,Justin Bailey,R,SJS,29,24,3,1,4
82,8481754,Nikita Nesterenko,C,ANA,23,30,2,2,4
82,8482511,Mason Lohrei,D,BOS,23,36,2,2,4
82,8481556,John Beecher,C,BOS,23,27,2,2,4
82,8477462,Robert Hagg,D,VGK,29,33,2,2,4
82,8481593,Jayden Struble,D,MTL,23,25,2,2,4
82,8480084,Nick DeSimone,D,NJD,30,15,2,2,4
82,8481578,Graeme Clarke,R,MIN,23,9,2,2,4
82,8483549,Lucas Condotta,L,MTL,27,32,1,3,4
82,8479985,Cale Fleury,D,SEA,26,25,1,3,4
82,8479576,Vincent Desharnais,D,VAN,28,39,1,3,4
82,8479587,Rhett Gardner,C,PHI,28,21,1,3,4
82,8481065,Angus Crookshank,L,OTT,25,14,1,3,4
82,8482177,Marat Khusnutdinov,C,MIN,22,31,1,3,4
82,8477149,Scott Sabourin,R,SJS,32,24,1,3,4
82,8477527,Ross Johnston,L,ANA,30,32,0,4,4
82,8479772,Zack MacEwen,R,OTT,28,49,3,0,3
82,8479638,Justin Brazeau,R,BOS,26,40,3,0,3
82,8481543,Nikita Alexandrov,C,STL,24,22,3,0,3
82,8483489,Fraser Minten,C,TOR,31,7,3,0,3
82,8480870,Bo Groulx,C,NYR,24,27,2,1,3
82,8481237,Kyle MacLean,C,NYI,25,23,2,1,3
82,8480267,Sammy Walker,C,MIN,25,7,2,1,3
82,8482118,Sam Colangelo,R,ANA,23,15,2,1,3
82,8479320,Maxime Lajoie,D,SEA,27,20,2,1,3
82,8484911,Collin Graf,R,SJS,22,36,1,2,3
82,8483512,Matthew Savoie,C,EDM,20,24,1,2,3
82,8481585,Egor Afanasyev,L,SJS,23,18,1,2,3
82,8481564,Ryan Johnson,D,BUF,23,10,1,2,3
82,8481743,Marc Del Gaizo,D,NSH,25,22,1,2,3
82,8477073,Kurtis MacDermid,L,NJD,30,24,1,2,3
82,8481043,Cole Koepke,L,BOS,26,20,1,2,3
82,8481541,Samuel Bolduc,D,NYI,24,18,0,3,3
82,8480890,Jan Jenik,C,OTT,24,28,0,3,3
82,8482470,Ilya Solovyov,D,CGY,24,14,0,3,3
82,8475795,Dylan McIlrath,D,WSH,32,11,0,3,3
82,8481030,Jack St. Ivany,D,PIT,25,19,0,3,3
82,8482861,Vincent Iorio,D,WSH,22,33,0,3,3
82,8477971,Andreas Englund,D,LAK,28,27,0,3,3
82,8479419,Brett Murray,L,BUF,26,14,2,0,2
82,8480851,Akil Thomas,C,LAK,24,18,2,0,2
82,8482751,Ryan Winterton,C,SEA,21,28,1,1,2
82,8481605,Jackson LaCombe,D,ANA,23,27,1,1,2
82,8482765,Isak Rosen,R,BUF,21,33,1,1,2
82,8475958,Michael Sgarbossa,C,WSH,32,29,1,1,2
82,8482141,Lukas Cormier,D,VGK,22,30,1,1,2
82,8478881,Brett Seney,L,CHI,28,9,1,1,2
82,8482172,Landon Slaggert,L,CHI,22,23,1,1,2
82,8479367,William Lockwood,R,FLA,26,20,1,1,2
82,8478477,Mitchell Stephens,C,SEA,27,21,1,1,2
82,8481462,Mason Morelli,L,VGK,28,14,1,1,2
82,8482250,Callahan Burke,C,VGK,27,20,1,1,2
82,8479362,Riley Tufte,L,BOS,26,22,1,1,2
82,8478446,Glenn Gawdin,C,LAK,27,9,1,1,2
82,8481006,Tyler Tucker,D,STL,24,21,1,1,2
82,8480823,Alexander Alexeyev,D,WSH,25,8,1,1,2
82,8483395,Arshdeep Bains,L,VAN,23,9,1,1,2
82,8479421,Jacob Moverare,D,LAK,26,8,1,1,2
82,8482929,Emil Lilleberg,D,TBL,23,20,0,2,2
82,8484287,Cole McWard,D,VAN,23,16,0,2,2
82,8478502,Dennis Gilbert,D,BUF,28,12,0,2,2
82,8482088,Justin Sourdif,R,FLA,22,17,0,2,2
82,8477541,Dakota Mermis,D,TOR,30,10,0,2,2
82,8481422,Jake Lucchini,C,NSH,29,23,1,0,1
82,8478051,Max Willman,C,NJD,29,25,1,0,1
82,8481024,Linus Karlsson,C,VAN,25,6,1,0,1
82,8483471,Brad Lambert,C,WPG,31,11,1,0,1
82,8482516,Matthew Kessel,D,STL,24,13,1,0,1
82,8482061,Brandon Biro,L,SEA,26,9,1,0,1
82,8483597,Milos Kelemen,L,UTA,25,7,1,0,1
82,8482201,Gage Goncalves,C,TBL,23,23,1,0,1
82,8474062,Riley Nash,C,NYR,35,17,1,0,1
82,8481206,John Ludvig,D,PIT,24,13,1,0,1
82,8478011,Louie Belpedio,D,PHI,28,14,1,0,1
82,8483401,Marc Johnstone,R,PIT,28,2,1,0,1
82,8483609,Adam Klapka,R,CGY,24,5,1,0,1
82,8481726,Adam Edstrom,C,NYR,24,5,1,0,1
82,8479986,Kole Lind,R,DAL,26,47,0,1,1
82,8482102,Vasily Ponomarev,C,PIT,22,19,0,1,1
82,8475413,Justin Dowling,C,NJD,34,15,0,1,1
82,8484325,Waltteri Merela,C,TBL,26,17,0,1,1
82,8483407,Brandon Scanlin,D,NYR,25,6,0,1,1
82,8480874,Adam Ginning,D,PHI,24,11,0,1,1
82,8482165,Yan Kuznetsov,D,CGY,22,16,0,1,1
82,8481699,Aku Raty,R,UTA,23,13,0,1,1
82,8482162,Roby Jarventie,L,EDM,22,18,0,1,1
82,8482787,Nikita Chibrikov,R,WPG,31,8,0,1,1
82,8479330,Brandon Gignac,C,MTL,27,9,0,1,1
82,8480075,Cameron Crotty,D,MIN,25,13,0,1,1
82,8481655,Cole Schwindt,R,CGY,23,8,0,1,1
82,8477320,Anton Blidh,L,NYR,29,18,0,0,0
82,8481719,Maxwell Crozier,D,TBL,24,9,0,0,0
82,8482460,Matt Rempe,C,NYR,22,12,0,0,0
82,8475780,Chris Wagner,R,COL,33,8,0,0,0
82,8481806,Louis Crevier,D,CHI,23,11,0,0,0
82,8483546,Marshall Rifai,D,TOR,26,6,0,0,0
82,8482197,Adam Raska,R,MIN,23,9,0,0,0
82,8482094,Daemon Hunt,D,MIN,22,13,0,0,0
82,8478854,Ryan Shea,D,PIT,27,8,0,0,0
82,8482476,Emil Heineman,L,MTL,23,7,0,0,0
82,8480306,Grant Hutton,D,NYI,29,6,0,0,0
82,8484326,Patrik Koch,D,UTA,28,0,0,0,0
82,8479522,Hardy Haman Aktell,D,WSH,26,3,0,0,0
82,8480032,Shane Bowers,C,NJD,25,16,0,0,0
82,8483398,Declan Carlile,D,TBL,31,3,0,0,0
82,8478147,Bokondji Imama,L,PIT,28,4,0,0,0
82,8483531,Brian Halonen,L,NJD,25,5,0,0,0
82,8475755,Alexander Petrovic,D,DAL,32,3,0,0,0
82,8482126,Emil Andrae,D,PHI,31,4,0,0,0
82,8484321,Nikolas Matinpalo,D,OTT,26,3,0,0,0
82,8483567,Georgii Merkulov,C,BOS,24,5,0,0,0
82,8483432,Luca Del Bel Belluz,C,CBJ,31,6,0,0,0
82,8478956,Samuel Laberge,L,NJD,27,0,0,0,0
82,8484304,Uvis Balinskis,D,FLA,28,12,0,0,0
82,8483920,Pierrick Dube,R,WSH,23,4,0,0,0
82,8477993,Justin Kirkland,C,CGY,28,5,0,0,0
82,8476323,Max McCormick,L,SEA,32,2,0,0,0
82,8480274,Philip Kemp,D,EDM,25,0,0,0,0
82,8484255,Jason Polin,R,COL,25,5,0,0,0
82,8481534,Raphael Lavoie,C,EDM,24,4,0,0,0
82,8484259,Ondrej Pavel,C,COL,31,2,0,0,0
82,8470794,Joe Pavelski,C,,40,0,0,0,0
82,8479321,Lucas Johansen,D,,27,0,0,0,0
82,8477950,Tony DeAngelo,D,,29,0,0,0,0
82,8471218,Blake Wheeler,R,,38,0,0,0,0
82,8475197,Tyson Barrie,D,,33,0,0,0,0
82,8474157,Max Pacioretty,L,,36,0,0,0,0
82,8475744,Evgeny Kuznetsov,C,,32,0,0,0,0
82,8474037,James van Riemsdyk,L,,35,0,0,0,0
82,8476907,Mackenzie MacEachern,L,,30,0,0,0,0
82,8480216,Jacob Peterson,C,,25,0,0,0,0
82,8474602,Justin Schultz,D,,34,0,0,0,0
82,8482222,Alexander Barabanov,L,,30,0,0,0,0
82,8474031,Kevin Shattenkirk,D,,35,0,0,0,0
82,8477330,Dominik Kubalik,L,,29,0,0,0,0
82,8480884,Calen Addison,D,,24,0,0,0,0
82,8475906,John Klingberg,D,,32,0,0,0,0
82,8480008,Adam Ruzicka,C,,25,0,0,0,0
82,8476884,Derrick Pouliot,D,,30,0,0,0,0
82,8476919,Chris Tierney,C,,30,0,0,0,0
82,8479415,Michael McLeod,C,,26,0,0,0,0
82,8474870,Tyler Johnson,C,,34,0,0,0,0
82,8470604,Jeff Carter,C,,39,0,0,0,0
82,8478104,Sammy Blais,L,,28,0,0,0,0
82,8474884,Mike Hoffman,C,,35,0,0,0,0
82,8481591,Sam Poulin,R,,23,0,0,0,0
82,8471274,Alex Goligoski,D,,39,0,0,0,0
82,8476871,Tanner Pearson,L,,32,0,0,0,0
82,8476393,Nick Cousins,C,,31,0,0,0,0
82,8479977,Kailer Yamamoto,R,,26,0,0,0,0
82,8479346,Dillon Dube,C,,26,0,0,0,0
82,8480184,Gustav Lindstrom,D,,26,0,0,0,0
82,8479376,Victor Mete,D,,26,0,0,0,0
82,8473449,Kyle Okposo,R,,36,0,0,0,0
82,8481058,Jesse Ylonen,R,,25,0,0,0,0
82,8475752,Tyler Pitlick,C,,33,0,0,0,0
82,8481239,Samuel Fagemo,L,,24,0,0,0,0
82,8480821,Filip Zadina,R,,25,0,0,0,0
82,8470966,Mark Giordano,D,,41,0,0,0,0
82,8478495,Denis Gurianov,R,,27,0,0,0,0
82,8477464,Nic Petan,C,,29,0,0,0,0
82,8478099,Kevin Labanc,R,,29,0,0,0,0
82,8482241,Radim Zohorna,L,,28,0,0,0,0
82,8474040,Sam Gagner,C,,35,0,0,0,0
82,8479514,Rem Pitlick,C,,27,0,0,0,0
82,8478430,Oliver Kylington,D,,27,0,0,0,0
82,8479533,Joona Koppanen,L,,26,0,0,0,0
82,8479984,Cal Foote,D,,26,0,0,0,0
82,8477126,Jayson Megna,C,,34,0,0,0,0
82,8475164,Jakob Silfverberg,R,,34,0,0,0,0
82,8474009,Nick Bonino,C,,36,0,0,0,0
82,8479458,Nikita Zaitsev,D,,33,0,0,0,0
82,8477944,Jakub Vrana,L,,28,0,0,0,0
82,8471699,Andrew Cogliano,C,,37,0,0,0,0
82,8478067,Oskar Lindblom,L,,28,0,0,0,0
82,8471686,Marc Staal,D,,37,0,0,0,0
82,8470610,Zach Parise,L,,40,0,0,0,0
82,8478904,Steven Lorentz,C,,28,0,0,0,0
82,8473473,Milan Lucic,L,,36,0,0,0,0
82,8480031,Maxime Comtois,L,,25,0,0,0,0
82,8478512,Austin Czarnik,C,,32,0,0,0,0
82,8473504,Cal Clutterbuck,R,,37,0,0,0,0
82,8477454,Adam Erne,L,,29,0,0,0,0
82,8479383,Boris Katchouk,L,,26,0,0,0,0
82,8475825,Jani Hakanpää,D,,32,0,0,0,0
82,8477846,Ryan Carpenter,C,,33,0,0,0,0
82,8477930,Pierre-Edouard Bellemare,L,,39,0,0,0,0
82,8478400,Colin White,C,,27,0,0,0,0
82,8480226,Marián Studenic,R,,26,0,0,0,0
82,8480853,Liam Foudy,C,,24,0,0,0,0
82,8475797,Jarred Tinordi,D,,32,0,0,0,0
82,8479423,Alex Nylander,L,,26,0,0,0,0
82,8474618,Marco Scandella,D,,34,0,0,0,0
82,8478028,Fredrik Olofsson,L,,28,0,0,0,0
82,8474709,Matt Martin,L,,35,0,0,0,0
82,8481070,Hugh McGing,L,,26,0,0,0,0
82,8479546,Oskar Steen,C,,26,0,0,0,0
82,8474145,Robert Bortuzzo,D,,35,0,0,0,0
82,8476915,Jujhar Khaira,L,,30,0,0,0,0
82,8475278,Byron Froese,C,,33,0,0,0,0
82,8481812,Nikolai Knyzhov,D,,27,0,0,0,0
82,8478408,Travis Dermott,D,,28,0,0,0,0
82,8481077,John Leonard,L,,26,0,0,0,0
82,8479547,Matthew Phillips,R,,26,0,0,0,0
82,8480836,Jonathan Gruden,C,,24,0,0,0,0
82,8481690,Tyler Angle,C,,24,0,0,0,0
82,8475766,Austin Watson,L,,32,0,0,0,0
82,8481016,Ruslan Iskhakov,C,,24,0,0,0,0
82,8478078,Rourke Chartier,C,,28,0,0,0,0
82,8480776,Sheldon Rempal,R,,29,0,0,0,0
82,8483045,Cameron Butler,R,CBJ,31,0,0,0,0
82,8484314,Jiri Smejkal,L,,28,0,0,0,0
83,8477956,David Pastrnak,R,BOS,28,81,70,68,138
83,8476453,Nikita Kucherov,R,TBL,31,82,41,89,130
83,8477492,Nathan MacKinnon,C,COL,29,80,55,71,126
83,8478402,Connor McDavid,C,EDM,27,80,39,85,124
83,8477934,Leon Draisaitl,C,EDM,29,79,47,73,120
83,8479318,Auston Matthews,C,TOR,27,77,65,54,119
83,8477493,Aleksander Barkov,C,FLA,29,78,32,77,109
83,8479314,Matthew Tkachuk,L,FLA,27,78,32,76,108
83,8481559,Jack Hughes,C,NJD,23,68,39,66,105
83,8476468,J.T. Miller,C,VAN,31,78,42,61,103
83,8477939,William Nylander,R,TOR,28,81,41,60,101
83,8478483,Mitch Marner,R,TOR,27,76,31,69,100
83,8482078,Lucas Raymond,L,DET,22,81,41,58,99
83,8480002,Nico Hischier,C,NJD,25,79,36,59,95
83,8478550,Artemi Panarin,L,NYR,33,77,33,62,95
83,8480027,Jason Robertson,L,DAL,25,81,33,62,95
83,8478420,Mikko Rantanen,R,COL,28,82,38,56,94
83,8478864,Kirill Kaprizov,L,MIN,27,75,37,56,93
83,8477404,Jake Guentzel,C,TBL,30,82,32,58,90
83,8478010,Brayden Point,C,TBL,28,82,40,49,89
83,8479407,Jesper Bratt,L,NJD,26,71,34,55,89
83,8480830,Andrei Svechnikov,R,CAR,24,73,35,53,88
83,8482116,Tim Stützle,C,OTT,22,81,34,54,88
83,8476887,Filip Forsberg,L,NSH,30,69,33,55,88
83,8478439,Travis Konecny,R,PHI,27,75,39,48,87
83,8474141,Patrick Kane,R,DET,36,81,24,63,87
83,8479385,Jordan Kyrou,C,STL,26,77,40,45,85
83,8475172,Nazem Kadri,C,CGY,34,80,34,51,85
83,8477402,Pavel Buchnevich,L,STL,29,78,32,53,85
83,8480839,Rasmus Dahlin,D,BUF,24,73,25,60,85
83,8475692,Mats Zuccarello,R,MIN,37,72,22,63,85
83,8478403,Jack Eichel,C,VGK,28,79,31,53,84
83,8477942,Kevin Fiala,L,LAK,28,79,37,46,83
83,8477409,Carter Verhaeghe,C,FLA,29,78,33,50,83
83,8484144,Connor Bedard,C,CHI,19,67,31,51,82
83,8480069,Cale Makar,D,COL,26,68,24,58,82
83,8477933,Sam Reinhart,C,FLA,29,79,46,35,81
83,8475166,John Tavares,C,TOR,34,79,34,47,81
83,8479343,Clayton Keller,R,UTA,26,77,26,55,81
83,8479420,Tage Thompson,C,BUF,27,74,48,32,80
83,8478427,Sebastian Aho,C,CAR,27,73,33,47,80
83,8471675,Sidney Crosby,C,PIT,37,69,37,42,79
83,8480012,Elias Pettersson,C,VAN,26,76,31,48,79
83,8480023,Robert Thomas,C,STL,25,76,22,57,79
83,8475765,Vladimir Tarasenko,R,DET,33,82,35,43,78
83,8477960,Adrian Kempe,R,LAK,28,81,30,48,78
83,8474564,Steven Stamkos,C,NSH,34,75,32,45,77
83,8478445,Mathew Barzal,C,NYI,27,80,26,51,77
83,8474578,Erik Karlsson,D,PIT,34,78,14,63,77
83,8475786,Zach Hyman,L,EDM,32,79,38,38,76
83,8477946,Dylan Larkin,C,DET,28,78,29,47,76
83,8477949,Alex Tuch,R,BUF,28,73,29,46,75
83,8475158,Ryan O'Reilly,C,NSH,33,79,36,38,74
83,8480208,Drake Batherson,R,OTT,26,78,29,45,74
83,8478493,Joel Eriksson Ek,C,MIN,27,73,28,46,74
83,8471685,Anze Kopitar,C,LAK,37,79,26,48,74
83,8478460,Zach Werenski,D,CBJ,27,78,19,55,74
83,8477501,Valeri Nichushkin,R,COL,29,80,39,34,73
83,8479542,Brandon Hagel,L,TBL,26,82,33,40,73
83,8476460,Mark Scheifele,C,WPG,31,72,32,41,73
83,8478449,Roope Hintz,C,DAL,28,82,38,34,72
83,8482740,Wyatt Johnston,C,DAL,21,82,36,34,70
83,8479323,Adam Fox,D,NYR,26,74,12,58,70
83,8478856,Conor Garland,R,VAN,28,76,29,40,69
83,8477951,Nick Schmaltz,C,UTA,28,74,27,42,69
83,8480801,Brady Tkachuk,L,OTT,25,81,25,44,69
83,8477955,Jared McCann,L,SEA,28,71,35,33,68
83,8476882,Teuvo Teravainen,C,CHI,30,72,26,42,68
83,8481711,Matias Maccelli,L,UTA,24,79,19,49,68
83,8476399,Blake Coleman,C,CGY,33,78,31,36,67
83,8478398,Kyle Connor,L,WPG,28,73,29,38,67
83,8475913,Mark Stone,R,VGK,32,78,26,41,67
83,8478401,Pavel Zacha,C,BOS,27,79,24,43,67
83,8476454,Ryan Nugent-Hopkins,C,EDM,31,75,22,45,67
83,8481557,Matt Boldy,L,MIN,23,72,21,46,67
83,8480865,Noah Dobson,D,NYI,24,81,19,48,67
83,8476346,Johnny Gaudreau,L,CBJ,31,68,18,49,67
83,8480800,Quinn Hughes,D,VAN,25,75,11,56,67
83,8479337,Alex DeBrincat,R,DET,27,80,30,36,66
83,8476881,Tomas Hertl,C,VGK,31,76,27,39,66
83,8475798,Mikael Granlund,C,SJS,32,69,14,52,66
83,8474590,John Carlson,D,WSH,34,69,10,56,66
83,8478440,Dylan Strome,C,WSH,27,74,18,47,65
83,8475184,Chris Kreider,L,NYR,33,80,36,28,64
83,8471215,Evgeni Malkin,C,PIT,38,69,29,35,64
83,8473512,Claude Giroux,R,OTT,36,78,28,36,64
83,8476905,Chandler Stephenson,C,SEA,30,76,27,37,64
83,8478975,Mason Marchment,L,DAL,29,81,24,40,64
83,8477503,Max Domi,C,TOR,29,76,18,46,64
83,8480036,Miro Heiskanen,D,DAL,25,74,13,51,64
83,8476389,Vincent Trocheck,C,NYR,31,77,28,35,63
83,8473419,Brad Marchand,L,BOS,36,80,22,41,63
83,8474600,Roman Josi,D,NSH,34,73,15,48,63
83,8475167,Victor Hedman,D,TBL,34,79,13,50,63
83,8476853,Morgan Rielly,D,TOR,30,69,11,52,63
83,8477500,Bo Horvat,C,NYI,29,74,29,33,62
83,8481540,Cole Caufield,R,MTL,23,74,28,34,62
83,8483515,Juraj Slafkovsky,L,MTL,20,75,25,37,62
83,8475754,Brock Nelson,C,NYI,33,80,28,33,61
83,8478438,Tommy Novak,C,NSH,27,75,24,37,61
83,8481596,Shane Pinto,C,OTT,24,76,19,42,61
83,8477935,Sam Bennett,C,FLA,28,76,30,30,60
83,8475151,Kyle Palmieri,C,NYI,33,75,25,35,60
83,8475168,Matt Duchene,C,DAL,33,81,24,36,60
83,8480028,Morgan Frost,C,PHI,25,74,23,37,60
83,8476459,Mika Zibanejad,C,NYR,31,73,22,38,60
83,8478414,Timo Meier,R,NJD,28,77,21,39,60
83,8479999,Casey Mittelstadt,C,COL,26,81,21,39,60
83,8480803,Evan Bouchard,D,EDM,25,76,10,50,60
83,8477456,J.T. Compher,L,DET,29,79,27,32,59
83,8480018,Nick Suzuki,C,MTL,25,74,26,33,59
83,8476448,William Karlsson,C,VGK,31,77,25,34,59
83,8478873,Troy Terry,R,ANA,27,69,22,37,59
83,8476479,Phillip Danault,C,LAK,31,79,28,30,58
83,8478519,Anthony Cirelli,C,TBL,27,81,25,33,58
83,8480015,Owen Tippett,R,PHI,25,76,23,35,58
83,8477940,Nikolaj Ehlers,L,WPG,28,69,14,44,58
83,8471214,Alex Ovechkin,L,WSH,39,71,34,23,57
83,8482093,Seth Jarvis,C,CAR,22,64,29,28,57
83,8478444,Brock Boeser,R,VAN,27,76,29,28,57
83,8482124,Quinton Byfield,R,LAK,22,79,22,35,57
83,8482699,Dylan Guenther,R,UTA,21,72,26,30,56
83,8477496,Elias Lindholm,C,BOS,30,80,21,35,56
83,8477504,Josh Morrissey,D,WPG,29,74,12,44,56
83,8480064,Josh Norris,C,OTT,25,78,37,18,55
83,8482175,JJ Peterka,R,BUF,22,67,34,21,55
83,8480014,Gabriel Vilardi,C,WPG,25,75,25,30,55
83,8479675,Trevor Moore,L,LAK,29,80,22,33,55
83,8473994,Jamie Benn,L,DAL,35,82,20,35,55
83,8474102,David Perron,L,OTT,36,77,18,37,55
83,8478042,Viktor Arvidsson,L,EDM,31,71,21,33,54
83,8474150,Mikael Backlund,C,CGY,35,74,18,36,54
83,8474586,Jordan Eberle,R,SEA,34,72,17,37,54
83,8471724,Kris Letang,D,PIT,37,79,13,41,54
83,8478407,Vince Dunn,D,SEA,28,71,12,42,54
83,8479410,Mikhail Sergachev,D,UTA,26,64,12,42,54
83,8476875,Mike Matheson,D,MTL,30,71,8,46,54
83,8475810,Bryan Rust,R,PIT,32,75,28,25,53
83,8482745,Mason McTavish,C,ANA,21,74,26,27,53
83,8484166,Adam Fantilli,C,CBJ,20,69,24,29,53
83,8477451,Ryan Hartman,R,MIN,30,74,24,29,53
83,8477416,Oliver Bjorkstrand,R,SEA,29,74,22,31,53
83,8475794,Tyler Seguin,C,DAL,32,81,22,31,53
83,8483808,Andrei Kuzmenko,L,CGY,28,78,21,32,53
83,8482720,Matthew Knies,L,TOR,22,75,20,33,53
83,8481528,Dylan Cozens,C,BUF,23,71,14,39,53
83,8480188,Fabian Zetterlund,L,SJS,25,66,28,24,52
83,8482110,Dawson Mercer,C,NJD,23,73,24,28,52
83,8475784,Jeff Skinner,C,EDM,32,77,23,29,52
83,8478047,Michael Bunting,L,PIT,29,75,21,31,52
83,8482159,Tyson Foerster,R,PHI,22,77,19,33,52
83,8478055,Gustav Forsling,D,FLA,28,74,12,40,52
83,8479425,Filip Hronek,D,VAN,27,77,10,42,52
83,8482712,Oskar Olausson,R,COL,22,76,10,42,52
83,8482684,Luke Hughes,D,NJD,21,75,7,45,52
83,8477511,Anthony Mantha,R,CGY,30,75,19,32,51
83,8484153,Leo Carlsson,C,ANA,20,72,18,33,51
83,8482665,Matty Beniers,C,SEA,22,72,17,34,51
83,8476539,Jonathan Marchessault,R,NSH,34,76,27,23,50
83,8480039,Martin Necas,C,CAR,25,70,24,26,50
83,8479400,Pierre-Luc Dubois,L,WSH,26,74,22,28,50
83,8481533,Trevor Zegras,C,ANA,23,74,16,34,50
83,8477932,Aaron Ekblad,D,FLA,28,75,11,39,50
83,8477476,Artturi Lehkonen,L,COL,29,74,25,24,49
83,8481068,Yegor Sharangovich,C,CGY,26,77,24,25,49
83,8482109,Alexis Lafrenière,L,NYR,23,76,20,29,49
83,8482097,Jack Quinn,R,BUF,23,65,19,30,49
83,8477964,Ivan Barbashev,C,VGK,29,74,18,31,49
83,8479339,Patrik Laine,L,CBJ,26,60,16,33,49
83,8477429,Andrew Copp,C,DET,30,78,16,33,49
83,8477495,Seth Jones,D,CHI,30,69,15,34,49
83,8476456,Jonathan Huberdeau,C,CGY,31,79,10,39,49
83,8478472,Mathieu Joseph,R,STL,27,70,10,39,49
83,8479325,Charlie McAvoy,D,BOS,27,76,7,42,49
83,8473986,Alex Killorn,L,ANA,35,75,21,27,48
83,8477986,Brandon Montour,D,SEA,30,77,17,31,48
83,8482113,Anton Lundell,C,FLA,23,77,17,31,48
83,8476854,Hampus Lindholm,D,BOS,30,76,13,35,48
83,8477447,Shea Theodore,D,VGK,29,69,11,37,48
83,8474641,Adam Henrique,C,EDM,34,75,27,20,47
83,8477497,Sean Monahan,C,CBJ,30,71,23,24,47
83,8475745,Charlie Coyle,C,BOS,32,74,18,29,47
83,8475726,Tyler Toffoli,C,SJS,32,71,26,20,46
83,8475169,Evander Kane,L,EDM,33,76,23,23,46
83,8475768,Jaden Schwartz,C,SEA,32,76,20,26,46
83,8476483,Rickard Rakell,R,PIT,31,69,17,29,46
83,8476872,Scott Laughton,C,PHI,30,77,15,31,46
83,8476792,Torey Krug,D,STL,33,76,13,33,46
83,8478397,Rasmus Andersson,D,CGY,28,71,9,37,46
83,8482105,Jake Sanderson,D,OTT,22,72,13,32,45
83,8477998,Warren Foegele,L,LAK,28,79,19,25,44
83,8477021,Alex Kerfoot,C,UTA,30,72,19,25,44
83,8480185,Eetu Luostarinen,C,FLA,26,75,17,27,44
83,8478396,Noah Hanifin,D,VGK,27,63,17,27,44
83,8479992,Michael Rasmussen,C,DET,25,79,15,29,44
83,8478469,Thomas Chabot,D,OTT,27,75,7,37,44
83,8478542,Evan Rodrigues,C,FLA,31,75,23,20,43
83,8481560,Arthur Kaliyev,R,LAK,23,80,21,22,43
83,8477407,Anthony Duclair,L,NYI,29,78,20,23,43
83,8476826,Yanni Gourde,C,SEA,33,73,19,24,43
83,8480817,K'Andre Miller,D,NYR,24,72,13,30,43
83,8476885,Jacob Trouba,D,NYR,30,72,8,35,43
83,8476474,Stefan Noesen,R,NJD,31,69,26,16,42
83,8478474,Lawson Crouse,L,UTA,27,76,23,19,42
83,8482092,Ridly Greig,C,OTT,22,77,19,23,42
83,8479987,Morgan Geekie,C,BOS,26,78,19,23,42
83,8475191,Reilly Smith,R,NYR,33,76,18,24,42
83,8474679,Gustav Nyquist,C,NSH,35,74,16,26,42
83,8477444,Andre Burakovsky,L,SEA,29,68,15,27,42
83,8482133,Thomas Bordeleau,C,SJS,22,69,15,27,42
83,8477479,Tyler Bertuzzi,L,CHI,29,61,14,28,42
83,8476958,Jaccob Slavin,D,CAR,30,76,7,35,42
83,8478462,Nicolas Roy,C,VGK,27,78,19,22,41
83,8483431,Logan Cooley,C,UTA,20,71,17,24,41
83,8482702,Logan Stankoven,C,DAL,21,80,17,24,41
83,8478458,John (Jack) Roslovic,C,CAR,27,73,15,26,41
83,8475848,Brendan Gallagher,R,MTL,32,70,15,26,41
83,8481703,Valtteri Puustinen,R,PIT,25,60,13,28,41
83,8476923,Damon Severson,D,CBJ,30,80,12,29,41
83,8481604,Pavel Dorofeyev,L,VGK,24,72,23,17,40
83,8481618,Alex Newhook,C,MTL,23,67,20,20,40
83,8479525,Ross Colton,C,COL,28,78,19,21,40
83,8474149,Evgenii Dadonov,R,DAL,35,82,19,21,40
83,8475753,Justin Faulk,D,STL,32,72,12,28,40
83,8480829,Jesperi Kotkaniemi,C,CAR,24,65,12,28,40
83,8475799,Nino Niederreiter,R,WPG,32,72,25,14,39
83,8476432,Boone Jenner,C,CBJ,31,66,24,15,39
83,8482660,Kent Johnson,C,CBJ,22,68,17,22,39
83,8482475,Yegor Chinakhov,R,CBJ,23,61,14,25,39
83,8477498,Darnell Nurse,D,EDM,29,73,13,26,39
83,8478115,Pierre Engvall,L,NYI,28,82,13,26,39
83,8482089,Jake Neighbours,L,STL,22,65,26,12,38
83,8475287,Erik Haula,L,NJD,33,74,19,19,38
83,8476438,Brandon Saad,L,STL,32,67,18,20,38
83,8475793,Ryan Johansen,C,PHI,32,74,17,21,38
83,8482705,Cole Sillinger,C,CBJ,21,65,17,21,38
83,8477987,Ryan Donato,C,CHI,28,57,17,21,38
83,8476906,Shayne Gostisbehere,D,CAR,31,74,15,23,38
83,8475170,Brayden Schenn,C,STL,33,74,14,24,38
83,8476392,Adam Lowry,C,WPG,31,70,14,24,38
83,8475193,Tomas Tatar,L,NJD,34,75,14,24,38
83,8481581,Thomas Harley,D,DAL,23,77,6,32,38
83,8481542,Moritz Seider,D,DET,23,75,5,33,38
83,8478366,Frank Vatrano,R,ANA,30,77,21,16,37
83,8478498,Jake DeBrusk,L,VAN,28,75,17,20,37
83,8475722,Jason Zucker,L,BUF,32,68,17,20,37
83,8476292,Ondrej Palat,L,NJD,33,71,16,21,37
83,8474716,Jared Spurgeon,D,MIN,35,81,16,21,37
83,8475218,Mattias Ekholm,D,EDM,34,71,10,27,37
83,8480434,Sean Durzi,D,UTA,26,67,9,28,37
83,8474053,Logan Couture,C,SJS,35,69,9,28,37
83,8476869,Brady Skjei,D,NSH,30,67,8,29,37
83,8477948,Travis Sanheim,D,PHI,28,73,8,29,37
83,8481546,Cam York,D,PHI,23,69,6,31,37
83,8474563,Drew Doughty,D,LAK,35,68,5,32,37
83,8475764,Cam Fowler,D,ANA,33,72,3,34,37
83,8481554,Kaapo Kakko,R,NYR,23,71,19,17,36
83,8478046,Danton Heinen,L,VAN,29,69,18,18,36
83,8479345,Jakob Chychrun,D,WSH,26,65,15,21,36
83,8480009,Eeli Tolvanen,R,SEA,25,73,14,22,36
83,8477346,MacKenzie Weegar,D,CGY,30,75,13,23,36
83,8478466,Daniel Sprong,R,VAN,27,71,13,23,36
83,8477505,Alexander Wennberg,C,SJS,30,71,11,25,36
83,8482122,Brock Faber,D,MIN,22,79,10,26,36
83,8477969,Marcus Pettersson,D,PIT,28,79,5,31,36
83,8470613,Brent Burns,D,CAR,39,77,3,33,36
83,8480797,Joel Farabee,L,PHI,24,71,16,19,35
83,8482055,Drew O'Connor,L,PIT,26,66,16,19,35
83,8476880,Tom Wilson,R,WSH,30,72,13,22,35
83,8483505,Matthew Poitras,C,BOS,20,74,9,26,35
83,8482624,Daniil Miromanov,D,CGY,27,61,8,27,35
83,8482671,Owen Power,D,BUF,22,66,6,29,35
83,8480145,Neal Pionk,D,WPG,29,72,6,29,35
83,8475760,Nick Bjugstad,C,UTA,32,74,21,13,34
83,8480893,Kirill Marchenko,R,CBJ,24,69,19,15,34
83,8477450,Jason Dickinson,C,CHI,29,59,18,16,34
83,8478057,Dakota Joshua,C,VAN,28,68,13,21,34
83,8478413,Jordan Greenway,L,BUF,27,59,10,24,34
83,8481606,Jordan Spence,D,LAK,23,66,4,30,34
83,8482125,Alexander Holtz,R,VGK,22,72,20,13,33
83,8477426,Nicholas Paul,L,TBL,29,80,18,15,33
83,8475314,Anders Lee,L,NYI,34,77,18,15,33
83,8478891,Mason Appleton,C,WPG,28,63,18,15,33
83,8476981,Josh Anderson,R,MTL,30,70,15,18,33
83,8480459,Pius Suter,C,VAN,28,72,13,20,33
83,8480078,Filip Chytil,C,NYR,25,69,12,21,33
83,8479365,Trent Frederic,C,BOS,26,78,11,22,33
83,8481524,Bowen Byram,D,BUF,23,66,9,24,33
83,8477494,Jonathan Drouin,L,COL,29,81,5,28,33
83,8478463,Anthony Beauvillier,L,PIT,27,61,19,13,32
83,8477953,Kasperi Kapanen,R,STL,28,67,17,15,32
83,8480068,Ryan Poehling,C,PHI,25,75,17,15,32
83,8481186,Logan O'Connor,R,COL,28,81,16,16,32
83,8471698,T.J. Oshie,R,WSH,38,72,15,17,32
83,8477220,Nate Schmidt,D,FLA,33,68,12,20,32
83,8476462,Dougie Hamilton,D,NJD,31,70,8,24,32
83,8474565,Alex Pietrangelo,D,VGK,34,54,8,24,32
83,8478508,Yakov Trenin,C,MIN,27,58,20,11,31
83,8476897,Oskar Sundqvist,C,STL,30,62,15,16,31
83,8484145,Zach Benson,L,BUF,19,69,14,17,31
83,8482149,Cole Perfetti,C,WPG,22,63,13,18,31
83,8476458,Ryan Strome,C,ANA,31,69,11,20,31
83,8481577,Philip Tomasino,C,NSH,23,67,11,20,31
83,8479591,Michael Eyssimont,C,TBL,28,81,11,20,31
83,8475763,Kevin Hayes,R,PIT,32,68,9,22,31
83,8476480,Vladislav Namestnikov,C,WPG,32,64,8,23,31
83,8478038,Devon Toews,D,COL,30,59,4,27,31
83,8478970,Jalen Chatfield,D,CAR,28,67,3,28,31
83,8477478,William Carrier,L,CAR,30,61,16,14,30
83,8479390,Taylor Raddysh,R,WSH,26,56,15,15,30
83,8481656,Aliaksei Protas,C,WSH,23,66,13,17,30
83,8484203,Bradly Nadeau,L,CAR,19,54,9,21,30
83,8476463,Jonas Brodin,D,MIN,31,80,8,22,30
83,8476902,Esa Lindell,D,DAL,30,76,7,23,30
83,8477506,Ryan Pulock,D,NYI,30,74,2,28,30
83,8480220,Noah Cates,L,PHI,25,73,16,13,29
83,8475714,Calle Jarnkrok,C,TOR,33,72,13,16,29
83,8480798,Philipp Kurashev,C,CHI,25,56,10,19,29
83,8483490,Pavel Mintyukov,D,ANA,21,68,9,20,29
83,8482087,Kaiden Guhle,D,MTL,22,65,9,20,29
83,8481582,Nicholas Robertson,L,TOR,23,68,19,9,28
83,8479661,Tanner Jeannot,L,LAK,27,75,18,10,28
83,8477425,Miles Wood,L,COL,29,77,16,12,28
83,8481093,Rafael Harvey-Pinard,L,MTL,25,64,16,12,28
83,8483491,Ivan Miroshnichenko,L,WSH,20,49,14,14,28
83,8480762,Eric Robinson,L,CAR,29,59,13,15,28
83,8482667,William Eklund,L,SJS,22,67,12,16,28
83,8479996,Cody Glass,C,NSH,25,65,11,17,28
83,8476419,Jean-Gabriel Pageau,C,NYI,32,77,8,20,28
83,8478434,Keegan Kolesar,R,VGK,27,67,7,21,28
83,8480336,Sean Walker,D,CAR,30,71,7,21,28
83,8478507,John Marino,D,UTA,27,67,6,22,28
83,8478911,Matt Roy,D,WSH,29,68,6,22,28
83,8478500,Ivan Provorov,D,CBJ,27,80,3,25,28
83,8481535,Nils Hoglander,L,VAN,24,61,18,9,27
83,8477353,Tyler Motte,C,DET,29,78,16,11,27
83,8482146,Luke Evangelista,R,NSH,22,72,14,13,27
83,8477952,Robby Fabbri,C,ANA,28,57,14,13,27
83,8478233,Andrew Mangiapane,L,WSH,28,67,13,14,27
83,8473533,Jordan Staal,C,CAR,36,63,13,14,27
83,8474189,Lars Eller,C,PIT,35,69,13,14,27
83,8476988,Matt Benning,D,SJS,30,68,11,16,27
83,8481624,Ilya Mikheyev,R,CHI,30,66,10,17,27
83,8476931,Jake McCabe,D,TOR,31,73,7,20,27
83,8477989,Christian Dvorak,C,MTL,28,67,6,21,27
83,8479619,Michael Carcone,L,UTA,28,64,20,6,26
83,8476461,Sean Couturier,C,PHI,32,72,15,11,26
83,8478020,Michael Amadio,R,OTT,28,71,14,12,26
83,8480113,Alex Iafallo,L,WPG,31,73,13,13,26
83,8480849,Barrett Hayton,C,UTA,24,70,12,14,26
83,8479351,Sam Steel,C,DAL,26,77,11,15,26
83,8481553,Bobby Brink,R,PHI,23,54,11,15,26
83,8480003,Jesper Boqvist,C,FLA,26,70,11,15,26
83,8473563,Nicklas Backstrom,C,WSH,37,64,10,16,26
83,8483468,Jiri Kulich,C,BUF,20,61,8,18,26
83,8481522,Peyton Krebs,C,BUF,23,59,7,19,26
83,8476917,Adam Pelech,D,NYI,30,78,4,22,26
83,8479976,Juuso Valimaki,D,UTA,26,65,2,24,26
83,8470621,Corey Perry,R,EDM,39,72,14,11,25
83,8480205,Emil Bemstrom,C,PIT,25,64,13,12,25
83,8478133,Jake Evans,C,MTL,28,60,12,13,25
83,8477015,Connor Brown,R,EDM,30,63,12,13,25
83,8482074,Connor Zary,C,CGY,23,57,12,13,25
83,8480289,Morgan Barron,C,WPG,26,59,10,15,25
83,8481704,Juuso Parssinen,C,NSH,23,53,7,18,25
83,8481523,Kirby Dach,C,MTL,23,70,5,20,25
83,8479293,Brandon Tanev,L,SEA,33,65,15,9,24
83,8474715,Cameron Atkinson,R,TBL,35,80,12,12,24
83,8482117,Lukas Reichel,L,CHI,22,63,12,12,24
83,8479941,Justin Danforth,R,CBJ,31,57,11,13,24
83,8476925,Colton Sissons,C,NSH,31,63,10,14,24
83,8476921,Jordan Martinook,L,CAR,32,60,10,14,24
83,8476960,Andreas Athanasiou,C,CHI,30,50,10,14,24
83,8480802,Ryan McLeod,C,BUF,25,60,9,15,24
83,8476927,Teddy Blueger,C,VAN,30,65,8,16,24
83,8476469,Joel Armia,R,MTL,31,66,8,16,24
83,8482101,Danil Gushchin,L,SJS,22,54,7,17,24
83,8479998,Mikey Anderson,D,LAK,25,64,7,17,24
83,8476892,Colton Parayko,D,STL,31,68,4,20,24
83,8476457,Adam Larsson,D,SEA,32,69,3,21,24
83,8475208,Brian Dumoulin,D,ANA,33,70,2,22,24
83,8477947,Sonny Milano,L,WSH,28,63,11,12,23
83,8473422,Nick Foligno,L,CHI,37,64,9,14,23
83,8480871,Adam Boqvist,D,FLA,24,61,8,15,23
83,8476856,Mathew Dumba,D,DAL,30,65,7,16,23
83,8476467,Jamie Oleksiak,D,SEA,32,74,4,19,23
83,8476979,Erik Gustafsson,D,DET,32,77,3,20,23
83,8478840,Will Borgen,D,SEA,28,68,2,21,23
83,8475188,Brayden McNabb,D,VGK,33,59,2,21,23
83,8480043,Timothy Liljegren,D,TOR,25,69,1,22,23
83,8478013,Jake Walman,D,SJS,28,74,12,10,22
83,8479393,Noah Gregor,L,OTT,26,70,12,10,22
83,8482809,Jackson Blake,R,CAR,21,60,12,10,22
83,8480813,Joe Veleno,C,DET,24,76,11,11,22
83,8475149,Marcus Johansson,L,MIN,34,59,10,12,22
83,8479414,Nathan Bastian,R,NJD,27,66,10,12,22
83,8480980,Connor Dewar,C,TOR,25,62,10,12,22
83,8480835,Jack Drury,C,CAR,24,62,9,13,22
83,8481032,Paul Cotter,C,NJD,25,58,9,13,22
83,8477508,Curtis Lazar,C,NJD,29,58,7,15,22
83,8482749,Joshua Roy,R,MTL,21,70,7,15,22
83,8475171,Oliver Ekman-Larsson,D,TOR,33,67,5,17,22
83,8473507,Jeff Petry,D,DET,37,71,5,17,22
83,8476879,Cody Ceci,D,EDM,31,69,5,17,22
83,8480878,Nils Lundkvist,D,DAL,24,69,5,17,22
83,8480073,Erik Brannstrom,D,COL,25,65,4,18,22
83,8478851,Alexandre Carrier,D,NSH,28,65,4,18,22
83,8479402,Jake Bean,D,CGY,26,72,3,19,22
83,8481568,Alex Vlasic,D,CHI,23,55,2,20,22
83,8474151,Ryan McDonagh,D,TBL,35,75,1,21,22
83,8477446,Michael McCarron,R,NSH,29,50,13,8,21
83,8480448,Parker Kelly,L,COL,25,77,11,10,21
83,8483499,Liam Ohgren,L,MIN,20,62,11,10,21
83,8476374,Sean Kuraly,C,CBJ,31,57,10,11,21
83,8475791,Taylor Hall,L,CHI,33,54,9,12,21
83,8483524,Shane Wright,C,SEA,20,64,9,12,21
83,8480144,David Kampf,C,TOR,29,68,8,13,21
83,8479316,Luke Kunin,C,SJS,27,57,8,13,21
83,8478432,Christian Fischer,R,DET,27,71,8,13,21
83,8480855,Jack McBain,C,UTA,24,71,7,14,21
83,8479315,Joey Anderson,R,CHI,26,48,6,15,21
83,8479980,Nicolas Hague,D,VGK,26,54,5,16,21
83,8475181,Nick Leddy,D,STL,33,64,4,17,21
83,8476331,Dylan DeMelo,D,WPG,31,73,4,17,21
83,8477488,Brett Pesce,D,NJD,30,67,3,18,21
83,8479398,Samuel Girard,D,COL,26,67,1,20,21
83,8480848,Ty Dellandrea,C,SJS,24,45,15,5,20
83,8482079,Marco Rossi,C,MIN,23,56,13,7,20
83,8483445,Cutter Gauthier,L,ANA,20,66,12,8,20
83,8479353,Brett Howden,C,VGK,26,59,12,8,20
83,8481716,Dmitri Voronkov,L,CBJ,24,50,12,8,20
83,8481641,Joel Kiviranta,L,COL,28,71,11,9,20
83,8483457,Lane Hutson,D,MTL,20,61,8,12,20
83,8483493,Frank Nazar,C,CHI,20,46,8,12,20
83,8482166,Shakir Mukhamadullin,D,SJS,22,52,8,12,20
83,8474034,Patrick Maroon,L,CHI,36,54,6,14,20
83,8476312,Josh Manson,D,COL,33,65,6,14,20
83,8478882,Vladislav Gavrikov,D,LAK,29,64,4,16,20
83,8482655,Janis Moser,D,TBL,24,76,4,16,20
83,8474574,Tyler Myers,D,VAN,34,64,3,17,20
83,8477839,Conor Sheary,L,TBL,32,81,11,8,19
83,8475343,Nic Dowd,C,WSH,34,58,10,9,19
83,8476918,Jimmy Vesey,L,NYR,31,64,10,9,19
83,8480995,Pontus Holmberg,R,TOR,25,68,9,10,19
83,8475220,Marcus Foligno,L,MIN,33,61,8,11,19
83,8476889,Radek Faksa,C,STL,30,57,8,11,19
83,8482111,Justin Barron,D,MTL,23,73,8,11,19
83,8481019,David Gustafsson,C,WPG,24,37,7,12,19
83,8480192,Johnathan Kovacevic,D,NJD,27,59,7,12,19
83,8475200,Dmitry Orlov,D,CAR,33,76,5,14,19
83,8477507,Nikita Zadorov,D,BOS,29,63,5,14,19
83,8481521,Ronnie Attard,D,PHI,25,55,5,14,19
83,8476422,Mike Reilly,D,NYI,31,77,4,15,19
83,8477931,Tomas Nosek,L,FLA,32,62,4,15,19
83,8470600,Ryan Suter,D,STL,39,62,4,15,19
83,8479371,Dante Fabbro,D,NSH,26,62,2,17,19
83,8480807,Mattias Samuelsson,D,BUF,24,57,1,18,19
83,8480049,Dylan Samberg,D,WPG,25,61,1,18,19
83,8480222,Sebastian Aho,D,PIT,28,72,1,18,19
83,8478043,Sam Lafferty,C,BUF,29,53,11,7,18
83,8477903,Garnet Hathaway,R,PHI,33,59,10,8,18
83,8475855,Jesper Fast,R,CAR,33,59,9,9,18
83,8482737,Zack Bolduc,C,STL,21,60,9,9,18
83,8481028,Martin Pospisil,C,CGY,25,55,9,9,18
83,8475231,Casey Cizikas,C,NYI,33,76,8,10,18
83,8483482,Tristan Luneau,D,ANA,20,64,7,11,18
83,8473453,Trevor Lewis,C,LAK,37,76,6,12,18
83,8482192,Isaak Phillips,D,CHI,23,59,5,13,18
83,8484149,Gavin Brindley,C,CBJ,20,44,5,13,18
83,8475790,Erik Gudbranson,D,CBJ,32,77,4,14,18
83,8480246,Nick Perbix,D,TBL,26,70,3,15,18
83,8478136,Jake Middleton,D,MIN,28,72,3,15,18
83,8480873,Rasmus Sandin,D,WSH,24,61,2,16,18
83,8474673,TJ Brodie,D,CHI,34,58,2,16,18
83,8477845,Trevor van Riemsdyk,D,WSH,33,62,2,16,18
83,8480891,Michael Kesselring,D,UTA,24,58,1,17,18
83,8476525,Colin Miller,D,WPG,32,60,1,17,18
83,8481601,Simon Holmstrom,R,NYI,23,70,10,7,17
83,8479066,Ryan Lomberg,L,CGY,30,65,10,7,17
83,8479328,Julien Gauthier,R,NYI,27,67,10,7,17
83,8482062,Cole Smith,L,NSH,29,55,7,10,17
83,8479369,Andrew Peeke,D,BOS,26,60,6,11,17
83,8478109,Victor Olofsson,L,VGK,29,64,5,12,17
83,8478452,Caleb Jones,D,LAK,27,61,5,12,17
83,8480035,Henri Jokiharju,D,BUF,25,60,4,13,17
83,8481527,Kaedan Korczak,D,VGK,23,45,4,13,17
83,8482245,Artem Zub,D,OTT,29,65,4,13,17
83,8476429,Scott Mayfield,D,NYI,32,73,4,13,17
83,8475462,Radko Gudas,D,ANA,34,62,3,14,17
83,8481178,Egor Zamula,D,PHI,24,50,3,14,17
83,8475179,Dmitry Kulikov,D,FLA,34,59,2,15,17
83,8479982,Conor Timmins,D,TOR,26,59,2,15,17
83,8477435,Ryan Graves,D,PIT,29,76,2,15,17
83,8482142,Jamie Drysdale,D,PHI,22,61,2,15,17
83,8477365,Connor Clifton,D,BUF,29,50,2,15,17
83,8480727,Zach Whitecloud,D,VGK,28,51,2,15,17
83,8474612,Travis Hamonic,D,OTT,34,48,2,15,17
83,8481014,Alexander Romanov,D,NYI,24,72,1,16,17
83,8478831,Kevin Stenlund,C,UTA,28,48,12,4,16
83,8476878,Zemgus Girgensons,C,TBL,30,79,10,6,16
83,8481580,Connor McMichael,C,WSH,23,61,7,9,16
83,8481477,Nico Sturm,C,SJS,29,54,7,9,16
83,8476934,Brock McGinn,L,ANA,30,50,7,9,16
83,8481441,Joe Snively,C,DET,28,59,6,10,16
83,8480021,Jack Studnicka,C,LAK,25,55,6,10,16
83,8480860,Kevin Bahl,D,CGY,24,55,6,10,16
83,8475324,Nick Jensen,D,OTT,34,60,4,12,16
83,8478451,Ethan Bear,D,WSH,27,54,4,12,16
83,8480789,Oliver Wahlstrom,R,NYI,24,65,4,12,16
83,8482073,Braden Schneider,D,NYR,23,67,4,12,16
83,8482451,Mikael Pyyhtia,L,CBJ,23,54,4,12,16
83,8479348,Kale Clague,D,BUF,26,38,4,12,16
83,8480796,Martin Fehervary,D,WSH,25,54,4,12,16
83,8474090,Brendan Smith,D,DAL,35,58,4,12,16
83,8480172,Jan Rutta,D,SJS,34,61,3,13,16
83,8479370,Tyson Jost,C,CAR,26,50,11,4,15
83,8481013,Jonatan Berggren,R,DET,24,62,9,6,15
83,8483565,Nick Blankenburg,D,NSH,26,62,6,9,15
83,8477573,Nathan Walker,L,STL,30,52,6,9,15
83,8482259,Bobby McMann,C,TOR,28,57,5,10,15
83,8479639,Dylan Coghlan,D,WPG,26,67,5,10,15
83,8477919,Frederick Gaudreau,C,MIN,31,63,5,10,15
83,8482067,Connor Mackey,D,NYR,28,68,5,10,15
83,8479291,Kevin Rooney,C,CGY,31,54,5,10,15
83,8478416,Erik Cernak,D,TBL,27,72,4,11,15
83,8479983,Mario Ferraro,D,SJS,26,60,2,13,15
83,8475233,David Savard,D,MTL,34,65,1,14,15
83,8480001,Urho Vaakanainen,D,ANA,25,59,1,14,15
83,8477499,Rasmus Ristolainen,D,PHI,30,64,1,14,15
83,8477482,Zachary Sanford,L,CHI,30,42,10,4,14
83,8482679,Matt Coronato,R,CGY,22,61,9,5,14
83,8482157,Will Cuylle,L,NYR,22,58,9,5,14
83,8476278,Colin Blackwell,C,DAL,31,76,8,6,14
83,8479359,Beck Malenstyn,L,BUF,26,55,8,6,14
83,8480748,Kiefer Sherwood,L,VAN,29,60,7,7,14
83,8477979,Nicolas Aube-Kubel,R,BUF,28,62,7,7,14
83,8482148,Hendrix Lapierre,C,WSH,22,52,6,8,14
83,8477887,Patrick Brown,C,BOS,32,49,6,8,14
83,8477369,Carson Soucy,D,VAN,30,64,5,9,14
83,8476329,Travis Boyd,C,MIN,31,58,4,10,14
83,8475718,Justin Holl,D,DET,32,56,4,10,14
83,8478443,Brandon Carlo,D,BOS,28,53,2,12,14
83,8475690,Chris Tanev,D,TOR,35,66,1,13,14
83,8477018,Ben Hutton,D,VGK,31,45,9,4,13
83,8477392,Hudson Fasching,R,NYI,29,62,8,5,13
83,8479344,Jesse Puljujarvi,R,PIT,26,53,8,5,13
83,8481517,Brett Leason,R,ANA,25,51,7,6,13
83,8482807,Ethan Del Mastro,D,CHI,21,45,6,7,13
83,8479520,Brandon Duhaime,R,WSH,27,60,6,7,13
83,8480011,Klim Kostin,C,SJS,25,42,6,7,13
83,8481789,Tye Kartye,L,SEA,23,47,6,7,13
83,8481617,Vasily Podkolzin,R,VAN,23,44,6,7,13
83,8481532,Alex Turcotte,C,LAK,23,46,5,8,13
83,8477070,Liam O'Brien,C,UTA,30,57,4,9,13
83,8479442,Troy Stecher,D,EDM,30,55,4,9,13
83,8481481,Blake Lizotte,C,PIT,27,59,3,10,13
83,8481550,Adam Beckman,L,NJD,23,36,3,10,13
83,8476891,Matthew Grzelcyk,D,PIT,30,73,2,11,13
83,8480806,Isac Lundestrom,C,ANA,25,60,2,11,13
83,8478178,Darren Raddysh,D,TBL,28,70,1,12,13
83,8481708,Zac Jones,D,NYR,24,48,1,12,13
83,8476967,Brett Kulak,D,EDM,30,62,1,12,13
83,8480025,MacKenzie Entwistle,R,FLA,25,61,10,2,12
83,8482762,Simon Edvinsson,D,DET,21,55,9,3,12
83,8478424,Jansen Harkins,C,ANA,27,40,9,3,12
83,8481537,Nikita Okhotiuk,D,CGY,24,60,6,6,12
83,8478569,Noel Acciari,C,PIT,33,52,6,6,12
83,8482803,Olen Zellweger,D,ANA,21,63,6,6,12
83,8483495,Simon Nemec,D,NJD,20,52,6,6,12
83,8479368,Max Jones,L,BOS,26,63,6,6,12
83,8482730,Brandt Clarke,D,LAK,21,49,6,6,12
83,8480355,Mark Kastelic,C,BOS,25,56,5,7,12
83,8482744,James Malatesta,L,CBJ,21,40,5,7,12
83,8480281,Alexey Toropchenko,R,STL,25,51,4,8,12
83,8480252,Cole Guttman,C,CHI,25,37,4,8,12
83,8479372,Joshua Mahura,D,SEA,26,48,3,9,12
83,8477938,Haydn Fleury,D,WPG,28,41,3,9,12
83,8478585,Derek Ryan,C,EDM,38,65,3,9,12
83,8481599,Victor Soderstrom,D,UTA,23,42,3,9,12
83,8471709,Marc-Edouard Vlasic,D,SJS,37,59,2,10,12
83,8481059,Scott Perunovich,D,STL,26,66,1,11,12
83,8479324,Ryan Lindgren,D,NYR,26,56,1,11,12
83,8478468,Jeremy Lauzon,D,NSH,27,56,1,11,12
83,8475455,Brenden Dillon,D,NJD,34,61,1,11,12
83,8478399,Jonas Siegenthaler,D,NJD,27,61,0,12,12
83,8473446,Erik Johnson,D,PHI,36,53,0,12,12
83,8480074,Alexandre Texier,C,STL,25,53,8,3,11
83,8482659,Josh Doan,R,UTA,22,55,7,4,11
83,8471817,Ryan Reaves,R,TOR,37,61,7,4,11
83,8480845,Rasmus Kupari,C,WPG,24,43,6,5,11
83,8475225,Craig Smith,C,CHI,35,53,6,5,11
83,8482155,Alex Laferriere,R,LAK,23,58,5,6,11
83,8475279,Ben Chiarot,D,DET,33,63,5,6,11
83,8482077,Dylan Holloway,L,EDM,23,50,5,6,11
83,8479439,Jacob MacDonald,D,COL,31,51,5,6,11
83,8480441,Trey Fix-Wolansky,R,CBJ,25,34,5,6,11
83,8476442,Matt Nieto,L,PIT,32,51,5,6,11
83,8479718,Alex Barré-Boulet,C,MTL,27,52,5,6,11
83,8481600,Tobias Bjornfot,D,FLA,23,40,5,6,11
83,8479543,Michael Pezzetta,L,MTL,26,55,4,7,11
83,8478859,Niko Mikkola,D,FLA,28,52,4,7,11
83,8480887,Jordan Harris,D,MTL,24,50,4,7,11
83,8476952,Dominic Toninato,C,WPG,30,25,4,7,11
83,8479671,Mathieu Olivier,R,CBJ,27,42,3,8,11
83,8481161,Jake Christiansen,D,CBJ,25,52,2,9,11
83,8480196,Jacob Bryson,D,BUF,27,49,1,10,11
83,8484254,Akito Hirose,D,VAN,25,35,1,10,11
83,8476822,Luke Glendening,C,TBL,35,75,6,4,10
83,8482713,Mackie Samoskevich,R,FLA,22,39,6,4,10
83,8481147,Reese Johnson,C,MIN,26,37,6,4,10
83,8479336,Carl Grundstrom,R,SJS,27,48,4,6,10
83,8482145,Mavrik Bourque,C,DAL,22,55,4,6,10
83,8474568,Luke Schenn,D,NSH,35,46,4,6,10
83,8479944,Zach Aston-Reese,C,VGK,30,46,4,6,10
83,8483549,Lucas Condotta,L,MTL,27,32,4,6,10
83,8484911,Collin Graf,R,SJS,22,44,4,6,10
83,8482859,Zack Ostapchuk,C,OTT,21,54,3,7,10
83,8476441,Joel Edmundson,D,LAK,31,38,3,7,10
83,8479968,Vinni Lettieri,C,BOS,29,47,2,8,10
83,8480007,Jonas Rondbjerg,R,VGK,25,39,2,8,10
83,8482634,Alex Steeves,C,TOR,25,52,2,8,10
83,8476913,Devin Shore,C,MIN,30,37,2,8,10
83,8477034,Jaycob Megna,D,FLA,32,50,2,8,10
83,8478450,Parker Wotherspoon,D,BOS,27,29,1,9,10
83,8482747,Brennan Othmann,L,NYR,21,39,1,9,10
83,8476874,Olli Maatta,D,DET,30,65,1,9,10
83,8475177,Calvin de Haan,D,COL,33,45,0,10,10
83,8475842,Sam Carrick,C,NYR,32,55,6,3,9
83,8476873,Mark Jankowski,C,NSH,30,44,5,4,9
83,8479994,Jaret Anderson-Dolan,C,WPG,25,37,5,4,9
83,8478211,Dryden Hunt,L,CGY,29,49,4,5,9
83,8483466,Kevin Korchinski,D,CHI,20,54,4,5,9
83,8477406,Mattias Janmark,C,EDM,32,57,3,6,9
83,8482095,Tyler Kleven,D,OTT,22,49,3,6,9
83,8482964,Arber Xhekaj,D,MTL,23,45,3,6,9
83,8479378,Logan Stanley,D,WPG,26,44,3,6,9
83,8478146,Matthew Highmore,C,OTT,28,33,3,6,9
83,8481701,Santeri Hatakka,D,NJD,23,36,3,6,9
83,8483763,Maksymilian Szuber,D,UTA,22,36,3,6,9
83,8482511,Mason Lohrei,D,BOS,23,41,3,6,9
83,8481167,Brayden Pachal,D,CGY,25,37,2,7,9
83,8475750,Jon Merrill,D,MIN,32,62,2,7,9
83,8474567,Zach Bogosian,D,MIN,34,60,2,7,9
83,8480950,Ilya Lyubushkin,D,DAL,30,63,1,8,9
83,8477962,Brendan Lemieux,L,CAR,28,38,1,8,9
83,8480157,Calle Rosen,D,COL,30,49,1,8,9
83,8476994,Vinnie Hinostroza,C,NSH,30,41,0,9,9
83,8477380,Jonny Brodzinski,C,NYR,31,53,5,3,8
83,8479772,Zack MacEwen,R,OTT,28,47,4,4,8
83,8479638,Justin Brazeau,R,BOS,26,38,4,4,8
83,8479536,Axel Jonsson-Fjallby,L,WPG,26,36,3,5,8
83,8480292,Carson Meyer,R,ANA,27,31,3,5,8
83,8475762,Derek Forbort,D,VAN,32,40,3,5,8
83,8481751,Lukas Rousek,R,BUF,25,43,2,6,8
83,8482733,Logan Mailloux,D,MTL,31,40,2,6,8
83,8478017,Mark Friedman,D,VAN,29,44,2,6,8
83,8474013,Ian Cole,D,UTA,35,55,1,7,8
83,8480879,Jacob Bernard-Docker,D,OTT,24,47,1,7,8
83,8474166,Alec Martinez,D,CHI,37,49,1,7,8
83,8477384,Joshua Brown,D,EDM,30,45,0,8,8
83,8481518,Nolan Foote,L,NJD,24,36,5,2,7
83,8478421,A.J. Greer,L,FLA,28,58,4,3,7
83,8478881,Brett Seney,L,CHI,28,14,4,3,7
83,8483630,Pavol Regenda,L,ANA,25,24,3,4,7
83,8483570,Ben Meyers,C,SEA,26,32,3,4,7
83,8479981,Jonah Gadjovich,L,FLA,26,43,3,4,7
83,8482144,Jack Thompson,D,SJS,22,30,3,4,7
83,8482666,Scott Morrow,D,CAR,22,51,2,5,7
83,8481567,Henry Thrun,D,SJS,23,47,2,5,7
83,8480070,Ian Mitchell,D,BOS,25,50,2,5,7
83,8480880,Jakub Lauko,C,MIN,24,28,1,6,7
83,8481754,Nikita Nesterenko,C,ANA,23,40,6,0,6
83,8476858,Phillip Di Giuseppe,L,VAN,31,45,4,2,6
83,8476372,Nick Seeler,D,PHI,31,42,4,2,6
83,8476867,Brendan Gaunce,C,MIN,30,29,4,2,6
83,8475235,Nicolas Deslauriers,L,PHI,33,46,4,2,6
83,8479985,Cale Fleury,D,SEA,26,22,4,2,6
83,8481598,Philip Broberg,D,EDM,23,41,3,3,6
83,8482070,Mitchell Chaffee,R,TBL,26,55,3,3,6
83,8482765,Isak Rosen,R,BUF,21,26,3,3,6
83,8482141,Lukas Cormier,D,VGK,22,24,3,3,6
83,8480058,Pierre-Olivier Joseph,D,STL,25,50,2,4,6
83,8481679,Maxence Guenette,D,OTT,23,38,2,4,6
83,8478454,Noah Juulsen,D,VAN,27,39,2,4,6
83,8481556,John Beecher,C,BOS,23,34,2,4,6
83,8481743,Marc Del Gaizo,D,NSH,25,29,2,4,6
83,8471677,Jack Johnson,D,CBJ,37,66,1,5,6
83,8482176,Wyatt Kaiser,D,CHI,22,51,0,6,6
83,8479991,Jake Leschyshyn,C,NYR,25,30,0,6,6
83,8483397,Marc McLaughlin,C,BOS,25,29,4,1,5
83,8481592,Jakob Pelletier,L,CGY,23,46,3,2,5
83,8483012,Logan Morrison,C,SEA,22,26,3,2,5
83,8476624,Barclay Goodrow,C,SJS,31,52,2,3,5
83,8481122,Simon Benoit,D,TOR,26,33,2,3,5
83,8478409,Anthony Richard,C,PHI,28,25,2,3,5
83,8481609,Vladislav Kolyachonok,D,UTA,23,37,2,3,5
83,8479972,Mason Shaw,C,WPG,26,32,2,3,5
83,8477401,John Hayden,C,SEA,29,37,2,3,5
83,8476473,Connor Murphy,D,CHI,31,37,2,3,5
83,8481422,Jake Lucchini,C,NSH,29,26,2,3,5
83,8482496,Nils Aman,C,VAN,24,31,1,4,5
83,8482652,Walker Duehr,R,CGY,27,41,1,4,5
83,8477851,Jordan Oesterle,D,BOS,32,44,1,4,5
83,8477810,Joel Hanley,D,CGY,33,25,1,4,5
83,8481605,Jackson LaCombe,D,ANA,23,34,1,4,5
83,8478874,Adam Gaudette,R,OTT,28,35,0,5,5
83,8480834,Ty Emberson,D,SJS,24,41,0,5,5
83,8482153,Brendan Brisson,C,VGK,23,30,0,5,5
83,8479249,Andrew Poturalski,C,SJS,30,25,0,5,5
83,8480870,Bo Groulx,C,NYR,24,29,0,5,5
83,8478502,Dennis Gilbert,D,BUF,28,15,0,5,5
83,8479986,Kole Lind,R,DAL,26,44,0,5,5
83,8477335,Kyle Burroughs,D,LAK,29,40,3,1,4
83,8482861,Vincent Iorio,D,WSH,22,25,3,1,4
83,8478446,Glenn Gawdin,C,LAK,27,23,3,1,4
83,8482784,Zach Dean,C,STL,21,40,2,2,4
83,8484258,Sam Malinski,D,COL,26,23,2,2,4
83,8484287,Cole McWard,D,VAN,23,21,2,2,4
83,8481719,Maxwell Crozier,D,TBL,24,17,2,2,4
83,8483460,David Jiricek,D,CBJ,21,59,1,3,4
83,8477467,Gustav Olofsson,D,SEA,30,20,1,3,4
83,8483619,Filip Roos,D,OTT,25,36,1,3,4
83,8477462,Robert Hagg,D,VGK,29,28,1,3,4
83,8482172,Landon Slaggert,L,CHI,22,21,1,3,4
83,8481462,Mason Morelli,L,VGK,28,19,1,3,4
83,8477320,Anton Blidh,L,NYR,29,24,1,3,4
83,8481543,Nikita Alexandrov,C,STL,24,35,0,4,4
83,8477473,Justin Bailey,R,SJS,29,23,3,0,3
83,8475413,Justin Dowling,C,NJD,34,16,3,0,3
83,8480844,Grigori Denisenko,L,VGK,24,33,2,1,3
83,8477527,Ross Johnston,L,ANA,30,36,2,1,3
83,8480267,Sammy Walker,C,MIN,25,21,2,1,3
83,8482751,Ryan Winterton,C,SEA,21,32,2,1,3
83,8482102,Vasily Ponomarev,C,PIT,22,18,2,1,3
83,8479026,Philippe Myers,D,TOR,27,43,1,2,3
83,8482147,Jean-Luc Foudy,C,COL,22,28,1,2,3
83,8481593,Jayden Struble,D,MTL,23,22,1,2,3
83,8479576,Vincent Desharnais,D,VAN,28,33,1,2,3
83,8482470,Ilya Solovyov,D,CGY,24,23,1,2,3
83,8479362,Riley Tufte,L,BOS,26,23,1,2,3
83,8481206,John Ludvig,D,PIT,24,10,1,2,3
83,8482858,Ryker Evans,D,SEA,23,23,0,3,3
83,8481585,Egor Afanasyev,L,SJS,23,15,0,3,3
83,8481564,Ryan Johnson,D,BUF,23,18,0,3,3
83,8482094,Daemon Hunt,D,MIN,22,17,0,3,3
83,8482201,Gage Goncalves,C,TBL,23,19,2,0,2
83,8483567,Georgii Merkulov,C,BOS,24,11,2,0,2
83,8480990,Declan Chisholm,D,MIN,24,30,1,1,2
83,8479379,Givani Smith,R,SJS,26,24,1,1,2
83,8483489,Fraser Minten,C,TOR,31,12,1,1,2
83,8482118,Sam Colangelo,R,ANA,23,19,1,1,2
83,8475958,Michael Sgarbossa,C,WSH,32,24,1,1,2
83,8482250,Callahan Burke,C,VGK,27,21,1,1,2
83,8481006,Tyler Tucker,D,STL,24,15,1,1,2
83,8478051,Max Willman,C,NJD,29,16,1,1,2
83,8482165,Yan Kuznetsov,D,CGY,22,13,1,1,2
83,8481699,Aku Raty,R,UTA,23,16,1,1,2
83,8480306,Grant Hutton,D,NYI,29,15,1,1,2
83,8484304,Uvis Balinskis,D,FLA,28,13,1,1,2
83,8478021,William Lagesson,D,DET,28,30,0,2,2
83,8477244,Chad Ruhwedel,D,NYR,34,33,0,2,2
83,8479587,Rhett Gardner,C,PHI,28,22,0,2,2
83,8482177,Marat Khusnutdinov,C,MIN,22,31,0,2,2
83,8477149,Scott Sabourin,R,SJS,32,19,0,2,2
83,8481237,Kyle MacLean,C,NYI,25,21,0,2,2
83,8479320,Maxime Lajoie,D,SEA,27,20,0,2,2
83,8477971,Andreas Englund,D,LAK,28,33,0,2,2
83,8479419,Brett Murray,L,BUF,26,19,0,2,2
83,8480851,Akil Thomas,C,LAK,24,15,0,2,2
83,8479367,William Lockwood,R,FLA,26,21,0,2,2
83,8482088,Justin Sourdif,R,FLA,22,14,0,2,2
83,8484325,Waltteri Merela,C,TBL,26,25,0,2,2
83,8481056,Spencer Stastney,D,NSH,24,32,1,0,1
83,8481043,Cole Koepke,L,BOS,26,10,1,0,1
83,8481541,Samuel Bolduc,D,NYI,24,22,1,0,1
83,8482929,Emil Lilleberg,D,TBL,23,24,1,0,1
83,8482061,Brandon Biro,L,SEA,26,12,1,0,1
83,8483609,Adam Klapka,R,CGY,24,2,1,0,1
83,8480874,Adam Ginning,D,PHI,24,8,1,0,1
83,8480032,Shane Bowers,C,NJD,25,15,1,0,1
83,8483432,Luca Del Bel Belluz,C,CBJ,31,8,1,0,1
83,8481534,Raphael Lavoie,C,EDM,24,5,1,0,1
83,8480245,Olle Lycksell,R,PHI,25,34,0,1,1
83,8477073,Kurtis MacDermid,L,NJD,30,24,0,1,1
83,8481030,Jack St. Ivany,D,PIT,25,16,0,1,1
83,8478477,Mitchell Stephens,C,SEA,27,13,0,1,1
83,8479421,Jacob Moverare,D,LAK,26,9,0,1,1
83,8481024,Linus Karlsson,C,VAN,25,7,0,1,1
83,8483471,Brad Lambert,C,WPG,31,14,0,1,1
83,8482516,Matthew Kessel,D,STL,24,19,0,1,1
83,8483597,Milos Kelemen,L,UTA,25,8,0,1,1
83,8474062,Riley Nash,C,NYR,35,16,0,1,1
83,8483407,Brandon Scanlin,D,NYR,25,2,0,1,1
83,8482162,Roby Jarventie,L,EDM,22,13,0,1,1
83,8481806,Louis Crevier,D,CHI,23,15,0,1,1
83,8478854,Ryan Shea,D,PIT,27,9,0,1,1
83,8475755,Alexander Petrovic,D,DAL,32,10,0,1,1
83,8482126,Emil Andrae,D,PHI,31,4,0,1,1
83,8484255,Jason Polin,R,COL,25,5,0,1,1
83,8480468,James Hamblin,L,EDM,25,27,0,0,0
83,8480084,Nick DeSimone,D,NJD,30,11,0,0,0
83,8481578,Graeme Clarke,R,MIN,23,13,0,0,0
83,8481065,Angus Crookshank,L,OTT,25,20,0,0,0
83,8483512,Matthew Savoie,C,EDM,20,20,0,0,0
83,8480890,Jan Jenik,C,OTT,24,28,0,0,0
83,8475795,Dylan McIlrath,D,WSH,32,15,0,0,0
83,8480823,Alexander Alexeyev,D,WSH,25,17,0,0,0
83,8483395,Arshdeep Bains,L,VAN,23,10,0,0,0
83,8477541,Dakota Mermis,D,TOR,30,9,0,0,0
83,8478011,Louie Belpedio,D,PHI,28,13,0,0,0
83,8483401,Marc Johnstone,R,PIT,28,0,0,0,0
83,8481726,Adam Edstrom,C,NYR,24,8,0,0,0
83,8482787,Nikita Chibrikov,R,WPG,31,7,0,0,0
83,8479330,Brandon Gignac,C,MTL,27,14,0,0,0
83,8480075,Cameron Crotty,D,MIN,25,11,0,0,0
83,8481655,Cole Schwindt,R,CGY,23,6,0,0,0
83,8482460,Matt Rempe,C,NYR,22,9,0,0,0
83,8475780,Chris Wagner,R,COL,33,9,0,0,0
83,8483546,Marshall Rifai,D,TOR,26,4,0,0,0
83,8482197,Adam Raska,R,MIN,23,5,0,0,0
83,8482476,Emil Heineman,L,MTL,23,4,0,0,0
83,8484326,Patrik Koch,D,UTA,28,1,0,0,0
83,8479522,Hardy Haman Aktell,D,WSH,26,2,0,0,0
83,8483398,Declan Carlile,D,TBL,31,9,0,0,0
83,8478147,Bokondji Imama,L,PIT,28,6,0,0,0
83,8483531,Brian Halonen,L,NJD,25,2,0,0,0
83,8484321,Nikolas Matinpalo,D,OTT,26,2,0,0,0
83,8478956,Samuel Laberge,L,NJD,27,0,0,0,0
83,8483920,Pierrick Dube,R,WSH,23,1,0,0,0
83,8477993,Justin Kirkland,C,CGY,28,7,0,0,0
83,8476323,Max McCormick,L,SEA,32,1,0,0,0
83,8480274,Philip Kemp,D,EDM,25,0,0,0,0
83,8484259,Ondrej Pavel,C,COL,31,4,0,0,0
83,8470794,Joe Pavelski,C,,40,0,0,0,0
83,8479321,Lucas Johansen,D,,27,0,0,0,0
83,8477950,Tony DeAngelo,D,,29,0,0,0,0
83,8471218,Blake Wheeler,R,,38,0,0,0,0
83,8475197,Tyson Barrie,D,,33,0,0,0,0
83,8474157,Max Pacioretty,L,,36,0,0,0,0
83,8475744,Evgeny Kuznetsov,C,,32,0,0,0,0
83,8474037,James van Riemsdyk,L,,35,0,0,0,0
83,8476907,Mackenzie MacEachern,L,,30,0,0,0,0
83,8480216,Jacob Peterson,C,,25,0,0,0,0
83,8474602,Justin Schultz,D,,34,0,0,0,0
83,8482222,Alexander Barabanov,L,,30,0,0,0,0
83,8474031,Kevin Shattenkirk,D,,35,0,0,0,0
83,8477330,Dominik Kubalik,L,,29,0,0,0,0
83,8480884,Calen Addison,D,,24,0,0,0,0
83,8475906,John Klingberg,D,,32,0,0,0,0
83,8480008,Adam Ruzicka,C,,25,0,0,0,0
83,8476884,Derrick Pouliot,D,,30,0,0,0,0
83,8476919,Chris Tierney,C,,30,0,0,0,0
83,8479415,Michael McLeod,C,,26,0,0,0,0
83,8474870,Tyler Johnson,C,,34,0,0,0,0
83,8470604,Jeff Carter,C,,39,0,0,0,0
83,8478104,Sammy Blais,L,,28,0,0,0,0
83,8474884,Mike Hoffman,C,,35,0,0,0,0
83,8481591,Sam Poulin,R,,23,0,0,0,0
83,8471274,Alex Goligoski,D,,39,0,0,0,0
83,8476871,Tanner Pearson,L,,32,0,0,0,0
83,8476393,Nick Cousins,C,,31,0,0,0,0
83,8479977,Kailer Yamamoto,R,,26,0,0,0,0
83,8479346,Dillon Dube,C,,26,0,0,0,0
83,8480184,Gustav Lindstrom,D,,26,0,0,0,0
83,8479376,Victor Mete,D,,26,0,0,0,0
83,8473449,Kyle Okposo,R,,36,0,0,0,0
83,8481058,Jesse Ylonen,R,,25,0,0,0,0
83,8475752,Tyler Pitlick,C,,33,0,0,0,0
83,8481239,Samuel Fagemo,L,,24,0,0,0,0
83,8480821,Filip Zadina,R,,25,0,0,0,0
83,8470966,Mark Giordano,D,,41,0,0,0,0
83,8478495,Denis Gurianov,R,,27,0,0,0,0
83,8477464,Nic Petan,C,,29,0,0,0,0
83,8478099,Kevin Labanc,R,,29,0,0,0,0
83,8482241,Radim Zohorna,L,,28,0,0,0,0
83,8474040,Sam Gagner,C,,35,0,0,0,0
83,8479514,Rem Pitlick,C,,27,0,0,0,0
83,8478430,Oliver Kylington,D,,27,0,0,0,0
83,8479533,Joona Koppanen,L,,26,0,0,0,0
83,8479984,Cal Foote,D,,26,0,0,0,0
83,8477126,Jayson Megna,C,,34,0,0,0,0
83,8475164,Jakob Silfverberg,R,,34,0,0,0,0
83,8474009,Nick Bonino,C,,36,0,0,0,0
83,8479458,Nikita Zaitsev,D,,33,0,0,0,0
83,8477944,Jakub Vrana,L,,28,0,0,0,0
83,8471699,Andrew Cogliano,C,,37,0,0,0,0
83,8478067,Oskar Lindblom,L,,28,0,0,0,0
83,8471686,Marc Staal,D,,37,0,0,0,0
83,8470610,Zach Parise,L,,40,0,0,0,0
83,8478904,Steven Lorentz,C,,28,0,0,0,0
83,8473473,Milan Lucic,L,,36,0,0,0,0
83,8480031,Maxime Comtois,L,,25,0,0,0,0
83,8478512,Austin Czarnik,C,,32,0,0,0,0
83,8473504,Cal Clutterbuck,R,,37,0,0,0,0
83,8477454,Adam Erne,L,,29,0,0,0,0
83,8479383,Boris Katchouk,L,,26,0,0,0,0
83,8475825,Jani Hakanpää,D,,32,0,0,0,0
83,8477846,Ryan Carpenter,C,,33,0,0,0,0
83,8477930,Pierre-Edouard Bellemare,L,,39,0,0,0,0
83,8478400,Colin White,C,,27,0,0,0,0
83,8480226,Marián Studenic,R,,26,0,0,0,0
83,8480853,Liam Foudy,C,,24,0,0,0,0
83,8475797,Jarred Tinordi,D,,32,0,0,0,0
83,8479423,Alex Nylander,L,,26,0,0,0,0
83,8474618,Marco Scandella,D,,34,0,0,0,0
83,8478028,Fredrik Olofsson,L,,28,0,0,0,0
83,8474709,Matt Martin,L,,35,0,0,0,0
83,8481070,Hugh McGing,L,,26,0,0,0,0
83,8479546,Oskar Steen,C,,26,0,0,0,0
83,8474145,Robert Bortuzzo,D,,35,0,0,0,0
83,8476915,Jujhar Khaira,L,,30,0,0,0,0
83,8475278,Byron Froese,C,,33,0,0,0,0
83,8481812,Nikolai Knyzhov,D,,27,0,0,0,0
83,8478408,Travis Dermott,D,,28,0,0,0,0
83,8481077,John Leonard,L,,26,0,0,0,0
83,8479547,Matthew Phillips,R,,26,0,0,0,0
83,8480836,Jonathan Gruden,C,,24,0,0,0,0
83,8481690,Tyler Angle,C,,24,0,0,0,0
83,8475766,Austin Watson,L,,32,0,0,0,0
83,8481016,Ruslan Iskhakov,C,,24,0,0,0,0
83,8478078,Rourke Chartier,C,,28,0,0,0,0
83,8480776,Sheldon Rempal,R,,29,0,0,0,0
83,8483045,Cameron Butler,R,CBJ,31,1,0,0,0
83,8484314,Jiri Smejkal,L,,28,0,0,0,0
84,8477492,Nathan MacKinnon,C,COL,29,82,56,91,147
84,8477956,David Pastrnak,R,BOS,28,80,64,74,138
84,8478483,Mitch Marner,R,TOR,27,78,46,86,132
84,8478402,Connor McDavid,C,EDM,27,78,35,92,127
84,8477934,Leon Draisaitl,C,EDM,29,79,54,69,123
84,8476453,Nikita Kucherov,R,TBL,31,82,34,83,117
84,8479314,Matthew Tkachuk,L,FLA,27,82,37,77,114
84,8481559,Jack Hughes,C,NJD,23,74,39,71,110
84,8476468,J.T. Miller,C,VAN,31,75,36,68,104
84,8478445,Mathew Barzal,C,NYI,27,81,31,70,101
84,8479318,Auston Matthews,C,TOR,27,79,55,44,99
84,8478864,Kirill Kaprizov,L,MIN,27,76,45,54,99
84,8482116,Tim Stützle,C,OTT,22,81,35,61,96
84,8477493,Aleksander Barkov,C,FLA,29,78,31,65,96
84,8476887,Filip Forsberg,L,NSH,30,74,30,65,95
84,8480027,Jason Robertson,L,DAL,25,82,37,56,93
84,8478420,Mikko Rantanen,R,COL,28,82,33,60,93
84,8484144,Connor Bedard,C,CHI,19,69,39,53,92
84,8474564,Steven Stamkos,C,NSH,34,76,42,49,91
84,8478550,Artemi Panarin,L,NYR,33,79,34,57,91
84,8477404,Jake Guentzel,C,TBL,30,82,43,46,89
84,8481557,Matt Boldy,L,MIN,23,73,37,51,88
84,8480023,Robert Thomas,C,STL,25,72,29,59,88
84,8480012,Elias Pettersson,C,VAN,26,75,33,54,87
84,8478439,Travis Konecny,R,PHI,27,75,36,50,86
84,8478403,Jack Eichel,C,VGK,28,76,37,48,85
84,8477933,Sam Reinhart,C,FLA,29,81,43,41,84
84,8480002,Nico Hischier,C,NJD,25,75,40,44,84
84,8478010,Brayden Point,C,TBL,28,82,43,40,83
84,8479407,Jesper Bratt,L,NJD,26,71,34,49,83
84,8479420,Tage Thompson,C,BUF,27,78,43,39,82
84,8477946,Dylan Larkin,C,DET,28,80,34,48,82
84,8477942,Kevin Fiala,L,LAK,28,80,38,43,81
84,8479337,Alex DeBrincat,R,DET,27,81,37,44,81
84,8476459,Mika Zibanejad,C,NYR,31,79,31,50,81
84,8475172,Nazem Kadri,C,CGY,34,76,30,51,81
84,8478398,Kyle Connor,L,WPG,28,72,38,42,80
84,8476456,Jonathan Huberdeau,C,CGY,31,79,22,58,80
84,8471675,Sidney Crosby,C,PIT,37,75,43,36,79
84,8477501,Valeri Nichushkin,R,COL,29,80,40,39,79
84,8477939,William Nylander,R,TOR,28,79,37,42,79
84,8477960,Adrian Kempe,R,LAK,28,82,36,43,79
84,8476460,Mark Scheifele,C,WPG,31,74,36,43,79
84,8478427,Sebastian Aho,C,CAR,27,71,30,49,79
84,8477949,Alex Tuch,R,BUF,28,73,28,50,78
84,8477500,Bo Horvat,C,NYI,29,81,38,39,77
84,8478873,Troy Terry,R,ANA,27,75,35,42,77
84,8471685,Anze Kopitar,C,LAK,37,82,21,56,77
84,8476539,Jonathan Marchessault,R,NSH,34,75,39,37,76
84,8475786,Zach Hyman,L,EDM,32,76,36,40,76
84,8477416,Oliver Bjorkstrand,R,SEA,29,77,27,49,76
84,8478460,Zach Werenski,D,CBJ,27,82,16,60,76
84,8480803,Evan Bouchard,D,EDM,25,77,11,65,76
84,8478449,Roope Hintz,C,DAL,28,81,35,40,75
84,8477409,Carter Verhaeghe,C,FLA,29,76,34,41,75
84,8480069,Cale Makar,D,COL,26,70,25,50,75
84,8479385,Jordan Kyrou,C,STL,26,77,35,39,74
84,8478493,Joel Eriksson Ek,C,MIN,27,71,34,40,74
84,8474578,Erik Karlsson,D,PIT,34,78,19,55,74
84,8480036,Miro Heiskanen,D,DAL,25,77,16,58,74
84,8478444,Brock Boeser,R,VAN,27,77,41,32,73
84,8475184,Chris Kreider,L,NYR,33,75,40,33,73
84,8480208,Drake Batherson,R,OTT,26,81,27,45,72
84,8478401,Pavel Zacha,C,BOS,27,79,22,50,72
84,8475166,John Tavares,C,TOR,34,78,36,35,71
84,8475913,Mark Stone,R,VGK,32,75,23,48,71
84,8480865,Noah Dobson,D,NYI,24,80,11,60,71
84,8482078,Lucas Raymond,L,DET,22,80,34,36,70
84,8475168,Matt Duchene,C,DAL,33,82,31,39,70
84,8479675,Trevor Moore,L,LAK,29,81,26,44,70
84,8480801,Brady Tkachuk,L,OTT,25,81,23,47,70
84,8482665,Matty Beniers,C,SEA,22,75,29,40,69
84,8473419,Brad Marchand,L,BOS,36,78,27,42,69
84,8476454,Ryan Nugent-Hopkins,C,EDM,31,78,22,47,69
84,8476346,Johnny Gaudreau,L,CBJ,31,71,20,49,69
84,8482740,Wyatt Johnston,C,DAL,21,78,38,30,68
84,8479542,Brandon Hagel,L,TBL,26,80,24,44,68
84,8480800,Quinn Hughes,D,VAN,25,75,7,61,68
84,8478440,Dylan Strome,C,WSH,27,71,23,44,67
84,8482684,Luke Hughes,D,NJD,21,75,10,57,67
84,8476389,Vincent Trocheck,C,NYR,31,77,30,36,66
84,8475754,Brock Nelson,C,NYI,33,75,30,36,66
84,8477402,Pavel Buchnevich,L,STL,29,78,28,38,66
84,8477496,Elias Lindholm,C,BOS,30,78,25,41,66
84,8474141,Patrick Kane,R,DET,36,81,22,44,66
84,8477951,Nick Schmaltz,C,UTA,28,74,18,48,66
84,8479343,Clayton Keller,R,UTA,26,80,28,37,65
84,8477504,Josh Morrissey,D,WPG,29,70,15,50,65
84,8477476,Artturi Lehkonen,L,COL,29,82,37,27,64
84,8475169,Evander Kane,L,EDM,33,76,33,31,64
84,8477940,Nikolaj Ehlers,L,WPG,28,72,26,38,64
84,8482745,Mason McTavish,C,ANA,21,71,26,38,64
84,8479999,Casey Mittelstadt,C,COL,26,80,18,46,64
84,8479323,Adam Fox,D,NYR,26,73,15,49,64
84,8471214,Alex Ovechkin,L,WSH,39,76,31,32,63
84,8477494,Jonathan Drouin,L,COL,29,81,13,50,63
84,8481540,Cole Caufield,R,MTL,23,75,30,32,62
84,8480015,Owen Tippett,R,PHI,25,74,21,41,62
84,8475794,Tyler Seguin,C,DAL,32,82,20,42,62
84,8483431,Logan Cooley,C,UTA,20,72,27,34,61
84,8481528,Dylan Cozens,C,BUF,23,69,26,35,61
84,8474586,Jordan Eberle,R,SEA,34,72,24,37,61
84,8477998,Warren Foegele,L,LAK,28,80,24,37,61
84,8475784,Jeff Skinner,C,EDM,32,77,22,39,61
84,8475745,Charlie Coyle,C,BOS,32,79,22,39,61
84,8475692,Mats Zuccarello,R,MIN,37,76,19,42,61
84,8475765,Vladimir Tarasenko,R,DET,33,79,17,44,61
84,8483808,Andrei Kuzmenko,L,CGY,28,71,25,35,60
84,8471215,Evgeni Malkin,C,PIT,38,74,23,37,60
84,8473994,Jamie Benn,L,DAL,35,82,22,38,60
84,8484166,Adam Fantilli,C,CBJ,20,75,22,38,60
84,8477407,Anthony Duclair,L,NYI,29,75,32,27,59
84,8475810,Bryan Rust,R,PIT,32,72,28,31,59
84,8475158,Ryan O'Reilly,C,NSH,33,74,25,34,59
84,8476905,Chandler Stephenson,C,SEA,30,75,19,40,59
84,8477986,Brandon Montour,D,SEA,30,75,18,41,59
84,8475798,Mikael Granlund,C,SJS,32,70,13,46,59
84,8480039,Martin Necas,C,CAR,25,72,26,32,58
84,8482159,Tyson Foerster,R,PHI,22,75,25,33,58
84,8480018,Nick Suzuki,C,MTL,25,79,19,39,58
84,8482124,Quinton Byfield,R,LAK,22,82,16,42,58
84,8478407,Vince Dunn,D,SEA,28,75,10,48,58
84,8476881,Tomas Hertl,C,VGK,31,78,26,31,57
84,8475151,Kyle Palmieri,C,NYI,33,81,24,33,57
84,8478366,Frank Vatrano,R,ANA,30,75,23,34,57
84,8477497,Sean Monahan,C,CBJ,30,70,22,35,57
84,8477503,Max Domi,C,TOR,29,80,19,38,57
84,8474600,Roman Josi,D,NSH,34,71,15,42,57
84,8474590,John Carlson,D,WSH,34,67,13,44,57
84,8474150,Mikael Backlund,C,CGY,35,75,19,37,56
84,8476826,Yanni Gourde,C,SEA,33,75,19,37,56
84,8476882,Teuvo Teravainen,C,CHI,30,67,15,41,56
84,8479425,Filip Hronek,D,VAN,27,73,7,49,56
84,8476479,Phillip Danault,C,LAK,31,79,17,37,54
84,8479325,Charlie McAvoy,D,BOS,27,75,10,44,54
84,8476853,Morgan Rielly,D,TOR,30,71,6,48,54
84,8477955,Jared McCann,L,SEA,28,79,29,24,53
84,8482093,Seth Jarvis,C,CAR,22,72,26,27,53
84,8478856,Conor Garland,R,VAN,28,67,19,34,53
84,8475167,Victor Hedman,D,TBL,34,81,10,43,53
84,8480839,Rasmus Dahlin,D,BUF,24,65,9,44,53
84,8476432,Boone Jenner,C,CBJ,31,64,27,25,52
84,8482699,Dylan Guenther,R,UTA,21,75,26,26,52
84,8478975,Mason Marchment,L,DAL,29,81,23,29,52
84,8477444,Andre Burakovsky,L,SEA,29,70,15,37,52
84,8477451,Ryan Hartman,R,MIN,30,73,14,38,52
84,8482109,Alexis Lafrenière,L,NYR,23,75,24,27,51
84,8478055,Gustav Forsling,D,FLA,28,72,14,37,51
84,8474679,Gustav Nyquist,C,NSH,35,69,14,37,51
84,8480064,Josh Norris,C,OTT,25,77,34,16,50
84,8481068,Yegor Sharangovich,C,CGY,26,77,30,20,50
84,8476399,Blake Coleman,C,CGY,33,80,29,21,50
84,8480797,Joel Farabee,L,PHI,24,76,26,24,50
84,8476483,Rickard Rakell,R,PIT,31,75,25,25,50
84,8481604,Pavel Dorofeyev,L,VGK,24,71,25,25,50
84,8477935,Sam Bennett,C,FLA,28,78,22,28,50
84,8475170,Brayden Schenn,C,STL,33,71,22,28,50
84,8479339,Patrik Laine,L,CBJ,26,69,18,32,50
84,8478462,Nicolas Roy,C,VGK,27,76,18,32,50
84,8476869,Brady Skjei,D,NSH,30,74,14,36,50
84,8479400,Pierre-Luc Dubois,L,WSH,26,67,22,27,49
84,8476448,William Karlsson,C,VGK,31,78,20,29,49
84,8478519,Anthony Cirelli,C,TBL,27,80,20,29,49
84,8482667,William Eklund,L,SJS,22,67,20,29,49
84,8484145,Zach Benson,L,BUF,19,66,19,30,49
84,8484153,Leo Carlsson,C,ANA,20,79,17,32,49
84,8473512,Claude Giroux,R,OTT,36,79,13,36,49
84,8482105,Jake Sanderson,D,OTT,22,72,13,36,49
84,8478469,Thomas Chabot,D,OTT,27,73,12,37,49
84,8475753,Justin Faulk,D,STL,32,76,11,38,49
84,8471724,Kris Letang,D,PIT,37,78,9,40,49
84,8478542,Evan Rodrigues,C,FLA,31,75,20,28,48
84,8478042,Viktor Arvidsson,L,EDM,31,76,19,29,48
84,8476792,Torey Krug,D,STL,33,76,11,37,48
84,8478414,Timo Meier,R,NJD,28,71,28,19,47
84,8475726,Tyler Toffoli,C,SJS,32,70,27,20,47
84,8473986,Alex Killorn,L,ANA,35,70,23,24,47
84,8480830,Andrei Svechnikov,R,CAR,24,68,20,27,47
84,8477964,Ivan Barbashev,C,VGK,29,72,17,30,47
84,8481618,Alex Newhook,C,MTL,23,70,16,31,47
84,8479345,Jakob Chychrun,D,WSH,26,68,12,35,47
84,8477346,MacKenzie Weegar,D,CGY,30,73,11,36,47
84,8478038,Devon Toews,D,COL,30,68,8,39,47
84,8479410,Mikhail Sergachev,D,UTA,26,74,4,43,47
84,8477426,Nicholas Paul,L,TBL,29,81,26,20,46
84,8475314,Anders Lee,L,NYI,34,79,24,22,46
84,8480220,Noah Cates,L,PHI,25,72,18,28,46
84,8475848,Brendan Gallagher,R,MTL,32,71,16,30,46
84,8474565,Alex Pietrangelo,D,VGK,34,67,12,34,46
84,8480014,Gabriel Vilardi,C,WPG,25,61,23,22,45
84,8479987,Morgan Geekie,C,BOS,26,79,23,22,45
84,8476906,Shayne Gostisbehere,D,CAR,31,80,21,24,45
84,8483515,Juraj Slafkovsky,L,MTL,20,73,20,25,45
84,8478438,Tommy Novak,C,NSH,27,72,19,26,45
84,8477447,Shea Theodore,D,VGK,29,63,11,34,45
84,8481546,Cam York,D,PHI,23,69,5,40,45
84,8482110,Dawson Mercer,C,NJD,23,76,24,20,44
84,8478047,Michael Bunting,L,PIT,29,69,22,22,44
84,8482702,Logan Stankoven,C,DAL,21,81,18,26,44
84,8479365,Trent Frederic,C,BOS,26,78,16,28,44
84,8480028,Morgan Frost,C,PHI,25,72,15,29,44
84,8479525,Ross Colton,C,COL,28,81,23,20,43
84,8474102,David Perron,L,OTT,36,79,22,21,43
84,8478046,Danton Heinen,L,VAN,29,73,22,21,43
84,8481596,Shane Pinto,C,OTT,24,75,21,22,43
84,8476872,Scott Laughton,C,PHI,30,72,19,24,43
84,8475763,Kevin Hayes,R,PIT,32,73,18,25,43
84,8476461,Sean Couturier,C,PHI,32,71,18,25,43
84,8477456,J.T. Compher,L,DET,29,80,17,26,43
84,8476292,Ondrej Palat,L,NJD,33,67,17,26,43
84,8481533,Trevor Zegras,C,ANA,23,71,15,28,43
84,8481711,Matias Maccelli,L,UTA,24,74,14,29,43
84,8476458,Ryan Strome,C,ANA,31,71,9,34,43
84,8478397,Rasmus Andersson,D,CGY,28,69,7,36,43
84,8475799,Nino Niederreiter,R,WPG,32,67,25,17,42
84,8474641,Adam Henrique,C,EDM,34,71,22,20,42
84,8478115,Pierre Engvall,L,NYI,28,76,22,20,42
84,8480188,Fabian Zetterlund,L,SJS,25,67,20,22,42
84,8477511,Anthony Mantha,R,CGY,30,75,14,28,42
84,8474053,Logan Couture,C,SJS,35,55,11,31,42
84,8482149,Cole Perfetti,C,WPG,22,71,13,28,41
84,8477495,Seth Jones,D,CHI,30,64,10,31,41
84,8481535,Nils Hoglander,L,VAN,24,72,26,14,40
84,8481560,Arthur Kaliyev,R,LAK,23,81,17,23,40
84,8475191,Reilly Smith,R,NYR,33,70,14,26,40
84,8481542,Moritz Seider,D,DET,23,79,13,27,40
84,8470613,Brent Burns,D,CAR,39,76,11,29,40
84,8476462,Dougie Hamilton,D,NJD,31,69,11,29,40
84,8474563,Drew Doughty,D,LAK,35,72,5,35,40
84,8471698,T.J. Oshie,R,WSH,38,68,24,15,39
84,8478020,Michael Amadio,R,OTT,28,77,22,17,39
84,8482720,Matthew Knies,L,TOR,22,71,12,27,39
84,8480185,Eetu Luostarinen,C,FLA,26,78,12,27,39
84,8481581,Thomas Harley,D,DAL,23,77,9,30,39
84,8482712,Oskar Olausson,R,COL,22,78,7,32,39
84,8477506,Ryan Pulock,D,NYI,30,81,7,32,39
84,8476958,Jaccob Slavin,D,CAR,30,77,6,33,39
84,8480145,Neal Pionk,D,WPG,29,73,6,33,39
84,8480893,Kirill Marchenko,R,CBJ,24,59,28,10,38
84,8479992,Michael Rasmussen,C,DET,25,81,18,20,38
84,8478498,Jake DeBrusk,L,VAN,28,72,18,20,38
84,8481577,Philip Tomasino,C,NSH,23,64,14,24,38
84,8476854,Hampus Lindholm,D,BOS,30,73,11,27,38
84,8476923,Damon Severson,D,CBJ,30,77,8,30,38
84,8480798,Philipp Kurashev,C,CHI,25,63,8,30,38
84,8478396,Noah Hanifin,D,VGK,27,63,6,32,38
84,8483490,Pavel Mintyukov,D,ANA,21,74,6,32,38
84,8478474,Lawson Crouse,L,UTA,27,71,21,16,37
84,8475768,Jaden Schwartz,C,SEA,32,73,17,20,37
84,8474149,Evgenii Dadonov,R,DAL,35,81,17,20,37
84,8477505,Alexander Wennberg,C,SJS,30,63,15,22,37
84,8480835,Jack Drury,C,CAR,24,67,15,22,37
84,8481523,Kirby Dach,C,MTL,23,62,14,23,37
84,8476474,Stefan Noesen,R,NJD,31,69,13,24,37
84,8479591,Michael Eyssimont,C,TBL,28,79,13,24,37
84,8475149,Marcus Johansson,L,MIN,34,61,12,25,37
84,8481524,Bowen Byram,D,BUF,23,65,10,27,37
84,8476875,Mike Matheson,D,MTL,30,76,7,30,37
84,8479390,Taylor Raddysh,R,WSH,26,68,19,17,36
84,8482089,Jake Neighbours,L,STL,22,63,18,18,36
84,8475760,Nick Bjugstad,C,UTA,32,72,18,18,36
84,8481624,Ilya Mikheyev,R,CHI,30,59,15,21,36
84,8476438,Brandon Saad,L,STL,32,71,21,14,35
84,8475722,Jason Zucker,L,BUF,32,67,16,19,35
84,8482113,Anton Lundell,C,FLA,23,78,11,24,35
84,8475287,Erik Haula,L,NJD,33,64,11,24,35
84,8477021,Alex Kerfoot,C,UTA,30,71,10,25,35
84,8476927,Teddy Blueger,C,VAN,30,63,10,25,35
84,8476979,Erik Gustafsson,D,DET,32,73,8,27,35
84,8475764,Cam Fowler,D,ANA,33,69,6,29,35
84,8482175,JJ Peterka,R,BUF,22,67,18,16,34
84,8480829,Jesperi Kotkaniemi,C,CAR,24,70,13,21,34
84,8483505,Matthew Poitras,C,BOS,20,75,11,23,34
84,8479351,Sam Steel,C,DAL,26,81,11,23,34
84,8476885,Jacob Trouba,D,NYR,30,68,10,24,34
84,8482122,Brock Faber,D,MIN,22,79,8,26,34
84,8480817,K'Andre Miller,D,NYR,24,70,4,30,34
84,8482475,Yegor Chinakhov,R,CBJ,23,59,14,19,33
84,8476921,Jordan Martinook,L,CAR,32,67,14,19,33
84,8474715,Cameron Atkinson,R,TBL,35,81,13,20,33
84,8478472,Mathieu Joseph,R,STL,27,71,12,21,33
84,8476880,Tom Wilson,R,WSH,30,62,12,21,33
84,8477932,Aaron Ekblad,D,FLA,28,71,11,22,33
84,8475714,Calle Jarnkrok,C,TOR,33,73,11,22,33
84,8477429,Andrew Copp,C,DET,30,78,10,23,33
84,8483565,Nick Blankenburg,D,NSH,26,60,9,24,33
84,8479639,Dylan Coghlan,D,WPG,26,69,9,24,33
84,8481703,Valtteri Puustinen,R,PIT,25,62,3,30,33
84,8475793,Ryan Johansen,C,PHI,32,68,21,11,32
84,8482705,Cole Sillinger,C,CBJ,21,67,16,16,32
84,8478463,Anthony Beauvillier,L,PIT,27,69,14,18,32
84,8479293,Brandon Tanev,L,SEA,33,69,14,18,32
84,8478891,Mason Appleton,C,WPG,28,65,12,20,32
84,8480871,Adam Boqvist,D,FLA,24,69,11,21,32
84,8482624,Daniil Miromanov,D,CGY,27,72,9,23,32
84,8477498,Darnell Nurse,D,EDM,29,78,8,24,32
84,8475218,Mattias Ekholm,D,EDM,34,75,8,24,32
84,8479402,Jake Bean,D,CGY,26,66,8,24,32
84,8480813,Joe Veleno,C,DET,24,76,17,14,31
84,8481186,Logan O'Connor,R,COL,28,76,13,18,31
84,8479661,Tanner Jeannot,L,LAK,27,73,12,19,31
84,8482117,Lukas Reichel,L,CHI,22,65,12,19,31
84,8476897,Oskar Sundqvist,C,STL,30,63,11,20,31
84,8475791,Taylor Hall,L,CHI,33,46,8,23,31
84,8480434,Sean Durzi,D,UTA,26,70,7,24,31
84,8478500,Ivan Provorov,D,CBJ,27,80,5,26,31
84,8476918,Jimmy Vesey,L,NYR,31,71,19,11,30
84,8476278,Colin Blackwell,C,DAL,31,76,18,12,30
84,8477479,Tyler Bertuzzi,L,CHI,29,59,16,14,30
84,8478413,Jordan Greenway,L,BUF,27,66,16,14,30
84,8481582,Nicholas Robertson,L,TOR,23,66,16,14,30
84,8480078,Filip Chytil,C,NYR,25,67,14,16,30
84,8476392,Adam Lowry,C,WPG,31,58,13,17,30
84,8479353,Brett Howden,C,VGK,26,65,13,17,30
84,8481656,Aliaksei Protas,C,WSH,23,66,12,18,30
84,8477353,Tyler Motte,C,DET,29,76,10,20,30
84,8473422,Nick Foligno,L,CHI,37,61,9,21,30
84,8476892,Colton Parayko,D,STL,31,70,6,24,30
84,8473453,Trevor Lewis,C,LAK,37,71,16,13,29
84,8476419,Jean-Gabriel Pageau,C,NYI,32,77,14,15,29
84,8477989,Christian Dvorak,C,MTL,28,69,13,16,29
84,8483457,Lane Hutson,D,MTL,20,63,12,17,29
84,8481606,Jordan Spence,D,LAK,23,70,11,18,29
84,8482809,Jackson Blake,R,CAR,21,60,10,19,29
84,8478466,Daniel Sprong,R,VAN,27,72,9,20,29
84,8477953,Kasperi Kapanen,R,STL,28,63,9,20,29
84,8476463,Jonas Brodin,D,MIN,31,76,7,22,29
84,8482092,Ridly Greig,C,OTT,22,74,6,23,29
84,8477948,Travis Sanheim,D,PHI,28,69,5,24,29
84,8480855,Jack McBain,C,UTA,24,70,15,13,28
84,8470621,Corey Perry,R,EDM,39,68,14,14,28
84,8482097,Jack Quinn,R,BUF,23,73,12,16,28
84,8482146,Luke Evangelista,R,NSH,22,69,12,16,28
84,8480009,Eeli Tolvanen,R,SEA,25,70,11,17,28
84,8484203,Bradly Nadeau,L,CAR,19,57,10,18,28
84,8478233,Andrew Mangiapane,L,WSH,28,71,7,21,28
84,8478458,John (Jack) Roslovic,C,CAR,27,72,5,23,28
84,8475200,Dmitry Orlov,D,CAR,33,74,5,23,28
84,8480459,Pius Suter,C,VAN,28,70,14,13,27
84,8476981,Josh Anderson,R,MTL,30,65,13,14,27
84,8477425,Miles Wood,L,COL,29,80,13,14,27
84,8482133,Thomas Bordeleau,C,SJS,22,64,12,15,27
84,8482660,Kent Johnson,C,CBJ,22,58,11,16,27
84,8480849,Barrett Hayton,C,UTA,24,71,11,16,27
84,8483491,Ivan Miroshnichenko,L,WSH,20,55,8,19,27
84,8480878,Nils Lundkvist,D,DAL,24,76,7,20,27
84,8482671,Owen Power,D,BUF,22,68,4,23,27
84,8475181,Nick Leddy,D,STL,33,70,4,23,27
84,8482073,Braden Schneider,D,NYR,23,67,3,24,27
84,8478109,Victor Olofsson,L,VGK,29,67,13,13,26
84,8478057,Dakota Joshua,C,VAN,28,59,11,15,26
84,8480802,Ryan McLeod,C,BUF,25,61,11,15,26
84,8482749,Joshua Roy,R,MTL,21,64,11,15,26
84,8483445,Cutter Gauthier,L,ANA,20,62,11,15,26
84,8480068,Ryan Poehling,C,PHI,25,66,10,16,26
84,8476329,Travis Boyd,C,MIN,31,57,10,16,26
84,8474716,Jared Spurgeon,D,MIN,35,74,8,18,26
84,8481521,Ronnie Attard,D,PHI,25,57,8,18,26
84,8482101,Danil Gushchin,L,SJS,22,56,7,19,26
84,8476925,Colton Sissons,C,NSH,31,68,6,20,26
84,8475171,Oliver Ekman-Larsson,D,TOR,33,69,6,20,26
84,8475231,Casey Cizikas,C,NYI,33,74,4,22,26
84,8474151,Ryan McDonagh,D,TBL,35,78,3,23,26
84,8477488,Brett Pesce,D,NJD,30,66,3,23,26
84,8477969,Marcus Pettersson,D,PIT,28,77,2,24,26
84,8481554,Kaapo Kakko,R,NYR,23,64,16,9,25
84,8481517,Brett Leason,R,ANA,25,63,15,10,25
84,8480113,Alex Iafallo,L,WPG,31,71,14,11,25
84,8476469,Joel Armia,R,MTL,31,62,14,11,25
84,8483524,Shane Wright,C,SEA,20,61,14,11,25
84,8482803,Olen Zellweger,D,ANA,21,69,13,12,25
84,8483468,Jiri Kulich,C,BUF,20,65,11,14,25
84,8480336,Sean Walker,D,CAR,30,72,9,16,25
84,8477220,Nate Schmidt,D,FLA,33,71,4,21,25
84,8478840,Will Borgen,D,SEA,28,68,4,21,25
84,8480049,Dylan Samberg,D,WPG,25,71,4,21,25
84,8480891,Michael Kesselring,D,UTA,24,64,3,22,25
84,8480873,Rasmus Sandin,D,WSH,24,61,2,23,25
84,8476931,Jake McCabe,D,TOR,31,66,1,24,25
84,8482125,Alexander Holtz,R,VGK,22,75,15,9,24
84,8478508,Yakov Trenin,C,MIN,27,65,14,10,24
84,8479619,Michael Carcone,L,UTA,28,62,14,10,24
84,8475220,Marcus Foligno,L,MIN,33,57,13,11,24
84,8480748,Kiefer Sherwood,L,VAN,29,60,12,12,24
84,8477450,Jason Dickinson,C,CHI,29,53,11,13,24
84,8479996,Cody Glass,C,NSH,25,63,11,13,24
84,8482259,Bobby McMann,C,TOR,28,58,11,13,24
84,8477919,Frederick Gaudreau,C,MIN,31,64,10,14,24
84,8477839,Conor Sheary,L,TBL,32,82,9,15,24
84,8476480,Vladislav Namestnikov,C,WPG,32,69,8,16,24
84,8477499,Rasmus Ristolainen,D,PHI,30,68,7,17,24
84,8473507,Jeff Petry,D,DET,37,75,1,23,24
84,8480281,Alexey Toropchenko,R,STL,25,54,16,7,23
84,8482155,Alex Laferriere,R,LAK,23,62,16,7,23
84,8479941,Justin Danforth,R,CBJ,31,59,14,9,23
84,8481704,Juuso Parssinen,C,NSH,23,58,13,10,23
84,8482074,Connor Zary,C,CGY,23,60,12,11,23
84,8479316,Luke Kunin,C,SJS,27,59,12,11,23
84,8477987,Ryan Donato,C,CHI,28,60,11,12,23
84,8477952,Robby Fabbri,C,ANA,28,62,11,12,23
84,8480789,Oliver Wahlstrom,R,NYI,24,68,10,13,23
84,8475193,Tomas Tatar,L,NJD,34,71,9,14,23
84,8480246,Nick Perbix,D,TBL,26,70,7,16,23
84,8478133,Jake Evans,C,MTL,28,66,6,17,23
84,8475855,Jesper Fast,R,CAR,33,58,6,17,23
84,8479543,Michael Pezzetta,L,MTL,26,60,5,18,23
84,8479398,Samuel Girard,D,COL,26,61,3,20,23
84,8480252,Cole Guttman,C,CHI,25,46,13,9,22
84,8480003,Jesper Boqvist,C,FLA,26,65,12,10,22
84,8482055,Drew O'Connor,L,PIT,26,59,10,12,22
84,8481093,Rafael Harvey-Pinard,L,MTL,25,58,10,12,22
84,8480980,Connor Dewar,C,TOR,25,69,10,12,22
84,8481580,Connor McMichael,C,WSH,23,55,10,12,22
84,8481441,Joe Snively,C,DET,28,61,10,12,22
84,8481553,Bobby Brink,R,PHI,23,68,8,14,22
84,8476878,Zemgus Girgensons,C,TBL,30,79,8,14,22
84,8481028,Martin Pospisil,C,CGY,25,55,7,15,22
84,8479976,Juuso Valimaki,D,UTA,26,66,6,16,22
84,8480448,Parker Kelly,L,COL,25,75,6,16,22
84,8475279,Ben Chiarot,D,DET,33,65,6,16,22
84,8480043,Timothy Liljegren,D,TOR,25,69,5,17,22
84,8474574,Tyler Myers,D,VAN,34,68,3,19,22
84,8482245,Artem Zub,D,OTT,29,66,3,19,22
84,8478507,John Marino,D,UTA,27,71,2,20,22
84,8477478,William Carrier,L,CAR,30,44,11,10,21
84,8477446,Michael McCarron,R,NSH,29,60,8,13,21
84,8483482,Tristan Luneau,D,ANA,20,64,8,13,21
84,8476457,Adam Larsson,D,SEA,32,71,7,14,21
84,8478136,Jake Middleton,D,MIN,28,79,6,15,21
84,8476422,Mike Reilly,D,NYI,31,79,4,17,21
84,8480073,Erik Brannstrom,D,COL,25,62,3,18,21
84,8481481,Blake Lizotte,C,PIT,27,61,13,7,20
84,8473533,Jordan Staal,C,CAR,36,64,11,9,20
84,8480995,Pontus Holmberg,R,TOR,25,66,10,10,20
84,8474189,Lars Eller,C,PIT,35,64,9,11,20
84,8477947,Sonny Milano,L,WSH,28,66,9,11,20
84,8479370,Tyson Jost,C,CAR,26,53,7,13,20
84,8476994,Vinnie Hinostroza,C,NSH,30,49,6,14,20
84,8476917,Adam Pelech,D,NYI,30,74,5,15,20
84,8477018,Ben Hutton,D,VGK,31,41,4,16,20
84,8480035,Henri Jokiharju,D,BUF,25,67,2,18,20
84,8482655,Janis Moser,D,TBL,24,76,1,19,20
84,8481601,Simon Holmstrom,R,NYI,23,65,10,9,19
84,8479336,Carl Grundstrom,R,SJS,27,48,10,9,19
84,8481032,Paul Cotter,C,NJD,25,66,9,10,19
84,8478043,Sam Lafferty,C,BUF,29,62,9,10,19
84,8478013,Jake Walman,D,SJS,28,65,8,11,19
84,8482737,Zack Bolduc,C,STL,21,60,8,11,19
84,8478851,Alexandre Carrier,D,NSH,28,68,7,12,19
84,8479371,Dante Fabbro,D,NSH,26,66,7,12,19
84,8478970,Jalen Chatfield,D,CAR,28,73,5,14,19
84,8478882,Vladislav Gavrikov,D,LAK,29,67,5,14,19
84,8479982,Conor Timmins,D,TOR,26,57,5,14,19
84,8483495,Simon Nemec,D,NJD,20,57,5,14,19
84,8476856,Mathew Dumba,D,DAL,30,74,3,16,19
84,8475790,Erik Gudbranson,D,CBJ,32,78,3,16,19
84,8481178,Egor Zamula,D,PHI,24,61,2,17,19
84,8476891,Matthew Grzelcyk,D,PIT,30,75,2,17,19
84,8479414,Nathan Bastian,R,NJD,27,61,11,7,18
84,8483493,Frank Nazar,C,CHI,20,52,10,8,18
84,8482679,Matt Coronato,R,CGY,22,68,10,8,18
84,8479393,Noah Gregor,L,OTT,26,70,8,10,18
84,8475343,Nic Dowd,C,WSH,34,55,8,10,18
84,8478585,Derek Ryan,C,EDM,38,68,8,10,18
84,8477015,Connor Brown,R,EDM,30,60,7,11,18
84,8479066,Ryan Lomberg,L,CGY,30,69,7,11,18
84,8478911,Matt Roy,D,WSH,29,67,6,12,18
84,8483499,Liam Ohgren,L,MIN,20,57,6,12,18
84,8482077,Dylan Holloway,L,EDM,23,56,6,12,18
84,8475842,Sam Carrick,C,NYR,32,57,6,12,18
84,8478451,Ethan Bear,D,WSH,27,48,5,13,18
84,8478434,Keegan Kolesar,R,VGK,27,68,4,14,18
84,8476889,Radek Faksa,C,STL,30,68,4,14,18
84,8481019,David Gustafsson,C,WPG,24,47,4,14,18
84,8482087,Kaiden Guhle,D,MTL,22,70,3,15,18
84,8480222,Sebastian Aho,D,PIT,28,69,3,15,18
84,8475462,Radko Gudas,D,ANA,34,66,3,15,18
84,8481014,Alexander Romanov,D,NYI,24,76,3,15,18
84,8477369,Carson Soucy,D,VAN,30,67,3,15,18
84,8478443,Brandon Carlo,D,BOS,28,61,3,15,18
84,8482142,Jamie Drysdale,D,PHI,22,61,2,16,18
84,8480001,Urho Vaakanainen,D,ANA,25,53,1,17,18
84,8480848,Ty Dellandrea,C,SJS,24,45,10,7,17
84,8477903,Garnet Hathaway,R,PHI,33,60,9,8,17
84,8480806,Isac Lundestrom,C,ANA,25,60,9,8,17
84,8480025,MacKenzie Entwistle,R,FLA,25,60,9,8,17
84,8480289,Morgan Barron,C,WPG,26,55,8,9,17
84,8476312,Josh Manson,D,COL,33,64,7,10,17
84,8482079,Marco Rossi,C,MIN,23,55,6,11,17
84,8477392,Hudson Fasching,R,NYI,29,62,6,11,17
84,8481522,Peyton Krebs,C,BUF,23,49,5,12,17
84,8478416,Erik Cernak,D,TBL,27,73,5,12,17
84,8479998,Mikey Anderson,D,LAK,25,61,4,13,17
84,8478178,Darren Raddysh,D,TBL,28,66,4,13,17
84,8476467,Jamie Oleksiak,D,SEA,32,63,3,14,17
84,8476331,Dylan DeMelo,D,WPG,31,65,3,14,17
84,8479324,Ryan Lindgren,D,NYR,26,63,2,15,17
84,8481059,Scott Perunovich,D,STL,26,63,1,16,17
84,8476374,Sean Kuraly,C,CBJ,31,60,9,7,16
84,8480205,Emil Bemstrom,C,PIT,25,51,8,8,16
84,8482062,Cole Smith,L,NSH,29,50,8,8,16
84,8479344,Jesse Puljujarvi,R,PIT,26,48,8,8,16
84,8481617,Vasily Podkolzin,R,VAN,23,54,8,8,16
84,8476960,Andreas Athanasiou,C,CHI,30,55,7,9,16
84,8482730,Brandt Clarke,D,LAK,21,50,7,9,16
84,8482744,James Malatesta,L,CBJ,21,40,7,9,16
84,8477508,Curtis Lazar,C,NJD,29,60,6,10,16
84,8477931,Tomas Nosek,L,FLA,32,55,6,10,16
84,8481477,Nico Sturm,C,SJS,29,56,6,10,16
84,8473563,Nicklas Backstrom,C,WSH,37,59,5,11,16
84,8482451,Mikael Pyyhtia,L,CBJ,23,46,5,11,16
84,8477435,Ryan Graves,D,PIT,29,74,4,12,16
84,8481708,Zac Jones,D,NYR,24,54,3,13,16
84,8476902,Esa Lindell,D,DAL,30,74,2,14,16
84,8477070,Liam O'Brien,C,UTA,30,58,10,5,15
84,8479368,Max Jones,L,BOS,26,68,8,7,15
84,8476822,Luke Glendening,C,TBL,35,77,8,7,15
84,8480157,Calle Rosen,D,COL,30,46,8,7,15
84,8477979,Nicolas Aube-Kubel,R,BUF,28,49,7,8,15
84,8477380,Jonny Brodzinski,C,NYR,31,52,6,9,15
84,8479026,Philippe Myers,D,TOR,27,51,6,9,15
84,8480144,David Kampf,C,TOR,29,75,5,10,15
84,8479315,Joey Anderson,R,CHI,26,50,5,10,15
84,8476525,Colin Miller,D,WPG,32,59,5,10,15
84,8479442,Troy Stecher,D,EDM,30,51,4,11,15
84,8474673,TJ Brodie,D,CHI,34,64,3,12,15
84,8475179,Dmitry Kulikov,D,FLA,34,61,2,13,15
84,8479983,Mario Ferraro,D,SJS,26,69,2,13,15
84,8478399,Jonas Siegenthaler,D,NJD,27,56,0,15,15
84,8482111,Justin Barron,D,MTL,23,69,10,4,14
84,8480762,Eric Robinson,L,CAR,29,53,9,5,14
84,8482157,Will Cuylle,L,NYR,22,61,9,5,14
84,8479439,Jacob MacDonald,D,COL,31,58,9,5,14
84,8476858,Phillip Di Giuseppe,L,VAN,31,42,9,5,14
84,8479772,Zack MacEwen,R,OTT,28,56,8,6,14
84,8475225,Craig Smith,C,CHI,35,56,7,7,14
84,8480355,Mark Kastelic,C,BOS,25,63,6,8,14
84,8478211,Dryden Hunt,L,CGY,29,56,6,8,14
84,8476874,Olli Maatta,D,DET,30,59,5,9,14
84,8478432,Christian Fischer,R,DET,27,72,4,10,14
84,8482192,Isaak Phillips,D,CHI,23,48,4,10,14
84,8476429,Scott Mayfield,D,NYI,32,74,4,10,14
84,8480172,Jan Rutta,D,SJS,34,70,4,10,14
84,8481013,Jonatan Berggren,R,DET,24,59,4,10,14
84,8481537,Nikita Okhotiuk,D,CGY,24,49,2,12,14
84,8480887,Jordan Harris,D,MTL,24,51,2,12,14
84,8475690,Chris Tanev,D,TOR,35,60,1,13,14
84,8479718,Alex Barré-Boulet,C,MTL,27,58,9,4,13
84,8481518,Nolan Foote,L,NJD,24,34,9,4,13
84,8477573,Nathan Walker,L,STL,30,48,8,5,13
84,8481641,Joel Kiviranta,L,COL,28,70,6,7,13
84,8480074,Alexandre Texier,C,STL,25,50,6,7,13
84,8479328,Julien Gauthier,R,NYI,27,61,5,8,13
84,8480807,Mattias Samuelsson,D,BUF,24,58,4,9,13
84,8479369,Andrew Peeke,D,BOS,26,59,4,9,13
84,8481599,Victor Soderstrom,D,UTA,23,45,4,9,13
84,8476952,Dominic Toninato,C,WPG,30,39,4,9,13
84,8479378,Logan Stanley,D,WPG,26,45,4,9,13
84,8476867,Brendan Gaunce,C,MIN,30,34,4,9,13
84,8479980,Nicolas Hague,D,VGK,26,56,3,10,13
84,8470600,Ryan Suter,D,STL,39,61,3,10,13
84,8478468,Jeremy Lauzon,D,NSH,27,51,2,11,13
84,8475455,Brenden Dillon,D,NJD,34,59,2,11,13
84,8482067,Connor Mackey,D,NYR,28,57,1,12,13
84,8476934,Brock McGinn,L,ANA,30,46,9,3,12
84,8475235,Nicolas Deslauriers,L,PHI,33,51,8,4,12
84,8480021,Jack Studnicka,C,LAK,25,56,7,5,12
84,8479671,Mathieu Olivier,R,CBJ,27,56,6,6,12
84,8481147,Reese Johnson,C,MIN,26,37,4,8,12
84,8484911,Collin Graf,R,SJS,22,49,3,9,12
84,8477845,Trevor van Riemsdyk,D,WSH,33,59,2,10,12
84,8477365,Connor Clifton,D,BUF,29,57,2,10,12
84,8484254,Akito Hirose,D,VAN,25,36,2,10,12
84,8474013,Ian Cole,D,UTA,35,54,2,10,12
84,8476988,Matt Benning,D,SJS,30,68,1,11,12
84,8480192,Johnathan Kovacevic,D,NJD,27,54,1,11,12
84,8475718,Justin Holl,D,DET,32,56,1,11,12
84,8481789,Tye Kartye,L,SEA,23,37,9,2,11
84,8482659,Josh Doan,R,UTA,22,49,8,3,11
84,8481716,Dmitri Voronkov,L,CBJ,24,39,7,4,11
84,8477406,Mattias Janmark,C,EDM,32,63,7,4,11
84,8480011,Klim Kostin,C,SJS,25,38,6,5,11
84,8482762,Simon Edvinsson,D,DET,21,58,6,5,11
84,8475762,Derek Forbort,D,VAN,32,42,6,5,11
84,8482784,Zach Dean,C,STL,21,42,6,5,11
84,8484149,Gavin Brindley,C,CBJ,20,57,5,6,11
84,8478421,A.J. Greer,L,FLA,28,63,5,6,11
84,8482070,Mitchell Chaffee,R,TBL,26,56,5,6,11
84,8474567,Zach Bogosian,D,MIN,34,67,4,7,11
84,8482176,Wyatt Kaiser,D,CHI,22,58,4,7,11
84,8476879,Cody Ceci,D,EDM,31,66,3,8,11
84,8478452,Caleb Jones,D,LAK,27,54,3,8,11
84,8479536,Axel Jonsson-Fjallby,L,WPG,26,37,3,8,11
84,8480860,Kevin Bahl,D,CGY,24,57,2,9,11
84,8477851,Jordan Oesterle,D,BOS,32,47,2,9,11
84,8480727,Zach Whitecloud,D,VGK,28,50,1,10,11
84,8478859,Niko Mikkola,D,FLA,28,60,1,10,11
84,8482861,Vincent Iorio,D,WSH,22,33,1,10,11
84,8481527,Kaedan Korczak,D,VGK,23,40,9,1,10
84,8482807,Ethan Del Mastro,D,CHI,21,52,8,2,10
84,8479291,Kevin Rooney,C,CGY,31,53,7,3,10
84,8478831,Kevin Stenlund,C,UTA,28,55,6,4,10
84,8476873,Mark Jankowski,C,NSH,30,46,6,4,10
84,8481532,Alex Turcotte,C,LAK,23,47,5,5,10
84,8478017,Mark Friedman,D,VAN,29,39,4,6,10
84,8475324,Nick Jensen,D,OTT,34,71,3,7,10
84,8477482,Zachary Sanford,L,CHI,30,36,3,7,10
84,8481167,Brayden Pachal,D,CGY,25,39,3,7,10
84,8481754,Nikita Nesterenko,C,ANA,23,35,3,7,10
84,8475188,Brayden McNabb,D,VGK,33,52,2,8,10
84,8476967,Brett Kulak,D,EDM,30,57,2,8,10
84,8479372,Joshua Mahura,D,SEA,26,49,2,8,10
84,8481568,Alex Vlasic,D,CHI,23,51,0,10,10
84,8475233,David Savard,D,MTL,34,67,0,10,10
84,8474568,Luke Schenn,D,NSH,35,51,0,10,10
84,8474166,Alec Martinez,D,CHI,37,53,0,10,10
84,8480070,Ian Mitchell,D,BOS,25,48,0,10,10
84,8481550,Adam Beckman,L,NJD,23,38,4,5,9
84,8479944,Zach Aston-Reese,C,VGK,30,50,4,5,9
84,8482964,Arber Xhekaj,D,MTL,23,45,4,5,9
84,8482496,Nils Aman,C,VAN,24,35,4,5,9
84,8474034,Patrick Maroon,L,CHI,36,46,3,6,9
84,8480845,Rasmus Kupari,C,WPG,24,39,3,6,9
84,8482652,Walker Duehr,R,CGY,27,41,3,6,9
84,8474090,Brendan Smith,D,DAL,35,48,2,7,9
84,8480441,Trey Fix-Wolansky,R,CBJ,25,31,2,7,9
84,8481751,Lukas Rousek,R,BUF,25,41,2,7,9
84,8481161,Jake Christiansen,D,CBJ,25,56,1,8,9
84,8482511,Mason Lohrei,D,BOS,23,34,1,8,9
84,8479249,Andrew Poturalski,C,SJS,30,30,1,8,9
84,8479576,Vincent Desharnais,D,VAN,28,41,1,8,9
84,8476442,Matt Nieto,L,PIT,32,50,4,4,8
84,8483466,Kevin Korchinski,D,CHI,20,46,4,4,8
84,8477034,Jaycob Megna,D,FLA,32,40,3,5,8
84,8478146,Matthew Highmore,C,OTT,28,27,3,5,8
84,8480950,Ilya Lyubushkin,D,DAL,30,62,3,5,8
84,8478424,Jansen Harkins,C,ANA,27,41,2,6,8
84,8480196,Jacob Bryson,D,BUF,27,39,2,6,8
84,8476624,Barclay Goodrow,C,SJS,31,59,2,6,8
84,8479348,Kale Clague,D,BUF,26,42,1,7,8
84,8473446,Erik Johnson,D,PHI,36,45,1,7,8
84,8480058,Pierre-Olivier Joseph,D,STL,25,44,1,7,8
84,8475750,Jon Merrill,D,MIN,32,69,0,8,8
84,8477335,Kyle Burroughs,D,LAK,29,41,0,8,8
84,8483460,David Jiricek,D,CBJ,21,56,0,8,8
84,8477527,Ross Johnston,L,ANA,30,34,0,8,8
84,8479994,Jaret Anderson-Dolan,C,WPG,25,35,6,1,7
84,8477401,John Hayden,C,SEA,29,26,5,2,7
84,8482166,Shakir Mukhamadullin,D,SJS,22,54,4,3,7
84,8479359,Beck Malenstyn,L,BUF,26,43,4,3,7
84,8479520,Brandon Duhaime,R,WSH,27,53,4,3,7
84,8478569,Noel Acciari,C,PIT,33,55,4,3,7
84,8482141,Lukas Cormier,D,VGK,22,35,4,3,7
84,8482153,Brendan Brisson,C,VGK,23,31,4,3,7
84,8477507,Nikita Zadorov,D,BOS,29,65,3,4,7
84,8477962,Brendan Lemieux,L,CAR,28,36,3,4,7
84,8483012,Logan Morrison,C,SEA,22,36,3,4,7
84,8477887,Patrick Brown,C,BOS,32,43,2,5,7
84,8477938,Haydn Fleury,D,WPG,28,40,2,5,7
84,8481600,Tobias Bjornfot,D,FLA,23,42,2,5,7
84,8475177,Calvin de Haan,D,COL,33,48,2,5,7
84,8481701,Santeri Hatakka,D,NJD,23,42,2,5,7
84,8482733,Logan Mailloux,D,MTL,31,33,2,5,7
84,8480879,Jacob Bernard-Docker,D,OTT,24,43,2,5,7
84,8482666,Scott Morrow,D,CAR,22,40,2,5,7
84,8481567,Henry Thrun,D,SJS,23,46,2,5,7
84,8471677,Jack Johnson,D,CBJ,37,63,2,5,7
84,8479986,Kole Lind,R,DAL,26,45,2,5,7
84,8475208,Brian Dumoulin,D,ANA,33,64,1,6,7
84,8483549,Lucas Condotta,L,MTL,27,34,1,6,7
84,8479972,Mason Shaw,C,WPG,26,36,1,6,7
84,8482751,Ryan Winterton,C,SEA,21,29,1,6,7
84,8478021,William Lagesson,D,DET,28,27,1,6,7
84,8471709,Marc-Edouard Vlasic,D,SJS,37,65,0,7,7
84,8482145,Mavrik Bourque,C,DAL,22,52,0,7,7
84,8478450,Parker Wotherspoon,D,BOS,27,30,0,7,7
84,8476372,Nick Seeler,D,PHI,31,39,0,7,7
84,8479968,Vinni Lettieri,C,BOS,29,46,5,1,6
84,8477073,Kurtis MacDermid,L,NJD,30,36,4,2,6
84,8480796,Martin Fehervary,D,WSH,25,59,3,3,6
84,8480880,Jakub Lauko,C,MIN,24,27,3,3,6
84,8477473,Justin Bailey,R,SJS,29,19,3,3,6
84,8474612,Travis Hamonic,D,OTT,34,52,2,4,6
84,8482095,Tyler Kleven,D,OTT,22,47,2,4,6
84,8478409,Anthony Richard,C,PHI,28,29,2,4,6
84,8482148,Hendrix Lapierre,C,WSH,22,51,1,5,6
84,8482634,Alex Steeves,C,TOR,25,42,1,5,6
84,8476913,Devin Shore,C,MIN,30,33,1,5,6
84,8477462,Robert Hagg,D,VGK,29,25,1,5,6
84,8477320,Anton Blidh,L,NYR,29,18,1,5,6
84,8482250,Callahan Burke,C,VGK,27,24,1,5,6
84,8482929,Emil Lilleberg,D,TBL,23,27,1,5,6
84,8476441,Joel Edmundson,D,LAK,31,48,0,6,6
84,8480007,Jonas Rondbjerg,R,VGK,25,39,0,6,6
84,8476473,Connor Murphy,D,CHI,31,43,0,6,6
84,8481056,Spencer Stastney,D,NSH,24,23,0,6,6
84,8478874,Adam Gaudette,R,OTT,28,40,4,1,5
84,8480844,Grigori Denisenko,L,VGK,24,27,4,1,5
84,8480292,Carson Meyer,R,ANA,27,27,2,3,5
84,8479981,Jonah Gadjovich,L,FLA,26,31,2,3,5
84,8481592,Jakob Pelletier,L,CGY,23,32,2,3,5
84,8482516,Matthew Kessel,D,STL,24,18,2,3,5
84,8482747,Brennan Othmann,L,NYR,21,41,1,4,5
84,8477384,Joshua Brown,D,EDM,30,43,1,4,5
84,8480870,Bo Groulx,C,NYR,24,30,1,4,5
84,8481543,Nikita Alexandrov,C,STL,24,33,1,4,5
84,8479379,Givani Smith,R,SJS,26,31,1,4,5
84,8478454,Noah Juulsen,D,VAN,27,38,0,5,5
84,8481122,Simon Benoit,D,TOR,26,32,0,5,5
84,8481605,Jackson LaCombe,D,ANA,23,33,0,5,5
84,8481237,Kyle MacLean,C,NYI,25,29,0,5,5
84,8483570,Ben Meyers,C,SEA,26,27,3,1,4
84,8483512,Matthew Savoie,C,EDM,20,19,3,1,4
84,8477993,Justin Kirkland,C,CGY,28,10,3,1,4
84,8482713,Mackie Samoskevich,R,FLA,22,43,2,2,4
84,8482859,Zack Ostapchuk,C,OTT,21,49,2,2,4
84,8479638,Justin Brazeau,R,BOS,26,30,2,2,4
84,8482765,Isak Rosen,R,BUF,21,32,2,2,4
84,8481743,Marc Del Gaizo,D,NSH,25,28,2,2,4
84,8483397,Marc McLaughlin,C,BOS,25,23,2,2,4
84,8481422,Jake Lucchini,C,NSH,29,17,2,2,4
84,8475958,Michael Sgarbossa,C,WSH,32,33,2,2,4
84,8474062,Riley Nash,C,NYR,35,23,2,2,4
84,8477810,Joel Hanley,D,CGY,33,27,1,3,4
84,8482470,Ilya Solovyov,D,CGY,24,19,1,3,4
84,8482165,Yan Kuznetsov,D,CGY,22,21,0,4,4
84,8479320,Maxime Lajoie,D,SEA,27,23,0,4,4
84,8477971,Andreas Englund,D,LAK,28,23,0,4,4
84,8483630,Pavol Regenda,L,ANA,25,28,2,1,3
84,8482144,Jack Thompson,D,SJS,22,23,2,1,3
84,8477467,Gustav Olofsson,D,SEA,30,19,2,1,3
84,8482147,Jean-Luc Foudy,C,COL,22,23,2,1,3
84,8479362,Riley Tufte,L,BOS,26,17,2,1,3
84,8482201,Gage Goncalves,C,TBL,23,23,2,1,3
84,8481679,Maxence Guenette,D,OTT,23,35,1,2,3
84,8479991,Jake Leschyshyn,C,NYR,25,23,1,2,3
84,8481609,Vladislav Kolyachonok,D,UTA,23,24,1,2,3
84,8480834,Ty Emberson,D,SJS,24,32,1,2,3
84,8478502,Dennis Gilbert,D,BUF,28,13,1,2,3
84,8484287,Cole McWard,D,VAN,23,13,1,2,3
84,8482177,Marat Khusnutdinov,C,MIN,22,35,1,2,3
84,8479419,Brett Murray,L,BUF,26,23,1,2,3
84,8479367,William Lockwood,R,FLA,26,29,1,2,3
84,8484255,Jason Polin,R,COL,25,6,1,2,3
84,8471817,Ryan Reaves,R,TOR,37,58,0,3,3
84,8483763,Maksymilian Szuber,D,UTA,22,24,0,3,3
84,8481598,Philip Broberg,D,EDM,23,45,0,3,3
84,8480267,Sammy Walker,C,MIN,25,17,0,3,3
84,8480245,Olle Lycksell,R,PHI,25,39,0,3,3
84,8481030,Jack St. Ivany,D,PIT,25,21,0,3,3
84,8481065,Angus Crookshank,L,OTT,25,14,0,3,3
84,8478881,Brett Seney,L,CHI,28,13,2,0,2
84,8482162,Roby Jarventie,L,EDM,22,19,2,0,2
84,8481719,Maxwell Crozier,D,TBL,24,14,1,1,2
84,8481462,Mason Morelli,L,VGK,28,12,1,1,2
84,8475413,Justin Dowling,C,NJD,34,20,1,1,2
84,8481206,John Ludvig,D,PIT,24,13,1,1,2
84,8480851,Akil Thomas,C,LAK,24,21,1,1,2
84,8478854,Ryan Shea,D,PIT,27,7,1,1,2
84,8483395,Arshdeep Bains,L,VAN,23,8,1,1,2
84,8481726,Adam Edstrom,C,NYR,24,12,1,1,2
84,8481655,Cole Schwindt,R,CGY,23,6,1,1,2
84,8479985,Cale Fleury,D,SEA,26,23,0,2,2
84,8483619,Filip Roos,D,OTT,25,31,0,2,2
84,8482172,Landon Slaggert,L,CHI,22,28,0,2,2
84,8480990,Declan Chisholm,D,MIN,24,32,0,2,2
84,8481006,Tyler Tucker,D,STL,24,14,0,2,2
84,8481541,Samuel Bolduc,D,NYI,24,20,0,2,2
84,8479421,Jacob Moverare,D,LAK,26,6,0,2,2
84,8480890,Jan Jenik,C,OTT,24,24,0,2,2
84,8479330,Brandon Gignac,C,MTL,27,8,0,2,2
84,8482476,Emil Heineman,L,MTL,23,10,0,2,2
84,8481556,John Beecher,C,BOS,23,41,1,0,1
84,8481593,Jayden Struble,D,MTL,23,18,1,0,1
84,8482858,Ryker Evans,D,SEA,23,26,1,0,1
84,8481564,Ryan Johnson,D,BUF,23,18,1,0,1
84,8482118,Sam Colangelo,R,ANA,23,14,1,0,1
84,8478051,Max Willman,C,NJD,29,17,1,0,1
84,8481043,Cole Koepke,L,BOS,26,19,1,0,1
84,8482061,Brandon Biro,L,SEA,26,10,1,0,1
84,8481024,Linus Karlsson,C,VAN,25,10,1,0,1
84,8480468,James Hamblin,L,EDM,25,19,1,0,1
84,8483398,Declan Carlile,D,TBL,31,7,1,0,1
84,8482102,Vasily Ponomarev,C,PIT,22,20,0,1,1
84,8481585,Egor Afanasyev,L,SJS,23,20,0,1,1
84,8483489,Fraser Minten,C,TOR,31,12,0,1,1
84,8481699,Aku Raty,R,UTA,23,16,0,1,1
84,8477244,Chad Ruhwedel,D,NYR,34,31,0,1,1
84,8479587,Rhett Gardner,C,PHI,28,16,0,1,1
84,8477149,Scott Sabourin,R,SJS,32,18,0,1,1
84,8482088,Justin Sourdif,R,FLA,22,12,0,1,1
84,8480032,Shane Bowers,C,NJD,25,14,0,1,1
84,8483471,Brad Lambert,C,WPG,31,12,0,1,1
84,8483597,Milos Kelemen,L,UTA,25,14,0,1,1
84,8481806,Louis Crevier,D,CHI,23,13,0,1,1
84,8475755,Alexander Petrovic,D,DAL,32,4,0,1,1
84,8480084,Nick DeSimone,D,NJD,30,14,0,1,1
84,8481578,Graeme Clarke,R,MIN,23,11,0,1,1
84,8480823,Alexander Alexeyev,D,WSH,25,16,0,1,1
84,8477541,Dakota Mermis,D,TOR,30,14,0,1,1
84,8480075,Cameron Crotty,D,MIN,25,7,0,1,1
84,8478446,Glenn Gawdin,C,LAK,27,7,0,0,0
84,8484258,Sam Malinski,D,COL,26,15,0,0,0
84,8482094,Daemon Hunt,D,MIN,22,9,0,0,0
84,8483567,Georgii Merkulov,C,BOS,24,8,0,0,0
84,8480306,Grant Hutton,D,NYI,29,8,0,0,0
84,8484304,Uvis Balinskis,D,FLA,28,6,0,0,0
84,8484325,Waltteri Merela,C,TBL,26,20,0,0,0
84,8483609,Adam Klapka,R,CGY,24,1,0,0,0
84,8480874,Adam Ginning,D,PHI,24,7,0,0,0
84,8483432,Luca Del Bel Belluz,C,CBJ,31,4,0,0,0
84,8481534,Raphael Lavoie,C,EDM,24,1,0,0,0
84,8478477,Mitchell Stephens,C,SEA,27,19,0,0,0
84,8483407,Brandon Scanlin,D,NYR,25,9,0,0,0
84,8482126,Emil Andrae,D,PHI,31,2,0,0,0
84,8475795,Dylan McIlrath,D,WSH,32,12,0,0,0
84,8478011,Louie Belpedio,D,PHI,28,14,0,0,0
84,8483401,Marc Johnstone,R,PIT,28,0,0,0,0
84,8482787,Nikita Chibrikov,R,WPG,31,4,0,0,0
84,8482460,Matt Rempe,C,NYR,22,10,0,0,0
84,8475780,Chris Wagner,R,COL,33,7,0,0,0
84,8483546,Marshall Rifai,D,TOR,26,3,0,0,0
84,8482197,Adam Raska,R,MIN,23,5,0,0,0
84,8484326,Patrik Koch,D,UTA,28,0,0,0,0
84,8479522,Hardy Haman Aktell,D,WSH,26,2,0,0,0
84,8478147,Bokondji Imama,L,PIT,28,7,0,0,0
84,8483531,Brian Halonen,L,NJD,25,0,0,0,0
84,8484321,Nikolas Matinpalo,D,OTT,26,2,0,0,0
84,8478956,Samuel Laberge,L,NJD,27,0,0,0,0
84,8483920,Pierrick Dube,R,WSH,23,8,0,0,0
84,8476323,Max McCormick,L,SEA,32,4,0,0,0
84,8480274,Philip Kemp,D,EDM,25,0,0,0,0
84,8484259,Ondrej Pavel,C,COL,31,1,0,0,0
84,8470794,Joe Pavelski,C,,40,0,0,0,0
84,8479321,Lucas Johansen,D,,27,0,0,0,0
84,8477950,Tony DeAngelo,D,,29,0,0,0,0
84,8471218,Blake Wheeler,R,,38,0,0,0,0
84,8475197,Tyson Barrie,D,,33,0,0,0,0
84,8474157,Max Pacioretty,L,,36,0,0,0,0
84,8475744,Evgeny Kuznetsov,C,,32,0,0,0,0
84,8474037,James van Riemsdyk,L,,35,0,0,0,0
84,8476907,Mackenzie MacEachern,L,,30,0,0,0,0
84,8480216,Jacob Peterson,C,,25,0,0,0,0
84,8474602,Justin Schultz,D,,34,0,0,0,0
84,8482222,Alexander Barabanov,L,,30,0,0,0,0
84,8474031,Kevin Shattenkirk,D,,35,0,0,0,0
84,8477330,Dominik Kubalik,L,,29,0,0,0,0
84,8480884,Calen Addison,D,,24,0,0,0,0
84,8475906,John Klingberg,D,,32,0,0,0,0
84,8480008,Adam Ruzicka,C,,25,0,0,0,0
84,8476884,Derrick Pouliot,D,,30,0,0,0,0
84,8476919,Chris Tierney,C,,30,0,0,0,0
84,8479415,Michael McLeod,C,,26,0,0,0,0
84,8474870,Tyler Johnson,C,,34,0,0,0,0
84,8470604,Jeff Carter,C,,39,0,0,0,0
84,8478104,Sammy Blais,L,,28,0,0,0,0
84,8474884,Mike Hoffman,C,,35,0,0,0,0
84,8481591,Sam Poulin,R,,23,0,0,0,0
84,8471274,Alex Goligoski,D,,39,0,0,0,0
84,8476871,Tanner Pearson,L,,32,0,0,0,0
84,8476393,Nick Cousins,C,,31,0,0,0,0
84,8479977,Kailer Yamamoto,R,,26,0,0,0,0
84,8479346,Dillon Dube,C,,26,0,0,0,0
84,8480184,Gustav Lindstrom,D,,26,0,0,0,0
84,8479376,Victor Mete,D,,26,0,0,0,0
84,8473449,Kyle Okposo,R,,36,0,0,0,0
84,8481058,Jesse Ylonen,R,,25,0,0,0,0
84,8475752,Tyler Pitlick,C,,33,0,0,0,0
84,8481239,Samuel Fagemo,L,,24,0,0,0,0
84,8480821,Filip Zadina,R,,25,0,0,0,0
84,8470966,Mark Giordano,D,,41,0,0,0,0
84,8478495,Denis Gurianov,R,,27,0,0,0,0
84,8477464,Nic Petan,C,,29,0,0,0,0
84,8478099,Kevin Labanc,R,,29,0,0,0,0
84,8482241,Radim Zohorna,L,,28,0,0,0,0
84,8474040,Sam Gagner,C,,35,0,0,0,0
84,8479514,Rem Pitlick,C,,27,0,0,0,0
84,8478430,Oliver Kylington,D,,27,0,0,0,0
84,8479533,Joona Koppanen,L,,26,0,0,0,0
84,8479984,Cal Foote,D,,26,0,0,0,0
84,8477126,Jayson Megna,C,,34,0,0,0,0
84,8475164,Jakob Silfverberg,R,,34,0,0,0,0
84,8474009,Nick Bonino,C,,36,0,0,0,0
84,8479458,Nikita Zaitsev,D,,33,0,0,0,0
84,8477944,Jakub Vrana,L,,28,0,0,0,0
84,8471699,Andrew Cogliano,C,,37,0,0,0,0
84,8478067,Oskar Lindblom,L,,28,0,0,0,0
84,8471686,Marc Staal,D,,37,0,0,0,0
84,8470610,Zach Parise,L,,40,0,0,0,0
84,8478904,Steven Lorentz,C,,28,0,0,0,0
84,8473473,Milan Lucic,L,,36,0,0,0,0
84,8480031,Maxime Comtois,L,,25,0,0,0,0
84,8478512,Austin Czarnik,C,,32,0,0,0,0
84,8473504,Cal Clutterbuck,R,,37,0,0,0,0
84,8477454,Adam Erne,L,,29,0,0,0,0
84,8479383,Boris Katchouk,L,,26,0,0,0,0
84,8475825,Jani Hakanpää,D,,32,0,0,0,0
84,8477846,Ryan Carpenter,C,,33,0,0,0,0
84,8477930,Pierre-Edouard Bellemare,L,,39,0,0,0,0
84,8478400,Colin White,C,,27,0,0,0,0
84,8480226,Marián Studenic,R,,26,0,0,0,0
84,8480853,Liam Foudy,C,,24,0,0,0,0
84,8475797,Jarred Tinordi,D,,32,0,0,0,0
84,8479423,Alex Nylander,L,,26,0,0,0,0
84,8474618,Marco Scandella,D,,34,0,0,0,0
84,8478028,Fredrik Olofsson,L,,28,0,0,0,0
84,8474709,Matt Martin,L,,35,0,0,0,0
84,8481070,Hugh McGing,L,,26,0,0,0,0
84,8479546,Oskar Steen,C,,26,0,0,0,0
84,8474145,Robert Bortuzzo,D,,35,0,0,0,0
84,8476915,Jujhar Khaira,L,,30,0,0,0,0
84,8475278,Byron Froese,C,,33,0,0,0,0
84,8481812,Nikolai Knyzhov,D,,27,0,0,0,0
84,8478408,Travis Dermott,D,,28,0,0,0,0
84,8481077,John Leonard,L,,26,0,0,0,0
84,8479547,Matthew Phillips,R,,26,0,0,0,0
84,8480836,Jonathan Gruden,C,,24,0,0,0,0
84,8481690,Tyler Angle,C,,24,0,0,0,0
84,8475766,Austin Watson,L,,32,0,0,0,0
84,8481016,Ruslan Iskhakov,C,,24,0,0,0,0
84,8478078,Rourke Chartier,C,,28,0,0,0,0
84,8480776,Sheldon Rempal,R,,29,0,0,0,0
84,8483045,Cameron Butler,R,CBJ,31,0,0,0,0
84,8484314,Jiri Smejkal,L,,28,0,0,0,0
85,8476453,Nikita Kucherov,R,TBL,31,82,44,98,142
85,8477492,Nathan MacKinnon,C,COL,29,82,47,85,132
85,8477956,David Pastrnak,R,BOS,28,81,54,70,124
85,8478420,Mikko Rantanen,R,COL,28,80,54,70,124
85,8478402,Connor McDavid,C,EDM,27,80,32,87,119
85,8480027,Jason Robertson,L,DAL,25,82,48,66,114
85,8477493,Aleksander Barkov,C,FLA,29,76,34,80,114
85,8479318,Auston Matthews,C,TOR,27,79,69,44,113
85,8481559,Jack Hughes,C,NJD,23,72,49,63,112
85,8477934,Leon Draisaitl,C,EDM,29,80,43,65,108
85,8477404,Jake Guentzel,C,TBL,30,82,45,61,106
85,8479314,Matthew Tkachuk,L,FLA,27,79,40,66,106
85,8478483,Mitch Marner,R,TOR,27,77,31,72,103
85,8480002,Nico Hischier,C,NJD,25,76,40,61,101
85,8479407,Jesper Bratt,L,NJD,26,79,34,65,99
85,8477939,William Nylander,R,TOR,28,75,45,53,98
85,8478864,Kirill Kaprizov,L,MIN,27,66,34,64,98
85,8478010,Brayden Point,C,TBL,28,82,43,53,96
85,8476468,J.T. Miller,C,VAN,31,78,41,55,96
85,8480830,Andrei Svechnikov,R,CAR,24,72,37,58,95
85,8481557,Matt Boldy,L,MIN,23,73,44,50,94
85,8480801,Brady Tkachuk,L,OTT,25,81,42,51,93
85,8484144,Connor Bedard,C,CHI,19,65,33,60,93
85,8475172,Nazem Kadri,C,CGY,34,80,31,61,92
85,8476887,Filip Forsberg,L,NSH,30,75,36,54,90
85,8478550,Artemi Panarin,L,NYR,33,78,30,60,90
85,8474564,Steven Stamkos,C,NSH,34,74,38,51,89
85,8478398,Kyle Connor,L,WPG,28,74,42,45,87
85,8475166,John Tavares,C,TOR,34,75,33,52,85
85,8477942,Kevin Fiala,L,LAK,28,82,30,54,84
85,8478449,Roope Hintz,C,DAL,28,82,38,45,83
85,8478460,Zach Werenski,D,CBJ,27,81,20,63,83
85,8482116,Tim Stützle,C,OTT,22,81,23,59,82
85,8477409,Carter Verhaeghe,C,FLA,29,79,44,36,80
85,8476460,Mark Scheifele,C,WPG,31,75,28,52,80
85,8471675,Sidney Crosby,C,PIT,37,75,37,42,79
85,8477949,Alex Tuch,R,BUF,28,72,27,52,79
85,8479323,Adam Fox,D,NYR,26,74,14,65,79
85,8480800,Quinn Hughes,D,VAN,25,76,12,67,79
85,8478439,Travis Konecny,R,PHI,27,75,34,44,78
85,8476454,Ryan Nugent-Hopkins,C,EDM,31,78,27,51,78
85,8480036,Miro Heiskanen,D,DAL,25,76,15,63,78
85,8477933,Sam Reinhart,C,FLA,29,77,33,44,77
85,8478427,Sebastian Aho,C,CAR,27,74,33,44,77
85,8475913,Mark Stone,R,VGK,32,75,31,46,77
85,8480023,Robert Thomas,C,STL,25,74,24,53,77
85,8480069,Cale Makar,D,COL,26,66,24,53,77
85,8476539,Jonathan Marchessault,R,NSH,34,74,37,39,76
85,8479343,Clayton Keller,R,UTA,26,76,34,42,76
85,8477960,Adrian Kempe,R,LAK,28,82,27,48,75
85,8480012,Elias Pettersson,C,VAN,26,71,25,50,75
85,8478414,Timo Meier,R,NJD,28,80,37,37,74
85,8479385,Jordan Kyrou,C,STL,26,80,36,38,74
85,8475810,Bryan Rust,R,PIT,32,75,37,36,73
85,8482665,Matty Beniers,C,SEA,22,75,25,48,73
85,8475167,Victor Hedman,D,TBL,34,82,23,50,73
85,8478440,Dylan Strome,C,WSH,27,77,20,53,73
85,8478403,Jack Eichel,C,VGK,28,75,34,38,72
85,8479420,Tage Thompson,C,BUF,27,71,32,40,72
85,8477946,Dylan Larkin,C,DET,28,79,30,42,72
85,8476346,Johnny Gaudreau,L,CBJ,31,70,17,55,72
85,8473419,Brad Marchand,L,BOS,36,79,32,39,71
85,8476459,Mika Zibanejad,C,NYR,31,76,24,47,71
85,8478445,Mathew Barzal,C,NYI,27,80,22,49,71
85,8477496,Elias Lindholm,C,BOS,30,80,34,36,70
85,8471214,Alex Ovechkin,L,WSH,39,75,37,32,69
85,8482093,Seth Jarvis,C,CAR,22,68,33,36,69
85,8476389,Vincent Trocheck,C,NYR,31,80,28,41,69
85,8480208,Drake Batherson,R,OTT,26,81,27,42,69
85,8482740,Wyatt Johnston,C,DAL,21,80,36,32,68
85,8478444,Brock Boeser,R,VAN,27,73,29,39,68
85,8473512,Claude Giroux,R,OTT,36,81,24,44,68
85,8477504,Josh Morrissey,D,WPG,29,77,10,58,68
85,8476448,William Karlsson,C,VGK,31,78,38,29,67
85,8478873,Troy Terry,R,ANA,27,71,20,47,67
85,8476456,Jonathan Huberdeau,C,CGY,31,76,12,55,67
85,8476853,Morgan Rielly,D,TOR,30,76,10,57,67
85,8480865,Noah Dobson,D,NYI,24,82,9,58,67
85,8475168,Matt Duchene,C,DAL,33,81,25,41,66
85,8473994,Jamie Benn,L,DAL,35,82,25,41,66
85,8477951,Nick Schmaltz,C,UTA,28,79,23,43,66
85,8477416,Oliver Bjorkstrand,R,SEA,29,74,22,44,66
85,8482078,Lucas Raymond,L,DET,22,81,18,48,66
85,8475798,Mikael Granlund,C,SJS,32,69,11,55,66
85,8477402,Pavel Buchnevich,L,STL,29,78,25,40,65
85,8477501,Valeri Nichushkin,R,COL,29,82,33,31,64
85,8481528,Dylan Cozens,C,BUF,23,73,26,38,64
85,8479542,Brandon Hagel,L,TBL,26,82,25,39,64
85,8474141,Patrick Kane,R,DET,36,80,25,39,64
85,8477940,Nikolaj Ehlers,L,WPG,28,71,23,41,64
85,8482684,Luke Hughes,D,NJD,21,73,9,55,64
85,8476479,Phillip Danault,C,LAK,31,78,26,37,63
85,8476881,Tomas Hertl,C,VGK,31,77,26,36,62
85,8477955,Jared McCann,L,SEA,28,75,33,28,61
85,8474600,Roman Josi,D,NSH,34,75,17,44,61
85,8479675,Trevor Moore,L,LAK,29,82,29,31,60
85,8477494,Jonathan Drouin,L,COL,29,80,24,36,60
85,8480018,Nick Suzuki,C,MTL,25,75,20,40,60
85,8474590,John Carlson,D,WSH,34,69,19,41,60
85,8474578,Erik Karlsson,D,PIT,34,80,16,44,60
85,8475692,Mats Zuccarello,R,MIN,37,72,14,46,60
85,8481540,Cole Caufield,R,MTL,23,74,30,29,59
85,8483515,Juraj Slafkovsky,L,MTL,20,77,27,32,59
85,8482699,Dylan Guenther,R,UTA,21,81,26,33,59
85,8478519,Anthony Cirelli,C,TBL,27,82,23,36,59
85,8479999,Casey Mittelstadt,C,COL,26,81,21,38,59
85,8476905,Chandler Stephenson,C,SEA,30,78,20,39,59
85,8479325,Charlie McAvoy,D,BOS,27,74,13,46,59
85,8477500,Bo Horvat,C,NYI,29,77,38,20,58
85,8480014,Gabriel Vilardi,C,WPG,25,71,36,22,58
85,8478366,Frank Vatrano,R,ANA,30,71,35,23,58
85,8475184,Chris Kreider,L,NYR,33,73,29,29,58
85,8480039,Martin Necas,C,CAR,25,74,27,31,58
85,8478493,Joel Eriksson Ek,C,MIN,27,70,24,34,58
85,8477986,Brandon Montour,D,SEA,30,74,21,37,58
85,8471685,Anze Kopitar,C,LAK,37,81,16,42,58
85,8477447,Shea Theodore,D,VGK,29,61,9,49,58
85,8482109,Alexis Lafrenière,L,NYR,23,74,28,29,57
85,8477497,Sean Monahan,C,CBJ,30,69,23,34,57
85,8471724,Kris Letang,D,PIT,37,80,18,39,57
85,8476906,Shayne Gostisbehere,D,CAR,31,77,16,41,57
85,8482159,Tyson Foerster,R,PHI,22,75,29,27,56
85,8480064,Josh Norris,C,OTT,25,75,26,30,56
85,8482149,Cole Perfetti,C,WPG,22,71,26,30,56
85,8482667,William Eklund,L,SJS,22,67,25,31,56
85,8480803,Evan Bouchard,D,EDM,25,73,14,42,56
85,8474586,Jordan Eberle,R,SEA,34,74,28,27,55
85,8477935,Sam Bennett,C,FLA,28,77,26,29,55
85,8474150,Mikael Backlund,C,CGY,35,77,24,31,55
85,8480015,Owen Tippett,R,PHI,25,76,30,24,54
85,8476399,Blake Coleman,C,CGY,33,77,29,25,54
85,8475726,Tyler Toffoli,C,SJS,32,67,27,27,54
85,8478397,Rasmus Andersson,D,CGY,28,74,8,46,54
85,8478498,Jake DeBrusk,L,VAN,28,72,25,28,53
85,8477451,Ryan Hartman,R,MIN,30,72,24,29,53
85,8474679,Gustav Nyquist,C,NSH,35,75,19,34,53
85,8475754,Brock Nelson,C,NYI,33,81,30,22,52
85,8479337,Alex DeBrincat,R,DET,27,80,27,25,52
85,8475170,Brayden Schenn,C,STL,33,77,18,34,52
85,8481533,Trevor Zegras,C,ANA,23,77,18,34,52
85,8482113,Anton Lundell,C,FLA,23,76,18,34,52
85,8478469,Thomas Chabot,D,OTT,27,72,17,35,52
85,8475786,Zach Hyman,L,EDM,32,76,22,29,51
85,8475794,Tyler Seguin,C,DAL,32,79,21,30,51
85,8475765,Vladimir Tarasenko,R,DET,33,82,19,32,51
85,8478047,Michael Bunting,L,PIT,29,69,19,32,51
85,8471215,Evgeni Malkin,C,PIT,38,75,16,35,51
85,8480839,Rasmus Dahlin,D,BUF,24,69,16,35,51
85,8475287,Erik Haula,L,NJD,33,68,15,36,51
85,8481581,Thomas Harley,D,DAL,23,75,11,40,51
85,8478407,Vince Dunn,D,SEA,28,75,7,44,51
85,8476875,Mike Matheson,D,MTL,30,76,7,44,51
85,8475784,Jeff Skinner,C,EDM,32,78,31,19,50
85,8476483,Rickard Rakell,R,PIT,31,73,27,23,50
85,8478975,Mason Marchment,L,DAL,29,79,22,28,50
85,8478401,Pavel Zacha,C,BOS,27,81,19,31,50
85,8476882,Teuvo Teravainen,C,CHI,30,67,19,31,50
85,8477479,Tyler Bertuzzi,L,CHI,29,62,18,32,50
85,8474565,Alex Pietrangelo,D,VGK,34,72,13,37,50
85,8476958,Jaccob Slavin,D,CAR,30,79,8,42,50
85,8483808,Andrei Kuzmenko,L,CGY,28,74,26,23,49
85,8477998,Warren Foegele,L,LAK,28,80,21,28,49
85,8478466,Daniel Sprong,R,VAN,27,68,16,33,49
85,8478462,Nicolas Roy,C,VGK,27,75,12,37,49
85,8475753,Justin Faulk,D,STL,32,72,11,37,48
85,8476432,Boone Jenner,C,CBJ,31,74,28,19,47
85,8477511,Anthony Mantha,R,CGY,30,79,25,22,47
85,8477964,Ivan Barbashev,C,VGK,29,74,24,23,47
85,8476880,Tom Wilson,R,WSH,30,70,22,25,47
85,8476872,Scott Laughton,C,PHI,30,73,21,26,47
85,8479410,Mikhail Sergachev,D,UTA,26,76,11,36,47
85,8470613,Brent Burns,D,CAR,39,76,11,36,47
85,8480009,Eeli Tolvanen,R,SEA,25,75,23,23,46
85,8482092,Ridly Greig,C,OTT,22,76,22,24,46
85,8475169,Evander Kane,L,EDM,33,81,20,26,46
85,8484166,Adam Fantilli,C,CBJ,20,69,19,27,46
85,8477503,Max Domi,C,TOR,29,79,13,33,46
85,8475714,Calle Jarnkrok,C,TOR,33,77,26,19,45
85,8473986,Alex Killorn,L,ANA,35,74,23,22,45
85,8477407,Anthony Duclair,L,NYI,29,78,21,24,45
85,8481068,Yegor Sharangovich,C,CGY,26,76,21,24,45
85,8479345,Jakob Chychrun,D,WSH,26,70,21,24,45
85,8481560,Arthur Kaliyev,R,LAK,23,78,21,24,45
85,8481596,Shane Pinto,C,OTT,24,73,20,25,45
85,8475158,Ryan O'Reilly,C,NSH,33,69,19,26,45
85,8479987,Morgan Geekie,C,BOS,26,79,19,26,45
85,8477456,J.T. Compher,L,DET,29,79,19,26,45
85,8482124,Quinton Byfield,R,LAK,22,76,16,29,45
85,8480798,Philipp Kurashev,C,CHI,25,65,15,30,45
85,8475799,Nino Niederreiter,R,WPG,32,73,29,15,44
85,8474102,David Perron,L,OTT,36,73,25,19,44
85,8482702,Logan Stankoven,C,DAL,21,81,23,21,44
85,8475191,Reilly Smith,R,NYR,33,72,20,24,44
85,8476826,Yanni Gourde,C,SEA,33,69,19,25,44
85,8482110,Dawson Mercer,C,NJD,23,70,19,25,44
85,8479365,Trent Frederic,C,BOS,26,74,18,26,44
85,8482133,Thomas Bordeleau,C,SJS,22,69,13,31,44
85,8476869,Brady Skjei,D,NSH,30,75,9,35,44
85,8475151,Kyle Palmieri,C,NYI,33,75,22,21,43
85,8483431,Logan Cooley,C,UTA,20,74,21,22,43
85,8475722,Jason Zucker,L,BUF,32,69,20,23,43
85,8478856,Conor Garland,R,VAN,28,74,14,29,43
85,8482720,Matthew Knies,L,TOR,22,71,14,29,43
85,8481711,Matias Maccelli,L,UTA,24,73,12,31,43
85,8479425,Filip Hronek,D,VAN,27,73,9,34,43
85,8480188,Fabian Zetterlund,L,SJS,25,69,24,18,42
85,8474716,Jared Spurgeon,D,MIN,35,82,17,25,42
85,8479400,Pierre-Luc Dubois,L,WSH,26,64,16,26,42
85,8477495,Seth Jones,D,CHI,30,69,14,27,41
85,8477429,Andrew Copp,C,DET,30,81,12,29,41
85,8477444,Andre Burakovsky,L,SEA,29,69,8,33,41
85,8483490,Pavel Mintyukov,D,ANA,21,70,7,34,41
85,8475314,Anders Lee,L,NYI,34,79,22,18,40
85,8481618,Alex Newhook,C,MTL,23,70,19,21,40
85,8480028,Morgan Frost,C,PHI,25,73,19,21,40
85,8477476,Artturi Lehkonen,L,COL,29,81,17,23,40
85,8477426,Nicholas Paul,L,TBL,29,82,17,23,40
85,8482175,JJ Peterka,R,BUF,22,71,17,23,40
85,8477346,MacKenzie Weegar,D,CGY,30,72,10,30,40
85,8481542,Moritz Seider,D,DET,23,78,7,33,40
85,8476438,Brandon Saad,L,STL,32,71,21,18,39
85,8482745,Mason McTavish,C,ANA,21,65,15,24,39
85,8480797,Joel Farabee,L,PHI,24,70,15,24,39
85,8476792,Torey Krug,D,STL,33,74,14,25,39
85,8477021,Alex Kerfoot,C,UTA,30,69,13,26,39
85,8477932,Aaron Ekblad,D,FLA,28,69,11,28,39
85,8478458,John (Jack) Roslovic,C,CAR,27,67,11,28,39
85,8478038,Devon Toews,D,COL,30,69,10,29,39
85,8478438,Tommy Novak,C,NSH,27,70,10,29,39
85,8480434,Sean Durzi,D,UTA,26,67,10,29,39
85,8482475,Yegor Chinakhov,R,CBJ,23,58,23,15,38
85,8474641,Adam Henrique,C,EDM,34,78,21,17,38
85,8479525,Ross Colton,C,COL,28,80,20,18,38
85,8478474,Lawson Crouse,L,UTA,27,77,18,20,38
85,8480459,Pius Suter,C,VAN,28,72,17,21,38
85,8478542,Evan Rodrigues,C,FLA,31,71,16,22,38
85,8476927,Teddy Blueger,C,VAN,30,67,14,24,38
85,8479339,Patrik Laine,L,CBJ,26,68,13,25,38
85,8476292,Ondrej Palat,L,NJD,33,69,13,25,38
85,8475745,Charlie Coyle,C,BOS,32,76,11,27,38
85,8476854,Hampus Lindholm,D,BOS,30,75,9,29,38
85,8481546,Cam York,D,PHI,23,73,4,34,38
85,8479992,Michael Rasmussen,C,DET,25,78,24,13,37
85,8478042,Viktor Arvidsson,L,EDM,31,70,12,25,37
85,8480185,Eetu Luostarinen,C,FLA,26,72,9,28,37
85,8477948,Travis Sanheim,D,PHI,28,67,8,29,37
85,8474149,Evgenii Dadonov,R,DAL,35,82,19,17,36
85,8471698,T.J. Oshie,R,WSH,38,68,15,21,36
85,8474053,Logan Couture,C,SJS,35,59,10,26,36
85,8478055,Gustav Forsling,D,FLA,28,71,7,29,36
85,8480145,Neal Pionk,D,WPG,29,71,6,30,36
85,8480220,Noah Cates,L,PHI,25,69,16,19,35
85,8479591,Michael Eyssimont,C,TBL,28,82,15,20,35
85,8476458,Ryan Strome,C,ANA,31,65,13,22,35
85,8482105,Jake Sanderson,D,OTT,22,74,9,26,35
85,8476979,Erik Gustafsson,D,DET,32,76,8,27,35
85,8478463,Anthony Beauvillier,L,PIT,27,56,8,27,35
85,8481535,Nils Hoglander,L,VAN,24,67,20,14,34
85,8478057,Dakota Joshua,C,VAN,28,69,17,17,34
85,8476480,Vladislav Namestnikov,C,WPG,32,63,15,19,34
85,8475768,Jaden Schwartz,C,SEA,32,67,13,21,34
85,8480873,Rasmus Sandin,D,WSH,24,64,2,32,34
85,8474715,Cameron Atkinson,R,TBL,35,80,18,15,33
85,8474189,Lars Eller,C,PIT,35,64,18,15,33
85,8484153,Leo Carlsson,C,ANA,20,74,16,17,33
85,8478233,Andrew Mangiapane,L,WSH,28,74,16,17,33
85,8478109,Victor Olofsson,L,VGK,29,73,15,18,33
85,8477952,Robby Fabbri,C,ANA,28,66,15,18,33
85,8476921,Jordan Martinook,L,CAR,32,63,11,22,33
85,8482101,Danil Gushchin,L,SJS,22,63,11,22,33
85,8479351,Sam Steel,C,DAL,26,76,10,23,33
85,8478133,Jake Evans,C,MTL,28,74,10,23,33
85,8474563,Drew Doughty,D,LAK,35,69,8,25,33
85,8477969,Marcus Pettersson,D,PIT,28,77,8,25,33
85,8476917,Adam Pelech,D,NYI,30,80,3,30,33
85,8475764,Cam Fowler,D,ANA,33,73,2,31,33
85,8475793,Ryan Johansen,C,PHI,32,71,16,16,32
85,8476392,Adam Lowry,C,WPG,31,69,15,17,32
85,8480829,Jesperi Kotkaniemi,C,CAR,24,64,14,18,32
85,8478891,Mason Appleton,C,WPG,28,62,12,20,32
85,8476461,Sean Couturier,C,PHI,32,72,10,22,32
85,8478115,Pierre Engvall,L,NYI,28,78,10,22,32
85,8475193,Tomas Tatar,L,NJD,34,67,10,22,32
85,8475171,Oliver Ekman-Larsson,D,TOR,33,68,5,27,32
85,8482712,Oskar Olausson,R,COL,22,77,3,29,32
85,8476331,Dylan DeMelo,D,WPG,31,76,3,29,32
85,8481186,Logan O'Connor,R,COL,28,79,17,14,31
85,8480802,Ryan McLeod,C,BUF,25,66,16,15,31
85,8476897,Oskar Sundqvist,C,STL,30,67,13,18,31
85,8480849,Barrett Hayton,C,UTA,24,68,13,18,31
85,8477839,Conor Sheary,L,TBL,32,81,13,18,31
85,8475763,Kevin Hayes,R,PIT,32,70,12,19,31
85,8475218,Mattias Ekholm,D,EDM,34,71,8,23,31
85,8476923,Damon Severson,D,CBJ,30,77,7,24,31
85,8476902,Esa Lindell,D,DAL,30,77,7,24,31
85,8482122,Brock Faber,D,MIN,22,79,6,25,31
85,8483524,Shane Wright,C,SEA,20,56,19,11,30
85,8480893,Kirill Marchenko,R,CBJ,24,60,18,12,30
85,8473422,Nick Foligno,L,CHI,37,61,17,13,30
85,8476278,Colin Blackwell,C,DAL,31,78,15,15,30
85,8479353,Brett Howden,C,VGK,26,66,11,19,30
85,8482097,Jack Quinn,R,BUF,23,71,9,21,30
85,8481523,Kirby Dach,C,MTL,23,67,8,22,30
85,8481014,Alexander Romanov,D,NYI,24,77,8,22,30
85,8483505,Matthew Poitras,C,BOS,20,74,3,27,30
85,8475149,Marcus Johansson,L,MIN,34,64,17,12,29
85,8482705,Cole Sillinger,C,CBJ,21,68,16,13,29
85,8476474,Stefan Noesen,R,NJD,31,70,15,14,29
85,8481554,Kaapo Kakko,R,NYR,23,67,15,14,29
85,8483491,Ivan Miroshnichenko,L,WSH,20,55,10,19,29
85,8482749,Joshua Roy,R,MTL,21,68,10,19,29
85,8476462,Dougie Hamilton,D,NJD,31,62,9,20,29
85,8484203,Bradly Nadeau,L,CAR,19,65,9,20,29
85,8476885,Jacob Trouba,D,NYR,30,70,8,21,29
85,8481703,Valtteri Puustinen,R,PIT,25,55,5,24,29
85,8482655,Janis Moser,D,TBL,24,77,5,24,29
85,8476463,Jonas Brodin,D,MIN,31,75,4,25,29
85,8478396,Noah Hanifin,D,VGK,27,60,3,26,29
85,8481178,Egor Zamula,D,PHI,24,56,2,27,29
85,8482089,Jake Neighbours,L,STL,22,61,15,13,28
85,8477505,Alexander Wennberg,C,SJS,30,56,13,15,28
85,8480113,Alex Iafallo,L,WPG,31,68,13,15,28
85,8480003,Jesper Boqvist,C,FLA,26,70,13,15,28
85,8481604,Pavel Dorofeyev,L,VGK,24,64,12,16,28
85,8479393,Noah Gregor,L,OTT,26,72,12,16,28
85,8482671,Owen Power,D,BUF,22,69,9,19,28
85,8475200,Dmitry Orlov,D,CAR,33,73,7,21,28
85,8480144,David Kampf,C,TOR,29,66,7,21,28
85,8483493,Frank Nazar,C,CHI,20,51,13,14,27
85,8482146,Luke Evangelista,R,NSH,22,66,11,16,27
85,8475220,Marcus Foligno,L,MIN,33,61,11,16,27
85,8477488,Brett Pesce,D,NJD,30,74,8,19,27
85,8477987,Ryan Donato,C,CHI,28,53,7,20,27
85,8480817,K'Andre Miller,D,NYR,24,71,6,21,27
85,8479639,Dylan Coghlan,D,WPG,26,59,6,21,27
85,8476329,Travis Boyd,C,MIN,31,58,6,21,27
85,8477506,Ryan Pulock,D,NYI,30,76,5,22,27
85,8478472,Mathieu Joseph,R,STL,27,66,5,22,27
85,8478882,Vladislav Gavrikov,D,LAK,29,67,5,22,27
85,8477435,Ryan Graves,D,PIT,29,77,4,23,27
85,8480813,Joe Veleno,C,DET,24,75,14,12,26
85,8478020,Michael Amadio,R,OTT,28,77,12,14,26
85,8479390,Taylor Raddysh,R,WSH,26,60,11,15,26
85,8477989,Christian Dvorak,C,MTL,28,65,11,15,26
85,8477953,Kasperi Kapanen,R,STL,28,65,11,15,26
85,8477947,Sonny Milano,L,WSH,28,65,11,15,26
85,8481524,Bowen Byram,D,BUF,23,64,9,17,26
85,8481577,Philip Tomasino,C,NSH,23,62,7,19,26
85,8480049,Dylan Samberg,D,WPG,25,70,3,23,26
85,8478500,Ivan Provorov,D,CBJ,27,75,2,24,26
85,8481716,Dmitri Voronkov,L,CBJ,24,48,18,7,25
85,8480748,Kiefer Sherwood,L,VAN,29,59,14,11,25
85,8480871,Adam Boqvist,D,FLA,24,71,11,14,25
85,8477919,Frederick Gaudreau,C,MIN,31,56,11,14,25
85,8475848,Brendan Gallagher,R,MTL,32,65,10,15,25
85,8477478,William Carrier,L,CAR,30,60,10,15,25
85,8473563,Nicklas Backstrom,C,WSH,37,59,7,18,25
85,8476879,Cody Ceci,D,EDM,31,69,7,18,25
85,8474151,Ryan McDonagh,D,TBL,35,79,5,20,25
85,8479661,Tanner Jeannot,L,LAK,27,72,16,8,24
85,8476469,Joel Armia,R,MTL,31,66,14,10,24
85,8482055,Drew O'Connor,L,PIT,26,63,14,10,24
85,8476918,Jimmy Vesey,L,NYR,31,71,12,12,24
85,8482125,Alexander Holtz,R,VGK,22,74,12,12,24
85,8481580,Connor McMichael,C,WSH,23,61,12,12,24
85,8484145,Zach Benson,L,BUF,19,68,11,13,24
85,8470621,Corey Perry,R,EDM,39,73,11,13,24
85,8479316,Luke Kunin,C,SJS,27,61,10,14,24
85,8480995,Pontus Holmberg,R,TOR,25,57,10,14,24
85,8477220,Nate Schmidt,D,FLA,33,73,9,15,24
85,8478413,Jordan Greenway,L,BUF,27,65,7,17,24
85,8481606,Jordan Spence,D,LAK,23,63,4,20,24
85,8473507,Jeff Petry,D,DET,37,70,2,22,24
85,8478046,Danton Heinen,L,VAN,29,67,14,9,23
85,8482074,Connor Zary,C,CGY,23,69,14,9,23
85,8482259,Bobby McMann,C,TOR,28,64,13,10,23
85,8473533,Jordan Staal,C,CAR,36,65,13,10,23
85,8481582,Nicholas Robertson,L,TOR,23,71,12,11,23
85,8482079,Marco Rossi,C,MIN,23,55,11,12,23
85,8479996,Cody Glass,C,NSH,25,54,10,13,23
85,8479066,Ryan Lomberg,L,CGY,30,64,10,13,23
85,8479368,Max Jones,L,BOS,26,70,10,13,23
85,8482111,Justin Barron,D,MTL,23,63,9,14,23
85,8476419,Jean-Gabriel Pageau,C,NYI,32,77,8,15,23
85,8482660,Kent Johnson,C,CBJ,22,66,8,15,23
85,8476925,Colton Sissons,C,NSH,31,68,8,15,23
85,8480336,Sean Walker,D,CAR,30,75,7,16,23
85,8482157,Will Cuylle,L,NYR,22,68,7,16,23
85,8483499,Liam Ohgren,L,MIN,20,63,6,17,23
85,8476525,Colin Miller,D,WPG,32,59,5,18,23
85,8477507,Nikita Zadorov,D,BOS,29,62,5,18,23
85,8480878,Nils Lundkvist,D,DAL,24,70,4,19,23
85,8480043,Timothy Liljegren,D,TOR,25,57,1,22,23
85,8475760,Nick Bjugstad,C,UTA,32,72,13,9,22
85,8479336,Carl Grundstrom,R,SJS,27,51,13,9,22
85,8476981,Josh Anderson,R,MTL,30,71,12,10,22
85,8475231,Casey Cizikas,C,NYI,33,75,9,13,22
85,8477508,Curtis Lazar,C,NJD,29,59,9,13,22
85,8477425,Miles Wood,L,COL,29,78,8,14,22
85,8483482,Tristan Luneau,D,ANA,20,59,8,14,22
85,8479414,Nathan Bastian,R,NJD,27,55,8,14,22
85,8477903,Garnet Hathaway,R,PHI,33,67,8,14,22
85,8481553,Bobby Brink,R,PHI,23,60,7,15,22
85,8476422,Mike Reilly,D,NYI,31,70,7,15,22
85,8479315,Joey Anderson,R,CHI,26,47,7,15,22
85,8474090,Brendan Smith,D,DAL,35,51,7,15,22
85,8482624,Daniil Miromanov,D,CGY,27,58,5,17,22
85,8478911,Matt Roy,D,WSH,29,68,5,17,22
85,8476988,Matt Benning,D,SJS,30,64,4,18,22
85,8476892,Colton Parayko,D,STL,31,73,3,19,22
85,8474574,Tyler Myers,D,VAN,34,70,2,20,22
85,8478569,Noel Acciari,C,PIT,33,56,15,6,21
85,8480980,Connor Dewar,C,TOR,25,71,11,10,21
85,8478434,Keegan Kolesar,R,VGK,27,67,9,12,21
85,8477499,Rasmus Ristolainen,D,PHI,30,61,8,13,21
85,8481481,Blake Lizotte,C,PIT,27,68,8,13,21
85,8480078,Filip Chytil,C,NYR,25,67,7,14,21
85,8482073,Braden Schneider,D,NYR,23,66,7,14,21
85,8480289,Morgan Barron,C,WPG,26,46,7,14,21
85,8476931,Jake McCabe,D,TOR,31,62,5,16,21
85,8477845,Trevor van Riemsdyk,D,WSH,33,60,5,16,21
85,8477498,Darnell Nurse,D,EDM,29,77,4,17,21
85,8474034,Patrick Maroon,L,CHI,36,54,4,17,21
85,8480246,Nick Perbix,D,TBL,26,75,3,18,21
85,8480222,Sebastian Aho,D,PIT,28,76,3,18,21
85,8479983,Mario Ferraro,D,SJS,26,75,1,20,21
85,8480281,Alexey Toropchenko,R,STL,25,66,16,4,20
85,8481624,Ilya Mikheyev,R,CHI,30,62,13,7,20
85,8480068,Ryan Poehling,C,PHI,25,70,11,9,20
85,8477450,Jason Dickinson,C,CHI,29,62,11,9,20
85,8478013,Jake Walman,D,SJS,28,72,11,9,20
85,8479293,Brandon Tanev,L,SEA,33,59,10,10,20
85,8480205,Emil Bemstrom,C,PIT,25,62,10,10,20
85,8480835,Jack Drury,C,CAR,24,61,9,11,20
85,8475855,Jesper Fast,R,CAR,33,56,9,11,20
85,8476374,Sean Kuraly,C,CBJ,31,59,9,11,20
85,8480762,Eric Robinson,L,CAR,29,55,9,11,20
85,8483457,Lane Hutson,D,MTL,20,69,8,12,20
85,8483445,Cutter Gauthier,L,ANA,20,65,8,12,20
85,8481522,Peyton Krebs,C,BUF,23,64,8,12,20
85,8479328,Julien Gauthier,R,NYI,27,62,8,12,20
85,8482166,Shakir Mukhamadullin,D,SJS,22,56,8,12,20
85,8482117,Lukas Reichel,L,CHI,22,58,7,13,20
85,8475343,Nic Dowd,C,WSH,34,59,7,13,20
85,8482634,Alex Steeves,C,TOR,25,54,6,14,20
85,8482803,Olen Zellweger,D,ANA,21,67,4,16,20
85,8479026,Philippe Myers,D,TOR,27,47,4,16,20
85,8474567,Zach Bogosian,D,MIN,34,68,4,16,20
85,8479402,Jake Bean,D,CGY,26,72,2,18,20
85,8474673,TJ Brodie,D,CHI,34,61,2,18,20
85,8475181,Nick Leddy,D,STL,33,68,1,19,20
85,8477573,Nathan Walker,L,STL,30,52,15,4,19
85,8478508,Yakov Trenin,C,MIN,27,58,11,8,19
85,8483468,Jiri Kulich,C,BUF,20,55,10,9,19
85,8477406,Mattias Janmark,C,EDM,32,67,10,9,19
85,8483565,Nick Blankenburg,D,NSH,26,59,9,10,19
85,8477979,Nicolas Aube-Kubel,R,BUF,28,60,8,11,19
85,8477015,Connor Brown,R,EDM,30,66,7,12,19
85,8476994,Vinnie Hinostroza,C,NSH,30,47,6,13,19
85,8477369,Carson Soucy,D,VAN,30,60,6,13,19
85,8479671,Mathieu Olivier,R,CBJ,27,46,6,13,19
85,8480891,Michael Kesselring,D,UTA,24,55,5,14,19
85,8475790,Erik Gudbranson,D,CBJ,32,75,5,14,19
85,8479976,Juuso Valimaki,D,UTA,26,64,4,15,19
85,8479982,Conor Timmins,D,TOR,26,60,4,15,19
85,8482087,Kaiden Guhle,D,MTL,22,67,3,16,19
85,8476856,Mathew Dumba,D,DAL,30,70,2,17,19
85,8478416,Erik Cernak,D,TBL,27,72,2,17,19
85,8482155,Alex Laferriere,R,LAK,23,73,14,4,18
85,8476822,Luke Glendening,C,TBL,35,79,9,9,18
85,8475225,Craig Smith,C,CHI,35,50,9,9,18
85,8482148,Hendrix Lapierre,C,WSH,22,49,9,9,18
85,8479941,Justin Danforth,R,CBJ,31,49,8,10,18
85,8481032,Paul Cotter,C,NJD,25,57,8,10,18
85,8478043,Sam Lafferty,C,BUF,29,56,7,11,18
85,8478432,Christian Fischer,R,DET,27,74,7,11,18
85,8477018,Ben Hutton,D,VGK,31,53,6,12,18
85,8482142,Jamie Drysdale,D,PHI,22,59,5,13,18
85,8478178,Darren Raddysh,D,TBL,28,72,5,13,18
85,8481013,Jonatan Berggren,R,DET,24,62,5,13,18
85,8476457,Adam Larsson,D,SEA,32,69,4,14,18
85,8475791,Taylor Hall,L,CHI,33,59,3,15,18
85,8479371,Dante Fabbro,D,NSH,26,63,2,16,18
85,8481521,Ronnie Attard,D,PHI,25,57,1,17,18
85,8481704,Juuso Parssinen,C,NSH,23,57,10,7,17
85,8477392,Hudson Fasching,R,NYI,29,65,9,8,17
85,8476878,Zemgus Girgensons,C,TBL,30,76,8,9,17
85,8476624,Barclay Goodrow,C,SJS,31,51,7,10,17
85,8480855,Jack McBain,C,UTA,24,64,6,11,17
85,8481656,Aliaksei Protas,C,WSH,23,60,5,12,17
85,8481093,Rafael Harvey-Pinard,L,MTL,25,65,5,12,17
85,8476960,Andreas Athanasiou,C,CHI,30,52,4,13,17
85,8478840,Will Borgen,D,SEA,28,60,3,14,17
85,8479398,Samuel Girard,D,COL,26,59,3,14,17
85,8482245,Artem Zub,D,OTT,29,70,3,14,17
85,8476312,Josh Manson,D,COL,33,66,3,14,17
85,8480074,Alexandre Texier,C,STL,25,54,3,14,17
85,8481567,Henry Thrun,D,SJS,23,55,3,14,17
85,8475208,Brian Dumoulin,D,ANA,33,57,3,14,17
85,8475188,Brayden McNabb,D,VGK,33,59,2,15,17
85,8478507,John Marino,D,UTA,27,66,1,16,17
85,8475324,Nick Jensen,D,OTT,34,66,1,16,17
85,8475462,Radko Gudas,D,ANA,34,72,0,17,17
85,8476873,Mark Jankowski,C,NSH,30,56,7,9,16
85,8482809,Jackson Blake,R,CAR,21,56,6,10,16
85,8480448,Parker Kelly,L,COL,25,76,6,10,16
85,8479324,Ryan Lindgren,D,NYR,26,71,6,10,16
85,8479520,Brandon Duhaime,R,WSH,27,55,5,11,16
85,8478851,Alexandre Carrier,D,NSH,28,71,4,12,16
85,8481019,David Gustafsson,C,WPG,24,40,4,12,16
85,8481059,Scott Perunovich,D,STL,26,62,4,12,16
85,8480073,Erik Brannstrom,D,COL,25,68,3,13,16
85,8476467,Jamie Oleksiak,D,SEA,32,66,3,13,16
85,8478452,Caleb Jones,D,LAK,27,57,3,13,16
85,8475233,David Savard,D,MTL,34,62,3,13,16
85,8479980,Nicolas Hague,D,VGK,26,46,2,14,16
85,8480860,Kevin Bahl,D,CGY,24,57,1,15,16
85,8477446,Michael McCarron,R,NSH,29,54,10,5,15
85,8479994,Jaret Anderson-Dolan,C,WPG,25,36,9,6,15
85,8473453,Trevor Lewis,C,LAK,37,68,8,7,15
85,8481601,Simon Holmstrom,R,NYI,23,62,8,7,15
85,8478421,A.J. Greer,L,FLA,28,61,8,7,15
85,8482679,Matt Coronato,R,CGY,22,60,7,8,15
85,8480025,MacKenzie Entwistle,R,FLA,25,60,6,9,15
85,8477931,Tomas Nosek,L,FLA,32,62,6,9,15
85,8480157,Calle Rosen,D,COL,30,50,6,9,15
85,8480011,Klim Kostin,C,SJS,25,50,6,9,15
85,8482062,Cole Smith,L,NSH,29,59,5,10,15
85,8475279,Ben Chiarot,D,DET,33,66,3,12,15
85,8482067,Connor Mackey,D,NYR,28,54,3,12,15
85,8480035,Henri Jokiharju,D,BUF,25,57,2,13,15
85,8479372,Joshua Mahura,D,SEA,26,54,2,13,15
85,8476891,Matthew Grzelcyk,D,PIT,30,67,1,14,15
85,8480879,Jacob Bernard-Docker,D,OTT,24,49,0,15,15
85,8479619,Michael Carcone,L,UTA,28,67,9,5,14
85,8481518,Nolan Foote,L,NJD,24,36,9,5,14
85,8481028,Martin Pospisil,C,CGY,25,56,8,6,14
85,8483466,Kevin Korchinski,D,CHI,20,51,8,6,14
85,8481517,Brett Leason,R,ANA,25,56,7,7,14
85,8480806,Isac Lundestrom,C,ANA,25,58,7,7,14
85,8481617,Vasily Podkolzin,R,VAN,23,43,7,7,14
85,8471709,Marc-Edouard Vlasic,D,SJS,37,56,7,7,14
85,8479344,Jesse Puljujarvi,R,PIT,26,57,5,9,14
85,8476874,Olli Maatta,D,DET,30,65,4,10,14
85,8477365,Connor Clifton,D,BUF,29,57,4,10,14
85,8479998,Mikey Anderson,D,LAK,25,60,3,11,14
85,8476429,Scott Mayfield,D,NYI,32,72,3,11,14
85,8476967,Brett Kulak,D,EDM,30,53,3,11,14
85,8475690,Chris Tanev,D,TOR,35,55,1,13,14
85,8482737,Zack Bolduc,C,STL,21,52,9,4,13
85,8478831,Kevin Stenlund,C,UTA,28,49,9,4,13
85,8477353,Tyler Motte,C,DET,29,65,8,5,13
85,8484149,Gavin Brindley,C,CBJ,20,45,8,5,13
85,8480789,Oliver Wahlstrom,R,NYI,24,75,7,6,13
85,8480252,Cole Guttman,C,CHI,25,40,7,6,13
85,8481789,Tye Kartye,L,SEA,23,39,7,6,13
85,8481441,Joe Snively,C,DET,28,68,6,7,13
85,8478451,Ethan Bear,D,WSH,27,46,6,7,13
85,8479439,Jacob MacDonald,D,COL,31,49,6,7,13
85,8479543,Michael Pezzetta,L,MTL,26,51,5,8,13
85,8480796,Martin Fehervary,D,WSH,25,54,4,9,13
85,8481122,Simon Benoit,D,TOR,26,50,4,9,13
85,8475455,Brenden Dillon,D,NJD,34,58,3,10,13
85,8477034,Jaycob Megna,D,FLA,32,45,3,10,13
85,8480058,Pierre-Olivier Joseph,D,STL,25,56,3,10,13
85,8477938,Haydn Fleury,D,WPG,28,42,3,10,13
85,8478443,Brandon Carlo,D,BOS,28,59,2,11,13
85,8482192,Isaak Phillips,D,CHI,23,53,2,11,13
85,8480172,Jan Rutta,D,SJS,34,62,2,11,13
85,8480887,Jordan Harris,D,MTL,24,52,2,11,13
85,8479370,Tyson Jost,C,CAR,26,44,7,5,12
85,8475842,Sam Carrick,C,NYR,32,54,7,5,12
85,8480845,Rasmus Kupari,C,WPG,24,44,7,5,12
85,8478585,Derek Ryan,C,EDM,38,56,6,6,12
85,8476889,Radek Faksa,C,STL,30,59,6,6,12
85,8479442,Troy Stecher,D,EDM,30,52,6,6,12
85,8480880,Jakub Lauko,C,MIN,24,37,6,6,12
85,8482859,Zack Ostapchuk,C,OTT,21,47,5,7,12
85,8474166,Alec Martinez,D,CHI,37,62,4,8,12
85,8482733,Logan Mailloux,D,MTL,31,33,4,8,12
85,8480848,Ty Dellandrea,C,SJS,24,46,3,9,12
85,8473446,Erik Johnson,D,PHI,36,45,3,9,12
85,8478136,Jake Middleton,D,MIN,28,76,2,10,12
85,8478211,Dryden Hunt,L,CGY,29,42,8,3,11
85,8481477,Nico Sturm,C,SJS,29,51,7,4,11
85,8481147,Reese Johnson,C,MIN,26,41,6,5,11
85,8479536,Axel Jonsson-Fjallby,L,WPG,26,29,6,5,11
85,8481532,Alex Turcotte,C,LAK,23,42,6,5,11
85,8477482,Zachary Sanford,L,CHI,30,31,6,5,11
85,8481754,Nikita Nesterenko,C,ANA,23,43,6,5,11
85,8475235,Nicolas Deslauriers,L,PHI,33,45,5,6,11
85,8481161,Jake Christiansen,D,CBJ,25,53,5,6,11
85,8477887,Patrick Brown,C,BOS,32,56,5,6,11
85,8482765,Isak Rosen,R,BUF,21,24,5,6,11
85,8478017,Mark Friedman,D,VAN,29,38,4,7,11
85,8481568,Alex Vlasic,D,CHI,23,57,4,7,11
85,8478970,Jalen Chatfield,D,CAR,28,68,3,8,11
85,8481527,Kaedan Korczak,D,VGK,23,42,3,8,11
85,8481708,Zac Jones,D,NYR,24,43,2,9,11
85,8478399,Jonas Siegenthaler,D,NJD,27,61,2,9,11
85,8470600,Ryan Suter,D,STL,39,61,2,9,11
85,8481751,Lukas Rousek,R,BUF,25,39,2,9,11
85,8475179,Dmitry Kulikov,D,FLA,34,66,1,10,11
85,8478859,Niko Mikkola,D,FLA,28,50,1,10,11
85,8476372,Nick Seeler,D,PHI,31,52,1,10,11
85,8480001,Urho Vaakanainen,D,ANA,25,56,0,11,11
85,8483460,David Jiricek,D,CBJ,21,65,0,11,11
85,8481592,Jakob Pelletier,L,CGY,23,44,8,2,10
85,8471817,Ryan Reaves,R,TOR,37,56,8,2,10
85,8482659,Josh Doan,R,UTA,22,49,7,3,10
85,8483495,Simon Nemec,D,NJD,20,54,4,6,10
85,8479772,Zack MacEwen,R,OTT,28,46,4,6,10
85,8479718,Alex Barré-Boulet,C,MTL,27,54,4,6,10
85,8476867,Brendan Gaunce,C,MIN,30,33,4,6,10
85,8478468,Jeremy Lauzon,D,NSH,27,53,4,6,10
85,8481599,Victor Soderstrom,D,UTA,23,41,3,7,10
85,8480192,Johnathan Kovacevic,D,NJD,27,47,3,7,10
85,8475762,Derek Forbort,D,VAN,32,52,3,7,10
85,8480070,Ian Mitchell,D,BOS,25,48,3,7,10
85,8476442,Matt Nieto,L,PIT,32,52,3,7,10
85,8478146,Matthew Highmore,C,OTT,28,40,3,7,10
85,8482730,Brandt Clarke,D,LAK,21,55,2,8,10
85,8478021,William Lagesson,D,DET,28,31,2,8,10
85,8477851,Jordan Oesterle,D,BOS,32,43,1,9,10
85,8480950,Ilya Lyubushkin,D,DAL,30,62,1,9,10
85,8481701,Santeri Hatakka,D,NJD,23,42,1,9,10
85,8481598,Philip Broberg,D,EDM,23,47,1,9,10
85,8482861,Vincent Iorio,D,WSH,22,32,0,10,10
85,8482964,Arber Xhekaj,D,MTL,23,41,0,10,10
85,8480355,Mark Kastelic,C,BOS,25,59,8,1,9
85,8476934,Brock McGinn,L,ANA,30,50,7,2,9
85,8477380,Jonny Brodzinski,C,NYR,31,45,6,3,9
85,8482762,Simon Edvinsson,D,DET,21,50,6,3,9
85,8479379,Givani Smith,R,SJS,26,31,5,4,9
85,8480021,Jack Studnicka,C,LAK,25,51,4,5,9
85,8484911,Collin Graf,R,SJS,22,45,4,5,9
85,8480727,Zach Whitecloud,D,VGK,28,48,4,5,9
85,8482095,Tyler Kleven,D,OTT,22,50,4,5,9
85,8483763,Maksymilian Szuber,D,UTA,22,34,4,5,9
85,8482784,Zach Dean,C,STL,21,36,3,6,9
85,8481550,Adam Beckman,L,NJD,23,36,2,7,9
85,8478454,Noah Juulsen,D,VAN,27,32,2,7,9
85,8482511,Mason Lohrei,D,BOS,23,44,1,8,9
85,8480007,Jonas Rondbjerg,R,VGK,25,46,0,9,9
85,8476858,Phillip Di Giuseppe,L,VAN,31,39,6,2,8
85,8479638,Justin Brazeau,R,BOS,26,33,6,2,8
85,8482077,Dylan Holloway,L,EDM,23,53,5,3,8
85,8482666,Scott Morrow,D,CAR,22,44,5,3,8
85,8482807,Ethan Del Mastro,D,CHI,21,41,4,4,8
85,8479359,Beck Malenstyn,L,BUF,26,41,4,4,8
85,8481609,Vladislav Kolyachonok,D,UTA,23,31,4,4,8
85,8474013,Ian Cole,D,UTA,35,55,3,5,8
85,8475750,Jon Merrill,D,MIN,32,57,3,5,8
85,8479968,Vinni Lettieri,C,BOS,29,48,3,5,8
85,8481605,Jackson LaCombe,D,ANA,23,38,3,5,8
85,8481537,Nikita Okhotiuk,D,CGY,24,44,2,6,8
85,8482176,Wyatt Kaiser,D,CHI,22,47,2,6,8
85,8476913,Devin Shore,C,MIN,30,35,2,6,8
85,8482451,Mikael Pyyhtia,L,CBJ,23,47,1,7,8
85,8476952,Dominic Toninato,C,WPG,30,35,1,7,8
85,8482652,Walker Duehr,R,CGY,27,45,1,7,8
85,8479986,Kole Lind,R,DAL,26,46,1,7,8
85,8481056,Spencer Stastney,D,NSH,24,34,1,7,8
85,8480245,Olle Lycksell,R,PHI,25,34,1,7,8
85,8480196,Jacob Bryson,D,BUF,27,47,0,8,8
85,8474612,Travis Hamonic,D,OTT,34,44,0,8,8
85,8482070,Mitchell Chaffee,R,TBL,26,49,4,3,7
85,8482751,Ryan Winterton,C,SEA,21,37,4,3,7
85,8482747,Brennan Othmann,L,NYR,21,40,4,3,7
85,8483630,Pavol Regenda,L,ANA,25,29,4,3,7
85,8481641,Joel Kiviranta,L,COL,28,69,3,4,7
85,8480834,Ty Emberson,D,SJS,24,32,3,4,7
85,8479369,Andrew Peeke,D,BOS,26,54,2,5,7
85,8479378,Logan Stanley,D,WPG,26,38,2,5,7
85,8477962,Brendan Lemieux,L,CAR,28,40,2,5,7
85,8478450,Parker Wotherspoon,D,BOS,27,33,1,6,7
85,8478874,Adam Gaudette,R,OTT,28,38,1,6,7
85,8479587,Rhett Gardner,C,PHI,28,23,0,7,7
85,8479981,Jonah Gadjovich,L,FLA,26,38,5,1,6
85,8479944,Zach Aston-Reese,C,VGK,30,47,4,2,6
85,8482201,Gage Goncalves,C,TBL,23,25,4,2,6
85,8475718,Justin Holl,D,DET,32,56,3,3,6
85,8480292,Carson Meyer,R,ANA,27,31,3,3,6
85,8481543,Nikita Alexandrov,C,STL,24,26,3,3,6
85,8481167,Brayden Pachal,D,CGY,25,45,1,5,6
85,8480990,Declan Chisholm,D,MIN,24,31,1,5,6
85,8477244,Chad Ruhwedel,D,NYR,34,37,1,5,6
85,8480807,Mattias Samuelsson,D,BUF,24,57,0,6,6
85,8484254,Akito Hirose,D,VAN,25,40,0,6,6
85,8479249,Andrew Poturalski,C,SJS,30,39,0,6,6
85,8471677,Jack Johnson,D,CBJ,37,66,0,6,6
85,8479972,Mason Shaw,C,WPG,26,40,0,6,6
85,8481556,John Beecher,C,BOS,23,24,4,1,5
85,8480851,Akil Thomas,C,LAK,24,25,3,2,5
85,8482744,James Malatesta,L,CBJ,21,42,2,3,5
85,8482496,Nils Aman,C,VAN,24,40,2,3,5
85,8479576,Vincent Desharnais,D,VAN,28,30,2,3,5
85,8477401,John Hayden,C,SEA,29,31,2,3,5
85,8482141,Lukas Cormier,D,VGK,22,32,2,3,5
85,8482153,Brendan Brisson,C,VGK,23,27,2,3,5
85,8484325,Waltteri Merela,C,TBL,26,20,2,3,5
85,8477070,Liam O'Brien,C,UTA,30,54,1,4,5
85,8479291,Kevin Rooney,C,CGY,31,49,1,4,5
85,8480441,Trey Fix-Wolansky,R,CBJ,25,41,1,4,5
85,8477335,Kyle Burroughs,D,LAK,29,43,1,4,5
85,8479991,Jake Leschyshyn,C,NYR,25,26,1,4,5
85,8479348,Kale Clague,D,BUF,26,40,0,5,5
85,8482145,Mavrik Bourque,C,DAL,22,56,0,5,5
85,8481237,Kyle MacLean,C,NYI,25,20,0,5,5
85,8483397,Marc McLaughlin,C,BOS,25,29,3,1,4
85,8477467,Gustav Olofsson,D,SEA,30,21,3,1,4
85,8482147,Jean-Luc Foudy,C,COL,22,25,3,1,4
85,8484287,Cole McWard,D,VAN,23,21,3,1,4
85,8483549,Lucas Condotta,L,MTL,27,34,2,2,4
85,8483570,Ben Meyers,C,SEA,26,36,2,2,4
85,8482177,Marat Khusnutdinov,C,MIN,22,32,2,2,4
85,8480890,Jan Jenik,C,OTT,24,31,2,2,4
85,8481600,Tobias Bjornfot,D,FLA,23,38,1,3,4
85,8476441,Joel Edmundson,D,LAK,31,40,1,3,4
85,8483619,Filip Roos,D,OTT,25,32,1,3,4
85,8481593,Jayden Struble,D,MTL,23,29,1,3,4
85,8482713,Mackie Samoskevich,R,FLA,22,41,0,4,4
85,8477473,Justin Bailey,R,SJS,29,20,3,0,3
85,8478424,Jansen Harkins,C,ANA,27,49,2,1,3
85,8482929,Emil Lilleberg,D,TBL,23,15,2,1,3
85,8476473,Connor Murphy,D,CHI,31,39,2,1,3
85,8477384,Joshua Brown,D,EDM,30,49,2,1,3
85,8483512,Matthew Savoie,C,EDM,20,13,2,1,3
85,8481422,Jake Lucchini,C,NSH,29,24,2,1,3
85,8475958,Michael Sgarbossa,C,WSH,32,25,2,1,3
85,8481679,Maxence Guenette,D,OTT,23,34,2,1,3
85,8480267,Sammy Walker,C,MIN,25,22,2,1,3
85,8483395,Arshdeep Bains,L,VAN,23,14,2,1,3
85,8482088,Justin Sourdif,R,FLA,22,20,2,1,3
85,8478446,Glenn Gawdin,C,LAK,27,14,2,1,3
85,8474568,Luke Schenn,D,NSH,35,47,1,2,3
85,8478409,Anthony Richard,C,PHI,28,31,1,2,3
85,8477462,Robert Hagg,D,VGK,29,19,1,2,3
85,8480844,Grigori Denisenko,L,VGK,24,28,1,2,3
85,8480870,Bo Groulx,C,NYR,24,40,1,2,3
85,8479419,Brett Murray,L,BUF,26,19,1,2,3
85,8478051,Max Willman,C,NJD,29,22,1,2,3
85,8480468,James Hamblin,L,EDM,25,21,1,2,3
85,8475755,Alexander Petrovic,D,DAL,32,11,1,2,3
85,8478477,Mitchell Stephens,C,SEA,27,18,1,2,3
85,8475177,Calvin de Haan,D,COL,33,39,0,3,3
85,8477971,Andreas Englund,D,LAK,28,31,0,3,3
85,8479367,William Lockwood,R,FLA,26,25,0,3,3
85,8481030,Jack St. Ivany,D,PIT,25,17,0,3,3
85,8481462,Mason Morelli,L,VGK,28,16,0,3,3
85,8479362,Riley Tufte,L,BOS,26,18,2,0,2
85,8482460,Matt Rempe,C,NYR,22,9,2,0,2
85,8482165,Yan Kuznetsov,D,CGY,22,24,1,1,2
85,8482144,Jack Thompson,D,SJS,22,20,1,1,2
85,8481065,Angus Crookshank,L,OTT,25,12,1,1,2
85,8482162,Roby Jarventie,L,EDM,22,9,1,1,2
85,8475413,Justin Dowling,C,NJD,34,17,1,1,2
85,8479985,Cale Fleury,D,SEA,26,26,1,1,2
85,8482061,Brandon Biro,L,SEA,26,17,1,1,2
85,8483489,Fraser Minten,C,TOR,31,12,1,1,2
85,8483471,Brad Lambert,C,WPG,31,8,1,1,2
85,8482094,Daemon Hunt,D,MIN,22,14,1,1,2
85,8482197,Adam Raska,R,MIN,23,8,1,1,2
85,8477073,Kurtis MacDermid,L,NJD,30,31,0,2,2
85,8482516,Matthew Kessel,D,STL,24,13,0,2,2
85,8477810,Joel Hanley,D,CGY,33,26,0,2,2
85,8479320,Maxime Lajoie,D,SEA,27,20,0,2,2
85,8478502,Dennis Gilbert,D,BUF,28,19,0,2,2
85,8482172,Landon Slaggert,L,CHI,22,26,0,2,2
85,8481541,Samuel Bolduc,D,NYI,24,26,0,2,2
85,8482118,Sam Colangelo,R,ANA,23,13,0,2,2
85,8481043,Cole Koepke,L,BOS,26,15,0,2,2
85,8480032,Shane Bowers,C,NJD,25,17,0,2,2
85,8481806,Louis Crevier,D,CHI,23,12,0,2,2
85,8480823,Alexander Alexeyev,D,WSH,25,13,0,2,2
85,8484258,Sam Malinski,D,COL,26,26,0,2,2
85,8477527,Ross Johnston,L,ANA,30,27,1,0,1
85,8483012,Logan Morrison,C,SEA,22,29,1,0,1
85,8477320,Anton Blidh,L,NYR,29,17,1,0,1
85,8482250,Callahan Burke,C,VGK,27,22,1,0,1
85,8477993,Justin Kirkland,C,CGY,28,7,1,0,1
85,8481743,Marc Del Gaizo,D,NSH,25,15,1,0,1
85,8480084,Nick DeSimone,D,NJD,30,21,1,0,1
85,8480075,Cameron Crotty,D,MIN,25,10,1,0,1
85,8483567,Georgii Merkulov,C,BOS,24,8,1,0,1
85,8481534,Raphael Lavoie,C,EDM,24,5,1,0,1
85,8483407,Brandon Scanlin,D,NYR,25,6,1,0,1
85,8482787,Nikita Chibrikov,R,WPG,31,9,1,0,1
85,8483546,Marshall Rifai,D,TOR,26,11,1,0,1
85,8474062,Riley Nash,C,NYR,35,20,0,1,1
85,8482470,Ilya Solovyov,D,CGY,24,20,0,1,1
85,8481719,Maxwell Crozier,D,TBL,24,14,0,1,1
85,8478854,Ryan Shea,D,PIT,27,7,0,1,1
85,8479330,Brandon Gignac,C,MTL,27,6,0,1,1
85,8481564,Ryan Johnson,D,BUF,23,13,0,1,1
85,8482102,Vasily Ponomarev,C,PIT,22,12,0,1,1
85,8481699,Aku Raty,R,UTA,23,18,0,1,1
85,8477149,Scott Sabourin,R,SJS,32,8,0,1,1
85,8483597,Milos Kelemen,L,UTA,25,14,0,1,1
85,8481578,Graeme Clarke,R,MIN,23,8,0,1,1
85,8484304,Uvis Balinskis,D,FLA,28,9,0,1,1
85,8482126,Emil Andrae,D,PHI,31,2,0,1,1
85,8484326,Patrik Koch,D,UTA,28,3,0,1,1
85,8484255,Jason Polin,R,COL,25,2,0,0,0
85,8478881,Brett Seney,L,CHI,28,19,0,0,0
85,8481206,John Ludvig,D,PIT,24,11,0,0,0
85,8481726,Adam Edstrom,C,NYR,24,7,0,0,0
85,8481655,Cole Schwindt,R,CGY,23,5,0,0,0
85,8481006,Tyler Tucker,D,STL,24,13,0,0,0
85,8479421,Jacob Moverare,D,LAK,26,7,0,0,0
85,8482476,Emil Heineman,L,MTL,23,2,0,0,0
85,8482858,Ryker Evans,D,SEA,23,27,0,0,0
85,8481024,Linus Karlsson,C,VAN,25,11,0,0,0
85,8483398,Declan Carlile,D,TBL,31,6,0,0,0
85,8481585,Egor Afanasyev,L,SJS,23,12,0,0,0
85,8477541,Dakota Mermis,D,TOR,30,6,0,0,0
85,8480306,Grant Hutton,D,NYI,29,9,0,0,0
85,8483609,Adam Klapka,R,CGY,24,4,0,0,0
85,8480874,Adam Ginning,D,PHI,24,8,0,0,0
85,8483432,Luca Del Bel Belluz,C,CBJ,31,5,0,0,0
85,8475795,Dylan McIlrath,D,WSH,32,12,0,0,0
85,8478011,Louie Belpedio,D,PHI,28,12,0,0,0
85,8483401,Marc Johnstone,R,PIT,28,1,0,0,0
85,8475780,Chris Wagner,R,COL,33,9,0,0,0
85,8479522,Hardy Haman Aktell,D,WSH,26,4,0,0,0
85,8478147,Bokondji Imama,L,PIT,28,1,0,0,0
85,8483531,Brian Halonen,L,NJD,25,3,0,0,0
85,8484321,Nikolas Matinpalo,D,OTT,26,1,0,0,0
85,8478956,Samuel Laberge,L,NJD,27,0,0,0,0
85,8483920,Pierrick Dube,R,WSH,23,8,0,0,0
85,8476323,Max McCormick,L,SEA,32,6,0,0,0
85,8480274,Philip Kemp,D,EDM,25,1,0,0,0
85,8484259,Ondrej Pavel,C,COL,31,3,0,0,0
85,8470794,Joe Pavelski,C,,40,0,0,0,0
85,8479321,Lucas Johansen,D,,27,0,0,0,0
85,8477950,Tony DeAngelo,D,,29,0,0,0,0
85,8471218,Blake Wheeler,R,,38,0,0,0,0
85,8475197,Tyson Barrie,D,,33,0,0,0,0
85,8474157,Max Pacioretty,L,,36,0,0,0,0
85,8475744,Evgeny Kuznetsov,C,,32,0,0,0,0
85,8474037,James van Riemsdyk,L,,35,0,0,0,0
85,8476907,Mackenzie MacEachern,L,,30,0,0,0,0
85,8480216,Jacob Peterson,C,,25,0,0,0,0
85,8474602,Justin Schultz,D,,34,0,0,0,0
85,8482222,Alexander Barabanov,L,,30,0,0,0,0
85,8474031,Kevin Shattenkirk,D,,35,0,0,0,0
85,8477330,Dominik Kubalik,L,,29,0,0,0,0
85,8480884,Calen Addison,D,,24,0,0,0,0
85,8475906,John Klingberg,D,,32,0,0,0,0
85,8480008,Adam Ruzicka,C,,25,0,0,0,0
85,8476884,Derrick Pouliot,D,,30,0,0,0,0
85,8476919,Chris Tierney,C,,30,0,0,0,0
85,8479415,Michael McLeod,C,,26,0,0,0,0
85,8474870,Tyler Johnson,C,,34,0,0,0,0
85,8470604,Jeff Carter,C,,39,0,0,0,0
85,8478104,Sammy Blais,L,,28,0,0,0,0
85,8474884,Mike Hoffman,C,,35,0,0,0,0
85,8481591,Sam Poulin,R,,23,0,0,0,0
85,8471274,Alex Goligoski,D,,39,0,0,0,0
85,8476871,Tanner Pearson,L,,32,0,0,0,0
85,8476393,Nick Cousins,C,,31,0,0,0,0
85,8479977,Kailer Yamamoto,R,,26,0,0,0,0
85,8479346,Dillon Dube,C,,26,0,0,0,0
85,8480184,Gustav Lindstrom,D,,26,0,0,0,0
85,8479376,Victor Mete,D,,26,0,0,0,0
85,8473449,Kyle Okposo,R,,36,0,0,0,0
85,8481058,Jesse Ylonen,R,,25,0,0,0,0
85,8475752,Tyler Pitlick,C,,33,0,0,0,0
85,8481239,Samuel Fagemo,L,,24,0,0,0,0
85,8480821,Filip Zadina,R,,25,0,0,0,0
85,8470966,Mark Giordano,D,,41,0,0,0,0
85,8478495,Denis Gurianov,R,,27,0,0,0,0
85,8477464,Nic Petan,C,,29,0,0,0,0
85,8478099,Kevin Labanc,R,,29,0,0,0,0
85,8482241,Radim Zohorna,L,,28,0,0,0,0
85,8474040,Sam Gagner,C,,35,0,0,0,0
85,8479514,Rem Pitlick,C,,27,0,0,0,0
85,8478430,Oliver Kylington,D,,27,0,0,0,0
85,8479533,Joona Koppanen,L,,26,0,0,0,0
85,8479984,Cal Foote,D,,26,0,0,0,0
85,8477126,Jayson Megna,C,,34,0,0,0,0
85,8475164,Jakob Silfverberg,R,,34,0,0,0,0
85,8474009,Nick Bonino,C,,36,0,0,0,0
85,8479458,Nikita Zaitsev,D,,33,0,0,0,0
85,8477944,Jakub Vrana,L,,28,0,0,0,0
85,8471699,Andrew Cogliano,C,,37,0,0,0,0
85,8478067,Oskar Lindblom,L,,28,0,0,0,0
85,8471686,Marc Staal,D,,37,0,0,0,0
85,8470610,Zach Parise,L,,40,0,0,0,0
85,8478904,Steven Lorentz,C,,28,0,0,0,0
85,8473473,Milan Lucic,L,,36,0,0,0,0
85,8480031,Maxime Comtois,L,,25,0,0,0,0
85,8478512,Austin Czarnik,C,,32,0,0,0,0
85,8473504,Cal Clutterbuck,R,,37,0,0,0,0
85,8477454,Adam Erne,L,,29,0,0,0,0
85,8479383,Boris Katchouk,L,,26,0,0,0,0
85,8475825,Jani Hakanpää,D,,32,0,0,0,0
85,8477846,Ryan Carpenter,C,,33,0,0,0,0
85,8477930,Pierre-Edouard Bellemare,L,,39,0,0,0,0
85,8478400,Colin White,C,,27,0,0,0,0
85,8480226,Marián Studenic,R,,26,0,0,0,0
85,8480853,Liam Foudy,C,,24,0,0,0,0
85,8475797,Jarred Tinordi,D,,32,0,0,0,0
85,8479423,Alex Nylander,L,,26,0,0,0,0
85,8474618,Marco Scandella,D,,34,0,0,0,0
85,8478028,Fredrik Olofsson,L,,28,0,0,0,0
85,8474709,Matt Martin,L,,35,0,0,0,0
85,8481070,Hugh McGing,L,,26,0,0,0,0
85,8479546,Oskar Steen,C,,26,0,0,0,0
85,8474145,Robert Bortuzzo,D,,35,0,0,0,0
85,8476915,Jujhar Khaira,L,,30,0,0,0,0
85,8475278,Byron Froese,C,,33,0,0,0,0
85,8481812,Nikolai Knyzhov,D,,27,0,0,0,0
85,8478408,Travis Dermott,D,,28,0,0,0,0
85,8481077,John Leonard,L,,26,0,0,0,0
85,8479547,Matthew Phillips,R,,26,0,0,0,0
85,8480836,Jonathan Gruden,C,,24,0,0,0,0
85,8481690,Tyler Angle,C,,24,0,0,0,0
85,8475766,Austin Watson,L,,32,0,0,0,0
85,8481016,Ruslan Iskhakov,C,,24,0,0,0,0
85,8478078,Rourke Chartier,C,,28,0,0,0,0
85,8480776,Sheldon Rempal,R,,29,0,0,0,0
85,8483045,Cameron Butler,R,CBJ,31,0,0,0,0
85,8484314,Jiri Smejkal,L,,28,0,0,0,0
86,8476453,Nikita Kucherov,R,TBL,31,82,39,102,141
86,8477492,Nathan MacKinnon,C,COL,29,81,43,88,131
86,8479318,Auston Matthews,C,TOR,27,80,58,66,124
86,8478402,Connor McDavid,C,EDM,27,79,35,89,124
86,8481559,Jack Hughes,C,NJD,23,76,47,74,121
86,8478483,Mitch Marner,R,TOR,27,81,28,91,119
86,8478010,Brayden Point,C,TBL,28,81,61,57,118
86,8477934,Leon Draisaitl,C,EDM,29,81,43,75,118
86,8478550,Artemi Panarin,L,NYR,33,78,31,86,117
86,8478420,Mikko Rantanen,R,COL,28,80,44,68,112
86,8477956,David Pastrnak,R,BOS,28,77,49,59,108
86,8480069,Cale Makar,D,COL,26,74,33,75,108
86,8477942,Kevin Fiala,L,LAK,28,79,48,57,105
86,8477939,William Nylander,R,TOR,28,77,48,55,103
86,8474564,Steven Stamkos,C,NSH,34,79,45,57,102
86,8480002,Nico Hischier,C,NJD,25,79,36,66,102
86,8477404,Jake Guentzel,C,TBL,30,81,41,59,100
86,8477493,Aleksander Barkov,C,FLA,29,80,33,67,100
86,8479343,Clayton Keller,R,UTA,26,80,37,62,99
86,8476468,J.T. Miller,C,VAN,31,79,32,66,98
86,8478403,Jack Eichel,C,VGK,28,76,42,54,96
86,8480027,Jason Robertson,L,DAL,25,82,34,61,95
86,8476459,Mika Zibanejad,C,NYR,31,77,35,56,91
86,8479314,Matthew Tkachuk,L,FLA,27,80,30,61,91
86,8480800,Quinn Hughes,D,VAN,25,75,21,70,91
86,8479323,Adam Fox,D,NYR,26,73,20,71,91
86,8477501,Valeri Nichushkin,R,COL,29,81,53,37,90
86,8477500,Bo Horvat,C,NYI,29,79,40,49,89
86,8479542,Brandon Hagel,L,TBL,26,82,39,50,89
86,8475166,John Tavares,C,TOR,34,78,36,53,89
86,8476887,Filip Forsberg,L,NSH,30,78,44,44,88
86,8478449,Roope Hintz,C,DAL,28,82,44,44,88
86,8471675,Sidney Crosby,C,PIT,37,69,35,52,87
86,8480801,Brady Tkachuk,L,OTT,25,79,41,45,86
86,8476460,Mark Scheifele,C,WPG,31,74,35,51,86
86,8479407,Jesper Bratt,L,NJD,26,75,29,57,86
86,8478445,Mathew Barzal,C,NYI,27,76,27,58,85
86,8477402,Pavel Buchnevich,L,STL,29,74,30,54,84
86,8480023,Robert Thomas,C,STL,25,72,20,64,84
86,8471685,Anze Kopitar,C,LAK,37,81,18,66,84
86,8477409,Carter Verhaeghe,C,FLA,29,79,42,41,83
86,8478414,Timo Meier,R,NJD,28,69,36,47,83
86,8474600,Roman Josi,D,NSH,34,75,29,54,83
86,8480012,Elias Pettersson,C,VAN,26,72,25,58,83
86,8474141,Patrick Kane,R,DET,36,80,29,53,82
86,8478398,Kyle Connor,L,WPG,28,70,40,41,81
86,8477946,Dylan Larkin,C,DET,28,80,38,43,81
86,8478427,Sebastian Aho,C,CAR,27,74,34,46,80
86,8477504,Josh Morrissey,D,WPG,29,76,18,61,79
86,8478864,Kirill Kaprizov,L,MIN,27,75,41,37,78
86,8481557,Matt Boldy,L,MIN,23,72,28,50,78
86,8477951,Nick Schmaltz,C,UTA,28,78,22,56,78
86,8480865,Noah Dobson,D,NYI,24,77,13,65,78
86,8475786,Zach Hyman,L,EDM,32,78,44,33,77
86,8475754,Brock Nelson,C,NYI,33,80,42,35,77
86,8480830,Andrei Svechnikov,R,CAR,24,69,30,47,77
86,8476539,Jonathan Marchessault,R,NSH,34,75,34,41,75
86,8482116,Tim Stützle,C,OTT,22,81,30,45,75
86,8480018,Nick Suzuki,C,MTL,25,80,21,54,75
86,8475184,Chris Kreider,L,NYR,33,75,44,30,74
86,8484144,Connor Bedard,C,CHI,19,72,31,43,74
86,8476389,Vincent Trocheck,C,NYR,31,73,31,43,74
86,8475172,Nazem Kadri,C,CGY,34,78,24,49,73
86,8476346,Johnny Gaudreau,L,CBJ,31,74,18,54,72
86,8480803,Evan Bouchard,D,EDM,25,76,21,50,71
86,8480036,Miro Heiskanen,D,DAL,25,74,15,56,71
86,8477933,Sam Reinhart,C,FLA,29,80,33,37,70
86,8479337,Alex DeBrincat,R,DET,27,80,32,38,70
86,8475692,Mats Zuccarello,R,MIN,37,75,21,49,70
86,8478439,Travis Konecny,R,PHI,27,75,20,50,70
86,8482740,Wyatt Johnston,C,DAL,21,82,32,37,69
86,8471215,Evgeni Malkin,C,PIT,38,75,30,39,69
86,8482078,Lucas Raymond,L,DET,22,81,29,40,69
86,8475167,Victor Hedman,D,TBL,34,79,7,62,69
86,8475158,Ryan O'Reilly,C,NSH,33,70,26,42,68
86,8473419,Brad Marchand,L,BOS,36,77,23,45,68
86,8478401,Pavel Zacha,C,BOS,27,78,31,36,67
86,8475765,Vladimir Tarasenko,R,DET,33,79,28,39,67
86,8473994,Jamie Benn,L,DAL,35,82,22,45,67
86,8477494,Jonathan Drouin,L,COL,29,79,21,46,67
86,8481711,Matias Maccelli,L,UTA,24,75,17,50,67
86,8478460,Zach Werenski,D,CBJ,27,82,13,54,67
86,8475168,Matt Duchene,C,DAL,33,81,26,40,66
86,8475810,Bryan Rust,R,PIT,32,70,32,33,65
86,8476881,Tomas Hertl,C,VGK,31,77,30,34,64
86,8477960,Adrian Kempe,R,LAK,28,79,28,36,64
86,8479675,Trevor Moore,L,LAK,29,80,28,36,64
86,8474578,Erik Karlsson,D,PIT,34,80,14,50,64
86,8480208,Drake Batherson,R,OTT,26,77,26,37,63
86,8475794,Tyler Seguin,C,DAL,32,81,26,37,63
86,8477940,Nikolaj Ehlers,L,WPG,28,68,24,39,63
86,8476905,Chandler Stephenson,C,SEA,30,77,24,39,63
86,8478407,Vince Dunn,D,SEA,28,72,11,52,63
86,8478975,Mason Marchment,L,DAL,29,81,25,37,62
86,8477496,Elias Lindholm,C,BOS,30,77,24,38,62
86,8484166,Adam Fantilli,C,CBJ,20,68,29,32,61
86,8477416,Oliver Bjorkstrand,R,SEA,29,79,25,36,61
86,8479385,Jordan Kyrou,C,STL,26,74,24,37,61
86,8477949,Alex Tuch,R,BUF,28,71,23,38,61
86,8476454,Ryan Nugent-Hopkins,C,EDM,31,82,16,45,61
86,8480839,Rasmus Dahlin,D,BUF,24,72,14,47,61
86,8479420,Tage Thompson,C,BUF,27,75,29,31,60
86,8481540,Cole Caufield,R,MTL,23,79,28,32,60
86,8475191,Reilly Smith,R,NYR,33,80,27,33,60
86,8473512,Claude Giroux,R,OTT,36,81,20,40,60
86,8474563,Drew Doughty,D,LAK,35,71,8,52,60
86,8478493,Joel Eriksson Ek,C,MIN,27,69,34,25,59
86,8477955,Jared McCann,L,SEA,28,73,31,28,59
86,8471214,Alex Ovechkin,L,WSH,39,75,28,31,59
86,8478856,Conor Garland,R,VAN,28,74,25,34,59
86,8477503,Max Domi,C,TOR,29,77,18,41,59
86,8477964,Ivan Barbashev,C,VGK,29,77,17,42,59
86,8476853,Morgan Rielly,D,TOR,30,74,9,50,59
86,8478444,Brock Boeser,R,VAN,27,75,36,22,58
86,8481068,Yegor Sharangovich,C,CGY,26,80,34,24,58
86,8475784,Jeff Skinner,C,EDM,32,77,27,31,58
86,8483515,Juraj Slafkovsky,L,MTL,20,72,20,38,58
86,8477407,Anthony Duclair,L,NYI,29,78,20,38,58
86,8478440,Dylan Strome,C,WSH,27,75,18,40,58
86,8480015,Owen Tippett,R,PHI,25,78,28,29,57
86,8478873,Troy Terry,R,ANA,27,73,25,32,57
86,8474586,Jordan Eberle,R,SEA,34,76,19,38,57
86,8476448,William Karlsson,C,VGK,31,70,24,32,56
86,8479400,Pierre-Luc Dubois,L,WSH,26,76,23,33,56
86,8480028,Morgan Frost,C,PHI,25,74,23,33,56
86,8474102,David Perron,L,OTT,36,80,22,34,56
86,8471724,Kris Letang,D,PIT,37,79,19,37,56
86,8476462,Dougie Hamilton,D,NJD,31,72,16,40,56
86,8475913,Mark Stone,R,VGK,32,74,13,43,56
86,8475170,Brayden Schenn,C,STL,33,77,28,27,55
86,8484153,Leo Carlsson,C,ANA,20,75,25,30,55
86,8482745,Mason McTavish,C,ANA,21,71,18,37,55
86,8482720,Matthew Knies,L,TOR,22,74,17,38,55
86,8479999,Casey Mittelstadt,C,COL,26,80,15,40,55
86,8482684,Luke Hughes,D,NJD,21,69,11,44,55
86,8478498,Jake DeBrusk,L,VAN,28,75,27,27,54
86,8482109,Alexis Lafrenière,L,NYR,23,75,26,28,54
86,8480039,Martin Necas,C,CAR,25,68,20,34,54
86,8476869,Brady Skjei,D,NSH,30,72,7,47,54
86,8475799,Nino Niederreiter,R,WPG,32,66,32,21,53
86,8482110,Dawson Mercer,C,NJD,23,77,23,30,53
86,8477444,Andre Burakovsky,L,SEA,29,70,23,30,53
86,8476399,Blake Coleman,C,CGY,33,80,20,33,53
86,8476479,Phillip Danault,C,LAK,31,80,18,35,53
86,8477456,J.T. Compher,L,DET,29,79,18,35,53
86,8477476,Artturi Lehkonen,L,COL,29,81,15,38,53
86,8475798,Mikael Granlund,C,SJS,32,70,13,40,53
86,8475169,Evander Kane,L,EDM,33,74,31,21,52
86,8478047,Michael Bunting,L,PIT,29,71,21,31,52
86,8476792,Torey Krug,D,STL,33,70,13,39,52
86,8476456,Jonathan Huberdeau,C,CGY,31,79,9,43,52
86,8481604,Pavel Dorofeyev,L,VGK,24,75,30,21,51
86,8476880,Tom Wilson,R,WSH,30,72,29,22,51
86,8481528,Dylan Cozens,C,BUF,23,71,24,27,51
86,8480797,Joel Farabee,L,PHI,24,74,24,27,51
86,8477511,Anthony Mantha,R,CGY,30,79,20,31,51
86,8477986,Brandon Montour,D,SEA,30,75,14,37,51
86,8479325,Charlie McAvoy,D,BOS,27,76,6,45,51
86,8476432,Boone Jenner,C,CBJ,31,69,34,16,50
86,8480064,Josh Norris,C,OTT,25,74,28,22,50
86,8478046,Danton Heinen,L,VAN,29,73,21,29,50
86,8476906,Shayne Gostisbehere,D,CAR,31,74,17,33,50
86,8478472,Mathieu Joseph,R,STL,27,77,17,33,50
86,8475745,Charlie Coyle,C,BOS,32,77,16,34,50
86,8482124,Quinton Byfield,R,LAK,22,79,13,37,50
86,8481542,Moritz Seider,D,DET,23,77,6,44,50
86,8477426,Nicholas Paul,L,TBL,29,81,25,24,49
86,8479525,Ross Colton,C,COL,28,78,25,24,49
86,8474641,Adam Henrique,C,EDM,34,75,24,25,49
86,8478519,Anthony Cirelli,C,TBL,27,82,23,26,49
86,8477935,Sam Bennett,C,FLA,28,71,22,27,49
86,8477429,Andrew Copp,C,DET,30,77,22,27,49
86,8483808,Andrei Kuzmenko,L,CGY,28,76,19,30,49
86,8479345,Jakob Chychrun,D,WSH,26,68,12,37,49
86,8478397,Rasmus Andersson,D,CGY,28,77,10,39,49
86,8477447,Shea Theodore,D,VGK,29,59,9,40,49
86,8480145,Neal Pionk,D,WPG,29,74,9,40,49
86,8479425,Filip Hronek,D,VAN,27,77,8,41,49
86,8482699,Dylan Guenther,R,UTA,21,77,25,23,48
86,8475151,Kyle Palmieri,C,NYI,33,80,21,27,48
86,8474679,Gustav Nyquist,C,NSH,35,67,16,32,48
86,8478038,Devon Toews,D,COL,30,68,13,35,48
86,8482093,Seth Jarvis,C,CAR,22,68,24,23,47
86,8482665,Matty Beniers,C,SEA,22,73,21,26,47
86,8478396,Noah Hanifin,D,VGK,27,61,18,29,47
86,8477021,Alex Kerfoot,C,UTA,30,68,17,30,47
86,8480829,Jesperi Kotkaniemi,C,CAR,24,68,15,32,47
86,8475726,Tyler Toffoli,C,SJS,32,71,26,20,46
86,8474715,Cameron Atkinson,R,TBL,35,80,24,22,46
86,8475314,Anders Lee,L,NYI,34,78,23,23,46
86,8478474,Lawson Crouse,L,UTA,27,75,23,23,46
86,8481618,Alex Newhook,C,MTL,23,72,22,24,46
86,8477497,Sean Monahan,C,CBJ,30,72,19,27,46
86,8476292,Ondrej Palat,L,NJD,33,74,19,27,46
86,8477346,MacKenzie Weegar,D,CGY,30,75,13,33,46
86,8478055,Gustav Forsling,D,FLA,28,77,13,33,46
86,8480849,Barrett Hayton,C,UTA,24,67,26,19,45
86,8481582,Nicholas Robertson,L,TOR,23,69,24,21,45
86,8482705,Cole Sillinger,C,CBJ,21,70,21,24,45
86,8482702,Logan Stankoven,C,DAL,21,81,17,28,45
86,8476875,Mike Matheson,D,MTL,30,71,16,29,45
86,8470613,Brent Burns,D,CAR,39,71,10,35,45
86,8481186,Logan O'Connor,R,COL,28,80,18,26,44
86,8482159,Tyson Foerster,R,PHI,22,73,16,28,44
86,8479410,Mikhail Sergachev,D,UTA,26,70,13,31,44
86,8476882,Teuvo Teravainen,C,CHI,30,64,7,37,44
86,8480009,Eeli Tolvanen,R,SEA,25,64,22,21,43
86,8476872,Scott Laughton,C,PHI,30,74,20,23,43
86,8476826,Yanni Gourde,C,SEA,33,68,20,23,43
86,8481596,Shane Pinto,C,OTT,24,79,18,25,43
86,8477932,Aaron Ekblad,D,FLA,28,78,16,27,43
86,8473986,Alex Killorn,L,ANA,35,74,24,18,42
86,8482089,Jake Neighbours,L,STL,22,65,24,18,42
86,8481560,Arthur Kaliyev,R,LAK,23,78,22,20,42
86,8481554,Kaapo Kakko,R,NYR,23,71,20,22,42
86,8475714,Calle Jarnkrok,C,TOR,33,74,19,23,42
86,8480188,Fabian Zetterlund,L,SJS,25,61,14,28,42
86,8476927,Teddy Blueger,C,VAN,30,70,14,28,42
86,8477506,Ryan Pulock,D,NYI,30,79,10,32,42
86,8478438,Tommy Novak,C,NSH,27,71,19,22,41
86,8477478,William Carrier,L,CAR,30,61,17,24,41
86,8478466,Daniel Sprong,R,VAN,27,70,16,25,41
86,8479339,Patrik Laine,L,CBJ,26,62,15,26,41
86,8474590,John Carlson,D,WSH,34,71,13,28,41
86,8482113,Anton Lundell,C,FLA,23,77,13,28,41
86,8475753,Justin Faulk,D,STL,32,69,8,33,41
86,8478366,Frank Vatrano,R,ANA,30,69,24,16,40
86,8479992,Michael Rasmussen,C,DET,25,76,23,17,40
86,8483431,Logan Cooley,C,UTA,20,74,21,19,40
86,8476419,Jean-Gabriel Pageau,C,NYI,32,78,21,19,40
86,8480798,Philipp Kurashev,C,CHI,25,70,20,20,40
86,8475287,Erik Haula,L,NJD,33,69,19,21,40
86,8478042,Viktor Arvidsson,L,EDM,31,71,18,22,40
86,8475793,Ryan Johansen,C,PHI,32,76,18,22,40
86,8482149,Cole Perfetti,C,WPG,22,66,17,23,40
86,8477451,Ryan Hartman,R,MIN,30,74,16,24,40
86,8479365,Trent Frederic,C,BOS,26,79,16,24,40
86,8478542,Evan Rodrigues,C,FLA,31,71,16,24,40
86,8475763,Kevin Hayes,R,PIT,32,61,16,24,40
86,8476483,Rickard Rakell,R,PIT,31,71,14,26,40
86,8476392,Adam Lowry,C,WPG,31,69,14,26,40
86,8475218,Mattias Ekholm,D,EDM,34,73,14,26,40
86,8480185,Eetu Luostarinen,C,FLA,26,76,13,27,40
86,8478469,Thomas Chabot,D,OTT,27,76,10,30,40
86,8476958,Jaccob Slavin,D,CAR,30,78,10,30,40
86,8475768,Jaden Schwartz,C,SEA,32,71,20,19,39
86,8474150,Mikael Backlund,C,CGY,35,76,13,26,39
86,8482712,Oskar Olausson,R,COL,22,77,10,29,39
86,8473422,Nick Foligno,L,CHI,37,57,17,21,38
86,8484145,Zach Benson,L,BUF,19,68,13,25,38
86,8474565,Alex Pietrangelo,D,VGK,34,64,12,26,38
86,8481703,Valtteri Puustinen,R,PIT,25,57,9,29,38
86,8480434,Sean Durzi,D,UTA,26,70,8,30,38
86,8482105,Jake Sanderson,D,OTT,22,77,8,30,38
86,8482671,Owen Power,D,BUF,22,74,5,33,38
86,8480014,Gabriel Vilardi,C,WPG,25,59,21,16,37
86,8478115,Pierre Engvall,L,NYI,28,78,19,18,37
86,8477998,Warren Foegele,L,LAK,28,81,17,20,37
86,8480068,Ryan Poehling,C,PHI,25,61,17,20,37
86,8478462,Nicolas Roy,C,VGK,27,68,16,21,37
86,8474149,Evgenii Dadonov,R,DAL,35,81,15,22,37
86,8475848,Brendan Gallagher,R,MTL,32,67,15,22,37
86,8479987,Morgan Geekie,C,BOS,26,82,14,23,37
86,8482475,Yegor Chinakhov,R,CBJ,23,67,14,23,37
86,8480220,Noah Cates,L,PHI,25,71,13,24,37
86,8483490,Pavel Mintyukov,D,ANA,21,70,11,26,37
86,8475764,Cam Fowler,D,ANA,33,74,4,33,37
86,8476979,Erik Gustafsson,D,DET,32,81,3,34,37
86,8476438,Brandon Saad,L,STL,32,68,21,15,36
86,8476474,Stefan Noesen,R,NJD,31,69,17,19,36
86,8471698,T.J. Oshie,R,WSH,38,61,14,22,36
86,8480459,Pius Suter,C,VAN,28,74,13,23,36
86,8481577,Philip Tomasino,C,NSH,23,62,13,23,36
86,8475200,Dmitry Orlov,D,CAR,33,78,10,26,36
86,8478463,Anthony Beauvillier,L,PIT,27,68,16,19,35
86,8479353,Brett Howden,C,VGK,26,72,15,20,35
86,8482092,Ridly Greig,C,OTT,22,78,12,23,35
86,8476921,Jordan Martinook,L,CAR,32,58,12,23,35
86,8483505,Matthew Poitras,C,BOS,20,72,12,23,35
86,8474716,Jared Spurgeon,D,MIN,35,77,9,26,35
86,8481533,Trevor Zegras,C,ANA,23,67,7,28,35
86,8482122,Brock Faber,D,MIN,22,78,4,31,35
86,8475722,Jason Zucker,L,BUF,32,68,18,16,34
86,8482055,Drew O'Connor,L,PIT,26,63,16,18,34
86,8482667,William Eklund,L,SJS,22,66,14,20,34
86,8476461,Sean Couturier,C,PHI,32,69,14,20,34
86,8474189,Lars Eller,C,PIT,35,67,13,21,34
86,8481656,Aliaksei Protas,C,WSH,23,70,13,21,34
86,8481524,Bowen Byram,D,BUF,23,71,11,23,34
86,8482660,Kent Johnson,C,CBJ,22,59,8,26,34
86,8476854,Hampus Lindholm,D,BOS,30,72,7,27,34
86,8477498,Darnell Nurse,D,EDM,29,69,13,20,33
86,8476458,Ryan Strome,C,ANA,31,71,9,24,33
86,8477479,Tyler Bertuzzi,L,CHI,29,58,8,25,33
86,8482074,Connor Zary,C,CGY,23,58,21,11,32
86,8478057,Dakota Joshua,C,VAN,28,67,16,16,32
86,8482749,Joshua Roy,R,MTL,21,58,16,16,32
86,8481553,Bobby Brink,R,PHI,23,63,13,19,32
86,8478432,Christian Fischer,R,DET,27,73,12,20,32
86,8480789,Oliver Wahlstrom,R,NYI,24,70,12,20,32
86,8481581,Thomas Harley,D,DAL,23,73,9,23,32
86,8479639,Dylan Coghlan,D,WPG,26,67,8,24,32
86,8481546,Cam York,D,PHI,23,69,7,25,32
86,8476885,Jacob Trouba,D,NYR,30,71,4,28,32
86,8477953,Kasperi Kapanen,R,STL,28,68,14,17,31
86,8473533,Jordan Staal,C,CAR,36,73,14,17,31
86,8479591,Michael Eyssimont,C,TBL,28,81,13,18,31
86,8476925,Colton Sissons,C,NSH,31,65,13,18,31
86,8478133,Jake Evans,C,MTL,28,67,10,21,31
86,8477839,Conor Sheary,L,TBL,32,82,10,21,31
86,8480871,Adam Boqvist,D,FLA,24,71,10,21,31
86,8480893,Kirill Marchenko,R,CBJ,24,54,16,14,30
86,8476278,Colin Blackwell,C,DAL,31,80,15,15,30
86,8478891,Mason Appleton,C,WPG,28,60,14,16,30
86,8479661,Tanner Jeannot,L,LAK,27,78,13,17,30
86,8476981,Josh Anderson,R,MTL,30,64,13,17,30
86,8479293,Brandon Tanev,L,SEA,33,64,12,18,30
86,8482146,Luke Evangelista,R,NSH,22,61,11,19,30
86,8475149,Marcus Johansson,L,MIN,34,65,10,20,30
86,8482133,Thomas Bordeleau,C,SJS,22,61,9,21,30
86,8478882,Vladislav Gavrikov,D,LAK,29,67,9,21,30
86,8483445,Cutter Gauthier,L,ANA,20,66,9,21,30
86,8476463,Jonas Brodin,D,MIN,31,80,4,26,30
86,8481535,Nils Hoglander,L,VAN,24,62,18,11,29
86,8478413,Jordan Greenway,L,BUF,27,70,14,15,29
86,8477505,Alexander Wennberg,C,SJS,30,64,13,16,29
86,8479393,Noah Gregor,L,OTT,26,71,13,16,29
86,8475231,Casey Cizikas,C,NYI,33,69,12,17,29
86,8480336,Sean Walker,D,CAR,30,71,11,18,29
86,8475171,Oliver Ekman-Larsson,D,TOR,33,70,8,21,29
86,8478109,Victor Olofsson,L,VGK,29,69,6,23,29
86,8480878,Nils Lundkvist,D,DAL,24,76,5,24,29
86,8476923,Damon Severson,D,CBJ,30,79,3,26,29
86,8478020,Michael Amadio,R,OTT,28,72,16,12,28
86,8482175,JJ Peterka,R,BUF,22,65,15,13,28
86,8482097,Jack Quinn,R,BUF,23,60,15,13,28
86,8477952,Robby Fabbri,C,ANA,28,67,13,15,28
86,8477392,Hudson Fasching,R,NYI,29,63,13,15,28
86,8481093,Rafael Harvey-Pinard,L,MTL,25,63,13,15,28
86,8479390,Taylor Raddysh,R,WSH,26,63,10,18,28
86,8481523,Kirby Dach,C,MTL,23,72,9,19,28
86,8480113,Alex Iafallo,L,WPG,31,66,8,20,28
86,8474053,Logan Couture,C,SJS,35,64,6,22,28
86,8476892,Colton Parayko,D,STL,31,70,5,23,28
86,8479402,Jake Bean,D,CGY,26,71,5,23,28
86,8477969,Marcus Pettersson,D,PIT,28,76,4,24,28
86,8480817,K'Andre Miller,D,NYR,24,71,3,25,28
86,8478458,John (Jack) Roslovic,C,CAR,27,70,12,15,27
86,8478233,Andrew Mangiapane,L,WSH,28,60,12,15,27
86,8477446,Michael McCarron,R,NSH,29,64,12,15,27
86,8484203,Bradly Nadeau,L,CAR,19,59,11,16,27
86,8473507,Jeff Petry,D,DET,37,72,6,21,27
86,8476902,Esa Lindell,D,DAL,30,76,5,22,27
86,8479980,Nicolas Hague,D,VGK,26,62,4,23,27
86,8482125,Alexander Holtz,R,VGK,22,69,18,8,26
86,8480802,Ryan McLeod,C,BUF,25,65,12,14,26
86,8476897,Oskar Sundqvist,C,STL,30,65,8,18,26
86,8477989,Christian Dvorak,C,MTL,28,64,8,18,26
86,8480078,Filip Chytil,C,NYR,25,72,7,19,26
86,8479026,Philippe Myers,D,TOR,27,54,6,20,26
86,8476917,Adam Pelech,D,NYI,30,77,3,23,26
86,8482655,Janis Moser,D,TBL,24,76,2,24,26
86,8478840,Will Borgen,D,SEA,28,58,1,25,26
86,8476469,Joel Armia,R,MTL,31,65,17,8,25
86,8480074,Alexandre Texier,C,STL,25,48,17,8,25
86,8481580,Connor McMichael,C,WSH,23,67,15,10,25
86,8477425,Miles Wood,L,COL,29,74,12,13,25
86,8480205,Emil Bemstrom,C,PIT,25,60,11,14,25
86,8481606,Jordan Spence,D,LAK,23,68,9,16,25
86,8475760,Nick Bjugstad,C,UTA,32,73,9,16,25
86,8476422,Mike Reilly,D,NYI,31,71,8,17,25
86,8479315,Joey Anderson,R,CHI,26,48,7,18,25
86,8481014,Alexander Romanov,D,NYI,24,76,4,21,25
86,8479398,Samuel Girard,D,COL,26,60,3,22,25
86,8478851,Alexandre Carrier,D,NSH,28,63,2,23,25
86,8481624,Ilya Mikheyev,R,CHI,30,61,16,8,24
86,8480003,Jesper Boqvist,C,FLA,26,68,10,14,24
86,8477919,Frederick Gaudreau,C,MIN,31,61,10,14,24
86,8477353,Tyler Motte,C,DET,29,75,10,14,24
86,8483524,Shane Wright,C,SEA,20,62,9,15,24
86,8478013,Jake Walman,D,SJS,28,77,9,15,24
86,8481481,Blake Lizotte,C,PIT,27,64,8,16,24
86,8478970,Jalen Chatfield,D,CAR,28,66,8,16,24
86,8477948,Travis Sanheim,D,PHI,28,68,7,17,24
86,8476480,Vladislav Namestnikov,C,WPG,32,64,7,17,24
86,8475193,Tomas Tatar,L,NJD,34,67,7,17,24
86,8483565,Nick Blankenburg,D,NSH,26,65,7,17,24
86,8477488,Brett Pesce,D,NJD,30,67,6,18,24
86,8477947,Sonny Milano,L,WSH,28,64,6,18,24
86,8474574,Tyler Myers,D,VAN,34,67,1,23,24
86,8479351,Sam Steel,C,DAL,26,82,12,11,23
86,8476918,Jimmy Vesey,L,NYR,31,66,12,11,23
86,8482259,Bobby McMann,C,TOR,28,64,12,11,23
86,8478434,Keegan Kolesar,R,VGK,27,59,11,12,23
86,8476374,Sean Kuraly,C,CBJ,31,61,11,12,23
86,8479941,Justin Danforth,R,CBJ,31,54,11,12,23
86,8482062,Cole Smith,L,NSH,29,56,11,12,23
86,8476329,Travis Boyd,C,MIN,31,53,8,15,23
86,8477495,Seth Jones,D,CHI,30,62,7,16,23
86,8480144,David Kampf,C,TOR,29,67,7,16,23
86,8482101,Danil Gushchin,L,SJS,22,58,6,17,23
86,8480222,Sebastian Aho,D,PIT,28,69,6,17,23
86,8476429,Scott Mayfield,D,NYI,32,77,3,20,23
86,8479336,Carl Grundstrom,R,SJS,27,58,15,7,22
86,8478831,Kevin Stenlund,C,UTA,28,55,15,7,22
86,8479520,Brandon Duhaime,R,WSH,27,58,12,10,22
86,8482624,Daniil Miromanov,D,CGY,27,62,8,14,22
86,8481521,Ronnie Attard,D,PHI,25,57,7,15,22
86,8477015,Connor Brown,R,EDM,30,68,6,16,22
86,8476960,Andreas Athanasiou,C,CHI,30,55,6,16,22
86,8482176,Wyatt Kaiser,D,CHI,22,54,6,16,22
86,8474151,Ryan McDonagh,D,TBL,35,77,3,19,22
86,8480049,Dylan Samberg,D,WPG,25,66,1,21,22
86,8482155,Alex Laferriere,R,LAK,23,62,15,6,21
86,8476878,Zemgus Girgensons,C,TBL,30,79,12,9,21
86,8481032,Paul Cotter,C,NJD,25,62,11,10,21
86,8477369,Carson Soucy,D,VAN,30,59,10,11,21
86,8476442,Matt Nieto,L,PIT,32,55,10,11,21
86,8476312,Josh Manson,D,COL,33,61,9,12,21
86,8480448,Parker Kelly,L,COL,25,76,9,12,21
86,8480748,Kiefer Sherwood,L,VAN,29,57,8,13,21
86,8482809,Jackson Blake,R,CAR,21,57,8,13,21
86,8477450,Jason Dickinson,C,CHI,29,66,7,14,21
86,8478911,Matt Roy,D,WSH,29,64,3,18,21
86,8480891,Michael Kesselring,D,UTA,24,53,3,18,21
86,8480873,Rasmus Sandin,D,WSH,24,64,2,19,21
86,8480980,Connor Dewar,C,TOR,25,60,10,10,20
86,8481441,Joe Snively,C,DET,28,68,10,10,20
86,8475220,Marcus Foligno,L,MIN,33,65,9,11,20
86,8482157,Will Cuylle,L,NYR,22,62,9,11,20
86,8475855,Jesper Fast,R,CAR,33,53,9,11,20
86,8478211,Dryden Hunt,L,CGY,29,62,9,11,20
86,8480252,Cole Guttman,C,CHI,25,39,8,12,20
86,8480835,Jack Drury,C,CAR,24,57,7,13,20
86,8480855,Jack McBain,C,UTA,24,68,7,13,20
86,8481701,Santeri Hatakka,D,NJD,23,41,7,13,20
86,8476873,Mark Jankowski,C,NSH,30,54,6,14,20
86,8476467,Jamie Oleksiak,D,SEA,32,68,6,14,20
86,8473563,Nicklas Backstrom,C,WSH,37,48,5,15,20
86,8477508,Curtis Lazar,C,NJD,29,53,5,15,20
86,8478500,Ivan Provorov,D,CBJ,27,79,4,16,20
86,8482142,Jamie Drysdale,D,PHI,22,61,3,17,20
86,8478507,John Marino,D,UTA,27,61,1,19,20
86,8477987,Ryan Donato,C,CHI,28,58,10,9,19
86,8481601,Simon Holmstrom,R,NYI,23,68,10,9,19
86,8478043,Sam Lafferty,C,BUF,29,53,9,10,19
86,8475462,Radko Gudas,D,ANA,34,65,7,12,19
86,8482737,Zack Bolduc,C,STL,21,59,7,12,19
86,8480021,Jack Studnicka,C,LAK,25,62,6,13,19
86,8477499,Rasmus Ristolainen,D,PHI,30,61,5,14,19
86,8480246,Nick Perbix,D,TBL,26,74,5,14,19
86,8479976,Juuso Valimaki,D,UTA,26,57,5,14,19
86,8483468,Jiri Kulich,C,BUF,20,59,4,15,19
86,8480073,Erik Brannstrom,D,COL,25,63,4,15,19
86,8482666,Scott Morrow,D,CAR,22,54,3,16,19
86,8480807,Mattias Samuelsson,D,BUF,24,66,3,16,19
86,8480043,Timothy Liljegren,D,TOR,25,62,2,17,19
86,8478859,Niko Mikkola,D,FLA,28,66,2,17,19
86,8481178,Egor Zamula,D,PHI,24,63,1,18,19
86,8480995,Pontus Holmberg,R,TOR,25,59,11,7,18
86,8479316,Luke Kunin,C,SJS,27,51,10,8,18
86,8479996,Cody Glass,C,NSH,25,53,10,8,18
86,8482634,Alex Steeves,C,TOR,25,51,10,8,18
86,8480011,Klim Kostin,C,SJS,25,41,9,9,18
86,8475791,Taylor Hall,L,CHI,33,56,8,10,18
86,8482117,Lukas Reichel,L,CHI,22,63,7,11,18
86,8479982,Conor Timmins,D,TOR,26,56,6,12,18
86,8473453,Trevor Lewis,C,LAK,37,70,6,12,18
86,8476331,Dylan DeMelo,D,WPG,31,67,5,13,18
86,8470621,Corey Perry,R,EDM,39,73,5,13,18
86,8482859,Zack Ostapchuk,C,OTT,21,59,5,13,18
86,8476525,Colin Miller,D,WPG,32,63,4,14,18
86,8476931,Jake McCabe,D,TOR,31,68,4,14,18
86,8476879,Cody Ceci,D,EDM,31,65,3,15,18
86,8476891,Matthew Grzelcyk,D,PIT,30,75,3,15,18
86,8479983,Mario Ferraro,D,SJS,26,72,2,16,18
86,8475324,Nick Jensen,D,OTT,34,62,0,18,18
86,8475233,David Savard,D,MTL,34,63,0,18,18
86,8483491,Ivan Miroshnichenko,L,WSH,20,53,10,7,17
86,8479619,Michael Carcone,L,UTA,28,60,10,7,17
86,8479368,Max Jones,L,BOS,26,64,9,8,17
86,8481013,Jonatan Berggren,R,DET,24,58,8,9,17
86,8484149,Gavin Brindley,C,CBJ,20,48,8,9,17
86,8479370,Tyson Jost,C,CAR,26,56,8,9,17
86,8477380,Jonny Brodzinski,C,NYR,31,50,7,10,17
86,8480813,Joe Veleno,C,DET,24,78,6,11,17
86,8477507,Nikita Zadorov,D,BOS,29,63,5,12,17
86,8477406,Mattias Janmark,C,EDM,32,61,5,12,17
86,8482067,Connor Mackey,D,NYR,28,57,5,12,17
86,8481522,Peyton Krebs,C,BUF,23,60,4,13,17
86,8478416,Erik Cernak,D,TBL,27,74,4,13,17
86,8481704,Juuso Parssinen,C,NSH,23,54,4,13,17
86,8475690,Chris Tanev,D,TOR,35,56,3,14,17
86,8480001,Urho Vaakanainen,D,ANA,25,61,3,14,17
86,8480192,Johnathan Kovacevic,D,NJD,27,49,1,16,17
86,8479066,Ryan Lomberg,L,CGY,30,64,12,4,16
86,8476889,Radek Faksa,C,STL,30,65,10,6,16
86,8483493,Frank Nazar,C,CHI,20,52,9,7,16
86,8482079,Marco Rossi,C,MIN,23,45,9,7,16
86,8479344,Jesse Puljujarvi,R,PIT,26,50,9,7,16
86,8476822,Luke Glendening,C,TBL,35,78,8,8,16
86,8482807,Ethan Del Mastro,D,CHI,21,55,8,8,16
86,8477220,Nate Schmidt,D,FLA,33,65,5,11,16
86,8475790,Erik Gudbranson,D,CBJ,32,75,5,11,16
86,8481527,Kaedan Korczak,D,VGK,23,43,5,11,16
86,8483495,Simon Nemec,D,NJD,20,55,5,11,16
86,8477845,Trevor van Riemsdyk,D,WSH,33,54,3,13,16
86,8483466,Kevin Korchinski,D,CHI,20,45,3,13,16
86,8479998,Mikey Anderson,D,LAK,25,64,3,13,16
86,8475455,Brenden Dillon,D,NJD,34,60,3,13,16
86,8480172,Jan Rutta,D,SJS,34,65,3,13,16
86,8477435,Ryan Graves,D,PIT,29,75,2,14,16
86,8482192,Isaak Phillips,D,CHI,23,49,1,15,16
86,8479414,Nathan Bastian,R,NJD,27,58,10,5,15
86,8478508,Yakov Trenin,C,MIN,27,63,9,6,15
86,8480762,Eric Robinson,L,CAR,29,57,8,7,15
86,8478421,A.J. Greer,L,FLA,28,61,8,7,15
86,8477903,Garnet Hathaway,R,PHI,33,62,7,8,15
86,8480025,MacKenzie Entwistle,R,FLA,25,65,7,8,15
86,8481599,Victor Soderstrom,D,UTA,23,55,7,8,15
86,8482111,Justin Barron,D,MTL,23,68,6,9,15
86,8482679,Matt Coronato,R,CGY,22,70,6,9,15
86,8475235,Nicolas Deslauriers,L,PHI,33,58,6,9,15
86,8481592,Jakob Pelletier,L,CGY,23,48,6,9,15
86,8477070,Liam O'Brien,C,UTA,30,52,6,9,15
86,8483499,Liam Ohgren,L,MIN,20,53,5,10,15
86,8474090,Brendan Smith,D,DAL,35,49,5,10,15
86,8476994,Vinnie Hinostroza,C,NSH,30,52,5,10,15
86,8476624,Barclay Goodrow,C,SJS,31,47,5,10,15
86,8481019,David Gustafsson,C,WPG,24,51,5,10,15
86,8480035,Henri Jokiharju,D,BUF,25,53,5,10,15
86,8481161,Jake Christiansen,D,CBJ,25,59,5,10,15
86,8475188,Brayden McNabb,D,VGK,33,52,3,12,15
86,8474673,TJ Brodie,D,CHI,34,61,2,13,15
86,8478399,Jonas Siegenthaler,D,NJD,27,55,2,13,15
86,8482964,Arber Xhekaj,D,MTL,23,59,2,13,15
86,8482245,Artem Zub,D,OTT,29,72,1,14,15
86,8480157,Calle Rosen,D,COL,30,54,8,6,14
86,8475225,Craig Smith,C,CHI,35,50,7,7,14
86,8481477,Nico Sturm,C,SJS,29,52,7,7,14
86,8481517,Brett Leason,R,ANA,25,59,6,8,14
86,8481518,Nolan Foote,L,NJD,24,39,4,10,14
86,8471677,Jack Johnson,D,CBJ,37,61,4,10,14
86,8475181,Nick Leddy,D,STL,33,68,1,13,14
86,8470600,Ryan Suter,D,STL,39,71,1,13,14
86,8482148,Hendrix Lapierre,C,WSH,22,51,10,3,13
86,8483457,Lane Hutson,D,MTL,20,56,8,5,13
86,8483482,Tristan Luneau,D,ANA,20,57,7,6,13
86,8482751,Ryan Winterton,C,SEA,21,39,7,6,13
86,8477931,Tomas Nosek,L,FLA,32,60,6,7,13
86,8477887,Patrick Brown,C,BOS,32,49,6,7,13
86,8481641,Joel Kiviranta,L,COL,28,73,6,7,13
86,8480796,Martin Fehervary,D,WSH,25,50,5,8,13
86,8482451,Mikael Pyyhtia,L,CBJ,23,50,4,9,13
86,8480845,Rasmus Kupari,C,WPG,24,39,3,10,13
86,8478136,Jake Middleton,D,MIN,28,73,3,10,13
86,8481751,Lukas Rousek,R,BUF,25,39,3,10,13
86,8475208,Brian Dumoulin,D,ANA,33,62,2,11,13
86,8480860,Kevin Bahl,D,CGY,24,55,2,11,13
86,8475279,Ben Chiarot,D,DET,33,68,2,11,13
86,8480727,Zach Whitecloud,D,VGK,28,50,2,11,13
86,8479324,Ryan Lindgren,D,NYR,26,60,1,12,13
86,8479371,Dante Fabbro,D,NSH,26,61,0,13,13
86,8481059,Scott Perunovich,D,STL,26,61,0,13,13
86,8479439,Jacob MacDonald,D,COL,31,52,8,4,12
86,8476934,Brock McGinn,L,ANA,30,52,8,4,12
86,8482730,Brandt Clarke,D,LAK,21,48,6,6,12
86,8479369,Andrew Peeke,D,BOS,26,57,6,6,12
86,8480289,Morgan Barron,C,WPG,26,58,5,7,12
86,8479671,Mathieu Olivier,R,CBJ,27,53,4,8,12
86,8481708,Zac Jones,D,NYR,24,49,4,8,12
86,8479972,Mason Shaw,C,WPG,26,52,4,8,12
86,8477018,Ben Hutton,D,VGK,31,50,3,9,12
86,8482087,Kaiden Guhle,D,MTL,22,60,2,10,12
86,8477365,Connor Clifton,D,BUF,29,56,2,10,12
86,8480887,Jordan Harris,D,MTL,24,58,2,10,12
86,8483460,David Jiricek,D,CBJ,21,57,2,10,12
86,8480196,Jacob Bryson,D,BUF,27,44,2,10,12
86,8475718,Justin Holl,D,DET,32,58,2,10,12
86,8475177,Calvin de Haan,D,COL,33,43,2,10,12
86,8479372,Joshua Mahura,D,SEA,26,62,1,11,12
86,8478443,Brandon Carlo,D,BOS,28,67,1,11,12
86,8478178,Darren Raddysh,D,TBL,28,72,0,12,12
86,8475842,Sam Carrick,C,NYR,32,57,8,3,11
86,8479718,Alex Barré-Boulet,C,MTL,27,51,7,4,11
86,8481550,Adam Beckman,L,NJD,23,42,6,5,11
86,8477573,Nathan Walker,L,STL,30,50,5,6,11
86,8481147,Reese Johnson,C,MIN,26,39,5,6,11
86,8476867,Brendan Gaunce,C,MIN,30,43,4,7,11
86,8482077,Dylan Holloway,L,EDM,23,44,4,7,11
86,8476952,Dominic Toninato,C,WPG,30,39,4,7,11
86,8479378,Logan Stanley,D,WPG,26,44,4,7,11
86,8483619,Filip Roos,D,OTT,25,40,4,7,11
86,8479328,Julien Gauthier,R,NYI,27,62,3,8,11
86,8475179,Dmitry Kulikov,D,FLA,34,50,3,8,11
86,8475343,Nic Dowd,C,WSH,34,57,2,9,11
86,8476457,Adam Larsson,D,SEA,32,61,2,9,11
86,8480058,Pierre-Olivier Joseph,D,STL,25,49,2,9,11
86,8474013,Ian Cole,D,UTA,35,52,2,9,11
86,8476967,Brett Kulak,D,EDM,30,70,0,11,11
86,8482784,Zach Dean,C,STL,21,43,7,3,10
86,8479968,Vinni Lettieri,C,BOS,29,45,7,3,10
86,8482744,James Malatesta,L,CBJ,21,37,7,3,10
86,8479944,Zach Aston-Reese,C,VGK,30,53,6,4,10
86,8480806,Isac Lundestrom,C,ANA,25,62,5,5,10
86,8479543,Michael Pezzetta,L,MTL,26,52,5,5,10
86,8478585,Derek Ryan,C,EDM,38,66,5,5,10
86,8478452,Caleb Jones,D,LAK,27,45,4,6,10
86,8482713,Mackie Samoskevich,R,FLA,22,40,4,6,10
86,8482803,Olen Zellweger,D,ANA,21,65,3,7,10
86,8477851,Jordan Oesterle,D,BOS,32,39,3,7,10
86,8482496,Nils Aman,C,VAN,24,36,3,7,10
86,8482166,Shakir Mukhamadullin,D,SJS,22,60,2,8,10
86,8476856,Mathew Dumba,D,DAL,30,73,2,8,10
86,8477034,Jaycob Megna,D,FLA,32,43,2,8,10
86,8479986,Kole Lind,R,DAL,26,44,2,8,10
86,8481056,Spencer Stastney,D,NSH,24,31,2,8,10
86,8478450,Parker Wotherspoon,D,BOS,27,39,2,8,10
86,8482073,Braden Schneider,D,NYR,23,69,1,9,10
86,8474567,Zach Bogosian,D,MIN,34,59,1,9,10
86,8481600,Tobias Bjornfot,D,FLA,23,39,1,9,10
86,8474568,Luke Schenn,D,NSH,35,48,1,9,10
86,8481617,Vasily Podkolzin,R,VAN,23,38,6,3,9
86,8480245,Olle Lycksell,R,PHI,25,31,6,3,9
86,8480281,Alexey Toropchenko,R,STL,25,59,5,4,9
86,8481567,Henry Thrun,D,SJS,23,56,4,5,9
86,8481028,Martin Pospisil,C,CGY,25,45,4,5,9
86,8474166,Alec Martinez,D,CHI,37,57,4,5,9
86,8482659,Josh Doan,R,UTA,22,45,4,5,9
86,8480355,Mark Kastelic,C,BOS,25,55,4,5,9
86,8483630,Pavol Regenda,L,ANA,25,28,4,5,9
86,8478569,Noel Acciari,C,PIT,33,53,3,6,9
86,8482145,Mavrik Bourque,C,DAL,22,45,3,6,9
86,8476988,Matt Benning,D,SJS,30,64,2,7,9
86,8481598,Philip Broberg,D,EDM,23,48,2,7,9
86,8481537,Nikita Okhotiuk,D,CGY,24,49,2,7,9
86,8479320,Maxime Lajoie,D,SEA,27,31,2,7,9
86,8476874,Olli Maatta,D,DET,30,60,0,9,9
86,8479994,Jaret Anderson-Dolan,C,WPG,25,40,6,2,8
86,8482762,Simon Edvinsson,D,DET,21,50,6,2,8
86,8479359,Beck Malenstyn,L,BUF,26,55,5,3,8
86,8481609,Vladislav Kolyachonok,D,UTA,23,34,5,3,8
86,8481716,Dmitri Voronkov,L,CBJ,24,46,4,4,8
86,8481789,Tye Kartye,L,SEA,23,39,4,4,8
86,8482095,Tyler Kleven,D,OTT,22,38,4,4,8
86,8479981,Jonah Gadjovich,L,FLA,26,40,4,4,8
86,8478424,Jansen Harkins,C,ANA,27,40,4,4,8
86,8482765,Isak Rosen,R,BUF,21,32,3,5,8
86,8480834,Ty Emberson,D,SJS,24,24,3,5,8
86,8482201,Gage Goncalves,C,TBL,23,23,3,5,8
86,8480990,Declan Chisholm,D,MIN,24,44,3,5,8
86,8477384,Joshua Brown,D,EDM,30,41,3,5,8
86,8479985,Cale Fleury,D,SEA,26,25,3,5,8
86,8473446,Erik Johnson,D,PHI,36,40,2,6,8
86,8480950,Ilya Lyubushkin,D,DAL,30,65,2,6,8
86,8482861,Vincent Iorio,D,WSH,22,40,2,6,8
86,8476441,Joel Edmundson,D,LAK,31,45,2,6,8
86,8478451,Ethan Bear,D,WSH,27,48,1,7,8
86,8475750,Jon Merrill,D,MIN,32,58,1,7,8
86,8474612,Travis Hamonic,D,OTT,34,36,1,7,8
86,8477962,Brendan Lemieux,L,CAR,28,36,1,7,8
86,8479249,Andrew Poturalski,C,SJS,30,36,0,8,8
86,8483549,Lucas Condotta,L,MTL,27,34,0,8,8
86,8480848,Ty Dellandrea,C,SJS,24,42,5,2,7
86,8482511,Mason Lohrei,D,BOS,23,32,5,2,7
86,8484911,Collin Graf,R,SJS,22,47,4,3,7
86,8476858,Phillip Di Giuseppe,L,VAN,31,44,4,3,7
86,8477244,Chad Ruhwedel,D,NYR,34,38,4,3,7
86,8481532,Alex Turcotte,C,LAK,23,47,3,4,7
86,8478017,Mark Friedman,D,VAN,29,39,3,4,7
86,8480890,Jan Jenik,C,OTT,24,30,3,4,7
86,8477462,Robert Hagg,D,VGK,29,26,3,4,7
86,8483012,Logan Morrison,C,SEA,22,41,3,4,7
86,8477979,Nicolas Aube-Kubel,R,BUF,28,54,2,5,7
86,8479772,Zack MacEwen,R,OTT,28,44,2,5,7
86,8483763,Maksymilian Szuber,D,UTA,22,36,2,5,7
86,8482747,Brennan Othmann,L,NYR,21,45,2,5,7
86,8480441,Trey Fix-Wolansky,R,CBJ,25,36,2,5,7
86,8481065,Angus Crookshank,L,OTT,25,17,2,5,7
86,8480879,Jacob Bernard-Docker,D,OTT,24,47,1,6,7
86,8471817,Ryan Reaves,R,TOR,37,60,1,6,7
86,8480070,Ian Mitchell,D,BOS,25,47,1,6,7
86,8479576,Vincent Desharnais,D,VAN,28,32,1,6,7
86,8479291,Kevin Rooney,C,CGY,31,48,1,6,7
86,8479348,Kale Clague,D,BUF,26,32,1,6,7
86,8475762,Derek Forbort,D,VAN,32,47,0,7,7
86,8481556,John Beecher,C,BOS,23,34,5,1,6
86,8480007,Jonas Rondbjerg,R,VGK,25,45,4,2,6
86,8479638,Justin Brazeau,R,BOS,26,39,4,2,6
86,8474034,Patrick Maroon,L,CHI,36,44,3,3,6
86,8479442,Troy Stecher,D,EDM,30,49,3,3,6
86,8480880,Jakub Lauko,C,MIN,24,38,3,3,6
86,8478874,Adam Gaudette,R,OTT,28,27,3,3,6
86,8480851,Akil Thomas,C,LAK,24,22,3,3,6
86,8480844,Grigori Denisenko,L,VGK,24,30,3,3,6
86,8471709,Marc-Edouard Vlasic,D,SJS,37,55,2,4,6
86,8478468,Jeremy Lauzon,D,NSH,27,51,2,4,6
86,8482153,Brendan Brisson,C,VGK,23,34,2,4,6
86,8481679,Maxence Guenette,D,OTT,23,38,2,4,6
86,8482858,Ryker Evans,D,SEA,23,16,2,4,6
86,8477938,Haydn Fleury,D,WPG,28,35,1,5,6
86,8478454,Noah Juulsen,D,VAN,27,26,1,5,6
86,8482177,Marat Khusnutdinov,C,MIN,22,37,1,5,6
86,8481743,Marc Del Gaizo,D,NSH,25,26,1,5,6
86,8480084,Nick DeSimone,D,NJD,30,24,1,5,6
86,8481568,Alex Vlasic,D,CHI,23,53,0,6,6
86,8479536,Axel Jonsson-Fjallby,L,WPG,26,30,4,1,5
86,8481543,Nikita Alexandrov,C,STL,24,20,4,1,5
86,8479991,Jake Leschyshyn,C,NYR,25,32,3,2,5
86,8476473,Connor Murphy,D,CHI,31,39,3,2,5
86,8478409,Anthony Richard,C,PHI,28,27,3,2,5
86,8479362,Riley Tufte,L,BOS,26,21,3,2,5
86,8481585,Egor Afanasyev,L,SJS,23,19,3,2,5
86,8481754,Nikita Nesterenko,C,ANA,23,32,2,3,5
86,8481699,Aku Raty,R,UTA,23,25,2,3,5
86,8482733,Logan Mailloux,D,MTL,31,33,1,4,5
86,8484254,Akito Hirose,D,VAN,25,44,1,4,5
86,8477335,Kyle Burroughs,D,LAK,29,40,1,4,5
86,8475958,Michael Sgarbossa,C,WSH,32,30,1,4,5
86,8482250,Callahan Burke,C,VGK,27,20,1,4,5
86,8481719,Maxwell Crozier,D,TBL,24,16,1,4,5
86,8476372,Nick Seeler,D,PHI,31,45,0,5,5
86,8482652,Walker Duehr,R,CGY,27,31,4,0,4
86,8482147,Jean-Luc Foudy,C,COL,22,29,4,0,4
86,8477482,Zachary Sanford,L,CHI,30,38,3,1,4
86,8481422,Jake Lucchini,C,NSH,29,23,3,1,4
86,8480267,Sammy Walker,C,MIN,25,17,3,1,4
86,8482102,Vasily Ponomarev,C,PIT,22,26,3,1,4
86,8477467,Gustav Olofsson,D,SEA,30,24,2,2,4
86,8483570,Ben Meyers,C,SEA,26,25,2,2,4
86,8479379,Givani Smith,R,SJS,26,35,1,3,4
86,8481167,Brayden Pachal,D,CGY,25,44,1,3,4
86,8477401,John Hayden,C,SEA,29,28,1,3,4
86,8477473,Justin Bailey,R,SJS,29,23,1,3,4
86,8477971,Andreas Englund,D,LAK,28,38,1,3,4
86,8482118,Sam Colangelo,R,ANA,23,16,1,3,4
86,8478146,Matthew Highmore,C,OTT,28,35,0,4,4
86,8478021,William Lagesson,D,DET,28,26,0,4,4
86,8479587,Rhett Gardner,C,PHI,28,18,0,4,4
86,8477810,Joel Hanley,D,CGY,33,24,0,4,4
86,8477527,Ross Johnston,L,ANA,30,28,0,4,4
86,8480292,Carson Meyer,R,ANA,27,34,2,1,3
86,8481206,John Ludvig,D,PIT,24,10,2,1,3
86,8482070,Mitchell Chaffee,R,TBL,26,50,1,2,3
86,8482141,Lukas Cormier,D,VGK,22,25,1,2,3
86,8483397,Marc McLaughlin,C,BOS,25,30,1,2,3
86,8482929,Emil Lilleberg,D,TBL,23,22,1,2,3
86,8482460,Matt Rempe,C,NYR,22,11,1,2,3
86,8482144,Jack Thompson,D,SJS,22,19,1,2,3
86,8475413,Justin Dowling,C,NJD,34,14,1,2,3
86,8481043,Cole Koepke,L,BOS,26,18,1,2,3
86,8480823,Alexander Alexeyev,D,WSH,25,17,1,2,3
86,8483597,Milos Kelemen,L,UTA,25,12,1,2,3
86,8481122,Simon Benoit,D,TOR,26,34,0,3,3
86,8481030,Jack St. Ivany,D,PIT,25,23,0,3,3
86,8484258,Sam Malinski,D,COL,26,17,0,3,3
86,8479419,Brett Murray,L,BUF,26,19,2,0,2
86,8480468,James Hamblin,L,EDM,25,15,2,0,2
86,8479367,William Lockwood,R,FLA,26,23,2,0,2
86,8482165,Yan Kuznetsov,D,CGY,22,17,2,0,2
86,8482061,Brandon Biro,L,SEA,26,10,2,0,2
86,8477073,Kurtis MacDermid,L,NJD,30,28,2,0,2
86,8475780,Chris Wagner,R,COL,33,9,2,0,2
86,8478051,Max Willman,C,NJD,29,16,1,1,2
86,8478477,Mitchell Stephens,C,SEA,27,18,1,1,2
86,8478502,Dennis Gilbert,D,BUF,28,12,1,1,2
86,8482172,Landon Slaggert,L,CHI,22,21,1,1,2
86,8481541,Samuel Bolduc,D,NYI,24,29,1,1,2
86,8474062,Riley Nash,C,NYR,35,13,1,1,2
86,8476913,Devin Shore,C,MIN,30,30,0,2,2
86,8481237,Kyle MacLean,C,NYI,25,25,0,2,2
86,8481593,Jayden Struble,D,MTL,23,24,0,2,2
86,8480870,Bo Groulx,C,NYR,24,25,0,2,2
86,8481462,Mason Morelli,L,VGK,28,16,0,2,2
86,8477320,Anton Blidh,L,NYR,29,17,0,2,2
86,8478446,Glenn Gawdin,C,LAK,27,6,1,0,1
86,8482094,Daemon Hunt,D,MIN,22,11,1,0,1
86,8480032,Shane Bowers,C,NJD,25,14,1,0,1
86,8484255,Jason Polin,R,COL,25,4,1,0,1
86,8481655,Cole Schwindt,R,CGY,23,2,1,0,1
86,8479421,Jacob Moverare,D,LAK,26,6,1,0,1
86,8481024,Linus Karlsson,C,VAN,25,9,1,0,1
86,8483401,Marc Johnstone,R,PIT,28,2,1,0,1
86,8476323,Max McCormick,L,SEA,32,7,1,0,1
86,8483471,Brad Lambert,C,WPG,31,9,0,1,1
86,8481806,Louis Crevier,D,CHI,23,17,0,1,1
86,8480075,Cameron Crotty,D,MIN,25,12,0,1,1
86,8482470,Ilya Solovyov,D,CGY,24,18,0,1,1
86,8479330,Brandon Gignac,C,MTL,27,13,0,1,1
86,8481564,Ryan Johnson,D,BUF,23,12,0,1,1
86,8477149,Scott Sabourin,R,SJS,32,18,0,1,1
86,8482126,Emil Andrae,D,PHI,31,5,0,1,1
86,8478881,Brett Seney,L,CHI,28,12,0,1,1
86,8481006,Tyler Tucker,D,STL,24,11,0,1,1
86,8482476,Emil Heineman,L,MTL,23,11,0,1,1
86,8477541,Dakota Mermis,D,TOR,30,11,0,1,1
86,8480306,Grant Hutton,D,NYI,29,6,0,1,1
86,8480874,Adam Ginning,D,PHI,24,8,0,1,1
86,8475795,Dylan McIlrath,D,WSH,32,14,0,1,1
86,8478011,Louie Belpedio,D,PHI,28,15,0,1,1
86,8484321,Nikolas Matinpalo,D,OTT,26,6,0,1,1
86,8483920,Pierrick Dube,R,WSH,23,4,0,1,1
86,8481605,Jackson LaCombe,D,ANA,23,38,0,0,0
86,8484325,Waltteri Merela,C,TBL,26,22,0,0,0
86,8484287,Cole McWard,D,VAN,23,26,0,0,0
86,8483512,Matthew Savoie,C,EDM,20,23,0,0,0
86,8483395,Arshdeep Bains,L,VAN,23,9,0,0,0
86,8482088,Justin Sourdif,R,FLA,22,13,0,0,0
86,8475755,Alexander Petrovic,D,DAL,32,6,0,0,0
86,8482162,Roby Jarventie,L,EDM,22,15,0,0,0
86,8483489,Fraser Minten,C,TOR,31,13,0,0,0
86,8482197,Adam Raska,R,MIN,23,3,0,0,0
86,8482516,Matthew Kessel,D,STL,24,23,0,0,0
86,8477993,Justin Kirkland,C,CGY,28,6,0,0,0
86,8483567,Georgii Merkulov,C,BOS,24,10,0,0,0
86,8481534,Raphael Lavoie,C,EDM,24,2,0,0,0
86,8483407,Brandon Scanlin,D,NYR,25,4,0,0,0
86,8482787,Nikita Chibrikov,R,WPG,31,4,0,0,0
86,8483546,Marshall Rifai,D,TOR,26,7,0,0,0
86,8478854,Ryan Shea,D,PIT,27,5,0,0,0
86,8481578,Graeme Clarke,R,MIN,23,7,0,0,0
86,8484304,Uvis Balinskis,D,FLA,28,3,0,0,0
86,8484326,Patrik Koch,D,UTA,28,4,0,0,0
86,8481726,Adam Edstrom,C,NYR,24,5,0,0,0
86,8483398,Declan Carlile,D,TBL,31,2,0,0,0
86,8483609,Adam Klapka,R,CGY,24,2,0,0,0
86,8483432,Luca Del Bel Belluz,C,CBJ,31,3,0,0,0
86,8479522,Hardy Haman Aktell,D,WSH,26,2,0,0,0
86,8478147,Bokondji Imama,L,PIT,28,2,0,0,0
86,8483531,Brian Halonen,L,NJD,25,2,0,0,0
86,8478956,Samuel Laberge,L,NJD,27,1,0,0,0
86,8480274,Philip Kemp,D,EDM,25,1,0,0,0
86,8484259,Ondrej Pavel,C,COL,31,2,0,0,0
86,8470794,Joe Pavelski,C,,40,0,0,0,0
86,8479321,Lucas Johansen,D,,27,0,0,0,0
86,8477950,Tony DeAngelo,D,,29,0,0,0,0
86,8471218,Blake Wheeler,R,,38,0,0,0,0
86,8475197,Tyson Barrie,D,,33,0,0,0,0
86,8474157,Max Pacioretty,L,,36,0,0,0,0
86,8475744,Evgeny Kuznetsov,C,,32,0,0,0,0
86,8474037,James van Riemsdyk,L,,35,0,0,0,0
86,8476907,Mackenzie MacEachern,L,,30,0,0,0,0
86,8480216,Jacob Peterson,C,,25,0,0,0,0
86,8474602,Justin Schultz,D,,34,0,0,0,0
86,8482222,Alexander Barabanov,L,,30,0,0,0,0
86,8474031,Kevin Shattenkirk,D,,35,0,0,0,0
86,8477330,Dominik Kubalik,L,,29,0,0,0,0
86,8480884,Calen Addison,D,,24,0,0,0,0
86,8475906,John Klingberg,D,,32,0,0,0,0
86,8480008,Adam Ruzicka,C,,25,0,0,0,0
86,8476884,Derrick Pouliot,D,,30,0,0,0,0
86,8476919,Chris Tierney,C,,30,0,0,0,0
86,8479415,Michael McLeod,C,,26,0,0,0,0
86,8474870,Tyler Johnson,C,,34,0,0,0,0
86,8470604,Jeff Carter,C,,39,0,0,0,0
86,8478104,Sammy Blais,L,,28,0,0,0,0
86,8474884,Mike Hoffman,C,,35,0,0,0,0
86,8481591,Sam Poulin,R,,23,0,0,0,0
86,8471274,Alex Goligoski,D,,39,0,0,0,0
86,8476871,Tanner Pearson,L,,32,0,0,0,0
86,8476393,Nick Cousins,C,,31,0,0,0,0
86,8479977,Kailer Yamamoto,R,,26,0,0,0,0
86,8479346,Dillon Dube,C,,26,0,0,0,0
86,8480184,Gustav Lindstrom,D,,26,0,0,0,0
86,8479376,Victor Mete,D,,26,0,0,0,0
86,8473449,Kyle Okposo,R,,36,0,0,0,0
86,8481058,Jesse Ylonen,R,,25,0,0,0,0
86,8475752,Tyler Pitlick,C,,33,0,0,0,0
86,8481239,Samuel Fagemo,L,,24,0,0,0,0
86,8480821,Filip Zadina,R,,25,0,0,0,0
86,8470966,Mark Giordano,D,,41,0,0,0,0
86,8478495,Denis Gurianov,R,,27,0,0,0,0
86,8477464,Nic Petan,C,,29,0,0,0,0
86,8478099,Kevin Labanc,R,,29,0,0,0,0
86,8482241,Radim Zohorna,L,,28,0,0,0,0
86,8474040,Sam Gagner,C,,35,0,0,0,0
86,8479514,Rem Pitlick,C,,27,0,0,0,0
86,8478430,Oliver Kylington,D,,27,0,0,0,0
86,8479533,Joona Koppanen,L,,26,0,0,0,0
86,8479984,Cal Foote,D,,26,0,0,0,0
86,8477126,Jayson Megna,C,,34,0,0,0,0
86,8475164,Jakob Silfverberg,R,,34,0,0,0,0
86,8474009,Nick Bonino,C,,36,0,0,0,0
86,8479458,Nikita Zaitsev,D,,33,0,0,0,0
86,8477944,Jakub Vrana,L,,28,0,0,0,0
86,8471699,Andrew Cogliano,C,,37,0,0,0,0
86,8478067,Oskar Lindblom,L,,28,0,0,0,0
86,8471686,Marc Staal,D,,37,0,0,0,0
86,8470610,Zach Parise,L,,40,0,0,0,0
86,8478904,Steven Lorentz,C,,28,0,0,0,0
86,8473473,Milan Lucic,L,,36,0,0,0,0
86,8480031,Maxime Comtois,L,,25,0,0,0,0
86,8478512,Austin Czarnik,C,,32,0,0,0,0
86,8473504,Cal Clutterbuck,R,,37,0,0,0,0
86,8477454,Adam Erne,L,,29,0,0,0,0
86,8479383,Boris Katchouk,L,,26,0,0,0,0
86,8475825,Jani Hakanpää,D,,32,0,0,0,0
86,8477846,Ryan Carpenter,C,,33,0,0,0,0
86,8477930,Pierre-Edouard Bellemare,L,,39,0,0,0,0
86,8478400,Colin White,C,,27,0,0,0,0
86,8480226,Marián Studenic,R,,26,0,0,0,0
86,8480853,Liam Foudy,C,,24,0,0,0,0
86,8475797,Jarred Tinordi,D,,32,0,0,0,0
86,8479423,Alex Nylander,L,,26,0,0,0,0
86,8474618,Marco Scandella,D,,34,0,0,0,0
86,8478028,Fredrik Olofsson,L,,28,0,0,0,0
86,8474709,Matt Martin,L,,35,0,0,0,0
86,8481070,Hugh McGing,L,,26,0,0,0,0
86,8479546,Oskar Steen,C,,26,0,0,0,0
86,8474145,Robert Bortuzzo,D,,35,0,0,0,0
86,8476915,Jujhar Khaira,L,,30,0,0,0,0
86,8475278,Byron Froese,C,,33,0,0,0,0
86,8481812,Nikolai Knyzhov,D,,27,0,0,0,0
86,8478408,Travis Dermott,D,,28,0,0,0,0
86,8481077,John Leonard,L,,26,0,0,0,0
86,8479547,Matthew Phillips,R,,26,0,0,0,0
86,8480836,Jonathan Gruden,C,,24,0,0,0,0
86,8481690,Tyler Angle,C,,24,0,0,0,0
86,8475766,Austin Watson,L,,32,0,0,0,0
86,8481016,Ruslan Iskhakov,C,,24,0,0,0,0
86,8478078,Rourke Chartier,C,,28,0,0,0,0
86,8480776,Sheldon Rempal,R,,29,0,0,0,0
86,8483045,Cameron Butler,R,CBJ,31,1,0,0,0
86,8484314,Jiri Smejkal,L,,28,0,0,0,0
87,8478402,Connor McDavid,C,EDM,27,80,51,96,147
87,8479318,Auston Matthews,C,TOR,27,82,79,65,144
87,8476453,Nikita Kucherov,R,TBL,31,82,49,90,139
87,8477939,William Nylander,R,TOR,28,81,51,67,118
87,8477492,Nathan MacKinnon,C,COL,29,82,45,73,118
87,8477956,David Pastrnak,R,BOS,28,81,63,53,116
87,8478483,Mitch Marner,R,TOR,27,80,33,81,114
87,8477409,Carter Verhaeghe,C,FLA,29,79,50,60,110
87,8479314,Matthew Tkachuk,L,FLA,27,78,41,69,110
87,8477493,Aleksander Barkov,C,FLA,29,77,29,80,109
87,8477934,Leon Draisaitl,C,EDM,29,77,44,62,106
87,8478550,Artemi Panarin,L,NYR,33,80,33,71,104
87,8471675,Sidney Crosby,C,PIT,37,73,50,48,98
87,8478427,Sebastian Aho,C,CAR,27,72,44,52,96
87,8476887,Filip Forsberg,L,NSH,30,76,37,58,95
87,8480023,Robert Thomas,C,STL,25,76,28,66,94
87,8478420,Mikko Rantanen,R,COL,28,82,39,53,92
87,8480012,Elias Pettersson,C,VAN,26,75,35,57,92
87,8474600,Roman Josi,D,NSH,34,73,26,66,92
87,8474141,Patrick Kane,R,DET,36,81,34,57,91
87,8480801,Brady Tkachuk,L,OTT,25,80,44,46,90
87,8478864,Kirill Kaprizov,L,MIN,27,76,39,50,89
87,8475754,Brock Nelson,C,NYI,33,78,49,39,88
87,8477404,Jake Guentzel,C,TBL,30,82,31,57,88
87,8476468,J.T. Miller,C,VAN,31,73,32,53,85
87,8477942,Kevin Fiala,L,LAK,28,80,20,65,85
87,8479343,Clayton Keller,R,UTA,26,73,29,55,84
87,8479407,Jesper Bratt,L,NJD,26,72,25,59,84
87,8477960,Adrian Kempe,R,LAK,28,79,40,43,83
87,8478398,Kyle Connor,L,WPG,28,74,40,42,82
87,8481559,Jack Hughes,C,NJD,23,73,31,51,82
87,8482116,Tim Stützle,C,OTT,22,76,32,49,81
87,8478460,Zach Werenski,D,CBJ,27,80,18,63,81
87,8478439,Travis Konecny,R,PHI,27,77,30,50,80
87,8471214,Alex Ovechkin,L,WSH,39,74,40,39,79
87,8477946,Dylan Larkin,C,DET,28,79,35,44,79
87,8475166,John Tavares,C,TOR,34,78,29,50,79
87,8475913,Mark Stone,R,VGK,32,77,28,51,79
87,8477933,Sam Reinhart,C,FLA,29,75,37,41,78
87,8477416,Oliver Bjorkstrand,R,SEA,29,72,32,46,78
87,8478445,Mathew Barzal,C,NYI,27,79,24,54,78
87,8481557,Matt Boldy,L,MIN,23,72,35,42,77
87,8480069,Cale Makar,D,COL,26,74,27,50,77
87,8482665,Matty Beniers,C,SEA,22,74,30,46,76
87,8476905,Chandler Stephenson,C,SEA,30,76,19,57,76
87,8480865,Noah Dobson,D,NYI,24,82,17,59,76
87,8477504,Josh Morrissey,D,WPG,29,74,14,62,76
87,8479420,Tage Thompson,C,BUF,27,73,43,32,75
87,8475172,Nazem Kadri,C,CGY,34,79,26,49,75
87,8482093,Seth Jarvis,C,CAR,22,70,36,38,74
87,8478010,Brayden Point,C,TBL,28,82,33,41,74
87,8484144,Connor Bedard,C,CHI,19,70,32,42,74
87,8475810,Bryan Rust,R,PIT,32,70,27,47,74
87,8473419,Brad Marchand,L,BOS,36,80,26,48,74
87,8475167,Victor Hedman,D,TBL,34,77,14,60,74
87,8476460,Mark Scheifele,C,WPG,31,65,29,43,72
87,8478414,Timo Meier,R,NJD,28,78,29,43,72
87,8477496,Elias Lindholm,C,BOS,30,80,23,49,72
87,8480800,Quinn Hughes,D,VAN,25,77,15,57,72
87,8480036,Miro Heiskanen,D,DAL,25,77,11,61,72
87,8480002,Nico Hischier,C,NJD,25,74,31,40,71
87,8477402,Pavel Buchnevich,L,STL,29,76,31,40,71
87,8478440,Dylan Strome,C,WSH,27,75,30,41,71
87,8475692,Mats Zuccarello,R,MIN,37,73,16,55,71
87,8476346,Johnny Gaudreau,L,CBJ,31,71,25,45,70
87,8474564,Steven Stamkos,C,NSH,34,74,34,35,69
87,8480208,Drake Batherson,R,OTT,26,79,31,38,69
87,8476479,Phillip Danault,C,LAK,31,81,28,41,69
87,8480027,Jason Robertson,L,DAL,25,81,26,43,69
87,8478873,Troy Terry,R,ANA,27,74,21,48,69
87,8479337,Alex DeBrincat,R,DET,27,79,33,35,68
87,8475726,Tyler Toffoli,C,SJS,32,71,33,35,68
87,8471685,Anze Kopitar,C,LAK,37,80,21,47,68
87,8480803,Evan Bouchard,D,EDM,25,75,14,54,68
87,8481540,Cole Caufield,R,MTL,23,77,34,33,67
87,8478403,Jack Eichel,C,VGK,28,80,33,34,67
87,8474102,David Perron,L,OTT,36,79,25,42,67
87,8478493,Joel Eriksson Ek,C,MIN,27,68,24,43,67
87,8482740,Wyatt Johnston,C,DAL,21,81,34,31,65
87,8479385,Jordan Kyrou,C,STL,26,75,33,32,65
87,8477500,Bo Horvat,C,NYI,29,80,32,33,65
87,8478975,Mason Marchment,L,DAL,29,82,27,38,65
87,8474679,Gustav Nyquist,C,NSH,35,75,24,41,65
87,8480839,Rasmus Dahlin,D,BUF,24,75,15,50,65
87,8476456,Jonathan Huberdeau,C,CGY,31,80,12,53,65
87,8478407,Vince Dunn,D,SEA,28,72,7,58,65
87,8477951,Nick Schmaltz,C,UTA,28,75,27,37,64
87,8477998,Warren Foegele,L,LAK,28,78,26,38,64
87,8475794,Tyler Seguin,C,DAL,32,82,24,40,64
87,8481542,Moritz Seider,D,DET,23,73,7,57,64
87,8478449,Roope Hintz,C,DAL,28,81,36,27,63
87,8477935,Sam Bennett,C,FLA,28,76,32,31,63
87,8480830,Andrei Svechnikov,R,CAR,24,66,24,39,63
87,8473994,Jamie Benn,L,DAL,35,82,20,43,63
87,8473512,Claude Giroux,R,OTT,36,76,18,45,63
87,8470613,Brent Burns,D,CAR,39,79,16,47,63
87,8476539,Jonathan Marchessault,R,NSH,34,71,32,30,62
87,8477955,Jared McCann,L,SEA,28,72,32,30,62
87,8475745,Charlie Coyle,C,BOS,32,76,20,42,62
87,8474590,John Carlson,D,WSH,34,65,15,47,62
87,8477501,Valeri Nichushkin,R,COL,29,80,32,29,61
87,8478444,Brock Boeser,R,VAN,27,74,30,31,61
87,8477940,Nikolaj Ehlers,L,WPG,28,74,27,34,61
87,8476448,William Karlsson,C,VGK,31,78,27,34,61
87,8475798,Mikael Granlund,C,SJS,32,70,20,41,61
87,8481528,Dylan Cozens,C,BUF,23,73,20,41,61
87,8477494,Jonathan Drouin,L,COL,29,79,19,42,61
87,8479425,Filip Hronek,D,VAN,27,81,9,52,61
87,8474586,Jordan Eberle,R,SEA,34,73,29,31,60
87,8480015,Owen Tippett,R,PHI,25,78,27,33,60
87,8476459,Mika Zibanejad,C,NYR,31,76,22,38,60
87,8471215,Evgeni Malkin,C,PIT,38,68,22,38,60
87,8477949,Alex Tuch,R,BUF,28,72,22,38,60
87,8476483,Rickard Rakell,R,PIT,31,72,35,24,59
87,8476399,Blake Coleman,C,CGY,33,78,27,32,59
87,8476454,Ryan Nugent-Hopkins,C,EDM,31,78,24,35,59
87,8480039,Martin Necas,C,CAR,25,71,27,31,58
87,8482113,Anton Lundell,C,FLA,23,76,27,31,58
87,8474641,Adam Henrique,C,EDM,34,76,24,34,58
87,8475765,Vladimir Tarasenko,R,DET,33,81,23,35,58
87,8483515,Juraj Slafkovsky,L,MTL,20,78,23,35,58
87,8482720,Matthew Knies,L,TOR,22,76,19,39,58
87,8480018,Nick Suzuki,C,MTL,25,76,18,40,58
87,8475168,Matt Duchene,C,DAL,33,81,33,24,57
87,8482078,Lucas Raymond,L,DET,22,80,28,29,57
87,8476880,Tom Wilson,R,WSH,30,71,22,35,57
87,8479325,Charlie McAvoy,D,BOS,27,73,12,45,57
87,8475184,Chris Kreider,L,NYR,33,76,33,23,56
87,8475784,Jeff Skinner,C,EDM,32,77,25,31,56
87,8482699,Dylan Guenther,R,UTA,21,79,23,33,56
87,8478047,Michael Bunting,L,PIT,29,73,21,35,56
87,8479400,Pierre-Luc Dubois,L,WSH,26,77,17,39,56
87,8479542,Brandon Hagel,L,TBL,26,81,28,27,55
87,8478498,Jake DeBrusk,L,VAN,28,77,25,30,55
87,8478042,Viktor Arvidsson,L,EDM,31,76,23,32,55
87,8478401,Pavel Zacha,C,BOS,27,79,18,37,55
87,8478397,Rasmus Andersson,D,CGY,28,76,11,44,55
87,8480014,Gabriel Vilardi,C,WPG,25,64,29,25,54
87,8478542,Evan Rodrigues,C,FLA,31,77,22,32,54
87,8482097,Jack Quinn,R,BUF,23,68,22,32,54
87,8476389,Vincent Trocheck,C,NYR,31,75,20,34,54
87,8479323,Adam Fox,D,NYR,26,73,11,43,54
87,8477932,Aaron Ekblad,D,FLA,28,77,11,43,54
87,8477407,Anthony Duclair,L,NYI,29,75,22,31,53
87,8479675,Trevor Moore,L,LAK,29,79,21,32,53
87,8479999,Casey Mittelstadt,C,COL,26,81,19,34,53
87,8477451,Ryan Hartman,R,MIN,30,70,18,35,53
87,8478462,Nicolas Roy,C,VGK,27,75,17,36,53
87,8477447,Shea Theodore,D,VGK,29,60,10,43,53
87,8482705,Cole Sillinger,C,CBJ,21,68,28,24,52
87,8481068,Yegor Sharangovich,C,CGY,26,79,27,25,52
87,8481560,Arthur Kaliyev,R,LAK,23,81,24,28,52
87,8477456,J.T. Compher,L,DET,29,79,23,29,52
87,8477511,Anthony Mantha,R,CGY,30,76,23,29,52
87,8476853,Morgan Rielly,D,TOR,30,64,9,43,52
87,8482684,Luke Hughes,D,NJD,21,70,8,44,52
87,8477476,Artturi Lehkonen,L,COL,29,78,25,26,51
87,8477479,Tyler Bertuzzi,L,CHI,29,70,25,26,51
87,8482667,William Eklund,L,SJS,22,70,24,27,51
87,8482124,Quinton Byfield,R,LAK,22,80,19,32,51
87,8481604,Pavel Dorofeyev,L,VGK,24,70,27,23,50
87,8479365,Trent Frederic,C,BOS,26,76,24,26,50
87,8481533,Trevor Zegras,C,ANA,23,67,23,27,50
87,8483808,Andrei Kuzmenko,L,CGY,28,75,21,29,50
87,8475170,Brayden Schenn,C,STL,33,74,19,31,50
87,8478856,Conor Garland,R,VAN,28,76,18,32,50
87,8476826,Yanni Gourde,C,SEA,33,72,16,34,50
87,8478469,Thomas Chabot,D,OTT,27,76,13,37,50
87,8483505,Matthew Poitras,C,BOS,20,73,13,37,50
87,8474578,Erik Karlsson,D,PIT,34,80,10,40,50
87,8475714,Calle Jarnkrok,C,TOR,33,76,27,22,49
87,8477426,Nicholas Paul,L,TBL,29,81,25,24,49
87,8475158,Ryan O'Reilly,C,NSH,33,72,24,25,49
87,8482745,Mason McTavish,C,ANA,21,74,22,27,49
87,8474150,Mikael Backlund,C,CGY,35,75,20,29,49
87,8481711,Matias Maccelli,L,UTA,24,74,19,30,49
87,8477964,Ivan Barbashev,C,VGK,29,81,18,31,49
87,8482109,Alexis Lafrenière,L,NYR,23,75,24,24,48
87,8483431,Logan Cooley,C,UTA,20,75,22,26,48
87,8477495,Seth Jones,D,CHI,30,69,14,34,48
87,8482175,JJ Peterka,R,BUF,22,70,29,18,47
87,8482055,Drew O'Connor,L,PIT,26,66,27,20,47
87,8475786,Zach Hyman,L,EDM,32,76,26,21,47
87,8471724,Kris Letang,D,PIT,37,79,13,34,47
87,8477497,Sean Monahan,C,CBJ,30,69,13,34,47
87,8477444,Andre Burakovsky,L,SEA,29,71,15,31,46
87,8478472,Mathieu Joseph,R,STL,27,70,15,31,46
87,8478055,Gustav Forsling,D,FLA,28,79,12,34,46
87,8476906,Shayne Gostisbehere,D,CAR,31,70,10,36,46
87,8477503,Max Domi,C,TOR,29,75,6,40,46
87,8476881,Tomas Hertl,C,VGK,31,76,29,16,45
87,8480064,Josh Norris,C,OTT,25,78,21,24,45
87,8484153,Leo Carlsson,C,ANA,20,75,17,28,45
87,8476432,Boone Jenner,C,CBJ,31,68,26,18,44
87,8476438,Brandon Saad,L,STL,32,72,24,20,44
87,8473986,Alex Killorn,L,ANA,35,74,23,21,44
87,8475799,Nino Niederreiter,R,WPG,32,67,22,22,44
87,8478438,Tommy Novak,C,NSH,27,74,21,23,44
87,8475760,Nick Bjugstad,C,UTA,32,74,21,23,44
87,8478366,Frank Vatrano,R,ANA,30,69,20,24,44
87,8481596,Shane Pinto,C,OTT,24,71,19,25,44
87,8484145,Zach Benson,L,BUF,19,69,18,26,44
87,8479410,Mikhail Sergachev,D,UTA,26,71,11,33,44
87,8480459,Pius Suter,C,VAN,28,74,25,18,43
87,8474149,Evgenii Dadonov,R,DAL,35,81,20,23,43
87,8479339,Patrik Laine,L,CBJ,26,70,18,25,43
87,8479987,Morgan Geekie,C,BOS,26,78,17,26,43
87,8482702,Logan Stankoven,C,DAL,21,82,16,27,43
87,8480188,Fabian Zetterlund,L,SJS,25,64,16,27,43
87,8478038,Devon Toews,D,COL,30,70,13,30,43
87,8482105,Jake Sanderson,D,OTT,22,76,10,33,43
87,8480434,Sean Durzi,D,UTA,26,73,8,35,43
87,8479591,Michael Eyssimont,C,TBL,28,82,22,20,42
87,8480009,Eeli Tolvanen,R,SEA,25,66,21,21,42
87,8477986,Brandon Montour,D,SEA,30,73,16,26,42
87,8480185,Eetu Luostarinen,C,FLA,26,76,15,27,42
87,8482159,Tyson Foerster,R,PHI,22,73,22,19,41
87,8478233,Andrew Mangiapane,L,WSH,28,67,21,20,41
87,8478474,Lawson Crouse,L,UTA,27,75,20,21,41
87,8480849,Barrett Hayton,C,UTA,24,75,19,22,41
87,8473422,Nick Foligno,L,CHI,37,60,19,22,41
87,8480797,Joel Farabee,L,PHI,24,74,16,25,41
87,8474563,Drew Doughty,D,LAK,35,70,13,28,41
87,8482149,Cole Perfetti,C,WPG,22,71,13,28,41
87,8479351,Sam Steel,C,DAL,26,82,10,31,41
87,8477498,Darnell Nurse,D,EDM,29,77,8,33,41
87,8476958,Jaccob Slavin,D,CAR,30,76,3,38,41
87,8475151,Kyle Palmieri,C,NYI,33,78,21,19,40
87,8483524,Shane Wright,C,SEA,20,63,19,21,40
87,8478519,Anthony Cirelli,C,TBL,27,82,15,25,40
87,8477429,Andrew Copp,C,DET,30,78,14,26,40
87,8480798,Philipp Kurashev,C,CHI,25,61,14,26,40
87,8476792,Torey Krug,D,STL,33,69,12,28,40
87,8475314,Anders Lee,L,NYI,34,81,24,15,39
87,8480893,Kirill Marchenko,R,CBJ,24,64,23,16,39
87,8475793,Ryan Johansen,C,PHI,32,76,16,23,39
87,8475169,Evander Kane,L,EDM,33,73,14,25,39
87,8482110,Dawson Mercer,C,NJD,23,72,17,21,38
87,8476927,Teddy Blueger,C,VAN,30,66,15,23,38
87,8480871,Adam Boqvist,D,FLA,24,63,10,28,38
87,8476463,Jonas Brodin,D,MIN,31,76,10,28,38
87,8480145,Neal Pionk,D,WPG,29,71,6,32,38
87,8480829,Jesperi Kotkaniemi,C,CAR,24,64,22,15,37
87,8475287,Erik Haula,L,NJD,33,74,20,17,37
87,8474715,Cameron Atkinson,R,TBL,35,80,19,18,37
87,8481186,Logan O'Connor,R,COL,28,81,17,20,37
87,8478891,Mason Appleton,C,WPG,28,63,16,21,37
87,8476458,Ryan Strome,C,ANA,31,70,12,25,37
87,8477346,MacKenzie Weegar,D,CGY,30,71,10,27,37
87,8476869,Brady Skjei,D,NSH,30,76,8,29,37
87,8478396,Noah Hanifin,D,VGK,27,58,6,31,37
87,8476882,Teuvo Teravainen,C,CHI,30,64,19,17,36
87,8476872,Scott Laughton,C,PHI,30,72,17,19,36
87,8479525,Ross Colton,C,COL,28,82,16,20,36
87,8481535,Nils Hoglander,L,VAN,24,67,13,23,36
87,8476462,Dougie Hamilton,D,NJD,31,70,9,27,36
87,8476923,Damon Severson,D,CBJ,30,79,8,28,36
87,8481546,Cam York,D,PHI,23,69,6,30,36
87,8481703,Valtteri Puustinen,R,PIT,25,61,5,31,36
87,8475149,Marcus Johansson,L,MIN,34,68,15,20,35
87,8484166,Adam Fantilli,C,CBJ,20,64,14,21,35
87,8477021,Alex Kerfoot,C,UTA,30,71,12,23,35
87,8476419,Jean-Gabriel Pageau,C,NYI,32,79,11,24,35
87,8478458,John (Jack) Roslovic,C,CAR,27,63,11,24,35
87,8482133,Thomas Bordeleau,C,SJS,22,62,10,25,35
87,8482660,Kent Johnson,C,CBJ,22,64,8,27,35
87,8476854,Hampus Lindholm,D,BOS,30,71,7,28,35
87,8476474,Stefan Noesen,R,NJD,31,73,17,17,34
87,8476480,Vladislav Namestnikov,C,WPG,32,69,17,17,34
87,8475848,Brendan Gallagher,R,MTL,32,74,13,21,34
87,8475855,Jesper Fast,R,CAR,33,67,12,22,34
87,8479345,Jakob Chychrun,D,WSH,26,63,11,23,34
87,8481524,Bowen Byram,D,BUF,23,63,10,24,34
87,8475764,Cam Fowler,D,ANA,33,75,9,25,34
87,8482122,Brock Faber,D,MIN,22,76,6,28,34
87,8478057,Dakota Joshua,C,VAN,28,60,17,16,33
87,8476897,Oskar Sundqvist,C,STL,30,69,17,16,33
87,8477953,Kasperi Kapanen,R,STL,28,70,15,18,33
87,8471698,T.J. Oshie,R,WSH,38,62,14,19,33
87,8473533,Jordan Staal,C,CAR,36,63,14,19,33
87,8478466,Daniel Sprong,R,VAN,27,64,12,21,33
87,8482092,Ridly Greig,C,OTT,22,75,10,23,33
87,8481577,Philip Tomasino,C,NSH,23,68,9,24,33
87,8475218,Mattias Ekholm,D,EDM,34,76,8,25,33
87,8481581,Thomas Harley,D,DAL,23,75,8,25,33
87,8475200,Dmitry Orlov,D,CAR,33,76,6,27,33
87,8475753,Justin Faulk,D,STL,32,72,3,30,33
87,8477506,Ryan Pulock,D,NYI,30,78,2,31,33
87,8478109,Victor Olofsson,L,VGK,29,67,20,12,32
87,8481618,Alex Newhook,C,MTL,23,75,16,16,32
87,8475768,Jaden Schwartz,C,SEA,32,70,14,18,32
87,8475791,Taylor Hall,L,CHI,33,52,13,19,32
87,8477839,Conor Sheary,L,TBL,32,81,9,23,32
87,8482125,Alexander Holtz,R,VGK,22,69,20,11,31
87,8474189,Lars Eller,C,PIT,35,72,18,13,31
87,8475220,Marcus Foligno,L,MIN,33,63,16,15,31
87,8480028,Morgan Frost,C,PHI,25,69,15,16,31
87,8479393,Noah Gregor,L,OTT,26,75,15,16,31
87,8476292,Ondrej Palat,L,NJD,33,68,13,18,31
87,8482809,Jackson Blake,R,CAR,21,63,13,18,31
87,8481656,Aliaksei Protas,C,WSH,23,59,12,19,31
87,8477505,Alexander Wennberg,C,SJS,30,65,11,20,31
87,8484203,Bradly Nadeau,L,CAR,19,61,9,22,31
87,8477948,Travis Sanheim,D,PHI,28,68,8,23,31
87,8482671,Owen Power,D,BUF,22,66,6,25,31
87,8476979,Erik Gustafsson,D,DET,32,76,4,27,31
87,8470621,Corey Perry,R,EDM,39,71,14,16,30
87,8475193,Tomas Tatar,L,NJD,34,71,13,17,30
87,8479353,Brett Howden,C,VGK,26,66,12,18,30
87,8475722,Jason Zucker,L,BUF,32,69,12,18,30
87,8479368,Max Jones,L,BOS,26,68,12,18,30
87,8476925,Colton Sissons,C,NSH,31,64,9,21,30
87,8476960,Andreas Athanasiou,C,CHI,30,51,9,21,30
87,8479661,Tanner Jeannot,L,LAK,27,75,8,22,30
87,8482712,Oskar Olausson,R,COL,22,75,6,24,30
87,8480817,K'Andre Miller,D,NYR,24,71,6,24,30
87,8476331,Dylan DeMelo,D,WPG,31,74,6,24,30
87,8474565,Alex Pietrangelo,D,VGK,34,60,3,27,30
87,8480043,Timothy Liljegren,D,TOR,25,67,3,27,30
87,8481582,Nicholas Robertson,L,TOR,23,61,15,14,29
87,8481601,Simon Holmstrom,R,NYI,23,73,12,17,29
87,8479293,Brandon Tanev,L,SEA,33,65,11,18,29
87,8476875,Mike Matheson,D,MTL,30,70,10,19,29
87,8477987,Ryan Donato,C,CHI,28,64,9,20,29
87,8477919,Frederick Gaudreau,C,MIN,31,62,8,21,29
87,8477220,Nate Schmidt,D,FLA,33,62,8,21,29
87,8483490,Pavel Mintyukov,D,ANA,21,73,4,25,29
87,8476879,Cody Ceci,D,EDM,31,71,3,26,29
87,8478046,Danton Heinen,L,VAN,29,68,12,16,28
87,8475763,Kevin Hayes,R,PIT,32,70,10,18,28
87,8478115,Pierre Engvall,L,NYI,28,78,10,18,28
87,8478463,Anthony Beauvillier,L,PIT,27,64,10,18,28
87,8482624,Daniil Miromanov,D,CGY,27,62,10,18,28
87,8476457,Adam Larsson,D,SEA,32,72,10,18,28
87,8481093,Rafael Harvey-Pinard,L,MTL,25,64,8,20,28
87,8476461,Sean Couturier,C,PHI,32,74,7,21,28
87,8481606,Jordan Spence,D,LAK,23,65,6,22,28
87,8479983,Mario Ferraro,D,SJS,26,67,6,22,28
87,8477969,Marcus Pettersson,D,PIT,28,78,3,25,28
87,8477425,Miles Wood,L,COL,29,80,17,10,27
87,8478508,Yakov Trenin,C,MIN,27,59,14,13,27
87,8480802,Ryan McLeod,C,BUF,25,65,12,15,27
87,8480205,Emil Bemstrom,C,PIT,25,56,12,15,27
87,8480748,Kiefer Sherwood,L,VAN,29,60,12,15,27
87,8477947,Sonny Milano,L,WSH,28,58,11,16,27
87,8481441,Joe Snively,C,DET,28,72,11,16,27
87,8478432,Christian Fischer,R,DET,27,78,8,19,27
87,8477989,Christian Dvorak,C,MTL,28,68,8,19,27
87,8482101,Danil Gushchin,L,SJS,22,65,7,20,27
87,8478911,Matt Roy,D,WSH,29,66,6,21,27
87,8480835,Jack Drury,C,CAR,24,53,16,10,26
87,8476392,Adam Lowry,C,WPG,31,64,13,13,26
87,8480762,Eric Robinson,L,CAR,29,58,12,14,26
87,8477478,William Carrier,L,CAR,30,65,11,15,26
87,8476918,Jimmy Vesey,L,NYR,31,66,10,16,26
87,8475343,Nic Dowd,C,WSH,34,55,10,16,26
87,8476885,Jacob Trouba,D,NYR,30,71,8,18,26
87,8480878,Nils Lundkvist,D,DAL,24,71,8,18,26
87,8480980,Connor Dewar,C,TOR,25,69,8,18,26
87,8474053,Logan Couture,C,SJS,35,56,7,19,26
87,8478500,Ivan Provorov,D,CBJ,27,77,4,22,26
87,8482089,Jake Neighbours,L,STL,22,67,15,10,25
87,8476981,Josh Anderson,R,MTL,30,70,14,11,25
87,8481580,Connor McMichael,C,WSH,23,65,14,11,25
87,8482475,Yegor Chinakhov,R,CBJ,23,65,13,12,25
87,8477952,Robby Fabbri,C,ANA,28,68,13,12,25
87,8480078,Filip Chytil,C,NYR,25,65,13,12,25
87,8481032,Paul Cotter,C,NJD,25,60,13,12,25
87,8479992,Michael Rasmussen,C,DET,25,75,12,13,25
87,8480281,Alexey Toropchenko,R,STL,25,61,11,14,25
87,8475231,Casey Cizikas,C,NYI,33,76,9,16,25
87,8481624,Ilya Mikheyev,R,CHI,30,61,9,16,25
87,8476467,Jamie Oleksiak,D,SEA,32,67,8,17,25
87,8481522,Peyton Krebs,C,BUF,23,63,8,17,25
87,8478413,Jordan Greenway,L,BUF,27,57,7,18,25
87,8480336,Sean Walker,D,CAR,30,74,6,19,25
87,8481523,Kirby Dach,C,MTL,23,70,5,20,25
87,8476902,Esa Lindell,D,DAL,30,73,4,21,25
87,8476917,Adam Pelech,D,NYI,30,77,4,21,25
87,8482655,Janis Moser,D,TBL,24,76,3,22,25
87,8476469,Joel Armia,R,MTL,31,67,17,7,24
87,8482079,Marco Rossi,C,MIN,23,59,14,10,24
87,8481554,Kaapo Kakko,R,NYR,23,68,12,12,24
87,8480068,Ryan Poehling,C,PHI,25,71,11,13,24
87,8480813,Joe Veleno,C,DET,24,77,10,14,24
87,8482146,Luke Evangelista,R,NSH,22,60,9,15,24
87,8479996,Cody Glass,C,NSH,25,63,8,16,24
87,8480113,Alex Iafallo,L,WPG,31,65,7,17,24
87,8480144,David Kampf,C,TOR,29,75,7,17,24
87,8473563,Nicklas Backstrom,C,WSH,37,59,7,17,24
87,8480855,Jack McBain,C,UTA,24,70,6,18,24
87,8478133,Jake Evans,C,MTL,28,70,5,19,24
87,8476931,Jake McCabe,D,TOR,31,67,5,19,24
87,8477845,Trevor van Riemsdyk,D,WSH,33,59,3,21,24
87,8477488,Brett Pesce,D,NJD,30,65,2,22,24
87,8477435,Ryan Graves,D,PIT,29,75,2,22,24
87,8476374,Sean Kuraly,C,CBJ,31,58,17,6,23
87,8482117,Lukas Reichel,L,CHI,22,51,16,7,23
87,8477979,Nicolas Aube-Kubel,R,BUF,28,61,14,9,23
87,8479316,Luke Kunin,C,SJS,27,63,12,11,23
87,8478020,Michael Amadio,R,OTT,28,70,10,13,23
87,8475191,Reilly Smith,R,NYR,33,73,9,14,23
87,8482142,Jamie Drysdale,D,PHI,22,66,8,15,23
87,8480220,Noah Cates,L,PHI,25,69,7,16,23
87,8479998,Mikey Anderson,D,LAK,25,68,5,18,23
87,8480035,Henri Jokiharju,D,BUF,25,61,4,19,23
87,8478851,Alexandre Carrier,D,NSH,28,69,3,20,23
87,8481568,Alex Vlasic,D,CHI,23,50,3,20,23
87,8483565,Nick Blankenburg,D,NSH,26,67,2,21,23
87,8478416,Erik Cernak,D,TBL,27,77,2,21,23
87,8474673,TJ Brodie,D,CHI,34,64,2,21,23
87,8480289,Morgan Barron,C,WPG,26,59,12,10,22
87,8478211,Dryden Hunt,L,CGY,29,54,11,11,22
87,8483457,Lane Hutson,D,MTL,20,74,11,11,22
87,8477507,Nikita Zadorov,D,BOS,29,71,10,12,22
87,8482111,Justin Barron,D,MTL,23,69,9,13,22
87,8481028,Martin Pospisil,C,CGY,25,56,9,13,22
87,8474716,Jared Spurgeon,D,MIN,35,75,8,14,22
87,8481019,David Gustafsson,C,WPG,24,57,8,14,22
87,8479370,Tyson Jost,C,CAR,26,47,7,15,22
87,8481553,Bobby Brink,R,PHI,23,62,6,16,22
87,8482087,Kaiden Guhle,D,MTL,22,71,6,16,22
87,8475171,Oliver Ekman-Larsson,D,TOR,33,67,4,18,22
87,8480873,Rasmus Sandin,D,WSH,24,66,3,19,22
87,8475179,Dmitry Kulikov,D,FLA,34,58,3,19,22
87,8474151,Ryan McDonagh,D,TBL,35,79,2,20,22
87,8482679,Matt Coronato,R,CGY,22,67,12,9,21
87,8482074,Connor Zary,C,CGY,23,62,11,10,21
87,8482737,Zack Bolduc,C,STL,21,54,11,10,21
87,8481704,Juuso Parssinen,C,NSH,23,57,9,12,21
87,8476921,Jordan Martinook,L,CAR,32,55,8,13,21
87,8481481,Blake Lizotte,C,PIT,27,54,7,14,21
87,8478882,Vladislav Gavrikov,D,LAK,29,68,6,15,21
87,8476312,Josh Manson,D,COL,33,59,5,16,21
87,8480807,Mattias Samuelsson,D,BUF,24,57,2,19,21
87,8483491,Ivan Miroshnichenko,L,WSH,20,61,12,8,20
87,8483499,Liam Ohgren,L,MIN,20,47,12,8,20
87,8479941,Justin Danforth,R,CBJ,31,60,10,10,20
87,8482077,Dylan Holloway,L,EDM,23,50,10,10,20
87,8477392,Hudson Fasching,R,NYI,29,65,8,12,20
87,8473507,Jeff Petry,D,DET,37,70,8,12,20
87,8479026,Philippe Myers,D,TOR,27,63,8,12,20
87,8477450,Jason Dickinson,C,CHI,29,60,8,12,20
87,8476278,Colin Blackwell,C,DAL,31,77,7,13,20
87,8476422,Mike Reilly,D,NYI,31,73,6,14,20
87,8478013,Jake Walman,D,SJS,28,73,6,14,20
87,8479976,Juuso Valimaki,D,UTA,26,67,6,14,20
87,8479369,Andrew Peeke,D,BOS,26,60,5,15,20
87,8476892,Colton Parayko,D,STL,31,68,4,16,20
87,8478970,Jalen Chatfield,D,CAR,28,71,4,16,20
87,8482067,Connor Mackey,D,NYR,28,61,4,16,20
87,8481014,Alexander Romanov,D,NYI,24,77,3,17,20
87,8476891,Matthew Grzelcyk,D,PIT,30,78,2,18,20
87,8475233,David Savard,D,MTL,34,63,2,18,20
87,8482259,Bobby McMann,C,TOR,28,59,15,4,19
87,8476878,Zemgus Girgensons,C,TBL,30,78,14,5,19
87,8480789,Oliver Wahlstrom,R,NYI,24,62,10,9,19
87,8479520,Brandon Duhaime,R,WSH,27,55,10,9,19
87,8477508,Curtis Lazar,C,NJD,29,57,10,9,19
87,8479619,Michael Carcone,L,UTA,28,65,10,9,19
87,8477406,Mattias Janmark,C,EDM,32,63,10,9,19
87,8476856,Mathew Dumba,D,DAL,30,66,10,9,19
87,8476442,Matt Nieto,L,PIT,32,47,8,11,19
87,8479066,Ryan Lomberg,L,CGY,30,68,8,11,19
87,8478434,Keegan Kolesar,R,VGK,27,68,7,12,19
87,8476329,Travis Boyd,C,MIN,31,52,7,12,19
87,8481521,Ronnie Attard,D,PHI,25,53,7,12,19
87,8481013,Jonatan Berggren,R,DET,24,58,6,13,19
87,8478136,Jake Middleton,D,MIN,28,74,6,13,19
87,8480222,Sebastian Aho,D,PIT,28,74,5,14,19
87,8477015,Connor Brown,R,EDM,30,65,11,7,18
87,8482730,Brandt Clarke,D,LAK,21,50,10,8,18
87,8482062,Cole Smith,L,NSH,29,61,8,10,18
87,8480995,Pontus Holmberg,R,TOR,25,61,8,10,18
87,8483445,Cutter Gauthier,L,ANA,20,65,7,11,18
87,8482148,Hendrix Lapierre,C,WSH,22,51,7,11,18
87,8480355,Mark Kastelic,C,BOS,25,56,7,11,18
87,8479982,Conor Timmins,D,TOR,26,55,5,13,18
87,8475718,Justin Holl,D,DET,32,58,5,13,18
87,8479402,Jake Bean,D,CGY,26,67,4,14,18
87,8480049,Dylan Samberg,D,WPG,25,67,3,15,18
87,8481527,Kaedan Korczak,D,VGK,23,49,3,15,18
87,8482245,Artem Zub,D,OTT,29,71,3,15,18
87,8479639,Dylan Coghlan,D,WPG,26,52,2,16,18
87,8478840,Will Borgen,D,SEA,28,64,2,16,18
87,8476525,Colin Miller,D,WPG,32,58,2,16,18
87,8481059,Scott Perunovich,D,STL,26,65,2,16,18
87,8478831,Kevin Stenlund,C,UTA,28,55,11,6,17
87,8480003,Jesper Boqvist,C,FLA,26,70,10,7,17
87,8480025,MacKenzie Entwistle,R,FLA,25,61,10,7,17
87,8478043,Sam Lafferty,C,BUF,29,59,8,9,17
87,8473453,Trevor Lewis,C,LAK,37,73,8,9,17
87,8482749,Joshua Roy,R,MTL,21,55,6,11,17
87,8480448,Parker Kelly,L,COL,25,75,6,11,17
87,8480806,Isac Lundestrom,C,ANA,25,57,6,11,17
87,8478569,Noel Acciari,C,PIT,33,55,6,11,17
87,8480074,Alexandre Texier,C,STL,25,51,5,12,17
87,8478585,Derek Ryan,C,EDM,38,66,5,12,17
87,8474034,Patrick Maroon,L,CHI,36,53,5,12,17
87,8475842,Sam Carrick,C,NYR,32,65,4,13,17
87,8478507,John Marino,D,UTA,27,65,3,14,17
87,8479324,Ryan Lindgren,D,NYR,26,61,2,15,17
87,8475181,Nick Leddy,D,STL,33,64,1,16,17
87,8482192,Isaak Phillips,D,CHI,23,57,0,17,17
87,8478421,A.J. Greer,L,FLA,28,65,12,4,16
87,8479336,Carl Grundstrom,R,SJS,27,61,11,5,16
87,8481641,Joel Kiviranta,L,COL,28,72,9,7,16
87,8479390,Taylor Raddysh,R,WSH,26,60,8,8,16
87,8479315,Joey Anderson,R,CHI,26,45,7,9,16
87,8476873,Mark Jankowski,C,NSH,30,50,7,9,16
87,8479291,Kevin Rooney,C,CGY,31,48,7,9,16
87,8483468,Jiri Kulich,C,BUF,20,60,6,10,16
87,8474567,Zach Bogosian,D,MIN,34,64,6,10,16
87,8479344,Jesse Puljujarvi,R,PIT,26,56,5,11,16
87,8479414,Nathan Bastian,R,NJD,27,56,5,11,16
87,8478468,Jeremy Lauzon,D,NSH,27,53,5,11,16
87,8475177,Calvin de Haan,D,COL,33,47,4,12,16
87,8475324,Nick Jensen,D,OTT,34,73,3,13,16
87,8475790,Erik Gudbranson,D,CBJ,32,75,3,13,16
87,8475188,Brayden McNabb,D,VGK,33,62,3,13,16
87,8480796,Martin Fehervary,D,WSH,25,53,3,13,16
87,8482496,Nils Aman,C,VAN,24,43,10,5,15
87,8477446,Michael McCarron,R,NSH,29,60,9,6,15
87,8480021,Jack Studnicka,C,LAK,25,60,8,7,15
87,8475225,Craig Smith,C,CHI,35,57,8,7,15
87,8480192,Johnathan Kovacevic,D,NJD,27,50,6,9,15
87,8481477,Nico Sturm,C,SJS,29,48,5,10,15
87,8480246,Nick Perbix,D,TBL,26,77,4,11,15
87,8475690,Chris Tanev,D,TOR,35,62,3,12,15
87,8480073,Erik Brannstrom,D,COL,25,59,2,13,15
87,8480860,Kevin Bahl,D,CGY,24,58,2,13,15
87,8479372,Joshua Mahura,D,SEA,26,49,2,13,15
87,8479980,Nicolas Hague,D,VGK,26,50,1,14,15
87,8476429,Scott Mayfield,D,NYI,32,76,1,14,15
87,8475455,Brenden Dillon,D,NJD,34,63,1,14,15
87,8480879,Jacob Bernard-Docker,D,OTT,24,49,1,14,15
87,8482157,Will Cuylle,L,NYR,22,56,10,4,14
87,8482784,Zach Dean,C,STL,21,40,9,5,14
87,8480011,Klim Kostin,C,SJS,25,46,7,7,14
87,8476822,Luke Glendening,C,TBL,35,80,7,7,14
87,8480845,Rasmus Kupari,C,WPG,24,40,7,7,14
87,8480891,Michael Kesselring,D,UTA,24,62,6,8,14
87,8479439,Jacob MacDonald,D,COL,31,47,6,8,14
87,8479671,Mathieu Olivier,R,CBJ,27,45,6,8,14
87,8478452,Caleb Jones,D,LAK,27,51,6,8,14
87,8476913,Devin Shore,C,MIN,30,41,6,8,14
87,8477369,Carson Soucy,D,VAN,30,63,5,9,14
87,8477887,Patrick Brown,C,BOS,32,50,5,9,14
87,8482073,Braden Schneider,D,NYR,23,60,5,9,14
87,8482634,Alex Steeves,C,TOR,25,45,4,10,14
87,8479371,Dante Fabbro,D,NSH,26,57,4,10,14
87,8479398,Samuel Girard,D,COL,26,65,3,11,14
87,8470600,Ryan Suter,D,STL,39,63,3,11,14
87,8478178,Darren Raddysh,D,TBL,28,72,3,11,14
87,8483482,Tristan Luneau,D,ANA,20,55,2,12,14
87,8478859,Niko Mikkola,D,FLA,28,57,1,13,14
87,8483460,David Jiricek,D,CBJ,21,63,1,13,14
87,8474574,Tyler Myers,D,VAN,34,68,0,14,14
87,8484254,Akito Hirose,D,VAN,25,45,0,14,14
87,8482145,Mavrik Bourque,C,DAL,22,43,7,6,13
87,8481701,Santeri Hatakka,D,NJD,23,42,6,7,13
87,8481708,Zac Jones,D,NYR,24,50,4,9,13
87,8477070,Liam O'Brien,C,UTA,30,50,3,10,13
87,8476624,Barclay Goodrow,C,SJS,31,54,3,10,13
87,8477931,Tomas Nosek,L,FLA,32,55,3,10,13
87,8477482,Zachary Sanford,L,CHI,30,43,3,10,13
87,8475462,Radko Gudas,D,ANA,34,64,2,11,13
87,8481178,Egor Zamula,D,PHI,24,56,1,12,13
87,8481592,Jakob Pelletier,L,CGY,23,37,1,12,13
87,8482762,Simon Edvinsson,D,DET,21,50,8,4,12
87,8483493,Frank Nazar,C,CHI,20,51,6,6,12
87,8479972,Mason Shaw,C,WPG,26,39,6,6,12
87,8482803,Olen Zellweger,D,ANA,21,66,6,6,12
87,8480441,Trey Fix-Wolansky,R,CBJ,25,37,6,6,12
87,8477903,Garnet Hathaway,R,PHI,33,68,5,7,12
87,8477573,Nathan Walker,L,STL,30,51,5,7,12
87,8483495,Simon Nemec,D,NJD,20,59,4,8,12
87,8481517,Brett Leason,R,ANA,25,61,4,8,12
87,8479359,Beck Malenstyn,L,BUF,26,46,4,8,12
87,8482861,Vincent Iorio,D,WSH,22,43,4,8,12
87,8482807,Ethan Del Mastro,D,CHI,21,46,3,9,12
87,8480172,Jan Rutta,D,SJS,34,67,3,9,12
87,8478399,Jonas Siegenthaler,D,NJD,27,53,3,9,12
87,8475279,Ben Chiarot,D,DET,33,68,3,9,12
87,8480070,Ian Mitchell,D,BOS,25,54,3,9,12
87,8476967,Brett Kulak,D,EDM,30,66,1,11,12
87,8475750,Jon Merrill,D,MIN,32,67,1,11,12
87,8477335,Kyle Burroughs,D,LAK,29,50,1,11,12
87,8482155,Alex Laferriere,R,LAK,23,61,8,3,11
87,8476934,Brock McGinn,L,ANA,30,49,6,5,11
87,8478443,Brandon Carlo,D,BOS,28,56,5,6,11
87,8477962,Brendan Lemieux,L,CAR,28,46,5,6,11
87,8476988,Matt Benning,D,SJS,30,68,4,7,11
87,8479442,Troy Stecher,D,EDM,30,47,4,7,11
87,8477938,Haydn Fleury,D,WPG,28,53,3,8,11
87,8476994,Vinnie Hinostroza,C,NSH,30,42,2,9,11
87,8479378,Logan Stanley,D,WPG,26,43,2,9,11
87,8481167,Brayden Pachal,D,CGY,25,38,2,9,11
87,8474013,Ian Cole,D,UTA,35,55,1,10,11
87,8479543,Michael Pezzetta,L,MTL,26,52,1,10,11
87,8481789,Tye Kartye,L,SEA,23,34,8,2,10
87,8477353,Tyler Motte,C,DET,29,67,6,4,10
87,8475958,Michael Sgarbossa,C,WSH,32,33,6,4,10
87,8483397,Marc McLaughlin,C,BOS,25,39,6,4,10
87,8481617,Vasily Podkolzin,R,VAN,23,49,5,5,10
87,8477380,Jonny Brodzinski,C,NYR,31,53,4,6,10
87,8481161,Jake Christiansen,D,CBJ,25,55,4,6,10
87,8479968,Vinni Lettieri,C,BOS,29,46,4,6,10
87,8482166,Shakir Mukhamadullin,D,SJS,22,53,4,6,10
87,8481609,Vladislav Kolyachonok,D,UTA,23,31,4,6,10
87,8483466,Kevin Korchinski,D,CHI,20,49,3,7,10
87,8479536,Axel Jonsson-Fjallby,L,WPG,26,31,3,7,10
87,8482176,Wyatt Kaiser,D,CHI,22,56,2,8,10
87,8484149,Gavin Brindley,C,CBJ,20,52,2,8,10
87,8480834,Ty Emberson,D,SJS,24,35,2,8,10
87,8479348,Kale Clague,D,BUF,26,43,2,8,10
87,8471709,Marc-Edouard Vlasic,D,SJS,37,56,2,8,10
87,8474090,Brendan Smith,D,DAL,35,56,1,9,10
87,8482451,Mikael Pyyhtia,L,CBJ,23,42,1,9,10
87,8476952,Dominic Toninato,C,WPG,30,37,1,9,10
87,8480058,Pierre-Olivier Joseph,D,STL,25,56,1,9,10
87,8477034,Jaycob Megna,D,FLA,32,48,1,9,10
87,8480001,Urho Vaakanainen,D,ANA,25,60,0,10,10
87,8474568,Luke Schenn,D,NSH,35,52,0,10,10
87,8479981,Jonah Gadjovich,L,FLA,26,48,7,2,9
87,8482747,Brennan Othmann,L,NYR,21,43,7,2,9
87,8481518,Nolan Foote,L,NJD,24,30,6,3,9
87,8479994,Jaret Anderson-Dolan,C,WPG,25,29,6,3,9
87,8481532,Alex Turcotte,C,LAK,23,46,5,4,9
87,8482659,Josh Doan,R,UTA,22,49,4,5,9
87,8481537,Nikita Okhotiuk,D,CGY,24,55,4,5,9
87,8483012,Logan Morrison,C,SEA,22,38,4,5,9
87,8479772,Zack MacEwen,R,OTT,28,56,4,5,9
87,8480727,Zach Whitecloud,D,VGK,28,50,3,6,9
87,8477018,Ben Hutton,D,VGK,31,45,3,6,9
87,8476372,Nick Seeler,D,PHI,31,47,3,6,9
87,8479944,Zach Aston-Reese,C,VGK,30,41,2,7,9
87,8481598,Philip Broberg,D,EDM,23,40,2,7,9
87,8477499,Rasmus Ristolainen,D,PHI,30,58,1,8,9
87,8482666,Scott Morrow,D,CAR,22,46,1,8,9
87,8477365,Connor Clifton,D,BUF,29,53,1,8,9
87,8471817,Ryan Reaves,R,TOR,37,56,1,8,9
87,8480157,Calle Rosen,D,COL,30,47,0,9,9
87,8481716,Dmitri Voronkov,L,CBJ,24,43,5,3,8
87,8482652,Walker Duehr,R,CGY,27,38,5,3,8
87,8480252,Cole Guttman,C,CHI,25,40,4,4,8
87,8481599,Victor Soderstrom,D,UTA,23,44,4,4,8
87,8476867,Brendan Gaunce,C,MIN,30,36,4,4,8
87,8480848,Ty Dellandrea,C,SJS,24,32,4,4,8
87,8476858,Phillip Di Giuseppe,L,VAN,31,42,4,4,8
87,8478146,Matthew Highmore,C,OTT,28,33,4,4,8
87,8471677,Jack Johnson,D,CBJ,37,63,3,5,8
87,8475762,Derek Forbort,D,VAN,32,42,3,5,8
87,8480007,Jonas Rondbjerg,R,VGK,25,44,3,5,8
87,8480292,Carson Meyer,R,ANA,27,31,3,5,8
87,8481600,Tobias Bjornfot,D,FLA,23,36,2,6,8
87,8473446,Erik Johnson,D,PHI,36,50,2,6,8
87,8483549,Lucas Condotta,L,MTL,27,31,2,6,8
87,8477244,Chad Ruhwedel,D,NYR,34,40,2,6,8
87,8483763,Maksymilian Szuber,D,UTA,22,24,2,6,8
87,8476874,Olli Maatta,D,DET,30,62,1,7,8
87,8482095,Tyler Kleven,D,OTT,22,35,1,7,8
87,8480950,Ilya Lyubushkin,D,DAL,30,64,1,7,8
87,8478451,Ethan Bear,D,WSH,27,41,1,7,8
87,8481556,John Beecher,C,BOS,23,35,6,1,7
87,8476889,Radek Faksa,C,STL,30,54,4,3,7
87,8482751,Ryan Winterton,C,SEA,21,36,4,3,7
87,8478874,Adam Gaudette,R,OTT,28,34,4,3,7
87,8478409,Anthony Richard,C,PHI,28,33,4,3,7
87,8481751,Lukas Rousek,R,BUF,25,31,3,4,7
87,8480880,Jakub Lauko,C,MIN,24,34,3,4,7
87,8482733,Logan Mailloux,D,MTL,31,27,3,4,7
87,8480870,Bo Groulx,C,NYR,24,38,3,4,7
87,8481550,Adam Beckman,L,NJD,23,47,2,5,7
87,8482744,James Malatesta,L,CBJ,21,38,2,5,7
87,8481567,Henry Thrun,D,SJS,23,53,2,5,7
87,8477073,Kurtis MacDermid,L,NJD,30,31,2,5,7
87,8476441,Joel Edmundson,D,LAK,31,39,1,6,7
87,8482859,Zack Ostapchuk,C,OTT,21,55,0,7,7
87,8479249,Andrew Poturalski,C,SJS,30,34,0,7,7
87,8478424,Jansen Harkins,C,ANA,27,47,5,1,6
87,8479718,Alex Barré-Boulet,C,MTL,27,41,4,2,6
87,8479328,Julien Gauthier,R,NYI,27,60,3,3,6
87,8477384,Joshua Brown,D,EDM,30,39,3,3,6
87,8474612,Travis Hamonic,D,OTT,34,42,3,3,6
87,8484911,Collin Graf,R,SJS,22,36,3,3,6
87,8480887,Jordan Harris,D,MTL,24,53,2,4,6
87,8480245,Olle Lycksell,R,PHI,25,29,2,4,6
87,8482765,Isak Rosen,R,BUF,21,23,2,4,6
87,8478017,Mark Friedman,D,VAN,29,32,2,4,6
87,8482165,Yan Kuznetsov,D,CGY,22,27,2,4,6
87,8474166,Alec Martinez,D,CHI,37,45,1,5,6
87,8479986,Kole Lind,R,DAL,26,49,0,6,6
87,8477467,Gustav Olofsson,D,SEA,30,18,4,1,5
87,8481147,Reese Johnson,C,MIN,26,42,3,2,5
87,8479379,Givani Smith,R,SJS,26,33,3,2,5
87,8478881,Brett Seney,L,CHI,28,11,3,2,5
87,8483512,Matthew Savoie,C,EDM,20,18,3,2,5
87,8480990,Declan Chisholm,D,MIN,24,31,2,3,5
87,8479638,Justin Brazeau,R,BOS,26,32,2,3,5
87,8481754,Nikita Nesterenko,C,ANA,23,32,2,3,5
87,8477541,Dakota Mermis,D,TOR,30,12,2,3,5
87,8475235,Nicolas Deslauriers,L,PHI,33,47,1,4,5
87,8477851,Jordan Oesterle,D,BOS,32,29,1,4,5
87,8478450,Parker Wotherspoon,D,BOS,27,37,1,4,5
87,8482511,Mason Lohrei,D,BOS,23,41,1,4,5
87,8481593,Jayden Struble,D,MTL,23,20,1,4,5
87,8475208,Brian Dumoulin,D,ANA,33,60,0,5,5
87,8478021,William Lagesson,D,DET,28,35,0,5,5
87,8482153,Brendan Brisson,C,VGK,23,31,3,1,4
87,8479991,Jake Leschyshyn,C,NYR,25,25,3,1,4
87,8480032,Shane Bowers,C,NJD,25,12,3,1,4
87,8480851,Akil Thomas,C,LAK,24,22,2,2,4
87,8478454,Noah Juulsen,D,VAN,27,40,2,2,4
87,8481743,Marc Del Gaizo,D,NSH,25,20,2,2,4
87,8481122,Simon Benoit,D,TOR,26,33,2,2,4
87,8480468,James Hamblin,L,EDM,25,21,2,2,4
87,8479367,William Lockwood,R,FLA,26,22,2,2,4
87,8482470,Ilya Solovyov,D,CGY,24,20,2,2,4
87,8482713,Mackie Samoskevich,R,FLA,22,29,1,3,4
87,8481056,Spencer Stastney,D,NSH,24,25,1,3,4
87,8479320,Maxime Lajoie,D,SEA,27,23,1,3,4
87,8482250,Callahan Burke,C,VGK,27,20,1,3,4
87,8477971,Andreas Englund,D,LAK,28,26,1,3,4
87,8481541,Samuel Bolduc,D,NYI,24,27,1,3,4
87,8481006,Tyler Tucker,D,STL,24,14,1,3,4
87,8480196,Jacob Bryson,D,BUF,27,43,0,4,4
87,8483630,Pavol Regenda,L,ANA,25,25,0,4,4
87,8477462,Robert Hagg,D,VGK,29,27,0,4,4
87,8479362,Riley Tufte,L,BOS,26,17,2,1,3
87,8477401,John Hayden,C,SEA,29,31,2,1,3
87,8477473,Justin Bailey,R,SJS,29,26,2,1,3
87,8477993,Justin Kirkland,C,CGY,28,6,2,1,3
87,8483619,Filip Roos,D,OTT,25,35,1,2,3
87,8479985,Cale Fleury,D,SEA,26,28,1,2,3
87,8480890,Jan Jenik,C,OTT,24,28,1,2,3
87,8481543,Nikita Alexandrov,C,STL,24,24,1,2,3
87,8476473,Connor Murphy,D,CHI,31,43,1,2,3
87,8481585,Egor Afanasyev,L,SJS,23,20,1,2,3
87,8482102,Vasily Ponomarev,C,PIT,22,18,1,2,3
87,8482141,Lukas Cormier,D,VGK,22,31,1,2,3
87,8484258,Sam Malinski,D,COL,26,24,1,2,3
87,8480874,Adam Ginning,D,PHI,24,11,1,2,3
87,8484287,Cole McWard,D,VAN,23,11,1,2,3
87,8482964,Arber Xhekaj,D,MTL,23,45,0,3,3
87,8480844,Grigori Denisenko,L,VGK,24,29,0,3,3
87,8481679,Maxence Guenette,D,OTT,23,32,0,3,3
87,8480084,Nick DeSimone,D,NJD,30,20,0,3,3
87,8480267,Sammy Walker,C,MIN,25,16,0,3,3
87,8482177,Marat Khusnutdinov,C,MIN,22,34,2,0,2
87,8482147,Jean-Luc Foudy,C,COL,22,25,2,0,2
87,8482929,Emil Lilleberg,D,TBL,23,21,2,0,2
87,8482460,Matt Rempe,C,NYR,22,10,2,0,2
87,8478051,Max Willman,C,NJD,29,15,2,0,2
87,8484325,Waltteri Merela,C,TBL,26,30,2,0,2
87,8481726,Adam Edstrom,C,NYR,24,8,2,0,2
87,8481065,Angus Crookshank,L,OTT,25,19,1,1,2
87,8479576,Vincent Desharnais,D,VAN,28,33,1,1,2
87,8481206,John Ludvig,D,PIT,24,11,1,1,2
87,8482070,Mitchell Chaffee,R,TBL,26,42,1,1,2
87,8483597,Milos Kelemen,L,UTA,25,12,1,1,2
87,8478477,Mitchell Stephens,C,SEA,27,20,1,1,2
87,8481237,Kyle MacLean,C,NYI,25,20,1,1,2
87,8477320,Anton Blidh,L,NYR,29,11,1,1,2
87,8480075,Cameron Crotty,D,MIN,25,10,1,1,2
87,8481605,Jackson LaCombe,D,ANA,23,39,1,1,2
87,8482162,Roby Jarventie,L,EDM,22,14,1,1,2
87,8482858,Ryker Evans,D,SEA,23,26,0,2,2
87,8479587,Rhett Gardner,C,PHI,28,12,0,2,2
87,8477810,Joel Hanley,D,CGY,33,18,0,2,2
87,8479419,Brett Murray,L,BUF,26,25,0,2,2
87,8478502,Dennis Gilbert,D,BUF,28,18,0,2,2
87,8476323,Max McCormick,L,SEA,32,5,0,2,2
87,8481422,Jake Lucchini,C,NSH,29,17,1,0,1
87,8483570,Ben Meyers,C,SEA,26,27,1,0,1
87,8482172,Landon Slaggert,L,CHI,22,20,1,0,1
87,8482088,Justin Sourdif,R,FLA,22,20,1,0,1
87,8475755,Alexander Petrovic,D,DAL,32,10,1,0,1
87,8481699,Aku Raty,R,UTA,23,12,0,1,1
87,8481719,Maxwell Crozier,D,TBL,24,9,0,1,1
87,8477527,Ross Johnston,L,ANA,30,28,0,1,1
87,8480823,Alexander Alexeyev,D,WSH,25,19,0,1,1
87,8481030,Jack St. Ivany,D,PIT,25,12,0,1,1
87,8482061,Brandon Biro,L,SEA,26,19,0,1,1
87,8474062,Riley Nash,C,NYR,35,21,0,1,1
87,8478446,Glenn Gawdin,C,LAK,27,9,0,1,1
87,8482094,Daemon Hunt,D,MIN,22,19,0,1,1
87,8481564,Ryan Johnson,D,BUF,23,13,0,1,1
87,8482476,Emil Heineman,L,MTL,23,4,0,1,1
87,8475795,Dylan McIlrath,D,WSH,32,14,0,1,1
87,8483489,Fraser Minten,C,TOR,31,10,0,1,1
87,8482516,Matthew Kessel,D,STL,24,21,0,1,1
87,8483407,Brandon Scanlin,D,NYR,25,5,0,1,1
87,8478854,Ryan Shea,D,PIT,27,5,0,1,1
87,8481578,Graeme Clarke,R,MIN,23,5,0,1,1
87,8478147,Bokondji Imama,L,PIT,28,7,0,1,1
87,8482201,Gage Goncalves,C,TBL,23,21,0,0,0
87,8482118,Sam Colangelo,R,ANA,23,18,0,0,0
87,8482144,Jack Thompson,D,SJS,22,20,0,0,0
87,8475413,Justin Dowling,C,NJD,34,16,0,0,0
87,8481043,Cole Koepke,L,BOS,26,10,0,0,0
87,8475780,Chris Wagner,R,COL,33,6,0,0,0
87,8481462,Mason Morelli,L,VGK,28,12,0,0,0
87,8484255,Jason Polin,R,COL,25,5,0,0,0
87,8481655,Cole Schwindt,R,CGY,23,3,0,0,0
87,8479421,Jacob Moverare,D,LAK,26,5,0,0,0
87,8481024,Linus Karlsson,C,VAN,25,8,0,0,0
87,8483401,Marc Johnstone,R,PIT,28,2,0,0,0
87,8483471,Brad Lambert,C,WPG,31,8,0,0,0
87,8481806,Louis Crevier,D,CHI,23,13,0,0,0
87,8479330,Brandon Gignac,C,MTL,27,12,0,0,0
87,8477149,Scott Sabourin,R,SJS,32,8,0,0,0
87,8482126,Emil Andrae,D,PHI,31,3,0,0,0
87,8480306,Grant Hutton,D,NYI,29,2,0,0,0
87,8478011,Louie Belpedio,D,PHI,28,11,0,0,0
87,8484321,Nikolas Matinpalo,D,OTT,26,3,0,0,0
87,8483920,Pierrick Dube,R,WSH,23,2,0,0,0
87,8483395,Arshdeep Bains,L,VAN,23,8,0,0,0
87,8482197,Adam Raska,R,MIN,23,7,0,0,0
87,8483567,Georgii Merkulov,C,BOS,24,8,0,0,0
87,8481534,Raphael Lavoie,C,EDM,24,3,0,0,0
87,8482787,Nikita Chibrikov,R,WPG,31,8,0,0,0
87,8483546,Marshall Rifai,D,TOR,26,2,0,0,0
87,8484304,Uvis Balinskis,D,FLA,28,12,0,0,0
87,8484326,Patrik Koch,D,UTA,28,0,0,0,0
87,8483398,Declan Carlile,D,TBL,31,4,0,0,0
87,8483609,Adam Klapka,R,CGY,24,3,0,0,0
87,8483432,Luca Del Bel Belluz,C,CBJ,31,4,0,0,0
87,8479522,Hardy Haman Aktell,D,WSH,26,3,0,0,0
87,8483531,Brian Halonen,L,NJD,25,3,0,0,0
87,8478956,Samuel Laberge,L,NJD,27,2,0,0,0
87,8480274,Philip Kemp,D,EDM,25,1,0,0,0
87,8484259,Ondrej Pavel,C,COL,31,1,0,0,0
87,8470794,Joe Pavelski,C,,40,0,0,0,0
87,8479321,Lucas Johansen,D,,27,0,0,0,0
87,8477950,Tony DeAngelo,D,,29,0,0,0,0
87,8471218,Blake Wheeler,R,,38,0,0,0,0
87,8475197,Tyson Barrie,D,,33,0,0,0,0
87,8474157,Max Pacioretty,L,,36,0,0,0,0
87,8475744,Evgeny Kuznetsov,C,,32,0,0,0,0
87,8474037,James van Riemsdyk,L,,35,0,0,0,0
87,8476907,Mackenzie MacEachern,L,,30,0,0,0,0
87,8480216,Jacob Peterson,C,,25,0,0,0,0
87,8474602,Justin Schultz,D,,34,0,0,0,0
87,8482222,Alexander Barabanov,L,,30,0,0,0,0
87,8474031,Kevin Shattenkirk,D,,35,0,0,0,0
87,8477330,Dominik Kubalik,L,,29,0,0,0,0
87,8480884,Calen Addison,D,,24,0,0,0,0
87,8475906,John Klingberg,D,,32,0,0,0,0
87,8480008,Adam Ruzicka,C,,25,0,0,0,0
87,8476884,Derrick Pouliot,D,,30,0,0,0,0
87,8476919,Chris Tierney,C,,30,0,0,0,0
87,8479415,Michael McLeod,C,,26,0,0,0,0
87,8474870,Tyler Johnson,C,,34,0,0,0,0
87,8470604,Jeff Carter,C,,39,0,0,0,0
87,8478104,Sammy Blais,L,,28,0,0,0,0
87,8474884,Mike Hoffman,C,,35,0,0,0,0
87,8481591,Sam Poulin,R,,23,0,0,0,0
87,8471274,Alex Goligoski,D,,39,0,0,0,0
87,8476871,Tanner Pearson,L,,32,0,0,0,0
87,8476393,Nick Cousins,C,,31,0,0,0,0
87,8479977,Kailer Yamamoto,R,,26,0,0,0,0
87,8479346,Dillon Dube,C,,26,0,0,0,0
87,8480184,Gustav Lindstrom,D,,26,0,0,0,0
87,8479376,Victor Mete,D,,26,0,0,0,0
87,8473449,Kyle Okposo,R,,36,0,0,0,0
87,8481058,Jesse Ylonen,R,,25,0,0,0,0
87,8475752,Tyler Pitlick,C,,33,0,0,0,0
87,8481239,Samuel Fagemo,L,,24,0,0,0,0
87,8480821,Filip Zadina,R,,25,0,0,0,0
87,8470966,Mark Giordano,D,,41,0,0,0,0
87,8478495,Denis Gurianov,R,,27,0,0,0,0
87,8477464,Nic Petan,C,,29,0,0,0,0
87,8478099,Kevin Labanc,R,,29,0,0,0,0
87,8482241,Radim Zohorna,L,,28,0,0,0,0
87,8474040,Sam Gagner,C,,35,0,0,0,0
87,8479514,Rem Pitlick,C,,27,0,0,0,0
87,8478430,Oliver Kylington,D,,27,0,0,0,0
87,8479533,Joona Koppanen,L,,26,0,0,0,0
87,8479984,Cal Foote,D,,26,0,0,0,0
87,8477126,Jayson Megna,C,,34,0,0,0,0
87,8475164,Jakob Silfverberg,R,,34,0,0,0,0
87,8474009,Nick Bonino,C,,36,0,0,0,0
87,8479458,Nikita Zaitsev,D,,33,0,0,0,0
87,8477944,Jakub Vrana,L,,28,0,0,0,0
87,8471699,Andrew Cogliano,C,,37,0,0,0,0
87,8478067,Oskar Lindblom,L,,28,0,0,0,0
87,8471686,Marc Staal,D,,37,0,0,0,0
87,8470610,Zach Parise,L,,40,0,0,0,0
87,8478904,Steven Lorentz,C,,28,0,0,0,0
87,8473473,Milan Lucic,L,,36,0,0,0,0
87,8480031,Maxime Comtois,L,,25,0,0,0,0
87,8478512,Austin Czarnik,C,,32,0,0,0,0
87,8473504,Cal Clutterbuck,R,,37,0,0,0,0
87,8477454,Adam Erne,L,,29,0,0,0,0
87,8479383,Boris Katchouk,L,,26,0,0,0,0
87,8475825,Jani Hakanpää,D,,32,0,0,0,0
87,8477846,Ryan Carpenter,C,,33,0,0,0,0
87,8477930,Pierre-Edouard Bellemare,L,,39,0,0,0,0
87,8478400,Colin White,C,,27,0,0,0,0
87,8480226,Marián Studenic,R,,26,0,0,0,0
87,8480853,Liam Foudy,C,,24,0,0,0,0
87,8475797,Jarred Tinordi,D,,32,0,0,0,0
87,8479423,Alex Nylander,L,,26,0,0,0,0
87,8474618,Marco Scandella,D,,34,0,0,0,0
87,8478028,Fredrik Olofsson,L,,28,0,0,0,0
87,8474709,Matt Martin,L,,35,0,0,0,0
87,8481070,Hugh McGing,L,,26,0,0,0,0
87,8479546,Oskar Steen,C,,26,0,0,0,0
87,8474145,Robert Bortuzzo,D,,35,0,0,0,0
87,8476915,Jujhar Khaira,L,,30,0,0,0,0
87,8475278,Byron Froese,C,,33,0,0,0,0
87,8481812,Nikolai Knyzhov,D,,27,0,0,0,0
87,8478408,Travis Dermott,D,,28,0,0,0,0
87,8481077,John Leonard,L,,26,0,0,0,0
87,8479547,Matthew Phillips,R,,26,0,0,0,0
87,8480836,Jonathan Gruden,C,,24,0,0,0,0
87,8481690,Tyler Angle,C,,24,0,0,0,0
87,8475766,Austin Watson,L,,32,0,0,0,0
87,8481016,Ruslan Iskhakov,C,,24,0,0,0,0
87,8478078,Rourke Chartier,C,,28,0,0,0,0
87,8480776,Sheldon Rempal,R,,29,0,0,0,0
87,8483045,Cameron Butler,R,CBJ,31,2,0,0,0
87,8484314,Jiri Smejkal,L,,28,0,0,0,0
88,8477492,Nathan MacKinnon,C,COL,29,82,59,87,146
88,8476453,Nikita Kucherov,R,TBL,31,81,44,90,134
88,8478402,Connor McDavid,C,EDM,27,76,25,100,125
88,8479318,Auston Matthews,C,TOR,27,78,74,45,119
88,8478420,Mikko Rantanen,R,COL,28,81,50,67,117
88,8479407,Jesper Bratt,L,NJD,26,76,44,73,117
88,8477956,David Pastrnak,R,BOS,28,81,48,65,113
88,8477934,Leon Draisaitl,C,EDM,29,78,47,63,110
88,8476887,Filip Forsberg,L,NSH,30,78,54,54,108
88,8481559,Jack Hughes,C,NJD,23,76,42,66,108
88,8478864,Kirill Kaprizov,L,MIN,27,71,47,60,107
88,8476468,J.T. Miller,C,VAN,31,77,38,68,106
88,8477939,William Nylander,R,TOR,28,79,44,61,105
88,8478550,Artemi Panarin,L,NYR,33,76,39,66,105
88,8479314,Matthew Tkachuk,L,FLA,27,79,35,69,104
88,8478483,Mitch Marner,R,TOR,27,81,30,74,104
88,8477942,Kevin Fiala,L,LAK,28,81,28,70,98
88,8480801,Brady Tkachuk,L,OTT,25,80,41,54,95
88,8480027,Jason Robertson,L,DAL,25,82,34,61,95
88,8474564,Steven Stamkos,C,NSH,34,73,44,50,94
88,8478403,Jack Eichel,C,VGK,28,79,40,54,94
88,8482116,Tim Stützle,C,OTT,22,80,34,59,93
88,8471675,Sidney Crosby,C,PIT,37,74,41,48,89
88,8480002,Nico Hischier,C,NJD,25,74,32,57,89
88,8475913,Mark Stone,R,VGK,32,80,35,52,87
88,8477951,Nick Schmaltz,C,UTA,28,79,25,62,87
88,8477404,Jake Guentzel,C,TBL,30,82,33,53,86
88,8477493,Aleksander Barkov,C,FLA,29,81,26,60,86
88,8481557,Matt Boldy,L,MIN,23,75,40,45,85
88,8474600,Roman Josi,D,NSH,34,77,23,61,84
88,8479385,Jordan Kyrou,C,STL,26,78,37,46,83
88,8475692,Mats Zuccarello,R,MIN,37,77,17,66,83
88,8477960,Adrian Kempe,R,LAK,28,81,38,44,82
88,8480069,Cale Makar,D,COL,26,70,27,55,82
88,8480023,Robert Thomas,C,STL,25,72,22,60,82
88,8477501,Valeri Nichushkin,R,COL,29,82,45,36,81
88,8477409,Carter Verhaeghe,C,FLA,29,80,40,41,81
88,8473419,Brad Marchand,L,BOS,36,81,36,45,81
88,8480830,Andrei Svechnikov,R,CAR,24,76,33,48,81
88,8471214,Alex Ovechkin,L,WSH,39,75,39,41,80
88,8484144,Connor Bedard,C,CHI,19,72,27,53,80
88,8478445,Mathew Barzal,C,NYI,27,82,26,54,80
88,8478398,Kyle Connor,L,WPG,28,72,38,41,79
88,8476389,Vincent Trocheck,C,NYR,31,77,35,44,79
88,8480800,Quinn Hughes,D,VAN,25,76,6,73,79
88,8480208,Drake Batherson,R,OTT,26,81,37,41,78
88,8475166,John Tavares,C,TOR,34,80,33,45,78
88,8480012,Elias Pettersson,C,VAN,26,77,31,47,78
88,8480839,Rasmus Dahlin,D,BUF,24,74,18,60,78
88,8475167,Victor Hedman,D,TBL,34,81,16,62,78
88,8479343,Clayton Keller,R,UTA,26,81,32,45,77
88,8478010,Brayden Point,C,TBL,28,82,45,31,76
88,8480018,Nick Suzuki,C,MTL,25,75,31,45,76
88,8475754,Brock Nelson,C,NYI,33,81,31,44,75
88,8476454,Ryan Nugent-Hopkins,C,EDM,31,74,27,48,75
88,8477500,Bo Horvat,C,NYI,29,77,36,38,74
88,8479542,Brandon Hagel,L,TBL,26,81,35,39,74
88,8477402,Pavel Buchnevich,L,STL,29,70,29,45,74
88,8477933,Sam Reinhart,C,FLA,29,76,34,39,73
88,8479675,Trevor Moore,L,LAK,29,81,34,39,73
88,8475172,Nazem Kadri,C,CGY,34,76,27,46,73
88,8477949,Alex Tuch,R,BUF,28,73,26,47,73
88,8476346,Johnny Gaudreau,L,CBJ,31,69,16,55,71
88,8478449,Roope Hintz,C,DAL,28,82,34,36,70
88,8477940,Nikolaj Ehlers,L,WPG,28,75,28,42,70
88,8473994,Jamie Benn,L,DAL,35,82,27,43,70
88,8474141,Patrick Kane,R,DET,36,81,26,44,70
88,8475798,Mikael Granlund,C,SJS,32,73,18,52,70
88,8479323,Adam Fox,D,NYR,26,73,10,60,70
88,8478414,Timo Meier,R,NJD,28,72,37,32,69
88,8476539,Jonathan Marchessault,R,NSH,34,75,37,32,69
88,8479420,Tage Thompson,C,BUF,27,70,36,33,69
88,8478444,Brock Boeser,R,VAN,27,77,33,36,69
88,8476460,Mark Scheifele,C,WPG,31,75,31,37,68
88,8475170,Brayden Schenn,C,STL,33,70,28,40,68
88,8482093,Seth Jarvis,C,CAR,22,76,34,33,67
88,8475786,Zach Hyman,L,EDM,32,80,30,37,67
88,8475158,Ryan O'Reilly,C,NSH,33,75,23,44,67
88,8474679,Gustav Nyquist,C,NSH,35,67,22,45,67
88,8480803,Evan Bouchard,D,EDM,25,79,16,51,67
88,8480036,Miro Heiskanen,D,DAL,25,77,13,54,67
88,8471724,Kris Letang,D,PIT,37,81,10,57,67
88,8481540,Cole Caufield,R,MTL,23,76,30,36,66
88,8475810,Bryan Rust,R,PIT,32,70,28,38,66
88,8475184,Chris Kreider,L,NYR,33,75,38,27,65
88,8471685,Anze Kopitar,C,LAK,37,81,25,40,65
88,8475765,Vladimir Tarasenko,R,DET,33,82,23,42,65
88,8477946,Dylan Larkin,C,DET,28,79,31,33,64
88,8477407,Anthony Duclair,L,NYI,29,79,30,34,64
88,8482078,Lucas Raymond,L,DET,22,80,24,40,64
88,8477416,Oliver Bjorkstrand,R,SEA,29,72,26,37,63
88,8476459,Mika Zibanejad,C,NYR,31,75,25,38,63
88,8478427,Sebastian Aho,C,CAR,27,69,22,41,63
88,8478460,Zach Werenski,D,CBJ,27,79,15,48,63
88,8473512,Claude Giroux,R,OTT,36,78,29,33,62
88,8478047,Michael Bunting,L,PIT,29,76,33,28,61
88,8482699,Dylan Guenther,R,UTA,21,75,30,31,61
88,8478873,Troy Terry,R,ANA,27,73,27,34,61
88,8478493,Joel Eriksson Ek,C,MIN,27,67,27,34,61
88,8477504,Josh Morrissey,D,WPG,29,76,13,48,61
88,8474590,John Carlson,D,WSH,34,69,13,48,61
88,8478407,Vince Dunn,D,SEA,28,70,14,46,60
88,8478469,Thomas Chabot,D,OTT,27,78,12,48,60
88,8475784,Jeff Skinner,C,EDM,32,79,35,24,59
88,8482740,Wyatt Johnston,C,DAL,21,82,32,27,59
88,8477955,Jared McCann,L,SEA,28,73,29,30,59
88,8478975,Mason Marchment,L,DAL,29,82,24,35,59
88,8479999,Casey Mittelstadt,C,COL,26,81,21,38,59
88,8477496,Elias Lindholm,C,BOS,30,81,18,41,59
88,8476399,Blake Coleman,C,CGY,33,77,32,26,58
88,8475191,Reilly Smith,R,NYR,33,74,23,35,58
88,8482684,Luke Hughes,D,NJD,21,70,14,44,58
88,8476881,Tomas Hertl,C,VGK,31,74,23,34,57
88,8475169,Evander Kane,L,EDM,33,75,29,27,56
88,8475168,Matt Duchene,C,DAL,33,82,15,41,56
88,8477497,Sean Monahan,C,CBJ,30,72,33,22,55
88,8479400,Pierre-Luc Dubois,L,WSH,26,68,26,29,55
88,8474102,David Perron,L,OTT,36,80,23,32,55
88,8478440,Dylan Strome,C,WSH,27,70,21,34,55
88,8482113,Anton Lundell,C,FLA,23,78,20,35,55
88,8476875,Mike Matheson,D,MTL,30,73,18,37,55
88,8476905,Chandler Stephenson,C,SEA,30,73,17,38,55
88,8478856,Conor Garland,R,VAN,28,77,22,32,54
88,8475794,Tyler Seguin,C,DAL,32,80,21,33,54
88,8481528,Dylan Cozens,C,BUF,23,67,21,33,54
88,8478439,Travis Konecny,R,PHI,27,76,20,34,54
88,8471215,Evgeni Malkin,C,PIT,38,74,18,36,54
88,8477476,Artturi Lehkonen,L,COL,29,81,18,36,54
88,8483515,Juraj Slafkovsky,L,MTL,20,76,17,37,54
88,8474578,Erik Karlsson,D,PIT,34,75,17,37,54
88,8473986,Alex Killorn,L,ANA,35,76,15,39,54
88,8475726,Tyler Toffoli,C,SJS,32,70,25,28,53
88,8478519,Anthony Cirelli,C,TBL,27,81,24,29,53
88,8476448,William Karlsson,C,VGK,31,77,20,33,53
88,8484145,Zach Benson,L,BUF,19,72,20,33,53
88,8477932,Aaron Ekblad,D,FLA,28,71,18,35,53
88,8482665,Matty Beniers,C,SEA,22,72,16,37,53
88,8477495,Seth Jones,D,CHI,30,72,13,40,53
88,8482159,Tyson Foerster,R,PHI,22,75,23,29,52
88,8480015,Owen Tippett,R,PHI,25,74,22,30,52
88,8478401,Pavel Zacha,C,BOS,27,80,22,30,52
88,8477935,Sam Bennett,C,FLA,28,76,21,31,52
88,8474586,Jordan Eberle,R,SEA,34,73,18,34,52
88,8480797,Joel Farabee,L,PHI,24,74,18,34,52
88,8476853,Morgan Rielly,D,TOR,30,75,13,39,52
88,8480865,Noah Dobson,D,NYI,24,78,11,41,52
88,8476869,Brady Skjei,D,NSH,30,68,13,38,51
88,8476906,Shayne Gostisbehere,D,CAR,31,76,10,41,51
88,8482109,Alexis Lafrenière,L,NYR,23,74,28,22,50
88,8477998,Warren Foegele,L,LAK,28,81,22,28,50
88,8478466,Daniel Sprong,R,VAN,27,66,18,32,50
88,8483808,Andrei Kuzmenko,L,CGY,28,74,31,18,49
88,8482055,Drew O'Connor,L,PIT,26,66,25,24,49
88,8478115,Pierre Engvall,L,NYI,28,78,22,27,49
88,8482667,William Eklund,L,SJS,22,63,19,30,49
88,8481533,Trevor Zegras,C,ANA,23,74,18,31,49
88,8476474,Stefan Noesen,R,NJD,31,71,18,31,49
88,8476456,Jonathan Huberdeau,C,CGY,31,73,13,36,49
88,8477494,Jonathan Drouin,L,COL,29,79,12,37,49
88,8475753,Justin Faulk,D,STL,32,76,10,39,49
88,8478498,Jake DeBrusk,L,VAN,28,73,26,22,48
88,8479337,Alex DeBrincat,R,DET,27,78,18,30,48
88,8476872,Scott Laughton,C,PHI,30,76,17,31,48
88,8481711,Matias Maccelli,L,UTA,24,77,13,35,48
88,8479325,Charlie McAvoy,D,BOS,27,70,12,36,48
88,8480014,Gabriel Vilardi,C,WPG,25,74,31,16,47
88,8482124,Quinton Byfield,R,LAK,22,80,21,26,47
88,8475745,Charlie Coyle,C,BOS,32,78,18,29,47
88,8476479,Phillip Danault,C,LAK,31,79,16,31,47
88,8482092,Ridly Greig,C,OTT,22,76,15,32,47
88,8478438,Tommy Novak,C,NSH,27,67,11,36,47
88,8479345,Jakob Chychrun,D,WSH,26,63,11,36,47
88,8474565,Alex Pietrangelo,D,VGK,34,64,10,37,47
88,8475151,Kyle Palmieri,C,NYI,33,78,28,18,46
88,8484166,Adam Fantilli,C,CBJ,20,71,20,26,46
88,8474150,Mikael Backlund,C,CGY,35,76,18,28,46
88,8482149,Cole Perfetti,C,WPG,22,71,18,28,46
88,8481577,Philip Tomasino,C,NSH,23,67,13,33,46
88,8477447,Shea Theodore,D,VGK,29,59,9,37,46
88,8477503,Max Domi,C,TOR,29,78,8,38,46
88,8474563,Drew Doughty,D,LAK,35,75,6,40,46
88,8477451,Ryan Hartman,R,MIN,30,65,23,22,45
88,8475314,Anders Lee,L,NYI,34,76,21,24,45
88,8475287,Erik Haula,L,NJD,33,71,18,27,45
88,8478542,Evan Rodrigues,C,FLA,31,75,15,30,45
88,8480039,Martin Necas,C,CAR,25,72,18,26,44
88,8477964,Ivan Barbashev,C,VGK,29,72,18,26,44
88,8482745,Mason McTavish,C,ANA,21,74,16,28,44
88,8470613,Brent Burns,D,CAR,39,74,13,31,44
88,8482671,Owen Power,D,BUF,22,74,11,33,44
88,8478397,Rasmus Andersson,D,CGY,28,71,5,39,44
88,8480064,Josh Norris,C,OTT,25,77,25,18,43
88,8477456,J.T. Compher,L,DET,29,81,23,20,43
88,8475760,Nick Bjugstad,C,UTA,32,69,23,20,43
88,8480188,Fabian Zetterlund,L,SJS,25,65,22,21,43
88,8476880,Tom Wilson,R,WSH,30,70,19,24,43
88,8482720,Matthew Knies,L,TOR,22,74,13,30,43
88,8477986,Brandon Montour,D,SEA,30,73,12,31,43
88,8481523,Kirby Dach,C,MTL,23,70,11,32,43
88,8484153,Leo Carlsson,C,ANA,20,75,21,21,42
88,8481560,Arthur Kaliyev,R,LAK,23,77,20,22,42
88,8478396,Noah Hanifin,D,VGK,27,64,10,32,42
88,8476854,Hampus Lindholm,D,BOS,30,75,7,35,42
88,8474641,Adam Henrique,C,EDM,34,77,25,16,41
88,8478366,Frank Vatrano,R,ANA,30,71,24,17,41
88,8476483,Rickard Rakell,R,PIT,31,73,23,18,41
88,8480009,Eeli Tolvanen,R,SEA,25,77,22,19,41
88,8475714,Calle Jarnkrok,C,TOR,33,75,20,21,41
88,8481596,Shane Pinto,C,OTT,24,76,19,22,41
88,8478474,Lawson Crouse,L,UTA,27,75,18,23,41
88,8481618,Alex Newhook,C,MTL,23,76,18,23,41
88,8475768,Jaden Schwartz,C,SEA,32,74,17,24,41
88,8476882,Teuvo Teravainen,C,CHI,30,66,15,26,41
88,8481656,Aliaksei Protas,C,WSH,23,71,11,30,41
88,8475793,Ryan Johansen,C,PHI,32,76,21,19,40
88,8482110,Dawson Mercer,C,NJD,23,70,18,22,40
88,8471698,T.J. Oshie,R,WSH,38,66,17,23,40
88,8477021,Alex Kerfoot,C,UTA,30,71,12,28,40
88,8479525,Ross Colton,C,COL,28,78,19,20,39
88,8481068,Yegor Sharangovich,C,CGY,26,79,15,24,39
88,8476826,Yanni Gourde,C,SEA,33,66,14,25,39
88,8477953,Kasperi Kapanen,R,STL,28,71,14,25,39
88,8476925,Colton Sissons,C,NSH,31,71,14,25,39
88,8477444,Andre Burakovsky,L,SEA,29,67,13,26,39
88,8475763,Kevin Hayes,R,PIT,32,60,13,26,39
88,8479339,Patrik Laine,L,CBJ,26,67,17,21,38
88,8480798,Philipp Kurashev,C,CHI,25,64,15,23,38
88,8477479,Tyler Bertuzzi,L,CHI,29,65,14,24,38
88,8476419,Jean-Gabriel Pageau,C,NYI,32,80,13,25,38
88,8476462,Dougie Hamilton,D,NJD,31,72,10,28,38
88,8482712,Oskar Olausson,R,COL,22,78,4,34,38
88,8479992,Michael Rasmussen,C,DET,25,77,20,17,37
88,8481524,Bowen Byram,D,BUF,23,67,17,20,37
88,8480028,Morgan Frost,C,PHI,25,79,17,20,37
88,8479591,Michael Eyssimont,C,TBL,28,82,15,22,37
88,8474149,Evgenii Dadonov,R,DAL,35,78,13,24,37
88,8476792,Torey Krug,D,STL,33,68,10,27,37
88,8477948,Travis Sanheim,D,PHI,28,71,4,33,37
88,8480459,Pius Suter,C,VAN,28,67,20,16,36
88,8477426,Nicholas Paul,L,TBL,29,81,19,17,36
88,8482175,JJ Peterka,R,BUF,22,67,17,19,36
88,8475848,Brendan Gallagher,R,MTL,32,73,16,20,36
88,8477952,Robby Fabbri,C,ANA,28,73,15,21,36
88,8482705,Cole Sillinger,C,CBJ,21,68,13,23,36
88,8478462,Nicolas Roy,C,VGK,27,72,11,25,36
88,8479425,Filip Hronek,D,VAN,27,71,10,26,36
88,8478055,Gustav Forsling,D,FLA,28,73,9,27,36
88,8479410,Mikhail Sergachev,D,UTA,26,72,9,27,36
88,8477969,Marcus Pettersson,D,PIT,28,78,9,27,36
88,8477488,Brett Pesce,D,NJD,30,72,9,27,36
88,8477947,Sonny Milano,L,WSH,28,65,18,17,35
88,8477987,Ryan Donato,C,CHI,28,57,16,19,35
88,8479661,Tanner Jeannot,L,LAK,27,73,15,20,35
88,8482097,Jack Quinn,R,BUF,23,61,14,21,35
88,8478046,Danton Heinen,L,VAN,29,69,12,23,35
88,8477429,Andrew Copp,C,DET,30,80,8,27,35
88,8482122,Brock Faber,D,MIN,22,79,8,27,35
88,8476292,Ondrej Palat,L,NJD,33,74,8,27,35
88,8478038,Devon Toews,D,COL,30,75,7,28,35
88,8477435,Ryan Graves,D,PIT,29,78,5,30,35
88,8482089,Jake Neighbours,L,STL,22,63,22,12,34
88,8481604,Pavel Dorofeyev,L,VGK,24,66,17,17,34
88,8476278,Colin Blackwell,C,DAL,31,78,15,19,34
88,8479365,Trent Frederic,C,BOS,26,77,14,20,34
88,8477989,Christian Dvorak,C,MTL,28,65,14,20,34
88,8483431,Logan Cooley,C,UTA,20,73,13,21,34
88,8478233,Andrew Mangiapane,L,WSH,28,61,13,21,34
88,8484203,Bradly Nadeau,L,CAR,19,65,13,21,34
88,8480185,Eetu Luostarinen,C,FLA,26,77,12,22,34
88,8482133,Thomas Bordeleau,C,SJS,22,68,12,22,34
88,8475218,Mattias Ekholm,D,EDM,34,73,7,27,34
88,8482702,Logan Stankoven,C,DAL,21,81,20,13,33
88,8480068,Ryan Poehling,C,PHI,25,67,18,15,33
88,8481186,Logan O'Connor,R,COL,28,80,17,16,33
88,8475722,Jason Zucker,L,BUF,32,66,17,16,33
88,8480748,Kiefer Sherwood,L,VAN,29,59,16,17,33
88,8482146,Luke Evangelista,R,NSH,22,68,16,17,33
88,8474715,Cameron Atkinson,R,TBL,35,81,15,18,33
88,8480871,Adam Boqvist,D,FLA,24,72,14,19,33
88,8476921,Jordan Martinook,L,CAR,32,69,14,19,33
88,8476480,Vladislav Namestnikov,C,WPG,32,69,13,20,33
88,8478891,Mason Appleton,C,WPG,28,66,12,21,33
88,8478458,John (Jack) Roslovic,C,CAR,27,65,11,22,33
88,8481542,Moritz Seider,D,DET,23,75,6,27,33
88,8481606,Jordan Spence,D,LAK,23,66,6,27,33
88,8474151,Ryan McDonagh,D,TBL,35,76,6,27,33
88,8480849,Barrett Hayton,C,UTA,24,73,18,14,32
88,8476432,Boone Jenner,C,CBJ,31,67,17,15,32
88,8475799,Nino Niederreiter,R,WPG,32,63,17,15,32
88,8479996,Cody Glass,C,NSH,25,62,16,16,32
88,8480113,Alex Iafallo,L,WPG,31,61,14,18,32
88,8478042,Viktor Arvidsson,L,EDM,31,72,13,19,32
88,8481535,Nils Hoglander,L,VAN,24,69,13,19,32
88,8480078,Filip Chytil,C,NYR,25,66,12,20,32
88,8479393,Noah Gregor,L,OTT,26,73,11,21,32
88,8478133,Jake Evans,C,MTL,28,72,8,24,32
88,8474053,Logan Couture,C,SJS,35,57,7,25,32
88,8475764,Cam Fowler,D,ANA,33,75,5,27,32
88,8483524,Shane Wright,C,SEA,20,63,18,13,31
88,8477511,Anthony Mantha,R,CGY,30,77,16,15,31
88,8474189,Lars Eller,C,PIT,35,60,13,18,31
88,8478472,Mathieu Joseph,R,STL,27,68,9,22,31
88,8475200,Dmitry Orlov,D,CAR,33,74,9,22,31
88,8476885,Jacob Trouba,D,NYR,30,68,7,24,31
88,8481554,Kaapo Kakko,R,NYR,23,69,21,9,30
88,8477425,Miles Wood,L,COL,29,80,20,10,30
88,8480829,Jesperi Kotkaniemi,C,CAR,24,65,16,14,30
88,8475149,Marcus Johansson,L,MIN,34,65,13,17,30
88,8482101,Danil Gushchin,L,SJS,22,64,13,17,30
88,8478413,Jordan Greenway,L,BUF,27,62,12,18,30
88,8478013,Jake Walman,D,SJS,28,72,11,19,30
88,8477346,MacKenzie Weegar,D,CGY,30,74,10,20,30
88,8483505,Matthew Poitras,C,BOS,20,75,9,21,30
88,8479402,Jake Bean,D,CGY,26,68,2,28,30
88,8476438,Brandon Saad,L,STL,32,72,17,12,29
88,8475193,Tomas Tatar,L,NJD,34,66,15,14,29
88,8473533,Jordan Staal,C,CAR,36,63,14,15,29
88,8479293,Brandon Tanev,L,SEA,33,64,14,15,29
88,8481624,Ilya Mikheyev,R,CHI,30,60,14,15,29
88,8476897,Oskar Sundqvist,C,STL,30,67,13,16,29
88,8470621,Corey Perry,R,EDM,39,63,12,17,29
88,8477498,Darnell Nurse,D,EDM,29,72,10,19,29
88,8477380,Jonny Brodzinski,C,NYR,31,57,10,19,29
88,8478109,Victor Olofsson,L,VGK,29,68,9,20,29
88,8480448,Parker Kelly,L,COL,25,79,9,20,29
88,8480220,Noah Cates,L,PHI,25,68,7,22,29
88,8480145,Neal Pionk,D,WPG,29,68,6,23,29
88,8474716,Jared Spurgeon,D,MIN,35,76,6,23,29
88,8482105,Jake Sanderson,D,OTT,22,72,5,24,29
88,8476923,Damon Severson,D,CBJ,30,79,2,27,29
88,8482074,Connor Zary,C,CGY,23,68,15,13,28
88,8478020,Michael Amadio,R,OTT,28,74,14,14,28
88,8480835,Jack Drury,C,CAR,24,55,13,15,28
88,8480855,Jack McBain,C,UTA,24,68,13,15,28
88,8477505,Alexander Wennberg,C,SJS,30,61,10,18,28
88,8476461,Sean Couturier,C,PHI,32,65,9,19,28
88,8480802,Ryan McLeod,C,BUF,25,68,9,19,28
88,8480336,Sean Walker,D,CAR,30,68,8,20,28
88,8476392,Adam Lowry,C,WPG,31,64,7,21,28
88,8480434,Sean Durzi,D,UTA,26,71,6,22,28
88,8478500,Ivan Provorov,D,CBJ,27,79,5,23,28
88,8476891,Matthew Grzelcyk,D,PIT,30,73,4,24,28
88,8481582,Nicholas Robertson,L,TOR,23,69,13,14,27
88,8476458,Ryan Strome,C,ANA,31,68,12,15,27
88,8482749,Joshua Roy,R,MTL,21,63,12,15,27
88,8478057,Dakota Joshua,C,VAN,28,70,11,16,27
88,8483482,Tristan Luneau,D,ANA,20,67,11,16,27
88,8483445,Cutter Gauthier,L,ANA,20,62,10,17,27
88,8476463,Jonas Brodin,D,MIN,31,77,9,18,27
88,8481703,Valtteri Puustinen,R,PIT,25,64,6,21,27
88,8481014,Alexander Romanov,D,NYI,24,79,6,21,27
88,8480049,Dylan Samberg,D,WPG,25,70,4,23,27
88,8482655,Janis Moser,D,TBL,24,82,3,24,27
88,8481553,Bobby Brink,R,PHI,23,60,14,12,26
88,8478463,Anthony Beauvillier,L,PIT,27,58,12,14,26
88,8480813,Joe Veleno,C,DET,24,80,12,14,26
88,8482475,Yegor Chinakhov,R,CBJ,23,64,11,15,26
88,8483491,Ivan Miroshnichenko,L,WSH,20,58,11,15,26
88,8479987,Morgan Geekie,C,BOS,26,73,10,16,26
88,8478432,Christian Fischer,R,DET,27,73,10,16,26
88,8478434,Keegan Kolesar,R,VGK,27,68,10,16,26
88,8482087,Kaiden Guhle,D,MTL,22,64,4,22,26
88,8480873,Rasmus Sandin,D,WSH,24,66,2,24,26
88,8482125,Alexander Holtz,R,VGK,22,69,15,10,25
88,8475231,Casey Cizikas,C,NYI,33,70,13,12,25
88,8475220,Marcus Foligno,L,MIN,33,68,12,13,25
88,8479390,Taylor Raddysh,R,WSH,26,68,12,13,25
88,8479351,Sam Steel,C,DAL,26,79,11,14,25
88,8482660,Kent Johnson,C,CBJ,22,70,8,17,25
88,8481581,Thomas Harley,D,DAL,23,75,8,17,25
88,8477919,Frederick Gaudreau,C,MIN,31,62,7,18,25
88,8483490,Pavel Mintyukov,D,ANA,21,69,5,20,25
88,8476469,Joel Armia,R,MTL,31,64,13,11,24
88,8482079,Marco Rossi,C,MIN,23,56,11,13,24
88,8473563,Nicklas Backstrom,C,WSH,37,54,9,15,24
88,8480144,David Kampf,C,TOR,29,63,8,16,24
88,8476457,Adam Larsson,D,SEA,32,65,5,19,24
88,8479639,Dylan Coghlan,D,WPG,26,62,2,22,24
88,8481601,Simon Holmstrom,R,NYI,23,68,13,10,23
88,8481580,Connor McMichael,C,WSH,23,66,13,10,23
88,8479941,Justin Danforth,R,CBJ,31,58,11,12,23
88,8479619,Michael Carcone,L,UTA,28,55,11,12,23
88,8479368,Max Jones,L,BOS,26,65,10,13,23
88,8479353,Brett Howden,C,VGK,26,66,9,14,23
88,8481093,Rafael Harvey-Pinard,L,MTL,25,59,9,14,23
88,8480011,Klim Kostin,C,SJS,25,47,9,14,23
88,8475343,Nic Dowd,C,WSH,34,57,8,15,23
88,8482624,Daniil Miromanov,D,CGY,27,61,7,16,23
88,8476979,Erik Gustafsson,D,DET,32,76,5,18,23
88,8480878,Nils Lundkvist,D,DAL,24,66,5,18,23
88,8478911,Matt Roy,D,WSH,29,57,4,19,23
88,8476902,Esa Lindell,D,DAL,30,74,4,19,23
88,8479371,Dante Fabbro,D,NSH,26,64,4,19,23
88,8478851,Alexandre Carrier,D,NSH,28,67,3,20,23
88,8482245,Artem Zub,D,OTT,29,72,3,20,23
88,8480817,K'Andre Miller,D,NYR,24,72,2,21,23
88,8481546,Cam York,D,PHI,23,72,1,22,23
88,8476429,Scott Mayfield,D,NYI,32,75,1,22,23
88,8479336,Carl Grundstrom,R,SJS,27,52,17,5,22
88,8476878,Zemgus Girgensons,C,TBL,30,80,14,8,22
88,8480848,Ty Dellandrea,C,SJS,24,41,11,11,22
88,8480980,Connor Dewar,C,TOR,25,64,10,12,22
88,8481704,Juuso Parssinen,C,NSH,23,54,10,12,22
88,8481481,Blake Lizotte,C,PIT,27,68,9,13,22
88,8475791,Taylor Hall,L,CHI,33,57,8,14,22
88,8481032,Paul Cotter,C,NJD,25,62,7,15,22
88,8483565,Nick Blankenburg,D,NSH,26,67,6,16,22
88,8476931,Jake McCabe,D,TOR,31,64,5,17,22
88,8479976,Juuso Valimaki,D,UTA,26,64,5,17,22
88,8476856,Mathew Dumba,D,DAL,30,74,4,18,22
88,8475171,Oliver Ekman-Larsson,D,TOR,33,68,3,19,22
88,8476988,Matt Benning,D,SJS,30,71,3,19,22
88,8476958,Jaccob Slavin,D,CAR,30,78,1,21,22
88,8480893,Kirill Marchenko,R,CBJ,24,58,12,9,21
88,8473422,Nick Foligno,L,CHI,37,58,11,10,21
88,8476374,Sean Kuraly,C,CBJ,31,56,11,10,21
88,8482737,Zack Bolduc,C,STL,21,63,10,11,21
88,8476822,Luke Glendening,C,TBL,35,75,10,11,21
88,8479520,Brandon Duhaime,R,WSH,27,57,9,12,21
88,8482067,Connor Mackey,D,NYR,28,61,8,13,21
88,8480789,Oliver Wahlstrom,R,NYI,24,67,8,13,21
88,8482634,Alex Steeves,C,TOR,25,58,7,14,21
88,8480043,Timothy Liljegren,D,TOR,25,70,4,17,21
88,8478507,John Marino,D,UTA,27,56,4,17,21
88,8483468,Jiri Kulich,C,BUF,20,56,4,17,21
88,8479398,Samuel Girard,D,COL,26,64,4,17,21
88,8477506,Ryan Pulock,D,NYI,30,79,3,18,21
88,8479983,Mario Ferraro,D,SJS,26,66,3,18,21
88,8475179,Dmitry Kulikov,D,FLA,34,60,3,18,21
88,8479316,Luke Kunin,C,SJS,27,58,13,7,20
88,8481477,Nico Sturm,C,SJS,29,53,12,8,20
88,8480021,Jack Studnicka,C,LAK,25,64,11,9,20
88,8477018,Ben Hutton,D,VGK,31,56,10,10,20
88,8478508,Yakov Trenin,C,MIN,27,59,9,11,20
88,8480205,Emil Bemstrom,C,PIT,25,65,7,13,20
88,8477450,Jason Dickinson,C,CHI,29,54,7,13,20
88,8484149,Gavin Brindley,C,CBJ,20,48,6,14,20
88,8476442,Matt Nieto,L,PIT,32,47,5,15,20
88,8475188,Brayden McNabb,D,VGK,33,58,5,15,20
88,8476917,Adam Pelech,D,NYI,30,77,2,18,20
88,8478178,Darren Raddysh,D,TBL,28,70,2,18,20
88,8475690,Chris Tanev,D,TOR,35,61,0,20,20
88,8482259,Bobby McMann,C,TOR,28,62,14,5,19
88,8477446,Michael McCarron,R,NSH,29,50,12,7,19
88,8477573,Nathan Walker,L,STL,30,49,11,8,19
88,8481522,Peyton Krebs,C,BUF,23,63,8,11,19
88,8476889,Radek Faksa,C,STL,30,65,8,11,19
88,8482744,James Malatesta,L,CBJ,21,38,8,11,19
88,8483457,Lane Hutson,D,MTL,20,70,7,12,19
88,8481441,Joe Snively,C,DET,28,60,6,13,19
88,8481059,Scott Perunovich,D,STL,26,62,3,16,19
88,8476879,Cody Ceci,D,EDM,31,70,2,17,19
88,8478416,Erik Cernak,D,TBL,27,70,2,17,19
88,8475181,Nick Leddy,D,STL,33,69,2,17,19
88,8475324,Nick Jensen,D,OTT,34,62,1,18,19
88,8475855,Jesper Fast,R,CAR,33,60,10,8,18
88,8477903,Garnet Hathaway,R,PHI,33,69,10,8,18
88,8476981,Josh Anderson,R,MTL,30,68,9,9,18
88,8477979,Nicolas Aube-Kubel,R,BUF,28,63,7,11,18
88,8483499,Liam Ohgren,L,MIN,20,52,6,12,18
88,8476994,Vinnie Hinostroza,C,NSH,30,51,6,12,18
88,8482809,Jackson Blake,R,CAR,21,57,5,13,18
88,8476967,Brett Kulak,D,EDM,30,54,5,13,18
88,8476467,Jamie Oleksiak,D,SEA,32,71,4,14,18
88,8480003,Jesper Boqvist,C,FLA,26,72,4,14,18
88,8476329,Travis Boyd,C,MIN,31,53,3,15,18
88,8480073,Erik Brannstrom,D,COL,25,58,3,15,18
88,8475462,Radko Gudas,D,ANA,34,68,3,15,18
88,8476331,Dylan DeMelo,D,WPG,31,71,2,16,18
88,8479344,Jesse Puljujarvi,R,PIT,26,54,13,4,17
88,8480281,Alexey Toropchenko,R,STL,25,57,12,5,17
88,8476873,Mark Jankowski,C,NSH,30,54,10,7,17
88,8476624,Barclay Goodrow,C,SJS,31,48,10,7,17
88,8482679,Matt Coronato,R,CGY,22,65,9,8,17
88,8479066,Ryan Lomberg,L,CGY,30,69,8,9,17
88,8480995,Pontus Holmberg,R,TOR,25,53,7,10,17
88,8480074,Alexandre Texier,C,STL,25,56,7,10,17
88,8476312,Josh Manson,D,COL,33,64,6,11,17
88,8473507,Jeff Petry,D,DET,37,69,6,11,17
88,8477015,Connor Brown,R,EDM,30,67,5,12,17
88,8477369,Carson Soucy,D,VAN,30,60,5,12,17
88,8481028,Martin Pospisil,C,CGY,25,50,4,13,17
88,8481019,David Gustafsson,C,WPG,24,42,4,13,17
88,8478882,Vladislav Gavrikov,D,LAK,29,68,4,13,17
88,8476525,Colin Miller,D,WPG,32,63,3,14,17
88,8475790,Erik Gudbranson,D,CBJ,32,75,3,14,17
88,8475279,Ben Chiarot,D,DET,33,73,3,14,17
88,8477499,Rasmus Ristolainen,D,PHI,30,65,3,14,17
88,8480246,Nick Perbix,D,TBL,26,69,2,15,17
88,8476892,Colton Parayko,D,STL,31,66,1,16,17
88,8471709,Marc-Edouard Vlasic,D,SJS,37,61,1,16,17
88,8477353,Tyler Motte,C,DET,29,75,12,4,16
88,8482155,Alex Laferriere,R,LAK,23,59,10,6,16
88,8481518,Nolan Foote,L,NJD,24,40,10,6,16
88,8477406,Mattias Janmark,C,EDM,32,66,8,8,16
88,8479370,Tyson Jost,C,CAR,26,46,7,9,16
88,8481521,Ronnie Attard,D,PHI,25,54,6,10,16
88,8476918,Jimmy Vesey,L,NYR,31,72,5,11,16
88,8480845,Rasmus Kupari,C,WPG,24,48,5,11,16
88,8479328,Julien Gauthier,R,NYI,27,63,5,11,16
88,8480796,Martin Fehervary,D,WSH,25,57,4,12,16
88,8475455,Brenden Dillon,D,NJD,34,61,2,14,16
88,8480891,Michael Kesselring,D,UTA,24,58,1,15,16
88,8478840,Will Borgen,D,SEA,28,63,0,16,16
88,8479324,Ryan Lindgren,D,NYR,26,64,0,16,16
88,8477478,William Carrier,L,CAR,30,54,10,5,15
88,8479671,Mathieu Olivier,R,CBJ,27,45,10,5,15
88,8479414,Nathan Bastian,R,NJD,27,58,8,7,15
88,8477839,Conor Sheary,L,TBL,32,79,6,9,15
88,8482062,Cole Smith,L,NSH,29,59,6,9,15
88,8478569,Noel Acciari,C,PIT,33,54,6,9,15
88,8474034,Patrick Maroon,L,CHI,36,49,6,9,15
88,8476927,Teddy Blueger,C,VAN,30,64,5,10,15
88,8482117,Lukas Reichel,L,CHI,22,58,5,10,15
88,8478831,Kevin Stenlund,C,UTA,28,58,5,10,15
88,8477507,Nikita Zadorov,D,BOS,29,69,4,11,15
88,8481537,Nikita Okhotiuk,D,CGY,24,49,4,11,15
88,8478136,Jake Middleton,D,MIN,28,74,2,13,15
88,8480860,Kevin Bahl,D,CGY,24,59,2,13,15
88,8470600,Ryan Suter,D,STL,39,68,2,13,15
88,8474574,Tyler Myers,D,VAN,34,70,2,13,15
88,8479982,Conor Timmins,D,TOR,26,53,1,14,15
88,8482073,Braden Schneider,D,NYR,23,66,0,15,15
88,8481716,Dmitri Voronkov,L,CBJ,24,50,13,1,14
88,8481789,Tye Kartye,L,SEA,23,42,9,5,14
88,8480252,Cole Guttman,C,CHI,25,39,8,6,14
88,8473453,Trevor Lewis,C,LAK,37,75,7,7,14
88,8478585,Derek Ryan,C,EDM,38,67,7,7,14
88,8479315,Joey Anderson,R,CHI,26,54,7,7,14
88,8476867,Brendan Gaunce,C,MIN,30,37,7,7,14
88,8481517,Brett Leason,R,ANA,25,49,6,8,14
88,8479968,Vinni Lettieri,C,BOS,29,46,6,8,14
88,8482142,Jamie Drysdale,D,PHI,22,64,5,9,14
88,8478421,A.J. Greer,L,FLA,28,55,5,9,14
88,8479980,Nicolas Hague,D,VGK,26,51,5,9,14
88,8482803,Olen Zellweger,D,ANA,21,61,5,9,14
88,8476960,Andreas Athanasiou,C,CHI,30,57,4,10,14
88,8477220,Nate Schmidt,D,FLA,33,67,4,10,14
88,8481708,Zac Jones,D,NYR,24,51,4,10,14
88,8475750,Jon Merrill,D,MIN,32,67,4,10,14
88,8482451,Mikael Pyyhtia,L,CBJ,23,39,3,11,14
88,8480035,Henri Jokiharju,D,BUF,25,56,2,12,14
88,8474673,TJ Brodie,D,CHI,34,55,2,12,14
88,8480192,Johnathan Kovacevic,D,NJD,27,55,2,12,14
88,8483460,David Jiricek,D,CBJ,21,52,2,12,14
88,8480727,Zach Whitecloud,D,VGK,28,48,2,12,14
88,8476422,Mike Reilly,D,NYI,31,74,1,13,14
88,8480950,Ilya Lyubushkin,D,DAL,30,63,1,13,14
88,8480355,Mark Kastelic,C,BOS,25,67,10,3,13
88,8482784,Zach Dean,C,STL,21,42,9,4,13
88,8479981,Jonah Gadjovich,L,FLA,26,44,8,5,13
88,8482762,Simon Edvinsson,D,DET,21,55,7,6,13
88,8482176,Wyatt Kaiser,D,CHI,22,54,7,6,13
88,8477931,Tomas Nosek,L,FLA,32,59,5,8,13
88,8481609,Vladislav Kolyachonok,D,UTA,23,42,5,8,13
88,8477508,Curtis Lazar,C,NJD,29,53,4,9,13
88,8474567,Zach Bogosian,D,MIN,34,56,4,9,13
88,8481161,Jake Christiansen,D,CBJ,25,58,4,9,13
88,8478452,Caleb Jones,D,LAK,27,56,3,10,13
88,8477845,Trevor van Riemsdyk,D,WSH,33,60,2,11,13
88,8478970,Jalen Chatfield,D,CAR,28,70,2,11,13
88,8475233,David Savard,D,MTL,34,62,2,11,13
88,8482666,Scott Morrow,D,CAR,22,52,1,12,13
88,8481013,Jonatan Berggren,R,DET,24,58,7,5,12
88,8475842,Sam Carrick,C,NYR,32,70,7,5,12
88,8481641,Joel Kiviranta,L,COL,28,65,6,6,12
88,8478443,Brandon Carlo,D,BOS,28,60,6,6,12
88,8482807,Ethan Del Mastro,D,CHI,21,52,5,7,12
88,8480880,Jakub Lauko,C,MIN,24,35,5,7,12
88,8482095,Tyler Kleven,D,OTT,22,50,4,8,12
88,8482859,Zack Ostapchuk,C,OTT,21,56,4,8,12
88,8479372,Joshua Mahura,D,SEA,26,54,3,9,12
88,8479536,Axel Jonsson-Fjallby,L,WPG,26,35,3,9,12
88,8481568,Alex Vlasic,D,CHI,23,49,2,10,12
88,8480807,Mattias Samuelsson,D,BUF,24,55,1,11,12
88,8480222,Sebastian Aho,D,PIT,28,65,1,11,12
88,8480172,Jan Rutta,D,SJS,34,64,1,11,12
88,8480001,Urho Vaakanainen,D,ANA,25,54,1,11,12
88,8475718,Justin Holl,D,DET,32,59,0,12,12
88,8480058,Pierre-Olivier Joseph,D,STL,25,45,0,12,12
88,8478424,Jansen Harkins,C,ANA,27,42,8,3,11
88,8480289,Morgan Barron,C,WPG,26,49,7,4,11
88,8481527,Kaedan Korczak,D,VGK,23,49,6,5,11
88,8475225,Craig Smith,C,CHI,35,44,6,5,11
88,8483495,Simon Nemec,D,NJD,20,48,6,5,11
88,8482166,Shakir Mukhamadullin,D,SJS,22,53,6,5,11
88,8479026,Philippe Myers,D,TOR,27,52,5,6,11
88,8481592,Jakob Pelletier,L,CGY,23,38,5,6,11
88,8479291,Kevin Rooney,C,CGY,31,49,4,7,11
88,8482157,Will Cuylle,L,NYR,22,56,4,7,11
88,8476874,Olli Maatta,D,DET,30,54,4,7,11
88,8481147,Reese Johnson,C,MIN,26,36,4,7,11
88,8477392,Hudson Fasching,R,NYI,29,62,3,8,11
88,8479369,Andrew Peeke,D,BOS,26,60,3,8,11
88,8479439,Jacob MacDonald,D,COL,31,52,3,8,11
88,8481617,Vasily Podkolzin,R,VAN,23,47,3,8,11
88,8479998,Mikey Anderson,D,LAK,25,63,2,9,11
88,8482111,Justin Barron,D,MTL,23,65,2,9,11
88,8477070,Liam O'Brien,C,UTA,30,51,2,9,11
88,8479718,Alex Barré-Boulet,C,MTL,27,48,2,9,11
88,8476473,Connor Murphy,D,CHI,31,39,2,9,11
88,8475208,Brian Dumoulin,D,ANA,33,65,1,10,11
88,8474568,Luke Schenn,D,NSH,35,53,0,11,11
88,8479359,Beck Malenstyn,L,BUF,26,48,6,4,10
88,8482652,Walker Duehr,R,CGY,27,44,6,4,10
88,8480007,Jonas Rondbjerg,R,VGK,25,41,6,4,10
88,8480441,Trey Fix-Wolansky,R,CBJ,25,40,5,5,10
88,8482733,Logan Mailloux,D,MTL,31,38,5,5,10
88,8474166,Alec Martinez,D,CHI,37,50,5,5,10
88,8482070,Mitchell Chaffee,R,TBL,26,59,5,5,10
88,8480157,Calle Rosen,D,COL,30,43,4,6,10
88,8481600,Tobias Bjornfot,D,FLA,23,32,4,6,10
88,8479348,Kale Clague,D,BUF,26,37,3,7,10
88,8474090,Brendan Smith,D,DAL,35,54,3,7,10
88,8482747,Brennan Othmann,L,NYR,21,35,3,7,10
88,8481550,Adam Beckman,L,NJD,23,45,3,7,10
88,8482511,Mason Lohrei,D,BOS,23,33,3,7,10
88,8477473,Justin Bailey,R,SJS,29,22,3,7,10
88,8480762,Eric Robinson,L,CAR,29,52,2,8,10
88,8480025,MacKenzie Entwistle,R,FLA,25,61,2,8,10
88,8481598,Philip Broberg,D,EDM,23,48,1,9,10
88,8481567,Henry Thrun,D,SJS,23,48,1,9,10
88,8474612,Travis Hamonic,D,OTT,34,47,1,9,10
88,8478043,Sam Lafferty,C,BUF,29,57,8,1,9
88,8482148,Hendrix Lapierre,C,WSH,22,52,5,4,9
88,8483493,Frank Nazar,C,CHI,20,52,5,4,9
88,8480070,Ian Mitchell,D,BOS,25,51,4,5,9
88,8471817,Ryan Reaves,R,TOR,37,56,4,5,9
88,8475235,Nicolas Deslauriers,L,PHI,33,44,4,5,9
88,8482077,Dylan Holloway,L,EDM,23,52,3,6,9
88,8477887,Patrick Brown,C,BOS,32,39,3,6,9
88,8479972,Mason Shaw,C,WPG,26,35,3,6,9
88,8479994,Jaret Anderson-Dolan,C,WPG,25,46,3,6,9
88,8480806,Isac Lundestrom,C,ANA,25,58,2,7,9
88,8481178,Egor Zamula,D,PHI,24,59,2,7,9
88,8482192,Isaak Phillips,D,CHI,23,50,1,8,9
88,8480196,Jacob Bryson,D,BUF,27,45,1,8,9
88,8479985,Cale Fleury,D,SEA,26,23,1,8,9
88,8479944,Zach Aston-Reese,C,VGK,30,50,7,1,8
88,8483570,Ben Meyers,C,SEA,26,33,7,1,8
88,8482659,Josh Doan,R,UTA,22,51,6,2,8
88,8479772,Zack MacEwen,R,OTT,28,51,5,3,8
88,8482496,Nils Aman,C,VAN,24,37,4,4,8
88,8481532,Alex Turcotte,C,LAK,23,42,4,4,8
88,8481599,Victor Soderstrom,D,UTA,23,43,4,4,8
88,8484911,Collin Graf,R,SJS,22,51,4,4,8
88,8483619,Filip Roos,D,OTT,25,32,4,4,8
88,8478211,Dryden Hunt,L,CGY,29,58,3,5,8
88,8478859,Niko Mikkola,D,FLA,28,58,3,5,8
88,8483763,Maksymilian Szuber,D,UTA,22,32,3,5,8
88,8478451,Ethan Bear,D,WSH,27,60,3,5,8
88,8484287,Cole McWard,D,VAN,23,24,3,5,8
88,8481701,Santeri Hatakka,D,NJD,23,35,2,6,8
88,8479442,Troy Stecher,D,EDM,30,49,2,6,8
88,8473446,Erik Johnson,D,PHI,36,44,2,6,8
88,8480870,Bo Groulx,C,NYR,24,32,2,6,8
88,8476441,Joel Edmundson,D,LAK,31,50,2,6,8
88,8482153,Brendan Brisson,C,VGK,23,40,2,6,8
88,8480887,Jordan Harris,D,MTL,24,51,1,7,8
88,8478450,Parker Wotherspoon,D,BOS,27,38,1,7,8
88,8481122,Simon Benoit,D,TOR,26,41,1,7,8
88,8482861,Vincent Iorio,D,WSH,22,32,0,8,8
88,8479249,Andrew Poturalski,C,SJS,30,32,0,8,8
88,8476934,Brock McGinn,L,ANA,30,48,5,2,7
88,8477335,Kyle Burroughs,D,LAK,29,33,4,3,7
88,8476858,Phillip Di Giuseppe,L,VAN,31,33,4,3,7
88,8483630,Pavol Regenda,L,ANA,25,30,4,3,7
88,8480267,Sammy Walker,C,MIN,25,25,4,3,7
88,8474013,Ian Cole,D,UTA,35,52,3,4,7
88,8478409,Anthony Richard,C,PHI,28,31,3,4,7
88,8481754,Nikita Nesterenko,C,ANA,23,35,3,4,7
88,8482730,Brandt Clarke,D,LAK,21,47,2,5,7
88,8480879,Jacob Bernard-Docker,D,OTT,24,46,2,5,7
88,8471677,Jack Johnson,D,CBJ,37,70,2,5,7
88,8481679,Maxence Guenette,D,OTT,23,31,2,5,7
88,8479576,Vincent Desharnais,D,VAN,28,39,2,5,7
88,8477384,Joshua Brown,D,EDM,30,45,1,6,7
88,8481056,Spencer Stastney,D,NSH,24,29,1,6,7
88,8477962,Brendan Lemieux,L,CAR,28,40,4,2,6
88,8482751,Ryan Winterton,C,SEA,21,45,4,2,6
88,8482145,Mavrik Bourque,C,DAL,22,52,3,3,6
88,8481167,Brayden Pachal,D,CGY,25,43,3,3,6
88,8476952,Dominic Toninato,C,WPG,30,27,3,3,6
88,8481556,John Beecher,C,BOS,23,26,3,3,6
88,8480245,Olle Lycksell,R,PHI,25,33,3,3,6
88,8482165,Yan Kuznetsov,D,CGY,22,20,3,3,6
88,8477401,John Hayden,C,SEA,29,31,3,3,6
88,8482118,Sam Colangelo,R,ANA,23,16,3,3,6
88,8477482,Zachary Sanford,L,CHI,30,34,2,4,6
88,8478399,Jonas Siegenthaler,D,NJD,27,57,2,4,6
88,8477938,Haydn Fleury,D,WPG,28,46,2,4,6
88,8479543,Michael Pezzetta,L,MTL,26,51,2,4,6
88,8476372,Nick Seeler,D,PHI,31,44,2,4,6
88,8483549,Lucas Condotta,L,MTL,27,34,2,4,6
88,8481743,Marc Del Gaizo,D,NSH,25,20,2,4,6
88,8482964,Arber Xhekaj,D,MTL,23,50,2,4,6
88,8478468,Jeremy Lauzon,D,NSH,27,47,1,5,6
88,8475177,Calvin de Haan,D,COL,33,46,1,5,6
88,8477365,Connor Clifton,D,BUF,29,51,1,5,6
88,8478146,Matthew Highmore,C,OTT,28,32,1,5,6
88,8478874,Adam Gaudette,R,OTT,28,34,1,5,6
88,8481806,Louis Crevier,D,CHI,23,21,1,5,6
88,8483466,Kevin Korchinski,D,CHI,20,50,0,6,6
88,8477034,Jaycob Megna,D,FLA,32,48,0,6,6
88,8479379,Givani Smith,R,SJS,26,28,0,6,6
88,8481751,Lukas Rousek,R,BUF,25,40,3,2,5
88,8478017,Mark Friedman,D,VAN,29,34,3,2,5
88,8479638,Justin Brazeau,R,BOS,26,24,3,2,5
88,8479367,William Lockwood,R,FLA,26,20,3,2,5
88,8482201,Gage Goncalves,C,TBL,23,24,3,2,5
88,8483012,Logan Morrison,C,SEA,22,32,2,3,5
88,8480844,Grigori Denisenko,L,VGK,24,29,2,3,5
88,8481605,Jackson LaCombe,D,ANA,23,33,2,3,5
88,8477073,Kurtis MacDermid,L,NJD,30,23,1,4,5
88,8477851,Jordan Oesterle,D,BOS,32,36,1,4,5
88,8480890,Jan Jenik,C,OTT,24,23,1,4,5
88,8480834,Ty Emberson,D,SJS,24,32,0,5,5
88,8482250,Callahan Burke,C,VGK,27,23,0,5,5
88,8474062,Riley Nash,C,NYR,35,14,0,5,5
88,8477149,Scott Sabourin,R,SJS,32,16,0,5,5
88,8483567,Georgii Merkulov,C,BOS,24,14,3,1,4
88,8484254,Akito Hirose,D,VAN,25,40,2,2,4
88,8475762,Derek Forbort,D,VAN,32,45,2,2,4
88,8482177,Marat Khusnutdinov,C,MIN,22,28,2,2,4
88,8482929,Emil Lilleberg,D,TBL,23,21,2,2,4
88,8478051,Max Willman,C,NJD,29,21,2,2,4
88,8482144,Jack Thompson,D,SJS,22,25,2,2,4
88,8476913,Devin Shore,C,MIN,30,35,1,3,4
88,8479378,Logan Stanley,D,WPG,26,36,1,3,4
88,8480292,Carson Meyer,R,ANA,27,36,1,3,4
88,8478454,Noah Juulsen,D,VAN,27,33,1,3,4
88,8479320,Maxime Lajoie,D,SEA,27,32,1,3,4
88,8479362,Riley Tufte,L,BOS,26,30,1,3,4
88,8482141,Lukas Cormier,D,VGK,22,24,1,3,4
88,8480084,Nick DeSimone,D,NJD,30,22,1,3,4
88,8482172,Landon Slaggert,L,CHI,22,28,1,3,4
88,8481030,Jack St. Ivany,D,PIT,25,16,1,3,4
88,8479986,Kole Lind,R,DAL,26,44,0,4,4
88,8477462,Robert Hagg,D,VGK,29,19,0,4,4
88,8475795,Dylan McIlrath,D,WSH,32,10,0,4,4
88,8477467,Gustav Olofsson,D,SEA,30,19,3,0,3
88,8482476,Emil Heineman,L,MTL,23,7,3,0,3
88,8482765,Isak Rosen,R,BUF,21,31,2,1,3
88,8481065,Angus Crookshank,L,OTT,25,13,2,1,3
88,8481206,John Ludvig,D,PIT,24,14,2,1,3
88,8479419,Brett Murray,L,BUF,26,20,2,1,3
88,8484304,Uvis Balinskis,D,FLA,28,11,2,1,3
88,8482713,Mackie Samoskevich,R,FLA,22,38,1,2,3
88,8477971,Andreas Englund,D,LAK,28,28,1,2,3
88,8477320,Anton Blidh,L,NYR,29,18,1,2,3
88,8479587,Rhett Gardner,C,PHI,28,17,1,2,3
88,8478502,Dennis Gilbert,D,BUF,28,25,1,2,3
88,8477527,Ross Johnston,L,ANA,30,24,1,2,3
88,8477244,Chad Ruhwedel,D,NYR,34,33,0,3,3
88,8480990,Declan Chisholm,D,MIN,24,34,0,3,3
88,8481593,Jayden Struble,D,MTL,23,19,0,3,3
88,8478021,William Lagesson,D,DET,28,31,0,3,3
88,8481006,Tyler Tucker,D,STL,24,15,0,3,3
88,8480823,Alexander Alexeyev,D,WSH,25,14,0,3,3
88,8482516,Matthew Kessel,D,STL,24,23,0,3,3
88,8481543,Nikita Alexandrov,C,STL,24,21,2,0,2
88,8481462,Mason Morelli,L,VGK,28,10,2,0,2
88,8483397,Marc McLaughlin,C,BOS,25,27,1,1,2
88,8480032,Shane Bowers,C,NJD,25,15,1,1,2
88,8484258,Sam Malinski,D,COL,26,20,1,1,2
88,8481237,Kyle MacLean,C,NYI,25,23,1,1,2
88,8477810,Joel Hanley,D,CGY,33,31,1,1,2
88,8483489,Fraser Minten,C,TOR,31,14,1,1,2
88,8475958,Michael Sgarbossa,C,WSH,32,23,0,2,2
88,8483512,Matthew Savoie,C,EDM,20,22,0,2,2
88,8482162,Roby Jarventie,L,EDM,22,18,0,2,2
88,8482858,Ryker Evans,D,SEA,23,22,0,2,2
88,8475413,Justin Dowling,C,NJD,34,15,0,2,2
88,8482787,Nikita Chibrikov,R,WPG,31,4,0,2,2
88,8478881,Brett Seney,L,CHI,28,16,1,0,1
88,8480851,Akil Thomas,C,LAK,24,20,1,0,1
88,8480468,James Hamblin,L,EDM,25,15,1,0,1
88,8481585,Egor Afanasyev,L,SJS,23,15,1,0,1
88,8478477,Mitchell Stephens,C,SEA,27,13,1,0,1
88,8481422,Jake Lucchini,C,NSH,29,13,1,0,1
88,8482088,Justin Sourdif,R,FLA,22,13,1,0,1
88,8479330,Brandon Gignac,C,MTL,27,7,1,0,1
88,8483920,Pierrick Dube,R,WSH,23,3,1,0,1
88,8483395,Arshdeep Bains,L,VAN,23,14,1,0,1
88,8477541,Dakota Mermis,D,TOR,30,5,0,1,1
88,8479991,Jake Leschyshyn,C,NYR,25,22,0,1,1
88,8481541,Samuel Bolduc,D,NYI,24,23,0,1,1
88,8482147,Jean-Luc Foudy,C,COL,22,21,0,1,1
88,8484325,Waltteri Merela,C,TBL,26,16,0,1,1
88,8483407,Brandon Scanlin,D,NYR,25,4,0,1,1
88,8478854,Ryan Shea,D,PIT,27,12,0,1,1
88,8481578,Graeme Clarke,R,MIN,23,9,0,1,1
88,8484255,Jason Polin,R,COL,25,8,0,1,1
88,8479421,Jacob Moverare,D,LAK,26,6,0,1,1
88,8483401,Marc Johnstone,R,PIT,28,1,0,1,1
88,8483471,Brad Lambert,C,WPG,31,8,0,1,1
88,8478011,Louie Belpedio,D,PHI,28,12,0,1,1
88,8482197,Adam Raska,R,MIN,23,9,0,1,1
88,8483398,Declan Carlile,D,TBL,31,8,0,1,1
88,8479522,Hardy Haman Aktell,D,WSH,26,4,0,1,1
88,8482470,Ilya Solovyov,D,CGY,24,16,0,0,0
88,8477993,Justin Kirkland,C,CGY,28,7,0,0,0
88,8482102,Vasily Ponomarev,C,PIT,22,16,0,0,0
88,8480874,Adam Ginning,D,PHI,24,7,0,0,0
88,8482460,Matt Rempe,C,NYR,22,11,0,0,0
88,8481726,Adam Edstrom,C,NYR,24,11,0,0,0
88,8483597,Milos Kelemen,L,UTA,25,9,0,0,0
88,8480075,Cameron Crotty,D,MIN,25,11,0,0,0
88,8476323,Max McCormick,L,SEA,32,8,0,0,0
88,8475755,Alexander Petrovic,D,DAL,32,9,0,0,0
88,8481699,Aku Raty,R,UTA,23,19,0,0,0
88,8481719,Maxwell Crozier,D,TBL,24,15,0,0,0
88,8482061,Brandon Biro,L,SEA,26,6,0,0,0
88,8478446,Glenn Gawdin,C,LAK,27,10,0,0,0
88,8482094,Daemon Hunt,D,MIN,22,18,0,0,0
88,8481564,Ryan Johnson,D,BUF,23,8,0,0,0
88,8478147,Bokondji Imama,L,PIT,28,4,0,0,0
88,8481043,Cole Koepke,L,BOS,26,20,0,0,0
88,8475780,Chris Wagner,R,COL,33,7,0,0,0
88,8481655,Cole Schwindt,R,CGY,23,2,0,0,0
88,8481024,Linus Karlsson,C,VAN,25,8,0,0,0
88,8482126,Emil Andrae,D,PHI,31,0,0,0,0
88,8480306,Grant Hutton,D,NYI,29,7,0,0,0
88,8484321,Nikolas Matinpalo,D,OTT,26,2,0,0,0
88,8481534,Raphael Lavoie,C,EDM,24,3,0,0,0
88,8483546,Marshall Rifai,D,TOR,26,3,0,0,0
88,8484326,Patrik Koch,D,UTA,28,2,0,0,0
88,8483609,Adam Klapka,R,CGY,24,2,0,0,0
88,8483432,Luca Del Bel Belluz,C,CBJ,31,4,0,0,0
88,8483531,Brian Halonen,L,NJD,25,2,0,0,0
88,8478956,Samuel Laberge,L,NJD,27,0,0,0,0
88,8480274,Philip Kemp,D,EDM,25,2,0,0,0
88,8484259,Ondrej Pavel,C,COL,31,2,0,0,0
88,8470794,Joe Pavelski,C,,40,0,0,0,0
88,8479321,Lucas Johansen,D,,27,0,0,0,0
88,8477950,Tony DeAngelo,D,,29,0,0,0,0
88,8471218,Blake Wheeler,R,,38,0,0,0,0
88,8475197,Tyson Barrie,D,,33,0,0,0,0
88,8474157,Max Pacioretty,L,,36,0,0,0,0
88,8475744,Evgeny Kuznetsov,C,,32,0,0,0,0
88,8474037,James van Riemsdyk,L,,35,0,0,0,0
88,8476907,Mackenzie MacEachern,L,,30,0,0,0,0
88,8480216,Jacob Peterson,C,,25,0,0,0,0
88,8474602,Justin Schultz,D,,34,0,0,0,0
88,8482222,Alexander Barabanov,L,,30,0,0,0,0
88,8474031,Kevin Shattenkirk,D,,35,0,0,0,0
88,8477330,Dominik Kubalik,L,,29,0,0,0,0
88,8480884,Calen Addison,D,,24,0,0,0,0
88,8475906,John Klingberg,D,,32,0,0,0,0
88,8480008,Adam Ruzicka,C,,25,0,0,0,0
88,8476884,Derrick Pouliot,D,,30,0,0,0,0
88,8476919,Chris Tierney,C,,30,0,0,0,0
88,8479415,Michael McLeod,C,,26,0,0,0,0
88,8474870,Tyler Johnson,C,,34,0,0,0,0
88,8470604,Jeff Carter,C,,39,0,0,0,0
88,8478104,Sammy Blais,L,,28,0,0,0,0
88,8474884,Mike Hoffman,C,,35,0,0,0,0
88,8481591,Sam Poulin,R,,23,0,0,0,0
88,8471274,Alex Goligoski,D,,39,0,0,0,0
88,8476871,Tanner Pearson,L,,32,0,0,0,0
88,8476393,Nick Cousins,C,,31,0,0,0,0
88,8479977,Kailer Yamamoto,R,,26,0,0,0,0
88,8479346,Dillon Dube,C,,26,0,0,0,0
88,8480184,Gustav Lindstrom,D,,26,0,0,0,0
88,8479376,Victor Mete,D,,26,0,0,0,0
88,8473449,Kyle Okposo,R,,36,0,0,0,0
88,8481058,Jesse Ylonen,R,,25,0,0,0,0
88,8475752,Tyler Pitlick,C,,33,0,0,0,0
88,8481239,Samuel Fagemo,L,,24,0,0,0,0
88,8480821,Filip Zadina,R,,25,0,0,0,0
88,8470966,Mark Giordano,D,,41,0,0,0,0
88,8478495,Denis Gurianov,R,,27,0,0,0,0
88,8477464,Nic Petan,C,,29,0,0,0,0
88,8478099,Kevin Labanc,R,,29,0,0,0,0
88,8482241,Radim Zohorna,L,,28,0,0,0,0
88,8474040,Sam Gagner,C,,35,0,0,0,0
88,8479514,Rem Pitlick,C,,27,0,0,0,0
88,8478430,Oliver Kylington,D,,27,0,0,0,0
88,8479533,Joona Koppanen,L,,26,0,0,0,0
88,8479984,Cal Foote,D,,26,0,0,0,0
88,8477126,Jayson Megna,C,,34,0,0,0,0
88,8475164,Jakob Silfverberg,R,,34,0,0,0,0
88,8474009,Nick Bonino,C,,36,0,0,0,0
88,8479458,Nikita Zaitsev,D,,33,0,0,0,0
88,8477944,Jakub Vrana,L,,28,0,0,0,0
88,8471699,Andrew Cogliano,C,,37,0,0,0,0
88,8478067,Oskar Lindblom,L,,28,0,0,0,0
88,8471686,Marc Staal,D,,37,0,0,0,0
88,8470610,Zach Parise,L,,40,0,0,0,0
88,8478904,Steven Lorentz,C,,28,0,0,0,0
88,8473473,Milan Lucic,L,,36,0,0,0,0
88,8480031,Maxime Comtois,L,,25,0,0,0,0
88,8478512,Austin Czarnik,C,,32,0,0,0,0
88,8473504,Cal Clutterbuck,R,,37,0,0,0,0
88,8477454,Adam Erne,L,,29,0,0,0,0
88,8479383,Boris Katchouk,L,,26,0,0,0,0
88,8475825,Jani Hakanpää,D,,32,0,0,0,0
88,8477846,Ryan Carpenter,C,,33,0,0,0,0
88,8477930,Pierre-Edouard Bellemare,L,,39,0,0,0,0
88,8478400,Colin White,C,,27,0,0,0,0
88,8480226,Marián Studenic,R,,26,0,0,0,0
88,8480853,Liam Foudy,C,,24,0,0,0,0
88,8475797,Jarred Tinordi,D,,32,0,0,0,0
88,8479423,Alex Nylander,L,,26,0,0,0,0
88,8474618,Marco Scandella,D,,34,0,0,0,0
88,8478028,Fredrik Olofsson,L,,28,0,0,0,0
88,8474709,Matt Martin,L,,35,0,0,0,0
88,8481070,Hugh McGing,L,,26,0,0,0,0
88,8479546,Oskar Steen,C,,26,0,0,0,0
88,8474145,Robert Bortuzzo,D,,35,0,0,0,0
88,8476915,Jujhar Khaira,L,,30,0,0,0,0
88,8475278,Byron Froese,C,,33,0,0,0,0
88,8481812,Nikolai Knyzhov,D,,27,0,0,0,0
88,8478408,Travis Dermott,D,,28,0,0,0,0
88,8481077,John Leonard,L,,26,0,0,0,0
88,8479547,Matthew Phillips,R,,26,0,0,0,0
88,8480836,Jonathan Gruden,C,,24,0,0,0,0
88,8481690,Tyler Angle,C,,24,0,0,0,0
88,8475766,Austin Watson,L,,32,0,0,0,0
88,8481016,Ruslan Iskhakov,C,,24,0,0,0,0
88,8478078,Rourke Chartier,C,,28,0,0,0,0
88,8480776,Sheldon Rempal,R,,29,0,0,0,0
88,8483045,Cameron Butler,R,CBJ,31,0,0,0,0
88,8484314,Jiri Smejkal,L,,28,0,0,0,0
89,8478402,Connor McDavid,C,EDM,27,80,47,120,167
89,8477492,Nathan MacKinnon,C,COL,29,80,60,88,148
89,8481559,Jack Hughes,C,NJD,23,74,45,75,120
89,8477956,David Pastrnak,R,BOS,28,79,54,65,119
89,8479318,Auston Matthews,C,TOR,27,80,64,52,116
89,8477939,William Nylander,R,TOR,28,80,59,54,113
89,8478550,Artemi Panarin,L,NYR,33,74,33,78,111
89,8476453,Nikita Kucherov,R,TBL,31,81,29,81,110
89,8477934,Leon Draisaitl,C,EDM,29,80,40,68,108
89,8480027,Jason Robertson,L,DAL,25,80,38,70,108
89,8478483,Mitch Marner,R,TOR,27,80,25,82,107
89,8478420,Mikko Rantanen,R,COL,28,81,40,66,106
89,8478010,Brayden Point,C,TBL,28,82,46,56,102
89,8479314,Matthew Tkachuk,L,FLA,27,78,27,72,99
89,8479407,Jesper Bratt,L,NJD,26,77,38,59,97
89,8477404,Jake Guentzel,C,TBL,30,81,42,54,96
89,8477933,Sam Reinhart,C,FLA,29,77,40,53,93
89,8478403,Jack Eichel,C,VGK,28,75,46,46,92
89,8476468,J.T. Miller,C,VAN,31,74,29,63,92
89,8471685,Anze Kopitar,C,LAK,37,81,31,60,91
89,8477942,Kevin Fiala,L,LAK,28,82,40,50,90
89,8473419,Brad Marchand,L,BOS,36,81,30,60,90
89,8477960,Adrian Kempe,R,LAK,28,81,39,49,88
89,8475166,John Tavares,C,TOR,34,82,39,49,88
89,8478864,Kirill Kaprizov,L,MIN,27,74,34,54,88
89,8484144,Connor Bedard,C,CHI,19,71,33,55,88
89,8475172,Nazem Kadri,C,CGY,34,80,33,54,87
89,8471675,Sidney Crosby,C,PIT,37,74,29,58,87
89,8478445,Mathew Barzal,C,NYI,27,80,22,64,86
89,8480800,Quinn Hughes,D,VAN,25,76,13,72,85
89,8479542,Brandon Hagel,L,TBL,26,82,32,52,84
89,8476887,Filip Forsberg,L,NSH,30,71,31,53,84
89,8474564,Steven Stamkos,C,NSH,34,72,31,53,84
89,8479323,Adam Fox,D,NYR,26,74,22,62,84
89,8480002,Nico Hischier,C,NJD,25,77,34,47,81
89,8477951,Nick Schmaltz,C,UTA,28,76,32,49,81
89,8477493,Aleksander Barkov,C,FLA,29,81,25,56,81
89,8479420,Tage Thompson,C,BUF,27,69,42,37,79
89,8482116,Tim Stützle,C,OTT,22,80,28,51,79
89,8476460,Mark Scheifele,C,WPG,31,73,28,51,79
89,8475168,Matt Duchene,C,DAL,33,81,28,51,79
89,8477496,Elias Lindholm,C,BOS,30,82,29,49,78
89,8480023,Robert Thomas,C,STL,25,75,18,60,78
89,8471215,Evgeni Malkin,C,PIT,38,73,28,49,77
89,8480801,Brady Tkachuk,L,OTT,25,79,38,38,76
89,8476459,Mika Zibanejad,C,NYR,31,78,36,40,76
89,8481557,Matt Boldy,L,MIN,23,69,32,44,76
89,8479385,Jordan Kyrou,C,STL,26,80,32,44,76
89,8479343,Clayton Keller,R,UTA,26,77,29,47,76
89,8478427,Sebastian Aho,C,CAR,27,68,29,47,76
89,8480069,Cale Makar,D,COL,26,69,17,59,76
89,8478407,Vince Dunn,D,SEA,28,76,10,66,76
89,8476346,Johnny Gaudreau,L,CBJ,31,69,18,57,75
89,8473512,Claude Giroux,R,OTT,36,79,18,57,75
89,8477409,Carter Verhaeghe,C,FLA,29,77,37,37,74
89,8476389,Vincent Trocheck,C,NYR,31,76,31,43,74
89,8475798,Mikael Granlund,C,SJS,32,69,19,55,74
89,8475754,Brock Nelson,C,NYI,33,80,36,37,73
89,8477946,Dylan Larkin,C,DET,28,80,36,37,73
89,8478493,Joel Eriksson Ek,C,MIN,27,76,32,41,73
89,8480036,Miro Heiskanen,D,DAL,25,75,17,56,73
89,8475786,Zach Hyman,L,EDM,32,77,39,33,72
89,8478449,Roope Hintz,C,DAL,28,81,28,44,72
89,8479337,Alex DeBrincat,R,DET,27,78,27,45,72
89,8478398,Kyle Connor,L,WPG,28,72,33,38,71
89,8471214,Alex Ovechkin,L,WSH,39,76,26,45,71
89,8480018,Nick Suzuki,C,MTL,25,80,25,46,71
89,8476454,Ryan Nugent-Hopkins,C,EDM,31,78,22,49,71
89,8480012,Elias Pettersson,C,VAN,26,74,28,42,70
89,8474578,Erik Karlsson,D,PIT,34,79,19,50,69
89,8480865,Noah Dobson,D,NYI,24,80,14,55,69
89,8481528,Dylan Cozens,C,BUF,23,73,35,33,68
89,8480830,Andrei Svechnikov,R,CAR,24,71,29,39,68
89,8475745,Charlie Coyle,C,BOS,32,77,23,45,68
89,8477501,Valeri Nichushkin,R,COL,29,81,37,30,67
89,8478975,Mason Marchment,L,DAL,29,82,28,39,67
89,8482093,Seth Jarvis,C,CAR,22,77,31,35,66
89,8475765,Vladimir Tarasenko,R,DET,33,80,25,41,66
89,8477503,Max Domi,C,TOR,29,78,20,46,66
89,8477949,Alex Tuch,R,BUF,28,74,18,48,66
89,8480839,Rasmus Dahlin,D,BUF,24,70,17,49,66
89,8482740,Wyatt Johnston,C,DAL,21,82,34,31,65
89,8476539,Jonathan Marchessault,R,NSH,34,73,33,32,65
89,8476456,Jonathan Huberdeau,C,CGY,31,77,21,44,65
89,8478460,Zach Werenski,D,CBJ,27,79,15,50,65
89,8477998,Warren Foegele,L,LAK,28,80,31,33,64
89,8478440,Dylan Strome,C,WSH,27,75,29,35,64
89,8477402,Pavel Buchnevich,L,STL,29,78,24,40,64
89,8476905,Chandler Stephenson,C,SEA,30,75,19,45,64
89,8477955,Jared McCann,L,SEA,28,72,32,31,63
89,8475794,Tyler Seguin,C,DAL,32,82,31,32,63
89,8480208,Drake Batherson,R,OTT,26,81,29,34,63
89,8482745,Mason McTavish,C,ANA,21,76,34,28,62
89,8475913,Mark Stone,R,VGK,32,71,27,35,62
89,8475170,Brayden Schenn,C,STL,33,75,27,35,62
89,8476881,Tomas Hertl,C,VGK,31,76,32,29,61
89,8478444,Brock Boeser,R,VAN,27,73,27,34,61
89,8482699,Dylan Guenther,R,UTA,21,77,26,35,61
89,8478438,Tommy Novak,C,NSH,27,71,25,36,61
89,8479675,Trevor Moore,L,LAK,29,82,24,37,61
89,8475184,Chris Kreider,L,NYR,33,74,33,27,60
89,8474600,Roman Josi,D,NSH,34,74,13,47,60
89,8475151,Kyle Palmieri,C,NYI,33,78,30,29,59
89,8478401,Pavel Zacha,C,BOS,27,80,25,34,59
89,8477451,Ryan Hartman,R,MIN,30,74,20,39,59
89,8477447,Shea Theodore,D,VGK,29,66,11,48,59
89,8476853,Morgan Rielly,D,TOR,30,76,5,54,59
89,8475810,Bryan Rust,R,PIT,32,73,32,26,58
89,8482665,Matty Beniers,C,SEA,22,75,25,33,58
89,8478439,Travis Konecny,R,PHI,27,76,22,36,58
89,8475692,Mats Zuccarello,R,MIN,37,68,14,44,58
89,8474141,Patrick Kane,R,DET,36,78,26,31,57
89,8478414,Timo Meier,R,NJD,28,74,26,31,57
89,8479999,Casey Mittelstadt,C,COL,26,82,25,32,57
89,8479325,Charlie McAvoy,D,BOS,27,73,11,46,57
89,8475726,Tyler Toffoli,C,SJS,32,67,30,26,56
89,8475158,Ryan O'Reilly,C,NSH,33,68,27,29,56
89,8477494,Jonathan Drouin,L,COL,29,79,18,38,56
89,8475169,Evander Kane,L,EDM,33,73,35,20,55
89,8477444,Andre Burakovsky,L,SEA,29,75,33,22,55
89,8478047,Michael Bunting,L,PIT,29,73,28,27,55
89,8477497,Sean Monahan,C,CBJ,30,69,26,29,55
89,8474679,Gustav Nyquist,C,NSH,35,74,19,36,55
89,8477504,Josh Morrissey,D,WPG,29,73,10,45,55
89,8476432,Boone Jenner,C,CBJ,31,72,27,27,54
89,8476880,Tom Wilson,R,WSH,30,70,25,29,54
89,8476448,William Karlsson,C,VGK,31,78,22,32,54
89,8473994,Jamie Benn,L,DAL,35,82,20,34,54
89,8481618,Alex Newhook,C,MTL,23,76,18,36,54
89,8475167,Victor Hedman,D,TBL,34,77,13,41,54
89,8481711,Matias Maccelli,L,UTA,24,73,13,41,54
89,8477476,Artturi Lehkonen,L,COL,29,81,30,23,53
89,8483808,Andrei Kuzmenko,L,CGY,28,79,30,23,53
89,8480039,Martin Necas,C,CAR,25,72,24,29,53
89,8482667,William Eklund,L,SJS,22,70,23,30,53
89,8482124,Quinton Byfield,R,LAK,22,79,20,33,53
89,8477416,Oliver Bjorkstrand,R,SEA,29,73,19,34,53
89,8480803,Evan Bouchard,D,EDM,25,69,10,43,53
89,8482684,Luke Hughes,D,NJD,21,71,9,44,53
89,8479400,Pierre-Luc Dubois,L,WSH,26,69,26,26,52
89,8477935,Sam Bennett,C,FLA,28,72,26,26,52
89,8477500,Bo Horvat,C,NYI,29,78,25,27,52
89,8481540,Cole Caufield,R,MTL,23,70,25,27,52
89,8483515,Juraj Slafkovsky,L,MTL,20,74,24,28,52
89,8477426,Nicholas Paul,L,TBL,29,81,24,28,52
89,8477940,Nikolaj Ehlers,L,WPG,28,72,23,29,52
89,8478873,Troy Terry,R,ANA,27,70,14,38,52
89,8478038,Devon Toews,D,COL,30,74,14,38,52
89,8474590,John Carlson,D,WSH,34,65,8,44,52
89,8482097,Jack Quinn,R,BUF,23,65,22,29,51
89,8482113,Anton Lundell,C,FLA,23,78,19,32,51
89,8471724,Kris Letang,D,PIT,37,79,17,34,51
89,8477346,MacKenzie Weegar,D,CGY,30,75,12,39,51
89,8480434,Sean Durzi,D,UTA,26,77,11,40,51
89,8476875,Mike Matheson,D,MTL,30,74,7,44,51
89,8478498,Jake DeBrusk,L,VAN,28,72,31,19,50
89,8480014,Gabriel Vilardi,C,WPG,25,71,24,26,50
89,8480028,Morgan Frost,C,PHI,25,76,12,38,50
89,8478396,Noah Hanifin,D,VGK,27,67,10,40,50
89,8476826,Yanni Gourde,C,SEA,33,73,24,25,49
89,8476882,Teuvo Teravainen,C,CHI,30,66,20,29,49
89,8477407,Anthony Duclair,L,NYI,29,78,19,30,49
89,8476906,Shayne Gostisbehere,D,CAR,31,79,12,37,49
89,8475191,Reilly Smith,R,NYR,33,67,22,26,48
89,8475784,Jeff Skinner,C,EDM,32,74,19,29,48
89,8481596,Shane Pinto,C,OTT,24,78,17,31,48
89,8477495,Seth Jones,D,CHI,30,68,16,32,48
89,8482078,Lucas Raymond,L,DET,22,79,14,34,48
89,8476869,Brady Skjei,D,NSH,30,76,14,34,48
89,8481703,Valtteri Puustinen,R,PIT,25,66,9,39,48
89,8480015,Owen Tippett,R,PHI,25,76,25,22,47
89,8476474,Stefan Noesen,R,NJD,31,61,23,24,47
89,8474150,Mikael Backlund,C,CGY,35,77,22,25,47
89,8477964,Ivan Barbashev,C,VGK,29,76,22,25,47
89,8479987,Morgan Geekie,C,BOS,26,73,17,30,47
89,8482110,Dawson Mercer,C,NJD,23,70,29,17,46
89,8477479,Tyler Bertuzzi,L,CHI,29,67,25,21,46
89,8478466,Daniel Sprong,R,VAN,27,67,24,22,46
89,8475848,Brendan Gallagher,R,MTL,32,75,21,25,46
89,8479345,Jakob Chychrun,D,WSH,26,66,19,27,46
89,8477511,Anthony Mantha,R,CGY,30,72,19,27,46
89,8476479,Phillip Danault,C,LAK,31,79,14,32,46
89,8473986,Alex Killorn,L,ANA,35,72,13,33,46
89,8470613,Brent Burns,D,CAR,39,75,10,36,46
89,8478233,Andrew Mangiapane,L,WSH,28,67,19,26,45
89,8476458,Ryan Strome,C,ANA,31,76,14,31,45
89,8482720,Matthew Knies,L,TOR,22,78,10,35,45
89,8475714,Calle Jarnkrok,C,TOR,33,75,27,17,44
89,8480064,Josh Norris,C,OTT,25,79,24,20,44
89,8476483,Rickard Rakell,R,PIT,31,67,24,20,44
89,8475287,Erik Haula,L,NJD,33,76,21,23,44
89,8479339,Patrik Laine,L,CBJ,26,67,18,26,44
89,8477456,J.T. Compher,L,DET,29,80,17,27,44
89,8480829,Jesperi Kotkaniemi,C,CAR,24,72,17,27,44
89,8477986,Brandon Montour,D,SEA,30,74,13,31,44
89,8478469,Thomas Chabot,D,OTT,27,75,11,33,44
89,8482109,Alexis Lafrenière,L,NYR,23,76,23,20,43
89,8478542,Evan Rodrigues,C,FLA,31,78,23,20,43
89,8476419,Jean-Gabriel Pageau,C,NYI,32,75,20,23,43
89,8481068,Yegor Sharangovich,C,CGY,26,77,17,26,43
89,8475753,Justin Faulk,D,STL,32,72,13,30,43
89,8482105,Jake Sanderson,D,OTT,22,75,12,31,43
89,8481546,Cam York,D,PHI,23,71,8,35,43
89,8475314,Anders Lee,L,NYI,34,78,27,15,42
89,8475793,Ryan Johansen,C,PHI,32,79,22,20,42
89,8478463,Anthony Beauvillier,L,PIT,27,72,22,20,42
89,8475722,Jason Zucker,L,BUF,32,69,18,24,42
89,8478474,Lawson Crouse,L,UTA,27,76,17,25,42
89,8477932,Aaron Ekblad,D,FLA,28,71,14,28,42
89,8475763,Kevin Hayes,R,PIT,32,70,13,29,42
89,8482671,Owen Power,D,BUF,22,62,9,33,42
89,8484153,Leo Carlsson,C,ANA,20,74,9,33,42
89,8476958,Jaccob Slavin,D,CAR,30,72,5,37,42
89,8474563,Drew Doughty,D,LAK,35,77,13,28,41
89,8476792,Torey Krug,D,STL,33,72,8,33,41
89,8478055,Gustav Forsling,D,FLA,28,72,6,35,41
89,8482475,Yegor Chinakhov,R,CBJ,23,66,21,19,40
89,8482702,Logan Stankoven,C,DAL,21,79,19,21,40
89,8478042,Viktor Arvidsson,L,EDM,31,72,18,22,40
89,8481554,Kaapo Kakko,R,NYR,23,73,18,22,40
89,8476872,Scott Laughton,C,PHI,30,73,16,24,40
89,8474102,David Perron,L,OTT,36,75,13,27,40
89,8478115,Pierre Engvall,L,NYI,28,76,27,12,39
89,8480797,Joel Farabee,L,PHI,24,72,20,19,39
89,8476399,Blake Coleman,C,CGY,33,77,19,20,39
89,8482133,Thomas Bordeleau,C,SJS,22,64,14,25,39
89,8474053,Logan Couture,C,SJS,35,61,13,26,39
89,8474716,Jared Spurgeon,D,MIN,35,78,11,28,39
89,8476917,Adam Pelech,D,NYI,30,80,11,28,39
89,8481581,Thomas Harley,D,DAL,23,75,8,31,39
89,8478519,Anthony Cirelli,C,TBL,27,81,20,18,38
89,8477429,Andrew Copp,C,DET,30,77,17,21,38
89,8481533,Trevor Zegras,C,ANA,23,72,15,23,38
89,8480113,Alex Iafallo,L,WPG,31,68,15,23,38
89,8481577,Philip Tomasino,C,NSH,23,67,14,24,38
89,8481524,Bowen Byram,D,BUF,23,72,14,24,38
89,8480078,Filip Chytil,C,NYR,25,72,13,25,38
89,8480802,Ryan McLeod,C,BUF,25,65,13,25,38
89,8480798,Philipp Kurashev,C,CHI,25,66,12,26,38
89,8477498,Darnell Nurse,D,EDM,29,74,10,28,38
89,8475218,Mattias Ekholm,D,EDM,34,73,9,29,38
89,8476462,Dougie Hamilton,D,NJD,31,64,8,30,38
89,8479410,Mikhail Sergachev,D,UTA,26,78,6,32,38
89,8478500,Ivan Provorov,D,CBJ,27,78,6,32,38
89,8480009,Eeli Tolvanen,R,SEA,25,73,18,19,37
89,8481186,Logan O'Connor,R,COL,28,80,18,19,37
89,8476480,Vladislav Namestnikov,C,WPG,32,61,16,21,37
89,8478856,Conor Garland,R,VAN,28,71,15,22,37
89,8477021,Alex Kerfoot,C,UTA,30,76,14,23,37
89,8474565,Alex Pietrangelo,D,VGK,34,66,10,27,37
89,8480185,Eetu Luostarinen,C,FLA,26,73,10,27,37
89,8476885,Jacob Trouba,D,NYR,30,75,9,28,37
89,8484166,Adam Fantilli,C,CBJ,20,68,8,29,37
89,8474586,Jordan Eberle,R,SEA,34,69,7,30,37
89,8478366,Frank Vatrano,R,ANA,30,74,19,17,36
89,8483431,Logan Cooley,C,UTA,20,74,17,19,36
89,8480835,Jack Drury,C,CAR,24,63,16,20,36
89,8482149,Cole Perfetti,C,WPG,22,67,15,21,36
89,8475768,Jaden Schwartz,C,SEA,32,71,13,23,36
89,8478462,Nicolas Roy,C,VGK,27,78,12,24,36
89,8483490,Pavel Mintyukov,D,ANA,21,75,12,24,36
89,8480145,Neal Pionk,D,WPG,29,68,7,29,36
89,8480336,Sean Walker,D,CAR,30,70,7,29,36
89,8475764,Cam Fowler,D,ANA,33,72,4,32,36
89,8471698,T.J. Oshie,R,WSH,38,63,18,17,35
89,8479992,Michael Rasmussen,C,DET,25,80,14,21,35
89,8482146,Luke Evangelista,R,NSH,22,66,14,21,35
89,8476392,Adam Lowry,C,WPG,31,66,13,22,35
89,8479425,Filip Hronek,D,VAN,27,74,11,24,35
89,8482712,Oskar Olausson,R,COL,22,79,9,26,35
89,8477478,William Carrier,L,CAR,30,65,18,16,34
89,8482159,Tyson Foerster,R,PHI,22,75,17,17,34
89,8480849,Barrett Hayton,C,UTA,24,72,17,17,34
89,8476292,Ondrej Palat,L,NJD,33,70,10,24,34
89,8475220,Marcus Foligno,L,MIN,33,63,9,25,34
89,8482122,Brock Faber,D,MIN,22,76,8,26,34
89,8480817,K'Andre Miller,D,NYR,24,74,7,27,34
89,8482705,Cole Sillinger,C,CBJ,21,65,20,13,33
89,8480188,Fabian Zetterlund,L,SJS,25,72,17,16,33
89,8476981,Josh Anderson,R,MTL,30,74,16,17,33
89,8479525,Ross Colton,C,COL,28,80,14,19,33
89,8478057,Dakota Joshua,C,VAN,28,73,12,21,33
89,8480003,Jesper Boqvist,C,FLA,26,66,12,21,33
89,8476927,Teddy Blueger,C,VAN,30,71,8,25,33
89,8476854,Hampus Lindholm,D,BOS,30,74,7,26,33
89,8478397,Rasmus Andersson,D,CGY,28,72,4,29,33
89,8475799,Nino Niederreiter,R,WPG,32,71,20,12,32
89,8482125,Alexander Holtz,R,VGK,22,72,17,15,32
89,8479351,Sam Steel,C,DAL,26,80,16,16,32
89,8475760,Nick Bjugstad,C,UTA,32,73,12,20,32
89,8476461,Sean Couturier,C,PHI,32,68,12,20,32
89,8475791,Taylor Hall,L,CHI,33,56,11,21,32
89,8478413,Jordan Greenway,L,BUF,27,65,10,22,32
89,8476902,Esa Lindell,D,DAL,30,76,7,25,32
89,8480893,Kirill Marchenko,R,CBJ,24,61,19,12,31
89,8476438,Brandon Saad,L,STL,32,73,16,15,31
89,8484203,Bradly Nadeau,L,CAR,19,57,14,17,31
89,8484145,Zach Benson,L,BUF,19,68,12,19,31
89,8474149,Evgenii Dadonov,R,DAL,35,79,12,19,31
89,8478472,Mathieu Joseph,R,STL,27,71,12,19,31
89,8482092,Ridly Greig,C,OTT,22,76,10,21,31
89,8477948,Travis Sanheim,D,PHI,28,69,9,22,31
89,8479365,Trent Frederic,C,BOS,26,72,8,23,31
89,8482660,Kent Johnson,C,CBJ,22,63,6,25,31
89,8475200,Dmitry Orlov,D,CAR,33,76,2,29,31
89,8481624,Ilya Mikheyev,R,CHI,30,62,16,14,30
89,8482055,Drew O'Connor,L,PIT,26,56,15,15,30
89,8474715,Cameron Atkinson,R,TBL,35,81,15,15,30
89,8478020,Michael Amadio,R,OTT,28,73,15,15,30
89,8479996,Cody Glass,C,NSH,25,51,12,18,30
89,8479390,Taylor Raddysh,R,WSH,26,65,12,18,30
89,8476925,Colton Sissons,C,NSH,31,63,11,19,30
89,8478046,Danton Heinen,L,VAN,29,70,11,19,30
89,8480144,David Kampf,C,TOR,29,67,7,23,30
89,8476923,Damon Severson,D,CBJ,30,79,6,24,30
89,8474673,TJ Brodie,D,CHI,34,67,3,27,30
89,8480855,Jack McBain,C,UTA,24,66,15,14,29
89,8481604,Pavel Dorofeyev,L,VGK,24,71,14,15,29
89,8477987,Ryan Donato,C,CHI,28,54,13,16,29
89,8479591,Michael Eyssimont,C,TBL,28,79,12,17,29
89,8475343,Nic Dowd,C,WSH,34,64,11,18,29
89,8474641,Adam Henrique,C,EDM,34,76,10,19,29
89,8480220,Noah Cates,L,PHI,25,67,8,21,29
89,8477488,Brett Pesce,D,NJD,30,71,5,24,29
89,8481582,Nicholas Robertson,L,TOR,23,68,16,12,28
89,8476469,Joel Armia,R,MTL,31,71,16,12,28
89,8477425,Miles Wood,L,COL,29,74,14,14,28
89,8478109,Victor Olofsson,L,VGK,29,72,13,15,28
89,8477505,Alexander Wennberg,C,SJS,30,63,12,16,28
89,8475193,Tomas Tatar,L,NJD,34,71,11,17,28
89,8473422,Nick Foligno,L,CHI,37,52,9,19,28
89,8481522,Peyton Krebs,C,BUF,23,57,9,19,28
89,8478133,Jake Evans,C,MTL,28,67,7,21,28
89,8481542,Moritz Seider,D,DET,23,76,6,22,28
89,8475181,Nick Leddy,D,STL,33,69,3,25,28
89,8477220,Nate Schmidt,D,FLA,33,72,2,26,28
89,8482089,Jake Neighbours,L,STL,22,62,18,9,27
89,8478432,Christian Fischer,R,DET,27,77,12,15,27
89,8475149,Marcus Johansson,L,MIN,34,66,11,16,27
89,8483505,Matthew Poitras,C,BOS,20,74,9,18,27
89,8478458,John (Jack) Roslovic,C,CAR,27,59,8,19,27
89,8481606,Jordan Spence,D,LAK,23,66,7,20,27
89,8480043,Timothy Liljegren,D,TOR,25,60,5,22,27
89,8474574,Tyler Myers,D,VAN,34,71,4,23,27
89,8477969,Marcus Pettersson,D,PIT,28,79,2,25,27
89,8477952,Robby Fabbri,C,ANA,28,61,14,12,26
89,8476918,Jimmy Vesey,L,NYR,31,69,14,12,26
89,8482111,Justin Barron,D,MTL,23,63,13,13,26
89,8482062,Cole Smith,L,NSH,29,66,12,14,26
89,8481523,Kirby Dach,C,MTL,23,63,11,15,26
89,8483457,Lane Hutson,D,MTL,20,63,9,17,26
89,8477435,Ryan Graves,D,PIT,29,79,5,21,26
89,8476463,Jonas Brodin,D,MIN,31,76,5,21,26
89,8474151,Ryan McDonagh,D,TBL,35,79,3,23,26
89,8476979,Erik Gustafsson,D,DET,32,76,3,23,26
89,8479398,Samuel Girard,D,COL,26,66,3,23,26
89,8479941,Justin Danforth,R,CBJ,31,60,14,11,25
89,8479414,Nathan Bastian,R,NJD,27,61,13,12,25
89,8480459,Pius Suter,C,VAN,28,64,12,13,25
89,8480871,Adam Boqvist,D,FLA,24,62,12,13,25
89,8479393,Noah Gregor,L,OTT,26,75,12,13,25
89,8483468,Jiri Kulich,C,BUF,20,58,12,13,25
89,8480068,Ryan Poehling,C,PHI,25,67,11,14,25
89,8476921,Jordan Martinook,L,CAR,32,61,11,14,25
89,8482749,Joshua Roy,R,MTL,21,58,10,15,25
89,8477947,Sonny Milano,L,WSH,28,69,9,16,25
89,8479353,Brett Howden,C,VGK,26,69,9,16,25
89,8481481,Blake Lizotte,C,PIT,27,60,9,16,25
89,8482624,Daniil Miromanov,D,CGY,27,64,8,17,25
89,8483445,Cutter Gauthier,L,ANA,20,64,7,18,25
89,8478970,Jalen Chatfield,D,CAR,28,74,7,18,25
89,8475171,Oliver Ekman-Larsson,D,TOR,33,69,6,19,25
89,8480873,Rasmus Sandin,D,WSH,24,61,3,22,25
89,8475790,Erik Gudbranson,D,CBJ,32,77,3,22,25
89,8477365,Connor Clifton,D,BUF,29,59,3,22,25
89,8482655,Janis Moser,D,TBL,24,77,2,23,25
89,8481580,Connor McMichael,C,WSH,23,67,13,11,24
89,8479661,Tanner Jeannot,L,LAK,27,77,12,12,24
89,8481560,Arthur Kaliyev,R,LAK,23,76,11,13,24
89,8477953,Kasperi Kapanen,R,STL,28,66,11,13,24
89,8480748,Kiefer Sherwood,L,VAN,29,61,11,13,24
89,8477406,Mattias Janmark,C,EDM,32,66,11,13,24
89,8482117,Lukas Reichel,L,CHI,22,55,9,15,24
89,8476856,Mathew Dumba,D,DAL,30,74,8,16,24
89,8478507,John Marino,D,UTA,27,68,6,18,24
89,8482142,Jamie Drysdale,D,PHI,22,61,6,18,24
89,8478882,Vladislav Gavrikov,D,LAK,29,68,3,21,24
89,8482079,Marco Rossi,C,MIN,23,53,17,6,23
89,8478013,Jake Walman,D,SJS,28,72,13,10,23
89,8482175,JJ Peterka,R,BUF,22,68,12,11,23
89,8481019,David Gustafsson,C,WPG,24,47,10,13,23
89,8481093,Rafael Harvey-Pinard,L,MTL,25,58,9,14,23
89,8482809,Jackson Blake,R,CAR,21,54,9,14,23
89,8479639,Dylan Coghlan,D,WPG,26,68,6,17,23
89,8476312,Josh Manson,D,COL,33,56,6,17,23
89,8475179,Dmitry Kulikov,D,FLA,34,63,5,18,23
89,8476892,Colton Parayko,D,STL,31,67,5,18,23
89,8479982,Conor Timmins,D,TOR,26,57,5,18,23
89,8478452,Caleb Jones,D,LAK,27,59,5,18,23
89,8476467,Jamie Oleksiak,D,SEA,32,62,4,19,23
89,8476331,Dylan DeMelo,D,WPG,31,67,4,19,23
89,8480860,Kevin Bahl,D,CGY,24,60,4,19,23
89,8480878,Nils Lundkvist,D,DAL,24,71,3,20,23
89,8476429,Scott Mayfield,D,NYI,32,72,3,20,23
89,8479983,Mario Ferraro,D,SJS,26,71,3,20,23
89,8478840,Will Borgen,D,SEA,28,67,3,20,23
89,8477446,Michael McCarron,R,NSH,29,61,16,6,22
89,8482074,Connor Zary,C,CGY,23,62,15,7,22
89,8473533,Jordan Staal,C,CAR,36,58,14,8,22
89,8481477,Nico Sturm,C,SJS,29,62,14,8,22
89,8477839,Conor Sheary,L,TBL,32,80,14,8,22
89,8479293,Brandon Tanev,L,SEA,33,63,13,9,22
89,8481517,Brett Leason,R,ANA,25,60,13,9,22
89,8478043,Sam Lafferty,C,BUF,29,62,13,9,22
89,8476278,Colin Blackwell,C,DAL,31,79,12,10,22
89,8480789,Oliver Wahlstrom,R,NYI,24,71,10,12,22
89,8483499,Liam Ohgren,L,MIN,20,51,9,13,22
89,8482803,Olen Zellweger,D,ANA,21,71,9,13,22
89,8477979,Nicolas Aube-Kubel,R,BUF,28,57,8,14,22
89,8477369,Carson Soucy,D,VAN,30,62,7,15,22
89,8477507,Nikita Zadorov,D,BOS,29,64,7,15,22
89,8482634,Alex Steeves,C,TOR,25,48,6,16,22
89,8476897,Oskar Sundqvist,C,STL,30,65,5,17,22
89,8479976,Juuso Valimaki,D,UTA,26,64,5,17,22
89,8476879,Cody Ceci,D,EDM,31,72,5,17,22
89,8483565,Nick Blankenburg,D,NSH,26,56,4,18,22
89,8482067,Connor Mackey,D,NYR,28,53,4,18,22
89,8479324,Ryan Lindgren,D,NYR,26,66,4,18,22
89,8477392,Hudson Fasching,R,NYI,29,69,3,19,22
89,8478136,Jake Middleton,D,MIN,28,75,2,20,22
89,8482259,Bobby McMann,C,TOR,28,52,13,8,21
89,8481601,Simon Holmstrom,R,NYI,23,71,12,9,21
89,8484149,Gavin Brindley,C,CBJ,20,46,11,10,21
89,8475855,Jesper Fast,R,CAR,33,57,11,10,21
89,8479718,Alex Barré-Boulet,C,MTL,27,57,11,10,21
89,8479368,Max Jones,L,BOS,26,63,10,11,21
89,8477353,Tyler Motte,C,DET,29,74,10,11,21
89,8477919,Frederick Gaudreau,C,MIN,31,62,9,12,21
89,8481553,Bobby Brink,R,PHI,23,60,7,14,21
89,8475231,Casey Cizikas,C,NYI,33,68,7,14,21
89,8481014,Alexander Romanov,D,NYI,24,75,2,19,21
89,8476931,Jake McCabe,D,TOR,31,66,2,19,21
89,8477506,Ryan Pulock,D,NYI,30,80,2,19,21
89,8479998,Mikey Anderson,D,LAK,25,65,2,19,21
89,8483524,Shane Wright,C,SEA,20,57,11,9,20
89,8470621,Corey Perry,R,EDM,39,65,11,9,20
89,8480813,Joe Veleno,C,DET,24,77,9,11,20
89,8481704,Juuso Parssinen,C,NSH,23,53,9,11,20
89,8475208,Brian Dumoulin,D,ANA,33,64,6,14,20
89,8482101,Danil Gushchin,L,SJS,22,58,4,16,20
89,8480073,Erik Brannstrom,D,COL,25,61,4,16,20
89,8477508,Curtis Lazar,C,NJD,29,54,4,16,20
89,8482245,Artem Zub,D,OTT,29,70,2,18,20
89,8479980,Nicolas Hague,D,VGK,26,53,2,18,20
89,8480035,Henri Jokiharju,D,BUF,25,61,2,18,20
89,8478911,Matt Roy,D,WSH,29,63,0,20,20
89,8480074,Alexandre Texier,C,STL,25,55,12,7,19
89,8481535,Nils Hoglander,L,VAN,24,60,10,9,19
89,8476374,Sean Kuraly,C,CBJ,31,61,9,10,19
89,8482155,Alex Laferriere,R,LAK,23,68,9,10,19
89,8481521,Ronnie Attard,D,PHI,25,49,9,10,19
89,8478891,Mason Appleton,C,WPG,28,63,8,11,19
89,8478569,Noel Acciari,C,PIT,33,58,8,11,19
89,8481013,Jonatan Berggren,R,DET,24,60,8,11,19
89,8478851,Alexandre Carrier,D,NSH,28,71,4,15,19
89,8481441,Joe Snively,C,DET,28,64,4,15,19
89,8480070,Ian Mitchell,D,BOS,25,57,4,15,19
89,8480246,Nick Perbix,D,TBL,26,78,3,16,19
89,8482087,Kaiden Guhle,D,MTL,22,69,2,17,19
89,8478178,Darren Raddysh,D,TBL,28,68,2,17,19
89,8480205,Emil Bemstrom,C,PIT,25,54,13,5,18
89,8480980,Connor Dewar,C,TOR,25,69,11,7,18
89,8481032,Paul Cotter,C,NJD,25,62,11,7,18
89,8482679,Matt Coronato,R,CGY,22,68,11,7,18
89,8473453,Trevor Lewis,C,LAK,37,72,10,8,18
89,8483491,Ivan Miroshnichenko,L,WSH,20,55,8,10,18
89,8476878,Zemgus Girgensons,C,TBL,30,78,8,10,18
89,8470600,Ryan Suter,D,STL,39,67,8,10,18
89,8480252,Cole Guttman,C,CHI,25,42,7,11,18
89,8476960,Andreas Athanasiou,C,CHI,30,51,7,11,18
89,8475188,Brayden McNabb,D,VGK,33,51,5,13,18
89,8479315,Joey Anderson,R,CHI,26,51,5,13,18
89,8476422,Mike Reilly,D,NYI,31,78,3,15,18
89,8478416,Erik Cernak,D,TBL,27,75,2,16,18
89,8482073,Braden Schneider,D,NYR,23,60,2,16,18
89,8480807,Mattias Samuelsson,D,BUF,24,56,1,17,18
89,8478508,Yakov Trenin,C,MIN,27,56,14,3,17
89,8479316,Luke Kunin,C,SJS,27,57,10,7,17
89,8482077,Dylan Holloway,L,EDM,23,47,10,7,17
89,8480025,MacKenzie Entwistle,R,FLA,25,68,9,8,17
89,8474189,Lars Eller,C,PIT,35,61,8,9,17
89,8478451,Ethan Bear,D,WSH,27,54,8,9,17
89,8481656,Aliaksei Protas,C,WSH,23,56,7,10,17
89,8476822,Luke Glendening,C,TBL,35,76,7,10,17
89,8476889,Radek Faksa,C,STL,30,53,7,10,17
89,8476994,Vinnie Hinostroza,C,NSH,30,57,7,10,17
89,8480001,Urho Vaakanainen,D,ANA,25,59,6,11,17
89,8480806,Isac Lundestrom,C,ANA,25,61,5,12,17
89,8477989,Christian Dvorak,C,MTL,28,62,4,13,17
89,8482148,Hendrix Lapierre,C,WSH,22,55,3,14,17
89,8479371,Dante Fabbro,D,NSH,26,64,2,15,17
89,8473507,Jeff Petry,D,DET,37,65,2,15,17
89,8480891,Michael Kesselring,D,UTA,24,54,2,15,17
89,8474568,Luke Schenn,D,NSH,35,42,2,15,17
89,8479968,Vinni Lettieri,C,BOS,29,48,11,5,16
89,8480355,Mark Kastelic,C,BOS,25,59,11,5,16
89,8480281,Alexey Toropchenko,R,STL,25,57,10,6,16
89,8476873,Mark Jankowski,C,NSH,30,50,8,8,16
89,8477380,Jonny Brodzinski,C,NYR,31,52,7,9,16
89,8477450,Jason Dickinson,C,CHI,29,53,7,9,16
89,8477015,Connor Brown,R,EDM,30,63,7,9,16
89,8479370,Tyson Jost,C,CAR,26,51,7,9,16
89,8477931,Tomas Nosek,L,FLA,32,53,7,9,16
89,8476329,Travis Boyd,C,MIN,31,47,6,10,16
89,8482730,Brandt Clarke,D,LAK,21,44,6,10,16
89,8482451,Mikael Pyyhtia,L,CBJ,23,40,5,11,16
89,8475718,Justin Holl,D,DET,32,66,5,11,16
89,8480058,Pierre-Olivier Joseph,D,STL,25,63,5,11,16
89,8476988,Matt Benning,D,SJS,30,66,2,14,16
89,8479402,Jake Bean,D,CGY,26,69,1,15,16
89,8481568,Alex Vlasic,D,CHI,23,53,1,15,16
89,8475233,David Savard,D,MTL,34,59,0,16,16
89,8480995,Pontus Holmberg,R,TOR,25,63,10,5,15
89,8479619,Michael Carcone,L,UTA,28,60,9,6,15
89,8477573,Nathan Walker,L,STL,30,49,8,7,15
89,8479066,Ryan Lomberg,L,CGY,30,68,8,7,15
89,8480448,Parker Kelly,L,COL,25,77,7,8,15
89,8481716,Dmitri Voronkov,L,CBJ,24,44,7,8,15
89,8480289,Morgan Barron,C,WPG,26,53,6,9,15
89,8482166,Shakir Mukhamadullin,D,SJS,22,59,6,9,15
89,8479543,Michael Pezzetta,L,MTL,26,59,5,10,15
89,8476525,Colin Miller,D,WPG,32,69,4,11,15
89,8480157,Calle Rosen,D,COL,30,45,4,11,15
89,8480172,Jan Rutta,D,SJS,34,59,3,12,15
89,8478859,Niko Mikkola,D,FLA,28,68,2,13,15
89,8478399,Jonas Siegenthaler,D,NJD,27,66,2,13,15
89,8480222,Sebastian Aho,D,PIT,28,70,1,14,15
89,8482659,Josh Doan,R,UTA,22,54,11,3,14
89,8479359,Beck Malenstyn,L,BUF,26,43,8,6,14
89,8483493,Frank Nazar,C,CHI,20,56,8,6,14
89,8482762,Simon Edvinsson,D,DET,21,56,7,7,14
89,8475225,Craig Smith,C,CHI,35,53,7,7,14
89,8477499,Rasmus Ristolainen,D,PHI,30,58,6,8,14
89,8474034,Patrick Maroon,L,CHI,36,48,6,8,14
89,8476858,Phillip Di Giuseppe,L,VAN,31,45,5,9,14
89,8481537,Nikita Okhotiuk,D,CGY,24,48,4,10,14
89,8482192,Isaak Phillips,D,CHI,23,55,4,10,14
89,8478211,Dryden Hunt,L,CGY,29,63,4,10,14
89,8473446,Erik Johnson,D,PHI,36,47,3,11,14
89,8482666,Scott Morrow,D,CAR,22,46,9,4,13
89,8482964,Arber Xhekaj,D,MTL,23,50,8,5,13
89,8479520,Brandon Duhaime,R,WSH,27,55,6,7,13
89,8475842,Sam Carrick,C,NYR,32,59,6,7,13
89,8481641,Joel Kiviranta,L,COL,28,73,6,7,13
89,8481617,Vasily Podkolzin,R,VAN,23,46,6,7,13
89,8481518,Nolan Foote,L,NJD,24,43,5,8,13
89,8479328,Julien Gauthier,R,NYI,27,56,5,8,13
89,8480796,Martin Fehervary,D,WSH,25,58,4,9,13
89,8479671,Mathieu Olivier,R,CBJ,27,43,4,9,13
89,8479026,Philippe Myers,D,TOR,27,55,4,9,13
89,8481550,Adam Beckman,L,NJD,23,41,3,10,13
89,8481167,Brayden Pachal,D,CGY,25,38,3,10,13
89,8477018,Ben Hutton,D,VGK,31,42,2,11,13
89,8483460,David Jiricek,D,CBJ,21,57,1,12,13
89,8479291,Kevin Rooney,C,CGY,31,46,1,12,13
89,8476874,Olli Maatta,D,DET,30,62,1,12,13
89,8482737,Zack Bolduc,C,STL,21,57,8,4,12
89,8481532,Alex Turcotte,C,LAK,23,45,8,4,12
89,8481751,Lukas Rousek,R,BUF,25,45,8,4,12
89,8478831,Kevin Stenlund,C,UTA,28,55,7,5,12
89,8478434,Keegan Kolesar,R,VGK,27,63,6,6,12
89,8480011,Klim Kostin,C,SJS,25,54,6,6,12
89,8478585,Derek Ryan,C,EDM,38,69,6,6,12
89,8480762,Eric Robinson,L,CAR,29,54,6,6,12
89,8481028,Martin Pospisil,C,CGY,25,49,5,7,12
89,8475324,Nick Jensen,D,OTT,34,64,3,9,12
89,8476457,Adam Larsson,D,SEA,32,66,2,10,12
89,8481527,Kaedan Korczak,D,VGK,23,45,2,10,12
89,8480950,Ilya Lyubushkin,D,DAL,30,62,1,11,12
89,8474567,Zach Bogosian,D,MIN,34,59,1,11,12
89,8481599,Victor Soderstrom,D,UTA,23,40,1,11,12
89,8476891,Matthew Grzelcyk,D,PIT,30,75,0,12,12
89,8481059,Scott Perunovich,D,STL,26,55,0,12,12
89,8482784,Zach Dean,C,STL,21,41,9,2,11
89,8482807,Ethan Del Mastro,D,CHI,21,52,7,4,11
89,8476934,Brock McGinn,L,ANA,30,48,7,4,11
89,8479336,Carl Grundstrom,R,SJS,27,50,6,5,11
89,8481754,Nikita Nesterenko,C,ANA,23,42,6,5,11
89,8477070,Liam O'Brien,C,UTA,30,50,5,6,11
89,8479994,Jaret Anderson-Dolan,C,WPG,25,39,5,6,11
89,8477903,Garnet Hathaway,R,PHI,33,61,4,7,11
89,8473563,Nicklas Backstrom,C,WSH,37,43,3,8,11
89,8479344,Jesse Puljujarvi,R,PIT,26,54,3,8,11
89,8482859,Zack Ostapchuk,C,OTT,21,51,3,8,11
89,8480727,Zach Whitecloud,D,VGK,28,47,2,9,11
89,8475690,Chris Tanev,D,TOR,35,55,0,11,11
89,8481789,Tye Kartye,L,SEA,23,38,7,3,10
89,8476442,Matt Nieto,L,PIT,32,43,6,4,10
89,8480441,Trey Fix-Wolansky,R,CBJ,25,39,6,4,10
89,8477962,Brendan Lemieux,L,CAR,28,45,6,4,10
89,8477401,John Hayden,C,SEA,29,35,6,4,10
89,8482744,James Malatesta,L,CBJ,21,45,5,5,10
89,8478443,Brandon Carlo,D,BOS,28,54,5,5,10
89,8479536,Axel Jonsson-Fjallby,L,WPG,26,34,5,5,10
89,8482157,Will Cuylle,L,NYR,22,59,5,5,10
89,8482733,Logan Mailloux,D,MTL,31,39,5,5,10
89,8477482,Zachary Sanford,L,CHI,30,37,5,5,10
89,8479944,Zach Aston-Reese,C,VGK,30,54,4,6,10
89,8481701,Santeri Hatakka,D,NJD,23,43,4,6,10
89,8478017,Mark Friedman,D,VAN,29,39,4,6,10
89,8483482,Tristan Luneau,D,ANA,20,62,3,7,10
89,8471817,Ryan Reaves,R,TOR,37,55,3,7,10
89,8482176,Wyatt Kaiser,D,CHI,22,51,2,8,10
89,8480007,Jonas Rondbjerg,R,VGK,25,40,2,8,10
89,8474090,Brendan Smith,D,DAL,35,53,2,8,10
89,8479972,Mason Shaw,C,WPG,26,41,2,8,10
89,8479249,Andrew Poturalski,C,SJS,30,29,2,8,10
89,8479369,Andrew Peeke,D,BOS,26,56,1,9,10
89,8474013,Ian Cole,D,UTA,35,48,1,9,10
89,8475462,Radko Gudas,D,ANA,34,62,0,10,10
89,8477845,Trevor van Riemsdyk,D,WSH,33,59,0,10,10
89,8481178,Egor Zamula,D,PHI,24,62,0,10,10
89,8478409,Anthony Richard,C,PHI,28,37,6,3,9
89,8482496,Nils Aman,C,VAN,24,38,5,4,9
89,8480845,Rasmus Kupari,C,WPG,24,42,4,5,9
89,8479991,Jake Leschyshyn,C,NYR,25,24,4,5,9
89,8476624,Barclay Goodrow,C,SJS,31,46,3,6,9
89,8481592,Jakob Pelletier,L,CGY,23,32,3,6,9
89,8479772,Zack MacEwen,R,OTT,28,50,3,6,9
89,8478468,Jeremy Lauzon,D,NSH,27,57,3,6,9
89,8477851,Jordan Oesterle,D,BOS,32,43,3,6,9
89,8481708,Zac Jones,D,NYR,24,52,2,7,9
89,8481600,Tobias Bjornfot,D,FLA,23,41,2,7,9
89,8481122,Simon Benoit,D,TOR,26,44,2,7,9
89,8476967,Brett Kulak,D,EDM,30,61,1,8,9
89,8475455,Brenden Dillon,D,NJD,34,55,1,8,9
89,8479372,Joshua Mahura,D,SEA,26,47,1,8,9
89,8480049,Dylan Samberg,D,WPG,25,66,0,9,9
89,8480021,Jack Studnicka,C,LAK,25,59,0,9,9
89,8474166,Alec Martinez,D,CHI,37,52,0,9,9
89,8478421,A.J. Greer,L,FLA,28,56,7,1,8
89,8475279,Ben Chiarot,D,DET,33,66,5,3,8
89,8480880,Jakub Lauko,C,MIN,24,35,5,3,8
89,8483495,Simon Nemec,D,NJD,20,51,4,4,8
89,8477938,Haydn Fleury,D,WPG,28,39,4,4,8
89,8483012,Logan Morrison,C,SEA,22,39,4,4,8
89,8471709,Marc-Edouard Vlasic,D,SJS,37,64,3,5,8
89,8481161,Jake Christiansen,D,CBJ,25,60,3,5,8
89,8479348,Kale Clague,D,BUF,26,43,3,5,8
89,8480990,Declan Chisholm,D,MIN,24,51,3,5,8
89,8481567,Henry Thrun,D,SJS,23,45,2,6,8
89,8483466,Kevin Korchinski,D,CHI,20,46,2,6,8
89,8483619,Filip Roos,D,OTT,25,36,1,7,8
89,8480887,Jordan Harris,D,MTL,24,58,1,7,8
89,8475177,Calvin de Haan,D,COL,33,42,1,7,8
89,8482861,Vincent Iorio,D,WSH,22,35,0,8,8
89,8477335,Kyle Burroughs,D,LAK,29,43,0,8,8
89,8480879,Jacob Bernard-Docker,D,OTT,24,42,0,8,8
89,8483549,Lucas Condotta,L,MTL,27,28,0,8,8
89,8479439,Jacob MacDonald,D,COL,31,53,5,2,7
89,8483630,Pavol Regenda,L,ANA,25,29,5,2,7
89,8477887,Patrick Brown,C,BOS,32,50,3,4,7
89,8483397,Marc McLaughlin,C,BOS,25,30,3,4,7
89,8481541,Samuel Bolduc,D,NYI,24,21,3,4,7
89,8476473,Connor Murphy,D,CHI,31,33,2,5,7
89,8484911,Collin Graf,R,SJS,22,42,2,5,7
89,8479378,Logan Stanley,D,WPG,26,42,2,5,7
89,8474612,Travis Hamonic,D,OTT,34,48,1,6,7
89,8479442,Troy Stecher,D,EDM,30,59,1,6,7
89,8476441,Joel Edmundson,D,LAK,31,37,1,6,7
89,8478874,Adam Gaudette,R,OTT,28,25,1,6,7
89,8484254,Akito Hirose,D,VAN,25,40,1,6,7
89,8480196,Jacob Bryson,D,BUF,27,36,0,7,7
89,8482172,Landon Slaggert,L,CHI,22,30,4,2,6
89,8479986,Kole Lind,R,DAL,26,46,4,2,6
89,8479981,Jonah Gadjovich,L,FLA,26,42,3,3,6
89,8481147,Reese Johnson,C,MIN,26,45,3,3,6
89,8482177,Marat Khusnutdinov,C,MIN,22,41,3,3,6
89,8482095,Tyler Kleven,D,OTT,22,42,2,4,6
89,8477034,Jaycob Megna,D,FLA,32,36,2,4,6
89,8480292,Carson Meyer,R,ANA,27,29,2,4,6
89,8475958,Michael Sgarbossa,C,WSH,32,30,2,4,6
89,8480851,Akil Thomas,C,LAK,24,20,2,4,6
89,8475750,Jon Merrill,D,MIN,32,50,1,5,6
89,8480192,Johnathan Kovacevic,D,NJD,27,47,1,5,6
89,8471677,Jack Johnson,D,CBJ,37,62,1,5,6
89,8479576,Vincent Desharnais,D,VAN,28,30,1,5,6
89,8478454,Noah Juulsen,D,VAN,27,34,1,5,6
89,8476372,Nick Seeler,D,PHI,31,37,0,6,6
89,8481605,Jackson LaCombe,D,ANA,23,27,0,6,6
89,8482070,Mitchell Chaffee,R,TBL,26,53,5,0,5
89,8481679,Maxence Guenette,D,OTT,23,39,5,0,5
89,8482652,Walker Duehr,R,CGY,27,46,4,1,5
89,8482144,Jack Thompson,D,SJS,22,19,4,1,5
89,8481609,Vladislav Kolyachonok,D,UTA,23,28,3,2,5
89,8482713,Mackie Samoskevich,R,FLA,22,37,3,2,5
89,8480032,Shane Bowers,C,NJD,25,14,3,2,5
89,8478424,Jansen Harkins,C,ANA,27,34,2,3,5
89,8482511,Mason Lohrei,D,BOS,23,35,2,3,5
89,8481598,Philip Broberg,D,EDM,23,43,2,3,5
89,8480874,Adam Ginning,D,PHI,24,17,2,3,5
89,8480848,Ty Dellandrea,C,SJS,24,34,1,4,5
89,8477384,Joshua Brown,D,EDM,30,40,1,4,5
89,8480834,Ty Emberson,D,SJS,24,37,1,4,5
89,8475762,Derek Forbort,D,VAN,32,44,1,4,5
89,8480084,Nick DeSimone,D,NJD,30,24,0,5,5
89,8477244,Chad Ruhwedel,D,NYR,34,32,0,5,5
89,8478021,William Lagesson,D,DET,28,25,0,5,5
89,8484287,Cole McWard,D,VAN,23,22,4,0,4
89,8480870,Bo Groulx,C,NYR,24,32,3,1,4
89,8480267,Sammy Walker,C,MIN,25,17,3,1,4
89,8482118,Sam Colangelo,R,ANA,23,12,3,1,4
89,8479367,William Lockwood,R,FLA,26,31,3,1,4
89,8481065,Angus Crookshank,L,OTT,25,19,3,1,4
89,8483512,Matthew Savoie,C,EDM,20,25,3,1,4
89,8482147,Jean-Luc Foudy,C,COL,22,23,3,1,4
89,8477473,Justin Bailey,R,SJS,29,27,2,2,4
89,8483763,Maksymilian Szuber,D,UTA,22,34,2,2,4
89,8481543,Nikita Alexandrov,C,STL,24,27,2,2,4
89,8482153,Brendan Brisson,C,VGK,23,27,1,3,4
89,8481056,Spencer Stastney,D,NSH,24,30,1,3,4
89,8482751,Ryan Winterton,C,SEA,21,29,1,3,4
89,8477073,Kurtis MacDermid,L,NJD,30,30,1,3,4
89,8476913,Devin Shore,C,MIN,30,36,1,3,4
89,8477467,Gustav Olofsson,D,SEA,30,20,1,3,4
89,8479587,Rhett Gardner,C,PHI,28,15,1,3,4
89,8484258,Sam Malinski,D,COL,26,26,1,3,4
89,8482858,Ryker Evans,D,SEA,23,30,1,3,4
89,8479638,Justin Brazeau,R,BOS,26,37,3,0,3
89,8480890,Jan Jenik,C,OTT,24,31,3,0,3
89,8475235,Nicolas Deslauriers,L,PHI,33,49,2,1,3
89,8482145,Mavrik Bourque,C,DAL,22,51,2,1,3
89,8481556,John Beecher,C,BOS,23,32,2,1,3
89,8477527,Ross Johnston,L,ANA,30,30,2,1,3
89,8481237,Kyle MacLean,C,NYI,25,26,2,1,3
89,8482747,Brennan Othmann,L,NYR,21,42,1,2,3
89,8483570,Ben Meyers,C,SEA,26,34,1,2,3
89,8476952,Dominic Toninato,C,WPG,30,26,1,2,3
89,8478146,Matthew Highmore,C,OTT,28,33,1,2,3
89,8482201,Gage Goncalves,C,TBL,23,26,1,2,3
89,8480844,Grigori Denisenko,L,VGK,24,25,1,2,3
89,8478051,Max Willman,C,NJD,29,17,1,2,3
89,8482141,Lukas Cormier,D,VGK,22,29,1,2,3
89,8482765,Isak Rosen,R,BUF,21,23,1,2,3
89,8478502,Dennis Gilbert,D,BUF,28,19,1,2,3
89,8481462,Mason Morelli,L,VGK,28,17,1,2,3
89,8479421,Jacob Moverare,D,LAK,26,11,1,2,3
89,8482102,Vasily Ponomarev,C,PIT,22,21,1,2,3
89,8481719,Maxwell Crozier,D,TBL,24,19,1,2,3
89,8479379,Givani Smith,R,SJS,26,30,0,3,3
89,8477462,Robert Hagg,D,VGK,29,26,2,0,2
89,8483395,Arshdeep Bains,L,VAN,23,15,2,0,2
89,8482470,Ilya Solovyov,D,CGY,24,20,2,0,2
89,8478147,Bokondji Imama,L,PIT,28,6,2,0,2
89,8479985,Cale Fleury,D,SEA,26,30,1,1,2
89,8482165,Yan Kuznetsov,D,CGY,22,16,1,1,2
89,8479320,Maxime Lajoie,D,SEA,27,20,1,1,2
89,8481006,Tyler Tucker,D,STL,24,14,1,1,2
89,8483489,Fraser Minten,C,TOR,31,9,1,1,2
89,8478477,Mitchell Stephens,C,SEA,27,21,1,1,2
89,8482094,Daemon Hunt,D,MIN,22,15,1,1,2
89,8476867,Brendan Gaunce,C,MIN,30,32,0,2,2
89,8478450,Parker Wotherspoon,D,BOS,27,36,0,2,2
89,8480245,Olle Lycksell,R,PHI,25,33,0,2,2
89,8481806,Louis Crevier,D,CHI,23,15,0,2,2
89,8477971,Andreas Englund,D,LAK,28,22,0,2,2
89,8481593,Jayden Struble,D,MTL,23,17,0,2,2
89,8482162,Roby Jarventie,L,EDM,22,14,0,2,2
89,8479330,Brandon Gignac,C,MTL,27,4,0,2,2
89,8482250,Callahan Burke,C,VGK,27,20,1,0,1
89,8474062,Riley Nash,C,NYR,35,12,1,0,1
89,8483567,Georgii Merkulov,C,BOS,24,9,1,0,1
89,8475795,Dylan McIlrath,D,WSH,32,14,1,0,1
89,8481206,John Ludvig,D,PIT,24,14,1,0,1
89,8479419,Brett Murray,L,BUF,26,23,1,0,1
89,8484304,Uvis Balinskis,D,FLA,28,7,1,0,1
89,8484325,Waltteri Merela,C,TBL,26,23,1,0,1
89,8483398,Declan Carlile,D,TBL,31,3,1,0,1
89,8481726,Adam Edstrom,C,NYR,24,10,1,0,1
89,8482061,Brandon Biro,L,SEA,26,10,1,0,1
89,8481024,Linus Karlsson,C,VAN,25,10,1,0,1
89,8484321,Nikolas Matinpalo,D,OTT,26,1,1,0,1
89,8477149,Scott Sabourin,R,SJS,32,12,0,1,1
89,8482929,Emil Lilleberg,D,TBL,23,16,0,1,1
89,8481030,Jack St. Ivany,D,PIT,25,14,0,1,1
89,8480823,Alexander Alexeyev,D,WSH,25,14,0,1,1
89,8482516,Matthew Kessel,D,STL,24,13,0,1,1
89,8475413,Justin Dowling,C,NJD,34,10,0,1,1
89,8481585,Egor Afanasyev,L,SJS,23,17,0,1,1
89,8481422,Jake Lucchini,C,NSH,29,21,0,1,1
89,8483920,Pierrick Dube,R,WSH,23,5,0,1,1
89,8478854,Ryan Shea,D,PIT,27,3,0,1,1
89,8481578,Graeme Clarke,R,MIN,23,14,0,1,1
89,8484255,Jason Polin,R,COL,25,5,0,1,1
89,8478011,Louie Belpedio,D,PHI,28,16,0,1,1
89,8483597,Milos Kelemen,L,UTA,25,12,0,1,1
89,8480075,Cameron Crotty,D,MIN,25,12,0,1,1
89,8476323,Max McCormick,L,SEA,32,2,0,1,1
89,8475755,Alexander Petrovic,D,DAL,32,6,0,1,1
89,8481699,Aku Raty,R,UTA,23,13,0,1,1
89,8481043,Cole Koepke,L,BOS,26,17,0,1,1
89,8483546,Marshall Rifai,D,TOR,26,7,0,1,1
89,8483432,Luca Del Bel Belluz,C,CBJ,31,6,0,1,1
89,8481743,Marc Del Gaizo,D,NSH,25,22,0,0,0
89,8479362,Riley Tufte,L,BOS,26,21,0,0,0
89,8482476,Emil Heineman,L,MTL,23,8,0,0,0
89,8477320,Anton Blidh,L,NYR,29,17,0,0,0
89,8477810,Joel Hanley,D,CGY,33,30,0,0,0
89,8482787,Nikita Chibrikov,R,WPG,31,9,0,0,0
89,8478881,Brett Seney,L,CHI,28,14,0,0,0
89,8480468,James Hamblin,L,EDM,25,21,0,0,0
89,8482088,Justin Sourdif,R,FLA,22,17,0,0,0
89,8477541,Dakota Mermis,D,TOR,30,3,0,0,0
89,8483407,Brandon Scanlin,D,NYR,25,6,0,0,0
89,8483401,Marc Johnstone,R,PIT,28,3,0,0,0
89,8483471,Brad Lambert,C,WPG,31,9,0,0,0
89,8482197,Adam Raska,R,MIN,23,5,0,0,0
89,8479522,Hardy Haman Aktell,D,WSH,26,3,0,0,0
89,8477993,Justin Kirkland,C,CGY,28,5,0,0,0
89,8482460,Matt Rempe,C,NYR,22,18,0,0,0
89,8478446,Glenn Gawdin,C,LAK,27,3,0,0,0
89,8481564,Ryan Johnson,D,BUF,23,14,0,0,0
89,8475780,Chris Wagner,R,COL,33,7,0,0,0
89,8481655,Cole Schwindt,R,CGY,23,3,0,0,0
89,8482126,Emil Andrae,D,PHI,31,5,0,0,0
89,8480306,Grant Hutton,D,NYI,29,6,0,0,0
89,8481534,Raphael Lavoie,C,EDM,24,4,0,0,0
89,8484326,Patrik Koch,D,UTA,28,1,0,0,0
89,8483609,Adam Klapka,R,CGY,24,3,0,0,0
89,8483531,Brian Halonen,L,NJD,25,1,0,0,0
89,8478956,Samuel Laberge,L,NJD,27,1,0,0,0
89,8480274,Philip Kemp,D,EDM,25,1,0,0,0
89,8484259,Ondrej Pavel,C,COL,31,2,0,0,0
89,8470794,Joe Pavelski,C,,40,0,0,0,0
89,8479321,Lucas Johansen,D,,27,0,0,0,0
89,8477950,Tony DeAngelo,D,,29,0,0,0,0
89,8471218,Blake Wheeler,R,,38,0,0,0,0
89,8475197,Tyson Barrie,D,,33,0,0,0,0
89,8474157,Max Pacioretty,L,,36,0,0,0,0
89,8475744,Evgeny Kuznetsov,C,,32,0,0,0,0
89,8474037,James van Riemsdyk,L,,35,0,0,0,0
89,8476907,Mackenzie MacEachern,L,,30,0,0,0,0
89,8480216,Jacob Peterson,C,,25,0,0,0,0
89,8474602,Justin Schultz,D,,34,0,0,0,0
89,8482222,Alexander Barabanov,L,,30,0,0,0,0
89,8474031,Kevin Shattenkirk,D,,35,0,0,0,0
89,8477330,Dominik Kubalik,L,,29,0,0,0,0
89,8480884,Calen Addison,D,,24,0,0,0,0
89,8475906,John Klingberg,D,,32,0,0,0,0
89,8480008,Adam Ruzicka,C,,25,0,0,0,0
89,8476884,Derrick Pouliot,D,,30,0,0,0,0
89,8476919,Chris Tierney,C,,30,0,0,0,0
89,8479415,Michael McLeod,C,,26,0,0,0,0
89,8474870,Tyler Johnson,C,,34,0,0,0,0
89,8470604,Jeff Carter,C,,39,0,0,0,0
89,8478104,Sammy Blais,L,,28,0,0,0,0
89,8474884,Mike Hoffman,C,,35,0,0,0,0
89,8481591,Sam Poulin,R,,23,0,0,0,0
89,8471274,Alex Goligoski,D,,39,0,0,0,0
89,8476871,Tanner Pearson,L,,32,0,0,0,0
89,8476393,Nick Cousins,C,,31,0,0,0,0
89,8479977,Kailer Yamamoto,R,,26,0,0,0,0
89,8479346,Dillon Dube,C,,26,0,0,0,0
89,8480184,Gustav Lindstrom,D,,26,0,0,0,0
89,8479376,Victor Mete,D,,26,0,0,0,0
89,8473449,Kyle Okposo,R,,36,0,0,0,0
89,8481058,Jesse Ylonen,R,,25,0,0,0,0
89,8475752,Tyler Pitlick,C,,33,0,0,0,0
89,8481239,Samuel Fagemo,L,,24,0,0,0,0
89,8480821,Filip Zadina,R,,25,0,0,0,0
89,8470966,Mark Giordano,D,,41,0,0,0,0
89,8478495,Denis Gurianov,R,,27,0,0,0,0
89,8477464,Nic Petan,C,,29,0,0,0,0
89,8478099,Kevin Labanc,R,,29,0,0,0,0
89,8482241,Radim Zohorna,L,,28,0,0,0,0
89,8474040,Sam Gagner,C,,35,0,0,0,0
89,8479514,Rem Pitlick,C,,27,0,0,0,0
89,8478430,Oliver Kylington,D,,27,0,0,0,0
89,8479533,Joona Koppanen,L,,26,0,0,0,0
89,8479984,Cal Foote,D,,26,0,0,0,0
89,8477126,Jayson Megna,C,,34,0,0,0,0
89,8475164,Jakob Silfverberg,R,,34,0,0,0,0
89,8474009,Nick Bonino,C,,36,0,0,0,0
89,8479458,Nikita Zaitsev,D,,33,0,0,0,0
89,8477944,Jakub Vrana,L,,28,0,0,0,0
89,8471699,Andrew Cogliano,C,,37,0,0,0,0
89,8478067,Oskar Lindblom,L,,28,0,0,0,0
89,8471686,Marc Staal,D,,37,0,0,0,0
89,8470610,Zach Parise,L,,40,0,0,0,0
89,8478904,Steven Lorentz,C,,28,0,0,0,0
89,8473473,Milan Lucic,L,,36,0,0,0,0
89,8480031,Maxime Comtois,L,,25,0,0,0,0
89,8478512,Austin Czarnik,C,,32,0,0,0,0
89,8473504,Cal Clutterbuck,R,,37,0,0,0,0
89,8477454,Adam Erne,L,,29,0,0,0,0
89,8479383,Boris Katchouk,L,,26,0,0,0,0
89,8475825,Jani Hakanpää,D,,32,0,0,0,0
89,8477846,Ryan Carpenter,C,,33,0,0,0,0
89,8477930,Pierre-Edouard Bellemare,L,,39,0,0,0,0
89,8478400,Colin White,C,,27,0,0,0,0
89,8480226,Marián Studenic,R,,26,0,0,0,0
89,8480853,Liam Foudy,C,,24,0,0,0,0
89,8475797,Jarred Tinordi,D,,32,0,0,0,0
89,8479423,Alex Nylander,L,,26,0,0,0,0
89,8474618,Marco Scandella,D,,34,0,0,0,0
89,8478028,Fredrik Olofsson,L,,28,0,0,0,0
89,8474709,Matt Martin,L,,35,0,0,0,0
89,8481070,Hugh McGing,L,,26,0,0,0,0
89,8479546,Oskar Steen,C,,26,0,0,0,0
89,8474145,Robert Bortuzzo,D,,35,0,0,0,0
89,8476915,Jujhar Khaira,L,,30,0,0,0,0
89,8475278,Byron Froese,C,,33,0,0,0,0
89,8481812,Nikolai Knyzhov,D,,27,0,0,0,0
89,8478408,Travis Dermott,D,,28,0,0,0,0
89,8481077,John Leonard,L,,26,0,0,0,0
89,8479547,Matthew Phillips,R,,26,0,0,0,0
89,8480836,Jonathan Gruden,C,,24,0,0,0,0
89,8481690,Tyler Angle,C,,24,0,0,0,0
89,8475766,Austin Watson,L,,32,0,0,0,0
89,8481016,Ruslan Iskhakov,C,,24,0,0,0,0
89,8478078,Rourke Chartier,C,,28,0,0,0,0
89,8480776,Sheldon Rempal,R,,29,0,0,0,0
89,8483045,Cameron Butler,R,CBJ,31,0,0,0,0
89,8484314,Jiri Smejkal,L,,28,0,0,0,0
90,8476453,Nikita Kucherov,R,TBL,31,82,45,107,152
90,8481559,Jack Hughes,C,NJD,23,78,52,98,150
90,8478402,Connor McDavid,C,EDM,27,80,47,94,141
90,8477492,Nathan MacKinnon,C,COL,29,82,49,89,138
90,8478420,Mikko Rantanen,R,COL,28,82,56,69,125
90,8479314,Matthew Tkachuk,L,FLA,27,79,40,78,118
90,8478483,Mitch Marner,R,TOR,27,80,35,83,118
90,8477404,Jake Guentzel,C,TBL,30,82,48,69,117
90,8477939,William Nylander,R,TOR,28,77,62,53,115
90,8479318,Auston Matthews,C,TOR,27,80,57,55,112
90,8478864,Kirill Kaprizov,L,MIN,27,72,48,63,111
90,8474600,Roman Josi,D,NSH,34,78,31,75,106
90,8479407,Jesper Bratt,L,NJD,26,76,38,67,105
90,8477956,David Pastrnak,R,BOS,28,79,43,60,103
90,8471675,Sidney Crosby,C,PIT,37,72,41,62,103
90,8477934,Leon Draisaitl,C,EDM,29,79,35,67,102
90,8477493,Aleksander Barkov,C,FLA,29,79,31,70,101
90,8480027,Jason Robertson,L,DAL,25,82,36,64,100
90,8477946,Dylan Larkin,C,DET,28,82,46,51,97
90,8478439,Travis Konecny,R,PHI,27,76,48,46,94
90,8482116,Tim Stützle,C,OTT,22,78,33,60,93
90,8480069,Cale Makar,D,COL,26,71,16,76,92
90,8480012,Elias Pettersson,C,VAN,26,77,32,59,91
90,8480002,Nico Hischier,C,NJD,25,74,31,60,91
90,8477933,Sam Reinhart,C,FLA,29,81,41,49,90
90,8478010,Brayden Point,C,TBL,28,82,40,50,90
90,8476468,J.T. Miller,C,VAN,31,78,30,59,89
90,8478398,Kyle Connor,L,WPG,28,75,46,42,88
90,8477501,Valeri Nichushkin,R,COL,29,82,44,44,88
90,8475172,Nazem Kadri,C,CGY,34,80,35,53,88
90,8479420,Tage Thompson,C,BUF,27,77,45,42,87
90,8480208,Drake Batherson,R,OTT,26,79,29,57,86
90,8478445,Mathew Barzal,C,NYI,27,79,22,63,85
90,8476887,Filip Forsberg,L,NSH,30,72,40,44,84
90,8475913,Mark Stone,R,VGK,32,74,32,52,84
90,8478550,Artemi Panarin,L,NYR,33,76,23,61,84
90,8475810,Bryan Rust,R,PIT,32,75,33,50,83
90,8477409,Carter Verhaeghe,C,FLA,29,81,38,44,82
90,8479385,Jordan Kyrou,C,STL,26,76,40,41,81
90,8479343,Clayton Keller,R,UTA,26,70,39,42,81
90,8475166,John Tavares,C,TOR,34,77,28,53,81
90,8481557,Matt Boldy,L,MIN,23,73,28,53,81
90,8480023,Robert Thomas,C,STL,25,75,20,61,81
90,8474564,Steven Stamkos,C,NSH,34,74,33,47,80
90,8477504,Josh Morrissey,D,WPG,29,75,22,58,80
90,8477942,Kevin Fiala,L,LAK,28,80,31,48,79
90,8482078,Lucas Raymond,L,DET,22,81,31,48,79
90,8484144,Connor Bedard,C,CHI,19,65,28,51,79
90,8476456,Jonathan Huberdeau,C,CGY,31,79,20,59,79
90,8480801,Brady Tkachuk,L,OTT,25,80,39,39,78
90,8476454,Ryan Nugent-Hopkins,C,EDM,31,73,26,52,78
90,8477500,Bo Horvat,C,NYI,29,78,35,41,76
90,8476389,Vincent Trocheck,C,NYR,31,76,34,42,76
90,8476460,Mark Scheifele,C,WPG,31,77,33,43,76
90,8478403,Jack Eichel,C,VGK,28,77,28,48,76
90,8480800,Quinn Hughes,D,VAN,25,77,8,68,76
90,8477955,Jared McCann,L,SEA,28,79,39,36,75
90,8482093,Seth Jarvis,C,CAR,22,73,38,37,75
90,8476448,William Karlsson,C,VGK,31,77,32,43,75
90,8478414,Timo Meier,R,NJD,28,78,38,36,74
90,8475754,Brock Nelson,C,NYI,33,80,37,37,74
90,8479337,Alex DeBrincat,R,DET,27,80,29,45,74
90,8475167,Victor Hedman,D,TBL,34,81,20,54,74
90,8471214,Alex Ovechkin,L,WSH,39,79,30,43,73
90,8474141,Patrick Kane,R,DET,36,80,20,53,73
90,8475692,Mats Zuccarello,R,MIN,37,73,15,58,73
90,8475798,Mikael Granlund,C,SJS,32,75,18,54,72
90,8482740,Wyatt Johnston,C,DAL,21,81,29,42,71
90,8476881,Tomas Hertl,C,VGK,31,76,30,40,70
90,8480803,Evan Bouchard,D,EDM,25,79,12,58,70
90,8481068,Yegor Sharangovich,C,CGY,26,73,35,34,69
90,8475765,Vladimir Tarasenko,R,DET,33,82,26,43,69
90,8478427,Sebastian Aho,C,CAR,27,66,23,46,69
90,8475184,Chris Kreider,L,NYR,33,77,42,26,68
90,8478449,Roope Hintz,C,DAL,28,82,38,30,68
90,8478440,Dylan Strome,C,WSH,27,73,29,39,68
90,8478460,Zach Werenski,D,CBJ,27,80,15,53,68
90,8480865,Noah Dobson,D,NYI,24,77,7,61,68
90,8480830,Andrei Svechnikov,R,CAR,24,73,35,32,67
90,8477940,Nikolaj Ehlers,L,WPG,28,75,23,44,67
90,8473419,Brad Marchand,L,BOS,36,79,26,40,66
90,8475784,Jeff Skinner,C,EDM,32,78,26,40,66
90,8476459,Mika Zibanejad,C,NYR,31,78,24,42,66
90,8479999,Casey Mittelstadt,C,COL,26,80,22,44,66
90,8476346,Johnny Gaudreau,L,CBJ,31,74,18,48,66
90,8479675,Trevor Moore,L,LAK,29,81,32,33,65
90,8477951,Nick Schmaltz,C,UTA,28,78,24,41,65
90,8471685,Anze Kopitar,C,LAK,37,80,19,46,65
90,8480839,Rasmus Dahlin,D,BUF,24,66,19,46,65
90,8478396,Noah Hanifin,D,VGK,27,69,12,53,65
90,8482699,Dylan Guenther,R,UTA,21,81,28,36,64
90,8479542,Brandon Hagel,L,TBL,26,81,25,39,64
90,8478444,Brock Boeser,R,VAN,27,75,31,32,63
90,8478493,Joel Eriksson Ek,C,MIN,27,72,28,35,63
90,8477494,Jonathan Drouin,L,COL,29,79,22,41,63
90,8473994,Jamie Benn,L,DAL,35,80,21,42,63
90,8476853,Morgan Rielly,D,TOR,30,67,11,52,63
90,8475786,Zach Hyman,L,EDM,32,79,33,29,62
90,8481528,Dylan Cozens,C,BUF,23,76,30,32,62
90,8477402,Pavel Buchnevich,L,STL,29,75,27,35,62
90,8480018,Nick Suzuki,C,MTL,25,76,26,36,62
90,8475158,Ryan O'Reilly,C,NSH,33,74,21,41,62
90,8480036,Miro Heiskanen,D,DAL,25,77,15,46,61
90,8479323,Adam Fox,D,NYR,26,73,9,52,61
90,8482684,Luke Hughes,D,NJD,21,69,9,52,61
90,8476539,Jonathan Marchessault,R,NSH,34,75,34,26,60
90,8475726,Tyler Toffoli,C,SJS,32,65,33,27,60
90,8473512,Claude Giroux,R,OTT,36,80,23,37,60
90,8474102,David Perron,L,OTT,36,79,23,37,60
90,8478047,Michael Bunting,L,PIT,29,74,20,40,60
90,8477949,Alex Tuch,R,BUF,28,73,20,39,59
90,8478498,Jake DeBrusk,L,VAN,28,75,36,22,58
90,8477960,Adrian Kempe,R,LAK,28,79,25,33,58
90,8476905,Chandler Stephenson,C,SEA,30,73,20,38,58
90,8478401,Pavel Zacha,C,BOS,27,80,19,39,58
90,8483431,Logan Cooley,C,UTA,20,70,19,39,58
90,8479325,Charlie McAvoy,D,BOS,27,72,9,49,58
90,8480015,Owen Tippett,R,PHI,25,76,26,31,57
90,8478873,Troy Terry,R,ANA,27,70,21,36,57
90,8477447,Shea Theodore,D,VGK,29,60,15,42,57
90,8474578,Erik Karlsson,D,PIT,34,80,12,45,57
90,8475314,Anders Lee,L,NYI,34,73,37,19,56
90,8476399,Blake Coleman,C,CGY,33,75,29,27,56
90,8475794,Tyler Seguin,C,DAL,32,82,24,32,56
90,8471215,Evgeni Malkin,C,PIT,38,73,25,30,55
90,8475287,Erik Haula,L,NJD,33,70,20,35,55
90,8474679,Gustav Nyquist,C,NSH,35,69,19,36,55
90,8475168,Matt Duchene,C,DAL,33,78,18,37,55
90,8477503,Max Domi,C,TOR,29,78,18,37,55
90,8478397,Rasmus Andersson,D,CGY,28,75,12,43,55
90,8478366,Frank Vatrano,R,ANA,30,71,33,21,54
90,8478462,Nicolas Roy,C,VGK,27,76,25,29,54
90,8482113,Anton Lundell,C,FLA,23,76,24,30,54
90,8475170,Brayden Schenn,C,STL,33,74,19,35,54
90,8471724,Kris Letang,D,PIT,37,79,16,38,54
90,8476432,Boone Jenner,C,CBJ,31,69,31,22,53
90,8482089,Jake Neighbours,L,STL,22,65,29,24,53
90,8475151,Kyle Palmieri,C,NYI,33,81,25,28,53
90,8483808,Andrei Kuzmenko,L,CGY,28,78,22,31,53
90,8477346,MacKenzie Weegar,D,CGY,30,73,18,35,53
90,8479425,Filip Hronek,D,VAN,27,68,13,40,53
90,8475191,Reilly Smith,R,NYR,33,76,29,23,52
90,8475799,Nino Niederreiter,R,WPG,32,70,27,25,52
90,8477416,Oliver Bjorkstrand,R,SEA,29,76,23,29,52
90,8480039,Martin Necas,C,CAR,25,66,22,30,52
90,8477479,Tyler Bertuzzi,L,CHI,29,58,21,31,52
90,8477407,Anthony Duclair,L,NYI,29,77,20,32,52
90,8477986,Brandon Montour,D,SEA,30,71,20,32,52
90,8482745,Mason McTavish,C,ANA,21,68,18,34,52
90,8482665,Matty Beniers,C,SEA,22,71,18,34,52
90,8476875,Mike Matheson,D,MTL,30,72,10,42,52
90,8470613,Brent Burns,D,CAR,39,74,9,43,52
90,8481533,Trevor Zegras,C,ANA,23,70,23,28,51
90,8478975,Mason Marchment,L,DAL,29,80,20,31,51
90,8479400,Pierre-Luc Dubois,L,WSH,26,75,19,32,51
90,8478856,Conor Garland,R,VAN,28,72,18,33,51
90,8474590,John Carlson,D,WSH,34,62,11,40,51
90,8480188,Fabian Zetterlund,L,SJS,25,66,22,28,50
90,8477496,Elias Lindholm,C,BOS,30,78,20,30,50
90,8479987,Morgan Geekie,C,BOS,26,74,19,31,50
90,8481711,Matias Maccelli,L,UTA,24,74,12,38,50
90,8478407,Vince Dunn,D,SEA,28,70,10,40,50
90,8482110,Dawson Mercer,C,NJD,23,73,26,23,49
90,8477935,Sam Bennett,C,FLA,28,70,23,26,49
90,8481604,Pavel Dorofeyev,L,VGK,24,74,22,27,49
90,8482124,Quinton Byfield,R,LAK,22,82,18,31,49
90,8483505,Matthew Poitras,C,BOS,20,74,17,32,49
90,8477497,Sean Monahan,C,CBJ,30,69,15,34,49
90,8476906,Shayne Gostisbehere,D,CAR,31,78,14,35,49
90,8474563,Drew Doughty,D,LAK,35,71,14,35,49
90,8482109,Alexis Lafrenière,L,NYR,23,74,26,22,48
90,8477476,Artturi Lehkonen,L,COL,29,80,24,24,48
90,8476826,Yanni Gourde,C,SEA,33,69,23,25,48
90,8478542,Evan Rodrigues,C,FLA,31,75,21,27,48
90,8473986,Alex Killorn,L,ANA,35,78,20,28,48
90,8483515,Juraj Slafkovsky,L,MTL,20,72,18,30,48
90,8477932,Aaron Ekblad,D,FLA,28,71,16,32,48
90,8479410,Mikhail Sergachev,D,UTA,26,68,7,41,48
90,8482159,Tyson Foerster,R,PHI,22,72,21,26,47
90,8475753,Justin Faulk,D,STL,32,74,18,29,47
90,8478519,Anthony Cirelli,C,TBL,27,81,18,29,47
90,8482149,Cole Perfetti,C,WPG,22,73,17,30,47
90,8478458,John (Jack) Roslovic,C,CAR,27,67,16,31,47
90,8476792,Torey Krug,D,STL,33,73,12,35,47
90,8481542,Moritz Seider,D,DET,23,78,8,39,47
90,8476483,Rickard Rakell,R,PIT,31,69,25,21,46
90,8480185,Eetu Luostarinen,C,FLA,26,78,21,25,46
90,8481596,Shane Pinto,C,OTT,24,74,19,27,46
90,8475768,Jaden Schwartz,C,SEA,32,72,17,29,46
90,8484153,Leo Carlsson,C,ANA,20,73,16,30,46
90,8476438,Brandon Saad,L,STL,32,71,29,16,45
90,8474641,Adam Henrique,C,EDM,34,75,23,22,45
90,8481540,Cole Caufield,R,MTL,23,71,21,24,45
90,8484166,Adam Fantilli,C,CBJ,20,68,21,24,45
90,8474150,Mikael Backlund,C,CGY,35,78,20,25,45
90,8479345,Jakob Chychrun,D,WSH,26,66,19,26,45
90,8477511,Anthony Mantha,R,CGY,30,73,19,26,45
90,8477021,Alex Kerfoot,C,UTA,30,77,17,28,45
90,8476872,Scott Laughton,C,PHI,30,75,16,29,45
90,8474586,Jordan Eberle,R,SEA,34,74,16,29,45
90,8476479,Phillip Danault,C,LAK,31,80,15,30,45
90,8477456,J.T. Compher,L,DET,29,81,15,30,45
90,8475745,Charlie Coyle,C,BOS,32,78,13,32,45
90,8477495,Seth Jones,D,CHI,30,67,9,36,45
90,8476958,Jaccob Slavin,D,CAR,30,74,8,37,45
90,8476880,Tom Wilson,R,WSH,30,67,19,25,44
90,8475714,Calle Jarnkrok,C,TOR,33,73,18,26,44
90,8478055,Gustav Forsling,D,FLA,28,74,15,29,44
90,8480336,Sean Walker,D,CAR,30,76,11,33,44
90,8478438,Tommy Novak,C,NSH,27,75,10,34,44
90,8480434,Sean Durzi,D,UTA,26,70,6,38,44
90,8481581,Thomas Harley,D,DAL,23,71,6,38,44
90,8475169,Evander Kane,L,EDM,33,76,27,16,43
90,8478042,Viktor Arvidsson,L,EDM,31,77,20,23,43
90,8482705,Cole Sillinger,C,CBJ,21,64,20,23,43
90,8478466,Daniel Sprong,R,VAN,27,68,17,26,43
90,8478038,Devon Toews,D,COL,30,67,9,34,43
90,8482122,Brock Faber,D,MIN,22,80,7,36,43
90,8482702,Logan Stankoven,C,DAL,21,81,25,17,42
90,8482667,William Eklund,L,SJS,22,63,21,21,42
90,8481618,Alex Newhook,C,MTL,23,74,20,22,42
90,8480009,Eeli Tolvanen,R,SEA,25,73,20,22,42
90,8479365,Trent Frederic,C,BOS,26,76,23,18,41
90,8482097,Jack Quinn,R,BUF,23,64,13,28,41
90,8475764,Cam Fowler,D,ANA,33,71,4,37,41
90,8475793,Ryan Johansen,C,PHI,32,72,14,26,40
90,8477426,Nicholas Paul,L,TBL,29,82,24,15,39
90,8475760,Nick Bjugstad,C,UTA,32,71,19,20,39
90,8475218,Mattias Ekholm,D,EDM,34,73,15,24,39
90,8476462,Dougie Hamilton,D,NJD,31,68,14,25,39
90,8481186,Logan O'Connor,R,COL,28,79,22,16,38
90,8477429,Andrew Copp,C,DET,30,78,20,18,38
90,8478474,Lawson Crouse,L,UTA,27,72,17,21,38
90,8477839,Conor Sheary,L,TBL,32,81,17,21,38
90,8477451,Ryan Hartman,R,MIN,30,64,16,22,38
90,8480797,Joel Farabee,L,PHI,24,74,15,23,38
90,8479339,Patrik Laine,L,CBJ,26,65,13,25,38
90,8482175,JJ Peterka,R,BUF,22,66,26,11,37
90,8476461,Sean Couturier,C,PHI,32,66,20,17,37
90,8481560,Arthur Kaliyev,R,LAK,23,77,19,18,37
90,8476882,Teuvo Teravainen,C,CHI,30,65,17,20,37
90,8480064,Josh Norris,C,OTT,25,73,16,21,37
90,8479525,Ross Colton,C,COL,28,77,16,21,37
90,8475763,Kevin Hayes,R,PIT,32,70,15,22,37
90,8481524,Bowen Byram,D,BUF,23,70,14,23,37
90,8479351,Sam Steel,C,DAL,26,80,11,26,37
90,8474565,Alex Pietrangelo,D,VGK,34,56,6,31,37
90,8481546,Cam York,D,PHI,23,71,4,33,37
90,8478115,Pierre Engvall,L,NYI,28,76,21,15,36
90,8474149,Evgenii Dadonov,R,DAL,35,82,20,16,36
90,8480849,Barrett Hayton,C,UTA,24,65,18,18,36
90,8476925,Colton Sissons,C,NSH,31,68,16,20,36
90,8482092,Ridly Greig,C,OTT,22,77,15,21,36
90,8475848,Brendan Gallagher,R,MTL,32,62,14,22,36
90,8476419,Jean-Gabriel Pageau,C,NYI,32,76,14,22,36
90,8476480,Vladislav Namestnikov,C,WPG,32,66,13,23,36
90,8476869,Brady Skjei,D,NSH,30,74,12,24,36
90,8480028,Morgan Frost,C,PHI,25,67,9,27,36
90,8480871,Adam Boqvist,D,FLA,24,68,8,28,36
90,8477964,Ivan Barbashev,C,VGK,29,75,18,17,35
90,8481582,Nicholas Robertson,L,TOR,23,70,18,17,35
90,8482720,Matthew Knies,L,TOR,22,76,17,18,35
90,8480014,Gabriel Vilardi,C,WPG,25,61,15,20,35
90,8478046,Danton Heinen,L,VAN,29,72,15,20,35
90,8474716,Jared Spurgeon,D,MIN,35,74,12,23,35
90,8478472,Mathieu Joseph,R,STL,27,67,9,26,35
90,8482737,Zack Bolduc,C,STL,21,54,22,12,34
90,8473422,Nick Foligno,L,CHI,37,64,18,16,34
90,8477998,Warren Foegele,L,LAK,28,80,16,18,34
90,8474053,Logan Couture,C,SJS,35,61,13,21,34
90,8478233,Andrew Mangiapane,L,WSH,28,68,12,22,34
90,8478463,Anthony Beauvillier,L,PIT,27,65,12,22,34
90,8477444,Andre Burakovsky,L,SEA,29,73,11,23,34
90,8478469,Thomas Chabot,D,OTT,27,68,10,24,34
90,8476885,Jacob Trouba,D,NYR,30,73,10,24,34
90,8477498,Darnell Nurse,D,EDM,29,75,8,26,34
90,8476927,Teddy Blueger,C,VAN,30,73,8,26,34
90,8477948,Travis Sanheim,D,PHI,28,70,5,29,34
90,8482475,Yegor Chinakhov,R,CBJ,23,69,16,17,33
90,8481032,Paul Cotter,C,NJD,25,63,16,17,33
90,8480448,Parker Kelly,L,COL,25,71,14,19,33
90,8480798,Philipp Kurashev,C,CHI,25,63,13,20,33
90,8474189,Lars Eller,C,PIT,35,67,13,20,33
90,8480145,Neal Pionk,D,WPG,29,75,8,25,33
90,8480068,Ryan Poehling,C,PHI,25,70,18,14,32
90,8478057,Dakota Joshua,C,VAN,28,65,17,15,32
90,8480220,Noah Cates,L,PHI,25,77,14,18,32
90,8484145,Zach Benson,L,BUF,19,66,13,19,32
90,8481553,Bobby Brink,R,PHI,23,61,12,20,32
90,8478136,Jake Middleton,D,MIN,28,77,10,22,32
90,8483490,Pavel Mintyukov,D,ANA,21,68,9,23,32
90,8476292,Ondrej Palat,L,NJD,33,64,8,24,32
90,8481703,Valtteri Puustinen,R,PIT,25,60,6,26,32
90,8481535,Nils Hoglander,L,VAN,24,67,19,12,31
90,8480855,Jack McBain,C,UTA,24,68,17,14,31
90,8478020,Michael Amadio,R,OTT,28,75,15,16,31
90,8479293,Brandon Tanev,L,SEA,33,65,12,19,31
90,8479066,Ryan Lomberg,L,CGY,30,64,12,19,31
90,8479992,Michael Rasmussen,C,DET,25,78,11,20,31
90,8480802,Ryan McLeod,C,BUF,25,64,9,22,31
90,8476923,Damon Severson,D,CBJ,30,79,8,23,31
90,8478133,Jake Evans,C,MTL,28,70,7,24,31
90,8477506,Ryan Pulock,D,NYI,30,78,2,29,31
90,8476921,Jordan Martinook,L,CAR,32,67,18,12,30
90,8471698,T.J. Oshie,R,WSH,38,61,14,16,30
90,8484203,Bradly Nadeau,L,CAR,19,59,12,18,30
90,8482117,Lukas Reichel,L,CHI,22,57,10,20,30
90,8482712,Oskar Olausson,R,COL,22,77,8,22,30
90,8475200,Dmitry Orlov,D,CAR,33,73,8,22,30
90,8482133,Thomas Bordeleau,C,SJS,22,58,7,23,30
90,8482655,Janis Moser,D,TBL,24,77,6,24,30
90,8478109,Victor Olofsson,L,VGK,29,69,15,14,29
90,8474715,Cameron Atkinson,R,TBL,35,82,13,16,29
90,8480829,Jesperi Kotkaniemi,C,CAR,24,67,12,17,29
90,8482105,Jake Sanderson,D,OTT,22,73,12,17,29
90,8480113,Alex Iafallo,L,WPG,31,66,11,18,29
90,8483445,Cutter Gauthier,L,ANA,20,68,11,18,29
90,8481656,Aliaksei Protas,C,WSH,23,68,10,19,29
90,8480078,Filip Chytil,C,NYR,25,68,9,20,29
90,8476854,Hampus Lindholm,D,BOS,30,70,6,23,29
90,8474151,Ryan McDonagh,D,TBL,35,76,4,25,29
90,8482671,Owen Power,D,BUF,22,66,2,27,29
90,8476392,Adam Lowry,C,WPG,31,62,15,13,28
90,8482259,Bobby McMann,C,TOR,28,65,15,13,28
90,8482660,Kent Johnson,C,CBJ,22,59,14,14,28
90,8480789,Oliver Wahlstrom,R,NYI,24,70,14,14,28
90,8481554,Kaapo Kakko,R,NYR,23,70,12,16,28
90,8476981,Josh Anderson,R,MTL,30,71,12,16,28
90,8482111,Justin Barron,D,MTL,23,67,12,16,28
90,8481093,Rafael Harvey-Pinard,L,MTL,25,64,12,16,28
90,8477987,Ryan Donato,C,CHI,28,54,11,17,28
90,8479591,Michael Eyssimont,C,TBL,28,80,11,17,28
90,8480748,Kiefer Sherwood,L,VAN,29,59,11,17,28
90,8480459,Pius Suter,C,VAN,28,68,10,18,28
90,8482074,Connor Zary,C,CGY,23,60,9,19,28
90,8477969,Marcus Pettersson,D,PIT,28,76,5,23,28
90,8475722,Jason Zucker,L,BUF,32,72,14,13,27
90,8480813,Joe Veleno,C,DET,24,77,13,14,27
90,8482125,Alexander Holtz,R,VGK,22,62,12,15,27
90,8476278,Colin Blackwell,C,DAL,31,77,12,15,27
90,8475220,Marcus Foligno,L,MIN,33,55,10,17,27
90,8476458,Ryan Strome,C,ANA,31,63,9,18,27
90,8481577,Philip Tomasino,C,NSH,23,60,9,18,27
90,8475193,Tomas Tatar,L,NJD,34,67,9,18,27
90,8478507,John Marino,D,UTA,27,66,6,21,27
90,8479398,Samuel Girard,D,COL,26,62,5,22,27
90,8478882,Vladislav Gavrikov,D,LAK,29,73,5,22,27
90,8480817,K'Andre Miller,D,NYR,24,71,4,23,27
90,8480049,Dylan Samberg,D,WPG,25,68,4,23,27
90,8481606,Jordan Spence,D,LAK,23,65,1,26,27
90,8479353,Brett Howden,C,VGK,26,64,13,13,26
90,8482809,Jackson Blake,R,CAR,21,59,12,14,26
90,8478013,Jake Walman,D,SJS,28,66,11,15,26
90,8478569,Noel Acciari,C,PIT,33,55,10,16,26
90,8477488,Brett Pesce,D,NJD,30,73,6,20,26
90,8482624,Daniil Miromanov,D,CGY,27,61,6,20,26
90,8476312,Josh Manson,D,COL,33,63,6,20,26
90,8476892,Colton Parayko,D,STL,31,75,6,20,26
90,8480878,Nils Lundkvist,D,DAL,24,72,6,20,26
90,8482101,Danil Gushchin,L,SJS,22,60,5,21,26
90,8482451,Mikael Pyyhtia,L,CBJ,23,47,5,21,26
90,8476429,Scott Mayfield,D,NYI,32,76,4,22,26
90,8476331,Dylan DeMelo,D,WPG,31,70,1,25,26
90,8479390,Taylor Raddysh,R,WSH,26,65,14,11,25
90,8470621,Corey Perry,R,EDM,39,68,14,11,25
90,8480893,Kirill Marchenko,R,CBJ,24,64,13,12,25
90,8475149,Marcus Johansson,L,MIN,34,62,13,12,25
90,8476918,Jimmy Vesey,L,NYR,31,73,12,13,25
90,8483499,Liam Ohgren,L,MIN,20,57,11,14,25
90,8475231,Casey Cizikas,C,NYI,33,76,9,16,25
90,8483524,Shane Wright,C,SEA,20,64,9,16,25
90,8478500,Ivan Provorov,D,CBJ,27,75,8,17,25
90,8479393,Noah Gregor,L,OTT,26,76,8,17,25
90,8477508,Curtis Lazar,C,NJD,29,58,8,17,25
90,8480074,Alexandre Texier,C,STL,25,57,6,19,25
90,8475181,Nick Leddy,D,STL,33,73,4,21,25
90,8481568,Alex Vlasic,D,CHI,23,58,4,21,25
90,8473533,Jordan Staal,C,CAR,36,63,13,11,24
90,8482055,Drew O'Connor,L,PIT,26,58,12,12,24
90,8477947,Sonny Milano,L,WSH,28,66,12,12,24
90,8479996,Cody Glass,C,NSH,25,65,11,13,24
90,8475791,Taylor Hall,L,CHI,33,54,10,14,24
90,8476474,Stefan Noesen,R,NJD,31,68,9,15,24
90,8480835,Jack Drury,C,CAR,24,56,9,15,24
90,8480003,Jesper Boqvist,C,FLA,26,66,9,15,24
90,8482749,Joshua Roy,R,MTL,21,61,7,17,24
90,8479976,Juuso Valimaki,D,UTA,26,59,7,17,24
90,8478911,Matt Roy,D,WSH,29,65,7,17,24
90,8475855,Jesper Fast,R,CAR,33,65,6,18,24
90,8476979,Erik Gustafsson,D,DET,32,77,5,19,24
90,8476917,Adam Pelech,D,NYI,30,75,4,20,24
90,8480043,Timothy Liljegren,D,TOR,25,66,3,21,24
90,8480073,Erik Brannstrom,D,COL,25,62,3,21,24
90,8480873,Rasmus Sandin,D,WSH,24,66,2,22,24
90,8476931,Jake McCabe,D,TOR,31,69,2,22,24
90,8480289,Morgan Barron,C,WPG,26,60,14,9,23
90,8481523,Kirby Dach,C,MTL,23,65,13,10,23
90,8476469,Joel Armia,R,MTL,31,68,12,11,23
90,8479661,Tanner Jeannot,L,LAK,27,75,12,11,23
90,8477425,Miles Wood,L,COL,29,77,11,12,23
90,8482079,Marco Rossi,C,MIN,23,65,11,12,23
90,8476374,Sean Kuraly,C,CBJ,31,60,11,12,23
90,8477369,Carson Soucy,D,VAN,30,61,9,14,23
90,8481014,Alexander Romanov,D,NYI,24,77,6,17,23
90,8478891,Mason Appleton,C,WPG,28,64,5,18,23
90,8476902,Esa Lindell,D,DAL,30,78,4,19,23
90,8477435,Ryan Graves,D,PIT,29,76,4,19,23
90,8482679,Matt Coronato,R,CGY,22,63,13,9,22
90,8481624,Ilya Mikheyev,R,CHI,30,58,12,10,22
90,8477353,Tyler Motte,C,DET,29,70,12,10,22
90,8480205,Emil Bemstrom,C,PIT,25,56,12,10,22
90,8477450,Jason Dickinson,C,CHI,29,59,12,10,22
90,8483493,Frank Nazar,C,CHI,20,62,11,11,22
90,8482146,Luke Evangelista,R,NSH,22,67,10,12,22
90,8477952,Robby Fabbri,C,ANA,28,63,10,12,22
90,8478432,Christian Fischer,R,DET,27,76,9,13,22
90,8478970,Jalen Chatfield,D,CAR,28,67,9,13,22
90,8481704,Juuso Parssinen,C,NSH,23,55,9,13,22
90,8477989,Christian Dvorak,C,MTL,28,67,9,13,22
90,8478413,Jordan Greenway,L,BUF,27,74,8,14,22
90,8481522,Peyton Krebs,C,BUF,23,61,7,15,22
90,8479315,Joey Anderson,R,CHI,26,56,7,15,22
90,8479982,Conor Timmins,D,TOR,26,62,6,16,22
90,8476467,Jamie Oleksiak,D,SEA,32,65,6,16,22
90,8479718,Alex Barré-Boulet,C,MTL,27,50,6,16,22
90,8477919,Frederick Gaudreau,C,MIN,31,57,6,16,22
90,8482192,Isaak Phillips,D,CHI,23,52,6,16,22
90,8478416,Erik Cernak,D,TBL,27,76,4,18,22
90,8482245,Artem Zub,D,OTT,29,69,2,20,22
90,8476457,Adam Larsson,D,SEA,32,70,1,21,22
90,8480995,Pontus Holmberg,R,TOR,25,60,14,7,21
90,8477446,Michael McCarron,R,NSH,29,57,11,10,21
90,8480144,David Kampf,C,TOR,29,72,10,11,21
90,8475343,Nic Dowd,C,WSH,34,60,10,11,21
90,8477380,Jonny Brodzinski,C,NYR,31,58,10,11,21
90,8480762,Eric Robinson,L,CAR,29,59,8,13,21
90,8479980,Nicolas Hague,D,VGK,26,58,7,14,21
90,8480246,Nick Perbix,D,TBL,26,72,7,14,21
90,8477505,Alexander Wennberg,C,SJS,30,60,6,15,21
90,8477953,Kasperi Kapanen,R,STL,28,68,6,15,21
90,8479998,Mikey Anderson,D,LAK,25,63,6,15,21
90,8473563,Nicklas Backstrom,C,WSH,37,52,6,15,21
90,8479442,Troy Stecher,D,EDM,30,58,6,15,21
90,8481521,Ronnie Attard,D,PHI,25,63,5,16,21
90,8478851,Alexandre Carrier,D,NSH,28,64,4,17,21
90,8477220,Nate Schmidt,D,FLA,33,68,2,19,21
90,8478399,Jonas Siegenthaler,D,NJD,27,56,1,20,21
90,8475790,Erik Gudbranson,D,CBJ,32,76,0,21,21
90,8473453,Trevor Lewis,C,LAK,37,78,14,6,20
90,8479344,Jesse Puljujarvi,R,PIT,26,52,12,8,20
90,8481517,Brett Leason,R,ANA,25,65,10,10,20
90,8481481,Blake Lizotte,C,PIT,27,65,9,11,20
90,8480355,Mark Kastelic,C,BOS,25,60,9,11,20
90,8476960,Andreas Athanasiou,C,CHI,30,54,7,13,20
90,8479316,Luke Kunin,C,SJS,27,56,7,13,20
90,8477499,Rasmus Ristolainen,D,PHI,30,64,7,13,20
90,8475179,Dmitry Kulikov,D,FLA,34,66,3,17,20
90,8483457,Lane Hutson,D,MTL,20,63,14,5,19
90,8481580,Connor McMichael,C,WSH,23,55,13,6,19
90,8481028,Martin Pospisil,C,CGY,25,55,11,8,19
90,8475188,Brayden McNabb,D,VGK,33,48,6,13,19
90,8474034,Patrick Maroon,L,CHI,36,52,6,13,19
90,8475171,Oliver Ekman-Larsson,D,TOR,33,69,5,14,19
90,8482087,Kaiden Guhle,D,MTL,22,65,4,15,19
90,8482634,Alex Steeves,C,TOR,25,43,3,16,19
90,8480035,Henri Jokiharju,D,BUF,25,66,2,17,19
90,8480807,Mattias Samuelsson,D,BUF,24,50,2,17,19
90,8476879,Cody Ceci,D,EDM,31,68,1,18,19
90,8475225,Craig Smith,C,CHI,35,50,12,6,18
90,8479619,Michael Carcone,L,UTA,28,64,11,7,18
90,8476889,Radek Faksa,C,STL,30,58,8,10,18
90,8476329,Travis Boyd,C,MIN,31,56,7,11,18
90,8482148,Hendrix Lapierre,C,WSH,22,57,6,12,18
90,8474574,Tyler Myers,D,VAN,34,70,5,13,18
90,8476856,Mathew Dumba,D,DAL,30,68,4,14,18
90,8478840,Will Borgen,D,SEA,28,68,4,14,18
90,8482067,Connor Mackey,D,NYR,28,69,4,14,18
90,8483565,Nick Blankenburg,D,NSH,26,61,3,15,18
90,8473507,Jeff Petry,D,DET,37,71,2,16,18
90,8479941,Justin Danforth,R,CBJ,31,59,12,5,17
90,8481477,Nico Sturm,C,SJS,29,53,11,6,17
90,8482659,Josh Doan,R,UTA,22,43,11,6,17
90,8481601,Simon Holmstrom,R,NYI,23,72,10,7,17
90,8482157,Will Cuylle,L,NYR,22,61,10,7,17
90,8479543,Michael Pezzetta,L,MTL,26,64,9,8,17
90,8476878,Zemgus Girgensons,C,TBL,30,76,8,9,17
90,8478434,Keegan Kolesar,R,VGK,27,63,7,10,17
90,8481013,Jonatan Berggren,R,DET,24,57,6,11,17
90,8478421,A.J. Greer,L,FLA,28,59,6,11,17
90,8479328,Julien Gauthier,R,NYI,27,59,5,12,17
90,8478443,Brandon Carlo,D,BOS,28,61,5,12,17
90,8478178,Darren Raddysh,D,TBL,28,60,4,13,17
90,8480796,Martin Fehervary,D,WSH,25,60,4,13,17
90,8476463,Jonas Brodin,D,MIN,31,76,3,14,17
90,8479371,Dante Fabbro,D,NSH,26,65,1,16,17
90,8475324,Nick Jensen,D,OTT,34,71,1,16,17
90,8481059,Scott Perunovich,D,STL,26,52,1,16,17
90,8482073,Braden Schneider,D,NYR,23,65,0,17,17
90,8478508,Yakov Trenin,C,MIN,27,56,13,3,16
90,8477478,William Carrier,L,CAR,30,50,9,7,16
90,8476624,Barclay Goodrow,C,SJS,31,60,9,7,16
90,8478043,Sam Lafferty,C,BUF,29,61,8,8,16
90,8480980,Connor Dewar,C,TOR,25,68,8,8,16
90,8479944,Zach Aston-Reese,C,VGK,30,55,7,9,16
90,8480021,Jack Studnicka,C,LAK,25,61,7,9,16
90,8477392,Hudson Fasching,R,NYI,29,62,6,10,16
90,8483468,Jiri Kulich,C,BUF,20,57,5,11,16
90,8476442,Matt Nieto,L,PIT,32,50,5,11,16
90,8479369,Andrew Peeke,D,BOS,26,61,5,11,16
90,8477365,Connor Clifton,D,BUF,29,56,4,12,16
90,8480070,Ian Mitchell,D,BOS,25,55,4,12,16
90,8476988,Matt Benning,D,SJS,30,66,4,12,16
90,8479026,Philippe Myers,D,TOR,27,48,4,12,16
90,8477018,Ben Hutton,D,VGK,31,48,4,12,16
90,8484149,Gavin Brindley,C,CBJ,20,48,3,13,16
90,8480058,Pierre-Olivier Joseph,D,STL,25,58,3,13,16
90,8471709,Marc-Edouard Vlasic,D,SJS,37,54,3,13,16
90,8479324,Ryan Lindgren,D,NYR,26,64,2,14,16
90,8481178,Egor Zamula,D,PHI,24,55,2,14,16
90,8480727,Zach Whitecloud,D,VGK,28,53,0,16,16
90,8480025,MacKenzie Entwistle,R,FLA,25,61,9,6,15
90,8483491,Ivan Miroshnichenko,L,WSH,20,54,7,8,15
90,8477573,Nathan Walker,L,STL,30,54,7,8,15
90,8481537,Nikita Okhotiuk,D,CGY,24,56,7,8,15
90,8483466,Kevin Korchinski,D,CHI,20,53,7,8,15
90,8477507,Nikita Zadorov,D,BOS,29,68,6,9,15
90,8482744,James Malatesta,L,CBJ,21,39,6,9,15
90,8477482,Zachary Sanford,L,CHI,30,41,4,11,15
90,8475455,Brenden Dillon,D,NJD,34,60,4,11,15
90,8474673,TJ Brodie,D,CHI,34,69,3,12,15
90,8480860,Kevin Bahl,D,CGY,24,60,2,13,15
90,8481567,Henry Thrun,D,SJS,23,53,2,13,15
90,8476873,Mark Jankowski,C,NSH,30,49,10,4,14
90,8483495,Simon Nemec,D,NJD,20,59,8,6,14
90,8479414,Nathan Bastian,R,NJD,27,59,7,7,14
90,8479983,Mario Ferraro,D,SJS,26,66,7,7,14
90,8476934,Brock McGinn,L,ANA,30,44,7,7,14
90,8476822,Luke Glendening,C,TBL,35,77,6,8,14
90,8482166,Shakir Mukhamadullin,D,SJS,22,62,6,8,14
90,8479439,Jacob MacDonald,D,COL,31,44,6,8,14
90,8480192,Johnathan Kovacevic,D,NJD,27,55,6,8,14
90,8476897,Oskar Sundqvist,C,STL,30,67,5,9,14
90,8481441,Joe Snively,C,DET,28,62,5,9,14
90,8476422,Mike Reilly,D,NYI,31,75,5,9,14
90,8478211,Dryden Hunt,L,CGY,29,50,5,9,14
90,8481751,Lukas Rousek,R,BUF,25,37,5,9,14
90,8480950,Ilya Lyubushkin,D,DAL,30,63,5,9,14
90,8475208,Brian Dumoulin,D,ANA,33,62,4,10,14
90,8482730,Brandt Clarke,D,LAK,21,47,4,10,14
90,8470600,Ryan Suter,D,STL,39,60,3,11,14
90,8478451,Ethan Bear,D,WSH,27,54,3,11,14
90,8480891,Michael Kesselring,D,UTA,24,55,2,12,14
90,8477845,Trevor van Riemsdyk,D,WSH,33,62,2,12,14
90,8479372,Joshua Mahura,D,SEA,26,58,1,13,14
90,8475233,David Savard,D,MTL,34,65,0,14,14
90,8480281,Alexey Toropchenko,R,STL,25,57,8,5,13
90,8477406,Mattias Janmark,C,EDM,32,68,7,6,13
90,8479368,Max Jones,L,BOS,26,66,7,6,13
90,8479336,Carl Grundstrom,R,SJS,27,49,7,6,13
90,8480001,Urho Vaakanainen,D,ANA,25,61,6,7,13
90,8482176,Wyatt Kaiser,D,CHI,22,48,6,7,13
90,8480845,Rasmus Kupari,C,WPG,24,43,6,7,13
90,8475279,Ben Chiarot,D,DET,33,70,5,8,13
90,8476525,Colin Miller,D,WPG,32,60,4,9,13
90,8477070,Liam O'Brien,C,UTA,30,60,4,9,13
90,8479639,Dylan Coghlan,D,WPG,26,58,3,10,13
90,8477979,Nicolas Aube-Kubel,R,BUF,28,58,3,10,13
90,8479359,Beck Malenstyn,L,BUF,26,41,3,10,13
90,8483482,Tristan Luneau,D,ANA,20,70,3,10,13
90,8478468,Jeremy Lauzon,D,NSH,27,45,3,10,13
90,8476874,Olli Maatta,D,DET,30,56,2,11,13
90,8474013,Ian Cole,D,UTA,35,53,1,12,13
90,8481641,Joel Kiviranta,L,COL,28,69,10,2,12
90,8477015,Connor Brown,R,EDM,30,68,7,5,12
90,8480011,Klim Kostin,C,SJS,25,51,6,6,12
90,8481019,David Gustafsson,C,WPG,24,41,5,7,12
90,8479994,Jaret Anderson-Dolan,C,WPG,25,36,5,7,12
90,8482807,Ethan Del Mastro,D,CHI,21,54,4,8,12
90,8479370,Tyson Jost,C,CAR,26,55,3,9,12
90,8474567,Zach Bogosian,D,MIN,34,57,3,9,12
90,8471677,Jack Johnson,D,CBJ,37,64,3,9,12
90,8480222,Sebastian Aho,D,PIT,28,68,2,10,12
90,8479249,Andrew Poturalski,C,SJS,30,46,2,10,12
90,8477851,Jordan Oesterle,D,BOS,32,35,2,10,12
90,8476952,Dominic Toninato,C,WPG,30,35,2,10,12
90,8475718,Justin Holl,D,DET,32,62,1,11,12
90,8480887,Jordan Harris,D,MTL,24,53,1,11,12
90,8480172,Jan Rutta,D,SJS,34,61,0,12,12
90,8481716,Dmitri Voronkov,L,CBJ,24,48,6,5,11
90,8480990,Declan Chisholm,D,MIN,24,46,5,6,11
90,8482803,Olen Zellweger,D,ANA,21,67,4,7,11
90,8477903,Garnet Hathaway,R,PHI,33,66,4,7,11
90,8483619,Filip Roos,D,OTT,25,41,4,7,11
90,8479986,Kole Lind,R,DAL,26,51,4,7,11
90,8481701,Santeri Hatakka,D,NJD,23,38,3,8,11
90,8479402,Jake Bean,D,CGY,26,55,2,9,11
90,8479972,Mason Shaw,C,WPG,26,36,2,9,11
90,8475462,Radko Gudas,D,ANA,34,63,0,11,11
90,8479520,Brandon Duhaime,R,WSH,27,56,7,3,10
90,8480880,Jakub Lauko,C,MIN,24,33,6,4,10
90,8477938,Haydn Fleury,D,WPG,28,41,5,5,10
90,8477335,Kyle Burroughs,D,LAK,29,49,5,5,10
90,8476867,Brendan Gaunce,C,MIN,30,40,5,5,10
90,8478452,Caleb Jones,D,LAK,27,56,4,6,10
90,8481754,Nikita Nesterenko,C,ANA,23,33,4,6,10
90,8477527,Ross Johnston,L,ANA,30,34,4,6,10
90,8482155,Alex Laferriere,R,LAK,23,65,3,7,10
90,8482666,Scott Morrow,D,CAR,22,50,3,7,10
90,8474166,Alec Martinez,D,CHI,37,42,3,7,10
90,8476913,Devin Shore,C,MIN,30,35,3,7,10
90,8482142,Jamie Drysdale,D,PHI,22,52,2,8,10
90,8476994,Vinnie Hinostroza,C,NSH,30,56,2,8,10
90,8474568,Luke Schenn,D,NSH,35,51,1,9,10
90,8476967,Brett Kulak,D,EDM,30,56,1,9,10
90,8475690,Chris Tanev,D,TOR,35,61,0,10,10
90,8476372,Nick Seeler,D,PHI,31,42,0,10,10
90,8481617,Vasily Podkolzin,R,VAN,23,41,8,1,9
90,8478585,Derek Ryan,C,EDM,38,59,5,4,9
90,8479981,Jonah Gadjovich,L,FLA,26,39,5,4,9
90,8482062,Cole Smith,L,NSH,29,50,4,5,9
90,8479968,Vinni Lettieri,C,BOS,29,46,4,5,9
90,8479671,Mathieu Olivier,R,CBJ,27,43,4,5,9
90,8482747,Brennan Othmann,L,NYR,21,40,4,5,9
90,8480441,Trey Fix-Wolansky,R,CBJ,25,35,3,6,9
90,8481708,Zac Jones,D,NYR,24,44,3,6,9
90,8478454,Noah Juulsen,D,VAN,27,36,3,6,9
90,8473446,Erik Johnson,D,PHI,36,50,2,7,9
90,8481599,Victor Soderstrom,D,UTA,23,51,2,7,9
90,8482784,Zach Dean,C,STL,21,42,2,7,9
90,8480007,Jonas Rondbjerg,R,VGK,25,43,2,7,9
90,8484254,Akito Hirose,D,VAN,25,44,2,7,9
90,8475750,Jon Merrill,D,MIN,32,59,2,7,9
90,8476891,Matthew Grzelcyk,D,PIT,30,74,1,8,9
90,8474090,Brendan Smith,D,DAL,35,54,0,9,9
90,8482762,Simon Edvinsson,D,DET,21,48,8,0,8
90,8483397,Marc McLaughlin,C,BOS,25,30,7,1,8
90,8476858,Phillip Di Giuseppe,L,VAN,31,41,5,3,8
90,8479536,Axel Jonsson-Fjallby,L,WPG,26,27,5,3,8
90,8483630,Pavol Regenda,L,ANA,25,37,5,3,8
90,8480806,Isac Lundestrom,C,ANA,25,57,4,4,8
90,8481789,Tye Kartye,L,SEA,23,33,4,4,8
90,8480848,Ty Dellandrea,C,SJS,24,47,4,4,8
90,8475235,Nicolas Deslauriers,L,PHI,33,52,4,4,8
90,8482095,Tyler Kleven,D,OTT,22,39,3,5,8
90,8481056,Spencer Stastney,D,NSH,24,33,3,5,8
90,8477931,Tomas Nosek,L,FLA,32,59,2,6,8
90,8480157,Calle Rosen,D,COL,30,52,2,6,8
90,8478859,Niko Mikkola,D,FLA,28,45,2,6,8
90,8475842,Sam Carrick,C,NYR,32,62,2,6,8
90,8479291,Kevin Rooney,C,CGY,31,49,2,6,8
90,8480292,Carson Meyer,R,ANA,27,34,2,6,8
90,8480844,Grigori Denisenko,L,VGK,24,32,2,6,8
90,8481161,Jake Christiansen,D,CBJ,25,57,1,7,8
90,8479378,Logan Stanley,D,WPG,26,45,1,7,8
90,8477034,Jaycob Megna,D,FLA,32,44,1,7,8
90,8479576,Vincent Desharnais,D,VAN,28,39,0,8,8
90,8475762,Derek Forbort,D,VAN,32,41,0,8,8
90,8481550,Adam Beckman,L,NJD,23,40,5,2,7
90,8478831,Kevin Stenlund,C,UTA,28,59,5,2,7
90,8483570,Ben Meyers,C,SEA,26,26,5,2,7
90,8483460,David Jiricek,D,CBJ,21,61,4,3,7
90,8478017,Mark Friedman,D,VAN,29,37,4,3,7
90,8477473,Justin Bailey,R,SJS,29,23,4,3,7
90,8477401,John Hayden,C,SEA,29,37,3,4,7
90,8478409,Anthony Richard,C,PHI,28,25,3,4,7
90,8482652,Walker Duehr,R,CGY,27,42,3,4,7
90,8481609,Vladislav Kolyachonok,D,UTA,23,37,3,4,7
90,8481598,Philip Broberg,D,EDM,23,38,3,4,7
90,8482141,Lukas Cormier,D,VGK,22,26,3,4,7
90,8478874,Adam Gaudette,R,OTT,28,41,2,5,7
90,8477384,Joshua Brown,D,EDM,30,44,2,5,7
90,8478450,Parker Wotherspoon,D,BOS,27,33,2,5,7
90,8481167,Brayden Pachal,D,CGY,25,46,1,6,7
90,8481527,Kaedan Korczak,D,VGK,23,45,1,6,7
90,8479772,Zack MacEwen,R,OTT,28,49,1,6,7
90,8481518,Nolan Foote,L,NJD,24,39,6,0,6
90,8481679,Maxence Guenette,D,OTT,23,33,6,0,6
90,8482144,Jack Thompson,D,SJS,22,31,5,1,6
90,8482496,Nils Aman,C,VAN,24,33,4,2,6
90,8481147,Reese Johnson,C,MIN,26,37,4,2,6
90,8480267,Sammy Walker,C,MIN,25,25,4,2,6
90,8479367,William Lockwood,R,FLA,26,27,4,2,6
90,8479638,Justin Brazeau,R,BOS,26,43,4,2,6
90,8477462,Robert Hagg,D,VGK,29,29,4,2,6
90,8477962,Brendan Lemieux,L,CAR,28,39,3,3,6
90,8481592,Jakob Pelletier,L,CGY,23,44,3,3,6
90,8483012,Logan Morrison,C,SEA,22,31,3,3,6
90,8479348,Kale Clague,D,BUF,26,36,3,3,6
90,8482145,Mavrik Bourque,C,DAL,22,48,3,3,6
90,8481600,Tobias Bjornfot,D,FLA,23,48,2,4,6
90,8478424,Jansen Harkins,C,ANA,27,41,2,4,6
90,8482751,Ryan Winterton,C,SEA,21,33,2,4,6
90,8479985,Cale Fleury,D,SEA,26,26,2,4,6
90,8476473,Connor Murphy,D,CHI,31,36,1,5,6
90,8482153,Brendan Brisson,C,VGK,23,30,1,5,6
90,8479991,Jake Leschyshyn,C,NYR,25,24,0,6,6
90,8482861,Vincent Iorio,D,WSH,22,38,0,6,6
90,8482859,Zack Ostapchuk,C,OTT,21,50,4,1,5
90,8482118,Sam Colangelo,R,ANA,23,15,4,1,5
90,8482172,Landon Slaggert,L,CHI,22,25,3,2,5
90,8482511,Mason Lohrei,D,BOS,23,37,3,2,5
90,8480252,Cole Guttman,C,CHI,25,26,2,3,5
90,8480879,Jacob Bernard-Docker,D,OTT,24,47,2,3,5
90,8484911,Collin Graf,R,SJS,22,34,2,3,5
90,8474612,Travis Hamonic,D,OTT,34,50,2,3,5
90,8482713,Mackie Samoskevich,R,FLA,22,41,2,3,5
90,8481719,Maxwell Crozier,D,TBL,24,24,2,3,5
90,8480245,Olle Lycksell,R,PHI,25,33,2,3,5
90,8481122,Simon Benoit,D,TOR,26,38,1,4,5
90,8475177,Calvin de Haan,D,COL,33,48,1,4,5
90,8481541,Samuel Bolduc,D,NYI,24,29,1,4,5
90,8481605,Jackson LaCombe,D,ANA,23,30,1,4,5
90,8482858,Ryker Evans,D,SEA,23,29,1,4,5
90,8482201,Gage Goncalves,C,TBL,23,28,1,4,5
90,8482964,Arber Xhekaj,D,MTL,23,50,0,5,5
90,8476441,Joel Edmundson,D,LAK,31,34,0,5,5
90,8480834,Ty Emberson,D,SJS,24,33,0,5,5
90,8478146,Matthew Highmore,C,OTT,28,39,0,5,5
90,8477971,Andreas Englund,D,LAK,28,27,0,5,5
90,8477810,Joel Hanley,D,CGY,33,22,0,5,5
90,8482077,Dylan Holloway,L,EDM,23,45,4,0,4
90,8471817,Ryan Reaves,R,TOR,37,55,3,1,4
90,8474062,Riley Nash,C,NYR,35,18,2,2,4
90,8481043,Cole Koepke,L,BOS,26,19,2,2,4
90,8481532,Alex Turcotte,C,LAK,23,38,1,3,4
90,8483549,Lucas Condotta,L,MTL,27,34,1,3,4
90,8477887,Patrick Brown,C,BOS,32,39,1,3,4
90,8480196,Jacob Bryson,D,BUF,27,48,1,3,4
90,8481006,Tyler Tucker,D,STL,24,15,0,4,4
90,8480032,Shane Bowers,C,NJD,25,19,3,0,3
90,8484325,Waltteri Merela,C,TBL,26,25,3,0,3
90,8475958,Michael Sgarbossa,C,WSH,32,25,2,1,3
90,8481556,John Beecher,C,BOS,23,29,2,1,3
90,8482733,Logan Mailloux,D,MTL,31,33,1,2,3
90,8482177,Marat Khusnutdinov,C,MIN,22,35,1,2,3
90,8477244,Chad Ruhwedel,D,NYR,34,26,1,2,3
90,8478021,William Lagesson,D,DET,28,30,1,2,3
90,8477073,Kurtis MacDermid,L,NJD,30,27,1,2,3
90,8478051,Max Willman,C,NJD,29,18,1,2,3
90,8478881,Brett Seney,L,CHI,28,21,1,2,3
90,8479587,Rhett Gardner,C,PHI,28,22,0,3,3
90,8478502,Dennis Gilbert,D,BUF,28,21,0,3,3
90,8481743,Marc Del Gaizo,D,NSH,25,21,0,3,3
90,8482070,Mitchell Chaffee,R,TBL,26,45,2,0,2
90,8483512,Matthew Savoie,C,EDM,20,17,2,0,2
90,8483763,Maksymilian Szuber,D,UTA,22,32,2,0,2
90,8484258,Sam Malinski,D,COL,26,23,2,0,2
90,8482094,Daemon Hunt,D,MIN,22,18,2,0,2
90,8481585,Egor Afanasyev,L,SJS,23,16,2,0,2
90,8478446,Glenn Gawdin,C,LAK,27,13,2,0,2
90,8480874,Adam Ginning,D,PHI,24,11,1,1,2
90,8481065,Angus Crookshank,L,OTT,25,17,1,1,2
90,8480890,Jan Jenik,C,OTT,24,17,1,1,2
90,8481237,Kyle MacLean,C,NYI,25,25,1,1,2
90,8482765,Isak Rosen,R,BUF,21,24,1,1,2
90,8479421,Jacob Moverare,D,LAK,26,7,1,1,2
90,8482102,Vasily Ponomarev,C,PIT,22,15,1,1,2
90,8482165,Yan Kuznetsov,D,CGY,22,17,1,1,2
90,8478477,Mitchell Stephens,C,SEA,27,23,1,1,2
90,8482061,Brandon Biro,L,SEA,26,10,1,1,2
90,8475413,Justin Dowling,C,NJD,34,12,1,1,2
90,8481578,Graeme Clarke,R,MIN,23,9,1,1,2
90,8483597,Milos Kelemen,L,UTA,25,15,1,1,2
90,8477320,Anton Blidh,L,NYR,29,12,1,1,2
90,8482460,Matt Rempe,C,NYR,22,13,1,1,2
90,8480084,Nick DeSimone,D,NJD,30,14,0,2,2
90,8482162,Roby Jarventie,L,EDM,22,17,0,2,2
90,8479330,Brandon Gignac,C,MTL,27,10,0,2,2
90,8482250,Callahan Burke,C,VGK,27,21,0,2,2
90,8484304,Uvis Balinskis,D,FLA,28,8,0,2,2
90,8482929,Emil Lilleberg,D,TBL,23,22,0,2,2
90,8480823,Alexander Alexeyev,D,WSH,25,9,0,2,2
90,8481655,Cole Schwindt,R,CGY,23,10,0,2,2
90,8482147,Jean-Luc Foudy,C,COL,22,28,1,0,1
90,8481543,Nikita Alexandrov,C,STL,24,24,1,0,1
90,8481462,Mason Morelli,L,VGK,28,16,1,0,1
90,8479379,Givani Smith,R,SJS,26,24,1,0,1
90,8482470,Ilya Solovyov,D,CGY,24,27,1,0,1
90,8479320,Maxime Lajoie,D,SEA,27,17,1,0,1
90,8481206,John Ludvig,D,PIT,24,14,1,0,1
90,8481030,Jack St. Ivany,D,PIT,25,16,1,0,1
90,8484255,Jason Polin,R,COL,25,10,1,0,1
90,8481699,Aku Raty,R,UTA,23,17,1,0,1
90,8481534,Raphael Lavoie,C,EDM,24,1,1,0,1
90,8480851,Akil Thomas,C,LAK,24,15,0,1,1
90,8484287,Cole McWard,D,VAN,23,19,0,1,1
90,8480870,Bo Groulx,C,NYR,24,18,0,1,1
90,8483395,Arshdeep Bains,L,VAN,23,14,0,1,1
90,8481806,Louis Crevier,D,CHI,23,13,0,1,1
90,8481593,Jayden Struble,D,MTL,23,24,0,1,1
90,8475795,Dylan McIlrath,D,WSH,32,8,0,1,1
90,8477149,Scott Sabourin,R,SJS,32,17,0,1,1
90,8481422,Jake Lucchini,C,NSH,29,18,0,1,1
90,8475755,Alexander Petrovic,D,DAL,32,9,0,1,1
90,8480468,James Hamblin,L,EDM,25,24,0,1,1
90,8477993,Justin Kirkland,C,CGY,28,5,0,1,1
90,8477467,Gustav Olofsson,D,SEA,30,18,0,0,0
90,8478147,Bokondji Imama,L,PIT,28,5,0,0,0
90,8483489,Fraser Minten,C,TOR,31,10,0,0,0
90,8483567,Georgii Merkulov,C,BOS,24,10,0,0,0
90,8479419,Brett Murray,L,BUF,26,13,0,0,0
90,8483398,Declan Carlile,D,TBL,31,4,0,0,0
90,8481726,Adam Edstrom,C,NYR,24,10,0,0,0
90,8481024,Linus Karlsson,C,VAN,25,6,0,0,0
90,8484321,Nikolas Matinpalo,D,OTT,26,1,0,0,0
90,8482516,Matthew Kessel,D,STL,24,12,0,0,0
90,8483920,Pierrick Dube,R,WSH,23,3,0,0,0
90,8478854,Ryan Shea,D,PIT,27,9,0,0,0
90,8478011,Louie Belpedio,D,PHI,28,11,0,0,0
90,8480075,Cameron Crotty,D,MIN,25,5,0,0,0
90,8476323,Max McCormick,L,SEA,32,2,0,0,0
90,8483546,Marshall Rifai,D,TOR,26,4,0,0,0
90,8483432,Luca Del Bel Belluz,C,CBJ,31,3,0,0,0
90,8479362,Riley Tufte,L,BOS,26,24,0,0,0
90,8482476,Emil Heineman,L,MTL,23,5,0,0,0
90,8482787,Nikita Chibrikov,R,WPG,31,6,0,0,0
90,8482088,Justin Sourdif,R,FLA,22,13,0,0,0
90,8477541,Dakota Mermis,D,TOR,30,8,0,0,0
90,8483407,Brandon Scanlin,D,NYR,25,7,0,0,0
90,8483401,Marc Johnstone,R,PIT,28,3,0,0,0
90,8483471,Brad Lambert,C,WPG,31,11,0,0,0
90,8482197,Adam Raska,R,MIN,23,8,0,0,0
90,8479522,Hardy Haman Aktell,D,WSH,26,2,0,0,0
90,8481564,Ryan Johnson,D,BUF,23,13,0,0,0
90,8475780,Chris Wagner,R,COL,33,7,0,0,0
90,8482126,Emil Andrae,D,PHI,31,3,0,0,0
90,8480306,Grant Hutton,D,NYI,29,5,0,0,0
90,8484326,Patrik Koch,D,UTA,28,1,0,0,0
90,8483609,Adam Klapka,R,CGY,24,6,0,0,0
90,8483531,Brian Halonen,L,NJD,25,1,0,0,0
90,8478956,Samuel Laberge,L,NJD,27,0,0,0,0
90,8480274,Philip Kemp,D,EDM,25,1,0,0,0
90,8484259,Ondrej Pavel,C,COL,31,4,0,0,0
90,8470794,Joe Pavelski,C,,40,0,0,0,0
90,8479321,Lucas Johansen,D,,27,0,0,0,0
90,8477950,Tony DeAngelo,D,,29,0,0,0,0
90,8471218,Blake Wheeler,R,,38,0,0,0,0
90,8475197,Tyson Barrie,D,,33,0,0,0,0
90,8474157,Max Pacioretty,L,,36,0,0,0,0
90,8475744,Evgeny Kuznetsov,C,,32,0,0,0,0
90,8474037,James van Riemsdyk,L,,35,0,0,0,0
90,8476907,Mackenzie MacEachern,L,,30,0,0,0,0
90,8480216,Jacob Peterson,C,,25,0,0,0,0
90,8474602,Justin Schultz,D,,34,0,0,0,0
90,8482222,Alexander Barabanov,L,,30,0,0,0,0
90,8474031,Kevin Shattenkirk,D,,35,0,0,0,0
90,8477330,Dominik Kubalik,L,,29,0,0,0,0
90,8480884,Calen Addison,D,,24,0,0,0,0
90,8475906,John Klingberg,D,,32,0,0,0,0
90,8480008,Adam Ruzicka,C,,25,0,0,0,0
90,8476884,Derrick Pouliot,D,,30,0,0,0,0
90,8476919,Chris Tierney,C,,30,0,0,0,0
90,8479415,Michael McLeod,C,,26,0,0,0,0
90,8474870,Tyler Johnson,C,,34,0,0,0,0
90,8470604,Jeff Carter,C,,39,0,0,0,0
90,8478104,Sammy Blais,L,,28,0,0,0,0
90,8474884,Mike Hoffman,C,,35,0,0,0,0
90,8481591,Sam Poulin,R,,23,0,0,0,0
90,8471274,Alex Goligoski,D,,39,0,0,0,0
90,8476871,Tanner Pearson,L,,32,0,0,0,0
90,8476393,Nick Cousins,C,,31,0,0,0,0
90,8479977,Kailer Yamamoto,R,,26,0,0,0,0
90,8479346,Dillon Dube,C,,26,0,0,0,0
90,8480184,Gustav Lindstrom,D,,26,0,0,0,0
90,8479376,Victor Mete,D,,26,0,0,0,0
90,8473449,Kyle Okposo,R,,36,0,0,0,0
90,8481058,Jesse Ylonen,R,,25,0,0,0,0
90,8475752,Tyler Pitlick,C,,33,0,0,0,0
90,8481239,Samuel Fagemo,L,,24,0,0,0,0
90,8480821,Filip Zadina,R,,25,0,0,0,0
90,8470966,Mark Giordano,D,,41,0,0,0,0
90,8478495,Denis Gurianov,R,,27,0,0,0,0
90,8477464,Nic Petan,C,,29,0,0,0,0
90,8478099,Kevin Labanc,R,,29,0,0,0,0
90,8482241,Radim Zohorna,L,,28,0,0,0,0
90,8474040,Sam Gagner,C,,35,0,0,0,0
90,8479514,Rem Pitlick,C,,27,0,0,0,0
90,8478430,Oliver Kylington,D,,27,0,0,0,0
90,8479533,Joona Koppanen,L,,26,0,0,0,0
90,8479984,Cal Foote,D,,26,0,0,0,0
90,8477126,Jayson Megna,C,,34,0,0,0,0
90,8475164,Jakob Silfverberg,R,,34,0,0,0,0
90,8474009,Nick Bonino,C,,36,0,0,0,0
90,8479458,Nikita Zaitsev,D,,33,0,0,0,0
90,8477944,Jakub Vrana,L,,28,0,0,0,0
90,8471699,Andrew Cogliano,C,,37,0,0,0,0
90,8478067,Oskar Lindblom,L,,28,0,0,0,0
90,8471686,Marc Staal,D,,37,0,0,0,0
90,8470610,Zach Parise,L,,40,0,0,0,0
90,8478904,Steven Lorentz,C,,28,0,0,0,0
90,8473473,Milan Lucic,L,,36,0,0,0,0
90,8480031,Maxime Comtois,L,,25,0,0,0,0
90,8478512,Austin Czarnik,C,,32,0,0,0,0
90,8473504,Cal Clutterbuck,R,,37,0,0,0,0
90,8477454,Adam Erne,L,,29,0,0,0,0
90,8479383,Boris Katchouk,L,,26,0,0,0,0
90,8475825,Jani Hakanpää,D,,32,0,0,0,0
90,8477846,Ryan Carpenter,C,,33,0,0,0,0
90,8477930,Pierre-Edouard Bellemare,L,,39,0,0,0,0
90,8478400,Colin White,C,,27,0,0,0,0
90,8480226,Marián Studenic,R,,26,0,0,0,0
90,8480853,Liam Foudy,C,,24,0,0,0,0
90,8475797,Jarred Tinordi,D,,32,0,0,0,0
90,8479423,Alex Nylander,L,,26,0,0,0,0
90,8474618,Marco Scandella,D,,34,0,0,0,0
90,8478028,Fredrik Olofsson,L,,28,0,0,0,0
90,8474709,Matt Martin,L,,35,0,0,0,0
90,8481070,Hugh McGing,L,,26,0,0,0,0
90,8479546,Oskar Steen,C,,26,0,0,0,0
90,8474145,Robert Bortuzzo,D,,35,0,0,0,0
90,8476915,Jujhar Khaira,L,,30,0,0,0,0
90,8475278,Byron Froese,C,,33,0,0,0,0
90,8481812,Nikolai Knyzhov,D,,27,0,0,0,0
90,8478408,Travis Dermott,D,,28,0,0,0,0
90,8481077,John Leonard,L,,26,0,0,0,0
90,8479547,Matthew Phillips,R,,26,0,0,0,0
90,8480836,Jonathan Gruden,C,,24,0,0,0,0
90,8481690,Tyler Angle,C,,24,0,0,0,0
90,8475766,Austin Watson,L,,32,0,0,0,0
90,8481016,Ruslan Iskhakov,C,,24,0,0,0,0
90,8478078,Rourke Chartier,C,,28,0,0,0,0
90,8480776,Sheldon Rempal,R,,29,0,0,0,0
90,8483045,Cameron Butler,R,CBJ,31,1,0,0,0
90,8484314,Jiri Smejkal,L,,28,0,0,0,0
91,8479318,Auston Matthews,C,TOR,27,78,77,59,136
91,8481559,Jack Hughes,C,NJD,23,75,58,78,136
91,8478483,Mitch Marner,R,TOR,27,80,38,98,136
91,8478402,Connor McDavid,C,EDM,27,77,44,90,134
91,8477492,Nathan MacKinnon,C,COL,29,80,50,83,133
91,8476453,Nikita Kucherov,R,TBL,31,82,36,89,125
91,8478550,Artemi Panarin,L,NYR,33,77,36,81,117
91,8478420,Mikko Rantanen,R,COL,28,81,47,68,115
91,8477956,David Pastrnak,R,BOS,28,81,63,51,114
91,8479314,Matthew Tkachuk,L,FLA,27,78,35,76,111
91,8477939,William Nylander,R,TOR,28,78,42,68,110
91,8477934,Leon Draisaitl,C,EDM,29,75,36,71,107
91,8480027,Jason Robertson,L,DAL,25,82,34,73,107
91,8474564,Steven Stamkos,C,NSH,34,73,40,66,106
91,8476468,J.T. Miller,C,VAN,31,72,34,67,101
91,8480012,Elias Pettersson,C,VAN,26,79,38,62,100
91,8478864,Kirill Kaprizov,L,MIN,27,79,38,58,96
91,8477493,Aleksander Barkov,C,FLA,29,82,27,69,96
91,8476389,Vincent Trocheck,C,NYR,31,76,41,53,94
91,8476887,Filip Forsberg,L,NSH,30,71,40,53,93
91,8477404,Jake Guentzel,C,TBL,30,81,35,58,93
91,8473419,Brad Marchand,L,BOS,36,79,27,65,92
91,8478445,Mathew Barzal,C,NYI,27,79,21,71,92
91,8477946,Dylan Larkin,C,DET,28,80,42,49,91
91,8484144,Connor Bedard,C,CHI,19,71,30,60,90
91,8478403,Jack Eichel,C,VGK,28,79,43,45,88
91,8476460,Mark Scheifele,C,WPG,31,75,35,53,88
91,8480002,Nico Hischier,C,NJD,25,78,30,58,88
91,8471675,Sidney Crosby,C,PIT,37,78,35,52,87
91,8475172,Nazem Kadri,C,CGY,34,80,31,56,87
91,8480800,Quinn Hughes,D,VAN,25,70,14,72,86
91,8478398,Kyle Connor,L,WPG,28,72,37,45,82
91,8479343,Clayton Keller,R,UTA,26,73,32,50,82
91,8475168,Matt Duchene,C,DAL,33,82,31,51,82
91,8476454,Ryan Nugent-Hopkins,C,EDM,31,81,29,52,81
91,8475166,John Tavares,C,TOR,34,80,39,40,79
91,8474141,Patrick Kane,R,DET,36,80,35,44,79
91,8474600,Roman Josi,D,NSH,34,69,22,57,79
91,8480069,Cale Makar,D,COL,26,71,21,58,79
91,8481540,Cole Caufield,R,MTL,23,75,40,38,78
91,8480830,Andrei Svechnikov,R,CAR,24,72,30,48,78
91,8476346,Johnny Gaudreau,L,CBJ,31,71,19,59,78
91,8477409,Carter Verhaeghe,C,FLA,29,79,41,36,77
91,8482740,Wyatt Johnston,C,DAL,21,81,40,37,77
91,8477501,Valeri Nichushkin,R,COL,29,82,39,38,77
91,8477933,Sam Reinhart,C,FLA,29,74,33,44,77
91,8479407,Jesper Bratt,L,NJD,26,73,23,54,77
91,8476456,Jonathan Huberdeau,C,CGY,31,78,19,58,77
91,8475692,Mats Zuccarello,R,MIN,37,67,18,59,77
91,8474679,Gustav Nyquist,C,NSH,35,75,24,52,76
91,8477942,Kevin Fiala,L,LAK,28,80,27,48,75
91,8475913,Mark Stone,R,VGK,32,74,27,47,74
91,8478449,Roope Hintz,C,DAL,28,81,41,32,73
91,8478427,Sebastian Aho,C,CAR,27,72,31,42,73
91,8478444,Brock Boeser,R,VAN,27,75,29,44,73
91,8478047,Michael Bunting,L,PIT,29,76,29,44,73
91,8476459,Mika Zibanejad,C,NYR,31,80,28,45,73
91,8480023,Robert Thomas,C,STL,25,76,24,49,73
91,8481557,Matt Boldy,L,MIN,23,73,35,37,72
91,8480039,Martin Necas,C,CAR,25,67,35,37,72
91,8478493,Joel Eriksson Ek,C,MIN,27,70,29,43,72
91,8473994,Jamie Benn,L,DAL,35,81,25,47,72
91,8475167,Victor Hedman,D,TBL,34,82,13,59,72
91,8476539,Jonathan Marchessault,R,NSH,34,73,33,38,71
91,8478010,Brayden Point,C,TBL,28,82,35,34,69
91,8475754,Brock Nelson,C,NYI,33,80,32,37,69
91,8480801,Brady Tkachuk,L,OTT,25,80,28,41,69
91,8479337,Alex DeBrincat,R,DET,27,80,28,41,69
91,8476853,Morgan Rielly,D,TOR,30,69,9,60,69
91,8482116,Tim Stützle,C,OTT,22,78,21,47,68
91,8477949,Alex Tuch,R,BUF,28,72,21,47,68
91,8478440,Dylan Strome,C,WSH,27,75,17,51,68
91,8475786,Zach Hyman,L,EDM,32,78,34,33,67
91,8471214,Alex Ovechkin,L,WSH,39,75,33,34,67
91,8478439,Travis Konecny,R,PHI,27,75,17,50,67
91,8478460,Zach Werenski,D,CBJ,27,81,17,50,67
91,8479325,Charlie McAvoy,D,BOS,27,72,13,54,67
91,8479420,Tage Thompson,C,BUF,27,73,32,34,66
91,8475765,Vladimir Tarasenko,R,DET,33,82,28,38,66
91,8477402,Pavel Buchnevich,L,STL,29,74,22,44,66
91,8478407,Vince Dunn,D,SEA,28,71,16,50,66
91,8479323,Adam Fox,D,NYR,26,72,11,55,66
91,8479999,Casey Mittelstadt,C,COL,26,80,19,46,65
91,8481068,Yegor Sharangovich,C,CGY,26,77,34,30,64
91,8475794,Tyler Seguin,C,DAL,32,81,29,35,64
91,8482093,Seth Jarvis,C,CAR,22,72,28,36,64
91,8477940,Nikolaj Ehlers,L,WPG,28,74,23,41,64
91,8477496,Elias Lindholm,C,BOS,30,77,20,44,64
91,8477504,Josh Morrissey,D,WPG,29,76,17,47,64
91,8475184,Chris Kreider,L,NYR,33,75,33,30,63
91,8478414,Timo Meier,R,NJD,28,73,29,34,63
91,8471685,Anze Kopitar,C,LAK,37,81,25,38,63
91,8475784,Jeff Skinner,C,EDM,32,76,30,32,62
91,8482078,Lucas Raymond,L,DET,22,81,27,35,62
91,8478856,Conor Garland,R,VAN,28,78,19,43,62
91,8474578,Erik Karlsson,D,PIT,34,78,12,50,62
91,8478366,Frank Vatrano,R,ANA,30,75,33,28,61
91,8482149,Cole Perfetti,C,WPG,22,70,25,36,61
91,8480018,Nick Suzuki,C,MTL,25,77,18,43,61
91,8480036,Miro Heiskanen,D,DAL,25,76,10,51,61
91,8483515,Juraj Slafkovsky,L,MTL,20,74,32,28,60
91,8479542,Brandon Hagel,L,TBL,26,82,29,31,60
91,8478233,Andrew Mangiapane,L,WSH,28,72,24,36,60
91,8476881,Tomas Hertl,C,VGK,31,79,22,38,60
91,8482159,Tyson Foerster,R,PHI,22,79,25,34,59
91,8481581,Thomas Harley,D,DAL,23,77,20,39,59
91,8473512,Claude Giroux,R,OTT,36,78,19,40,59
91,8477951,Nick Schmaltz,C,UTA,28,74,15,44,59
91,8477476,Artturi Lehkonen,L,COL,29,81,31,27,58
91,8482745,Mason McTavish,C,ANA,21,73,25,33,58
91,8477960,Adrian Kempe,R,LAK,28,80,23,35,58
91,8481711,Matias Maccelli,L,UTA,24,78,21,37,58
91,8480865,Noah Dobson,D,NYI,24,81,7,51,58
91,8471215,Evgeni Malkin,C,PIT,38,76,30,27,57
91,8479385,Jordan Kyrou,C,STL,26,74,28,29,57
91,8478542,Evan Rodrigues,C,FLA,31,74,19,38,57
91,8479425,Filip Hronek,D,VAN,27,78,13,44,57
91,8480014,Gabriel Vilardi,C,WPG,25,65,29,27,56
91,8480208,Drake Batherson,R,OTT,26,80,25,31,56
91,8475158,Ryan O'Reilly,C,NSH,33,69,22,34,56
91,8475745,Charlie Coyle,C,BOS,32,81,19,37,56
91,8471724,Kris Letang,D,PIT,37,79,12,44,56
91,8477407,Anthony Duclair,L,NYI,29,79,26,29,55
91,8477500,Bo Horvat,C,NYI,29,82,25,30,55
91,8476483,Rickard Rakell,R,PIT,31,69,25,30,55
91,8477416,Oliver Bjorkstrand,R,SEA,29,70,24,31,55
91,8484166,Adam Fantilli,C,CBJ,20,66,21,34,55
91,8479675,Trevor Moore,L,LAK,29,79,20,35,55
91,8476479,Phillip Danault,C,LAK,31,80,20,35,55
91,8478438,Tommy Novak,C,NSH,27,71,15,40,55
91,8480803,Evan Bouchard,D,EDM,25,71,14,41,55
91,8475726,Tyler Toffoli,C,SJS,32,66,31,23,54
91,8475810,Bryan Rust,R,PIT,32,64,26,28,54
91,8477986,Brandon Montour,D,SEA,30,75,14,40,54
91,8477503,Max Domi,C,TOR,29,78,11,43,54
91,8478401,Pavel Zacha,C,BOS,27,80,29,24,53
91,8474641,Adam Henrique,C,EDM,34,78,23,30,53
91,8474149,Evgenii Dadonov,R,DAL,35,80,20,33,53
91,8478055,Gustav Forsling,D,FLA,28,76,8,45,53
91,8475768,Jaden Schwartz,C,SEA,32,71,23,29,52
91,8475793,Ryan Johansen,C,PHI,32,73,21,31,52
91,8475287,Erik Haula,L,NJD,33,75,20,32,52
91,8481535,Nils Hoglander,L,VAN,24,71,29,22,51
91,8474586,Jordan Eberle,R,SEA,34,72,24,27,51
91,8476399,Blake Coleman,C,CGY,33,75,23,28,51
91,8478975,Mason Marchment,L,DAL,29,82,15,36,51
91,8477494,Jonathan Drouin,L,COL,29,79,12,39,51
91,8475151,Kyle Palmieri,C,NYI,33,79,25,25,50
91,8476448,William Karlsson,C,VGK,31,75,24,26,50
91,8476880,Tom Wilson,R,WSH,30,67,19,31,50
91,8475170,Brayden Schenn,C,STL,33,71,18,32,50
91,8481528,Dylan Cozens,C,BUF,23,74,12,38,50
91,8480797,Joel Farabee,L,PHI,24,75,22,27,49
91,8478396,Noah Hanifin,D,VGK,27,64,8,41,49
91,8478038,Devon Toews,D,COL,30,69,8,41,49
91,8480015,Owen Tippett,R,PHI,25,71,28,20,48
91,8482699,Dylan Guenther,R,UTA,21,73,25,23,48
91,8482109,Alexis Lafrenière,L,NYR,23,73,25,23,48
91,8477935,Sam Bennett,C,FLA,28,78,23,25,48
91,8483808,Andrei Kuzmenko,L,CGY,28,76,20,28,48
91,8473986,Alex Killorn,L,ANA,35,75,18,30,48
91,8480798,Philipp Kurashev,C,CHI,25,65,17,31,48
91,8477495,Seth Jones,D,CHI,30,73,14,34,48
91,8475753,Justin Faulk,D,STL,32,74,9,39,48
91,8479410,Mikhail Sergachev,D,UTA,26,70,8,40,48
91,8480028,Morgan Frost,C,PHI,25,72,24,23,47
91,8475191,Reilly Smith,R,NYR,33,71,21,26,47
91,8477511,Anthony Mantha,R,CGY,30,74,20,27,47
91,8477456,J.T. Compher,L,DET,29,80,19,28,47
91,8476905,Chandler Stephenson,C,SEA,30,72,12,35,47
91,8482122,Brock Faber,D,MIN,22,80,9,38,47
91,8476875,Mike Matheson,D,MTL,30,75,6,41,47
91,8476432,Boone Jenner,C,CBJ,31,68,30,16,46
91,8471698,T.J. Oshie,R,WSH,38,68,21,25,46
91,8478873,Troy Terry,R,ANA,27,71,19,27,46
91,8479339,Patrik Laine,L,CBJ,26,66,19,27,46
91,8474590,John Carlson,D,WSH,34,69,12,34,46
91,8477447,Shea Theodore,D,VGK,29,57,10,36,46
91,8470613,Brent Burns,D,CAR,39,79,6,40,46
91,8476958,Jaccob Slavin,D,CAR,30,77,4,42,46
91,8475314,Anders Lee,L,NYI,34,80,30,15,45
91,8481560,Arthur Kaliyev,R,LAK,23,82,27,18,45
91,8477426,Nicholas Paul,L,TBL,29,81,25,20,45
91,8480802,Ryan McLeod,C,BUF,25,67,25,20,45
91,8480188,Fabian Zetterlund,L,SJS,25,70,20,25,45
91,8477451,Ryan Hartman,R,MIN,30,71,18,27,45
91,8475798,Mikael Granlund,C,SJS,32,65,9,36,45
91,8482702,Logan Stankoven,C,DAL,21,81,24,20,44
91,8476438,Brandon Saad,L,STL,32,73,20,24,44
91,8483505,Matthew Poitras,C,BOS,20,76,17,27,44
91,8477429,Andrew Copp,C,DET,30,82,17,27,44
91,8476882,Teuvo Teravainen,C,CHI,30,65,17,27,44
91,8475848,Brendan Gallagher,R,MTL,32,76,17,27,44
91,8476462,Dougie Hamilton,D,NJD,31,75,16,28,44
91,8477021,Alex Kerfoot,C,UTA,30,79,13,31,44
91,8476292,Ondrej Palat,L,NJD,33,73,12,32,44
91,8480839,Rasmus Dahlin,D,BUF,24,71,11,33,44
91,8481533,Trevor Zegras,C,ANA,23,74,11,33,44
91,8476906,Shayne Gostisbehere,D,CAR,31,78,8,36,44
91,8477955,Jared McCann,L,SEA,28,72,24,19,43
91,8480835,Jack Drury,C,CAR,24,66,21,22,43
91,8482146,Luke Evangelista,R,NSH,22,65,20,23,43
91,8478462,Nicolas Roy,C,VGK,27,77,17,26,43
91,8478472,Mathieu Joseph,R,STL,27,66,14,29,43
91,8482684,Luke Hughes,D,NJD,21,68,9,34,43
91,8481542,Moritz Seider,D,DET,23,77,7,36,43
91,8482175,JJ Peterka,R,BUF,22,70,28,14,42
91,8478519,Anthony Cirelli,C,TBL,27,82,25,17,42
91,8475714,Calle Jarnkrok,C,TOR,33,73,23,19,42
91,8478057,Dakota Joshua,C,VAN,28,64,22,20,42
91,8482665,Matty Beniers,C,SEA,22,70,20,22,42
91,8475169,Evander Kane,L,EDM,33,77,20,22,42
91,8482113,Anton Lundell,C,FLA,23,72,18,24,42
91,8476792,Torey Krug,D,STL,33,73,14,28,42
91,8476869,Brady Skjei,D,NSH,30,71,9,33,42
91,8478397,Rasmus Andersson,D,CGY,28,73,5,37,42
91,8482089,Jake Neighbours,L,STL,22,75,31,10,41
91,8475799,Nino Niederreiter,R,WPG,32,64,23,18,41
91,8483431,Logan Cooley,C,UTA,20,71,19,22,41
91,8479987,Morgan Geekie,C,BOS,26,77,17,24,41
91,8480185,Eetu Luostarinen,C,FLA,26,73,17,24,41
91,8481524,Bowen Byram,D,BUF,23,66,15,26,41
91,8481618,Alex Newhook,C,MTL,23,76,14,27,41
91,8482124,Quinton Byfield,R,LAK,22,80,13,28,41
91,8476872,Scott Laughton,C,PHI,30,71,12,29,41
91,8477444,Andre Burakovsky,L,SEA,29,74,11,30,41
91,8482667,William Eklund,L,SJS,22,66,27,13,40
91,8482720,Matthew Knies,L,TOR,22,80,22,18,40
91,8482110,Dawson Mercer,C,NJD,23,69,18,22,40
91,8478042,Viktor Arvidsson,L,EDM,31,74,17,23,40
91,8484153,Leo Carlsson,C,ANA,20,71,16,24,40
91,8479400,Pierre-Luc Dubois,L,WSH,26,68,15,25,40
91,8478498,Jake DeBrusk,L,VAN,28,74,19,20,39
91,8475760,Nick Bjugstad,C,UTA,32,72,19,20,39
91,8478115,Pierre Engvall,L,NYI,28,77,19,20,39
91,8477987,Ryan Donato,C,CHI,28,70,19,20,39
91,8477964,Ivan Barbashev,C,VGK,29,76,17,22,39
91,8474150,Mikael Backlund,C,CGY,35,78,15,24,39
91,8477497,Sean Monahan,C,CBJ,30,68,14,25,39
91,8480434,Sean Durzi,D,UTA,26,73,8,31,39
91,8478458,John (Jack) Roslovic,C,CAR,27,64,16,22,38
91,8480068,Ryan Poehling,C,PHI,25,71,16,22,38
91,8479365,Trent Frederic,C,BOS,26,79,13,25,38
91,8481596,Shane Pinto,C,OTT,24,79,11,27,38
91,8477953,Kasperi Kapanen,R,STL,28,70,11,27,38
91,8474563,Drew Doughty,D,LAK,35,69,9,29,38
91,8476854,Hampus Lindholm,D,BOS,30,73,8,30,38
91,8480064,Josh Norris,C,OTT,25,76,20,17,37
91,8477998,Warren Foegele,L,LAK,28,81,19,18,37
91,8474102,David Perron,L,OTT,36,77,18,19,37
91,8475763,Kevin Hayes,R,PIT,32,72,17,20,37
91,8476278,Colin Blackwell,C,DAL,31,76,13,24,37
91,8478466,Daniel Sprong,R,VAN,27,66,12,25,37
91,8476422,Mike Reilly,D,NYI,31,77,12,25,37
91,8482097,Jack Quinn,R,BUF,23,65,8,29,37
91,8476458,Ryan Strome,C,ANA,31,67,8,29,37
91,8482092,Ridly Greig,C,OTT,22,77,17,19,36
91,8480459,Pius Suter,C,VAN,28,64,16,20,36
91,8481604,Pavel Dorofeyev,L,VGK,24,69,15,21,36
91,8480220,Noah Cates,L,PHI,25,72,12,24,36
91,8477479,Tyler Bertuzzi,L,CHI,29,60,10,26,36
91,8476923,Damon Severson,D,CBJ,30,79,8,28,36
91,8474565,Alex Pietrangelo,D,VGK,34,61,6,30,36
91,8478109,Victor Olofsson,L,VGK,29,66,19,16,35
91,8483493,Frank Nazar,C,CHI,20,56,19,16,35
91,8481186,Logan O'Connor,R,COL,28,78,17,18,35
91,8479591,Michael Eyssimont,C,TBL,28,81,15,20,35
91,8473533,Jordan Staal,C,CAR,36,69,14,21,35
91,8477839,Conor Sheary,L,TBL,32,82,13,22,35
91,8476419,Jean-Gabriel Pageau,C,NYI,32,72,11,24,35
91,8474716,Jared Spurgeon,D,MIN,35,73,11,24,35
91,8482133,Thomas Bordeleau,C,SJS,22,66,10,25,35
91,8480817,K'Andre Miller,D,NYR,24,71,6,29,35
91,8475764,Cam Fowler,D,ANA,33,73,3,32,35
91,8478474,Lawson Crouse,L,UTA,27,71,21,13,34
91,8479525,Ross Colton,C,COL,28,79,19,15,34
91,8478046,Danton Heinen,L,VAN,29,67,18,16,34
91,8478469,Thomas Chabot,D,OTT,27,75,12,22,34
91,8482705,Cole Sillinger,C,CBJ,21,68,16,17,33
91,8474715,Cameron Atkinson,R,TBL,35,80,16,17,33
91,8476474,Stefan Noesen,R,NJD,31,68,15,18,33
91,8482475,Yegor Chinakhov,R,CBJ,23,69,14,19,33
91,8477948,Travis Sanheim,D,PHI,28,62,12,21,33
91,8475200,Dmitry Orlov,D,CAR,33,73,10,23,33
91,8482067,Connor Mackey,D,NYR,28,67,8,25,33
91,8475149,Marcus Johansson,L,MIN,34,59,17,15,32
91,8481624,Ilya Mikheyev,R,CHI,30,56,17,15,32
91,8479996,Cody Glass,C,NSH,25,61,16,16,32
91,8478463,Anthony Beauvillier,L,PIT,27,66,14,18,32
91,8479992,Michael Rasmussen,C,DET,25,79,13,19,32
91,8473422,Nick Foligno,L,CHI,37,59,12,20,32
91,8480078,Filip Chytil,C,NYR,25,63,11,21,32
91,8482660,Kent Johnson,C,CBJ,22,68,11,21,32
91,8476925,Colton Sissons,C,NSH,31,64,9,23,32
91,8480145,Neal Pionk,D,WPG,29,73,7,25,32
91,8476917,Adam Pelech,D,NYI,30,77,7,25,32
91,8482712,Oskar Olausson,R,COL,22,72,6,26,32
91,8479398,Samuel Girard,D,COL,26,69,3,29,32
91,8482125,Alexander Holtz,R,VGK,22,65,20,11,31
91,8479345,Jakob Chychrun,D,WSH,26,63,13,18,31
91,8484145,Zach Benson,L,BUF,19,68,12,19,31
91,8481703,Valtteri Puustinen,R,PIT,25,64,8,23,31
91,8482671,Owen Power,D,BUF,22,65,8,23,31
91,8478500,Ivan Provorov,D,CBJ,27,76,6,25,31
91,8477478,William Carrier,L,CAR,30,60,17,13,30
91,8480009,Eeli Tolvanen,R,SEA,25,72,16,14,30
91,8480849,Barrett Hayton,C,UTA,24,77,16,14,30
91,8480762,Eric Robinson,L,CAR,29,58,15,15,30
91,8478911,Matt Roy,D,WSH,29,64,12,18,30
91,8476826,Yanni Gourde,C,SEA,33,70,11,19,30
91,8480871,Adam Boqvist,D,FLA,24,71,10,20,30
91,8481577,Philip Tomasino,C,NSH,23,59,10,20,30
91,8476927,Teddy Blueger,C,VAN,30,66,8,22,30
91,8481521,Ronnie Attard,D,PHI,25,61,8,22,30
91,8478020,Michael Amadio,R,OTT,28,72,15,14,29
91,8480113,Alex Iafallo,L,WPG,31,68,15,14,29
91,8479661,Tanner Jeannot,L,LAK,27,78,15,14,29
91,8482117,Lukas Reichel,L,CHI,22,55,14,15,29
91,8475193,Tomas Tatar,L,NJD,34,66,14,15,29
91,8482749,Joshua Roy,R,MTL,21,67,12,17,29
91,8476878,Zemgus Girgensons,C,TBL,30,82,12,17,29
91,8477346,MacKenzie Weegar,D,CGY,30,73,11,18,29
91,8482055,Drew O'Connor,L,PIT,26,64,11,18,29
91,8481523,Kirby Dach,C,MTL,23,62,11,18,29
91,8475218,Mattias Ekholm,D,EDM,34,71,7,22,29
91,8483490,Pavel Mintyukov,D,ANA,21,72,7,22,29
91,8476979,Erik Gustafsson,D,DET,32,75,7,22,29
91,8479402,Jake Bean,D,CGY,26,67,6,23,29
91,8476918,Jimmy Vesey,L,NYR,31,65,18,10,28
91,8477952,Robby Fabbri,C,ANA,28,64,18,10,28
91,8476981,Josh Anderson,R,MTL,30,70,17,11,28
91,8477919,Frederick Gaudreau,C,MIN,31,64,17,11,28
91,8483468,Jiri Kulich,C,BUF,20,67,15,13,28
91,8476480,Vladislav Namestnikov,C,WPG,32,69,13,15,28
91,8481582,Nicholas Robertson,L,TOR,23,68,13,15,28
91,8480829,Jesperi Kotkaniemi,C,CAR,24,57,9,19,28
91,8477989,Christian Dvorak,C,MTL,28,62,9,19,28
91,8480813,Joe Veleno,C,DET,24,77,7,21,28
91,8477506,Ryan Pulock,D,NYI,30,77,4,24,28
91,8476892,Colton Parayko,D,STL,31,61,3,25,28
91,8480893,Kirill Marchenko,R,CBJ,24,57,19,8,27
91,8475722,Jason Zucker,L,BUF,32,61,16,11,27
91,8482679,Matt Coronato,R,CGY,22,61,12,15,27
91,8476392,Adam Lowry,C,WPG,31,63,11,16,27
91,8482062,Cole Smith,L,NSH,29,56,11,16,27
91,8478891,Mason Appleton,C,WPG,28,69,9,18,27
91,8474053,Logan Couture,C,SJS,35,56,8,19,27
91,8476921,Jordan Martinook,L,CAR,32,56,8,19,27
91,8477505,Alexander Wennberg,C,SJS,30,61,7,20,27
91,8481546,Cam York,D,PHI,23,70,6,21,27
91,8479315,Joey Anderson,R,CHI,26,55,6,21,27
91,8475171,Oliver Ekman-Larsson,D,TOR,33,66,5,22,27
91,8482655,Janis Moser,D,TBL,24,79,3,24,27
91,8483499,Liam Ohgren,L,MIN,20,55,13,13,26
91,8477932,Aaron Ekblad,D,FLA,28,74,11,15,26
91,8481554,Kaapo Kakko,R,NYR,23,70,11,15,26
91,8479351,Sam Steel,C,DAL,26,79,10,16,26
91,8481481,Blake Lizotte,C,PIT,27,65,9,17,26
91,8476461,Sean Couturier,C,PHI,32,62,7,19,26
91,8481606,Jordan Spence,D,LAK,23,60,6,20,26
91,8482101,Danil Gushchin,L,SJS,22,61,6,20,26
91,8476463,Jonas Brodin,D,MIN,31,78,4,22,26
91,8479371,Dante Fabbro,D,NSH,26,68,2,24,26
91,8482079,Marco Rossi,C,MIN,23,66,16,9,25
91,8479414,Nathan Bastian,R,NJD,27,55,14,11,25
91,8483524,Shane Wright,C,SEA,20,56,11,14,25
91,8481032,Paul Cotter,C,NJD,25,60,9,16,25
91,8475231,Casey Cizikas,C,NYI,33,73,9,16,25
91,8477498,Darnell Nurse,D,EDM,29,70,8,17,25
91,8479983,Mario Ferraro,D,SJS,26,76,6,19,25
91,8476902,Esa Lindell,D,DAL,30,71,5,20,25
91,8480873,Rasmus Sandin,D,WSH,24,61,4,21,25
91,8479941,Justin Danforth,R,CBJ,31,61,16,8,24
91,8482074,Connor Zary,C,CGY,23,67,12,12,24
91,8479439,Jacob MacDonald,D,COL,31,53,12,12,24
91,8479293,Brandon Tanev,L,SEA,33,67,11,13,24
91,8484203,Bradly Nadeau,L,CAR,19,66,9,15,24
91,8477903,Garnet Hathaway,R,PHI,33,68,9,15,24
91,8480789,Oliver Wahlstrom,R,NYI,24,69,8,16,24
91,8482624,Daniil Miromanov,D,CGY,27,63,6,18,24
91,8480043,Timothy Liljegren,D,TOR,25,61,6,18,24
91,8477220,Nate Schmidt,D,FLA,33,67,6,18,24
91,8478840,Will Borgen,D,SEA,28,64,5,19,24
91,8475233,David Savard,D,MTL,34,65,5,19,24
91,8480887,Jordan Harris,D,MTL,24,55,3,21,24
91,8482259,Bobby McMann,C,TOR,28,65,18,5,23
91,8479390,Taylor Raddysh,R,WSH,26,69,12,11,23
91,8470621,Corey Perry,R,EDM,39,77,12,11,23
91,8476960,Andreas Athanasiou,C,CHI,30,48,12,11,23
91,8481553,Bobby Brink,R,PHI,23,60,11,12,23
91,8479393,Noah Gregor,L,OTT,26,69,10,13,23
91,8477392,Hudson Fasching,R,NYI,29,64,10,13,23
91,8476897,Oskar Sundqvist,C,STL,30,69,10,13,23
91,8476469,Joel Armia,R,MTL,31,61,9,14,23
91,8477435,Ryan Graves,D,PIT,29,76,9,14,23
91,8480144,David Kampf,C,TOR,29,70,9,14,23
91,8479368,Max Jones,L,BOS,26,63,9,14,23
91,8475791,Taylor Hall,L,CHI,33,53,8,15,23
91,8483565,Nick Blankenburg,D,NSH,26,66,8,15,23
91,8475181,Nick Leddy,D,STL,33,71,6,17,23
91,8481441,Joe Snively,C,DET,28,68,6,17,23
91,8477969,Marcus Pettersson,D,PIT,28,79,5,18,23
91,8476879,Cody Ceci,D,EDM,31,72,5,18,23
91,8476885,Jacob Trouba,D,NYR,30,72,4,19,23
91,8478416,Erik Cernak,D,TBL,27,74,1,22,23
91,8475324,Nick Jensen,D,OTT,34,68,0,23,23
91,8476873,Mark Jankowski,C,NSH,30,56,14,8,22
91,8482737,Zack Bolduc,C,STL,21,55,13,9,22
91,8481601,Simon Holmstrom,R,NYI,23,67,13,9,22
91,8480748,Kiefer Sherwood,L,VAN,29,55,12,10,22
91,8477482,Zachary Sanford,L,CHI,30,46,12,10,22
91,8480003,Jesper Boqvist,C,FLA,26,64,11,11,22
91,8475855,Jesper Fast,R,CAR,33,58,11,11,22
91,8479344,Jesse Puljujarvi,R,PIT,26,50,11,11,22
91,8480448,Parker Kelly,L,COL,25,77,10,12,22
91,8480855,Jack McBain,C,UTA,24,72,9,13,22
91,8480073,Erik Brannstrom,D,COL,25,62,7,15,22
91,8478413,Jordan Greenway,L,BUF,27,65,6,16,22
91,8478452,Caleb Jones,D,LAK,27,61,6,16,22
91,8478882,Vladislav Gavrikov,D,LAK,29,63,5,17,22
91,8476312,Josh Manson,D,COL,33,66,5,17,22
91,8476429,Scott Mayfield,D,NYI,32,72,4,18,22
91,8481568,Alex Vlasic,D,CHI,23,49,4,18,22
91,8479980,Nicolas Hague,D,VGK,26,53,4,18,22
91,8478851,Alexandre Carrier,D,NSH,28,70,4,18,22
91,8480035,Henri Jokiharju,D,BUF,25,64,4,18,22
91,8474151,Ryan McDonagh,D,TBL,35,74,2,20,22
91,8480172,Jan Rutta,D,SJS,34,63,2,20,22
91,8476891,Matthew Grzelcyk,D,PIT,30,75,2,20,22
91,8477369,Carson Soucy,D,VAN,30,66,13,8,21
91,8481704,Juuso Parssinen,C,NSH,23,58,12,9,21
91,8475842,Sam Carrick,C,NYR,32,61,10,11,21
91,8479066,Ryan Lomberg,L,CGY,30,67,9,12,21
91,8475220,Marcus Foligno,L,MIN,33,53,9,12,21
91,8480995,Pontus Holmberg,R,TOR,25,58,9,12,21
91,8479619,Michael Carcone,L,UTA,28,60,9,12,21
91,8483482,Tristan Luneau,D,ANA,20,64,9,12,21
91,8482105,Jake Sanderson,D,OTT,22,68,8,13,21
91,8482111,Justin Barron,D,MTL,23,63,8,13,21
91,8478133,Jake Evans,C,MTL,28,69,7,14,21
91,8477507,Nikita Zadorov,D,BOS,29,67,7,14,21
91,8478136,Jake Middleton,D,MIN,28,72,4,17,21
91,8477845,Trevor van Riemsdyk,D,WSH,33,63,2,19,21
91,8479998,Mikey Anderson,D,LAK,25,64,1,20,21
91,8478013,Jake Walman,D,SJS,28,71,9,11,20
91,8481522,Peyton Krebs,C,BUF,23,59,7,13,20
91,8477015,Connor Brown,R,EDM,30,62,7,13,20
91,8478399,Jonas Siegenthaler,D,NJD,27,65,6,14,20
91,8474189,Lars Eller,C,PIT,35,64,4,16,20
91,8477488,Brett Pesce,D,NJD,30,72,4,16,20
91,8482073,Braden Schneider,D,NYR,23,60,4,16,20
91,8480891,Michael Kesselring,D,UTA,24,62,4,16,20
91,8473507,Jeff Petry,D,DET,37,76,3,17,20
91,8470600,Ryan Suter,D,STL,39,64,3,17,20
91,8479639,Dylan Coghlan,D,WPG,26,62,3,17,20
91,8478507,John Marino,D,UTA,27,66,2,18,20
91,8480246,Nick Perbix,D,TBL,26,72,2,18,20
91,8481178,Egor Zamula,D,PHI,24,65,2,18,20
91,8480878,Nils Lundkvist,D,DAL,24,70,1,19,20
91,8479336,Carl Grundstrom,R,SJS,27,60,11,8,19
91,8477450,Jason Dickinson,C,CHI,29,59,10,9,19
91,8479353,Brett Howden,C,VGK,26,68,9,10,19
91,8481028,Martin Pospisil,C,CGY,25,57,9,10,19
91,8478043,Sam Lafferty,C,BUF,29,59,9,10,19
91,8480980,Connor Dewar,C,TOR,25,63,9,10,19
91,8476374,Sean Kuraly,C,CBJ,31,57,8,11,19
91,8479328,Julien Gauthier,R,NYI,27,62,7,12,19
91,8481527,Kaedan Korczak,D,VGK,23,49,7,12,19
91,8479324,Ryan Lindgren,D,NYR,26,59,6,13,19
91,8483445,Cutter Gauthier,L,ANA,20,62,5,14,19
91,8482809,Jackson Blake,R,CAR,21,57,5,14,19
91,8480807,Mattias Samuelsson,D,BUF,24,53,1,18,19
91,8480049,Dylan Samberg,D,WPG,25,69,0,19,19
91,8478432,Christian Fischer,R,DET,27,71,12,6,18
91,8481641,Joel Kiviranta,L,COL,28,75,10,8,18
91,8476889,Radek Faksa,C,STL,30,54,9,9,18
91,8481477,Nico Sturm,C,SJS,29,52,8,10,18
91,8478831,Kevin Stenlund,C,UTA,28,59,8,10,18
91,8480336,Sean Walker,D,CAR,30,69,7,11,18
91,8477499,Rasmus Ristolainen,D,PHI,30,63,7,11,18
91,8481580,Connor McMichael,C,WSH,23,61,7,11,18
91,8475225,Craig Smith,C,CHI,35,51,6,12,18
91,8482451,Mikael Pyyhtia,L,CBJ,23,45,3,15,18
91,8482634,Alex Steeves,C,TOR,25,47,3,15,18
91,8474673,TJ Brodie,D,CHI,34,62,3,15,18
91,8476967,Brett Kulak,D,EDM,30,64,2,16,18
91,8480205,Emil Bemstrom,C,PIT,25,50,13,4,17
91,8477425,Miles Wood,L,COL,29,75,12,5,17
91,8483457,Lane Hutson,D,MTL,20,74,9,8,17
91,8478508,Yakov Trenin,C,MIN,27,57,9,8,17
91,8477947,Sonny Milano,L,WSH,28,65,8,9,17
91,8481517,Brett Leason,R,ANA,25,66,8,9,17
91,8476994,Vinnie Hinostroza,C,NSH,30,49,7,10,17
91,8480806,Isac Lundestrom,C,ANA,25,59,7,10,17
91,8480074,Alexandre Texier,C,STL,25,58,6,11,17
91,8477406,Mattias Janmark,C,EDM,32,65,6,11,17
91,8474013,Ian Cole,D,UTA,35,49,6,11,17
91,8473563,Nicklas Backstrom,C,WSH,37,52,5,12,17
91,8481656,Aliaksei Protas,C,WSH,23,64,4,13,17
91,8476856,Mathew Dumba,D,DAL,30,68,4,13,17
91,8481013,Jonatan Berggren,R,DET,24,56,4,13,17
91,8481014,Alexander Romanov,D,NYI,24,77,3,14,17
91,8475343,Nic Dowd,C,WSH,34,49,3,14,17
91,8475790,Erik Gudbranson,D,CBJ,32,73,3,14,17
91,8478178,Darren Raddysh,D,TBL,28,67,3,14,17
91,8476525,Colin Miller,D,WPG,32,61,3,14,17
91,8482142,Jamie Drysdale,D,PHI,22,61,3,14,17
91,8475208,Brian Dumoulin,D,ANA,33,64,2,15,17
91,8483460,David Jiricek,D,CBJ,21,55,2,15,17
91,8482245,Artem Zub,D,OTT,29,66,1,16,17
91,8480281,Alexey Toropchenko,R,STL,25,53,12,4,16
91,8477573,Nathan Walker,L,STL,30,45,9,7,16
91,8481093,Rafael Harvey-Pinard,L,MTL,25,64,7,9,16
91,8484149,Gavin Brindley,C,CBJ,20,47,7,9,16
91,8482155,Alex Laferriere,R,LAK,23,66,7,9,16
91,8479316,Luke Kunin,C,SJS,27,58,6,10,16
91,8477380,Jonny Brodzinski,C,NYR,31,55,4,12,16
91,8480011,Klim Kostin,C,SJS,25,54,4,12,16
91,8481708,Zac Jones,D,NYR,24,55,4,12,16
91,8479976,Juuso Valimaki,D,UTA,26,61,3,13,16
91,8478970,Jalen Chatfield,D,CAR,28,68,3,13,16
91,8479982,Conor Timmins,D,TOR,26,57,3,13,16
91,8474574,Tyler Myers,D,VAN,34,62,3,13,16
91,8478569,Noel Acciari,C,PIT,33,52,7,8,15
91,8480289,Morgan Barron,C,WPG,26,50,7,8,15
91,8477446,Michael McCarron,R,NSH,29,54,7,8,15
91,8482166,Shakir Mukhamadullin,D,SJS,22,56,7,8,15
91,8471709,Marc-Edouard Vlasic,D,SJS,37,61,6,9,15
91,8482803,Olen Zellweger,D,ANA,21,61,6,9,15
91,8482148,Hendrix Lapierre,C,WSH,22,54,5,10,15
91,8478443,Brandon Carlo,D,BOS,28,61,5,10,15
91,8480025,MacKenzie Entwistle,R,FLA,25,72,5,10,15
91,8482747,Brennan Othmann,L,NYR,21,38,5,10,15
91,8476329,Travis Boyd,C,MIN,31,51,4,11,15
91,8482176,Wyatt Kaiser,D,CHI,22,52,4,11,15
91,8479026,Philippe Myers,D,TOR,27,60,3,12,15
91,8481019,David Gustafsson,C,WPG,24,45,3,12,15
91,8475462,Radko Gudas,D,ANA,34,69,3,12,15
91,8475188,Brayden McNabb,D,VGK,33,53,2,13,15
91,8478451,Ethan Bear,D,WSH,27,47,2,13,15
91,8480222,Sebastian Aho,D,PIT,28,67,2,13,15
91,8476988,Matt Benning,D,SJS,30,60,1,14,15
91,8479671,Mathieu Olivier,R,CBJ,27,48,9,5,14
91,8480355,Mark Kastelic,C,BOS,25,58,8,6,14
91,8483491,Ivan Miroshnichenko,L,WSH,20,55,8,6,14
91,8477353,Tyler Motte,C,DET,29,68,7,7,14
91,8477931,Tomas Nosek,L,FLA,32,59,6,8,14
91,8474034,Patrick Maroon,L,CHI,36,48,5,9,14
91,8480727,Zach Whitecloud,D,VGK,28,48,5,9,14
91,8478017,Mark Friedman,D,VAN,29,46,5,9,14
91,8477508,Curtis Lazar,C,NJD,29,58,4,10,14
91,8481161,Jake Christiansen,D,CBJ,25,66,4,10,14
91,8476467,Jamie Oleksiak,D,SEA,32,76,3,11,14
91,8474568,Luke Schenn,D,NSH,35,54,3,11,14
91,8476931,Jake McCabe,D,TOR,31,68,2,12,14
91,8480058,Pierre-Olivier Joseph,D,STL,25,56,1,13,14
91,8482762,Simon Edvinsson,D,DET,21,57,10,3,13
91,8476822,Luke Glendening,C,TBL,35,78,9,4,13
91,8481617,Vasily Podkolzin,R,VAN,23,38,9,4,13
91,8482077,Dylan Holloway,L,EDM,23,46,9,4,13
91,8481537,Nikita Okhotiuk,D,CGY,24,54,6,7,13
91,8477070,Liam O'Brien,C,UTA,30,59,6,7,13
91,8481518,Nolan Foote,L,NJD,24,40,6,7,13
91,8482496,Nils Aman,C,VAN,24,45,6,7,13
91,8482964,Arber Xhekaj,D,MTL,23,43,6,7,13
91,8473453,Trevor Lewis,C,LAK,37,72,5,8,13
91,8483466,Kevin Korchinski,D,CHI,20,55,5,8,13
91,8477018,Ben Hutton,D,VGK,31,44,3,10,13
91,8482192,Isaak Phillips,D,CHI,23,50,2,11,13
91,8475690,Chris Tanev,D,TOR,35,66,2,11,13
91,8482087,Kaiden Guhle,D,MTL,22,64,1,12,13
91,8477365,Connor Clifton,D,BUF,29,54,1,12,13
91,8475455,Brenden Dillon,D,NJD,34,59,1,12,13
91,8476457,Adam Larsson,D,SEA,32,66,0,13,13
91,8481059,Scott Perunovich,D,STL,26,62,0,13,13
91,8479370,Tyson Jost,C,CAR,26,54,8,4,12
91,8478434,Keegan Kolesar,R,VGK,27,64,6,6,12
91,8476624,Barclay Goodrow,C,SJS,31,51,6,6,12
91,8480252,Cole Guttman,C,CHI,25,39,6,6,12
91,8479718,Alex Barré-Boulet,C,MTL,27,46,5,7,12
91,8480192,Johnathan Kovacevic,D,NJD,27,51,5,7,12
91,8482807,Ethan Del Mastro,D,CHI,21,47,5,7,12
91,8477938,Haydn Fleury,D,WPG,28,44,5,7,12
91,8480848,Ty Dellandrea,C,SJS,24,47,5,7,12
91,8475179,Dmitry Kulikov,D,FLA,34,57,4,8,12
91,8480834,Ty Emberson,D,SJS,24,33,4,8,12
91,8479543,Michael Pezzetta,L,MTL,26,64,3,9,12
91,8480796,Martin Fehervary,D,WSH,25,60,3,9,12
91,8476372,Nick Seeler,D,PHI,31,41,3,9,12
91,8481147,Reese Johnson,C,MIN,26,42,3,9,12
91,8481550,Adam Beckman,L,NJD,23,44,2,10,12
91,8476441,Joel Edmundson,D,LAK,31,46,2,10,12
91,8476331,Dylan DeMelo,D,WPG,31,65,1,11,12
91,8480950,Ilya Lyubushkin,D,DAL,30,59,1,11,12
91,8475279,Ben Chiarot,D,DET,33,60,0,12,12
91,8479520,Brandon Duhaime,R,WSH,27,58,9,2,11
91,8476934,Brock McGinn,L,ANA,30,46,7,4,11
91,8481754,Nikita Nesterenko,C,ANA,23,35,6,5,11
91,8478424,Jansen Harkins,C,ANA,27,41,6,5,11
91,8482659,Josh Doan,R,UTA,22,44,5,6,11
91,8474090,Brendan Smith,D,DAL,35,57,5,6,11
91,8477401,John Hayden,C,SEA,29,36,5,6,11
91,8476442,Matt Nieto,L,PIT,32,47,4,7,11
91,8482511,Mason Lohrei,D,BOS,23,42,4,7,11
91,8481599,Victor Soderstrom,D,UTA,23,46,3,8,11
91,8478454,Noah Juulsen,D,VAN,27,39,2,9,11
91,8482730,Brandt Clarke,D,LAK,21,58,1,10,11
91,8478468,Jeremy Lauzon,D,NSH,27,45,1,10,11
91,8478421,A.J. Greer,L,FLA,28,55,7,3,10
91,8478585,Derek Ryan,C,EDM,38,61,7,3,10
91,8482157,Will Cuylle,L,NYR,22,61,5,5,10
91,8482666,Scott Morrow,D,CAR,22,48,4,6,10
91,8481598,Philip Broberg,D,EDM,23,51,4,6,10
91,8482751,Ryan Winterton,C,SEA,21,28,4,6,10
91,8482859,Zack Ostapchuk,C,OTT,21,54,4,6,10
91,8481751,Lukas Rousek,R,BUF,25,37,3,7,10
91,8477979,Nicolas Aube-Kubel,R,BUF,28,55,3,7,10
91,8476952,Dominic Toninato,C,WPG,30,37,3,7,10
91,8474166,Alec Martinez,D,CHI,37,48,3,7,10
91,8479536,Axel Jonsson-Fjallby,L,WPG,26,34,3,7,10
91,8474567,Zach Bogosian,D,MIN,34,60,2,8,10
91,8475718,Justin Holl,D,DET,32,66,2,8,10
91,8481701,Santeri Hatakka,D,NJD,23,35,2,8,10
91,8482713,Mackie Samoskevich,R,FLA,22,38,2,8,10
91,8475177,Calvin de Haan,D,COL,33,43,2,8,10
91,8480860,Kevin Bahl,D,CGY,24,54,1,9,10
91,8477034,Jaycob Megna,D,FLA,32,41,1,9,10
91,8480879,Jacob Bernard-Docker,D,OTT,24,50,1,9,10
91,8476874,Olli Maatta,D,DET,30,55,0,10,10
91,8480021,Jack Studnicka,C,LAK,25,54,6,3,9
91,8480245,Olle Lycksell,R,PHI,25,31,6,3,9
91,8481716,Dmitri Voronkov,L,CBJ,24,47,5,4,9
91,8479359,Beck Malenstyn,L,BUF,26,42,4,5,9
91,8476867,Brendan Gaunce,C,MIN,30,36,4,5,9
91,8482095,Tyler Kleven,D,OTT,22,49,4,5,9
91,8471677,Jack Johnson,D,CBJ,37,62,2,7,9
91,8471817,Ryan Reaves,R,TOR,37,55,2,7,9
91,8479369,Andrew Peeke,D,BOS,26,59,1,8,9
91,8480070,Ian Mitchell,D,BOS,25,48,1,8,9
91,8480001,Urho Vaakanainen,D,ANA,25,56,1,8,9
91,8480845,Rasmus Kupari,C,WPG,24,43,1,8,9
91,8473446,Erik Johnson,D,PHI,36,50,1,8,9
91,8478211,Dryden Hunt,L,CGY,29,48,6,2,8
91,8479994,Jaret Anderson-Dolan,C,WPG,25,33,4,4,8
91,8483619,Filip Roos,D,OTT,25,35,4,4,8
91,8483397,Marc McLaughlin,C,BOS,25,38,4,4,8
91,8476858,Phillip Di Giuseppe,L,VAN,31,44,4,4,8
91,8479985,Cale Fleury,D,SEA,26,31,4,4,8
91,8479944,Zach Aston-Reese,C,VGK,30,48,3,5,8
91,8481567,Henry Thrun,D,SJS,23,44,3,5,8
91,8479772,Zack MacEwen,R,OTT,28,56,3,5,8
91,8478146,Matthew Highmore,C,OTT,28,32,3,5,8
91,8481532,Alex Turcotte,C,LAK,23,43,3,5,8
91,8482744,James Malatesta,L,CBJ,21,37,2,6,8
91,8477851,Jordan Oesterle,D,BOS,32,44,2,6,8
91,8479972,Mason Shaw,C,WPG,26,34,2,6,8
91,8482153,Brendan Brisson,C,VGK,23,36,2,6,8
91,8482177,Marat Khusnutdinov,C,MIN,22,40,2,6,8
91,8480990,Declan Chisholm,D,MIN,24,35,1,7,8
91,8479378,Logan Stanley,D,WPG,26,42,1,7,8
91,8475762,Derek Forbort,D,VAN,32,43,1,7,8
91,8481167,Brayden Pachal,D,CGY,25,45,1,7,8
91,8483570,Ben Meyers,C,SEA,26,34,7,0,7
91,8477887,Patrick Brown,C,BOS,32,46,6,1,7
91,8477462,Robert Hagg,D,VGK,29,32,3,4,7
91,8482145,Mavrik Bourque,C,DAL,22,49,3,4,7
91,8481600,Tobias Bjornfot,D,FLA,23,39,3,4,7
91,8479991,Jake Leschyshyn,C,NYR,25,37,3,4,7
91,8479419,Brett Murray,L,BUF,26,25,3,4,7
91,8479291,Kevin Rooney,C,CGY,31,52,2,5,7
91,8477384,Joshua Brown,D,EDM,30,38,2,5,7
91,8476473,Connor Murphy,D,CHI,31,45,2,5,7
91,8481605,Jackson LaCombe,D,ANA,23,33,2,5,7
91,8480196,Jacob Bryson,D,BUF,27,46,2,5,7
91,8482784,Zach Dean,C,STL,21,47,1,6,7
91,8481592,Jakob Pelletier,L,CGY,23,41,1,6,7
91,8479442,Troy Stecher,D,EDM,30,54,0,7,7
91,8479372,Joshua Mahura,D,SEA,26,44,0,7,7
91,8479638,Justin Brazeau,R,BOS,26,31,5,1,6
91,8480844,Grigori Denisenko,L,VGK,24,33,4,2,6
91,8479968,Vinni Lettieri,C,BOS,29,43,3,3,6
91,8480441,Trey Fix-Wolansky,R,CBJ,25,39,3,3,6
91,8483549,Lucas Condotta,L,MTL,27,27,3,3,6
91,8481422,Jake Lucchini,C,NSH,29,30,3,3,6
91,8480007,Jonas Rondbjerg,R,VGK,25,36,2,4,6
91,8478859,Niko Mikkola,D,FLA,28,54,2,4,6
91,8484911,Collin Graf,R,SJS,22,37,2,4,6
91,8479986,Kole Lind,R,DAL,26,49,1,5,6
91,8484254,Akito Hirose,D,VAN,25,33,1,5,6
91,8475750,Jon Merrill,D,MIN,32,60,1,5,6
91,8482141,Lukas Cormier,D,VGK,22,31,1,5,6
91,8479249,Andrew Poturalski,C,SJS,30,33,0,6,6
91,8481122,Simon Benoit,D,TOR,26,38,0,6,6
91,8479587,Rhett Gardner,C,PHI,28,27,0,6,6
91,8477527,Ross Johnston,L,ANA,30,34,3,2,5
91,8481789,Tye Kartye,L,SEA,23,38,3,2,5
91,8482144,Jack Thompson,D,SJS,22,28,3,2,5
91,8479379,Givani Smith,R,SJS,26,27,3,2,5
91,8477335,Kyle Burroughs,D,LAK,29,40,2,3,5
91,8476913,Devin Shore,C,MIN,30,32,2,3,5
91,8480292,Carson Meyer,R,ANA,27,23,2,3,5
91,8482652,Walker Duehr,R,CGY,27,37,2,3,5
91,8480267,Sammy Walker,C,MIN,25,22,2,3,5
91,8477962,Brendan Lemieux,L,CAR,28,36,2,3,5
91,8482861,Vincent Iorio,D,WSH,22,41,2,3,5
91,8475958,Michael Sgarbossa,C,WSH,32,29,2,3,5
91,8483512,Matthew Savoie,C,EDM,20,21,2,3,5
91,8482765,Isak Rosen,R,BUF,21,25,2,3,5
91,8474612,Travis Hamonic,D,OTT,34,54,1,4,5
91,8481541,Samuel Bolduc,D,NYI,24,25,1,4,5
91,8478502,Dennis Gilbert,D,BUF,28,24,1,4,5
91,8480084,Nick DeSimone,D,NJD,30,11,1,4,5
91,8482470,Ilya Solovyov,D,CGY,24,20,1,4,5
91,8483495,Simon Nemec,D,NJD,20,56,0,5,5
91,8478874,Adam Gaudette,R,OTT,28,34,0,5,5
91,8481585,Egor Afanasyev,L,SJS,23,15,0,5,5
91,8483012,Logan Morrison,C,SEA,22,30,4,0,4
91,8479981,Jonah Gadjovich,L,FLA,26,51,3,1,4
91,8480890,Jan Jenik,C,OTT,24,25,3,1,4
91,8482147,Jean-Luc Foudy,C,COL,22,28,3,1,4
91,8480880,Jakub Lauko,C,MIN,24,30,2,2,4
91,8481056,Spencer Stastney,D,NSH,24,26,2,2,4
91,8478409,Anthony Richard,C,PHI,28,28,2,2,4
91,8484325,Waltteri Merela,C,TBL,26,23,2,2,4
91,8481743,Marc Del Gaizo,D,NSH,25,23,2,2,4
91,8482070,Mitchell Chaffee,R,TBL,26,48,2,2,4
91,8482929,Emil Lilleberg,D,TBL,23,23,2,2,4
91,8483398,Declan Carlile,D,TBL,31,9,2,2,4
91,8477473,Justin Bailey,R,SJS,29,23,1,3,4
91,8481609,Vladislav Kolyachonok,D,UTA,23,34,1,3,4
91,8482858,Ryker Evans,D,SEA,23,24,1,3,4
91,8477971,Andreas Englund,D,LAK,28,28,1,3,4
91,8481556,John Beecher,C,BOS,23,30,1,3,4
91,8478021,William Lagesson,D,DET,28,26,1,3,4
91,8482250,Callahan Burke,C,VGK,27,23,1,3,4
91,8481543,Nikita Alexandrov,C,STL,24,24,1,3,4
91,8483489,Fraser Minten,C,TOR,31,11,1,3,4
91,8481024,Linus Karlsson,C,VAN,25,14,1,3,4
91,8477810,Joel Hanley,D,CGY,33,24,0,4,4
91,8483471,Brad Lambert,C,WPG,31,13,0,4,4
91,8480157,Calle Rosen,D,COL,30,38,2,1,3
91,8479348,Kale Clague,D,BUF,26,38,2,1,3
91,8478051,Max Willman,C,NJD,29,18,2,1,3
91,8483763,Maksymilian Szuber,D,UTA,22,29,2,1,3
91,8481237,Kyle MacLean,C,NYI,25,21,2,1,3
91,8482165,Yan Kuznetsov,D,CGY,22,19,2,1,3
91,8480468,James Hamblin,L,EDM,25,21,2,1,3
91,8479576,Vincent Desharnais,D,VAN,28,33,1,2,3
91,8477073,Kurtis MacDermid,L,NJD,30,25,1,2,3
91,8482094,Daemon Hunt,D,MIN,22,26,1,2,3
91,8479320,Maxime Lajoie,D,SEA,27,19,1,2,3
91,8482516,Matthew Kessel,D,STL,24,15,1,2,3
91,8478450,Parker Wotherspoon,D,BOS,27,26,0,3,3
91,8482118,Sam Colangelo,R,ANA,23,16,0,3,3
91,8477244,Chad Ruhwedel,D,NYR,34,30,0,3,3
91,8480851,Akil Thomas,C,LAK,24,15,0,3,3
91,8482197,Adam Raska,R,MIN,23,9,0,3,3
91,8475235,Nicolas Deslauriers,L,PHI,33,49,2,0,2
91,8482061,Brandon Biro,L,SEA,26,15,2,0,2
91,8482460,Matt Rempe,C,NYR,22,11,2,0,2
91,8481462,Mason Morelli,L,VGK,28,16,2,0,2
91,8483395,Arshdeep Bains,L,VAN,23,12,2,0,2
91,8482787,Nikita Chibrikov,R,WPG,31,6,2,0,2
91,8479367,William Lockwood,R,FLA,26,20,1,1,2
91,8482172,Landon Slaggert,L,CHI,22,21,1,1,2
91,8474062,Riley Nash,C,NYR,35,13,1,1,2
91,8482733,Logan Mailloux,D,MTL,31,34,1,1,2
91,8484258,Sam Malinski,D,COL,26,21,1,1,2
91,8481065,Angus Crookshank,L,OTT,25,17,1,1,2
91,8482162,Roby Jarventie,L,EDM,22,12,1,1,2
91,8484304,Uvis Balinskis,D,FLA,28,13,1,1,2
91,8484255,Jason Polin,R,COL,25,5,1,1,2
91,8480870,Bo Groulx,C,NYR,24,32,1,1,2
91,8482088,Justin Sourdif,R,FLA,22,15,1,1,2
91,8480874,Adam Ginning,D,PHI,24,10,0,2,2
91,8481806,Louis Crevier,D,CHI,23,11,0,2,2
91,8475795,Dylan McIlrath,D,WSH,32,8,0,2,2
91,8477149,Scott Sabourin,R,SJS,32,16,0,2,2
91,8475755,Alexander Petrovic,D,DAL,32,14,0,2,2
91,8481679,Maxence Guenette,D,OTT,23,23,1,0,1
91,8482201,Gage Goncalves,C,TBL,23,20,1,0,1
91,8477320,Anton Blidh,L,NYR,29,21,1,0,1
91,8479330,Brandon Gignac,C,MTL,27,7,1,0,1
91,8484287,Cole McWard,D,VAN,23,22,1,0,1
91,8481593,Jayden Struble,D,MTL,23,19,1,0,1
91,8477993,Justin Kirkland,C,CGY,28,6,1,0,1
91,8477467,Gustav Olofsson,D,SEA,30,22,1,0,1
91,8483407,Brandon Scanlin,D,NYR,25,6,1,0,1
91,8475780,Chris Wagner,R,COL,33,12,1,0,1
91,8483609,Adam Klapka,R,CGY,24,4,1,0,1
91,8483630,Pavol Regenda,L,ANA,25,32,0,1,1
91,8481006,Tyler Tucker,D,STL,24,16,0,1,1
91,8478477,Mitchell Stephens,C,SEA,27,27,0,1,1
91,8483597,Milos Kelemen,L,UTA,25,10,0,1,1
91,8480823,Alexander Alexeyev,D,WSH,25,11,0,1,1
91,8481030,Jack St. Ivany,D,PIT,25,18,0,1,1
91,8478011,Louie Belpedio,D,PHI,28,7,0,1,1
91,8476323,Max McCormick,L,SEA,32,10,0,1,1
91,8479362,Riley Tufte,L,BOS,26,15,0,1,1
91,8477541,Dakota Mermis,D,TOR,30,5,0,1,1
91,8481564,Ryan Johnson,D,BUF,23,11,0,1,1
91,8480306,Grant Hutton,D,NYI,29,6,0,1,1
91,8481719,Maxwell Crozier,D,TBL,24,12,0,0,0
91,8481043,Cole Koepke,L,BOS,26,20,0,0,0
91,8480032,Shane Bowers,C,NJD,25,13,0,0,0
91,8478881,Brett Seney,L,CHI,28,7,0,0,0
91,8478446,Glenn Gawdin,C,LAK,27,13,0,0,0
91,8479421,Jacob Moverare,D,LAK,26,3,0,0,0
91,8482102,Vasily Ponomarev,C,PIT,22,20,0,0,0
91,8475413,Justin Dowling,C,NJD,34,14,0,0,0
91,8481578,Graeme Clarke,R,MIN,23,8,0,0,0
91,8481655,Cole Schwindt,R,CGY,23,6,0,0,0
91,8481206,John Ludvig,D,PIT,24,15,0,0,0
91,8481699,Aku Raty,R,UTA,23,12,0,0,0
91,8481534,Raphael Lavoie,C,EDM,24,3,0,0,0
91,8478147,Bokondji Imama,L,PIT,28,7,0,0,0
91,8483567,Georgii Merkulov,C,BOS,24,10,0,0,0
91,8481726,Adam Edstrom,C,NYR,24,5,0,0,0
91,8484321,Nikolas Matinpalo,D,OTT,26,4,0,0,0
91,8483920,Pierrick Dube,R,WSH,23,3,0,0,0
91,8478854,Ryan Shea,D,PIT,27,5,0,0,0
91,8480075,Cameron Crotty,D,MIN,25,8,0,0,0
91,8483546,Marshall Rifai,D,TOR,26,2,0,0,0
91,8483432,Luca Del Bel Belluz,C,CBJ,31,2,0,0,0
91,8482476,Emil Heineman,L,MTL,23,7,0,0,0
91,8483401,Marc Johnstone,R,PIT,28,0,0,0,0
91,8479522,Hardy Haman Aktell,D,WSH,26,5,0,0,0
91,8482126,Emil Andrae,D,PHI,31,2,0,0,0
91,8484326,Patrik Koch,D,UTA,28,2,0,0,0
91,8483531,Brian Halonen,L,NJD,25,5,0,0,0
91,8478956,Samuel Laberge,L,NJD,27,2,0,0,0
91,8480274,Philip Kemp,D,EDM,25,1,0,0,0
91,8484259,Ondrej Pavel,C,COL,31,0,0,0,0
91,8470794,Joe Pavelski,C,,40,0,0,0,0
91,8479321,Lucas Johansen,D,,27,0,0,0,0
91,8477950,Tony DeAngelo,D,,29,0,0,0,0
91,8471218,Blake Wheeler,R,,38,0,0,0,0
91,8475197,Tyson Barrie,D,,33,0,0,0,0
91,8474157,Max Pacioretty,L,,36,0,0,0,0
91,8475744,Evgeny Kuznetsov,C,,32,0,0,0,0
91,8474037,James van Riemsdyk,L,,35,0,0,0,0
91,8476907,Mackenzie MacEachern,L,,30,0,0,0,0
91,8480216,Jacob Peterson,C,,25,0,0,0,0
91,8474602,Justin Schultz,D,,34,0,0,0,0
91,8482222,Alexander Barabanov,L,,30,0,0,0,0
91,8474031,Kevin Shattenkirk,D,,35,0,0,0,0
91,8477330,Dominik Kubalik,L,,29,0,0,0,0
91,8480884,Calen Addison,D,,24,0,0,0,0
91,8475906,John Klingberg,D,,32,0,0,0,0
91,8480008,Adam Ruzicka,C,,25,0,0,0,0
91,8476884,Derrick Pouliot,D,,30,0,0,0,0
91,8476919,Chris Tierney,C,,30,0,0,0,0
91,8479415,Michael McLeod,C,,26,0,0,0,0
91,8474870,Tyler Johnson,C,,34,0,0,0,0
91,8470604,Jeff Carter,C,,39,0,0,0,0
91,8478104,Sammy Blais,L,,28,0,0,0,0
91,8474884,Mike Hoffman,C,,35,0,0,0,0
91,8481591,Sam Poulin,R,,23,0,0,0,0
91,8471274,Alex Goligoski,D,,39,0,0,0,0
91,8476871,Tanner Pearson,L,,32,0,0,0,0
91,8476393,Nick Cousins,C,,31,0,0,0,0
91,8479977,Kailer Yamamoto,R,,26,0,0,0,0
91,8479346,Dillon Dube,C,,26,0,0,0,0
91,8480184,Gustav Lindstrom,D,,26,0,0,0,0
91,8479376,Victor Mete,D,,26,0,0,0,0
91,8473449,Kyle Okposo,R,,36,0,0,0,0
91,8481058,Jesse Ylonen,R,,25,0,0,0,0
91,8475752,Tyler Pitlick,C,,33,0,0,0,0
91,8481239,Samuel Fagemo,L,,24,0,0,0,0
91,8480821,Filip Zadina,R,,25,0,0,0,0
91,8470966,Mark Giordano,D,,41,0,0,0,0
91,8478495,Denis Gurianov,R,,27,0,0,0,0
91,8477464,Nic Petan,C,,29,0,0,0,0
91,8478099,Kevin Labanc,R,,29,0,0,0,0
91,8482241,Radim Zohorna,L,,28,0,0,0,0
91,8474040,Sam Gagner,C,,35,0,0,0,0
91,8479514,Rem Pitlick,C,,27,0,0,0,0
91,8478430,Oliver Kylington,D,,27,0,0,0,0
91,8479533,Joona Koppanen,L,,26,0,0,0,0
91,8479984,Cal Foote,D,,26,0,0,0,0
91,8477126,Jayson Megna,C,,34,0,0,0,0
91,8475164,Jakob Silfverberg,R,,34,0,0,0,0
91,8474009,Nick Bonino,C,,36,0,0,0,0
91,8479458,Nikita Zaitsev,D,,33,0,0,0,0
91,8477944,Jakub Vrana,L,,28,0,0,0,0
91,8471699,Andrew Cogliano,C,,37,0,0,0,0
91,8478067,Oskar Lindblom,L,,28,0,0,0,0
91,8471686,Marc Staal,D,,37,0,0,0,0
91,8470610,Zach Parise,L,,40,0,0,0,0
91,8478904,Steven Lorentz,C,,28,0,0,0,0
91,8473473,Milan Lucic,L,,36,0,0,0,0
91,8480031,Maxime Comtois,L,,25,0,0,0,0
91,8478512,Austin Czarnik,C,,32,0,0,0,0
91,8473504,Cal Clutterbuck,R,,37,0,0,0,0
91,8477454,Adam Erne,L,,29,0,0,0,0
91,8479383,Boris Katchouk,L,,26,0,0,0,0
91,8475825,Jani Hakanpää,D,,32,0,0,0,0
91,8477846,Ryan Carpenter,C,,33,0,0,0,0
91,8477930,Pierre-Edouard Bellemare,L,,39,0,0,0,0
91,8478400,Colin White,C,,27,0,0,0,0
91,8480226,Marián Studenic,R,,26,0,0,0,0
91,8480853,Liam Foudy,C,,24,0,0,0,0
91,8475797,Jarred Tinordi,D,,32,0,0,0,0
91,8479423,Alex Nylander,L,,26,0,0,0,0
91,8474618,Marco Scandella,D,,34,0,0,0,0
91,8478028,Fredrik Olofsson,L,,28,0,0,0,0
91,8474709,Matt Martin,L,,35,0,0,0,0
91,8481070,Hugh McGing,L,,26,0,0,0,0
91,8479546,Oskar Steen,C,,26,0,0,0,0
91,8474145,Robert Bortuzzo,D,,35,0,0,0,0
91,8476915,Jujhar Khaira,L,,30,0,0,0,0
91,8475278,Byron Froese,C,,33,0,0,0,0
91,8481812,Nikolai Knyzhov,D,,27,0,0,0,0
91,8478408,Travis Dermott,D,,28,0,0,0,0
91,8481077,John Leonard,L,,26,0,0,0,0
91,8479547,Matthew Phillips,R,,26,0,0,0,0
91,8480836,Jonathan Gruden,C,,24,0,0,0,0
91,8481690,Tyler Angle,C,,24,0,0,0,0
91,8475766,Austin Watson,L,,32,0,0,0,0
91,8481016,Ruslan Iskhakov,C,,24,0,0,0,0
91,8478078,Rourke Chartier,C,,28,0,0,0,0
91,8480776,Sheldon Rempal,R,,29,0,0,0,0
91,8483045,Cameron Butler,R,CBJ,31,0,0,0,0
91,8484314,Jiri Smejkal,L,,28,0,0,0,0
92,8478402,Connor McDavid,C,EDM,27,79,48,100,148
92,8479318,Auston Matthews,C,TOR,27,80,66,62,128
92,8477492,Nathan MacKinnon,C,COL,29,82,64,63,127
92,8477934,Leon Draisaitl,C,EDM,29,80,38,86,124
92,8476453,Nikita Kucherov,R,TBL,31,81,32,86,118
92,8481559,Jack Hughes,C,NJD,23,75,44,70,114
92,8477956,David Pastrnak,R,BOS,28,78,56,54,110
92,8478420,Mikko Rantanen,R,COL,28,82,42,68,110
92,8478483,Mitch Marner,R,TOR,27,79,34,74,108
92,8479314,Matthew Tkachuk,L,FLA,27,77,31,77,108
92,8477939,William Nylander,R,TOR,28,80,45,60,105
92,8477404,Jake Guentzel,C,TBL,30,82,41,60,101
92,8480027,Jason Robertson,L,DAL,25,81,40,60,100
92,8478550,Artemi Panarin,L,NYR,33,74,29,71,100
92,8477942,Kevin Fiala,L,LAK,28,82,33,65,98
92,8477493,Aleksander Barkov,C,FLA,29,78,29,68,97
92,8478864,Kirill Kaprizov,L,MIN,27,73,44,50,94
92,8478010,Brayden Point,C,TBL,28,82,48,44,92
92,8479343,Clayton Keller,R,UTA,26,78,41,50,91
92,8475166,John Tavares,C,TOR,34,81,39,52,91
92,8480012,Elias Pettersson,C,VAN,26,75,23,68,91
92,8477933,Sam Reinhart,C,FLA,29,76,39,51,90
92,8482116,Tim Stützle,C,OTT,22,81,35,55,90
92,8478403,Jack Eichel,C,VGK,28,74,48,41,89
92,8477501,Valeri Nichushkin,R,COL,29,82,38,50,88
92,8477409,Carter Verhaeghe,C,FLA,29,78,45,42,87
92,8478398,Kyle Connor,L,WPG,28,75,40,46,86
92,8480801,Brady Tkachuk,L,OTT,25,81,39,46,85
92,8475913,Mark Stone,R,VGK,32,76,29,55,84
92,8478445,Mathew Barzal,C,NYI,27,80,25,59,84
92,8480002,Nico Hischier,C,NJD,25,71,32,51,83
92,8475810,Bryan Rust,R,PIT,32,74,49,33,82
92,8479420,Tage Thompson,C,BUF,27,76,38,44,82
92,8475184,Chris Kreider,L,NYR,33,76,49,32,81
92,8476887,Filip Forsberg,L,NSH,30,76,39,42,81
92,8476389,Vincent Trocheck,C,NYR,31,76,33,48,81
92,8476460,Mark Scheifele,C,WPG,31,74,27,54,81
92,8480023,Robert Thomas,C,STL,25,75,31,49,80
92,8479323,Adam Fox,D,NYR,26,76,16,64,80
92,8480865,Noah Dobson,D,NYI,24,82,15,65,80
92,8475172,Nazem Kadri,C,CGY,34,81,27,52,79
92,8474600,Roman Josi,D,NSH,34,75,20,59,79
92,8477946,Dylan Larkin,C,DET,28,82,35,43,78
92,8478444,Brock Boeser,R,VAN,27,74,42,35,77
92,8476468,J.T. Miller,C,VAN,31,74,28,49,77
92,8478414,Timo Meier,R,NJD,28,78,40,36,76
92,8478427,Sebastian Aho,C,CAR,27,72,37,39,76
92,8477416,Oliver Bjorkstrand,R,SEA,29,73,31,45,76
92,8478449,Roope Hintz,C,DAL,28,82,30,46,76
92,8480069,Cale Makar,D,COL,26,69,22,54,76
92,8473994,Jamie Benn,L,DAL,35,82,28,47,75
92,8477951,Nick Schmaltz,C,UTA,28,75,28,47,75
92,8476454,Ryan Nugent-Hopkins,C,EDM,31,76,26,49,75
92,8474564,Steven Stamkos,C,NSH,34,71,32,42,74
92,8480839,Rasmus Dahlin,D,BUF,24,76,24,50,74
92,8475786,Zach Hyman,L,EDM,32,77,36,37,73
92,8477960,Adrian Kempe,R,LAK,28,79,31,42,73
92,8478439,Travis Konecny,R,PHI,27,76,29,44,73
92,8484144,Connor Bedard,C,CHI,19,73,21,52,73
92,8480800,Quinn Hughes,D,VAN,25,74,7,66,73
92,8477500,Bo Horvat,C,NYI,29,81,30,41,71
92,8471675,Sidney Crosby,C,PIT,37,72,23,48,71
92,8477940,Nikolaj Ehlers,L,WPG,28,64,28,42,70
92,8475170,Brayden Schenn,C,STL,33,72,23,46,69
92,8479325,Charlie McAvoy,D,BOS,27,79,10,59,69
92,8479675,Trevor Moore,L,LAK,29,80,37,31,68
92,8479542,Brandon Hagel,L,TBL,26,81,33,35,68
92,8479407,Jesper Bratt,L,NJD,26,74,26,42,68
92,8479385,Jordan Kyrou,C,STL,26,75,26,42,68
92,8478873,Troy Terry,R,ANA,27,72,22,46,68
92,8476459,Mika Zibanejad,C,NYR,31,78,22,45,67
92,8478460,Zach Werenski,D,CBJ,27,82,18,49,67
92,8476539,Jonathan Marchessault,R,NSH,34,71,36,30,66
92,8480830,Andrei Svechnikov,R,CAR,24,71,29,37,66
92,8476456,Jonathan Huberdeau,C,CGY,31,75,26,40,66
92,8477402,Pavel Buchnevich,L,STL,29,75,23,43,66
92,8482093,Seth Jarvis,C,CAR,22,71,34,31,65
92,8477955,Jared McCann,L,SEA,28,74,33,32,65
92,8479337,Alex DeBrincat,R,DET,27,82,31,34,65
92,8475754,Brock Nelson,C,NYI,33,79,29,36,65
92,8473512,Claude Giroux,R,OTT,36,79,23,42,65
92,8471215,Evgeni Malkin,C,PIT,38,66,22,43,65
92,8478975,Mason Marchment,L,DAL,29,81,33,31,64
92,8474141,Patrick Kane,R,DET,36,81,24,40,64
92,8476479,Phillip Danault,C,LAK,31,79,24,40,64
92,8477504,Josh Morrissey,D,WPG,29,71,17,47,64
92,8478407,Vince Dunn,D,SEA,28,71,9,55,64
92,8477935,Sam Bennett,C,FLA,28,72,37,26,63
92,8480208,Drake Batherson,R,OTT,26,81,24,39,63
92,8475168,Matt Duchene,C,DAL,33,80,23,40,63
92,8473419,Brad Marchand,L,BOS,36,79,22,41,63
92,8476448,William Karlsson,C,VGK,31,80,34,28,62
92,8478047,Michael Bunting,L,PIT,29,78,29,33,62
92,8475765,Vladimir Tarasenko,R,DET,33,80,28,34,62
92,8480039,Martin Necas,C,CAR,25,74,22,40,62
92,8475692,Mats Zuccarello,R,MIN,37,73,13,49,62
92,8475167,Victor Hedman,D,TBL,34,80,13,49,62
92,8482740,Wyatt Johnston,C,DAL,21,79,37,24,61
92,8477949,Alex Tuch,R,BUF,28,67,25,36,61
92,8471685,Anze Kopitar,C,LAK,37,79,21,40,61
92,8477503,Max Domi,C,TOR,29,79,13,48,61
92,8477476,Artturi Lehkonen,L,COL,29,80,33,27,60
92,8479400,Pierre-Luc Dubois,L,WSH,26,72,31,28,59
92,8478401,Pavel Zacha,C,BOS,27,78,29,30,59
92,8475794,Tyler Seguin,C,DAL,32,81,28,31,59
92,8482667,William Eklund,L,SJS,22,71,27,32,59
92,8478493,Joel Eriksson Ek,C,MIN,27,69,26,33,59
92,8481557,Matt Boldy,L,MIN,23,72,28,30,58
92,8477496,Elias Lindholm,C,BOS,30,77,23,35,58
92,8474586,Jordan Eberle,R,SEA,34,75,22,36,58
92,8480798,Philipp Kurashev,C,CHI,25,69,21,37,58
92,8479999,Casey Mittelstadt,C,COL,26,80,19,39,58
92,8477986,Brandon Montour,D,SEA,30,75,15,43,58
92,8476853,Morgan Rielly,D,TOR,30,69,9,49,58
92,8478366,Frank Vatrano,R,ANA,30,71,33,24,57
92,8482745,Mason McTavish,C,ANA,21,70,24,33,57
92,8481528,Dylan Cozens,C,BUF,23,76,24,33,57
92,8480018,Nick Suzuki,C,MTL,25,79,23,34,57
92,8475158,Ryan O'Reilly,C,NSH,33,78,23,34,57
92,8482665,Matty Beniers,C,SEA,22,73,23,34,57
92,8483808,Andrei Kuzmenko,L,CGY,28,75,21,36,57
92,8482078,Lucas Raymond,L,DET,22,82,20,37,57
92,8480803,Evan Bouchard,D,EDM,25,76,15,42,57
92,8474563,Drew Doughty,D,LAK,35,74,15,42,57
92,8477447,Shea Theodore,D,VGK,29,62,13,44,57
92,8482699,Dylan Guenther,R,UTA,21,72,26,30,56
92,8481540,Cole Caufield,R,MTL,23,73,25,31,56
92,8475169,Evander Kane,L,EDM,33,79,25,31,56
92,8474150,Mikael Backlund,C,CGY,35,76,24,32,56
92,8476881,Tomas Hertl,C,VGK,31,78,23,33,56
92,8474578,Erik Karlsson,D,PIT,34,80,21,35,56
92,8471214,Alex Ovechkin,L,WSH,39,74,31,24,55
92,8478440,Dylan Strome,C,WSH,27,71,26,29,55
92,8483431,Logan Cooley,C,UTA,20,74,24,31,55
92,8477497,Sean Monahan,C,CBJ,30,68,23,32,55
92,8477494,Jonathan Drouin,L,COL,29,80,16,39,55
92,8475799,Nino Niederreiter,R,WPG,32,65,31,23,54
92,8478498,Jake DeBrusk,L,VAN,28,66,27,27,54
92,8482124,Quinton Byfield,R,LAK,22,78,22,32,54
92,8474679,Gustav Nyquist,C,NSH,35,70,19,35,54
92,8476346,Johnny Gaudreau,L,CBJ,31,75,10,44,54
92,8477444,Andre Burakovsky,L,SEA,29,71,20,33,53
92,8482113,Anton Lundell,C,FLA,23,74,28,24,52
92,8481560,Arthur Kaliyev,R,LAK,23,79,24,28,52
92,8484153,Leo Carlsson,C,ANA,20,69,20,32,52
92,8478397,Rasmus Andersson,D,CGY,28,76,15,37,52
92,8471724,Kris Letang,D,PIT,37,79,15,36,51
92,8482684,Luke Hughes,D,NJD,21,72,13,38,51
92,8477407,Anthony Duclair,L,NYI,29,76,29,21,50
92,8475768,Jaden Schwartz,C,SEA,32,73,26,24,50
92,8476483,Rickard Rakell,R,PIT,31,69,22,28,50
92,8477495,Seth Jones,D,CHI,30,69,8,42,50
92,8473986,Alex Killorn,L,ANA,35,71,22,27,49
92,8482149,Cole Perfetti,C,WPG,22,70,20,29,49
92,8476826,Yanni Gourde,C,SEA,33,73,19,30,49
92,8480036,Miro Heiskanen,D,DAL,25,76,11,38,49
92,8476958,Jaccob Slavin,D,CAR,30,75,10,39,49
92,8474590,John Carlson,D,WSH,34,67,8,41,49
92,8480014,Gabriel Vilardi,C,WPG,25,67,29,19,48
92,8475784,Jeff Skinner,C,EDM,32,75,27,21,48
92,8481533,Trevor Zegras,C,ANA,23,77,22,26,48
92,8476905,Chandler Stephenson,C,SEA,30,68,15,33,48
92,8477479,Tyler Bertuzzi,L,CHI,29,62,13,35,48
92,8475798,Mikael Granlund,C,SJS,32,70,12,36,48
92,8481524,Bowen Byram,D,BUF,23,65,11,37,48
92,8476399,Blake Coleman,C,CGY,33,78,22,25,47
92,8480113,Alex Iafallo,L,WPG,31,73,22,25,47
92,8478438,Tommy Novak,C,NSH,27,70,19,28,47
92,8478519,Anthony Cirelli,C,TBL,27,81,18,29,47
92,8479410,Mikhail Sergachev,D,UTA,26,65,9,38,47
92,8477021,Alex Kerfoot,C,UTA,30,74,18,28,46
92,8478462,Nicolas Roy,C,VGK,27,75,17,29,46
92,8482133,Thomas Bordeleau,C,SJS,22,61,16,30,46
92,8483515,Juraj Slafkovsky,L,MTL,20,76,15,31,46
92,8477429,Andrew Copp,C,DET,30,79,12,34,46
92,8477346,MacKenzie Weegar,D,CGY,30,71,12,34,46
92,8481711,Matias Maccelli,L,UTA,24,73,8,38,46
92,8475726,Tyler Toffoli,C,SJS,32,75,27,18,45
92,8475745,Charlie Coyle,C,BOS,32,77,20,25,45
92,8484145,Zach Benson,L,BUF,19,65,20,25,45
92,8481068,Yegor Sharangovich,C,CGY,26,77,19,26,45
92,8481596,Shane Pinto,C,OTT,24,77,19,26,45
92,8480188,Fabian Zetterlund,L,SJS,25,68,17,28,45
92,8482097,Jack Quinn,R,BUF,23,71,17,28,45
92,8476872,Scott Laughton,C,PHI,30,73,14,31,45
92,8474641,Adam Henrique,C,EDM,34,76,26,18,44
92,8475760,Nick Bjugstad,C,UTA,32,74,24,20,44
92,8475191,Reilly Smith,R,NYR,33,69,16,28,44
92,8480015,Owen Tippett,R,PHI,25,78,15,29,44
92,8478038,Devon Toews,D,COL,30,66,9,35,44
92,8476875,Mike Matheson,D,MTL,30,75,8,36,44
92,8478856,Conor Garland,R,VAN,28,69,21,22,43
92,8477964,Ivan Barbashev,C,VGK,29,77,15,28,43
92,8480078,Filip Chytil,C,NYR,25,67,15,28,43
92,8476392,Adam Lowry,C,WPG,31,65,15,28,43
92,8470613,Brent Burns,D,CAR,39,80,9,34,43
92,8480434,Sean Durzi,D,UTA,26,71,8,35,43
92,8477451,Ryan Hartman,R,MIN,30,69,23,19,42
92,8478474,Lawson Crouse,L,UTA,27,74,22,20,42
92,8475151,Kyle Palmieri,C,NYI,33,77,21,21,42
92,8476882,Teuvo Teravainen,C,CHI,30,65,21,21,42
92,8476880,Tom Wilson,R,WSH,30,71,20,22,42
92,8478233,Andrew Mangiapane,L,WSH,28,69,19,23,42
92,8477998,Warren Foegele,L,LAK,28,81,19,23,42
92,8478466,Daniel Sprong,R,VAN,27,75,16,26,42
92,8481604,Pavel Dorofeyev,L,VGK,24,73,14,28,42
92,8474565,Alex Pietrangelo,D,VGK,34,58,12,30,42
92,8476906,Shayne Gostisbehere,D,CAR,31,76,11,31,42
92,8479345,Jakob Chychrun,D,WSH,26,69,11,31,42
92,8476432,Boone Jenner,C,CBJ,31,74,24,17,41
92,8478458,John (Jack) Roslovic,C,CAR,27,63,16,25,41
92,8476921,Jordan Martinook,L,CAR,32,64,15,26,41
92,8480855,Jack McBain,C,UTA,24,71,20,20,40
92,8477426,Nicholas Paul,L,TBL,29,80,19,21,40
92,8480849,Barrett Hayton,C,UTA,24,73,19,21,40
92,8479992,Michael Rasmussen,C,DET,25,77,18,22,40
92,8482702,Logan Stankoven,C,DAL,21,82,15,25,40
92,8475753,Justin Faulk,D,STL,32,76,12,28,40
92,8476869,Brady Skjei,D,NSH,30,76,12,28,40
92,8476792,Torey Krug,D,STL,33,68,10,30,40
92,8474716,Jared Spurgeon,D,MIN,35,72,8,32,40
92,8479591,Michael Eyssimont,C,TBL,28,82,21,18,39
92,8474102,David Perron,L,OTT,36,81,15,24,39
92,8478042,Viktor Arvidsson,L,EDM,31,71,13,26,39
92,8476292,Ondrej Palat,L,NJD,33,75,12,27,39
92,8480817,K'Andre Miller,D,NYR,24,72,9,30,39
92,8479425,Filip Hronek,D,VAN,27,75,8,31,39
92,8477969,Marcus Pettersson,D,PIT,28,76,5,34,39
92,8479525,Ross Colton,C,COL,28,80,22,16,38
92,8475793,Ryan Johansen,C,PHI,32,74,21,17,38
92,8477425,Miles Wood,L,COL,29,80,19,19,38
92,8477456,J.T. Compher,L,DET,29,80,17,21,38
92,8480064,Josh Norris,C,OTT,25,73,15,23,38
92,8479987,Morgan Geekie,C,BOS,26,74,14,24,38
92,8478542,Evan Rodrigues,C,FLA,31,75,10,28,38
92,8476923,Damon Severson,D,CBJ,30,80,8,30,38
92,8476462,Dougie Hamilton,D,NJD,31,70,7,31,38
92,8481581,Thomas Harley,D,DAL,23,75,6,32,38
92,8476854,Hampus Lindholm,D,BOS,30,72,6,32,38
92,8482109,Alexis Lafrenière,L,NYR,23,77,17,20,37
92,8482175,JJ Peterka,R,BUF,22,69,16,21,37
92,8478115,Pierre Engvall,L,NYI,28,79,15,22,37
92,8477932,Aaron Ekblad,D,FLA,28,69,14,23,37
92,8478891,Mason Appleton,C,WPG,28,70,11,26,37
92,8481542,Moritz Seider,D,DET,23,72,8,29,37
92,8476892,Colton Parayko,D,STL,31,73,3,34,37
92,8482125,Alexander Holtz,R,VGK,22,73,22,14,36
92,8481618,Alex Newhook,C,MTL,23,73,15,21,36
92,8475763,Kevin Hayes,R,PIT,32,60,14,22,36
92,8475287,Erik Haula,L,NJD,33,70,12,24,36
92,8480185,Eetu Luostarinen,C,FLA,26,74,12,24,36
92,8482245,Artem Zub,D,OTT,29,73,10,26,36
92,8476458,Ryan Strome,C,ANA,31,74,8,28,36
92,8483490,Pavel Mintyukov,D,ANA,21,77,5,31,36
92,8481606,Jordan Spence,D,LAK,23,68,5,31,36
92,8478396,Noah Hanifin,D,VGK,27,62,4,32,36
92,8476469,Joel Armia,R,MTL,31,70,18,17,35
92,8480028,Morgan Frost,C,PHI,25,73,17,18,35
92,8480797,Joel Farabee,L,PHI,24,74,15,20,35
92,8476461,Sean Couturier,C,PHI,32,67,15,20,35
92,8480220,Noah Cates,L,PHI,25,67,14,21,35
92,8478055,Gustav Forsling,D,FLA,28,70,12,23,35
92,8477505,Alexander Wennberg,C,SJS,30,65,11,24,35
92,8478469,Thomas Chabot,D,OTT,27,73,8,27,35
92,8482110,Dawson Mercer,C,NJD,23,71,20,14,34
92,8482092,Ridly Greig,C,OTT,22,75,18,16,34
92,8478413,Jordan Greenway,L,BUF,27,68,18,16,34
92,8477987,Ryan Donato,C,CHI,28,61,16,18,34
92,8480789,Oliver Wahlstrom,R,NYI,24,69,16,18,34
92,8484166,Adam Fantilli,C,CBJ,20,65,14,20,34
92,8481624,Ilya Mikheyev,R,CHI,30,56,13,21,34
92,8477511,Anthony Mantha,R,CGY,30,74,11,23,34
92,8477498,Darnell Nurse,D,EDM,29,76,11,23,34
92,8482720,Matthew Knies,L,TOR,22,78,8,26,34
92,8482122,Brock Faber,D,MIN,22,81,7,27,34
92,8471698,T.J. Oshie,R,WSH,38,63,20,13,33
92,8482159,Tyson Foerster,R,PHI,22,70,17,16,33
92,8478046,Danton Heinen,L,VAN,29,70,15,18,33
92,8479365,Trent Frederic,C,BOS,26,79,13,20,33
92,8475193,Tomas Tatar,L,NJD,34,66,12,21,33
92,8482146,Luke Evangelista,R,NSH,22,67,11,22,33
92,8484203,Bradly Nadeau,L,CAR,19,63,11,22,33
92,8482105,Jake Sanderson,D,OTT,22,71,9,24,33
92,8482055,Drew O'Connor,L,PIT,26,70,18,14,32
92,8482705,Cole Sillinger,C,CBJ,21,71,16,16,32
92,8475314,Anders Lee,L,NYI,34,78,14,18,32
92,8483505,Matthew Poitras,C,BOS,20,74,11,21,32
92,8479351,Sam Steel,C,DAL,26,80,11,21,32
92,8481523,Kirby Dach,C,MTL,23,64,10,22,32
92,8481703,Valtteri Puustinen,R,PIT,25,61,8,24,32
92,8481546,Cam York,D,PHI,23,73,7,25,32
92,8482712,Oskar Olausson,R,COL,22,78,6,26,32
92,8482624,Daniil Miromanov,D,CGY,27,61,6,26,32
92,8475764,Cam Fowler,D,ANA,33,75,4,28,32
92,8480459,Pius Suter,C,VAN,28,65,23,8,31
92,8480813,Joe Veleno,C,DET,24,77,19,12,31
92,8481554,Kaapo Kakko,R,NYR,23,71,16,15,31
92,8475714,Calle Jarnkrok,C,TOR,33,72,15,16,31
92,8482101,Danil Gushchin,L,SJS,22,54,13,18,31
92,8474151,Ryan McDonagh,D,TBL,35,78,4,27,31
92,8477220,Nate Schmidt,D,FLA,33,69,2,29,31
92,8470621,Corey Perry,R,EDM,39,71,18,12,30
92,8476981,Josh Anderson,R,MTL,30,74,17,13,30
92,8482475,Yegor Chinakhov,R,CBJ,23,58,16,14,30
92,8476419,Jean-Gabriel Pageau,C,NYI,32,74,12,18,30
92,8480829,Jesperi Kotkaniemi,C,CAR,24,64,12,18,30
92,8476480,Vladislav Namestnikov,C,WPG,32,66,9,21,30
92,8475149,Marcus Johansson,L,MIN,34,63,8,22,30
92,8482671,Owen Power,D,BUF,22,69,6,24,30
92,8475848,Brendan Gallagher,R,MTL,32,71,19,10,29
92,8482089,Jake Neighbours,L,STL,22,62,17,12,29
92,8480893,Kirill Marchenko,R,CBJ,24,63,17,12,29
92,8478472,Mathieu Joseph,R,STL,27,66,11,18,29
92,8481577,Philip Tomasino,C,NSH,23,61,10,19,29
92,8479315,Joey Anderson,R,CHI,26,54,10,19,29
92,8480835,Jack Drury,C,CAR,24,54,9,20,29
92,8481186,Logan O'Connor,R,COL,28,78,8,21,29
92,8477506,Ryan Pulock,D,NYI,30,79,5,24,29
92,8478851,Alexandre Carrier,D,NSH,28,70,3,26,29
92,8477952,Robby Fabbri,C,ANA,28,62,14,14,28
92,8479293,Brandon Tanev,L,SEA,33,57,14,14,28
92,8477478,William Carrier,L,CAR,30,59,13,15,28
92,8479393,Noah Gregor,L,OTT,26,69,13,15,28
92,8476897,Oskar Sundqvist,C,STL,30,67,12,16,28
92,8481704,Juuso Parssinen,C,NSH,23,57,11,17,28
92,8475791,Taylor Hall,L,CHI,33,58,9,19,28
92,8482192,Isaak Phillips,D,CHI,23,51,9,19,28
92,8480802,Ryan McLeod,C,BUF,25,66,8,20,28
92,8476891,Matthew Grzelcyk,D,PIT,30,81,6,22,28
92,8477947,Sonny Milano,L,WSH,28,63,6,22,28
92,8476925,Colton Sissons,C,NSH,31,65,13,14,27
92,8478020,Michael Amadio,R,OTT,28,72,12,15,27
92,8475722,Jason Zucker,L,BUF,32,61,12,15,27
92,8474149,Evgenii Dadonov,R,DAL,35,81,11,16,27
92,8480009,Eeli Tolvanen,R,SEA,25,71,11,16,27
92,8482749,Joshua Roy,R,MTL,21,64,11,16,27
92,8477839,Conor Sheary,L,TBL,32,81,9,18,27
92,8481522,Peyton Krebs,C,BUF,23,59,7,20,27
92,8477488,Brett Pesce,D,NJD,30,72,7,20,27
92,8478500,Ivan Provorov,D,CBJ,27,78,5,22,27
92,8476457,Adam Larsson,D,SEA,32,66,5,22,27
92,8476331,Dylan DeMelo,D,WPG,31,70,5,22,27
92,8480871,Adam Boqvist,D,FLA,24,71,4,23,27
92,8476278,Colin Blackwell,C,DAL,31,79,13,13,26
92,8473422,Nick Foligno,L,CHI,37,63,13,13,26
92,8479661,Tanner Jeannot,L,LAK,27,77,13,13,26
92,8477450,Jason Dickinson,C,CHI,29,59,12,14,26
92,8476918,Jimmy Vesey,L,NYR,31,71,11,15,26
92,8479339,Patrik Laine,L,CBJ,26,62,9,17,26
92,8474053,Logan Couture,C,SJS,35,61,7,19,26
92,8478911,Matt Roy,D,WSH,29,67,6,20,26
92,8476885,Jacob Trouba,D,NYR,30,70,5,21,26
92,8475343,Nic Dowd,C,WSH,34,62,5,21,26
92,8475218,Mattias Ekholm,D,EDM,34,72,3,23,26
92,8482679,Matt Coronato,R,CGY,22,64,14,11,25
92,8480448,Parker Kelly,L,COL,25,76,12,13,25
92,8473533,Jordan Staal,C,CAR,36,65,11,14,25
92,8475231,Casey Cizikas,C,NYI,33,74,11,14,25
92,8481601,Simon Holmstrom,R,NYI,23,69,11,14,25
92,8474715,Cameron Atkinson,R,TBL,35,81,9,16,25
92,8475171,Oliver Ekman-Larsson,D,TOR,33,72,8,17,25
92,8480246,Nick Perbix,D,TBL,26,77,8,17,25
92,8476979,Erik Gustafsson,D,DET,32,72,7,18,25
92,8479639,Dylan Coghlan,D,WPG,26,65,7,18,25
92,8482087,Kaiden Guhle,D,MTL,22,67,5,20,25
92,8481059,Scott Perunovich,D,STL,26,60,4,21,25
92,8481582,Nicholas Robertson,L,TOR,23,66,13,11,24
92,8482660,Kent Johnson,C,CBJ,22,60,12,12,24
92,8480003,Jesper Boqvist,C,FLA,26,74,12,12,24
92,8478057,Dakota Joshua,C,VAN,28,66,10,14,24
92,8477953,Kasperi Kapanen,R,STL,28,70,9,15,24
92,8480068,Ryan Poehling,C,PHI,25,64,7,17,24
92,8478013,Jake Walman,D,SJS,28,72,7,17,24
92,8475200,Dmitry Orlov,D,CAR,33,76,5,19,24
92,8476463,Jonas Brodin,D,MIN,31,76,5,19,24
92,8480873,Rasmus Sandin,D,WSH,24,65,5,19,24
92,8480222,Sebastian Aho,D,PIT,28,69,5,19,24
92,8482655,Janis Moser,D,TBL,24,72,3,21,24
92,8477435,Ryan Graves,D,PIT,29,75,2,22,24
92,8479976,Juuso Valimaki,D,UTA,26,63,2,22,24
92,8478043,Sam Lafferty,C,BUF,29,64,14,9,23
92,8482062,Cole Smith,L,NSH,29,67,13,10,23
92,8480205,Emil Bemstrom,C,PIT,25,62,13,10,23
92,8483524,Shane Wright,C,SEA,20,58,12,11,23
92,8483445,Cutter Gauthier,L,ANA,20,62,10,13,23
92,8479368,Max Jones,L,BOS,26,70,9,14,23
92,8481580,Connor McMichael,C,WSH,23,65,9,14,23
92,8479324,Ryan Lindgren,D,NYR,26,71,8,15,23
92,8480049,Dylan Samberg,D,WPG,25,68,7,16,23
92,8477508,Curtis Lazar,C,NJD,29,63,7,16,23
92,8476856,Mathew Dumba,D,DAL,30,67,6,17,23
92,8475279,Ben Chiarot,D,DET,33,65,6,17,23
92,8476927,Teddy Blueger,C,VAN,30,67,5,18,23
92,8476902,Esa Lindell,D,DAL,30,75,3,20,23
92,8476879,Cody Ceci,D,EDM,31,66,3,20,23
92,8480878,Nils Lundkvist,D,DAL,24,76,2,21,23
92,8475225,Craig Smith,C,CHI,35,52,14,8,22
92,8479941,Justin Danforth,R,CBJ,31,60,9,13,22
92,8478109,Victor Olofsson,L,VGK,29,68,8,14,22
92,8480144,David Kampf,C,TOR,29,67,8,14,22
92,8477369,Carson Soucy,D,VAN,30,64,7,15,22
92,8477948,Travis Sanheim,D,PHI,28,64,5,17,22
92,8481656,Aliaksei Protas,C,WSH,23,64,5,17,22
92,8482142,Jamie Drysdale,D,PHI,22,67,5,17,22
92,8474673,TJ Brodie,D,CHI,34,67,3,19,22
92,8476917,Adam Pelech,D,NYI,30,75,2,20,22
92,8482259,Bobby McMann,C,TOR,28,60,13,8,21
92,8480995,Pontus Holmberg,R,TOR,25,61,13,8,21
92,8478508,Yakov Trenin,C,MIN,27,63,11,10,21
92,8478463,Anthony Beauvillier,L,PIT,27,66,10,11,21
92,8483468,Jiri Kulich,C,BUF,20,55,10,11,21
92,8477903,Garnet Hathaway,R,PHI,33,65,10,11,21
92,8479996,Cody Glass,C,NSH,25,54,8,13,21
92,8476988,Matt Benning,D,SJS,30,66,8,13,21
92,8482079,Marco Rossi,C,MIN,23,56,7,14,21
92,8479398,Samuel Girard,D,COL,26,65,5,16,21
92,8479026,Philippe Myers,D,TOR,27,57,5,16,21
92,8478136,Jake Middleton,D,MIN,28,75,4,17,21
92,8478133,Jake Evans,C,MTL,28,65,3,18,21
92,8475188,Brayden McNabb,D,VGK,33,57,3,18,21
92,8475462,Radko Gudas,D,ANA,34,69,1,20,21
92,8476878,Zemgus Girgensons,C,TBL,30,80,15,5,20
92,8477573,Nathan Walker,L,STL,30,55,15,5,20
92,8481553,Bobby Brink,R,PHI,23,61,12,8,20
92,8479336,Carl Grundstrom,R,SJS,27,47,12,8,20
92,8477919,Frederick Gaudreau,C,MIN,31,61,10,10,20
92,8476960,Andreas Athanasiou,C,CHI,30,53,10,10,20
92,8477989,Christian Dvorak,C,MTL,28,70,9,11,20
92,8479066,Ryan Lomberg,L,CGY,30,67,9,11,20
92,8480762,Eric Robinson,L,CAR,29,60,8,12,20
92,8481481,Blake Lizotte,C,PIT,27,65,8,12,20
92,8475220,Marcus Foligno,L,MIN,33,61,7,13,20
92,8476329,Travis Boyd,C,MIN,31,59,7,13,20
92,8480145,Neal Pionk,D,WPG,29,70,5,15,20
92,8475181,Nick Leddy,D,STL,33,66,4,16,20
92,8479372,Joshua Mahura,D,SEA,26,61,4,16,20
92,8479998,Mikey Anderson,D,LAK,25,63,3,17,20
92,8481178,Egor Zamula,D,PHI,24,60,3,17,20
92,8481019,David Gustafsson,C,WPG,24,52,3,17,20
92,8476312,Josh Manson,D,COL,33,63,2,18,20
92,8478434,Keegan Kolesar,R,VGK,27,67,14,5,19
92,8480281,Alexey Toropchenko,R,STL,25,59,13,6,19
92,8479619,Michael Carcone,L,UTA,28,57,12,7,19
92,8476438,Brandon Saad,L,STL,32,68,11,8,19
92,8479718,Alex Barré-Boulet,C,MTL,27,52,11,8,19
92,8482157,Will Cuylle,L,NYR,22,60,10,9,19
92,8483493,Frank Nazar,C,CHI,20,50,9,10,19
92,8473453,Trevor Lewis,C,LAK,37,70,9,10,19
92,8479316,Luke Kunin,C,SJS,27,61,8,11,19
92,8481521,Ronnie Attard,D,PHI,25,56,7,12,19
92,8479353,Brett Howden,C,VGK,26,67,7,12,19
92,8481013,Jonatan Berggren,R,DET,24,59,7,12,19
92,8482067,Connor Mackey,D,NYR,28,62,6,13,19
92,8477406,Mattias Janmark,C,EDM,32,68,6,13,19
92,8479980,Nicolas Hague,D,VGK,26,52,5,14,19
92,8477507,Nikita Zadorov,D,BOS,29,69,5,14,19
92,8473507,Jeff Petry,D,DET,37,71,1,18,19
92,8478507,John Marino,D,UTA,27,70,0,19,19
92,8481032,Paul Cotter,C,NJD,25,55,11,7,18
92,8482074,Connor Zary,C,CGY,23,62,10,8,18
92,8477380,Jonny Brodzinski,C,NYR,31,53,8,10,18
92,8481028,Martin Pospisil,C,CGY,25,56,7,11,18
92,8478569,Noel Acciari,C,PIT,33,59,7,11,18
92,8478452,Caleb Jones,D,LAK,27,55,6,12,18
92,8481527,Kaedan Korczak,D,VGK,23,53,6,12,18
92,8483491,Ivan Miroshnichenko,L,WSH,20,60,6,12,18
92,8474189,Lars Eller,C,PIT,35,65,5,13,18
92,8482634,Alex Steeves,C,TOR,25,49,5,13,18
92,8481014,Alexander Romanov,D,NYI,24,70,5,13,18
92,8480073,Erik Brannstrom,D,COL,25,60,4,14,18
92,8477353,Tyler Motte,C,DET,29,72,4,14,18
92,8479369,Andrew Peeke,D,BOS,26,66,4,14,18
92,8480157,Calle Rosen,D,COL,30,54,4,14,18
92,8476931,Jake McCabe,D,TOR,31,61,3,15,18
92,8475324,Nick Jensen,D,OTT,34,62,1,17,18
92,8475233,David Savard,D,MTL,34,66,0,18,18
92,8477392,Hudson Fasching,R,NYI,29,62,12,5,17
92,8475855,Jesper Fast,R,CAR,33,61,12,5,17
92,8480074,Alexandre Texier,C,STL,25,51,12,5,17
92,8481716,Dmitri Voronkov,L,CBJ,24,44,12,5,17
92,8483499,Liam Ohgren,L,MIN,20,54,10,7,17
92,8476474,Stefan Noesen,R,NJD,31,64,8,9,17
92,8480980,Connor Dewar,C,TOR,25,62,8,9,17
92,8478831,Kevin Stenlund,C,UTA,28,56,8,9,17
92,8480025,MacKenzie Entwistle,R,FLA,25,63,8,9,17
92,8471817,Ryan Reaves,R,TOR,37,64,8,9,17
92,8481535,Nils Hoglander,L,VAN,24,71,7,10,17
92,8482117,Lukas Reichel,L,CHI,22,49,7,10,17
92,8479390,Taylor Raddysh,R,WSH,26,57,7,10,17
92,8481517,Brett Leason,R,ANA,25,60,7,10,17
92,8474034,Patrick Maroon,L,CHI,36,47,7,10,17
92,8482111,Justin Barron,D,MTL,23,57,6,11,17
92,8482803,Olen Zellweger,D,ANA,21,64,6,11,17
92,8476467,Jamie Oleksiak,D,SEA,32,67,4,13,17
92,8478882,Vladislav Gavrikov,D,LAK,29,71,3,14,17
92,8481568,Alex Vlasic,D,CHI,23,55,3,14,17
92,8477845,Trevor van Riemsdyk,D,WSH,33,62,3,14,17
92,8478178,Darren Raddysh,D,TBL,28,70,3,14,17
92,8475790,Erik Gudbranson,D,CBJ,32,72,2,15,17
92,8480950,Ilya Lyubushkin,D,DAL,30,60,2,15,17
92,8481641,Joel Kiviranta,L,COL,28,74,10,6,16
92,8476822,Luke Glendening,C,TBL,35,79,8,8,16
92,8479370,Tyson Jost,C,CAR,26,57,8,8,16
92,8476442,Matt Nieto,L,PIT,32,49,8,8,16
92,8483457,Lane Hutson,D,MTL,20,69,6,10,16
92,8481093,Rafael Harvey-Pinard,L,MTL,25,57,6,10,16
92,8477979,Nicolas Aube-Kubel,R,BUF,28,62,6,10,16
92,8482737,Zack Bolduc,C,STL,21,58,5,11,16
92,8478451,Ethan Bear,D,WSH,27,45,4,12,16
92,8477365,Connor Clifton,D,BUF,29,63,3,13,16
92,8476429,Scott Mayfield,D,NYI,32,74,2,14,16
92,8477499,Rasmus Ristolainen,D,PHI,30,56,2,14,16
92,8482176,Wyatt Kaiser,D,CHI,22,52,2,14,16
92,8475690,Chris Tanev,D,TOR,35,58,2,14,16
92,8480001,Urho Vaakanainen,D,ANA,25,65,2,14,16
92,8478840,Will Borgen,D,SEA,28,64,1,15,16
92,8477446,Michael McCarron,R,NSH,29,56,8,7,15
92,8480336,Sean Walker,D,CAR,30,69,7,8,15
92,8479944,Zach Aston-Reese,C,VGK,30,52,7,8,15
92,8482148,Hendrix Lapierre,C,WSH,22,54,6,9,15
92,8484911,Collin Graf,R,SJS,22,47,6,9,15
92,8475208,Brian Dumoulin,D,ANA,33,60,5,10,15
92,8479402,Jake Bean,D,CGY,26,60,4,11,15
92,8476994,Vinnie Hinostroza,C,NSH,30,52,4,11,15
92,8478970,Jalen Chatfield,D,CAR,28,72,4,11,15
92,8480727,Zach Whitecloud,D,VGK,28,50,4,11,15
92,8475179,Dmitry Kulikov,D,FLA,34,67,4,11,15
92,8480834,Ty Emberson,D,SJS,24,35,4,11,15
92,8482095,Tyler Kleven,D,OTT,22,48,4,11,15
92,8479983,Mario Ferraro,D,SJS,26,66,3,12,15
92,8478399,Jonas Siegenthaler,D,NJD,27,56,2,13,15
92,8474574,Tyler Myers,D,VAN,34,67,2,13,15
92,8481708,Zac Jones,D,NYR,24,48,1,14,15
92,8481754,Nikita Nesterenko,C,ANA,23,43,11,3,14
92,8479414,Nathan Bastian,R,NJD,27,64,7,7,14
92,8480748,Kiefer Sherwood,L,VAN,29,59,7,7,14
92,8479520,Brandon Duhaime,R,WSH,27,55,7,7,14
92,8476873,Mark Jankowski,C,NSH,30,51,6,8,14
92,8482807,Ethan Del Mastro,D,CHI,21,48,6,8,14
92,8482744,James Malatesta,L,CBJ,21,45,6,8,14
92,8479439,Jacob MacDonald,D,COL,31,48,5,9,14
92,8479344,Jesse Puljujarvi,R,PIT,26,51,5,9,14
92,8473563,Nicklas Backstrom,C,WSH,37,47,5,9,14
92,8477938,Haydn Fleury,D,WPG,28,41,5,9,14
92,8479543,Michael Pezzetta,L,MTL,26,51,5,9,14
92,8483565,Nick Blankenburg,D,NSH,26,58,4,10,14
92,8480441,Trey Fix-Wolansky,R,CBJ,25,41,4,10,14
92,8476422,Mike Reilly,D,NYI,31,77,3,11,14
92,8480860,Kevin Bahl,D,CGY,24,52,3,11,14
92,8481167,Brayden Pachal,D,CGY,25,48,3,11,14
92,8479371,Dante Fabbro,D,NSH,26,67,2,12,14
92,8478416,Erik Cernak,D,TBL,27,74,2,12,14
92,8480172,Jan Rutta,D,SJS,34,62,2,12,14
92,8481599,Victor Soderstrom,D,UTA,23,48,2,12,14
92,8482730,Brandt Clarke,D,LAK,21,46,2,12,14
92,8480807,Mattias Samuelsson,D,BUF,24,58,1,13,14
92,8476525,Colin Miller,D,WPG,32,65,0,14,14
92,8482077,Dylan Holloway,L,EDM,23,53,10,3,13
92,8476889,Radek Faksa,C,STL,30,61,8,5,13
92,8482762,Simon Edvinsson,D,DET,21,59,7,6,13
92,8470600,Ryan Suter,D,STL,39,64,5,8,13
92,8478432,Christian Fischer,R,DET,27,72,5,8,13
92,8483466,Kevin Korchinski,D,CHI,20,41,5,8,13
92,8480021,Jack Studnicka,C,LAK,25,63,5,8,13
92,8482073,Braden Schneider,D,NYR,23,60,4,9,13
92,8471709,Marc-Edouard Vlasic,D,SJS,37,58,4,9,13
92,8478443,Brandon Carlo,D,BOS,28,57,3,10,13
92,8480887,Jordan Harris,D,MTL,24,57,2,11,13
92,8475718,Justin Holl,D,DET,32,61,2,11,13
92,8476874,Olli Maatta,D,DET,30,64,2,11,13
92,8480035,Henri Jokiharju,D,BUF,25,60,1,12,13
92,8481567,Henry Thrun,D,SJS,23,51,1,12,13
92,8481441,Joe Snively,C,DET,28,61,8,4,12
92,8477482,Zachary Sanford,L,CHI,30,38,7,5,12
92,8480011,Klim Kostin,C,SJS,25,43,7,5,12
92,8478424,Jansen Harkins,C,ANA,27,43,7,5,12
92,8478421,A.J. Greer,L,FLA,28,52,7,5,12
92,8479328,Julien Gauthier,R,NYI,27,64,6,6,12
92,8477931,Tomas Nosek,L,FLA,32,61,6,6,12
92,8481751,Lukas Rousek,R,BUF,25,38,6,6,12
92,8482652,Walker Duehr,R,CGY,27,47,6,6,12
92,8481477,Nico Sturm,C,SJS,29,45,5,7,12
92,8480806,Isac Lundestrom,C,ANA,25,59,5,7,12
92,8482859,Zack Ostapchuk,C,OTT,21,62,5,7,12
92,8479994,Jaret Anderson-Dolan,C,WPG,25,38,5,7,12
92,8477015,Connor Brown,R,EDM,30,64,4,8,12
92,8482666,Scott Morrow,D,CAR,22,44,4,8,12
92,8483549,Lucas Condotta,L,MTL,27,29,4,8,12
92,8480891,Michael Kesselring,D,UTA,24,56,3,9,12
92,8480043,Timothy Liljegren,D,TOR,25,61,2,10,12
92,8476374,Sean Kuraly,C,CBJ,31,60,2,10,12
92,8481701,Santeri Hatakka,D,NJD,23,45,2,10,12
92,8476952,Dominic Toninato,C,WPG,30,31,1,11,12
92,8474567,Zach Bogosian,D,MIN,34,69,1,11,12
92,8481617,Vasily Podkolzin,R,VAN,23,56,8,3,11
92,8484149,Gavin Brindley,C,CBJ,20,49,7,4,11
92,8480289,Morgan Barron,C,WPG,26,44,7,4,11
92,8481518,Nolan Foote,L,NJD,24,33,7,4,11
92,8480252,Cole Guttman,C,CHI,25,36,6,5,11
92,8476624,Barclay Goodrow,C,SJS,31,54,5,6,11
92,8479291,Kevin Rooney,C,CGY,31,42,5,6,11
92,8479981,Jonah Gadjovich,L,FLA,26,43,5,6,11
92,8483482,Tristan Luneau,D,ANA,20,61,4,7,11
92,8480355,Mark Kastelic,C,BOS,25,48,4,7,11
92,8482659,Josh Doan,R,UTA,22,50,4,7,11
92,8482809,Jackson Blake,R,CAR,21,59,3,8,11
92,8482451,Mikael Pyyhtia,L,CBJ,23,37,3,8,11
92,8481537,Nikita Okhotiuk,D,CGY,24,57,3,8,11
92,8479982,Conor Timmins,D,TOR,26,54,2,9,11
92,8479671,Mathieu Olivier,R,CBJ,27,48,2,9,11
92,8482964,Arber Xhekaj,D,MTL,23,50,2,9,11
92,8480007,Jonas Rondbjerg,R,VGK,25,44,2,9,11
92,8474568,Luke Schenn,D,NSH,35,45,1,10,11
92,8477034,Jaycob Megna,D,FLA,32,43,0,11,11
92,8482166,Shakir Mukhamadullin,D,SJS,22,56,9,1,10
92,8475842,Sam Carrick,C,NYR,32,54,8,2,10
92,8476934,Brock McGinn,L,ANA,30,44,7,3,10
92,8481679,Maxence Guenette,D,OTT,23,34,7,3,10
92,8480845,Rasmus Kupari,C,WPG,24,46,5,5,10
92,8481789,Tye Kartye,L,SEA,23,39,4,6,10
92,8481598,Philip Broberg,D,EDM,23,41,3,7,10
92,8474612,Travis Hamonic,D,OTT,34,44,3,7,10
92,8477070,Liam O'Brien,C,UTA,30,53,2,8,10
92,8475455,Brenden Dillon,D,NJD,34,57,2,8,10
92,8481122,Simon Benoit,D,TOR,26,43,2,8,10
92,8479348,Kale Clague,D,BUF,26,32,2,8,10
92,8483460,David Jiricek,D,CBJ,21,61,1,9,10
92,8477018,Ben Hutton,D,VGK,31,39,1,9,10
92,8480879,Jacob Bernard-Docker,D,OTT,24,46,1,9,10
92,8479359,Beck Malenstyn,L,BUF,26,46,6,3,9
92,8476858,Phillip Di Giuseppe,L,VAN,31,48,6,3,9
92,8479968,Vinni Lettieri,C,BOS,29,47,5,4,9
92,8480192,Johnathan Kovacevic,D,NJD,27,52,4,5,9
92,8481592,Jakob Pelletier,L,CGY,23,47,4,5,9
92,8482747,Brennan Othmann,L,NYR,21,39,3,6,9
92,8478468,Jeremy Lauzon,D,NSH,27,50,3,6,9
92,8480070,Ian Mitchell,D,BOS,25,54,3,6,9
92,8480796,Martin Fehervary,D,WSH,25,57,2,7,9
92,8474090,Brendan Smith,D,DAL,35,56,2,7,9
92,8474166,Alec Martinez,D,CHI,37,54,2,7,9
92,8482145,Mavrik Bourque,C,DAL,22,45,2,7,9
92,8476967,Brett Kulak,D,EDM,30,67,1,8,9
92,8479378,Logan Stanley,D,WPG,26,42,1,8,9
92,8475762,Derek Forbort,D,VAN,32,40,1,8,9
92,8484254,Akito Hirose,D,VAN,25,43,1,8,9
92,8480880,Jakub Lauko,C,MIN,24,37,5,3,8
92,8481550,Adam Beckman,L,NJD,23,41,4,4,8
92,8479638,Justin Brazeau,R,BOS,26,42,4,4,8
92,8483630,Pavol Regenda,L,ANA,25,26,4,4,8
92,8481609,Vladislav Kolyachonok,D,UTA,23,37,3,5,8
92,8482784,Zach Dean,C,STL,21,42,2,6,8
92,8484258,Sam Malinski,D,COL,26,24,2,6,8
92,8473446,Erik Johnson,D,PHI,36,49,1,7,8
92,8477851,Jordan Oesterle,D,BOS,32,32,1,7,8
92,8479972,Mason Shaw,C,WPG,26,32,1,7,8
92,8483495,Simon Nemec,D,NJD,20,56,0,8,8
92,8483570,Ben Meyers,C,SEA,26,40,5,2,7
92,8481556,John Beecher,C,BOS,23,36,5,2,7
92,8480848,Ty Dellandrea,C,SJS,24,42,4,3,7
92,8483763,Maksymilian Szuber,D,UTA,22,30,4,3,7
92,8477401,John Hayden,C,SEA,29,31,3,4,7
92,8476867,Brendan Gaunce,C,MIN,30,34,3,4,7
92,8479985,Cale Fleury,D,SEA,26,31,3,4,7
92,8478859,Niko Mikkola,D,FLA,28,58,3,4,7
92,8477335,Kyle Burroughs,D,LAK,29,40,3,4,7
92,8476372,Nick Seeler,D,PHI,31,42,2,5,7
92,8480844,Grigori Denisenko,L,VGK,24,24,2,5,7
92,8479576,Vincent Desharnais,D,VAN,28,38,2,5,7
92,8478211,Dryden Hunt,L,CGY,29,48,1,6,7
92,8475750,Jon Merrill,D,MIN,32,60,1,6,7
92,8479379,Givani Smith,R,SJS,26,32,1,6,7
92,8483012,Logan Morrison,C,SEA,22,35,1,6,7
92,8471677,Jack Johnson,D,CBJ,37,60,0,7,7
92,8477462,Robert Hagg,D,VGK,29,32,0,7,7
92,8476473,Connor Murphy,D,CHI,31,43,0,7,7
92,8482155,Alex Laferriere,R,LAK,23,64,4,2,6
92,8475235,Nicolas Deslauriers,L,PHI,33,51,4,2,6
92,8482061,Brandon Biro,L,SEA,26,14,4,2,6
92,8478017,Mark Friedman,D,VAN,29,36,3,3,6
92,8482511,Mason Lohrei,D,BOS,23,32,3,3,6
92,8478585,Derek Ryan,C,EDM,38,66,3,3,6
92,8482713,Mackie Samoskevich,R,FLA,22,36,3,3,6
92,8481532,Alex Turcotte,C,LAK,23,43,3,3,6
92,8481543,Nikita Alexandrov,C,STL,24,28,3,3,6
92,8479986,Kole Lind,R,DAL,26,51,2,4,6
92,8481585,Egor Afanasyev,L,SJS,23,17,2,4,6
92,8476441,Joel Edmundson,D,LAK,31,38,1,5,6
92,8478146,Matthew Highmore,C,OTT,28,33,1,5,6
92,8477887,Patrick Brown,C,BOS,32,41,1,5,6
92,8477962,Brendan Lemieux,L,CAR,28,27,1,5,6
92,8482858,Ryker Evans,D,SEA,23,21,1,5,6
92,8477073,Kurtis MacDermid,L,NJD,30,34,1,5,6
92,8475177,Calvin de Haan,D,COL,33,43,0,6,6
92,8479442,Troy Stecher,D,EDM,30,47,0,6,6
92,8479249,Andrew Poturalski,C,SJS,30,33,0,6,6
92,8481161,Jake Christiansen,D,CBJ,25,59,4,1,5
92,8482201,Gage Goncalves,C,TBL,23,27,4,1,5
92,8481578,Graeme Clarke,R,MIN,23,13,4,1,5
92,8482751,Ryan Winterton,C,SEA,21,38,3,2,5
92,8483397,Marc McLaughlin,C,BOS,25,32,3,2,5
92,8482070,Mitchell Chaffee,R,TBL,26,44,3,2,5
92,8479536,Axel Jonsson-Fjallby,L,WPG,26,33,2,3,5
92,8479772,Zack MacEwen,R,OTT,28,51,2,3,5
92,8477384,Joshua Brown,D,EDM,30,46,2,3,5
92,8482765,Isak Rosen,R,BUF,21,29,2,3,5
92,8482733,Logan Mailloux,D,MTL,31,27,2,3,5
92,8480058,Pierre-Olivier Joseph,D,STL,25,49,1,4,5
92,8481600,Tobias Bjornfot,D,FLA,23,37,1,4,5
92,8476913,Devin Shore,C,MIN,30,35,1,4,5
92,8475958,Michael Sgarbossa,C,WSH,32,29,1,4,5
92,8474013,Ian Cole,D,UTA,35,49,0,5,5
92,8477527,Ross Johnston,L,ANA,30,29,0,5,5
92,8478450,Parker Wotherspoon,D,BOS,27,31,0,5,5
92,8482177,Marat Khusnutdinov,C,MIN,22,26,3,1,4
92,8481147,Reese Johnson,C,MIN,26,41,2,2,4
92,8480245,Olle Lycksell,R,PHI,25,36,2,2,4
92,8480292,Carson Meyer,R,ANA,27,36,2,2,4
92,8478409,Anthony Richard,C,PHI,28,29,2,2,4
92,8482172,Landon Slaggert,L,CHI,22,25,2,2,4
92,8477467,Gustav Olofsson,D,SEA,30,19,2,2,4
92,8481719,Maxwell Crozier,D,TBL,24,20,2,2,4
92,8483619,Filip Roos,D,OTT,25,41,1,3,4
92,8481605,Jackson LaCombe,D,ANA,23,21,1,3,4
92,8480267,Sammy Walker,C,MIN,25,20,1,3,4
92,8482470,Ilya Solovyov,D,CGY,24,17,1,3,4
92,8477149,Scott Sabourin,R,SJS,32,16,1,3,4
92,8480196,Jacob Bryson,D,BUF,27,40,0,4,4
92,8478874,Adam Gaudette,R,OTT,28,34,0,4,4
92,8482516,Matthew Kessel,D,STL,24,20,0,4,4
92,8480990,Declan Chisholm,D,MIN,24,32,2,1,3
92,8479991,Jake Leschyshyn,C,NYR,25,32,2,1,3
92,8479320,Maxime Lajoie,D,SEA,27,17,2,1,3
92,8481065,Angus Crookshank,L,OTT,25,10,2,1,3
92,8478477,Mitchell Stephens,C,SEA,27,19,2,1,3
92,8481043,Cole Koepke,L,BOS,26,17,2,1,3
92,8482496,Nils Aman,C,VAN,24,27,1,2,3
92,8483512,Matthew Savoie,C,EDM,20,18,1,2,3
92,8477473,Justin Bailey,R,SJS,29,22,1,2,3
92,8482250,Callahan Burke,C,VGK,27,20,1,2,3
92,8482165,Yan Kuznetsov,D,CGY,22,21,1,2,3
92,8479367,William Lockwood,R,FLA,26,28,1,2,3
92,8478011,Louie Belpedio,D,PHI,28,15,1,2,3
92,8479587,Rhett Gardner,C,PHI,28,26,0,3,3
92,8482861,Vincent Iorio,D,WSH,22,34,0,3,3
92,8484287,Cole McWard,D,VAN,23,23,0,3,3
92,8481593,Jayden Struble,D,MTL,23,24,0,3,3
92,8482118,Sam Colangelo,R,ANA,23,16,2,0,2
92,8480851,Akil Thomas,C,LAK,24,18,2,0,2
92,8481806,Louis Crevier,D,CHI,23,12,2,0,2
92,8480032,Shane Bowers,C,NJD,25,15,2,0,2
92,8482141,Lukas Cormier,D,VGK,22,27,1,1,2
92,8482144,Jack Thompson,D,SJS,22,26,1,1,2
92,8482147,Jean-Luc Foudy,C,COL,22,22,1,1,2
92,8484325,Waltteri Merela,C,TBL,26,23,1,1,2
92,8482929,Emil Lilleberg,D,TBL,23,16,1,1,2
92,8483489,Fraser Minten,C,TOR,31,6,1,1,2
92,8481237,Kyle MacLean,C,NYI,25,22,1,1,2
92,8482094,Daemon Hunt,D,MIN,22,15,1,1,2
92,8482088,Justin Sourdif,R,FLA,22,23,1,1,2
92,8475795,Dylan McIlrath,D,WSH,32,12,1,1,2
92,8477320,Anton Blidh,L,NYR,29,31,1,1,2
92,8479421,Jacob Moverare,D,LAK,26,5,1,1,2
92,8480075,Cameron Crotty,D,MIN,25,12,1,1,2
92,8478454,Noah Juulsen,D,VAN,27,32,0,2,2
92,8478502,Dennis Gilbert,D,BUF,28,18,0,2,2
92,8480890,Jan Jenik,C,OTT,24,25,0,2,2
92,8481056,Spencer Stastney,D,NSH,24,33,0,2,2
92,8481743,Marc Del Gaizo,D,NSH,25,18,0,2,2
92,8478051,Max Willman,C,NJD,29,21,0,2,2
92,8477244,Chad Ruhwedel,D,NYR,34,27,0,2,2
92,8482787,Nikita Chibrikov,R,WPG,31,7,0,2,2
92,8482162,Roby Jarventie,L,EDM,22,11,0,2,2
92,8475755,Alexander Petrovic,D,DAL,32,7,0,2,2
92,8481564,Ryan Johnson,D,BUF,23,11,0,2,2
92,8481206,John Ludvig,D,PIT,24,12,0,2,2
92,8483567,Georgii Merkulov,C,BOS,24,15,0,2,2
92,8483398,Declan Carlile,D,TBL,31,5,1,0,1
92,8481462,Mason Morelli,L,VGK,28,8,1,0,1
92,8483407,Brandon Scanlin,D,NYR,25,6,1,0,1
92,8481006,Tyler Tucker,D,STL,24,16,1,0,1
92,8481030,Jack St. Ivany,D,PIT,25,13,1,0,1
92,8482153,Brendan Brisson,C,VGK,23,28,0,1,1
92,8481541,Samuel Bolduc,D,NYI,24,21,0,1,1
92,8477971,Andreas Englund,D,LAK,28,32,0,1,1
92,8477810,Joel Hanley,D,CGY,33,29,0,1,1
92,8483471,Brad Lambert,C,WPG,31,12,0,1,1
92,8480468,James Hamblin,L,EDM,25,17,0,1,1
92,8482460,Matt Rempe,C,NYR,22,13,0,1,1
92,8474062,Riley Nash,C,NYR,35,10,0,1,1
92,8484304,Uvis Balinskis,D,FLA,28,8,0,1,1
92,8480870,Bo Groulx,C,NYR,24,26,0,1,1
92,8480874,Adam Ginning,D,PHI,24,8,0,1,1
92,8480306,Grant Hutton,D,NYI,29,14,0,1,1
92,8478881,Brett Seney,L,CHI,28,14,0,1,1
92,8478446,Glenn Gawdin,C,LAK,27,12,0,1,1
92,8481655,Cole Schwindt,R,CGY,23,7,0,1,1
92,8483920,Pierrick Dube,R,WSH,23,8,0,1,1
92,8478854,Ryan Shea,D,PIT,27,7,0,1,1
92,8483546,Marshall Rifai,D,TOR,26,8,0,1,1
92,8479419,Brett Murray,L,BUF,26,12,0,0,0
92,8481422,Jake Lucchini,C,NSH,29,18,0,0,0
92,8480084,Nick DeSimone,D,NJD,30,12,0,0,0
92,8478021,William Lagesson,D,DET,28,28,0,0,0
92,8481024,Linus Karlsson,C,VAN,25,9,0,0,0
92,8482197,Adam Raska,R,MIN,23,5,0,0,0
92,8483395,Arshdeep Bains,L,VAN,23,13,0,0,0
92,8484255,Jason Polin,R,COL,25,3,0,0,0
92,8479330,Brandon Gignac,C,MTL,27,11,0,0,0
92,8477993,Justin Kirkland,C,CGY,28,8,0,0,0
92,8475780,Chris Wagner,R,COL,33,6,0,0,0
92,8483609,Adam Klapka,R,CGY,24,0,0,0,0
92,8483597,Milos Kelemen,L,UTA,25,19,0,0,0
92,8480823,Alexander Alexeyev,D,WSH,25,10,0,0,0
92,8476323,Max McCormick,L,SEA,32,2,0,0,0
92,8479362,Riley Tufte,L,BOS,26,20,0,0,0
92,8477541,Dakota Mermis,D,TOR,30,9,0,0,0
92,8482102,Vasily Ponomarev,C,PIT,22,13,0,0,0
92,8475413,Justin Dowling,C,NJD,34,12,0,0,0
92,8481699,Aku Raty,R,UTA,23,11,0,0,0
92,8481534,Raphael Lavoie,C,EDM,24,3,0,0,0
92,8478147,Bokondji Imama,L,PIT,28,4,0,0,0
92,8481726,Adam Edstrom,C,NYR,24,7,0,0,0
92,8484321,Nikolas Matinpalo,D,OTT,26,0,0,0,0
92,8483432,Luca Del Bel Belluz,C,CBJ,31,2,0,0,0
92,8482476,Emil Heineman,L,MTL,23,5,0,0,0
92,8483401,Marc Johnstone,R,PIT,28,0,0,0,0
92,8479522,Hardy Haman Aktell,D,WSH,26,4,0,0,0
92,8482126,Emil Andrae,D,PHI,31,2,0,0,0
92,8484326,Patrik Koch,D,UTA,28,3,0,0,0
92,8483531,Brian Halonen,L,NJD,25,1,0,0,0
92,8478956,Samuel Laberge,L,NJD,27,1,0,0,0
92,8480274,Philip Kemp,D,EDM,25,1,0,0,0
92,8484259,Ondrej Pavel,C,COL,31,1,0,0,0
92,8470794,Joe Pavelski,C,,40,0,0,0,0
92,8479321,Lucas Johansen,D,,27,0,0,0,0
92,8477950,Tony DeAngelo,D,,29,0,0,0,0
92,8471218,Blake Wheeler,R,,38,0,0,0,0
92,8475197,Tyson Barrie,D,,33,0,0,0,0
92,8474157,Max Pacioretty,L,,36,0,0,0,0
92,8475744,Evgeny Kuznetsov,C,,32,0,0,0,0
92,8474037,James van Riemsdyk,L,,35,0,0,0,0
92,8476907,Mackenzie MacEachern,L,,30,0,0,0,0
92,8480216,Jacob Peterson,C,,25,0,0,0,0
92,8474602,Justin Schultz,D,,34,0,0,0,0
92,8482222,Alexander Barabanov,L,,30,0,0,0,0
92,8474031,Kevin Shattenkirk,D,,35,0,0,0,0
92,8477330,Dominik Kubalik,L,,29,0,0,0,0
92,8480884,Calen Addison,D,,24,0,0,0,0
92,8475906,John Klingberg,D,,32,0,0,0,0
92,8480008,Adam Ruzicka,C,,25,0,0,0,0
92,8476884,Derrick Pouliot,D,,30,0,0,0,0
92,8476919,Chris Tierney,C,,30,0,0,0,0
92,8479415,Michael McLeod,C,,26,0,0,0,0
92,8474870,Tyler Johnson,C,,34,0,0,0,0
92,8470604,Jeff Carter,C,,39,0,0,0,0
92,8478104,Sammy Blais,L,,28,0,0,0,0
92,8474884,Mike Hoffman,C,,35,0,0,0,0
92,8481591,Sam Poulin,R,,23,0,0,0,0
92,8471274,Alex Goligoski,D,,39,0,0,0,0
92,8476871,Tanner Pearson,L,,32,0,0,0,0
92,8476393,Nick Cousins,C,,31,0,0,0,0
92,8479977,Kailer Yamamoto,R,,26,0,0,0,0
92,8479346,Dillon Dube,C,,26,0,0,0,0
92,8480184,Gustav Lindstrom,D,,26,0,0,0,0
92,8479376,Victor Mete,D,,26,0,0,0,0
92,8473449,Kyle Okposo,R,,36,0,0,0,0
92,8481058,Jesse Ylonen,R,,25,0,0,0,0
92,8475752,Tyler Pitlick,C,,33,0,0,0,0
92,8481239,Samuel Fagemo,L,,24,0,0,0,0
92,8480821,Filip Zadina,R,,25,0,0,0,0
92,8470966,Mark Giordano,D,,41,0,0,0,0
92,8478495,Denis Gurianov,R,,27,0,0,0,0
92,8477464,Nic Petan,C,,29,0,0,0,0
92,8478099,Kevin Labanc,R,,29,0,0,0,0
92,8482241,Radim Zohorna,L,,28,0,0,0,0
92,8474040,Sam Gagner,C,,35,0,0,0,0
92,8479514,Rem Pitlick,C,,27,0,0,0,0
92,8478430,Oliver Kylington,D,,27,0,0,0,0
92,8479533,Joona Koppanen,L,,26,0,0,0,0
92,8479984,Cal Foote,D,,26,0,0,0,0
92,8477126,Jayson Megna,C,,34,0,0,0,0
92,8475164,Jakob Silfverberg,R,,34,0,0,0,0
92,8474009,Nick Bonino,C,,36,0,0,0,0
92,8479458,Nikita Zaitsev,D,,33,0,0,0,0
92,8477944,Jakub Vrana,L,,28,0,0,0,0
92,8471699,Andrew Cogliano,C,,37,0,0,0,0
92,8478067,Oskar Lindblom,L,,28,0,0,0,0
92,8471686,Marc Staal,D,,37,0,0,0,0
92,8470610,Zach Parise,L,,40,0,0,0,0
92,8478904,Steven Lorentz,C,,28,0,0,0,0
92,8473473,Milan Lucic,L,,36,0,0,0,0
92,8480031,Maxime Comtois,L,,25,0,0,0,0
92,8478512,Austin Czarnik,C,,32,0,0,0,0
92,8473504,Cal Clutterbuck,R,,37,0,0,0,0
92,8477454,Adam Erne,L,,29,0,0,0,0
92,8479383,Boris Katchouk,L,,26,0,0,0,0
92,8475825,Jani Hakanpää,D,,32,0,0,0,0
92,8477846,Ryan Carpenter,C,,33,0,0,0,0
92,8477930,Pierre-Edouard Bellemare,L,,39,0,0,0,0
92,8478400,Colin White,C,,27,0,0,0,0
92,8480226,Marián Studenic,R,,26,0,0,0,0
92,8480853,Liam Foudy,C,,24,0,0,0,0
92,8475797,Jarred Tinordi,D,,32,0,0,0,0
92,8479423,Alex Nylander,L,,26,0,0,0,0
92,8474618,Marco Scandella,D,,34,0,0,0,0
92,8478028,Fredrik Olofsson,L,,28,0,0,0,0
92,8474709,Matt Martin,L,,35,0,0,0,0
92,8481070,Hugh McGing,L,,26,0,0,0,0
92,8479546,Oskar Steen,C,,26,0,0,0,0
92,8474145,Robert Bortuzzo,D,,35,0,0,0,0
92,8476915,Jujhar Khaira,L,,30,0,0,0,0
92,8475278,Byron Froese,C,,33,0,0,0,0
92,8481812,Nikolai Knyzhov,D,,27,0,0,0,0
92,8478408,Travis Dermott,D,,28,0,0,0,0
92,8481077,John Leonard,L,,26,0,0,0,0
92,8479547,Matthew Phillips,R,,26,0,0,0,0
92,8480836,Jonathan Gruden,C,,24,0,0,0,0
92,8481690,Tyler Angle,C,,24,0,0,0,0
92,8475766,Austin Watson,L,,32,0,0,0,0
92,8481016,Ruslan Iskhakov,C,,24,0,0,0,0
92,8478078,Rourke Chartier,C,,28,0,0,0,0
92,8480776,Sheldon Rempal,R,,29,0,0,0,0
92,8483045,Cameron Butler,R,CBJ,31,2,0,0,0
92,8484314,Jiri Smejkal,L,,28,0,0,0,0
93,8478402,Connor McDavid,C,EDM,27,80,55,100,155
93,8477492,Nathan MacKinnon,C,COL,29,81,50,83,133
93,8478483,Mitch Marner,R,TOR,27,77,40,86,126
93,8477956,David Pastrnak,R,BOS,28,80,59,66,125
93,8477934,Leon Draisaitl,C,EDM,29,81,44,77,121
93,8479314,Matthew Tkachuk,L,FLA,27,77,39,79,118
93,8477939,William Nylander,R,TOR,28,78,50,66,116
93,8479318,Auston Matthews,C,TOR,27,78,61,52,113
93,8478420,Mikko Rantanen,R,COL,28,81,42,70,112
93,8476453,Nikita Kucherov,R,TBL,31,81,37,75,112
93,8480069,Cale Makar,D,COL,26,67,28,84,112
93,8476887,Filip Forsberg,L,NSH,30,75,44,61,105
93,8476468,J.T. Miller,C,VAN,31,79,36,62,98
93,8481559,Jack Hughes,C,NJD,23,77,33,65,98
93,8477493,Aleksander Barkov,C,FLA,29,78,29,68,97
93,8480002,Nico Hischier,C,NJD,25,71,35,60,95
93,8478864,Kirill Kaprizov,L,MIN,27,71,43,51,94
93,8480801,Brady Tkachuk,L,OTT,25,79,41,53,94
93,8478403,Jack Eichel,C,VGK,28,78,31,62,93
93,8480012,Elias Pettersson,C,VAN,26,74,37,54,91
93,8480023,Robert Thomas,C,STL,25,75,24,66,90
93,8477501,Valeri Nichushkin,R,COL,29,81,43,46,89
93,8477404,Jake Guentzel,C,TBL,30,82,36,53,89
93,8480027,Jason Robertson,L,DAL,25,81,31,58,89
93,8471675,Sidney Crosby,C,PIT,37,71,39,49,88
93,8481557,Matt Boldy,L,MIN,23,72,33,55,88
93,8478445,Mathew Barzal,C,NYI,27,81,27,61,88
93,8477409,Carter Verhaeghe,C,FLA,29,80,41,45,86
93,8478550,Artemi Panarin,L,NYR,33,78,25,61,86
93,8478427,Sebastian Aho,C,CAR,27,71,41,44,85
93,8478010,Brayden Point,C,TBL,28,80,43,41,84
93,8480865,Noah Dobson,D,NYI,24,79,16,68,84
93,8477933,Sam Reinhart,C,FLA,29,78,42,41,83
93,8477946,Dylan Larkin,C,DET,28,81,42,41,83
93,8478439,Travis Konecny,R,PHI,27,76,39,44,83
93,8478444,Brock Boeser,R,VAN,27,73,39,43,82
93,8478449,Roope Hintz,C,DAL,28,82,37,45,82
93,8480800,Quinn Hughes,D,VAN,25,75,14,68,82
93,8475166,John Tavares,C,TOR,34,81,36,45,81
93,8474564,Steven Stamkos,C,NSH,34,74,31,50,81
93,8471215,Evgeni Malkin,C,PIT,38,73,29,52,81
93,8476460,Mark Scheifele,C,WPG,31,74,27,53,80
93,8475172,Nazem Kadri,C,CGY,34,82,34,45,79
93,8482116,Tim Stützle,C,OTT,22,78,29,50,79
93,8476448,William Karlsson,C,VGK,31,76,34,44,78
93,8480830,Andrei Svechnikov,R,CAR,24,69,35,41,76
93,8477402,Pavel Buchnevich,L,STL,29,75,20,56,76
93,8479407,Jesper Bratt,L,NJD,26,75,28,46,74
93,8476875,Mike Matheson,D,MTL,30,74,15,59,74
93,8475786,Zach Hyman,L,EDM,32,79,36,37,73
93,8484144,Connor Bedard,C,CHI,19,66,32,41,73
93,8482740,Wyatt Johnston,C,DAL,21,81,38,33,71
93,8478414,Timo Meier,R,NJD,28,73,33,38,71
93,8475784,Jeff Skinner,C,EDM,32,78,32,39,71
93,8479542,Brandon Hagel,L,TBL,26,82,24,47,71
93,8477496,Elias Lindholm,C,BOS,30,74,19,52,71
93,8480803,Evan Bouchard,D,EDM,25,74,17,54,71
93,8477500,Bo Horvat,C,NYI,29,79,37,33,70
93,8477951,Nick Schmaltz,C,UTA,28,78,26,44,70
93,8477504,Josh Morrissey,D,WPG,29,73,10,60,70
93,8478493,Joel Eriksson Ek,C,MIN,27,72,34,35,69
93,8476389,Vincent Trocheck,C,NYR,31,75,27,42,69
93,8476456,Jonathan Huberdeau,C,CGY,31,80,21,48,69
93,8480036,Miro Heiskanen,D,DAL,25,77,8,61,69
93,8476459,Mika Zibanejad,C,NYR,31,81,28,40,68
93,8479337,Alex DeBrincat,R,DET,27,79,28,40,68
93,8475754,Brock Nelson,C,NYI,33,81,36,31,67
93,8478401,Pavel Zacha,C,BOS,27,80,32,35,67
93,8476881,Tomas Hertl,C,VGK,31,80,32,34,66
93,8480039,Martin Necas,C,CAR,25,71,29,37,66
93,8482078,Lucas Raymond,L,DET,22,78,21,45,66
93,8476853,Morgan Rielly,D,TOR,30,74,15,51,66
93,8475692,Mats Zuccarello,R,MIN,37,79,13,53,66
93,8477960,Adrian Kempe,R,LAK,28,82,36,29,65
93,8475913,Mark Stone,R,VGK,32,77,24,41,65
93,8480208,Drake Batherson,R,OTT,26,76,24,41,65
93,8474141,Patrick Kane,R,DET,36,81,23,42,65
93,8477964,Ivan Barbashev,C,VGK,29,73,22,43,65
93,8475168,Matt Duchene,C,DAL,33,81,23,41,64
93,8477942,Kevin Fiala,L,LAK,28,80,22,42,64
93,8479323,Adam Fox,D,NYR,26,68,11,53,64
93,8479343,Clayton Keller,R,UTA,26,77,26,37,63
93,8480839,Rasmus Dahlin,D,BUF,24,72,18,45,63
93,8476346,Johnny Gaudreau,L,CBJ,31,73,17,46,63
93,8481540,Cole Caufield,R,MTL,23,78,34,28,62
93,8477935,Sam Bennett,C,FLA,28,74,32,30,62
93,8479420,Tage Thompson,C,BUF,27,73,25,37,62
93,8474600,Roman Josi,D,NSH,34,75,17,45,62
93,8478975,Mason Marchment,L,DAL,29,82,17,45,62
93,8475184,Chris Kreider,L,NYR,33,77,33,28,61
93,8476539,Jonathan Marchessault,R,NSH,34,70,32,29,61
93,8482665,Matty Beniers,C,SEA,22,75,26,35,61
93,8475158,Ryan O'Reilly,C,NSH,33,68,23,38,61
93,8477955,Jared McCann,L,SEA,28,75,32,28,60
93,8476479,Phillip Danault,C,LAK,31,81,29,31,60
93,8471685,Anze Kopitar,C,LAK,37,82,24,36,60
93,8471724,Kris Letang,D,PIT,37,79,12,48,60
93,8471214,Alex Ovechkin,L,WSH,39,75,28,31,59
93,8477476,Artturi Lehkonen,L,COL,29,77,26,33,59
93,8473512,Claude Giroux,R,OTT,36,80,22,37,59
93,8476454,Ryan Nugent-Hopkins,C,EDM,31,77,21,38,59
93,8479999,Casey Mittelstadt,C,COL,26,81,18,41,59
93,8470613,Brent Burns,D,CAR,39,78,17,42,59
93,8479385,Jordan Kyrou,C,STL,26,75,28,30,58
93,8484153,Leo Carlsson,C,ANA,20,73,24,34,58
93,8477940,Nikolaj Ehlers,L,WPG,28,72,23,35,58
93,8477949,Alex Tuch,R,BUF,28,75,21,37,58
93,8479525,Ross Colton,C,COL,28,80,31,26,57
93,8482093,Seth Jarvis,C,CAR,22,69,27,30,57
93,8477479,Tyler Bertuzzi,L,CHI,29,63,24,33,57
93,8482113,Anton Lundell,C,FLA,23,75,22,35,57
93,8475167,Victor Hedman,D,TBL,34,77,13,44,57
93,8473419,Brad Marchand,L,BOS,36,77,20,36,56
93,8480018,Nick Suzuki,C,MTL,25,68,16,40,56
93,8478460,Zach Werenski,D,CBJ,27,78,12,44,56
93,8478398,Kyle Connor,L,WPG,28,76,29,26,55
93,8480064,Josh Norris,C,OTT,25,82,29,26,55
93,8475810,Bryan Rust,R,PIT,32,70,26,29,55
93,8477511,Anthony Mantha,R,CGY,30,76,26,29,55
93,8482109,Alexis Lafrenière,L,NYR,23,77,25,30,55
93,8474679,Gustav Nyquist,C,NSH,35,73,17,38,55
93,8478440,Dylan Strome,C,WSH,27,68,15,40,55
93,8474563,Drew Doughty,D,LAK,35,74,9,46,55
93,8475765,Vladimir Tarasenko,R,DET,33,81,19,35,54
93,8475726,Tyler Toffoli,C,SJS,32,66,18,36,54
93,8477503,Max Domi,C,TOR,29,78,16,38,54
93,8475169,Evander Kane,L,EDM,33,76,24,29,53
93,8483808,Andrei Kuzmenko,L,CGY,28,73,23,30,53
93,8478047,Michael Bunting,L,PIT,29,69,20,33,53
93,8475794,Tyler Seguin,C,DAL,32,80,28,24,52
93,8478519,Anthony Cirelli,C,TBL,27,82,25,27,52
93,8482699,Dylan Guenther,R,UTA,21,78,21,31,52
93,8477494,Jonathan Drouin,L,COL,29,79,18,34,52
93,8482124,Quinton Byfield,R,LAK,22,79,17,35,52
93,8475798,Mikael Granlund,C,SJS,32,72,13,39,52
93,8482712,Oskar Olausson,R,COL,22,79,12,40,52
93,8482159,Tyson Foerster,R,PHI,22,72,26,25,51
93,8476906,Shayne Gostisbehere,D,CAR,31,77,11,40,51
93,8479325,Charlie McAvoy,D,BOS,27,72,10,41,51
93,8480015,Owen Tippett,R,PHI,25,77,29,21,50
93,8478498,Jake DeBrusk,L,VAN,28,68,28,22,50
93,8482745,Mason McTavish,C,ANA,21,70,20,30,50
93,8476826,Yanni Gourde,C,SEA,33,75,17,33,50
93,8475170,Brayden Schenn,C,STL,33,70,14,36,50
93,8478397,Rasmus Andersson,D,CGY,28,72,9,41,50
93,8481596,Shane Pinto,C,OTT,24,70,22,27,49
93,8481711,Matias Maccelli,L,UTA,24,78,19,30,49
93,8475745,Charlie Coyle,C,BOS,32,78,19,30,49
93,8476905,Chandler Stephenson,C,SEA,30,73,16,33,49
93,8479345,Jakob Chychrun,D,WSH,26,71,16,33,49
93,8482684,Luke Hughes,D,NJD,21,66,13,36,49
93,8474590,John Carlson,D,WSH,34,66,11,38,49
93,8473986,Alex Killorn,L,ANA,35,75,24,24,48
93,8481618,Alex Newhook,C,MTL,23,71,23,25,48
93,8473994,Jamie Benn,L,DAL,35,80,22,26,48
93,8474102,David Perron,L,OTT,36,80,20,28,48
93,8481528,Dylan Cozens,C,BUF,23,73,16,32,48
93,8478055,Gustav Forsling,D,FLA,28,76,11,37,48
93,8475151,Kyle Palmieri,C,NYI,33,80,27,20,47
93,8476399,Blake Coleman,C,CGY,33,75,19,28,47
93,8479675,Trevor Moore,L,LAK,29,76,18,29,47
93,8477447,Shea Theodore,D,VGK,29,63,18,29,47
93,8483515,Juraj Slafkovsky,L,MTL,20,76,15,32,47
93,8477497,Sean Monahan,C,CBJ,30,66,14,33,47
93,8478873,Troy Terry,R,ANA,27,71,22,24,46
93,8481186,Logan O'Connor,R,COL,28,79,22,24,46
93,8474150,Mikael Backlund,C,CGY,35,76,21,25,46
93,8481560,Arthur Kaliyev,R,LAK,23,81,19,27,46
93,8476792,Torey Krug,D,STL,33,69,17,29,46
93,8478042,Viktor Arvidsson,L,EDM,31,75,15,31,46
93,8474578,Erik Karlsson,D,PIT,34,79,9,37,46
93,8482671,Owen Power,D,BUF,22,74,9,37,46
93,8482097,Jack Quinn,R,BUF,23,67,21,24,45
93,8477416,Oliver Bjorkstrand,R,SEA,29,77,20,25,45
93,8476458,Ryan Strome,C,ANA,31,73,20,25,45
93,8474586,Jordan Eberle,R,SEA,34,78,19,26,45
93,8480028,Morgan Frost,C,PHI,25,75,19,26,45
93,8478469,Thomas Chabot,D,OTT,27,78,16,29,45
93,8478462,Nicolas Roy,C,VGK,27,73,10,35,45
93,8480014,Gabriel Vilardi,C,WPG,25,69,25,19,44
93,8477426,Nicholas Paul,L,TBL,29,81,20,24,44
93,8480849,Barrett Hayton,C,UTA,24,71,20,24,44
93,8478407,Vince Dunn,D,SEA,28,74,11,33,44
93,8476432,Boone Jenner,C,CBJ,31,64,27,16,43
93,8475722,Jason Zucker,L,BUF,32,63,27,16,43
93,8477456,J.T. Compher,L,DET,29,81,21,22,43
93,8475714,Calle Jarnkrok,C,TOR,33,77,21,22,43
93,8475753,Justin Faulk,D,STL,32,73,15,28,43
93,8476882,Teuvo Teravainen,C,CHI,30,66,13,30,43
93,8476872,Scott Laughton,C,PHI,30,75,12,31,43
93,8478472,Mathieu Joseph,R,STL,27,69,12,31,43
93,8478038,Devon Toews,D,COL,30,70,11,32,43
93,8476462,Dougie Hamilton,D,NJD,31,66,11,32,43
93,8482720,Matthew Knies,L,TOR,22,74,10,33,43
93,8480434,Sean Durzi,D,UTA,26,74,9,34,43
93,8481581,Thomas Harley,D,DAL,23,74,7,36,43
93,8483431,Logan Cooley,C,UTA,20,78,22,20,42
93,8474641,Adam Henrique,C,EDM,34,80,22,20,42
93,8475799,Nino Niederreiter,R,WPG,32,68,21,21,42
93,8480798,Philipp Kurashev,C,CHI,25,62,18,24,42
93,8475768,Jaden Schwartz,C,SEA,32,66,18,24,42
93,8482149,Cole Perfetti,C,WPG,22,68,15,27,42
93,8477495,Seth Jones,D,CHI,30,66,13,29,42
93,8476483,Rickard Rakell,R,PIT,31,72,25,16,41
93,8480188,Fabian Zetterlund,L,SJS,25,64,22,19,41
93,8480009,Eeli Tolvanen,R,SEA,25,73,22,19,41
93,8477407,Anthony Duclair,L,NYI,29,74,19,22,41
93,8484166,Adam Fantilli,C,CBJ,20,70,19,22,41
93,8476480,Vladislav Namestnikov,C,WPG,32,64,16,25,41
93,8481068,Yegor Sharangovich,C,CGY,26,80,15,26,41
93,8480797,Joel Farabee,L,PHI,24,77,12,29,41
93,8481533,Trevor Zegras,C,ANA,23,71,11,30,41
93,8477932,Aaron Ekblad,D,FLA,28,70,11,30,41
93,8477998,Warren Foegele,L,LAK,28,79,20,20,40
93,8482175,JJ Peterka,R,BUF,22,66,20,20,40
93,8479992,Michael Rasmussen,C,DET,25,81,18,22,40
93,8476474,Stefan Noesen,R,NJD,31,71,18,22,40
93,8479591,Michael Eyssimont,C,TBL,28,82,15,25,40
93,8477987,Ryan Donato,C,CHI,28,62,15,25,40
93,8478438,Tommy Novak,C,NSH,27,68,13,27,40
93,8478856,Conor Garland,R,VAN,28,66,12,28,40
93,8475218,Mattias Ekholm,D,EDM,34,75,12,28,40
93,8476958,Jaccob Slavin,D,CAR,30,76,10,30,40
93,8478458,John (Jack) Roslovic,C,CAR,27,65,9,31,40
93,8476869,Brady Skjei,D,NSH,30,73,8,32,40
93,8479410,Mikhail Sergachev,D,UTA,26,66,7,33,40
93,8478366,Frank Vatrano,R,ANA,30,70,20,19,39
93,8476880,Tom Wilson,R,WSH,30,72,20,19,39
93,8471698,T.J. Oshie,R,WSH,38,70,20,19,39
93,8478474,Lawson Crouse,L,UTA,27,72,19,20,39
93,8481604,Pavel Dorofeyev,L,VGK,24,66,17,22,39
93,8474053,Logan Couture,C,SJS,35,62,16,23,39
93,8478233,Andrew Mangiapane,L,WSH,28,75,14,25,39
93,8481577,Philip Tomasino,C,NSH,23,70,13,26,39
93,8478133,Jake Evans,C,MTL,28,69,13,26,39
93,8482667,William Eklund,L,SJS,22,63,18,20,38
93,8475314,Anders Lee,L,NYI,34,75,18,20,38
93,8477451,Ryan Hartman,R,MIN,30,65,17,21,38
93,8480220,Noah Cates,L,PHI,25,74,17,21,38
93,8482110,Dawson Mercer,C,NJD,23,71,17,21,38
93,8479339,Patrik Laine,L,CBJ,26,67,15,23,38
93,8480078,Filip Chytil,C,NYR,25,70,14,24,38
93,8480829,Jesperi Kotkaniemi,C,CAR,24,63,14,24,38
93,8477986,Brandon Montour,D,SEA,30,69,9,29,38
93,8476461,Sean Couturier,C,PHI,32,64,8,30,38
93,8476463,Jonas Brodin,D,MIN,31,74,5,33,38
93,8477346,MacKenzie Weegar,D,CGY,30,70,3,35,38
93,8478057,Dakota Joshua,C,VAN,28,65,21,16,37
93,8476392,Adam Lowry,C,WPG,31,67,16,21,37
93,8474189,Lars Eller,C,PIT,35,64,15,22,37
93,8482624,Daniil Miromanov,D,CGY,27,67,13,24,37
93,8479400,Pierre-Luc Dubois,L,WSH,26,73,12,25,37
93,8477444,Andre Burakovsky,L,SEA,29,73,12,25,37
93,8482146,Luke Evangelista,R,NSH,22,67,12,25,37
93,8476419,Jean-Gabriel Pageau,C,NYI,32,79,12,25,37
93,8477498,Darnell Nurse,D,EDM,29,72,10,27,37
93,8477021,Alex Kerfoot,C,UTA,30,76,7,30,37
93,8480145,Neal Pionk,D,WPG,29,72,7,30,37
93,8481542,Moritz Seider,D,DET,23,71,6,31,37
93,8482702,Logan Stankoven,C,DAL,21,79,17,19,36
93,8483505,Matthew Poitras,C,BOS,20,74,17,19,36
93,8478466,Daniel Sprong,R,VAN,27,71,14,22,36
93,8478115,Pierre Engvall,L,NYI,28,76,12,24,36
93,8478396,Noah Hanifin,D,VGK,27,60,8,28,36
93,8474149,Evgenii Dadonov,R,DAL,35,81,20,15,35
93,8480871,Adam Boqvist,D,FLA,24,73,15,20,35
93,8480068,Ryan Poehling,C,PHI,25,70,15,20,35
93,8476438,Brandon Saad,L,STL,32,65,15,20,35
93,8475848,Brendan Gallagher,R,MTL,32,67,12,23,35
93,8475191,Reilly Smith,R,NYR,33,76,10,25,35
93,8476927,Teddy Blueger,C,VAN,30,73,8,27,35
93,8480873,Rasmus Sandin,D,WSH,24,65,4,31,35
93,8481624,Ilya Mikheyev,R,CHI,30,62,16,18,34
93,8476292,Ondrej Palat,L,NJD,33,70,13,21,34
93,8480459,Pius Suter,C,VAN,28,68,13,21,34
93,8477505,Alexander Wennberg,C,SJS,30,63,12,22,34
93,8477919,Frederick Gaudreau,C,MIN,31,65,12,22,34
93,8477429,Andrew Copp,C,DET,30,80,18,15,33
93,8476278,Colin Blackwell,C,DAL,31,80,16,17,33
93,8479987,Morgan Geekie,C,BOS,26,73,15,18,33
93,8482705,Cole Sillinger,C,CBJ,21,70,15,18,33
93,8477953,Kasperi Kapanen,R,STL,28,69,14,19,33
93,8481524,Bowen Byram,D,BUF,23,68,13,20,33
93,8478542,Evan Rodrigues,C,FLA,31,74,12,21,33
93,8475287,Erik Haula,L,NJD,33,63,12,21,33
93,8480185,Eetu Luostarinen,C,FLA,26,75,11,22,33
93,8482092,Ridly Greig,C,OTT,22,80,8,25,33
93,8477969,Marcus Pettersson,D,PIT,28,81,7,26,33
93,8479398,Samuel Girard,D,COL,26,63,6,27,33
93,8476469,Joel Armia,R,MTL,31,70,22,10,32
93,8479996,Cody Glass,C,NSH,25,55,19,13,32
93,8475760,Nick Bjugstad,C,UTA,32,72,18,14,32
93,8482079,Marco Rossi,C,MIN,23,67,17,15,32
93,8480802,Ryan McLeod,C,BUF,25,70,16,16,32
93,8478020,Michael Amadio,R,OTT,28,78,16,16,32
93,8478463,Anthony Beauvillier,L,PIT,27,70,13,19,32
93,8481523,Kirby Dach,C,MTL,23,66,12,20,32
93,8484145,Zach Benson,L,BUF,19,73,10,22,32
93,8477948,Travis Sanheim,D,PHI,28,68,9,23,32
93,8476854,Hampus Lindholm,D,BOS,30,65,4,28,32
93,8478046,Danton Heinen,L,VAN,29,68,15,16,31
93,8480835,Jack Drury,C,CAR,24,60,14,17,31
93,8481535,Nils Hoglander,L,VAN,24,69,14,17,31
93,8474565,Alex Pietrangelo,D,VGK,34,57,11,20,31
93,8484203,Bradly Nadeau,L,CAR,19,60,11,20,31
93,8480980,Connor Dewar,C,TOR,25,66,11,20,31
93,8482660,Kent Johnson,C,CBJ,22,63,10,21,31
93,8482105,Jake Sanderson,D,OTT,22,71,8,23,31
93,8476923,Damon Severson,D,CBJ,30,81,7,24,31
93,8481546,Cam York,D,PHI,23,70,5,26,31
93,8476917,Adam Pelech,D,NYI,30,77,5,26,31
93,8477952,Robby Fabbri,C,ANA,28,67,18,12,30
93,8480855,Jack McBain,C,UTA,24,62,13,17,30
93,8476981,Josh Anderson,R,MTL,30,72,13,17,30
93,8473422,Nick Foligno,L,CHI,37,59,12,18,30
93,8479365,Trent Frederic,C,BOS,26,73,10,20,30
93,8482101,Danil Gushchin,L,SJS,22,61,10,20,30
93,8480878,Nils Lundkvist,D,DAL,24,75,9,21,30
93,8478882,Vladislav Gavrikov,D,LAK,29,66,5,25,30
93,8480043,Timothy Liljegren,D,TOR,25,68,4,26,30
93,8473533,Jordan Staal,C,CAR,36,65,20,9,29
93,8474715,Cameron Atkinson,R,TBL,35,78,20,9,29
93,8482125,Alexander Holtz,R,VGK,22,66,15,14,29
93,8477507,Nikita Zadorov,D,BOS,29,67,14,15,29
93,8475793,Ryan Johansen,C,PHI,32,72,13,16,29
93,8482055,Drew O'Connor,L,PIT,26,60,13,16,29
93,8480817,K'Andre Miller,D,NYR,24,74,11,18,29
93,8476921,Jordan Martinook,L,CAR,32,63,8,21,29
93,8474716,Jared Spurgeon,D,MIN,35,75,7,22,29
93,8480336,Sean Walker,D,CAR,30,70,6,23,29
93,8482122,Brock Faber,D,MIN,22,81,5,24,29
93,8479425,Filip Hronek,D,VAN,27,72,4,25,29
93,8481606,Jordan Spence,D,LAK,23,69,4,25,29
93,8475200,Dmitry Orlov,D,CAR,33,70,2,27,29
93,8474673,TJ Brodie,D,CHI,34,61,0,29,29
93,8478891,Mason Appleton,C,WPG,28,66,15,13,28
93,8481656,Aliaksei Protas,C,WSH,23,63,15,13,28
93,8477989,Christian Dvorak,C,MTL,28,69,13,15,28
93,8479393,Noah Gregor,L,OTT,26,74,12,16,28
93,8481580,Connor McMichael,C,WSH,23,66,12,16,28
93,8477839,Conor Sheary,L,TBL,32,79,9,19,28
93,8482067,Connor Mackey,D,NYR,28,63,8,20,28
93,8480281,Alexey Toropchenko,R,STL,25,62,20,7,27
93,8482259,Bobby McMann,C,TOR,28,67,19,8,27
93,8475855,Jesper Fast,R,CAR,33,54,15,12,27
93,8475763,Kevin Hayes,R,PIT,32,67,13,14,27
93,8475220,Marcus Foligno,L,MIN,33,64,11,16,27
93,8482133,Thomas Bordeleau,C,SJS,22,64,10,17,27
93,8477979,Nicolas Aube-Kubel,R,BUF,28,64,7,20,27
93,8474574,Tyler Myers,D,VAN,34,74,5,22,27
93,8481703,Valtteri Puustinen,R,PIT,25,65,3,24,27
93,8477450,Jason Dickinson,C,CHI,29,60,16,10,26
93,8479661,Tanner Jeannot,L,LAK,27,77,15,11,26
93,8481582,Nicholas Robertson,L,TOR,23,65,15,11,26
93,8479353,Brett Howden,C,VGK,26,69,15,11,26
93,8476918,Jimmy Vesey,L,NYR,31,70,14,12,26
93,8481553,Bobby Brink,R,PHI,23,62,13,13,26
93,8479414,Nathan Bastian,R,NJD,27,65,12,14,26
93,8479390,Taylor Raddysh,R,WSH,26,63,11,15,26
93,8483565,Nick Blankenburg,D,NSH,26,68,11,15,26
93,8475791,Taylor Hall,L,CHI,33,57,10,16,26
93,8479351,Sam Steel,C,DAL,26,78,9,17,26
93,8482111,Justin Barron,D,MTL,23,67,9,17,26
93,8476902,Esa Lindell,D,DAL,30,70,8,18,26
93,8479639,Dylan Coghlan,D,WPG,26,63,7,19,26
93,8476892,Colton Parayko,D,STL,31,70,5,21,26
93,8478851,Alexandre Carrier,D,NSH,28,66,5,21,26
93,8477435,Ryan Graves,D,PIT,29,77,5,21,26
93,8477488,Brett Pesce,D,NJD,30,69,4,22,26
93,8478970,Jalen Chatfield,D,CAR,28,71,4,22,26
93,8478109,Victor Olofsson,L,VGK,29,69,17,8,25
93,8481481,Blake Lizotte,C,PIT,27,60,15,10,25
93,8476873,Mark Jankowski,C,NSH,30,58,14,11,25
93,8478432,Christian Fischer,R,DET,27,71,14,11,25
93,8479368,Max Jones,L,BOS,26,71,13,12,25
93,8477478,William Carrier,L,CAR,30,57,9,16,25
93,8476329,Travis Boyd,C,MIN,31,57,8,17,25
93,8480891,Michael Kesselring,D,UTA,24,64,6,19,25
93,8478500,Ivan Provorov,D,CBJ,27,82,4,21,25
93,8473507,Jeff Petry,D,DET,37,74,4,21,25
93,8480073,Erik Brannstrom,D,COL,25,53,3,22,25
93,8482245,Artem Zub,D,OTT,29,71,2,23,25
93,8475149,Marcus Johansson,L,MIN,34,60,14,10,24
93,8480205,Emil Bemstrom,C,PIT,25,63,14,10,24
93,8477903,Garnet Hathaway,R,PHI,33,66,13,11,24
93,8477392,Hudson Fasching,R,NYI,29,59,10,14,24
93,8480748,Kiefer Sherwood,L,VAN,29,58,10,14,24
93,8476897,Oskar Sundqvist,C,STL,30,62,9,15,24
93,8473563,Nicklas Backstrom,C,WSH,37,64,9,15,24
93,8475171,Oliver Ekman-Larsson,D,TOR,33,69,8,16,24
93,8476467,Jamie Oleksiak,D,SEA,32,66,5,19,24
93,8475764,Cam Fowler,D,ANA,33,76,4,20,24
93,8477220,Nate Schmidt,D,FLA,33,65,3,21,24
93,8482089,Jake Neighbours,L,STL,22,69,15,8,23
93,8479619,Michael Carcone,L,UTA,28,64,15,8,23
93,8479316,Luke Kunin,C,SJS,27,56,12,11,23
93,8482142,Jamie Drysdale,D,PHI,22,68,9,14,23
93,8483482,Tristan Luneau,D,ANA,20,62,8,15,23
93,8478413,Jordan Greenway,L,BUF,27,58,6,17,23
93,8475233,David Savard,D,MTL,34,65,6,17,23
93,8476331,Dylan DeMelo,D,WPG,31,70,5,18,23
93,8479976,Juuso Valimaki,D,UTA,26,66,4,19,23
93,8483445,Cutter Gauthier,L,ANA,20,64,4,19,23
93,8478585,Derek Ryan,C,EDM,38,65,4,19,23
93,8476979,Erik Gustafsson,D,DET,32,76,3,20,23
93,8477499,Rasmus Ristolainen,D,PHI,30,60,3,20,23
93,8478508,Yakov Trenin,C,MIN,27,60,11,11,22
93,8480762,Eric Robinson,L,CAR,29,52,11,11,22
93,8483457,Lane Hutson,D,MTL,20,64,11,11,22
93,8476889,Radek Faksa,C,STL,30,62,11,11,22
93,8481093,Rafael Harvey-Pinard,L,MTL,25,59,10,12,22
93,8474034,Patrick Maroon,L,CHI,36,51,9,13,22
93,8480003,Jesper Boqvist,C,FLA,26,75,8,14,22
93,8478013,Jake Walman,D,SJS,28,64,7,15,22
93,8475181,Nick Leddy,D,STL,33,65,7,15,22
93,8483524,Shane Wright,C,SEA,20,61,6,16,22
93,8476925,Colton Sissons,C,NSH,31,72,5,17,22
93,8482655,Janis Moser,D,TBL,24,77,4,18,22
93,8479983,Mario Ferraro,D,SJS,26,70,4,18,22
93,8477506,Ryan Pulock,D,NYI,30,79,1,21,22
93,8479336,Carl Grundstrom,R,SJS,27,53,14,7,21
93,8483493,Frank Nazar,C,CHI,20,50,13,8,21
93,8480025,MacKenzie Entwistle,R,FLA,25,61,12,9,21
93,8480813,Joe Veleno,C,DET,24,77,10,11,21
93,8476856,Mathew Dumba,D,DAL,30,67,7,14,21
93,8482087,Kaiden Guhle,D,MTL,22,70,6,15,21
93,8478136,Jake Middleton,D,MIN,28,73,5,16,21
93,8479369,Andrew Peeke,D,BOS,26,62,2,19,21
93,8470621,Corey Perry,R,EDM,39,70,12,8,20
93,8475225,Craig Smith,C,CHI,35,55,12,8,20
93,8476885,Jacob Trouba,D,NYR,30,68,10,10,20
93,8481601,Simon Holmstrom,R,NYI,23,67,10,10,20
93,8476422,Mike Reilly,D,NYI,31,71,9,11,20
93,8479315,Joey Anderson,R,CHI,26,54,8,12,20
93,8482749,Joshua Roy,R,MTL,21,64,8,12,20
93,8480144,David Kampf,C,TOR,29,68,8,12,20
93,8481554,Kaapo Kakko,R,NYR,23,65,7,13,20
93,8482117,Lukas Reichel,L,CHI,22,59,7,13,20
93,8482803,Olen Zellweger,D,ANA,21,63,7,13,20
93,8482809,Jackson Blake,R,CAR,21,60,7,13,20
93,8476988,Matt Benning,D,SJS,30,62,6,14,20
93,8474151,Ryan McDonagh,D,TBL,35,75,4,16,20
93,8479402,Jake Bean,D,CGY,26,75,3,17,20
93,8470600,Ryan Suter,D,STL,39,64,3,17,20
93,8479980,Nicolas Hague,D,VGK,26,55,2,18,20
93,8475455,Brenden Dillon,D,NJD,34,64,2,18,20
93,8482737,Zack Bolduc,C,STL,21,62,14,5,19
93,8480893,Kirill Marchenko,R,CBJ,24,61,13,6,19
93,8481032,Paul Cotter,C,NJD,25,58,13,6,19
93,8479344,Jesse Puljujarvi,R,PIT,26,52,13,6,19
93,8481641,Joel Kiviranta,L,COL,28,74,11,8,19
93,8475193,Tomas Tatar,L,NJD,34,67,9,10,19
93,8473453,Trevor Lewis,C,LAK,37,72,9,10,19
93,8477015,Connor Brown,R,EDM,30,62,9,10,19
93,8478211,Dryden Hunt,L,CGY,29,59,7,12,19
93,8479543,Michael Pezzetta,L,MTL,26,62,6,13,19
93,8481441,Joe Snively,C,DET,28,63,6,13,19
93,8480113,Alex Iafallo,L,WPG,31,67,5,14,19
93,8479998,Mikey Anderson,D,LAK,25,65,4,15,19
93,8477018,Ben Hutton,D,VGK,31,44,4,15,19
93,8480222,Sebastian Aho,D,PIT,28,69,3,16,19
93,8480049,Dylan Samberg,D,WPG,25,70,2,17,19
93,8480887,Jordan Harris,D,MTL,24,54,2,17,19
93,8478507,John Marino,D,UTA,27,67,1,18,19
93,8471709,Marc-Edouard Vlasic,D,SJS,37,64,1,18,19
93,8477425,Miles Wood,L,COL,29,78,14,4,18
93,8475231,Casey Cizikas,C,NYI,33,76,11,7,18
93,8482074,Connor Zary,C,CGY,23,58,11,7,18
93,8482475,Yegor Chinakhov,R,CBJ,23,56,9,9,18
93,8479293,Brandon Tanev,L,SEA,33,66,9,9,18
93,8478043,Sam Lafferty,C,BUF,29,64,9,9,18
93,8480995,Pontus Holmberg,R,TOR,25,67,9,9,18
93,8479941,Justin Danforth,R,CBJ,31,58,7,11,18
93,8481527,Kaedan Korczak,D,VGK,23,48,7,11,18
93,8480074,Alexandre Texier,C,STL,25,53,7,11,18
93,8477931,Tomas Nosek,L,FLA,32,63,6,12,18
93,8484149,Gavin Brindley,C,CBJ,20,55,5,13,18
93,8481014,Alexander Romanov,D,NYI,24,76,4,14,18
93,8476429,Scott Mayfield,D,NYI,32,79,4,14,18
93,8478416,Erik Cernak,D,TBL,27,74,4,14,18
93,8482807,Ethan Del Mastro,D,CHI,21,49,3,15,18
93,8476879,Cody Ceci,D,EDM,31,67,2,16,18
93,8481521,Ronnie Attard,D,PHI,25,63,2,16,18
93,8476931,Jake McCabe,D,TOR,31,59,1,17,18
93,8480289,Morgan Barron,C,WPG,26,61,12,5,17
93,8482157,Will Cuylle,L,NYR,22,65,10,7,17
93,8480789,Oliver Wahlstrom,R,NYI,24,63,9,8,17
93,8482062,Cole Smith,L,NSH,29,58,9,8,17
93,8477070,Liam O'Brien,C,UTA,30,56,8,9,17
93,8481522,Peyton Krebs,C,BUF,23,59,6,11,17
93,8482666,Scott Morrow,D,CAR,22,50,5,12,17
93,8479026,Philippe Myers,D,TOR,27,52,3,14,17
93,8475188,Brayden McNabb,D,VGK,33,52,3,14,17
93,8476874,Olli Maatta,D,DET,30,61,3,14,17
93,8480806,Isac Lundestrom,C,ANA,25,59,3,14,17
93,8481178,Egor Zamula,D,PHI,24,46,2,15,17
93,8482679,Matt Coronato,R,CGY,22,66,11,5,16
93,8483491,Ivan Miroshnichenko,L,WSH,20,52,11,5,16
93,8481028,Martin Pospisil,C,CGY,25,61,10,6,16
93,8481517,Brett Leason,R,ANA,25,48,10,6,16
93,8482744,James Malatesta,L,CBJ,21,45,10,6,16
93,8481477,Nico Sturm,C,SJS,29,49,10,6,16
93,8480011,Klim Kostin,C,SJS,25,54,9,7,16
93,8481704,Juuso Parssinen,C,NSH,23,59,8,8,16
93,8477947,Sonny Milano,L,WSH,28,57,8,8,16
93,8477380,Jonny Brodzinski,C,NYR,31,55,8,8,16
93,8479671,Mathieu Olivier,R,CBJ,27,49,8,8,16
93,8482176,Wyatt Kaiser,D,CHI,22,59,7,9,16
93,8480355,Mark Kastelic,C,BOS,25,58,7,9,16
93,8476312,Josh Manson,D,COL,33,68,6,10,16
93,8480848,Ty Dellandrea,C,SJS,24,49,6,10,16
93,8475343,Nic Dowd,C,WSH,34,61,5,11,16
93,8476525,Colin Miller,D,WPG,32,61,5,11,16
93,8482192,Isaak Phillips,D,CHI,23,48,4,12,16
93,8475279,Ben Chiarot,D,DET,33,70,4,12,16
93,8480172,Jan Rutta,D,SJS,34,65,4,12,16
93,8478443,Brandon Carlo,D,BOS,28,67,4,12,16
93,8480246,Nick Perbix,D,TBL,26,76,3,13,16
93,8477369,Carson Soucy,D,VAN,30,63,3,13,16
93,8475690,Chris Tanev,D,TOR,35,59,3,13,16
93,8483490,Pavel Mintyukov,D,ANA,21,67,2,14,16
93,8481568,Alex Vlasic,D,CHI,23,49,2,14,16
93,8476624,Barclay Goodrow,C,SJS,31,52,2,14,16
93,8476457,Adam Larsson,D,SEA,32,68,0,16,16
93,8477508,Curtis Lazar,C,NJD,29,63,12,3,15
93,8475842,Sam Carrick,C,NYR,32,54,9,6,15
93,8479439,Jacob MacDonald,D,COL,31,51,8,7,15
93,8478434,Keegan Kolesar,R,VGK,27,63,7,8,15
93,8476934,Brock McGinn,L,ANA,30,56,7,8,15
93,8480990,Declan Chisholm,D,MIN,24,35,6,9,15
93,8481754,Nikita Nesterenko,C,ANA,23,40,5,10,15
93,8477962,Brendan Lemieux,L,CAR,28,48,5,10,15
93,8478911,Matt Roy,D,WSH,29,63,4,11,15
93,8478452,Caleb Jones,D,LAK,27,51,4,11,15
93,8478178,Darren Raddysh,D,TBL,28,65,3,12,15
93,8476967,Brett Kulak,D,EDM,30,62,3,12,15
93,8479986,Kole Lind,R,DAL,26,54,3,12,15
93,8475790,Erik Gudbranson,D,CBJ,32,78,2,13,15
93,8474567,Zach Bogosian,D,MIN,34,66,2,13,15
93,8482451,Mikael Pyyhtia,L,CBJ,23,41,2,13,15
93,8483460,David Jiricek,D,CBJ,21,57,2,13,15
93,8475208,Brian Dumoulin,D,ANA,33,55,1,14,15
93,8476878,Zemgus Girgensons,C,TBL,30,79,9,5,14
93,8477446,Michael McCarron,R,NSH,29,53,7,7,14
93,8480021,Jack Studnicka,C,LAK,25,57,6,8,14
93,8477573,Nathan Walker,L,STL,30,53,5,9,14
93,8477406,Mattias Janmark,C,EDM,32,60,5,9,14
93,8482634,Alex Steeves,C,TOR,25,45,5,9,14
93,8475177,Calvin de Haan,D,COL,33,45,4,10,14
93,8476822,Luke Glendening,C,TBL,35,80,3,11,14
93,8479982,Conor Timmins,D,TOR,26,54,3,11,14
93,8481600,Tobias Bjornfot,D,FLA,23,44,3,11,14
93,8482073,Braden Schneider,D,NYR,23,70,2,12,14
93,8476891,Matthew Grzelcyk,D,PIT,30,75,1,13,14
93,8482095,Tyler Kleven,D,OTT,22,53,1,13,14
93,8480807,Mattias Samuelsson,D,BUF,24,51,1,13,14
93,8475324,Nick Jensen,D,OTT,34,66,0,14,14
93,8478569,Noel Acciari,C,PIT,33,54,8,5,13
93,8482148,Hendrix Lapierre,C,WSH,22,54,7,6,13
93,8478399,Jonas Siegenthaler,D,NJD,27,55,5,8,13
93,8477851,Jordan Oesterle,D,BOS,32,53,5,8,13
93,8479372,Joshua Mahura,D,SEA,26,44,4,9,13
93,8479718,Alex Barré-Boulet,C,MTL,27,44,4,9,13
93,8482859,Zack Ostapchuk,C,OTT,21,55,4,9,13
93,8483468,Jiri Kulich,C,BUF,20,58,3,10,13
93,8476960,Andreas Athanasiou,C,CHI,30,49,3,10,13
93,8479328,Julien Gauthier,R,NYI,27,64,3,10,13
93,8481708,Zac Jones,D,NYR,24,46,2,11,13
93,8479371,Dante Fabbro,D,NSH,26,53,2,11,13
93,8478468,Jeremy Lauzon,D,NSH,27,55,0,13,13
93,8482077,Dylan Holloway,L,EDM,23,49,8,4,12
93,8480035,Henri Jokiharju,D,BUF,25,61,7,5,12
93,8483499,Liam Ohgren,L,MIN,20,52,6,6,12
93,8478451,Ethan Bear,D,WSH,27,50,6,6,12
93,8479291,Kevin Rooney,C,CGY,31,48,6,6,12
93,8471817,Ryan Reaves,R,TOR,37,51,5,7,12
93,8482652,Walker Duehr,R,CGY,27,41,5,7,12
93,8483495,Simon Nemec,D,NJD,20,53,5,7,12
93,8479442,Troy Stecher,D,EDM,30,58,5,7,12
93,8480448,Parker Kelly,L,COL,25,74,4,8,12
93,8482166,Shakir Mukhamadullin,D,SJS,22,56,4,8,12
93,8480058,Pierre-Olivier Joseph,D,STL,25,59,4,8,12
93,8477845,Trevor van Riemsdyk,D,WSH,33,60,2,10,12
93,8481567,Henry Thrun,D,SJS,23,48,2,10,12
93,8478840,Will Borgen,D,SEA,28,61,1,11,12
93,8481059,Scott Perunovich,D,STL,26,59,0,12,12
93,8479249,Andrew Poturalski,C,SJS,30,38,0,12,12
93,8481716,Dmitri Voronkov,L,CBJ,24,46,9,2,11
93,8481013,Jonatan Berggren,R,DET,24,58,6,5,11
93,8477353,Tyler Motte,C,DET,29,73,6,5,11
93,8481550,Adam Beckman,L,NJD,23,35,6,5,11
93,8479772,Zack MacEwen,R,OTT,28,49,6,5,11
93,8482730,Brandt Clarke,D,LAK,21,52,5,6,11
93,8478424,Jansen Harkins,C,ANA,27,37,5,6,11
93,8480192,Johnathan Kovacevic,D,NJD,27,61,5,6,11
93,8482145,Mavrik Bourque,C,DAL,22,45,5,6,11
93,8480252,Cole Guttman,C,CHI,25,34,4,7,11
93,8480001,Urho Vaakanainen,D,ANA,25,64,3,8,11
93,8477034,Jaycob Megna,D,FLA,32,47,3,8,11
93,8480796,Martin Fehervary,D,WSH,25,55,3,8,11
93,8479944,Zach Aston-Reese,C,VGK,30,54,2,9,11
93,8474612,Travis Hamonic,D,OTT,34,50,2,9,11
93,8479348,Kale Clague,D,BUF,26,38,2,9,11
93,8478859,Niko Mikkola,D,FLA,28,53,2,9,11
93,8476473,Connor Murphy,D,CHI,31,48,2,9,11
93,8482155,Alex Laferriere,R,LAK,23,72,2,9,11
93,8481167,Brayden Pachal,D,CGY,25,37,1,10,11
93,8479536,Axel Jonsson-Fjallby,L,WPG,26,34,7,3,10
93,8476374,Sean Kuraly,C,CBJ,31,54,6,4,10
93,8479066,Ryan Lomberg,L,CGY,30,61,5,5,10
93,8482762,Simon Edvinsson,D,DET,21,59,5,5,10
93,8479638,Justin Brazeau,R,BOS,26,38,5,5,10
93,8476442,Matt Nieto,L,PIT,32,46,4,6,10
93,8479520,Brandon Duhaime,R,WSH,27,44,4,6,10
93,8476858,Phillip Di Giuseppe,L,VAN,31,42,4,6,10
93,8481019,David Gustafsson,C,WPG,24,45,3,7,10
93,8475179,Dmitry Kulikov,D,FLA,34,59,3,7,10
93,8483466,Kevin Korchinski,D,CHI,20,48,3,7,10
93,8482964,Arber Xhekaj,D,MTL,23,48,2,8,10
93,8480844,Grigori Denisenko,L,VGK,24,30,2,8,10
93,8480441,Trey Fix-Wolansky,R,CBJ,25,36,6,3,9
93,8482784,Zach Dean,C,STL,21,36,6,3,9
93,8479359,Beck Malenstyn,L,BUF,26,45,5,4,9
93,8483012,Logan Morrison,C,SEA,22,36,5,4,9
93,8476994,Vinnie Hinostroza,C,NSH,30,44,4,5,9
93,8480727,Zach Whitecloud,D,VGK,28,48,4,5,9
93,8481751,Lukas Rousek,R,BUF,25,35,4,5,9
93,8482659,Josh Doan,R,UTA,22,48,4,5,9
93,8476867,Brendan Gaunce,C,MIN,30,36,4,5,9
93,8478409,Anthony Richard,C,PHI,28,28,4,5,9
93,8480157,Calle Rosen,D,COL,30,49,3,6,9
93,8478421,A.J. Greer,L,FLA,28,54,3,6,9
93,8481537,Nikita Okhotiuk,D,CGY,24,47,3,6,9
93,8478017,Mark Friedman,D,VAN,29,40,3,6,9
93,8481532,Alex Turcotte,C,LAK,23,38,3,6,9
93,8478450,Parker Wotherspoon,D,BOS,27,27,3,6,9
93,8479320,Maxime Lajoie,D,SEA,27,35,3,6,9
93,8480950,Ilya Lyubushkin,D,DAL,30,62,2,7,9
93,8481605,Jackson LaCombe,D,ANA,23,37,2,7,9
93,8478454,Noah Juulsen,D,VAN,27,27,2,7,9
93,8475462,Radko Gudas,D,ANA,34,68,1,8,9
93,8481122,Simon Benoit,D,TOR,26,40,1,8,9
93,8481161,Jake Christiansen,D,CBJ,25,54,0,9,9
93,8479370,Tyson Jost,C,CAR,26,57,5,3,8
93,8481598,Philip Broberg,D,EDM,23,42,5,3,8
93,8479968,Vinni Lettieri,C,BOS,29,43,5,3,8
93,8477938,Haydn Fleury,D,WPG,28,44,4,4,8
93,8482070,Mitchell Chaffee,R,TBL,26,53,3,5,8
93,8477384,Joshua Brown,D,EDM,30,42,3,5,8
93,8480292,Carson Meyer,R,ANA,27,37,3,5,8
93,8479324,Ryan Lindgren,D,NYR,26,63,2,6,8
93,8481541,Samuel Bolduc,D,NYI,24,27,2,6,8
93,8475718,Justin Holl,D,DET,32,55,1,7,8
93,8479378,Logan Stanley,D,WPG,26,39,1,7,8
93,8484254,Akito Hirose,D,VAN,25,35,1,7,8
93,8477365,Connor Clifton,D,BUF,29,53,0,8,8
93,8481701,Santeri Hatakka,D,NJD,23,43,0,8,8
93,8484911,Collin Graf,R,SJS,22,40,5,2,7
93,8481518,Nolan Foote,L,NJD,24,38,5,2,7
93,8479379,Givani Smith,R,SJS,26,31,4,3,7
93,8481617,Vasily Podkolzin,R,VAN,23,54,3,4,7
93,8480879,Jacob Bernard-Docker,D,OTT,24,41,3,4,7
93,8480880,Jakub Lauko,C,MIN,24,33,3,4,7
93,8481592,Jakob Pelletier,L,CGY,23,37,2,5,7
93,8482747,Brennan Othmann,L,NYR,21,38,2,5,7
93,8474090,Brendan Smith,D,DAL,35,61,2,5,7
93,8479972,Mason Shaw,C,WPG,26,42,2,5,7
93,8479367,William Lockwood,R,FLA,26,30,2,5,7
93,8480860,Kevin Bahl,D,CGY,24,58,1,6,7
93,8474166,Alec Martinez,D,CHI,37,53,1,6,7
93,8475762,Derek Forbort,D,VAN,32,49,1,6,7
93,8476372,Nick Seeler,D,PHI,31,42,1,6,7
93,8482861,Vincent Iorio,D,WSH,22,32,1,6,7
93,8473446,Erik Johnson,D,PHI,36,44,0,7,7
93,8482102,Vasily Ponomarev,C,PIT,22,23,0,7,7
93,8478831,Kevin Stenlund,C,UTA,28,51,5,1,6
93,8481543,Nikita Alexandrov,C,STL,24,27,4,2,6
93,8477887,Patrick Brown,C,BOS,32,45,4,2,6
93,8481237,Kyle MacLean,C,NYI,25,30,4,2,6
93,8477482,Zachary Sanford,L,CHI,30,35,3,3,6
93,8481609,Vladislav Kolyachonok,D,UTA,23,31,3,3,6
93,8479985,Cale Fleury,D,SEA,26,34,3,3,6
93,8481147,Reese Johnson,C,MIN,26,36,3,3,6
93,8481056,Spencer Stastney,D,NSH,24,33,3,3,6
93,8476952,Dominic Toninato,C,WPG,30,28,2,4,6
93,8479981,Jonah Gadjovich,L,FLA,26,44,2,4,6
93,8480070,Ian Mitchell,D,BOS,25,48,2,4,6
93,8475235,Nicolas Deslauriers,L,PHI,33,44,2,4,6
93,8475958,Michael Sgarbossa,C,WSH,32,24,2,4,6
93,8477527,Ross Johnston,L,ANA,30,29,2,4,6
93,8478874,Adam Gaudette,R,OTT,28,28,2,4,6
93,8480834,Ty Emberson,D,SJS,24,37,1,5,6
93,8483549,Lucas Condotta,L,MTL,27,36,1,5,6
93,8475750,Jon Merrill,D,MIN,32,63,1,5,6
93,8482511,Mason Lohrei,D,BOS,23,31,1,5,6
93,8483619,Filip Roos,D,OTT,25,30,1,5,6
93,8480196,Jacob Bryson,D,BUF,27,38,1,5,6
93,8477462,Robert Hagg,D,VGK,29,34,0,6,6
93,8476441,Joel Edmundson,D,LAK,31,39,0,6,6
93,8479587,Rhett Gardner,C,PHI,28,20,0,6,6
93,8480468,James Hamblin,L,EDM,25,19,5,0,5
93,8477073,Kurtis MacDermid,L,NJD,30,29,3,2,5
93,8482765,Isak Rosen,R,BUF,21,26,3,2,5
93,8482153,Brendan Brisson,C,VGK,23,28,3,2,5
93,8483630,Pavol Regenda,L,ANA,25,25,2,3,5
93,8480245,Olle Lycksell,R,PHI,25,32,2,3,5
93,8478502,Dennis Gilbert,D,BUF,28,26,2,3,5
93,8477541,Dakota Mermis,D,TOR,30,12,2,3,5
93,8481599,Victor Soderstrom,D,UTA,23,41,1,4,5
93,8479994,Jaret Anderson-Dolan,C,WPG,25,34,1,4,5
93,8483763,Maksymilian Szuber,D,UTA,22,32,1,4,5
93,8482858,Ryker Evans,D,SEA,23,29,1,4,5
93,8482201,Gage Goncalves,C,TBL,23,33,1,4,5
93,8482177,Marat Khusnutdinov,C,MIN,22,27,1,4,5
93,8482496,Nils Aman,C,VAN,24,38,1,4,5
93,8477244,Chad Ruhwedel,D,NYR,34,36,1,4,5
93,8471677,Jack Johnson,D,CBJ,37,62,0,5,5
93,8481556,John Beecher,C,BOS,23,38,3,1,4
93,8482751,Ryan Winterton,C,SEA,21,39,3,1,4
93,8481699,Aku Raty,R,UTA,23,18,3,1,4
93,8474568,Luke Schenn,D,NSH,35,50,2,2,4
93,8483570,Ben Meyers,C,SEA,26,28,2,2,4
93,8478146,Matthew Highmore,C,OTT,28,30,2,2,4
93,8483397,Marc McLaughlin,C,BOS,25,29,2,2,4
93,8482172,Landon Slaggert,L,CHI,22,30,2,2,4
93,8482165,Yan Kuznetsov,D,CGY,22,23,2,2,4
93,8478011,Louie Belpedio,D,PHI,28,16,2,2,4
93,8482162,Roby Jarventie,L,EDM,22,9,2,2,4
93,8479419,Brett Murray,L,BUF,26,15,2,2,4
93,8481422,Jake Lucchini,C,NSH,29,20,2,2,4
93,8480007,Jonas Rondbjerg,R,VGK,25,43,1,3,4
93,8482733,Logan Mailloux,D,MTL,31,32,1,3,4
93,8474013,Ian Cole,D,UTA,35,47,1,3,4
93,8482470,Ilya Solovyov,D,CGY,24,19,1,3,4
93,8482141,Lukas Cormier,D,VGK,22,31,1,3,4
93,8482144,Jack Thompson,D,SJS,22,26,1,3,4
93,8477971,Andreas Englund,D,LAK,28,26,1,3,4
93,8478021,William Lagesson,D,DET,28,26,1,3,4
93,8479362,Riley Tufte,L,BOS,26,24,1,3,4
93,8480845,Rasmus Kupari,C,WPG,24,35,3,0,3
93,8481789,Tye Kartye,L,SEA,23,36,3,0,3
93,8484258,Sam Malinski,D,COL,26,26,2,1,3
93,8480267,Sammy Walker,C,MIN,25,20,2,1,3
93,8479991,Jake Leschyshyn,C,NYR,25,24,2,1,3
93,8482147,Jean-Luc Foudy,C,COL,22,20,2,1,3
93,8477320,Anton Blidh,L,NYR,29,17,2,1,3
93,8477401,John Hayden,C,SEA,29,27,1,2,3
93,8479576,Vincent Desharnais,D,VAN,28,34,1,2,3
93,8481719,Maxwell Crozier,D,TBL,24,22,1,2,3
93,8483512,Matthew Savoie,C,EDM,20,23,1,2,3
93,8475795,Dylan McIlrath,D,WSH,32,17,1,2,3
93,8481679,Maxence Guenette,D,OTT,23,30,0,3,3
93,8477335,Kyle Burroughs,D,LAK,29,42,0,3,3
93,8476913,Devin Shore,C,MIN,30,31,0,3,3
93,8477149,Scott Sabourin,R,SJS,32,11,0,3,3
93,8481743,Marc Del Gaizo,D,NSH,25,19,0,3,3
93,8480306,Grant Hutton,D,NYI,29,4,0,3,3
93,8484287,Cole McWard,D,VAN,23,23,2,0,2
93,8480890,Jan Jenik,C,OTT,24,27,2,0,2
93,8480870,Bo Groulx,C,NYR,24,29,2,0,2
93,8475780,Chris Wagner,R,COL,33,13,2,0,2
93,8478477,Mitchell Stephens,C,SEA,27,13,1,1,2
93,8484325,Waltteri Merela,C,TBL,26,12,1,1,2
93,8482787,Nikita Chibrikov,R,WPG,31,6,1,1,2
93,8481462,Mason Morelli,L,VGK,28,11,1,1,2
93,8474062,Riley Nash,C,NYR,35,14,1,1,2
93,8481024,Linus Karlsson,C,VAN,25,11,1,1,2
93,8480823,Alexander Alexeyev,D,WSH,25,13,1,1,2
93,8482713,Mackie Samoskevich,R,FLA,22,29,0,2,2
93,8482250,Callahan Burke,C,VGK,27,28,0,2,2
93,8482929,Emil Lilleberg,D,TBL,23,24,0,2,2
93,8481006,Tyler Tucker,D,STL,24,16,0,2,2
93,8477810,Joel Hanley,D,CGY,33,24,0,2,2
93,8480084,Nick DeSimone,D,NJD,30,15,0,2,2
93,8483395,Arshdeep Bains,L,VAN,23,7,0,2,2
93,8475413,Justin Dowling,C,NJD,34,20,0,2,2
93,8482061,Brandon Biro,L,SEA,26,8,1,0,1
93,8481585,Egor Afanasyev,L,SJS,23,18,1,0,1
93,8481043,Cole Koepke,L,BOS,26,16,1,0,1
93,8480075,Cameron Crotty,D,MIN,25,11,1,0,1
93,8483567,Georgii Merkulov,C,BOS,24,13,1,0,1
93,8483920,Pierrick Dube,R,WSH,23,3,1,0,1
93,8479330,Brandon Gignac,C,MTL,27,7,1,0,1
93,8483597,Milos Kelemen,L,UTA,25,5,1,0,1
93,8482126,Emil Andrae,D,PHI,31,5,1,0,1
93,8481578,Graeme Clarke,R,MIN,23,12,0,1,1
93,8482516,Matthew Kessel,D,STL,24,17,0,1,1
93,8477473,Justin Bailey,R,SJS,29,18,0,1,1
93,8481593,Jayden Struble,D,MTL,23,18,0,1,1
93,8482118,Sam Colangelo,R,ANA,23,19,0,1,1
93,8481806,Louis Crevier,D,CHI,23,11,0,1,1
93,8480032,Shane Bowers,C,NJD,25,13,0,1,1
93,8483489,Fraser Minten,C,TOR,31,12,0,1,1
93,8478051,Max Willman,C,NJD,29,21,0,1,1
93,8475755,Alexander Petrovic,D,DAL,32,6,0,1,1
93,8483471,Brad Lambert,C,WPG,31,8,0,1,1
93,8482460,Matt Rempe,C,NYR,22,8,0,1,1
93,8480874,Adam Ginning,D,PHI,24,10,0,1,1
93,8478446,Glenn Gawdin,C,LAK,27,6,0,1,1
93,8483546,Marshall Rifai,D,TOR,26,5,0,1,1
93,8482197,Adam Raska,R,MIN,23,5,0,1,1
93,8481726,Adam Edstrom,C,NYR,24,11,0,1,1
93,8477467,Gustav Olofsson,D,SEA,30,12,0,0,0
93,8481065,Angus Crookshank,L,OTT,25,18,0,0,0
93,8480851,Akil Thomas,C,LAK,24,22,0,0,0
93,8482094,Daemon Hunt,D,MIN,22,14,0,0,0
93,8482088,Justin Sourdif,R,FLA,22,17,0,0,0
93,8479421,Jacob Moverare,D,LAK,26,8,0,0,0
93,8481564,Ryan Johnson,D,BUF,23,11,0,0,0
93,8481206,John Ludvig,D,PIT,24,10,0,0,0
93,8483398,Declan Carlile,D,TBL,31,2,0,0,0
93,8483407,Brandon Scanlin,D,NYR,25,4,0,0,0
93,8481030,Jack St. Ivany,D,PIT,25,18,0,0,0
93,8484304,Uvis Balinskis,D,FLA,28,5,0,0,0
93,8478881,Brett Seney,L,CHI,28,10,0,0,0
93,8481655,Cole Schwindt,R,CGY,23,1,0,0,0
93,8478854,Ryan Shea,D,PIT,27,4,0,0,0
93,8484255,Jason Polin,R,COL,25,5,0,0,0
93,8477993,Justin Kirkland,C,CGY,28,2,0,0,0
93,8483609,Adam Klapka,R,CGY,24,8,0,0,0
93,8476323,Max McCormick,L,SEA,32,5,0,0,0
93,8481534,Raphael Lavoie,C,EDM,24,1,0,0,0
93,8478147,Bokondji Imama,L,PIT,28,5,0,0,0
93,8484321,Nikolas Matinpalo,D,OTT,26,2,0,0,0
93,8483432,Luca Del Bel Belluz,C,CBJ,31,10,0,0,0
93,8482476,Emil Heineman,L,MTL,23,6,0,0,0
93,8483401,Marc Johnstone,R,PIT,28,0,0,0,0
93,8479522,Hardy Haman Aktell,D,WSH,26,0,0,0,0
93,8484326,Patrik Koch,D,UTA,28,4,0,0,0
93,8483531,Brian Halonen,L,NJD,25,3,0,0,0
93,8478956,Samuel Laberge,L,NJD,27,1,0,0,0
93,8480274,Philip Kemp,D,EDM,25,0,0,0,0
93,8484259,Ondrej Pavel,C,COL,31,2,0,0,0
93,8470794,Joe Pavelski,C,,40,0,0,0,0
93,8479321,Lucas Johansen,D,,27,0,0,0,0
93,8477950,Tony DeAngelo,D,,29,0,0,0,0
93,8471218,Blake Wheeler,R,,38,0,0,0,0
93,8475197,Tyson Barrie,D,,33,0,0,0,0
93,8474157,Max Pacioretty,L,,36,0,0,0,0
93,8475744,Evgeny Kuznetsov,C,,32,0,0,0,0
93,8474037,James van Riemsdyk,L,,35,0,0,0,0
93,8476907,Mackenzie MacEachern,L,,30,0,0,0,0
93,8480216,Jacob Peterson,C,,25,0,0,0,0
93,8474602,Justin Schultz,D,,34,0,0,0,0
93,8482222,Alexander Barabanov,L,,30,0,0,0,0
93,8474031,Kevin Shattenkirk,D,,35,0,0,0,0
93,8477330,Dominik Kubalik,L,,29,0,0,0,0
93,8480884,Calen Addison,D,,24,0,0,0,0
93,8475906,John Klingberg,D,,32,0,0,0,0
93,8480008,Adam Ruzicka,C,,25,0,0,0,0
93,8476884,Derrick Pouliot,D,,30,0,0,0,0
93,8476919,Chris Tierney,C,,30,0,0,0,0
93,8479415,Michael McLeod,C,,26,0,0,0,0
93,8474870,Tyler Johnson,C,,34,0,0,0,0
93,8470604,Jeff Carter,C,,39,0,0,0,0
93,8478104,Sammy Blais,L,,28,0,0,0,0
93,8474884,Mike Hoffman,C,,35,0,0,0,0
93,8481591,Sam Poulin,R,,23,0,0,0,0
93,8471274,Alex Goligoski,D,,39,0,0,0,0
93,8476871,Tanner Pearson,L,,32,0,0,0,0
93,8476393,Nick Cousins,C,,31,0,0,0,0
93,8479977,Kailer Yamamoto,R,,26,0,0,0,0
93,8479346,Dillon Dube,C,,26,0,0,0,0
93,8480184,Gustav Lindstrom,D,,26,0,0,0,0
93,8479376,Victor Mete,D,,26,0,0,0,0
93,8473449,Kyle Okposo,R,,36,0,0,0,0
93,8481058,Jesse Ylonen,R,,25,0,0,0,0
93,8475752,Tyler Pitlick,C,,33,0,0,0,0
93,8481239,Samuel Fagemo,L,,24,0,0,0,0
93,8480821,Filip Zadina,R,,25,0,0,0,0
93,8470966,Mark Giordano,D,,41,0,0,0,0
93,8478495,Denis Gurianov,R,,27,0,0,0,0
93,8477464,Nic Petan,C,,29,0,0,0,0
93,8478099,Kevin Labanc,R,,29,0,0,0,0
93,8482241,Radim Zohorna,L,,28,0,0,0,0
93,8474040,Sam Gagner,C,,35,0,0,0,0
93,8479514,Rem Pitlick,C,,27,0,0,0,0
93,8478430,Oliver Kylington,D,,27,0,0,0,0
93,8479533,Joona Koppanen,L,,26,0,0,0,0
93,8479984,Cal Foote,D,,26,0,0,0,0
93,8477126,Jayson Megna,C,,34,0,0,0,0
93,8475164,Jakob Silfverberg,R,,34,0,0,0,0
93,8474009,Nick Bonino,C,,36,0,0,0,0
93,8479458,Nikita Zaitsev,D,,33,0,0,0,0
93,8477944,Jakub Vrana,L,,28,0,0,0,0
93,8471699,Andrew Cogliano,C,,37,0,0,0,0
93,8478067,Oskar Lindblom,L,,28,0,0,0,0
93,8471686,Marc Staal,D,,37,0,0,0,0
93,8470610,Zach Parise,L,,40,0,0,0,0
93,8478904,Steven Lorentz,C,,28,0,0,0,0
93,8473473,Milan Lucic,L,,36,0,0,0,0
93,8480031,Maxime Comtois,L,,25,0,0,0,0
93,8478512,Austin Czarnik,C,,32,0,0,0,0
93,8473504,Cal Clutterbuck,R,,37,0,0,0,0
93,8477454,Adam Erne,L,,29,0,0,0,0
93,8479383,Boris Katchouk,L,,26,0,0,0,0
93,8475825,Jani Hakanpää,D,,32,0,0,0,0
93,8477846,Ryan Carpenter,C,,33,0,0,0,0
93,8477930,Pierre-Edouard Bellemare,L,,39,0,0,0,0
93,8478400,Colin White,C,,27,0,0,0,0
93,8480226,Marián Studenic,R,,26,0,0,0,0
93,8480853,Liam Foudy,C,,24,0,0,0,0
93,8475797,Jarred Tinordi,D,,32,0,0,0,0
93,8479423,Alex Nylander,L,,26,0,0,0,0
93,8474618,Marco Scandella,D,,34,0,0,0,0
93,8478028,Fredrik Olofsson,L,,28,0,0,0,0
93,8474709,Matt Martin,L,,35,0,0,0,0
93,8481070,Hugh McGing,L,,26,0,0,0,0
93,8479546,Oskar Steen,C,,26,0,0,0,0
93,8474145,Robert Bortuzzo,D,,35,0,0,0,0
93,8476915,Jujhar Khaira,L,,30,0,0,0,0
93,8475278,Byron Froese,C,,33,0,0,0,0
93,8481812,Nikolai Knyzhov,D,,27,0,0,0,0
93,8478408,Travis Dermott,D,,28,0,0,0,0
93,8481077,John Leonard,L,,26,0,0,0,0
93,8479547,Matthew Phillips,R,,26,0,0,0,0
93,8480836,Jonathan Gruden,C,,24,0,0,0,0
93,8481690,Tyler Angle,C,,24,0,0,0,0
93,8475766,Austin Watson,L,,32,0,0,0,0
93,8481016,Ruslan Iskhakov,C,,24,0,0,0,0
93,8478078,Rourke Chartier,C,,28,0,0,0,0
93,8480776,Sheldon Rempal,R,,29,0,0,0,0
93,8483045,Cameron Butler,R,CBJ,31,0,0,0,0
93,8484314,Jiri Smejkal,L,,28,0,0,0,0
94,8478402,Connor McDavid,C,EDM,27,80,49,111,160
94,8477492,Nathan MacKinnon,C,COL,29,82,57,93,150
94,8477956,David Pastrnak,R,BOS,28,79,63,51,114
94,8476453,Nikita Kucherov,R,TBL,31,82,38,76,114
94,8479314,Matthew Tkachuk,L,FLA,27,82,32,76,108
94,8477934,Leon Draisaitl,C,EDM,29,80,41,65,106
94,8477939,William Nylander,R,TOR,28,80,43,53,96
94,8478420,Mikko Rantanen,R,COL,28,82,35,61,96
94,8479318,Auston Matthews,C,TOR,27,81,47,48,95
94,8477493,Aleksander Barkov,C,FLA,29,79,29,66,95
94,8480027,Jason Robertson,L,DAL,25,81,36,57,93
94,8478550,Artemi Panarin,L,NYR,33,79,23,70,93
94,8477404,Jake Guentzel,C,TBL,30,82,42,47,89
94,8478439,Travis Konecny,R,PHI,27,78,33,56,89
94,8479407,Jesper Bratt,L,NJD,26,74,28,61,89
94,8479323,Adam Fox,D,NYR,26,79,22,67,89
94,8475172,Nazem Kadri,C,CGY,34,80,30,58,88
94,8481559,Jack Hughes,C,NJD,23,74,38,48,86
94,8476389,Vincent Trocheck,C,NYR,31,74,31,55,86
94,8478398,Kyle Connor,L,WPG,28,74,37,48,85
94,8480801,Brady Tkachuk,L,OTT,25,77,41,43,84
94,8475726,Tyler Toffoli,C,SJS,32,76,35,49,84
94,8482116,Tim Stützle,C,OTT,22,82,25,59,84
94,8480012,Elias Pettersson,C,VAN,26,75,37,46,83
94,8475913,Mark Stone,R,VGK,32,80,33,50,83
94,8484144,Connor Bedard,C,CHI,19,72,32,51,83
94,8476468,J.T. Miller,C,VAN,31,76,31,52,83
94,8479385,Jordan Kyrou,C,STL,26,74,31,51,82
94,8471675,Sidney Crosby,C,PIT,37,70,40,41,81
94,8478010,Brayden Point,C,TBL,28,81,40,41,81
94,8481557,Matt Boldy,L,MIN,23,75,36,45,81
94,8480002,Nico Hischier,C,NJD,25,75,28,53,81
94,8477496,Elias Lindholm,C,BOS,30,78,26,55,81
94,8478449,Roope Hintz,C,DAL,28,82,42,38,80
94,8475786,Zach Hyman,L,EDM,32,77,39,41,80
94,8475754,Brock Nelson,C,NYI,33,81,38,42,80
94,8478403,Jack Eichel,C,VGK,28,79,36,44,80
94,8478483,Mitch Marner,R,TOR,27,82,25,55,80
94,8480023,Robert Thomas,C,STL,25,69,17,63,80
94,8480036,Miro Heiskanen,D,DAL,25,76,13,67,80
94,8477933,Sam Reinhart,C,FLA,29,80,45,34,79
94,8478414,Timo Meier,R,NJD,28,74,39,40,79
94,8479343,Clayton Keller,R,UTA,26,74,35,44,79
94,8477946,Dylan Larkin,C,DET,28,80,36,41,77
94,8478444,Brock Boeser,R,VAN,27,73,38,38,76
94,8476460,Mark Scheifele,C,WPG,31,73,37,39,76
94,8477409,Carter Verhaeghe,C,FLA,29,78,29,47,76
94,8477942,Kevin Fiala,L,LAK,28,81,23,53,76
94,8478445,Mathew Barzal,C,NYI,27,79,21,55,76
94,8480069,Cale Makar,D,COL,26,65,18,58,76
94,8474564,Steven Stamkos,C,NSH,34,78,29,46,75
94,8475168,Matt Duchene,C,DAL,33,82,27,47,74
94,8481540,Cole Caufield,R,MTL,23,79,31,42,73
94,8478864,Kirill Kaprizov,L,MIN,27,71,27,46,73
94,8480800,Quinn Hughes,D,VAN,25,69,9,63,72
94,8479420,Tage Thompson,C,BUF,27,76,45,26,71
94,8476887,Filip Forsberg,L,NSH,30,76,32,39,71
94,8478440,Dylan Strome,C,WSH,27,73,25,45,70
94,8476459,Mika Zibanejad,C,NYR,31,80,20,50,70
94,8474600,Roman Josi,D,NSH,34,74,16,54,70
94,8475166,John Tavares,C,TOR,34,81,36,33,69
94,8478427,Sebastian Aho,C,CAR,27,65,34,35,69
94,8473419,Brad Marchand,L,BOS,36,80,30,39,69
94,8476905,Chandler Stephenson,C,SEA,30,79,24,45,69
94,8474141,Patrick Kane,R,DET,36,82,21,48,69
94,8480015,Owen Tippett,R,PHI,25,75,32,36,68
94,8476454,Ryan Nugent-Hopkins,C,EDM,31,80,23,45,68
94,8477951,Nick Schmaltz,C,UTA,28,75,21,47,68
94,8474586,Jordan Eberle,R,SEA,34,74,21,47,68
94,8480830,Andrei Svechnikov,R,CAR,24,69,20,48,68
94,8475184,Chris Kreider,L,NYR,33,77,41,26,67
94,8477476,Artturi Lehkonen,L,COL,29,81,38,29,67
94,8482740,Wyatt Johnston,C,DAL,21,82,36,31,67
94,8471215,Evgeni Malkin,C,PIT,38,77,30,37,67
94,8475692,Mats Zuccarello,R,MIN,37,68,17,50,67
94,8475784,Jeff Skinner,C,EDM,32,75,34,32,66
94,8477940,Nikolaj Ehlers,L,WPG,28,72,32,34,66
94,8471214,Alex Ovechkin,L,WSH,39,78,29,37,66
94,8481711,Matias Maccelli,L,UTA,24,74,15,51,66
94,8478407,Vince Dunn,D,SEA,28,72,13,53,66
94,8480865,Noah Dobson,D,NYI,24,80,12,54,66
94,8476539,Jonathan Marchessault,R,NSH,34,74,37,28,65
94,8477402,Pavel Buchnevich,L,STL,29,74,31,34,65
94,8477501,Valeri Nichushkin,R,COL,29,82,26,39,65
94,8482078,Lucas Raymond,L,DET,22,78,24,41,65
94,8477504,Josh Morrissey,D,WPG,29,74,19,46,65
94,8475798,Mikael Granlund,C,SJS,32,71,19,46,65
94,8480803,Evan Bouchard,D,EDM,25,74,10,55,65
94,8476881,Tomas Hertl,C,VGK,31,76,25,39,64
94,8473512,Claude Giroux,R,OTT,36,79,20,44,64
94,8476346,Johnny Gaudreau,L,CBJ,31,73,15,49,64
94,8475167,Victor Hedman,D,TBL,34,80,15,49,64
94,8479542,Brandon Hagel,L,TBL,26,82,34,29,63
94,8476479,Phillip Danault,C,LAK,31,81,27,36,63
94,8479337,Alex DeBrincat,R,DET,27,80,26,37,63
94,8476456,Jonathan Huberdeau,C,CGY,31,80,17,46,63
94,8480039,Martin Necas,C,CAR,25,76,27,35,62
94,8475158,Ryan O'Reilly,C,NSH,33,77,23,39,62
94,8478460,Zach Werenski,D,CBJ,27,81,15,47,62
94,8484153,Leo Carlsson,C,ANA,20,71,25,36,61
94,8471685,Anze Kopitar,C,LAK,37,81,16,45,61
94,8477447,Shea Theodore,D,VGK,29,65,14,47,61
94,8474578,Erik Karlsson,D,PIT,34,79,7,54,61
94,8482665,Matty Beniers,C,SEA,22,76,24,36,60
94,8477949,Alex Tuch,R,BUF,28,70,21,39,60
94,8477500,Bo Horvat,C,NYI,29,77,32,27,59
94,8477960,Adrian Kempe,R,LAK,28,82,28,31,59
94,8476448,William Karlsson,C,VGK,31,78,27,32,59
94,8475765,Vladimir Tarasenko,R,DET,33,82,26,33,59
94,8481533,Trevor Zegras,C,ANA,23,71,23,36,59
94,8474150,Mikael Backlund,C,CGY,35,82,19,40,59
94,8480839,Rasmus Dahlin,D,BUF,24,73,12,47,59
94,8479675,Trevor Moore,L,LAK,29,79,29,29,58
94,8481068,Yegor Sharangovich,C,CGY,26,77,28,30,58
94,8474102,David Perron,L,OTT,36,79,25,33,58
94,8474679,Gustav Nyquist,C,NSH,35,72,20,38,58
94,8473994,Jamie Benn,L,DAL,35,80,17,41,58
94,8480064,Josh Norris,C,OTT,25,73,34,23,57
94,8480188,Fabian Zetterlund,L,SJS,25,73,28,29,57
94,8483431,Logan Cooley,C,UTA,20,78,27,30,57
94,8479400,Pierre-Luc Dubois,L,WSH,26,73,24,33,57
94,8478873,Troy Terry,R,ANA,27,73,20,37,57
94,8478493,Joel Eriksson Ek,C,MIN,27,70,25,31,56
94,8477935,Sam Bennett,C,FLA,28,80,33,22,55
94,8478366,Frank Vatrano,R,ANA,30,75,32,23,55
94,8477407,Anthony Duclair,L,NYI,29,76,28,27,55
94,8478401,Pavel Zacha,C,BOS,27,72,25,30,55
94,8478519,Anthony Cirelli,C,TBL,27,82,21,34,55
94,8482745,Mason McTavish,C,ANA,21,71,20,35,55
94,8477346,MacKenzie Weegar,D,CGY,30,75,17,38,55
94,8480018,Nick Suzuki,C,MTL,25,73,23,31,54
94,8480028,Morgan Frost,C,PHI,25,72,19,35,54
94,8480208,Drake Batherson,R,OTT,26,79,18,36,54
94,8479999,Casey Mittelstadt,C,COL,26,82,17,37,54
94,8474590,John Carlson,D,WSH,34,66,12,42,54
94,8482684,Luke Hughes,D,NJD,21,70,9,45,54
94,8476853,Morgan Rielly,D,TOR,30,71,3,51,54
94,8475810,Bryan Rust,R,PIT,32,75,30,23,53
94,8481618,Alex Newhook,C,MTL,23,75,23,30,53
94,8478438,Tommy Novak,C,NSH,27,72,16,37,53
94,8478498,Jake DeBrusk,L,VAN,28,69,33,19,52
94,8477451,Ryan Hartman,R,MIN,30,69,28,24,52
94,8477955,Jared McCann,L,SEA,28,70,26,26,52
94,8481528,Dylan Cozens,C,BUF,23,66,24,28,52
94,8479339,Patrik Laine,L,CBJ,26,70,23,29,52
94,8477986,Brandon Montour,D,SEA,30,76,19,33,52
94,8477932,Aaron Ekblad,D,FLA,28,68,13,39,52
94,8475794,Tyler Seguin,C,DAL,32,81,25,26,51
94,8480014,Gabriel Vilardi,C,WPG,25,66,23,28,51
94,8484166,Adam Fantilli,C,CBJ,20,72,20,31,51
94,8478046,Danton Heinen,L,VAN,29,71,19,32,51
94,8478856,Conor Garland,R,VAN,28,71,16,35,51
94,8482097,Jack Quinn,R,BUF,23,64,15,35,50
94,8474563,Drew Doughty,D,LAK,35,72,13,37,50
94,8479325,Charlie McAvoy,D,BOS,27,73,7,43,50
94,8478975,Mason Marchment,L,DAL,29,78,25,24,49
94,8481596,Shane Pinto,C,OTT,24,72,20,29,49
94,8480797,Joel Farabee,L,PHI,24,78,20,29,49
94,8475287,Erik Haula,L,NJD,33,73,20,29,49
94,8477416,Oliver Bjorkstrand,R,SEA,29,74,18,31,49
94,8478038,Devon Toews,D,COL,30,72,12,37,49
94,8471724,Kris Letang,D,PIT,37,79,8,41,49
94,8478397,Rasmus Andersson,D,CGY,28,73,6,43,49
94,8476432,Boone Jenner,C,CBJ,31,71,29,19,48
94,8476399,Blake Coleman,C,CGY,33,73,25,23,48
94,8483808,Andrei Kuzmenko,L,CGY,28,78,20,28,48
94,8475191,Reilly Smith,R,NYR,33,71,20,28,48
94,8475745,Charlie Coyle,C,BOS,32,77,18,30,48
94,8477503,Max Domi,C,TOR,29,77,17,31,48
94,8476458,Ryan Strome,C,ANA,31,68,17,31,48
94,8478469,Thomas Chabot,D,OTT,27,77,12,36,48
94,8476875,Mike Matheson,D,MTL,30,77,8,40,48
94,8475169,Evander Kane,L,EDM,33,73,26,21,47
94,8482110,Dawson Mercer,C,NJD,23,74,26,21,47
94,8476438,Brandon Saad,L,STL,32,71,23,24,47
94,8482113,Anton Lundell,C,FLA,23,76,21,26,47
94,8478542,Evan Rodrigues,C,FLA,31,72,21,26,47
94,8477494,Jonathan Drouin,L,COL,29,79,19,28,47
94,8478042,Viktor Arvidsson,L,EDM,31,73,19,28,47
94,8478047,Michael Bunting,L,PIT,29,70,18,29,47
94,8478055,Gustav Forsling,D,FLA,28,73,12,35,47
94,8477495,Seth Jones,D,CHI,30,70,12,35,47
94,8478396,Noah Hanifin,D,VGK,27,63,12,35,47
94,8479525,Ross Colton,C,COL,28,80,24,22,46
94,8476880,Tom Wilson,R,WSH,30,68,24,22,46
94,8477511,Anthony Mantha,R,CGY,30,77,21,25,46
94,8473986,Alex Killorn,L,ANA,35,73,18,28,46
94,8476882,Teuvo Teravainen,C,CHI,30,64,17,29,46
94,8482093,Seth Jarvis,C,CAR,22,70,23,22,45
94,8477953,Kasperi Kapanen,R,STL,28,73,22,23,45
94,8482124,Quinton Byfield,R,LAK,22,78,17,28,45
94,8477479,Tyler Bertuzzi,L,CHI,29,68,23,21,44
94,8481604,Pavel Dorofeyev,L,VGK,24,66,23,21,44
94,8477497,Sean Monahan,C,CBJ,30,70,20,24,44
94,8475170,Brayden Schenn,C,STL,33,74,18,26,44
94,8478474,Lawson Crouse,L,UTA,27,79,18,26,44
94,8476921,Jordan Martinook,L,CAR,32,64,17,27,44
94,8479591,Michael Eyssimont,C,TBL,28,82,15,29,44
94,8478466,Daniel Sprong,R,VAN,27,72,15,29,44
94,8476872,Scott Laughton,C,PHI,30,70,14,30,44
94,8480145,Neal Pionk,D,WPG,29,71,13,31,44
94,8479410,Mikhail Sergachev,D,UTA,26,69,9,35,44
94,8476958,Jaccob Slavin,D,CAR,30,78,2,42,44
94,8477426,Nicholas Paul,L,TBL,29,82,23,20,43
94,8482159,Tyson Foerster,R,PHI,22,77,18,25,43
94,8481581,Thomas Harley,D,DAL,23,75,13,30,43
94,8479987,Morgan Geekie,C,BOS,26,81,13,30,43
94,8479425,Filip Hronek,D,VAN,27,75,8,35,43
94,8474641,Adam Henrique,C,EDM,34,70,27,15,42
94,8477456,J.T. Compher,L,DET,29,80,22,20,42
94,8482092,Ridly Greig,C,OTT,22,78,22,20,42
94,8482667,William Eklund,L,SJS,22,64,21,21,42
94,8474149,Evgenii Dadonov,R,DAL,35,80,20,22,42
94,8481186,Logan O'Connor,R,COL,28,80,19,23,42
94,8482660,Kent Johnson,C,CBJ,22,69,19,23,42
94,8482475,Yegor Chinakhov,R,CBJ,23,64,17,25,42
94,8482149,Cole Perfetti,C,WPG,22,71,15,27,42
94,8480220,Noah Cates,L,PHI,25,74,9,33,42
94,8475764,Cam Fowler,D,ANA,33,71,4,38,42
94,8482699,Dylan Guenther,R,UTA,21,78,20,21,41
94,8480849,Barrett Hayton,C,UTA,24,72,20,21,41
94,8483515,Juraj Slafkovsky,L,MTL,20,76,19,22,41
94,8477964,Ivan Barbashev,C,VGK,29,74,17,24,41
94,8478462,Nicolas Roy,C,VGK,27,81,17,24,41
94,8475151,Kyle Palmieri,C,NYI,33,79,16,25,41
94,8482105,Jake Sanderson,D,OTT,22,70,9,32,41
94,8481542,Moritz Seider,D,DET,23,76,8,33,41
94,8482109,Alexis Lafrenière,L,NYR,23,72,21,19,40
94,8475760,Nick Bjugstad,C,UTA,32,72,19,21,40
94,8482175,JJ Peterka,R,BUF,22,69,18,22,40
94,8475768,Jaden Schwartz,C,SEA,32,67,17,23,40
94,8480113,Alex Iafallo,L,WPG,31,66,17,23,40
94,8478891,Mason Appleton,C,WPG,28,69,16,24,40
94,8477021,Alex Kerfoot,C,UTA,30,71,14,26,40
94,8482720,Matthew Knies,L,TOR,22,74,13,27,40
94,8474565,Alex Pietrangelo,D,VGK,34,65,7,33,40
94,8476483,Rickard Rakell,R,PIT,31,70,18,21,39
94,8477444,Andre Burakovsky,L,SEA,29,75,18,21,39
94,8481524,Bowen Byram,D,BUF,23,71,15,24,39
94,8481577,Philip Tomasino,C,NSH,23,67,14,25,39
94,8481523,Kirby Dach,C,MTL,23,70,12,27,39
94,8480434,Sean Durzi,D,UTA,26,79,10,29,39
94,8482671,Owen Power,D,BUF,22,69,7,32,39
94,8475314,Anders Lee,L,NYI,34,78,21,17,38
94,8480829,Jesperi Kotkaniemi,C,CAR,24,66,15,23,38
94,8482146,Luke Evangelista,R,NSH,22,68,15,23,38
94,8478115,Pierre Engvall,L,NYI,28,79,13,25,38
94,8476792,Torey Krug,D,STL,33,74,9,29,38
94,8480871,Adam Boqvist,D,FLA,24,69,9,29,38
94,8476462,Dougie Hamilton,D,NJD,31,74,7,31,38
94,8474053,Logan Couture,C,SJS,35,57,14,23,37
94,8476419,Jean-Gabriel Pageau,C,NYI,32,78,13,24,37
94,8477429,Andrew Copp,C,DET,30,78,13,24,37
94,8475714,Calle Jarnkrok,C,TOR,33,72,12,25,37
94,8480798,Philipp Kurashev,C,CHI,25,62,12,25,37
94,8479345,Jakob Chychrun,D,WSH,26,66,11,26,37
94,8482705,Cole Sillinger,C,CBJ,21,67,11,26,37
94,8476927,Teddy Blueger,C,VAN,30,73,10,27,37
94,8476331,Dylan DeMelo,D,WPG,31,68,7,30,37
94,8475799,Nino Niederreiter,R,WPG,32,69,21,15,36
94,8476461,Sean Couturier,C,PHI,32,70,17,19,36
94,8480068,Ryan Poehling,C,PHI,25,72,14,22,36
94,8482122,Brock Faber,D,MIN,22,79,6,30,36
94,8481582,Nicholas Robertson,L,TOR,23,69,20,15,35
94,8475848,Brendan Gallagher,R,MTL,32,72,19,16,35
94,8480185,Eetu Luostarinen,C,FLA,26,79,19,16,35
94,8476474,Stefan Noesen,R,NJD,31,67,17,18,35
94,8478458,John (Jack) Roslovic,C,CAR,27,69,17,18,35
94,8481560,Arthur Kaliyev,R,LAK,23,77,16,19,35
94,8473533,Jordan Staal,C,CAR,36,59,15,20,35
94,8475793,Ryan Johansen,C,PHI,32,76,15,20,35
94,8481553,Bobby Brink,R,PHI,23,61,14,21,35
94,8476869,Brady Skjei,D,NSH,30,72,10,25,35
94,8482101,Danil Gushchin,L,SJS,22,59,10,25,35
94,8477948,Travis Sanheim,D,PHI,28,71,7,28,35
94,8476906,Shayne Gostisbehere,D,CAR,31,77,6,29,35
94,8480078,Filip Chytil,C,NYR,25,69,17,17,34
94,8481554,Kaapo Kakko,R,NYR,23,70,16,18,34
94,8475149,Marcus Johansson,L,MIN,34,61,12,22,34
94,8476826,Yanni Gourde,C,SEA,33,64,11,23,34
94,8475218,Mattias Ekholm,D,EDM,34,75,7,27,34
94,8476392,Adam Lowry,C,WPG,31,69,7,27,34
94,8473422,Nick Foligno,L,CHI,37,52,19,14,33
94,8471698,T.J. Oshie,R,WSH,38,67,16,17,33
94,8482702,Logan Stankoven,C,DAL,21,78,15,18,33
94,8475753,Justin Faulk,D,STL,32,69,13,20,33
94,8476979,Erik Gustafsson,D,DET,32,77,7,26,33
94,8476854,Hampus Lindholm,D,BOS,30,78,4,29,33
94,8482655,Janis Moser,D,TBL,24,77,1,32,33
94,8470621,Corey Perry,R,EDM,39,71,16,16,32
94,8484145,Zach Benson,L,BUF,19,68,14,18,32
94,8478413,Jordan Greenway,L,BUF,27,68,14,18,32
94,8478472,Mathieu Joseph,R,STL,27,72,13,19,32
94,8478057,Dakota Joshua,C,VAN,28,69,13,19,32
94,8477498,Darnell Nurse,D,EDM,29,79,10,22,32
94,8483524,Shane Wright,C,SEA,20,58,10,22,32
94,8476292,Ondrej Palat,L,NJD,33,63,9,23,32
94,8474716,Jared Spurgeon,D,MIN,35,79,9,23,32
94,8476892,Colton Parayko,D,STL,31,74,9,23,32
94,8483490,Pavel Mintyukov,D,ANA,21,71,9,23,32
94,8476923,Damon Severson,D,CBJ,30,81,6,26,32
94,8477488,Brett Pesce,D,NJD,30,68,5,27,32
94,8479992,Michael Rasmussen,C,DET,25,79,15,16,31
94,8480009,Eeli Tolvanen,R,SEA,25,68,14,17,31
94,8479365,Trent Frederic,C,BOS,26,74,13,18,31
94,8476480,Vladislav Namestnikov,C,WPG,32,60,11,20,31
94,8484203,Bradly Nadeau,L,CAR,19,63,11,20,31
94,8475231,Casey Cizikas,C,NYI,33,72,10,21,31
94,8482133,Thomas Bordeleau,C,SJS,22,53,9,22,31
94,8476902,Esa Lindell,D,DAL,30,76,7,24,31
94,8482089,Jake Neighbours,L,STL,22,67,23,7,30
94,8477952,Robby Fabbri,C,ANA,28,66,17,13,30
94,8482055,Drew O'Connor,L,PIT,26,58,17,13,30
94,8478013,Jake Walman,D,SJS,28,70,13,17,30
94,8480817,K'Andre Miller,D,NYR,24,70,4,26,30
94,8478020,Michael Amadio,R,OTT,28,78,15,14,29
94,8475193,Tomas Tatar,L,NJD,34,61,12,17,29
94,8478133,Jake Evans,C,MTL,28,62,10,19,29
94,8480336,Sean Walker,D,CAR,30,74,10,19,29
94,8481656,Aliaksei Protas,C,WSH,23,67,9,20,29
94,8476463,Jonas Brodin,D,MIN,31,77,8,21,29
94,8480043,Timothy Liljegren,D,TOR,25,68,3,26,29
94,8474715,Cameron Atkinson,R,TBL,35,80,16,12,28
94,8478508,Yakov Trenin,C,MIN,27,67,16,12,28
94,8478109,Victor Olofsson,L,VGK,29,72,15,13,28
94,8477505,Alexander Wennberg,C,SJS,30,64,10,18,28
94,8476960,Andreas Athanasiou,C,CHI,30,55,10,18,28
94,8481481,Blake Lizotte,C,PIT,27,69,9,19,28
94,8480873,Rasmus Sandin,D,WSH,24,69,4,24,28
94,8470613,Brent Burns,D,CAR,39,75,3,25,28
94,8480459,Pius Suter,C,VAN,28,69,17,10,27
94,8478233,Andrew Mangiapane,L,WSH,28,71,14,13,27
94,8480835,Jack Drury,C,CAR,24,61,13,14,27
94,8479996,Cody Glass,C,NSH,25,58,11,16,27
94,8477987,Ryan Donato,C,CHI,28,57,10,17,27
94,8478882,Vladislav Gavrikov,D,LAK,29,68,9,18,27
94,8483445,Cutter Gauthier,L,ANA,20,58,9,18,27
94,8481703,Valtteri Puustinen,R,PIT,25,62,6,21,27
94,8478911,Matt Roy,D,WSH,29,64,6,21,27
94,8476918,Jimmy Vesey,L,NYR,31,66,16,10,26
94,8482737,Zack Bolduc,C,STL,21,56,14,12,26
94,8481704,Juuso Parssinen,C,NSH,23,53,14,12,26
94,8475722,Jason Zucker,L,BUF,32,66,13,13,26
94,8475763,Kevin Hayes,R,PIT,32,70,12,14,26
94,8483565,Nick Blankenburg,D,NSH,26,65,11,15,26
94,8477998,Warren Foegele,L,LAK,28,78,10,16,26
94,8475200,Dmitry Orlov,D,CAR,33,73,9,17,26
94,8476897,Oskar Sundqvist,C,STL,30,61,9,17,26
94,8479315,Joey Anderson,R,CHI,26,58,8,18,26
94,8477989,Christian Dvorak,C,MTL,28,58,7,19,26
94,8478500,Ivan Provorov,D,CBJ,27,78,5,21,26
94,8477969,Marcus Pettersson,D,PIT,28,77,3,23,26
94,8476469,Joel Armia,R,MTL,31,63,15,10,25
94,8479336,Carl Grundstrom,R,SJS,27,55,14,11,25
94,8479293,Brandon Tanev,L,SEA,33,67,14,11,25
94,8483505,Matthew Poitras,C,BOS,20,68,12,13,25
94,8474189,Lars Eller,C,PIT,35,63,11,14,25
94,8477839,Conor Sheary,L,TBL,32,81,10,15,25
94,8479316,Luke Kunin,C,SJS,27,57,10,15,25
94,8481093,Rafael Harvey-Pinard,L,MTL,25,65,9,16,25
94,8481624,Ilya Mikheyev,R,CHI,30,54,8,17,25
94,8479661,Tanner Jeannot,L,LAK,27,73,8,17,25
94,8475171,Oliver Ekman-Larsson,D,TOR,33,68,8,17,25
94,8476988,Matt Benning,D,SJS,30,64,7,18,25
94,8480789,Oliver Wahlstrom,R,NYI,24,70,7,18,25
94,8481606,Jordan Spence,D,LAK,23,73,6,19,25
94,8478178,Darren Raddysh,D,TBL,28,70,5,20,25
94,8480878,Nils Lundkvist,D,DAL,24,75,1,24,25
94,8477425,Miles Wood,L,COL,29,79,14,10,24
94,8476278,Colin Blackwell,C,DAL,31,78,10,14,24
94,8482125,Alexander Holtz,R,VGK,22,68,10,14,24
94,8480762,Eric Robinson,L,CAR,29,60,9,15,24
94,8482142,Jamie Drysdale,D,PHI,22,56,7,17,24
94,8481527,Kaedan Korczak,D,VGK,23,47,6,18,24
94,8482712,Oskar Olausson,R,COL,22,79,5,19,24
94,8475220,Marcus Foligno,L,MIN,33,57,5,19,24
94,8478970,Jalen Chatfield,D,CAR,28,65,5,19,24
94,8476422,Mike Reilly,D,NYI,31,76,5,19,24
94,8476457,Adam Larsson,D,SEA,32,70,5,19,24
94,8477506,Ryan Pulock,D,NYI,30,78,4,20,24
94,8475181,Nick Leddy,D,STL,33,70,3,21,24
94,8474151,Ryan McDonagh,D,TBL,35,76,2,22,24
94,8476525,Colin Miller,D,WPG,32,61,1,23,24
94,8476981,Josh Anderson,R,MTL,30,72,15,8,23
94,8482679,Matt Coronato,R,CGY,22,59,13,10,23
94,8478043,Sam Lafferty,C,BUF,29,59,12,11,23
94,8482079,Marco Rossi,C,MIN,23,57,11,12,23
94,8480074,Alexandre Texier,C,STL,25,56,11,12,23
94,8476329,Travis Boyd,C,MIN,31,54,8,15,23
94,8476312,Josh Manson,D,COL,33,58,7,16,23
94,8483468,Jiri Kulich,C,BUF,20,51,7,16,23
94,8480855,Jack McBain,C,UTA,24,63,6,17,23
94,8474574,Tyler Myers,D,VAN,34,67,2,21,23
94,8479619,Michael Carcone,L,UTA,28,63,17,5,22
94,8481535,Nils Hoglander,L,VAN,24,62,13,9,22
94,8480205,Emil Bemstrom,C,PIT,25,59,13,9,22
94,8481580,Connor McMichael,C,WSH,23,54,12,10,22
94,8477450,Jason Dickinson,C,CHI,29,61,11,11,22
94,8479351,Sam Steel,C,DAL,26,79,11,11,22
94,8476925,Colton Sissons,C,NSH,31,66,11,11,22
94,8479393,Noah Gregor,L,OTT,26,78,10,12,22
94,8477931,Tomas Nosek,L,FLA,32,57,10,12,22
94,8481477,Nico Sturm,C,SJS,29,52,10,12,22
94,8476878,Zemgus Girgensons,C,TBL,30,78,9,13,22
94,8479639,Dylan Coghlan,D,WPG,26,59,8,14,22
94,8483457,Lane Hutson,D,MTL,20,63,7,15,22
94,8476889,Radek Faksa,C,STL,30,62,6,16,22
94,8480001,Urho Vaakanainen,D,ANA,25,59,6,16,22
94,8479353,Brett Howden,C,VGK,26,66,5,17,22
94,8477220,Nate Schmidt,D,FLA,33,67,4,18,22
94,8479998,Mikey Anderson,D,LAK,25,60,4,18,22
94,8481059,Scott Perunovich,D,STL,26,61,4,18,22
94,8481601,Simon Holmstrom,R,NYI,23,62,13,8,21
94,8478585,Derek Ryan,C,EDM,38,60,12,9,21
94,8480802,Ryan McLeod,C,BUF,25,59,10,11,21
94,8480144,David Kampf,C,TOR,29,67,9,12,21
94,8477903,Garnet Hathaway,R,PHI,33,64,8,13,21
94,8476467,Jamie Oleksiak,D,SEA,32,62,7,14,21
94,8483493,Frank Nazar,C,CHI,20,54,7,14,21
94,8481441,Joe Snively,C,DET,28,63,6,15,21
94,8477507,Nikita Zadorov,D,BOS,29,67,5,16,21
94,8479983,Mario Ferraro,D,SJS,26,75,5,16,21
94,8482117,Lukas Reichel,L,CHI,22,51,4,17,21
94,8481568,Alex Vlasic,D,CHI,23,53,3,18,21
94,8476931,Jake McCabe,D,TOR,31,63,2,19,21
94,8479402,Jake Bean,D,CGY,26,75,1,20,21
94,8480049,Dylan Samberg,D,WPG,25,64,1,20,21
94,8478840,Will Borgen,D,SEA,28,61,1,20,21
94,8480893,Kirill Marchenko,R,CBJ,24,55,17,3,20
94,8477508,Curtis Lazar,C,NJD,29,59,11,9,20
94,8475842,Sam Carrick,C,NYR,32,65,11,9,20
94,8483495,Simon Nemec,D,NJD,20,57,11,9,20
94,8482067,Connor Mackey,D,NYR,28,59,10,10,20
94,8482259,Bobby McMann,C,TOR,28,61,10,10,20
94,8483482,Tristan Luneau,D,ANA,20,61,10,10,20
94,8477947,Sonny Milano,L,WSH,28,58,10,10,20
94,8480813,Joe Veleno,C,DET,24,74,9,11,20
94,8481028,Martin Pospisil,C,CGY,25,52,8,12,20
94,8476374,Sean Kuraly,C,CBJ,31,51,8,12,20
94,8479368,Max Jones,L,BOS,26,64,7,13,20
94,8475225,Craig Smith,C,CHI,35,57,6,14,20
94,8480035,Henri Jokiharju,D,BUF,25,70,6,14,20
94,8478443,Brandon Carlo,D,BOS,28,63,5,15,20
94,8475462,Radko Gudas,D,ANA,34,64,3,17,20
94,8483491,Ivan Miroshnichenko,L,WSH,20,58,12,7,19
94,8479066,Ryan Lomberg,L,CGY,30,70,11,8,19
94,8477478,William Carrier,L,CAR,30,60,10,9,19
94,8479390,Taylor Raddysh,R,WSH,26,63,7,12,19
94,8480748,Kiefer Sherwood,L,VAN,29,60,7,12,19
94,8480003,Jesper Boqvist,C,FLA,26,64,7,12,19
94,8475855,Jesper Fast,R,CAR,33,53,6,13,19
94,8476917,Adam Pelech,D,NYI,30,79,5,14,19
94,8478432,Christian Fischer,R,DET,27,73,5,14,19
94,8479982,Conor Timmins,D,TOR,26,55,5,14,19
94,8480246,Nick Perbix,D,TBL,26,74,4,15,19
94,8479543,Michael Pezzetta,L,MTL,26,59,3,16,19
94,8480222,Sebastian Aho,D,PIT,28,70,3,16,19
94,8478507,John Marino,D,UTA,27,68,3,16,19
94,8481014,Alexander Romanov,D,NYI,24,75,1,18,19
94,8475208,Brian Dumoulin,D,ANA,33,64,1,18,19
94,8481518,Nolan Foote,L,NJD,24,43,12,6,18
94,8482809,Jackson Blake,R,CAR,21,57,10,8,18
94,8473453,Trevor Lewis,C,LAK,37,74,10,8,18
94,8475791,Taylor Hall,L,CHI,33,55,9,9,18
94,8479718,Alex Barré-Boulet,C,MTL,27,52,9,9,18
94,8480806,Isac Lundestrom,C,ANA,25,68,8,10,18
94,8478569,Noel Acciari,C,PIT,33,50,8,10,18
94,8480980,Connor Dewar,C,TOR,25,69,7,11,18
94,8477573,Nathan Walker,L,STL,30,51,7,11,18
94,8480448,Parker Kelly,L,COL,25,74,6,12,18
94,8475790,Erik Gudbranson,D,CBJ,32,71,5,13,18
94,8482111,Justin Barron,D,MTL,23,63,4,14,18
94,8482087,Kaiden Guhle,D,MTL,22,69,4,14,18
94,8477018,Ben Hutton,D,VGK,31,52,4,14,18
94,8478851,Alexandre Carrier,D,NSH,28,61,3,15,18
94,8474673,TJ Brodie,D,CHI,34,56,2,16,18
94,8480073,Erik Brannstrom,D,COL,25,67,2,16,18
94,8479249,Andrew Poturalski,C,SJS,30,39,2,16,18
94,8475690,Chris Tanev,D,TOR,35,61,0,18,18
94,8480289,Morgan Barron,C,WPG,26,57,10,7,17
94,8477919,Frederick Gaudreau,C,MIN,31,61,8,9,17
94,8482803,Olen Zellweger,D,ANA,21,64,8,9,17
94,8482155,Alex Laferriere,R,LAK,23,69,8,9,17
94,8481546,Cam York,D,PHI,23,68,7,10,17
94,8481522,Peyton Krebs,C,BUF,23,64,7,10,17
94,8476624,Barclay Goodrow,C,SJS,31,59,7,10,17
94,8479941,Justin Danforth,R,CBJ,31,52,6,11,17
94,8479369,Andrew Peeke,D,BOS,26,63,5,12,17
94,8481178,Egor Zamula,D,PHI,24,57,4,13,17
94,8480172,Jan Rutta,D,SJS,34,66,4,13,17
94,8478434,Keegan Kolesar,R,VGK,27,64,4,13,17
94,8479344,Jesse Puljujarvi,R,PIT,26,49,3,14,17
94,8479398,Samuel Girard,D,COL,26,68,2,15,17
94,8476429,Scott Mayfield,D,NYI,32,75,1,16,17
94,8477845,Trevor van Riemsdyk,D,WSH,33,65,1,16,17
94,8480995,Pontus Holmberg,R,TOR,25,56,10,6,16
94,8476822,Luke Glendening,C,TBL,35,77,9,7,16
94,8474034,Patrick Maroon,L,CHI,36,50,7,9,16
94,8480011,Klim Kostin,C,SJS,25,55,7,9,16
94,8481161,Jake Christiansen,D,CBJ,25,61,7,9,16
94,8478463,Anthony Beauvillier,L,PIT,27,68,6,10,16
94,8476873,Mark Jankowski,C,NSH,30,48,6,10,16
94,8476885,Jacob Trouba,D,NYR,30,60,5,11,16
94,8478452,Caleb Jones,D,LAK,27,62,5,11,16
94,8479372,Joshua Mahura,D,SEA,26,63,5,11,16
94,8478416,Erik Cernak,D,TBL,27,71,4,12,16
94,8480355,Mark Kastelic,C,BOS,25,68,4,12,16
94,8477979,Nicolas Aube-Kubel,R,BUF,28,59,3,13,16
94,8482245,Artem Zub,D,OTT,29,70,3,13,16
94,8474567,Zach Bogosian,D,MIN,34,62,1,15,16
94,8482859,Zack Ostapchuk,C,OTT,21,50,11,4,15
94,8478831,Kevin Stenlund,C,UTA,28,54,10,5,15
94,8481013,Jonatan Berggren,R,DET,24,60,7,8,15
94,8479968,Vinni Lettieri,C,BOS,29,53,7,8,15
94,8477482,Zachary Sanford,L,CHI,30,36,6,9,15
94,8482624,Daniil Miromanov,D,CGY,27,57,5,10,15
94,8482192,Isaak Phillips,D,CHI,23,56,5,10,15
94,8477446,Michael McCarron,R,NSH,29,58,5,10,15
94,8483499,Liam Ohgren,L,MIN,20,59,5,10,15
94,8475718,Justin Holl,D,DET,32,60,5,10,15
94,8477435,Ryan Graves,D,PIT,29,78,4,11,15
94,8480950,Ilya Lyubushkin,D,DAL,30,56,4,11,15
94,8479976,Juuso Valimaki,D,UTA,26,64,3,12,15
94,8475188,Brayden McNabb,D,VGK,33,53,3,12,15
94,8480807,Mattias Samuelsson,D,BUF,24,58,3,12,15
94,8478859,Niko Mikkola,D,FLA,28,62,3,12,15
94,8473446,Erik Johnson,D,PHI,36,49,2,13,15
94,8480891,Michael Kesselring,D,UTA,24,56,1,14,15
94,8482073,Braden Schneider,D,NYR,23,62,1,14,15
94,8479371,Dante Fabbro,D,NSH,26,67,1,14,15
94,8479291,Kevin Rooney,C,CGY,31,48,10,4,14
94,8479439,Jacob MacDonald,D,COL,31,57,8,6,14
94,8482166,Shakir Mukhamadullin,D,SJS,22,53,7,7,14
94,8477353,Tyler Motte,C,DET,29,75,7,7,14
94,8478211,Dryden Hunt,L,CGY,29,56,6,8,14
94,8477938,Haydn Fleury,D,WPG,28,45,6,8,14
94,8481032,Paul Cotter,C,NJD,25,64,5,9,14
94,8475343,Nic Dowd,C,WSH,34,55,5,9,14
94,8473563,Nicklas Backstrom,C,WSH,37,57,4,10,14
94,8482749,Joshua Roy,R,MTL,21,59,4,10,14
94,8482730,Brandt Clarke,D,LAK,21,50,4,10,14
94,8476994,Vinnie Hinostroza,C,NSH,30,38,4,10,14
94,8480887,Jordan Harris,D,MTL,24,58,3,11,14
94,8479026,Philippe Myers,D,TOR,27,53,3,11,14
94,8476874,Olli Maatta,D,DET,30,62,3,11,14
94,8471709,Marc-Edouard Vlasic,D,SJS,37,62,2,12,14
94,8482074,Connor Zary,C,CGY,23,60,10,3,13
94,8476858,Phillip Di Giuseppe,L,VAN,31,40,8,5,13
94,8482157,Will Cuylle,L,NYR,22,58,7,6,13
94,8482062,Cole Smith,L,NSH,29,63,7,6,13
94,8480252,Cole Guttman,C,CHI,25,44,7,6,13
94,8482659,Josh Doan,R,UTA,22,52,7,6,13
94,8480281,Alexey Toropchenko,R,STL,25,58,6,7,13
94,8480021,Jack Studnicka,C,LAK,25,55,6,7,13
94,8482634,Alex Steeves,C,TOR,25,47,6,7,13
94,8482144,Jack Thompson,D,SJS,22,33,6,7,13
94,8480025,MacKenzie Entwistle,R,FLA,25,61,5,8,13
94,8481517,Brett Leason,R,ANA,25,53,5,8,13
94,8477406,Mattias Janmark,C,EDM,32,59,5,8,13
94,8483466,Kevin Korchinski,D,CHI,20,54,5,8,13
94,8479370,Tyson Jost,C,CAR,26,53,5,8,13
94,8476879,Cody Ceci,D,EDM,31,68,4,9,13
94,8481521,Ronnie Attard,D,PHI,25,60,4,9,13
94,8481567,Henry Thrun,D,SJS,23,40,4,9,13
94,8483549,Lucas Condotta,L,MTL,27,34,4,9,13
94,8476856,Mathew Dumba,D,DAL,30,72,3,10,13
94,8476891,Matthew Grzelcyk,D,PIT,30,75,3,10,13
94,8475455,Brenden Dillon,D,NJD,34,61,2,11,13
94,8476967,Brett Kulak,D,EDM,30,63,2,11,13
94,8475324,Nick Jensen,D,OTT,34,65,1,12,13
94,8475233,David Savard,D,MTL,34,66,0,13,13
94,8482666,Scott Morrow,D,CAR,22,50,6,6,12
94,8477380,Jonny Brodzinski,C,NYR,31,59,6,6,12
94,8482148,Hendrix Lapierre,C,WSH,22,56,6,6,12
94,8478421,A.J. Greer,L,FLA,28,61,6,6,12
94,8477392,Hudson Fasching,R,NYI,29,60,5,7,12
94,8484149,Gavin Brindley,C,CBJ,20,47,5,7,12
94,8477070,Liam O'Brien,C,UTA,30,57,5,7,12
94,8478399,Jonas Siegenthaler,D,NJD,27,55,4,8,12
94,8476442,Matt Nieto,L,PIT,32,45,4,8,12
94,8477015,Connor Brown,R,EDM,30,63,3,9,12
94,8479378,Logan Stanley,D,WPG,26,50,3,9,12
94,8479980,Nicolas Hague,D,VGK,26,49,2,10,12
94,8480058,Pierre-Olivier Joseph,D,STL,25,49,2,10,12
94,8481019,David Gustafsson,C,WPG,24,43,2,10,12
94,8481701,Santeri Hatakka,D,NJD,23,37,2,10,12
94,8477369,Carson Soucy,D,VAN,30,59,1,11,12
94,8482451,Mikael Pyyhtia,L,CBJ,23,55,1,11,12
94,8480796,Martin Fehervary,D,WSH,25,46,1,11,12
94,8479324,Ryan Lindgren,D,NYR,26,63,1,11,12
94,8481641,Joel Kiviranta,L,COL,28,69,7,4,11
94,8476934,Brock McGinn,L,ANA,30,56,7,4,11
94,8479328,Julien Gauthier,R,NYI,27,63,7,4,11
94,8482762,Simon Edvinsson,D,DET,21,55,7,4,11
94,8481556,John Beecher,C,BOS,23,36,7,4,11
94,8481789,Tye Kartye,L,SEA,23,46,6,5,11
94,8478136,Jake Middleton,D,MIN,28,70,4,7,11
94,8482176,Wyatt Kaiser,D,CHI,22,52,4,7,11
94,8481537,Nikita Okhotiuk,D,CGY,24,57,4,7,11
94,8474166,Alec Martinez,D,CHI,37,42,4,7,11
94,8470600,Ryan Suter,D,STL,39,64,3,8,11
94,8477851,Jordan Oesterle,D,BOS,32,36,3,8,11
94,8480727,Zach Whitecloud,D,VGK,28,44,3,8,11
94,8476867,Brendan Gaunce,C,MIN,30,35,3,8,11
94,8480157,Calle Rosen,D,COL,30,46,3,8,11
94,8473507,Jeff Petry,D,DET,37,68,2,9,11
94,8483460,David Jiricek,D,CBJ,21,55,2,9,11
94,8480192,Johnathan Kovacevic,D,NJD,27,56,2,9,11
94,8475179,Dmitry Kulikov,D,FLA,34,61,1,10,11
94,8477365,Connor Clifton,D,BUF,29,44,1,10,11
94,8475279,Ben Chiarot,D,DET,33,60,0,11,11
94,8479944,Zach Aston-Reese,C,VGK,30,44,6,4,10
94,8479536,Axel Jonsson-Fjallby,L,WPG,26,33,6,4,10
94,8480441,Trey Fix-Wolansky,R,CBJ,25,36,6,4,10
94,8477499,Rasmus Ristolainen,D,PHI,30,56,5,5,10
94,8480848,Ty Dellandrea,C,SJS,24,34,5,5,10
94,8481617,Vasily Podkolzin,R,VAN,23,43,5,5,10
94,8479994,Jaret Anderson-Dolan,C,WPG,25,32,5,5,10
94,8479414,Nathan Bastian,R,NJD,27,55,4,6,10
94,8482077,Dylan Holloway,L,EDM,23,52,4,6,10
94,8478451,Ethan Bear,D,WSH,27,45,4,6,10
94,8481751,Lukas Rousek,R,BUF,25,39,4,6,10
94,8471677,Jack Johnson,D,CBJ,37,65,4,6,10
94,8479981,Jonah Gadjovich,L,FLA,26,42,3,7,10
94,8476441,Joel Edmundson,D,LAK,31,41,3,7,10
94,8482744,James Malatesta,L,CBJ,21,41,2,8,10
94,8481708,Zac Jones,D,NYR,24,55,2,8,10
94,8481599,Victor Soderstrom,D,UTA,23,37,2,8,10
94,8481716,Dmitri Voronkov,L,CBJ,24,34,6,3,9
94,8480007,Jonas Rondbjerg,R,VGK,25,37,6,3,9
94,8477401,John Hayden,C,SEA,29,31,6,3,9
94,8471817,Ryan Reaves,R,TOR,37,54,5,4,9
94,8478468,Jeremy Lauzon,D,NSH,27,56,4,5,9
94,8482964,Arber Xhekaj,D,MTL,23,45,3,6,9
94,8481598,Philip Broberg,D,EDM,23,42,3,6,9
94,8478146,Matthew Highmore,C,OTT,28,34,3,6,9
94,8479671,Mathieu Olivier,R,CBJ,27,49,2,7,9
94,8481600,Tobias Bjornfot,D,FLA,23,41,2,7,9
94,8479359,Beck Malenstyn,L,BUF,26,53,2,7,9
94,8481167,Brayden Pachal,D,CGY,25,43,1,8,9
94,8480196,Jacob Bryson,D,BUF,27,33,1,8,9
94,8474612,Travis Hamonic,D,OTT,34,48,0,9,9
94,8474568,Luke Schenn,D,NSH,35,50,0,9,9
94,8474013,Ian Cole,D,UTA,35,53,0,9,9
94,8481592,Jakob Pelletier,L,CGY,23,37,6,2,8
94,8482751,Ryan Winterton,C,SEA,21,34,6,2,8
94,8481754,Nikita Nesterenko,C,ANA,23,28,4,4,8
94,8477962,Brendan Lemieux,L,CAR,28,39,4,4,8
94,8478409,Anthony Richard,C,PHI,28,32,4,4,8
94,8477462,Robert Hagg,D,VGK,29,26,4,4,8
94,8482765,Isak Rosen,R,BUF,21,32,4,4,8
94,8480990,Declan Chisholm,D,MIN,24,40,3,5,8
94,8479772,Zack MacEwen,R,OTT,28,57,3,5,8
94,8482784,Zach Dean,C,STL,21,37,3,5,8
94,8479520,Brandon Duhaime,R,WSH,27,54,2,6,8
94,8480844,Grigori Denisenko,L,VGK,24,33,2,6,8
94,8481550,Adam Beckman,L,NJD,23,39,1,7,8
94,8481605,Jackson LaCombe,D,ANA,23,38,1,7,8
94,8477384,Joshua Brown,D,EDM,30,38,1,7,8
94,8480860,Kevin Bahl,D,CGY,24,61,1,7,8
94,8480070,Ian Mitchell,D,BOS,25,44,1,7,8
94,8479379,Givani Smith,R,SJS,26,29,0,8,8
94,8480879,Jacob Bernard-Docker,D,OTT,24,44,0,8,8
94,8482095,Tyler Kleven,D,OTT,22,42,5,2,7
94,8479638,Justin Brazeau,R,BOS,26,38,5,2,7
94,8482652,Walker Duehr,R,CGY,27,39,4,3,7
94,8481532,Alex Turcotte,C,LAK,23,48,4,3,7
94,8477467,Gustav Olofsson,D,SEA,30,22,4,3,7
94,8479348,Kale Clague,D,BUF,26,39,3,4,7
94,8481122,Simon Benoit,D,TOR,26,39,3,4,7
94,8476372,Nick Seeler,D,PHI,31,51,3,4,7
94,8482153,Brendan Brisson,C,VGK,23,36,3,4,7
94,8479986,Kole Lind,R,DAL,26,56,2,5,7
94,8480292,Carson Meyer,R,ANA,27,33,2,5,7
94,8484911,Collin Graf,R,SJS,22,39,2,5,7
94,8477887,Patrick Brown,C,BOS,32,41,2,5,7
94,8478874,Adam Gaudette,R,OTT,28,36,2,5,7
94,8475750,Jon Merrill,D,MIN,32,62,2,5,7
94,8477335,Kyle Burroughs,D,LAK,29,44,2,5,7
94,8484254,Akito Hirose,D,VAN,25,36,1,6,7
94,8477244,Chad Ruhwedel,D,NYR,34,39,1,6,7
94,8480845,Rasmus Kupari,C,WPG,24,44,1,6,7
94,8480870,Bo Groulx,C,NYR,24,22,1,6,7
94,8481147,Reese Johnson,C,MIN,26,41,4,2,6
94,8483570,Ben Meyers,C,SEA,26,33,4,2,6
94,8479991,Jake Leschyshyn,C,NYR,25,32,4,2,6
94,8482807,Ethan Del Mastro,D,CHI,21,51,3,3,6
94,8478017,Mark Friedman,D,VAN,29,43,3,3,6
94,8481543,Nikita Alexandrov,C,STL,24,29,3,3,6
94,8475235,Nicolas Deslauriers,L,PHI,33,39,3,3,6
94,8482172,Landon Slaggert,L,CHI,22,20,3,3,6
94,8482733,Logan Mailloux,D,MTL,31,35,3,3,6
94,8481679,Maxence Guenette,D,OTT,23,38,3,3,6
94,8476913,Devin Shore,C,MIN,30,44,3,3,6
94,8479442,Troy Stecher,D,EDM,30,52,2,4,6
94,8475762,Derek Forbort,D,VAN,32,44,2,4,6
94,8480245,Olle Lycksell,R,PHI,25,24,2,4,6
94,8482070,Mitchell Chaffee,R,TBL,26,48,1,5,6
94,8480880,Jakub Lauko,C,MIN,24,33,4,1,5
94,8481609,Vladislav Kolyachonok,D,UTA,23,35,4,1,5
94,8483630,Pavol Regenda,L,ANA,25,28,4,1,5
94,8479972,Mason Shaw,C,WPG,26,31,3,2,5
94,8475177,Calvin de Haan,D,COL,33,36,2,3,5
94,8482747,Brennan Othmann,L,NYR,21,40,2,3,5
94,8480834,Ty Emberson,D,SJS,24,29,2,3,5
94,8483763,Maksymilian Szuber,D,UTA,22,30,2,3,5
94,8479419,Brett Murray,L,BUF,26,21,2,3,5
94,8482141,Lukas Cormier,D,VGK,22,28,2,3,5
94,8481806,Louis Crevier,D,CHI,23,17,2,3,5
94,8478424,Jansen Harkins,C,ANA,27,50,1,4,5
94,8482145,Mavrik Bourque,C,DAL,22,47,1,4,5
94,8477527,Ross Johnston,L,ANA,30,28,1,4,5
94,8483619,Filip Roos,D,OTT,25,36,1,4,5
94,8482496,Nils Aman,C,VAN,24,44,1,4,5
94,8478477,Mitchell Stephens,C,SEA,27,15,1,4,5
94,8477810,Joel Hanley,D,CGY,33,22,1,4,5
94,8476473,Connor Murphy,D,CHI,31,41,0,5,5
94,8478454,Noah Juulsen,D,VAN,27,38,0,5,5
94,8483512,Matthew Savoie,C,EDM,20,26,0,5,5
94,8475958,Michael Sgarbossa,C,WSH,32,29,3,1,4
94,8484287,Cole McWard,D,VAN,23,24,3,1,4
94,8482511,Mason Lohrei,D,BOS,23,34,2,2,4
94,8482177,Marat Khusnutdinov,C,MIN,22,32,2,2,4
94,8483397,Marc McLaughlin,C,BOS,25,27,2,2,4
94,8480267,Sammy Walker,C,MIN,25,19,2,2,4
94,8481743,Marc Del Gaizo,D,NSH,25,15,2,2,4
94,8482929,Emil Lilleberg,D,TBL,23,22,2,2,4
94,8477473,Justin Bailey,R,SJS,29,21,2,2,4
94,8481726,Adam Edstrom,C,NYR,24,8,2,2,4
94,8480851,Akil Thomas,C,LAK,24,22,2,2,4
94,8481030,Jack St. Ivany,D,PIT,25,19,2,2,4
94,8474090,Brendan Smith,D,DAL,35,51,1,3,4
94,8477149,Scott Sabourin,R,SJS,32,17,1,3,4
94,8484325,Waltteri Merela,C,TBL,26,20,1,3,4
94,8483012,Logan Morrison,C,SEA,22,41,0,4,4
94,8482861,Vincent Iorio,D,WSH,22,32,0,4,4
94,8479587,Rhett Gardner,C,PHI,28,22,0,4,4
94,8478021,William Lagesson,D,DET,28,34,0,4,4
94,8481462,Mason Morelli,L,VGK,28,14,3,0,3
94,8483546,Marshall Rifai,D,TOR,26,5,3,0,3
94,8481699,Aku Raty,R,UTA,23,12,2,1,3
94,8474062,Riley Nash,C,NYR,35,14,2,1,3
94,8479367,William Lockwood,R,FLA,26,26,1,2,3
94,8479985,Cale Fleury,D,SEA,26,21,1,2,3
94,8480468,James Hamblin,L,EDM,25,21,1,2,3
94,8484258,Sam Malinski,D,COL,26,23,1,2,3
94,8480084,Nick DeSimone,D,NJD,30,14,1,2,3
94,8481043,Cole Koepke,L,BOS,26,17,1,2,3
94,8480075,Cameron Crotty,D,MIN,25,6,1,2,3
94,8482516,Matthew Kessel,D,STL,24,16,1,2,3
94,8483489,Fraser Minten,C,TOR,31,14,1,2,3
94,8481564,Ryan Johnson,D,BUF,23,20,1,2,3
94,8478450,Parker Wotherspoon,D,BOS,27,34,0,3,3
94,8481056,Spencer Stastney,D,NSH,24,32,0,3,3
94,8482858,Ryker Evans,D,SEA,23,25,0,3,3
94,8477320,Anton Blidh,L,NYR,29,20,0,3,3
94,8479576,Vincent Desharnais,D,VAN,28,37,0,3,3
94,8481593,Jayden Struble,D,MTL,23,16,0,3,3
94,8482102,Vasily Ponomarev,C,PIT,22,23,2,0,2
94,8482061,Brandon Biro,L,SEA,26,10,2,0,2
94,8477034,Jaycob Megna,D,FLA,32,43,1,1,2
94,8478502,Dennis Gilbert,D,BUF,28,15,1,1,2
94,8478011,Louie Belpedio,D,PHI,28,11,1,1,2
94,8477971,Andreas Englund,D,LAK,28,19,1,1,2
94,8479362,Riley Tufte,L,BOS,26,21,1,1,2
94,8482147,Jean-Luc Foudy,C,COL,22,20,1,1,2
94,8475780,Chris Wagner,R,COL,33,8,1,1,2
94,8481585,Egor Afanasyev,L,SJS,23,10,1,1,2
94,8475755,Alexander Petrovic,D,DAL,32,11,1,1,2
94,8478881,Brett Seney,L,CHI,28,14,1,1,2
94,8476952,Dominic Toninato,C,WPG,30,34,0,2,2
94,8482201,Gage Goncalves,C,TBL,23,27,0,2,2
94,8482165,Yan Kuznetsov,D,CGY,22,15,0,2,2
94,8480823,Alexander Alexeyev,D,WSH,25,12,0,2,2
94,8482713,Mackie Samoskevich,R,FLA,22,31,0,2,2
94,8481006,Tyler Tucker,D,STL,24,15,0,2,2
94,8483567,Georgii Merkulov,C,BOS,24,10,0,2,2
94,8481065,Angus Crookshank,L,OTT,25,7,0,2,2
94,8484304,Uvis Balinskis,D,FLA,28,8,0,2,2
94,8481541,Samuel Bolduc,D,NYI,24,27,1,0,1
94,8481237,Kyle MacLean,C,NYI,25,30,1,0,1
94,8482118,Sam Colangelo,R,ANA,23,14,1,0,1
94,8478051,Max Willman,C,NJD,29,13,1,0,1
94,8480874,Adam Ginning,D,PHI,24,10,1,0,1
94,8478446,Glenn Gawdin,C,LAK,27,6,1,0,1
94,8477993,Justin Kirkland,C,CGY,28,5,1,0,1
94,8481534,Raphael Lavoie,C,EDM,24,4,1,0,1
94,8483432,Luca Del Bel Belluz,C,CBJ,31,7,1,0,1
94,8479320,Maxime Lajoie,D,SEA,27,20,0,1,1
94,8477073,Kurtis MacDermid,L,NJD,30,33,0,1,1
94,8482470,Ilya Solovyov,D,CGY,24,14,0,1,1
94,8480890,Jan Jenik,C,OTT,24,25,0,1,1
94,8481024,Linus Karlsson,C,VAN,25,9,0,1,1
94,8482250,Callahan Burke,C,VGK,27,16,0,1,1
94,8482460,Matt Rempe,C,NYR,22,8,0,1,1
94,8482197,Adam Raska,R,MIN,23,8,0,1,1
94,8482094,Daemon Hunt,D,MIN,22,17,0,1,1
94,8482088,Justin Sourdif,R,FLA,22,16,0,1,1
94,8483407,Brandon Scanlin,D,NYR,25,5,0,1,1
94,8481655,Cole Schwindt,R,CGY,23,8,0,1,1
94,8483609,Adam Klapka,R,CGY,24,3,0,1,1
94,8477541,Dakota Mermis,D,TOR,30,9,0,0,0
94,8482162,Roby Jarventie,L,EDM,22,20,0,0,0
94,8481422,Jake Lucchini,C,NSH,29,16,0,0,0
94,8481719,Maxwell Crozier,D,TBL,24,13,0,0,0
94,8475795,Dylan McIlrath,D,WSH,32,23,0,0,0
94,8480306,Grant Hutton,D,NYI,29,2,0,0,0
94,8482787,Nikita Chibrikov,R,WPG,31,9,0,0,0
94,8483395,Arshdeep Bains,L,VAN,23,8,0,0,0
94,8475413,Justin Dowling,C,NJD,34,21,0,0,0
94,8483920,Pierrick Dube,R,WSH,23,3,0,0,0
94,8479330,Brandon Gignac,C,MTL,27,9,0,0,0
94,8483597,Milos Kelemen,L,UTA,25,10,0,0,0
94,8482126,Emil Andrae,D,PHI,31,3,0,0,0
94,8481578,Graeme Clarke,R,MIN,23,3,0,0,0
94,8480032,Shane Bowers,C,NJD,25,18,0,0,0
94,8483471,Brad Lambert,C,WPG,31,12,0,0,0
94,8479421,Jacob Moverare,D,LAK,26,3,0,0,0
94,8481206,John Ludvig,D,PIT,24,8,0,0,0
94,8483398,Declan Carlile,D,TBL,31,9,0,0,0
94,8478854,Ryan Shea,D,PIT,27,7,0,0,0
94,8484255,Jason Polin,R,COL,25,5,0,0,0
94,8476323,Max McCormick,L,SEA,32,2,0,0,0
94,8478147,Bokondji Imama,L,PIT,28,6,0,0,0
94,8484321,Nikolas Matinpalo,D,OTT,26,2,0,0,0
94,8482476,Emil Heineman,L,MTL,23,6,0,0,0
94,8483401,Marc Johnstone,R,PIT,28,0,0,0,0
94,8479522,Hardy Haman Aktell,D,WSH,26,4,0,0,0
94,8484326,Patrik Koch,D,UTA,28,1,0,0,0
94,8483531,Brian Halonen,L,NJD,25,1,0,0,0
94,8478956,Samuel Laberge,L,NJD,27,3,0,0,0
94,8480274,Philip Kemp,D,EDM,25,1,0,0,0
94,8484259,Ondrej Pavel,C,COL,31,2,0,0,0
94,8470794,Joe Pavelski,C,,40,0,0,0,0
94,8479321,Lucas Johansen,D,,27,0,0,0,0
94,8477950,Tony DeAngelo,D,,29,0,0,0,0
94,8471218,Blake Wheeler,R,,38,0,0,0,0
94,8475197,Tyson Barrie,D,,33,0,0,0,0
94,8474157,Max Pacioretty,L,,36,0,0,0,0
94,8475744,Evgeny Kuznetsov,C,,32,0,0,0,0
94,8474037,James van Riemsdyk,L,,35,0,0,0,0
94,8476907,Mackenzie MacEachern,L,,30,0,0,0,0
94,8480216,Jacob Peterson,C,,25,0,0,0,0
94,8474602,Justin Schultz,D,,34,0,0,0,0
94,8482222,Alexander Barabanov,L,,30,0,0,0,0
94,8474031,Kevin Shattenkirk,D,,35,0,0,0,0
94,8477330,Dominik Kubalik,L,,29,0,0,0,0
94,8480884,Calen Addison,D,,24,0,0,0,0
94,8475906,John Klingberg,D,,32,0,0,0,0
94,8480008,Adam Ruzicka,C,,25,0,0,0,0
94,8476884,Derrick Pouliot,D,,30,0,0,0,0
94,8476919,Chris Tierney,C,,30,0,0,0,0
94,8479415,Michael McLeod,C,,26,0,0,0,0
94,8474870,Tyler Johnson,C,,34,0,0,0,0
94,8470604,Jeff Carter,C,,39,0,0,0,0
94,8478104,Sammy Blais,L,,28,0,0,0,0
94,8474884,Mike Hoffman,C,,35,0,0,0,0
94,8481591,Sam Poulin,R,,23,0,0,0,0
94,8471274,Alex Goligoski,D,,39,0,0,0,0
94,8476871,Tanner Pearson,L,,32,0,0,0,0
94,8476393,Nick Cousins,C,,31,0,0,0,0
94,8479977,Kailer Yamamoto,R,,26,0,0,0,0
94,8479346,Dillon Dube,C,,26,0,0,0,0
94,8480184,Gustav Lindstrom,D,,26,0,0,0,0
94,8479376,Victor Mete,D,,26,0,0,0,0
94,8473449,Kyle Okposo,R,,36,0,0,0,0
94,8481058,Jesse Ylonen,R,,25,0,0,0,0
94,8475752,Tyler Pitlick,C,,33,0,0,0,0
94,8481239,Samuel Fagemo,L,,24,0,0,0,0
94,8480821,Filip Zadina,R,,25,0,0,0,0
94,8470966,Mark Giordano,D,,41,0,0,0,0
94,8478495,Denis Gurianov,R,,27,0,0,0,0
94,8477464,Nic Petan,C,,29,0,0,0,0
94,8478099,Kevin Labanc,R,,29,0,0,0,0
94,8482241,Radim Zohorna,L,,28,0,0,0,0
94,8474040,Sam Gagner,C,,35,0,0,0,0
94,8479514,Rem Pitlick,C,,27,0,0,0,0
94,8478430,Oliver Kylington,D,,27,0,0,0,0
94,8479533,Joona Koppanen,L,,26,0,0,0,0
94,8479984,Cal Foote,D,,26,0,0,0,0
94,8477126,Jayson Megna,C,,34,0,0,0,0
94,8475164,Jakob Silfverberg,R,,34,0,0,0,0
94,8474009,Nick Bonino,C,,36,0,0,0,0
94,8479458,Nikita Zaitsev,D,,33,0,0,0,0
94,8477944,Jakub Vrana,L,,28,0,0,0,0
94,8471699,Andrew Cogliano,C,,37,0,0,0,0
94,8478067,Oskar Lindblom,L,,28,0,0,0,0
94,8471686,Marc Staal,D,,37,0,0,0,0
94,8470610,Zach Parise,L,,40,0,0,0,0
94,8478904,Steven Lorentz,C,,28,0,0,0,0
94,8473473,Milan Lucic,L,,36,0,0,0,0
94,8480031,Maxime Comtois,L,,25,0,0,0,0
94,8478512,Austin Czarnik,C,,32,0,0,0,0
94,8473504,Cal Clutterbuck,R,,37,0,0,0,0
94,8477454,Adam Erne,L,,29,0,0,0,0
94,8479383,Boris Katchouk,L,,26,0,0,0,0
94,8475825,Jani Hakanpää,D,,32,0,0,0,0
94,8477846,Ryan Carpenter,C,,33,0,0,0,0
94,8477930,Pierre-Edouard Bellemare,L,,39,0,0,0,0
94,8478400,Colin White,C,,27,0,0,0,0
94,8480226,Marián Studenic,R,,26,0,0,0,0
94,8480853,Liam Foudy,C,,24,0,0,0,0
94,8475797,Jarred Tinordi,D,,32,0,0,0,0
94,8479423,Alex Nylander,L,,26,0,0,0,0
94,8474618,Marco Scandella,D,,34,0,0,0,0
94,8478028,Fredrik Olofsson,L,,28,0,0,0,0
94,8474709,Matt Martin,L,,35,0,0,0,0
94,8481070,Hugh McGing,L,,26,0,0,0,0
94,8479546,Oskar Steen,C,,26,0,0,0,0
94,8474145,Robert Bortuzzo,D,,35,0,0,0,0
94,8476915,Jujhar Khaira,L,,30,0,0,0,0
94,8475278,Byron Froese,C,,33,0,0,0,0
94,8481812,Nikolai Knyzhov,D,,27,0,0,0,0
94,8478408,Travis Dermott,D,,28,0,0,0,0
94,8481077,John Leonard,L,,26,0,0,0,0
94,8479547,Matthew Phillips,R,,26,0,0,0,0
94,8480836,Jonathan Gruden,C,,24,0,0,0,0
94,8481690,Tyler Angle,C,,24,0,0,0,0
94,8475766,Austin Watson,L,,32,0,0,0,0
94,8481016,Ruslan Iskhakov,C,,24,0,0,0,0
94,8478078,Rourke Chartier,C,,28,0,0,0,0
94,8480776,Sheldon Rempal,R,,29,0,0,0,0
94,8483045,Cameron Butler,R,CBJ,31,1,0,0,0
94,8484314,Jiri Smejkal,L,,28,0,0,0,0
95,8477492,Nathan MacKinnon,C,COL,29,81,61,101,162
95,8478402,Connor McDavid,C,EDM,27,78,50,108,158
95,8476453,Nikita Kucherov,R,TBL,31,82,40,105,145
95,8477956,David Pastrnak,R,BOS,28,81,52,72,124
95,8479318,Auston Matthews,C,TOR,27,79,69,52,121
95,8481559,Jack Hughes,C,NJD,23,72,52,69,121
95,8478483,Mitch Marner,R,TOR,27,82,32,87,119
95,8480027,Jason Robertson,L,DAL,25,82,40,75,115
95,8478550,Artemi Panarin,L,NYR,33,78,34,76,110
95,8477939,William Nylander,R,TOR,28,81,49,58,107
95,8477942,Kevin Fiala,L,LAK,28,81,35,69,104
95,8477404,Jake Guentzel,C,TBL,30,81,40,61,101
95,8479407,Jesper Bratt,L,NJD,26,72,33,67,100
95,8477934,Leon Draisaitl,C,EDM,29,77,37,62,99
95,8478420,Mikko Rantanen,R,COL,28,81,40,56,96
95,8478403,Jack Eichel,C,VGK,28,77,39,56,95
95,8475692,Mats Zuccarello,R,MIN,37,70,25,70,95
95,8474600,Roman Josi,D,NSH,34,75,24,71,95
95,8480801,Brady Tkachuk,L,OTT,25,76,38,55,93
95,8479343,Clayton Keller,R,UTA,26,79,39,53,92
95,8480069,Cale Makar,D,COL,26,68,22,70,92
95,8477946,Dylan Larkin,C,DET,28,80,43,47,90
95,8479314,Matthew Tkachuk,L,FLA,27,78,29,60,89
95,8475184,Chris Kreider,L,NYR,33,77,50,37,87
95,8477933,Sam Reinhart,C,FLA,29,77,41,46,87
95,8478010,Brayden Point,C,TBL,28,82,40,47,87
95,8478864,Kirill Kaprizov,L,MIN,27,74,38,49,87
95,8476881,Tomas Hertl,C,VGK,31,78,39,47,86
95,8476468,J.T. Miller,C,VAN,31,78,35,51,86
95,8482116,Tim Stützle,C,OTT,22,79,28,58,86
95,8476887,Filip Forsberg,L,NSH,30,77,44,41,85
95,8471675,Sidney Crosby,C,PIT,37,74,36,49,85
95,8480002,Nico Hischier,C,NJD,25,73,31,54,85
95,8478427,Sebastian Aho,C,CAR,27,74,36,48,84
95,8475172,Nazem Kadri,C,CGY,34,82,33,50,83
95,8477493,Aleksander Barkov,C,FLA,29,80,24,59,83
95,8480800,Quinn Hughes,D,VAN,25,78,16,67,83
95,8474564,Steven Stamkos,C,NSH,34,71,33,49,82
95,8479337,Alex DeBrincat,R,DET,27,81,32,50,82
95,8480208,Drake Batherson,R,OTT,26,80,31,51,82
95,8476389,Vincent Trocheck,C,NYR,31,75,34,47,81
95,8478445,Mathew Barzal,C,NYI,27,79,24,55,79
95,8479323,Adam Fox,D,NYR,26,74,17,62,79
95,8476459,Mika Zibanejad,C,NYR,31,76,34,44,78
95,8473419,Brad Marchand,L,BOS,36,81,30,48,78
95,8471685,Anze Kopitar,C,LAK,37,82,27,51,78
95,8473512,Claude Giroux,R,OTT,36,80,23,55,78
95,8474578,Erik Karlsson,D,PIT,34,81,17,61,78
95,8481557,Matt Boldy,L,MIN,23,72,37,40,77
95,8476460,Mark Scheifele,C,WPG,31,71,31,46,77
95,8476454,Ryan Nugent-Hopkins,C,EDM,31,78,21,56,77
95,8478460,Zach Werenski,D,CBJ,27,81,16,61,77
95,8480036,Miro Heiskanen,D,DAL,25,78,15,62,77
95,8471214,Alex Ovechkin,L,WSH,39,75,41,35,76
95,8477960,Adrian Kempe,R,LAK,28,80,34,42,76
95,8480018,Nick Suzuki,C,MTL,25,78,30,46,76
95,8480865,Noah Dobson,D,NYI,24,81,10,66,76
95,8477501,Valeri Nichushkin,R,COL,29,81,37,38,75
95,8478440,Dylan Strome,C,WSH,27,78,21,54,75
95,8477949,Alex Tuch,R,BUF,28,73,32,42,74
95,8480023,Robert Thomas,C,STL,25,73,17,57,74
95,8475166,John Tavares,C,TOR,34,74,36,37,73
95,8475798,Mikael Granlund,C,SJS,32,66,17,56,73
95,8476456,Jonathan Huberdeau,C,CGY,31,76,15,58,73
95,8475913,Mark Stone,R,VGK,32,73,29,43,72
95,8479420,Tage Thompson,C,BUF,27,77,37,33,70
95,8478449,Roope Hintz,C,DAL,28,82,32,38,70
95,8479675,Trevor Moore,L,LAK,29,81,32,38,70
95,8482109,Alexis Lafrenière,L,NYR,23,78,32,38,70
95,8480012,Elias Pettersson,C,VAN,26,75,27,43,70
95,8474141,Patrick Kane,R,DET,36,80,27,43,70
95,8482078,Lucas Raymond,L,DET,22,81,26,44,70
95,8478047,Michael Bunting,L,PIT,29,74,21,49,70
95,8476853,Morgan Rielly,D,TOR,30,72,16,54,70
95,8479385,Jordan Kyrou,C,STL,26,73,31,38,69
95,8480830,Andrei Svechnikov,R,CAR,24,71,30,38,68
95,8478493,Joel Eriksson Ek,C,MIN,27,71,26,42,68
95,8475167,Victor Hedman,D,TBL,34,78,23,45,68
95,8477504,Josh Morrissey,D,WPG,29,75,13,55,68
95,8477940,Nikolaj Ehlers,L,WPG,28,69,31,36,67
95,8482740,Wyatt Johnston,C,DAL,21,82,30,37,67
95,8477402,Pavel Buchnevich,L,STL,29,75,28,39,67
95,8478401,Pavel Zacha,C,BOS,27,80,27,40,67
95,8477951,Nick Schmaltz,C,UTA,28,75,23,44,67
95,8478398,Kyle Connor,L,WPG,28,70,26,40,66
95,8477447,Shea Theodore,D,VGK,29,67,12,54,66
95,8475786,Zach Hyman,L,EDM,32,80,36,29,65
95,8478873,Troy Terry,R,ANA,27,73,28,37,65
95,8480803,Evan Bouchard,D,EDM,25,76,15,50,65
95,8482684,Luke Hughes,D,NJD,21,67,12,53,65
95,8473994,Jamie Benn,L,DAL,35,81,31,33,64
95,8475794,Tyler Seguin,C,DAL,32,81,31,32,63
95,8475784,Jeff Skinner,C,EDM,32,77,30,33,63
95,8475168,Matt Duchene,C,DAL,33,81,26,37,63
95,8475754,Brock Nelson,C,NYI,33,81,33,29,62
95,8477496,Elias Lindholm,C,BOS,30,77,27,35,62
95,8477416,Oliver Bjorkstrand,R,SEA,29,77,23,39,62
95,8476539,Jonathan Marchessault,R,NSH,34,74,31,30,61
95,8477500,Bo Horvat,C,NYI,29,80,31,30,61
95,8484144,Connor Bedard,C,CHI,19,68,25,36,61
95,8478444,Brock Boeser,R,VAN,27,75,22,39,61
95,8477955,Jared McCann,L,SEA,28,76,30,30,60
95,8482124,Quinton Byfield,R,LAK,22,80,25,35,60
95,8478519,Anthony Cirelli,C,TBL,27,82,22,38,60
95,8477409,Carter Verhaeghe,C,FLA,29,80,33,26,59
95,8482093,Seth Jarvis,C,CAR,22,70,31,28,59
95,8478856,Conor Garland,R,VAN,28,75,30,29,59
95,8478975,Mason Marchment,L,DAL,29,82,21,38,59
95,8479999,Casey Mittelstadt,C,COL,26,81,19,40,59
95,8480839,Rasmus Dahlin,D,BUF,24,71,14,45,59
95,8482665,Matty Beniers,C,SEA,22,70,28,30,58
95,8477964,Ivan Barbashev,C,VGK,29,78,28,30,58
95,8476479,Phillip Danault,C,LAK,31,77,16,42,58
95,8475765,Vladimir Tarasenko,R,DET,33,80,23,34,57
95,8475745,Charlie Coyle,C,BOS,32,80,16,41,57
95,8480014,Gabriel Vilardi,C,WPG,25,70,32,24,56
95,8480015,Owen Tippett,R,PHI,25,73,31,25,56
95,8475768,Jaden Schwartz,C,SEA,32,73,26,30,56
95,8474590,John Carlson,D,WSH,34,68,15,41,56
95,8475169,Evander Kane,L,EDM,33,76,27,28,55
95,8476346,Johnny Gaudreau,L,CBJ,31,67,16,39,55
95,8479410,Mikhail Sergachev,D,UTA,26,68,14,41,55
95,8475810,Bryan Rust,R,PIT,32,74,28,26,54
95,8478414,Timo Meier,R,NJD,28,75,24,30,54
95,8483431,Logan Cooley,C,UTA,20,73,22,32,54
95,8471215,Evgeni Malkin,C,PIT,38,75,21,33,54
95,8482699,Dylan Guenther,R,UTA,21,76,20,34,54
95,8483515,Juraj Slafkovsky,L,MTL,20,77,17,37,54
95,8476905,Chandler Stephenson,C,SEA,30,74,16,38,54
95,8475753,Justin Faulk,D,STL,32,70,12,42,54
95,8479325,Charlie McAvoy,D,BOS,27,79,8,46,54
95,8479400,Pierre-Luc Dubois,L,WSH,26,68,23,30,53
95,8477476,Artturi Lehkonen,L,COL,29,80,22,31,53
95,8480039,Martin Necas,C,CAR,25,72,21,32,53
95,8478439,Travis Konecny,R,PHI,27,75,19,34,53
95,8477021,Alex Kerfoot,C,UTA,30,78,18,35,53
95,8481711,Matias Maccelli,L,UTA,24,75,14,39,53
95,8477426,Nicholas Paul,L,TBL,29,81,28,24,52
95,8477407,Anthony Duclair,L,NYI,29,74,26,26,52
95,8481068,Yegor Sharangovich,C,CGY,26,75,25,27,52
95,8475158,Ryan O'Reilly,C,NSH,33,71,24,28,52
95,8476880,Tom Wilson,R,WSH,30,67,23,29,52
95,8475191,Reilly Smith,R,NYR,33,73,21,31,52
95,8477998,Warren Foegele,L,LAK,28,80,18,34,52
95,8476480,Vladislav Namestnikov,C,WPG,32,68,14,38,52
95,8477503,Max Domi,C,TOR,29,79,11,41,52
95,8475726,Tyler Toffoli,C,SJS,32,66,28,23,51
95,8476882,Teuvo Teravainen,C,CHI,30,70,23,28,51
95,8480028,Morgan Frost,C,PHI,25,79,20,31,51
95,8477494,Jonathan Drouin,L,COL,29,81,17,34,51
95,8476875,Mike Matheson,D,MTL,30,74,10,41,51
95,8481604,Pavel Dorofeyev,L,VGK,24,69,26,24,50
95,8478498,Jake DeBrusk,L,VAN,28,72,24,26,50
95,8476448,William Karlsson,C,VGK,31,78,20,30,50
95,8479542,Brandon Hagel,L,TBL,26,82,19,31,50
95,8482097,Jack Quinn,R,BUF,23,71,17,33,50
95,8471698,T.J. Oshie,R,WSH,38,74,26,23,49
95,8475170,Brayden Schenn,C,STL,33,72,24,25,49
95,8480064,Josh Norris,C,OTT,25,75,23,26,49
95,8474150,Mikael Backlund,C,CGY,35,78,20,29,49
95,8482149,Cole Perfetti,C,WPG,22,68,20,29,49
95,8478233,Andrew Mangiapane,L,WSH,28,70,19,30,49
95,8471724,Kris Letang,D,PIT,37,81,18,31,49
95,8481542,Moritz Seider,D,DET,23,78,6,43,49
95,8479525,Ross Colton,C,COL,28,80,35,13,48
95,8482113,Anton Lundell,C,FLA,23,78,25,23,48
95,8484153,Leo Carlsson,C,ANA,20,77,19,29,48
95,8477444,Andre Burakovsky,L,SEA,29,68,19,29,48
95,8470613,Brent Burns,D,CAR,39,78,17,31,48
95,8478366,Frank Vatrano,R,ANA,30,68,32,15,47
95,8481540,Cole Caufield,R,MTL,23,74,25,22,47
95,8476292,Ondrej Palat,L,NJD,33,64,24,23,47
95,8477429,Andrew Copp,C,DET,30,80,22,25,47
95,8480185,Eetu Luostarinen,C,FLA,26,75,22,25,47
95,8474586,Jordan Eberle,R,SEA,34,77,21,26,47
95,8477935,Sam Bennett,C,FLA,28,77,20,27,47
95,8481528,Dylan Cozens,C,BUF,23,72,19,28,47
95,8474102,David Perron,L,OTT,36,79,17,30,47
95,8482092,Ridly Greig,C,OTT,22,80,17,30,47
95,8477456,J.T. Compher,L,DET,29,81,15,32,47
95,8478397,Rasmus Andersson,D,CGY,28,75,9,38,47
95,8477511,Anthony Mantha,R,CGY,30,76,25,21,46
95,8483808,Andrei Kuzmenko,L,CGY,28,73,22,24,46
95,8475793,Ryan Johansen,C,PHI,32,70,21,25,46
95,8481533,Trevor Zegras,C,ANA,23,75,19,27,46
95,8478438,Tommy Novak,C,NSH,27,68,14,32,46
95,8477986,Brandon Montour,D,SEA,30,72,13,33,46
95,8476432,Boone Jenner,C,CBJ,31,71,32,13,45
95,8478474,Lawson Crouse,L,UTA,27,75,23,22,45
95,8476872,Scott Laughton,C,PHI,30,76,21,24,45
95,8478458,John (Jack) Roslovic,C,CAR,27,69,19,26,45
95,8482702,Logan Stankoven,C,DAL,21,80,18,27,45
95,8482745,Mason McTavish,C,ANA,21,67,16,29,45
95,8473986,Alex Killorn,L,ANA,35,72,16,29,45
95,8474679,Gustav Nyquist,C,NSH,35,69,15,30,45
95,8476792,Torey Krug,D,STL,33,73,8,37,45
95,8478407,Vince Dunn,D,SEA,28,75,7,38,45
95,8477932,Aaron Ekblad,D,FLA,28,74,4,41,45
95,8479992,Michael Rasmussen,C,DET,25,79,21,23,44
95,8482720,Matthew Knies,L,TOR,22,71,19,25,44
95,8476483,Rickard Rakell,R,PIT,31,66,19,25,44
95,8477497,Sean Monahan,C,CBJ,30,63,16,28,44
95,8478469,Thomas Chabot,D,OTT,27,77,15,29,44
95,8482105,Jake Sanderson,D,OTT,22,74,10,34,44
95,8476869,Brady Skjei,D,NSH,30,69,10,34,44
95,8482159,Tyson Foerster,R,PHI,22,73,21,22,43
95,8478472,Mathieu Joseph,R,STL,27,65,20,23,43
95,8481618,Alex Newhook,C,MTL,23,75,17,26,43
95,8478115,Pierre Engvall,L,NYI,28,77,17,26,43
95,8478542,Evan Rodrigues,C,FLA,31,77,14,29,43
95,8481524,Bowen Byram,D,BUF,23,65,12,31,43
95,8481581,Thomas Harley,D,DAL,23,71,11,32,43
95,8477346,MacKenzie Weegar,D,CGY,30,78,9,34,43
95,8479987,Morgan Geekie,C,BOS,26,77,18,24,42
95,8476474,Stefan Noesen,R,NJD,31,64,17,25,42
95,8476399,Blake Coleman,C,CGY,33,77,16,26,42
95,8475151,Kyle Palmieri,C,NYI,33,79,16,26,42
95,8475218,Mattias Ekholm,D,EDM,34,73,13,29,42
95,8475314,Anders Lee,L,NYI,34,78,22,19,41
95,8481554,Kaapo Kakko,R,NYR,23,70,22,19,41
95,8475799,Nino Niederreiter,R,WPG,32,70,19,22,41
95,8480188,Fabian Zetterlund,L,SJS,25,69,18,23,41
95,8480849,Barrett Hayton,C,UTA,24,78,16,25,41
95,8482712,Oskar Olausson,R,COL,22,80,7,34,41
95,8474565,Alex Pietrangelo,D,VGK,34,59,9,31,40
95,8476854,Hampus Lindholm,D,BOS,30,77,8,32,40
95,8480009,Eeli Tolvanen,R,SEA,25,72,19,20,39
95,8483505,Matthew Poitras,C,BOS,20,72,15,24,39
95,8478042,Viktor Arvidsson,L,EDM,31,72,14,25,39
95,8479345,Jakob Chychrun,D,WSH,26,65,14,25,39
95,8476958,Jaccob Slavin,D,CAR,30,71,12,27,39
95,8479351,Sam Steel,C,DAL,26,81,10,29,39
95,8476906,Shayne Gostisbehere,D,CAR,31,67,6,33,39
95,8476438,Brandon Saad,L,STL,32,64,24,14,38
95,8480113,Alex Iafallo,L,WPG,31,72,22,16,38
95,8484166,Adam Fantilli,C,CBJ,20,72,20,18,38
95,8480829,Jesperi Kotkaniemi,C,CAR,24,66,17,21,38
95,8475149,Marcus Johansson,L,MIN,34,65,17,21,38
95,8482667,William Eklund,L,SJS,22,70,16,22,38
95,8480434,Sean Durzi,D,UTA,26,74,16,22,38
95,8476458,Ryan Strome,C,ANA,31,66,13,25,38
95,8482122,Brock Faber,D,MIN,22,74,7,31,38
95,8479339,Patrik Laine,L,CBJ,26,63,19,18,37
95,8480893,Kirill Marchenko,R,CBJ,24,60,18,19,37
95,8477451,Ryan Hartman,R,MIN,30,67,15,22,37
95,8478109,Victor Olofsson,L,VGK,29,66,14,23,37
95,8482110,Dawson Mercer,C,NJD,23,70,13,24,37
95,8481186,Logan O'Connor,R,COL,28,79,12,25,37
95,8482660,Kent Johnson,C,CBJ,22,65,11,26,37
95,8476419,Jean-Gabriel Pageau,C,NYI,32,79,9,28,37
95,8475200,Dmitry Orlov,D,CAR,33,75,6,31,37
95,8481596,Shane Pinto,C,OTT,24,77,18,18,36
95,8476392,Adam Lowry,C,WPG,31,63,16,20,36
95,8481560,Arthur Kaliyev,R,LAK,23,75,15,21,36
95,8478462,Nicolas Roy,C,VGK,27,73,12,24,36
95,8476826,Yanni Gourde,C,SEA,33,71,12,24,36
95,8477498,Darnell Nurse,D,EDM,29,69,11,25,36
95,8474563,Drew Doughty,D,LAK,35,70,9,27,36
95,8478038,Devon Toews,D,COL,30,63,8,28,36
95,8477495,Seth Jones,D,CHI,30,71,7,29,36
95,8479425,Filip Hronek,D,VAN,27,71,4,32,36
95,8474149,Evgenii Dadonov,R,DAL,35,79,16,19,35
95,8484145,Zach Benson,L,BUF,19,70,16,19,35
95,8479365,Trent Frederic,C,BOS,26,75,16,19,35
95,8483499,Liam Ohgren,L,MIN,20,62,15,20,35
95,8480078,Filip Chytil,C,NYR,25,66,14,21,35
95,8473563,Nicklas Backstrom,C,WSH,37,57,14,21,35
95,8476462,Dougie Hamilton,D,NJD,31,64,12,23,35
95,8477505,Alexander Wennberg,C,SJS,30,61,11,24,35
95,8481577,Philip Tomasino,C,NSH,23,67,8,27,35
95,8474641,Adam Henrique,C,EDM,34,77,18,16,34
95,8480068,Ryan Poehling,C,PHI,25,78,15,19,34
95,8475714,Calle Jarnkrok,C,TOR,33,76,13,21,34
95,8478057,Dakota Joshua,C,VAN,28,60,13,21,34
95,8482133,Thomas Bordeleau,C,SJS,22,66,8,26,34
95,8482475,Yegor Chinakhov,R,CBJ,23,65,13,20,33
95,8475193,Tomas Tatar,L,NJD,34,66,13,20,33
95,8480797,Joel Farabee,L,PHI,24,74,12,21,33
95,8475763,Kevin Hayes,R,PIT,32,68,12,21,33
95,8477506,Ryan Pulock,D,NYI,30,79,11,22,33
95,8478055,Gustav Forsling,D,FLA,28,71,10,23,33
95,8482671,Owen Power,D,BUF,22,72,10,23,33
95,8476923,Damon Severson,D,CBJ,30,81,8,25,33
95,8474716,Jared Spurgeon,D,MIN,35,73,7,26,33
95,8481606,Jordan Spence,D,LAK,23,68,4,29,33
95,8478020,Michael Amadio,R,OTT,28,72,16,16,32
95,8474053,Logan Couture,C,SJS,35,65,15,17,32
95,8475722,Jason Zucker,L,BUF,32,68,15,17,32
95,8482705,Cole Sillinger,C,CBJ,21,69,13,19,32
95,8481580,Connor McMichael,C,WSH,23,62,13,19,32
95,8480220,Noah Cates,L,PHI,25,68,11,21,32
95,8478891,Mason Appleton,C,WPG,28,68,9,23,32
95,8476885,Jacob Trouba,D,NYR,30,67,6,26,32
95,8474715,Cameron Atkinson,R,TBL,35,82,17,14,31
95,8474189,Lars Eller,C,PIT,35,64,16,15,31
95,8475760,Nick Bjugstad,C,UTA,32,76,14,17,31
95,8478046,Danton Heinen,L,VAN,29,73,13,18,31
95,8483524,Shane Wright,C,SEA,20,63,13,18,31
95,8480459,Pius Suter,C,VAN,28,72,13,18,31
95,8479353,Brett Howden,C,VGK,26,71,13,18,31
95,8475287,Erik Haula,L,NJD,33,69,11,20,31
95,8478466,Daniel Sprong,R,VAN,27,74,11,20,31
95,8477947,Sonny Milano,L,WSH,28,65,11,20,31
95,8481656,Aliaksei Protas,C,WSH,23,61,10,21,31
95,8481703,Valtteri Puustinen,R,PIT,25,62,6,25,31
95,8476463,Jonas Brodin,D,MIN,31,75,5,26,31
95,8480043,Timothy Liljegren,D,TOR,25,62,5,26,31
95,8482146,Luke Evangelista,R,NSH,22,70,19,11,30
95,8475848,Brendan Gallagher,R,MTL,32,71,17,13,30
95,8479293,Brandon Tanev,L,SEA,33,62,14,16,30
95,8478463,Anthony Beauvillier,L,PIT,27,65,14,16,30
95,8477353,Tyler Motte,C,DET,29,79,14,16,30
95,8475791,Taylor Hall,L,CHI,33,58,12,18,30
95,8477953,Kasperi Kapanen,R,STL,28,67,8,22,30
95,8478970,Jalen Chatfield,D,CAR,28,76,8,22,30
95,8480817,K'Andre Miller,D,NYR,24,69,7,23,30
95,8475171,Oliver Ekman-Larsson,D,TOR,33,66,6,24,30
95,8480336,Sean Walker,D,CAR,30,74,2,28,30
95,8479941,Justin Danforth,R,CBJ,31,66,13,16,29
95,8476927,Teddy Blueger,C,VAN,30,70,12,17,29
95,8473422,Nick Foligno,L,CHI,37,58,12,17,29
95,8481553,Bobby Brink,R,PHI,23,70,11,18,29
95,8484203,Bradly Nadeau,L,CAR,19,65,11,18,29
95,8477488,Brett Pesce,D,NJD,30,72,6,23,29
95,8476917,Adam Pelech,D,NYI,30,77,3,26,29
95,8476278,Colin Blackwell,C,DAL,31,76,16,12,28
95,8480802,Ryan McLeod,C,BUF,25,65,15,13,28
95,8477478,William Carrier,L,CAR,30,57,13,15,28
95,8476921,Jordan Martinook,L,CAR,32,70,12,16,28
95,8482125,Alexander Holtz,R,VGK,22,68,12,16,28
95,8475343,Nic Dowd,C,WSH,34,64,10,18,28
95,8476461,Sean Couturier,C,PHI,32,60,7,21,28
95,8480145,Neal Pionk,D,WPG,29,71,6,22,28
95,8476979,Erik Gustafsson,D,DET,32,70,6,22,28
95,8480049,Dylan Samberg,D,WPG,25,64,6,22,28
95,8477425,Miles Wood,L,COL,29,79,16,11,27
95,8480835,Jack Drury,C,CAR,24,58,12,15,27
95,8478396,Noah Hanifin,D,VGK,27,64,8,19,27
95,8476467,Jamie Oleksiak,D,SEA,32,70,8,19,27
95,8480074,Alexandre Texier,C,STL,25,58,7,20,27
95,8473507,Jeff Petry,D,DET,37,76,6,21,27
95,8478136,Jake Middleton,D,MIN,28,76,5,22,27
95,8476429,Scott Mayfield,D,NYI,32,76,3,24,27
95,8481032,Paul Cotter,C,NJD,25,61,14,12,26
95,8482175,JJ Peterka,R,BUF,22,70,13,13,26
95,8479661,Tanner Jeannot,L,LAK,27,78,11,15,26
95,8481535,Nils Hoglander,L,VAN,24,71,11,15,26
95,8481523,Kirby Dach,C,MTL,23,70,10,16,26
95,8482117,Lukas Reichel,L,CHI,22,54,10,16,26
95,8480813,Joe Veleno,C,DET,24,77,8,18,26
95,8476902,Esa Lindell,D,DAL,30,74,5,21,26
95,8477969,Marcus Pettersson,D,PIT,28,76,3,23,26
95,8475181,Nick Leddy,D,STL,33,69,3,23,26
95,8474151,Ryan McDonagh,D,TBL,35,77,3,23,26
95,8480873,Rasmus Sandin,D,WSH,24,66,1,25,26
95,8475764,Cam Fowler,D,ANA,33,68,0,26,26
95,8482259,Bobby McMann,C,TOR,28,60,17,8,25
95,8476918,Jimmy Vesey,L,NYR,31,68,15,10,25
95,8482079,Marco Rossi,C,MIN,23,56,15,10,25
95,8479336,Carl Grundstrom,R,SJS,27,54,14,11,25
95,8482055,Drew O'Connor,L,PIT,26,64,13,12,25
95,8479393,Noah Gregor,L,OTT,26,76,13,12,25
95,8478432,Christian Fischer,R,DET,27,72,13,12,25
95,8480798,Philipp Kurashev,C,CHI,25,59,11,14,25
95,8482101,Danil Gushchin,L,SJS,22,55,11,14,25
95,8477987,Ryan Donato,C,CHI,28,63,11,14,25
95,8477479,Tyler Bertuzzi,L,CHI,29,60,10,15,25
95,8479316,Luke Kunin,C,SJS,27,57,10,15,25
95,8481477,Nico Sturm,C,SJS,29,52,10,15,25
95,8480144,David Kampf,C,TOR,29,73,9,16,25
95,8480871,Adam Boqvist,D,FLA,24,62,8,17,25
95,8478133,Jake Evans,C,MTL,28,70,8,17,25
95,8479976,Juuso Valimaki,D,UTA,26,69,2,23,25
95,8482089,Jake Neighbours,L,STL,22,68,20,4,24
95,8481582,Nicholas Robertson,L,TOR,23,70,14,10,24
95,8473453,Trevor Lewis,C,LAK,37,69,14,10,24
95,8481601,Simon Holmstrom,R,NYI,23,63,12,12,24
95,8479996,Cody Glass,C,NSH,25,56,10,14,24
95,8477989,Christian Dvorak,C,MTL,28,66,10,14,24
95,8477220,Nate Schmidt,D,FLA,33,71,10,14,24
95,8482679,Matt Coronato,R,CGY,22,67,8,16,24
95,8482148,Hendrix Lapierre,C,WSH,22,49,7,17,24
95,8476422,Mike Reilly,D,NYI,31,76,5,19,24
95,8476892,Colton Parayko,D,STL,31,68,4,20,24
95,8479982,Conor Timmins,D,TOR,26,54,4,20,24
95,8478882,Vladislav Gavrikov,D,LAK,29,64,3,21,24
95,8482067,Connor Mackey,D,NYR,28,60,2,22,24
95,8482155,Alex Laferriere,R,LAK,23,72,16,7,23
95,8481093,Rafael Harvey-Pinard,L,MTL,25,59,14,9,23
95,8479390,Taylor Raddysh,R,WSH,26,61,13,10,23
95,8482074,Connor Zary,C,CGY,23,58,12,11,23
95,8482157,Will Cuylle,L,NYR,22,61,12,11,23
95,8477839,Conor Sheary,L,TBL,32,82,11,12,23
95,8477952,Robby Fabbri,C,ANA,28,69,10,13,23
95,8483445,Cutter Gauthier,L,ANA,20,66,10,13,23
95,8477499,Rasmus Ristolainen,D,PHI,30,60,10,13,23
95,8477948,Travis Sanheim,D,PHI,28,65,8,15,23
95,8477507,Nikita Zadorov,D,BOS,29,65,7,16,23
95,8481522,Peyton Krebs,C,BUF,23,62,4,19,23
95,8479324,Ryan Lindgren,D,NYR,26,63,3,20,23
95,8475279,Ben Chiarot,D,DET,33,67,3,20,23
95,8483490,Pavel Mintyukov,D,ANA,21,76,2,21,23
95,8475462,Radko Gudas,D,ANA,34,66,2,21,23
95,8480891,Michael Kesselring,D,UTA,24,60,2,21,23
95,8478500,Ivan Provorov,D,CBJ,27,79,1,22,23
95,8474673,TJ Brodie,D,CHI,34,63,1,22,23
95,8478508,Yakov Trenin,C,MIN,27,61,16,6,22
95,8481013,Jonatan Berggren,R,DET,24,59,11,11,22
95,8478413,Jordan Greenway,L,BUF,27,62,10,12,22
95,8476469,Joel Armia,R,MTL,31,70,10,12,22
95,8482624,Daniil Miromanov,D,CGY,27,59,9,13,22
95,8476329,Travis Boyd,C,MIN,31,54,8,14,22
95,8477919,Frederick Gaudreau,C,MIN,31,58,8,14,22
95,8481441,Joe Snively,C,DET,28,55,7,15,22
95,8478911,Matt Roy,D,WSH,29,58,5,17,22
95,8480887,Jordan Harris,D,MTL,24,55,5,17,22
95,8476988,Matt Benning,D,SJS,30,67,4,18,22
95,8482142,Jamie Drysdale,D,PHI,22,68,4,18,22
95,8479398,Samuel Girard,D,COL,26,60,4,18,22
95,8482245,Artem Zub,D,OTT,29,69,3,19,22
95,8480748,Kiefer Sherwood,L,VAN,29,61,11,10,21
95,8470621,Corey Perry,R,EDM,39,64,10,11,21
95,8480789,Oliver Wahlstrom,R,NYI,24,70,10,11,21
95,8482737,Zack Bolduc,C,STL,21,65,9,12,21
95,8475220,Marcus Foligno,L,MIN,33,60,9,12,21
95,8479619,Michael Carcone,L,UTA,28,63,9,12,21
95,8482749,Joshua Roy,R,MTL,21,61,9,12,21
95,8480980,Connor Dewar,C,TOR,25,69,8,13,21
95,8483468,Jiri Kulich,C,BUF,20,52,7,14,21
95,8474034,Patrick Maroon,L,CHI,36,51,6,15,21
95,8479591,Michael Eyssimont,C,TBL,28,80,3,18,21
95,8477845,Trevor van Riemsdyk,D,WSH,33,62,3,18,21
95,8480855,Jack McBain,C,UTA,24,60,12,8,20
95,8477573,Nathan Walker,L,STL,30,54,12,8,20
95,8479344,Jesse Puljujarvi,R,PIT,26,55,12,8,20
95,8478043,Sam Lafferty,C,BUF,29,62,10,10,20
95,8480205,Emil Bemstrom,C,PIT,25,57,10,10,20
95,8476374,Sean Kuraly,C,CBJ,31,57,10,10,20
95,8480289,Morgan Barron,C,WPG,26,52,10,10,20
95,8475225,Craig Smith,C,CHI,35,55,9,11,20
95,8476925,Colton Sissons,C,NSH,31,68,8,12,20
95,8483493,Frank Nazar,C,CHI,20,63,7,13,20
95,8482809,Jackson Blake,R,CAR,21,52,7,13,20
95,8477979,Nicolas Aube-Kubel,R,BUF,28,62,7,13,20
95,8480252,Cole Guttman,C,CHI,25,43,7,13,20
95,8476960,Andreas Athanasiou,C,CHI,30,59,6,14,20
95,8476856,Mathew Dumba,D,DAL,30,74,6,14,20
95,8479998,Mikey Anderson,D,LAK,25,65,5,15,20
95,8481059,Scott Perunovich,D,STL,26,60,5,15,20
95,8476525,Colin Miller,D,WPG,32,64,3,17,20
95,8481014,Alexander Romanov,D,NYI,24,77,2,18,20
95,8478851,Alexandre Carrier,D,NSH,28,70,2,18,20
95,8474574,Tyler Myers,D,VAN,34,68,1,19,20
95,8478585,Derek Ryan,C,EDM,38,64,13,6,19
95,8476981,Josh Anderson,R,MTL,30,68,10,9,19
95,8476889,Radek Faksa,C,STL,30,66,9,10,19
95,8480281,Alexey Toropchenko,R,STL,25,51,9,10,19
95,8477406,Mattias Janmark,C,EDM,32,62,8,11,19
95,8480448,Parker Kelly,L,COL,25,75,6,13,19
95,8481546,Cam York,D,PHI,23,70,6,13,19
95,8479402,Jake Bean,D,CGY,26,66,5,14,19
95,8476457,Adam Larsson,D,SEA,32,65,4,15,19
95,8475790,Erik Gudbranson,D,CBJ,32,75,4,15,19
95,8478434,Keegan Kolesar,R,VGK,27,63,4,15,19
95,8478859,Niko Mikkola,D,FLA,28,54,4,15,19
95,8481521,Ronnie Attard,D,PHI,25,53,4,15,19
95,8481178,Egor Zamula,D,PHI,24,59,3,16,19
95,8476331,Dylan DeMelo,D,WPG,31,67,2,17,19
95,8479639,Dylan Coghlan,D,WPG,26,63,2,17,19
95,8477392,Hudson Fasching,R,NYI,29,60,14,4,18
95,8476897,Oskar Sundqvist,C,STL,30,61,9,9,18
95,8478013,Jake Walman,D,SJS,28,69,8,10,18
95,8480003,Jesper Boqvist,C,FLA,26,66,8,10,18
95,8481704,Juuso Parssinen,C,NSH,23,49,7,11,18
95,8478468,Jeremy Lauzon,D,NSH,27,60,7,11,18
95,8479370,Tyson Jost,C,CAR,26,58,6,12,18
95,8476891,Matthew Grzelcyk,D,PIT,30,73,6,12,18
95,8479983,Mario Ferraro,D,SJS,26,67,5,13,18
95,8477369,Carson Soucy,D,VAN,30,66,4,14,18
95,8482634,Alex Steeves,C,TOR,25,52,3,15,18
95,8480807,Mattias Samuelsson,D,BUF,24,52,2,16,18
95,8475233,David Savard,D,MTL,34,69,1,17,18
95,8477450,Jason Dickinson,C,CHI,29,60,11,6,17
95,8476878,Zemgus Girgensons,C,TBL,30,79,9,8,17
95,8481518,Nolan Foote,L,NJD,24,46,9,8,17
95,8481641,Joel Kiviranta,L,COL,28,74,9,8,17
95,8475855,Jesper Fast,R,CAR,33,56,8,9,17
95,8482111,Justin Barron,D,MTL,23,61,8,9,17
95,8481028,Martin Pospisil,C,CGY,25,53,7,10,17
95,8476874,Olli Maatta,D,DET,30,59,7,10,17
95,8476624,Barclay Goodrow,C,SJS,31,48,6,11,17
95,8475324,Nick Jensen,D,OTT,34,69,6,11,17
95,8482176,Wyatt Kaiser,D,CHI,22,58,5,12,17
95,8480246,Nick Perbix,D,TBL,26,75,4,13,17
95,8476879,Cody Ceci,D,EDM,31,70,3,14,17
95,8479980,Nicolas Hague,D,VGK,26,54,3,14,17
95,8476867,Brendan Gaunce,C,MIN,30,34,3,14,17
95,8478507,John Marino,D,UTA,27,65,0,17,17
95,8478569,Noel Acciari,C,PIT,33,55,9,7,16
95,8476822,Luke Glendening,C,TBL,35,78,9,7,16
95,8481517,Brett Leason,R,ANA,25,53,9,7,16
95,8479328,Julien Gauthier,R,NYI,27,62,9,7,16
95,8479066,Ryan Lomberg,L,CGY,30,64,8,8,16
95,8483495,Simon Nemec,D,NJD,20,58,7,9,16
95,8480021,Jack Studnicka,C,LAK,25,58,7,9,16
95,8482803,Olen Zellweger,D,ANA,21,70,6,10,16
95,8480796,Martin Fehervary,D,WSH,25,55,6,10,16
95,8479414,Nathan Bastian,R,NJD,27,62,6,10,16
95,8475842,Sam Carrick,C,NYR,32,56,5,11,16
95,8483482,Tristan Luneau,D,ANA,20,62,4,12,16
95,8475208,Brian Dumoulin,D,ANA,33,62,4,12,16
95,8478452,Caleb Jones,D,LAK,27,52,4,12,16
95,8475455,Brenden Dillon,D,NJD,34,67,4,12,16
95,8484149,Gavin Brindley,C,CBJ,20,54,4,12,16
95,8478451,Ethan Bear,D,WSH,27,58,4,12,16
95,8480878,Nils Lundkvist,D,DAL,24,68,3,13,16
95,8478399,Jonas Siegenthaler,D,NJD,27,58,3,13,16
95,8477435,Ryan Graves,D,PIT,29,75,2,14,16
95,8479026,Philippe Myers,D,TOR,27,56,2,14,16
95,8470600,Ryan Suter,D,STL,39,60,2,14,16
95,8475179,Dmitry Kulikov,D,FLA,34,62,0,16,16
95,8481624,Ilya Mikheyev,R,CHI,30,51,10,5,15
95,8477018,Ben Hutton,D,VGK,31,56,8,7,15
95,8482730,Brandt Clarke,D,LAK,21,51,8,7,15
95,8481716,Dmitri Voronkov,L,CBJ,24,42,8,7,15
95,8479671,Mathieu Olivier,R,CBJ,27,52,8,7,15
95,8477070,Liam O'Brien,C,UTA,30,51,7,8,15
95,8480845,Rasmus Kupari,C,WPG,24,39,7,8,15
95,8477015,Connor Brown,R,EDM,30,68,6,9,15
95,8477508,Curtis Lazar,C,NJD,29,57,5,10,15
95,8479944,Zach Aston-Reese,C,VGK,30,47,5,10,15
95,8479359,Beck Malenstyn,L,BUF,26,45,5,10,15
95,8480073,Erik Brannstrom,D,COL,25,59,4,11,15
95,8479291,Kevin Rooney,C,CGY,31,58,4,11,15
95,8480222,Sebastian Aho,D,PIT,28,70,3,12,15
95,8475188,Brayden McNabb,D,VGK,33,53,3,12,15
95,8478416,Erik Cernak,D,TBL,27,70,2,13,15
95,8471709,Marc-Edouard Vlasic,D,SJS,37,59,2,13,15
95,8481708,Zac Jones,D,NYR,24,53,2,13,15
95,8475231,Casey Cizikas,C,NYI,33,74,10,4,14
95,8477903,Garnet Hathaway,R,PHI,33,64,7,7,14
95,8476994,Vinnie Hinostroza,C,NSH,30,46,6,8,14
95,8479543,Michael Pezzetta,L,MTL,26,61,5,9,14
95,8480192,Johnathan Kovacevic,D,NJD,27,51,5,9,14
95,8482655,Janis Moser,D,TBL,24,78,3,11,14
95,8478178,Darren Raddysh,D,TBL,28,71,3,11,14
95,8480035,Henri Jokiharju,D,BUF,25,61,3,11,14
95,8475718,Justin Holl,D,DET,32,55,3,11,14
95,8481701,Santeri Hatakka,D,NJD,23,42,3,11,14
95,8477335,Kyle Burroughs,D,LAK,29,47,3,11,14
95,8483565,Nick Blankenburg,D,NSH,26,70,2,12,14
95,8481527,Kaedan Korczak,D,VGK,23,51,2,12,14
95,8480001,Urho Vaakanainen,D,ANA,25,65,2,12,14
95,8475690,Chris Tanev,D,TOR,35,67,2,12,14
95,8480172,Jan Rutta,D,SJS,34,63,2,12,14
95,8480007,Jonas Rondbjerg,R,VGK,25,36,2,12,14
95,8480860,Kevin Bahl,D,CGY,24,60,2,12,14
95,8471677,Jack Johnson,D,CBJ,37,74,1,13,14
95,8482659,Josh Doan,R,UTA,22,50,10,3,13
95,8473533,Jordan Staal,C,CAR,36,54,8,5,13
95,8477380,Jonny Brodzinski,C,NYR,31,53,6,7,13
95,8480025,MacKenzie Entwistle,R,FLA,25,61,5,8,13
95,8476934,Brock McGinn,L,ANA,30,52,5,8,13
95,8482744,James Malatesta,L,CBJ,21,39,5,8,13
95,8482095,Tyler Kleven,D,OTT,22,46,5,8,13
95,8481481,Blake Lizotte,C,PIT,27,58,4,9,13
95,8478443,Brandon Carlo,D,BOS,28,52,4,9,13
95,8474166,Alec Martinez,D,CHI,37,49,4,9,13
95,8482747,Brennan Othmann,L,NYR,21,40,4,9,13
95,8480762,Eric Robinson,L,CAR,29,52,3,10,13
95,8481568,Alex Vlasic,D,CHI,23,55,3,10,13
95,8476312,Josh Manson,D,COL,33,65,2,11,13
95,8483457,Lane Hutson,D,MTL,20,70,2,11,13
95,8476931,Jake McCabe,D,TOR,31,62,2,11,13
95,8482451,Mikael Pyyhtia,L,CBJ,23,38,2,11,13
95,8482073,Braden Schneider,D,NYR,23,66,1,12,13
95,8481019,David Gustafsson,C,WPG,24,45,1,12,13
95,8484911,Collin Graf,R,SJS,22,32,8,4,12
95,8480995,Pontus Holmberg,R,TOR,25,57,7,5,12
95,8483466,Kevin Korchinski,D,CHI,20,41,6,6,12
95,8477962,Brendan Lemieux,L,CAR,28,40,6,6,12
95,8479718,Alex Barré-Boulet,C,MTL,27,47,5,7,12
95,8480806,Isac Lundestrom,C,ANA,25,58,5,7,12
95,8482062,Cole Smith,L,NSH,29,59,5,7,12
95,8476967,Brett Kulak,D,EDM,30,66,4,8,12
95,8478421,A.J. Greer,L,FLA,28,58,4,8,12
95,8482192,Isaak Phillips,D,CHI,23,52,3,9,12
95,8482964,Arber Xhekaj,D,MTL,23,49,3,9,12
95,8481598,Philip Broberg,D,EDM,23,42,2,10,12
95,8481167,Brayden Pachal,D,CGY,25,41,2,10,12
95,8479368,Max Jones,L,BOS,26,57,1,11,12
95,8482087,Kaiden Guhle,D,MTL,22,59,1,11,12
95,8479439,Jacob MacDonald,D,COL,31,58,8,3,11
95,8480011,Klim Kostin,C,SJS,25,45,7,4,11
95,8476873,Mark Jankowski,C,NSH,30,52,7,4,11
95,8479638,Justin Brazeau,R,BOS,26,38,7,4,11
95,8481754,Nikita Nesterenko,C,ANA,23,38,6,5,11
95,8482166,Shakir Mukhamadullin,D,SJS,22,52,5,6,11
95,8479315,Joey Anderson,R,CHI,26,40,4,7,11
95,8474013,Ian Cole,D,UTA,35,47,4,7,11
95,8474090,Brendan Smith,D,DAL,35,56,4,7,11
95,8482859,Zack Ostapchuk,C,OTT,21,51,3,8,11
95,8480950,Ilya Lyubushkin,D,DAL,30,64,3,8,11
95,8481567,Henry Thrun,D,SJS,23,62,3,8,11
95,8483549,Lucas Condotta,L,MTL,27,27,3,8,11
95,8482666,Scott Morrow,D,CAR,22,51,3,8,11
95,8481600,Tobias Bjornfot,D,FLA,23,44,3,8,11
95,8480070,Ian Mitchell,D,BOS,25,43,3,8,11
95,8480058,Pierre-Olivier Joseph,D,STL,25,49,2,9,11
95,8480157,Calle Rosen,D,COL,30,52,2,9,11
95,8478840,Will Borgen,D,SEA,28,61,1,10,11
95,8479371,Dante Fabbro,D,NSH,26,60,0,11,11
95,8471817,Ryan Reaves,R,TOR,37,51,8,2,10
95,8478211,Dryden Hunt,L,CGY,29,56,7,3,10
95,8482807,Ethan Del Mastro,D,CHI,21,49,6,4,10
95,8479378,Logan Stanley,D,WPG,26,39,5,5,10
95,8479536,Axel Jonsson-Fjallby,L,WPG,26,38,5,5,10
95,8479520,Brandon Duhaime,R,WSH,27,44,5,5,10
95,8482145,Mavrik Bourque,C,DAL,22,45,5,5,10
95,8481599,Victor Soderstrom,D,UTA,23,42,4,6,10
95,8475750,Jon Merrill,D,MIN,32,66,4,6,10
95,8476952,Dominic Toninato,C,WPG,30,33,4,6,10
95,8483491,Ivan Miroshnichenko,L,WSH,20,51,3,7,10
95,8480355,Mark Kastelic,C,BOS,25,60,3,7,10
95,8477938,Haydn Fleury,D,WPG,28,49,3,7,10
95,8478450,Parker Wotherspoon,D,BOS,27,33,3,7,10
95,8477931,Tomas Nosek,L,FLA,32,59,2,8,10
95,8481537,Nikita Okhotiuk,D,CGY,24,48,2,8,10
95,8476441,Joel Edmundson,D,LAK,31,37,2,8,10
95,8479442,Troy Stecher,D,EDM,30,53,2,8,10
95,8477365,Connor Clifton,D,BUF,29,55,1,9,10
95,8478831,Kevin Stenlund,C,UTA,28,43,7,2,9
95,8479994,Jaret Anderson-Dolan,C,WPG,25,35,6,3,9
95,8482652,Walker Duehr,R,CGY,27,40,5,4,9
95,8482762,Simon Edvinsson,D,DET,21,54,4,5,9
95,8480441,Trey Fix-Wolansky,R,CBJ,25,35,4,5,9
95,8479772,Zack MacEwen,R,OTT,28,47,4,5,9
95,8483460,David Jiricek,D,CBJ,21,57,3,6,9
95,8478874,Adam Gaudette,R,OTT,28,38,3,6,9
95,8480245,Olle Lycksell,R,PHI,25,30,3,6,9
95,8476473,Connor Murphy,D,CHI,31,41,3,6,9
95,8478021,William Lagesson,D,DET,28,33,3,6,9
95,8480879,Jacob Bernard-Docker,D,OTT,24,50,2,7,9
95,8476372,Nick Seeler,D,PHI,31,44,2,7,9
95,8475177,Calvin de Haan,D,COL,33,44,2,7,9
95,8477446,Michael McCarron,R,NSH,29,59,7,1,8
95,8481789,Tye Kartye,L,SEA,23,35,5,3,8
95,8481161,Jake Christiansen,D,CBJ,25,45,4,4,8
95,8480848,Ty Dellandrea,C,SJS,24,42,4,4,8
95,8481617,Vasily Podkolzin,R,VAN,23,44,4,4,8
95,8475958,Michael Sgarbossa,C,WSH,32,34,4,4,8
95,8474567,Zach Bogosian,D,MIN,34,66,3,5,8
95,8477851,Jordan Oesterle,D,BOS,32,43,3,5,8
95,8482784,Zach Dean,C,STL,21,45,3,5,8
95,8477527,Ross Johnston,L,ANA,30,33,3,5,8
95,8477482,Zachary Sanford,L,CHI,30,30,2,6,8
95,8481147,Reese Johnson,C,MIN,26,38,2,6,8
95,8481609,Vladislav Kolyachonok,D,UTA,23,37,2,6,8
95,8478454,Noah Juulsen,D,VAN,27,36,2,6,8
95,8479576,Vincent Desharnais,D,VAN,28,28,2,6,8
95,8477034,Jaycob Megna,D,FLA,32,46,1,7,8
95,8479249,Andrew Poturalski,C,SJS,30,39,0,8,8
95,8480196,Jacob Bryson,D,BUF,27,43,0,8,8
95,8479348,Kale Clague,D,BUF,26,38,0,8,8
95,8478424,Jansen Harkins,C,ANA,27,42,5,2,7
95,8480727,Zach Whitecloud,D,VGK,28,47,4,3,7
95,8479981,Jonah Gadjovich,L,FLA,26,41,3,4,7
95,8475762,Derek Forbort,D,VAN,32,48,3,4,7
95,8481751,Lukas Rousek,R,BUF,25,32,2,5,7
95,8473446,Erik Johnson,D,PHI,36,46,1,6,7
95,8477401,John Hayden,C,SEA,29,28,1,6,7
95,8481550,Adam Beckman,L,NJD,23,39,1,6,7
95,8477384,Joshua Brown,D,EDM,30,40,1,6,7
95,8480834,Ty Emberson,D,SJS,24,27,1,6,7
95,8479369,Andrew Peeke,D,BOS,26,65,0,7,7
95,8479972,Mason Shaw,C,WPG,26,36,0,7,7
95,8481556,John Beecher,C,BOS,23,42,6,0,6
95,8482077,Dylan Holloway,L,EDM,23,45,5,1,6
95,8481532,Alex Turcotte,C,LAK,23,46,5,1,6
95,8484287,Cole McWard,D,VAN,23,26,5,1,6
95,8481122,Simon Benoit,D,TOR,26,40,4,2,6
95,8476913,Devin Shore,C,MIN,30,36,4,2,6
95,8478017,Mark Friedman,D,VAN,29,32,3,3,6
95,8483763,Maksymilian Szuber,D,UTA,22,28,3,3,6
95,8479372,Joshua Mahura,D,SEA,26,53,2,4,6
95,8474612,Travis Hamonic,D,OTT,34,43,2,4,6
95,8482172,Landon Slaggert,L,CHI,22,30,2,4,6
95,8482733,Logan Mailloux,D,MTL,31,33,2,4,6
95,8482858,Ryker Evans,D,SEA,23,25,2,4,6
95,8480990,Declan Chisholm,D,MIN,24,38,1,5,6
95,8481056,Spencer Stastney,D,NSH,24,31,0,6,6
95,8476442,Matt Nieto,L,PIT,32,45,3,2,5
95,8478146,Matthew Highmore,C,OTT,28,39,3,2,5
95,8482070,Mitchell Chaffee,R,TBL,26,47,3,2,5
95,8484258,Sam Malinski,D,COL,26,23,3,2,5
95,8482765,Isak Rosen,R,BUF,21,25,2,3,5
95,8480292,Carson Meyer,R,ANA,27,27,2,3,5
95,8479991,Jake Leschyshyn,C,NYR,25,26,2,3,5
95,8480880,Jakub Lauko,C,MIN,24,31,2,3,5
95,8479419,Brett Murray,L,BUF,26,16,2,3,5
95,8483012,Logan Morrison,C,SEA,22,44,2,3,5
95,8477971,Andreas Englund,D,LAK,28,37,2,3,5
95,8479986,Kole Lind,R,DAL,26,52,1,4,5
95,8477887,Patrick Brown,C,BOS,32,43,1,4,5
95,8477149,Scott Sabourin,R,SJS,32,20,1,4,5
95,8477473,Justin Bailey,R,SJS,29,29,0,5,5
95,8479379,Givani Smith,R,SJS,26,30,4,0,4
95,8481679,Maxence Guenette,D,OTT,23,29,4,0,4
95,8484254,Akito Hirose,D,VAN,25,39,3,1,4
95,8484325,Waltteri Merela,C,TBL,26,21,3,1,4
95,8479367,William Lockwood,R,FLA,26,29,3,1,4
95,8482144,Jack Thompson,D,SJS,22,26,2,2,4
95,8481592,Jakob Pelletier,L,CGY,23,39,2,2,4
95,8477462,Robert Hagg,D,VGK,29,25,2,2,4
95,8480844,Grigori Denisenko,L,VGK,24,32,2,2,4
95,8482153,Brendan Brisson,C,VGK,23,33,2,2,4
95,8481543,Nikita Alexandrov,C,STL,24,27,2,2,4
95,8482496,Nils Aman,C,VAN,24,34,2,2,4
95,8482177,Marat Khusnutdinov,C,MIN,22,40,2,2,4
95,8482470,Ilya Solovyov,D,CGY,24,15,2,2,4
95,8481206,John Ludvig,D,PIT,24,11,2,2,4
95,8477467,Gustav Olofsson,D,SEA,30,22,1,3,4
95,8483570,Ben Meyers,C,SEA,26,25,1,3,4
95,8482141,Lukas Cormier,D,VGK,22,16,1,3,4
95,8477810,Joel Hanley,D,CGY,33,24,1,3,4
95,8483397,Marc McLaughlin,C,BOS,25,35,1,3,4
95,8480851,Akil Thomas,C,LAK,24,17,1,3,4
95,8481699,Aku Raty,R,UTA,23,14,1,3,4
95,8482516,Matthew Kessel,D,STL,24,24,1,3,4
95,8478502,Dennis Gilbert,D,BUF,28,27,1,3,4
95,8480870,Bo Groulx,C,NYR,24,31,0,4,4
95,8482929,Emil Lilleberg,D,TBL,23,20,0,4,4
95,8479362,Riley Tufte,L,BOS,26,18,3,0,3
95,8479968,Vinni Lettieri,C,BOS,29,44,2,1,3
95,8476858,Phillip Di Giuseppe,L,VAN,31,33,2,1,3
95,8483630,Pavol Regenda,L,ANA,25,34,2,1,3
95,8482713,Mackie Samoskevich,R,FLA,22,32,2,1,3
95,8481541,Samuel Bolduc,D,NYI,24,18,2,1,3
95,8477073,Kurtis MacDermid,L,NJD,30,34,2,1,3
95,8481030,Jack St. Ivany,D,PIT,25,18,1,2,3
95,8479985,Cale Fleury,D,SEA,26,23,1,2,3
95,8478011,Louie Belpedio,D,PHI,28,14,1,2,3
95,8482147,Jean-Luc Foudy,C,COL,22,19,1,2,3
95,8482118,Sam Colangelo,R,ANA,23,14,1,2,3
95,8481422,Jake Lucchini,C,NSH,29,28,1,2,3
95,8480032,Shane Bowers,C,NJD,25,15,1,2,3
95,8478409,Anthony Richard,C,PHI,28,29,0,3,3
95,8482511,Mason Lohrei,D,BOS,23,35,0,3,3
95,8482165,Yan Kuznetsov,D,CGY,22,26,0,3,3
95,8478051,Max Willman,C,NJD,29,19,0,3,3
95,8479320,Maxime Lajoie,D,SEA,27,26,0,3,3
95,8482250,Callahan Burke,C,VGK,27,30,0,3,3
95,8482094,Daemon Hunt,D,MIN,22,17,0,3,3
95,8482162,Roby Jarventie,L,EDM,22,20,0,3,3
95,8483597,Milos Kelemen,L,UTA,25,18,0,3,3
95,8475235,Nicolas Deslauriers,L,PHI,33,48,2,0,2
95,8481743,Marc Del Gaizo,D,NSH,25,18,2,0,2
95,8481065,Angus Crookshank,L,OTT,25,14,2,0,2
95,8483395,Arshdeep Bains,L,VAN,23,12,2,0,2
95,8478147,Bokondji Imama,L,PIT,28,9,2,0,2
95,8482751,Ryan Winterton,C,SEA,21,34,1,1,2
95,8483512,Matthew Savoie,C,EDM,20,21,1,1,2
95,8482861,Vincent Iorio,D,WSH,22,29,1,1,2
95,8481462,Mason Morelli,L,VGK,28,12,1,1,2
95,8480468,James Hamblin,L,EDM,25,20,1,1,2
95,8481043,Cole Koepke,L,BOS,26,18,1,1,2
95,8482061,Brandon Biro,L,SEA,26,14,1,1,2
95,8481585,Egor Afanasyev,L,SJS,23,18,1,1,2
95,8482201,Gage Goncalves,C,TBL,23,25,1,1,2
95,8482088,Justin Sourdif,R,FLA,22,16,1,1,2
95,8483407,Brandon Scanlin,D,NYR,25,5,1,1,2
95,8475795,Dylan McIlrath,D,WSH,32,16,1,1,2
95,8474568,Luke Schenn,D,NSH,35,39,0,2,2
95,8483619,Filip Roos,D,OTT,25,33,0,2,2
95,8479587,Rhett Gardner,C,PHI,28,17,0,2,2
95,8481593,Jayden Struble,D,MTL,23,22,0,2,2
95,8482102,Vasily Ponomarev,C,PIT,22,18,0,2,2
95,8481237,Kyle MacLean,C,NYI,25,28,0,2,2
95,8475413,Justin Dowling,C,NJD,34,20,0,2,2
95,8483531,Brian Halonen,L,NJD,25,5,0,2,2
95,8478477,Mitchell Stephens,C,SEA,27,20,1,0,1
95,8480075,Cameron Crotty,D,MIN,25,7,1,0,1
95,8475780,Chris Wagner,R,COL,33,10,1,0,1
95,8481719,Maxwell Crozier,D,TBL,24,16,1,0,1
95,8482476,Emil Heineman,L,MTL,23,3,1,0,1
95,8481605,Jackson LaCombe,D,ANA,23,23,0,1,1
95,8481726,Adam Edstrom,C,NYR,24,7,0,1,1
95,8480084,Nick DeSimone,D,NJD,30,13,0,1,1
95,8477320,Anton Blidh,L,NYR,29,13,0,1,1
95,8478881,Brett Seney,L,CHI,28,12,0,1,1
95,8480823,Alexander Alexeyev,D,WSH,25,13,0,1,1
95,8481006,Tyler Tucker,D,STL,24,19,0,1,1
95,8480874,Adam Ginning,D,PHI,24,11,0,1,1
95,8482460,Matt Rempe,C,NYR,22,14,0,1,1
95,8482787,Nikita Chibrikov,R,WPG,31,8,0,1,1
95,8483920,Pierrick Dube,R,WSH,23,4,0,1,1
95,8481578,Graeme Clarke,R,MIN,23,11,0,1,1
95,8483471,Brad Lambert,C,WPG,31,9,0,1,1
95,8478854,Ryan Shea,D,PIT,27,7,0,1,1
95,8479522,Hardy Haman Aktell,D,WSH,26,2,0,1,1
95,8477244,Chad Ruhwedel,D,NYR,34,35,0,0,0
95,8481806,Louis Crevier,D,CHI,23,13,0,0,0
95,8480267,Sammy Walker,C,MIN,25,19,0,0,0
95,8483546,Marshall Rifai,D,TOR,26,6,0,0,0
95,8474062,Riley Nash,C,NYR,35,22,0,0,0
95,8483489,Fraser Minten,C,TOR,31,10,0,0,0
95,8481564,Ryan Johnson,D,BUF,23,8,0,0,0
95,8475755,Alexander Petrovic,D,DAL,32,7,0,0,0
95,8483567,Georgii Merkulov,C,BOS,24,6,0,0,0
95,8484304,Uvis Balinskis,D,FLA,28,8,0,0,0
95,8478446,Glenn Gawdin,C,LAK,27,8,0,0,0
95,8477993,Justin Kirkland,C,CGY,28,6,0,0,0
95,8481534,Raphael Lavoie,C,EDM,24,5,0,0,0
95,8483432,Luca Del Bel Belluz,C,CBJ,31,6,0,0,0
95,8480890,Jan Jenik,C,OTT,24,21,0,0,0
95,8481024,Linus Karlsson,C,VAN,25,5,0,0,0
95,8482197,Adam Raska,R,MIN,23,5,0,0,0
95,8481655,Cole Schwindt,R,CGY,23,5,0,0,0
95,8483609,Adam Klapka,R,CGY,24,1,0,0,0
95,8477541,Dakota Mermis,D,TOR,30,7,0,0,0
95,8480306,Grant Hutton,D,NYI,29,8,0,0,0
95,8479330,Brandon Gignac,C,MTL,27,7,0,0,0
95,8482126,Emil Andrae,D,PHI,31,2,0,0,0
95,8479421,Jacob Moverare,D,LAK,26,1,0,0,0
95,8483398,Declan Carlile,D,TBL,31,7,0,0,0
95,8484255,Jason Polin,R,COL,25,3,0,0,0
95,8476323,Max McCormick,L,SEA,32,1,0,0,0
95,8484321,Nikolas Matinpalo,D,OTT,26,2,0,0,0
95,8483401,Marc Johnstone,R,PIT,28,1,0,0,0
95,8484326,Patrik Koch,D,UTA,28,2,0,0,0
95,8478956,Samuel Laberge,L,NJD,27,1,0,0,0
95,8480274,Philip Kemp,D,EDM,25,3,0,0,0
95,8484259,Ondrej Pavel,C,COL,31,0,0,0,0
95,8470794,Joe Pavelski,C,,40,0,0,0,0
95,8479321,Lucas Johansen,D,,27,0,0,0,0
95,8477950,Tony DeAngelo,D,,29,0,0,0,0
95,8471218,Blake Wheeler,R,,38,0,0,0,0
95,8475197,Tyson Barrie,D,,33,0,0,0,0
95,8474157,Max Pacioretty,L,,36,0,0,0,0
95,8475744,Evgeny Kuznetsov,C,,32,0,0,0,0
95,8474037,James van Riemsdyk,L,,35,0,0,0,0
95,8476907,Mackenzie MacEachern,L,,30,0,0,0,0
95,8480216,Jacob Peterson,C,,25,0,0,0,0
95,8474602,Justin Schultz,D,,34,0,0,0,0
95,8482222,Alexander Barabanov,L,,30,0,0,0,0
95,8474031,Kevin Shattenkirk,D,,35,0,0,0,0
95,8477330,Dominik Kubalik,L,,29,0,0,0,0
95,8480884,Calen Addison,D,,24,0,0,0,0
95,8475906,John Klingberg,D,,32,0,0,0,0
95,8480008,Adam Ruzicka,C,,25,0,0,0,0
95,8476884,Derrick Pouliot,D,,30,0,0,0,0
95,8476919,Chris Tierney,C,,30,0,0,0,0
95,8479415,Michael McLeod,C,,26,0,0,0,0
95,8474870,Tyler Johnson,C,,34,0,0,0,0
95,8470604,Jeff Carter,C,,39,0,0,0,0
95,8478104,Sammy Blais,L,,28,0,0,0,0
95,8474884,Mike Hoffman,C,,35,0,0,0,0
95,8481591,Sam Poulin,R,,23,0,0,0,0
95,8471274,Alex Goligoski,D,,39,0,0,0,0
95,8476871,Tanner Pearson,L,,32,0,0,0,0
95,8476393,Nick Cousins,C,,31,0,0,0,0
95,8479977,Kailer Yamamoto,R,,26,0,0,0,0
95,8479346,Dillon Dube,C,,26,0,0,0,0
95,8480184,Gustav Lindstrom,D,,26,0,0,0,0
95,8479376,Victor Mete,D,,26,0,0,0,0
95,8473449,Kyle Okposo,R,,36,0,0,0,0
95,8481058,Jesse Ylonen,R,,25,0,0,0,0
95,8475752,Tyler Pitlick,C,,33,0,0,0,0
95,8481239,Samuel Fagemo,L,,24,0,0,0,0
95,8480821,Filip Zadina,R,,25,0,0,0,0
95,8470966,Mark Giordano,D,,41,0,0,0,0
95,8478495,Denis Gurianov,R,,27,0,0,0,0
95,8477464,Nic Petan,C,,29,0,0,0,0
95,8478099,Kevin Labanc,R,,29,0,0,0,0
95,8482241,Radim Zohorna,L,,28,0,0,0,0
95,8474040,Sam Gagner,C,,35,0,0,0,0
95,8479514,Rem Pitlick,C,,27,0,0,0,0
95,8478430,Oliver Kylington,D,,27,0,0,0,0
95,8479533,Joona Koppanen,L,,26,0,0,0,0
95,8479984,Cal Foote,D,,26,0,0,0,0
95,8477126,Jayson Megna,C,,34,0,0,0,0
95,8475164,Jakob Silfverberg,R,,34,0,0,0,0
95,8474009,Nick Bonino,C,,36,0,0,0,0
95,8479458,Nikita Zaitsev,D,,33,0,0,0,0
95,8477944,Jakub Vrana,L,,28,0,0,0,0
95,8471699,Andrew Cogliano,C,,37,0,0,0,0
95,8478067,Oskar Lindblom,L,,28,0,0,0,0
95,8471686,Marc Staal,D,,37,0,0,0,0
95,8470610,Zach Parise,L,,40,0,0,0,0
95,8478904,Steven Lorentz,C,,28,0,0,0,0
95,8473473,Milan Lucic,L,,36,0,0,0,0
95,8480031,Maxime Comtois,L,,25,0,0,0,0
95,8478512,Austin Czarnik,C,,32,0,0,0,0
95,8473504,Cal Clutterbuck,R,,37,0,0,0,0
95,8477454,Adam Erne,L,,29,0,0,0,0
95,8479383,Boris Katchouk,L,,26,0,0,0,0
95,8475825,Jani Hakanpää,D,,32,0,0,0,0
95,8477846,Ryan Carpenter,C,,33,0,0,0,0
95,8477930,Pierre-Edouard Bellemare,L,,39,0,0,0,0
95,8478400,Colin White,C,,27,0,0,0,0
95,8480226,Marián Studenic,R,,26,0,0,0,0
95,8480853,Liam Foudy,C,,24,0,0,0,0
95,8475797,Jarred Tinordi,D,,32,0,0,0,0
95,8479423,Alex Nylander,L,,26,0,0,0,0
95,8474618,Marco Scandella,D,,34,0,0,0,0
95,8478028,Fredrik Olofsson,L,,28,0,0,0,0
95,8474709,Matt Martin,L,,35,0,0,0,0
95,8481070,Hugh McGing,L,,26,0,0,0,0
95,8479546,Oskar Steen,C,,26,0,0,0,0
95,8474145,Robert Bortuzzo,D,,35,0,0,0,0
95,8476915,Jujhar Khaira,L,,30,0,0,0,0
95,8475278,Byron Froese,C,,33,0,0,0,0
95,8481812,Nikolai Knyzhov,D,,27,0,0,0,0
95,8478408,Travis Dermott,D,,28,0,0,0,0
95,8481077,John Leonard,L,,26,0,0,0,0
95,8479547,Matthew Phillips,R,,26,0,0,0,0
95,8480836,Jonathan Gruden,C,,24,0,0,0,0
95,8481690,Tyler Angle,C,,24,0,0,0,0
95,8475766,Austin Watson,L,,32,0,0,0,0
95,8481016,Ruslan Iskhakov,C,,24,0,0,0,0
95,8478078,Rourke Chartier,C,,28,0,0,0,0
95,8480776,Sheldon Rempal,R,,29,0,0,0,0
95,8483045,Cameron Butler,R,CBJ,31,0,0,0,0
95,8484314,Jiri Smejkal,L,,28,0,0,0,0
96,8478402,Connor McDavid,C,EDM,27,77,44,94,138
96,8478483,Mitch Marner,R,TOR,27,80,38,91,129
96,8477492,Nathan MacKinnon,C,COL,29,81,55,73,128
96,8477956,David Pastrnak,R,BOS,28,79,52,73,125
96,8476453,Nikita Kucherov,R,TBL,31,82,35,88,123
96,8479318,Auston Matthews,C,TOR,27,79,70,48,118
96,8478420,Mikko Rantanen,R,COL,28,81,46,68,114
96,8476468,J.T. Miller,C,VAN,31,80,37,70,107
96,8481559,Jack Hughes,C,NJD,23,77,43,61,104
96,8478550,Artemi Panarin,L,NYR,33,80,38,66,104
96,8480800,Quinn Hughes,D,VAN,25,74,15,84,99
96,8478398,Kyle Connor,L,WPG,28,79,44,54,98
96,8477934,Leon Draisaitl,C,EDM,29,76,36,62,98
96,8480027,Jason Robertson,L,DAL,25,81,39,57,96
96,8479314,Matthew Tkachuk,L,FLA,27,77,30,66,96
96,8480801,Brady Tkachuk,L,OTT,25,80,35,59,94
96,8476459,Mika Zibanejad,C,NYR,31,82,28,65,93
96,8471675,Sidney Crosby,C,PIT,37,74,45,46,91
96,8477939,William Nylander,R,TOR,28,80,43,46,89
96,8477404,Jake Guentzel,C,TBL,30,81,41,48,89
96,8477933,Sam Reinhart,C,FLA,29,77,40,47,87
96,8477940,Nikolaj Ehlers,L,WPG,28,74,31,56,87
96,8477493,Aleksander Barkov,C,FLA,29,76,25,62,87
96,8478449,Roope Hintz,C,DAL,28,81,35,50,85
96,8482116,Tim Stützle,C,OTT,22,80,27,58,85
96,8478864,Kirill Kaprizov,L,MIN,27,68,40,44,84
96,8476389,Vincent Trocheck,C,NYR,31,76,38,46,84
96,8478427,Sebastian Aho,C,CAR,27,70,34,50,84
96,8480023,Robert Thomas,C,STL,25,72,26,58,84
96,8475166,John Tavares,C,TOR,34,80,34,49,83
96,8484144,Connor Bedard,C,CHI,19,69,24,58,82
96,8475786,Zach Hyman,L,EDM,32,75,44,37,81
96,8474564,Steven Stamkos,C,NSH,34,78,34,47,81
96,8479343,Clayton Keller,R,UTA,26,78,33,48,81
96,8481557,Matt Boldy,L,MIN,23,76,30,51,81
96,8478445,Mathew Barzal,C,NYI,27,78,26,55,81
96,8476456,Jonathan Huberdeau,C,CGY,31,79,25,56,81
96,8477960,Adrian Kempe,R,LAK,28,82,35,45,80
96,8479323,Adam Fox,D,NYR,26,71,13,67,80
96,8476887,Filip Forsberg,L,NSH,30,74,42,37,79
96,8475913,Mark Stone,R,VGK,32,74,32,47,79
96,8480002,Nico Hischier,C,NJD,25,76,31,48,79
96,8471214,Alex Ovechkin,L,WSH,39,73,41,37,78
96,8476454,Ryan Nugent-Hopkins,C,EDM,31,78,22,56,78
96,8478403,Jack Eichel,C,VGK,28,76,35,41,76
96,8477942,Kevin Fiala,L,LAK,28,79,28,48,76
96,8471215,Evgeni Malkin,C,PIT,38,71,24,52,76
96,8477504,Josh Morrissey,D,WPG,29,74,14,62,76
96,8480012,Elias Pettersson,C,VAN,26,75,27,48,75
96,8475172,Nazem Kadri,C,CGY,34,80,25,50,75
96,8480069,Cale Makar,D,COL,26,76,22,53,75
96,8479407,Jesper Bratt,L,NJD,26,74,16,59,75
96,8480036,Miro Heiskanen,D,DAL,25,74,13,62,75
96,8475754,Brock Nelson,C,NYI,33,81,34,39,73
96,8481540,Cole Caufield,R,MTL,23,75,34,39,73
96,8476460,Mark Scheifele,C,WPG,31,69,29,44,73
96,8477949,Alex Tuch,R,BUF,28,76,24,49,73
96,8478493,Joel Eriksson Ek,C,MIN,27,72,33,39,72
96,8478010,Brayden Point,C,TBL,28,82,41,30,71
96,8482078,Lucas Raymond,L,DET,22,79,32,39,71
96,8480830,Andrei Svechnikov,R,CAR,24,72,30,41,71
96,8474600,Roman Josi,D,NSH,34,71,19,52,71
96,8477946,Dylan Larkin,C,DET,28,78,34,36,70
96,8477501,Valeri Nichushkin,R,COL,29,81,34,36,70
96,8479385,Jordan Kyrou,C,STL,26,77,30,39,69
96,8478975,Mason Marchment,L,DAL,29,82,30,39,69
96,8480039,Martin Necas,C,CAR,25,71,26,43,69
96,8474141,Patrick Kane,R,DET,36,80,33,35,68
96,8477951,Nick Schmaltz,C,UTA,28,78,30,38,68
96,8478444,Brock Boeser,R,VAN,27,75,27,40,67
96,8478439,Travis Konecny,R,PHI,27,76,24,43,67
96,8480208,Drake Batherson,R,OTT,26,80,23,44,67
96,8479420,Tage Thompson,C,BUF,27,71,34,32,66
96,8479675,Trevor Moore,L,LAK,29,79,33,33,66
96,8476448,William Karlsson,C,VGK,31,77,27,39,66
96,8481068,Yegor Sharangovich,C,CGY,26,79,29,36,65
96,8476905,Chandler Stephenson,C,SEA,30,79,22,43,65
96,8476881,Tomas Hertl,C,VGK,31,78,26,38,64
96,8479337,Alex DeBrincat,R,DET,27,80,25,39,64
96,8477500,Bo Horvat,C,NYI,29,82,25,39,64
96,8477964,Ivan Barbashev,C,VGK,29,73,23,41,64
96,8475692,Mats Zuccarello,R,MIN,37,73,17,47,64
96,8474578,Erik Karlsson,D,PIT,34,75,16,48,64
96,8480839,Rasmus Dahlin,D,BUF,24,66,14,50,64
96,8480865,Noah Dobson,D,NYI,24,82,11,53,64
96,8478047,Michael Bunting,L,PIT,29,73,24,39,63
96,8482159,Tyson Foerster,R,PHI,22,76,24,39,63
96,8479542,Brandon Hagel,L,TBL,26,82,29,33,62
96,8477476,Artturi Lehkonen,L,COL,29,78,26,36,62
96,8473994,Jamie Benn,L,DAL,35,81,22,40,62
96,8476346,Johnny Gaudreau,L,CBJ,31,71,16,46,62
96,8475168,Matt Duchene,C,DAL,33,80,26,35,61
96,8477416,Oliver Bjorkstrand,R,SEA,29,74,20,41,61
96,8478856,Conor Garland,R,VAN,28,77,35,25,60
96,8476483,Rickard Rakell,R,PIT,31,78,32,28,60
96,8478414,Timo Meier,R,NJD,28,72,24,36,60
96,8478873,Troy Terry,R,ANA,27,74,21,39,60
96,8479999,Casey Mittelstadt,C,COL,26,81,19,41,60
96,8471685,Anze Kopitar,C,LAK,37,81,16,44,60
96,8480803,Evan Bouchard,D,EDM,25,76,12,48,60
96,8475184,Chris Kreider,L,NYR,33,73,42,17,59
96,8477409,Carter Verhaeghe,C,FLA,29,75,37,22,59
96,8477496,Elias Lindholm,C,BOS,30,73,27,32,59
96,8475158,Ryan O'Reilly,C,NSH,33,73,25,34,59
96,8475784,Jeff Skinner,C,EDM,32,77,24,35,59
96,8478038,Devon Toews,D,COL,30,65,12,47,59
96,8476853,Morgan Rielly,D,TOR,30,70,11,48,59
96,8475151,Kyle Palmieri,C,NYI,33,78,31,27,58
96,8476539,Jonathan Marchessault,R,NSH,34,73,30,28,58
96,8477935,Sam Bennett,C,FLA,28,80,27,31,58
96,8482740,Wyatt Johnston,C,DAL,21,79,22,36,58
96,8473419,Brad Marchand,L,BOS,36,77,15,43,58
96,8478407,Vince Dunn,D,SEA,28,71,13,45,58
96,8480064,Josh Norris,C,OTT,25,80,29,28,57
96,8475794,Tyler Seguin,C,DAL,32,81,26,31,57
96,8477955,Jared McCann,L,SEA,28,77,26,31,57
96,8482093,Seth Jarvis,C,CAR,22,68,23,34,57
96,8478460,Zach Werenski,D,CBJ,27,79,18,39,57
96,8481711,Matias Maccelli,L,UTA,24,75,14,42,56
96,8474586,Jordan Eberle,R,SEA,34,73,29,26,55
96,8475169,Evander Kane,L,EDM,33,75,25,30,55
96,8473512,Claude Giroux,R,OTT,36,75,20,35,55
96,8482124,Quinton Byfield,R,LAK,22,80,20,35,55
96,8481533,Trevor Zegras,C,ANA,23,69,20,35,55
96,8477494,Jonathan Drouin,L,COL,29,82,16,39,55
96,8471724,Kris Letang,D,PIT,37,81,16,39,55
96,8476875,Mike Matheson,D,MTL,30,76,10,45,55
96,8481703,Valtteri Puustinen,R,PIT,25,66,10,45,55
96,8475765,Vladimir Tarasenko,R,DET,33,81,24,30,54
96,8480018,Nick Suzuki,C,MTL,25,78,20,34,54
96,8481596,Shane Pinto,C,OTT,24,70,20,34,54
96,8477402,Pavel Buchnevich,L,STL,29,76,19,35,54
96,8475798,Mikael Granlund,C,SJS,32,67,13,41,54
96,8475167,Victor Hedman,D,TBL,34,79,10,44,54
96,8482699,Dylan Guenther,R,UTA,21,73,22,31,53
96,8477451,Ryan Hartman,R,MIN,30,72,21,32,53
96,8475191,Reilly Smith,R,NYR,33,74,18,35,53
96,8479325,Charlie McAvoy,D,BOS,27,79,10,43,53
96,8475726,Tyler Toffoli,C,SJS,32,70,30,22,52
96,8482665,Matty Beniers,C,SEA,22,71,26,26,52
96,8481528,Dylan Cozens,C,BUF,23,69,26,26,52
96,8477407,Anthony Duclair,L,NYI,29,79,24,28,52
96,8476399,Blake Coleman,C,CGY,33,78,24,28,52
96,8475810,Bryan Rust,R,PIT,32,73,22,30,52
96,8482745,Mason McTavish,C,ANA,21,74,20,32,52
96,8477497,Sean Monahan,C,CBJ,30,69,20,32,52
96,8482684,Luke Hughes,D,NJD,21,76,7,45,52
96,8476432,Boone Jenner,C,CBJ,31,68,29,22,51
96,8482667,William Eklund,L,SJS,22,72,16,35,51
96,8479425,Filip Hronek,D,VAN,27,69,7,44,51
96,8479400,Pierre-Luc Dubois,L,WSH,26,74,24,26,50
96,8474590,John Carlson,D,WSH,34,69,10,40,50
96,8478519,Anthony Cirelli,C,TBL,27,81,22,27,49
96,8483515,Juraj Slafkovsky,L,MTL,20,72,21,28,49
96,8478462,Nicolas Roy,C,VGK,27,78,20,29,49
96,8474565,Alex Pietrangelo,D,VGK,34,65,15,34,49
96,8479345,Jakob Chychrun,D,WSH,26,67,14,35,49
96,8477986,Brandon Montour,D,SEA,30,73,13,36,49
96,8474102,David Perron,L,OTT,36,76,25,23,48
96,8481560,Arthur Kaliyev,R,LAK,23,77,23,25,48
96,8474149,Evgenii Dadonov,R,DAL,35,79,22,26,48
96,8478233,Andrew Mangiapane,L,WSH,28,70,20,28,48
96,8479339,Patrik Laine,L,CBJ,26,62,20,28,48
96,8480028,Morgan Frost,C,PHI,25,72,16,32,48
96,8475745,Charlie Coyle,C,BOS,32,77,22,25,47
96,8475768,Jaden Schwartz,C,SEA,32,67,21,26,47
96,8478440,Dylan Strome,C,WSH,27,72,18,29,47
96,8477998,Warren Foegele,L,LAK,28,77,16,31,47
96,8481604,Pavel Dorofeyev,L,VGK,24,73,26,20,46
96,8479525,Ross Colton,C,COL,28,80,22,24,46
96,8474150,Mikael Backlund,C,CGY,35,76,18,28,46
96,8477932,Aaron Ekblad,D,FLA,28,74,15,31,46
96,8480188,Fabian Zetterlund,L,SJS,25,62,15,31,46
96,8481524,Bowen Byram,D,BUF,23,73,14,32,46
96,8476882,Teuvo Teravainen,C,CHI,30,66,17,28,45
96,8475170,Brayden Schenn,C,STL,33,74,16,29,45
96,8477503,Max Domi,C,TOR,29,78,14,31,45
96,8478469,Thomas Chabot,D,OTT,27,70,13,32,45
96,8477346,MacKenzie Weegar,D,CGY,30,77,12,33,45
96,8483490,Pavel Mintyukov,D,ANA,21,77,9,36,45
96,8482113,Anton Lundell,C,FLA,23,79,23,21,44
96,8477444,Andre Burakovsky,L,SEA,29,71,15,29,44
96,8478458,John (Jack) Roslovic,C,CAR,27,64,15,29,44
96,8476419,Jean-Gabriel Pageau,C,NYI,32,74,20,23,43
96,8474641,Adam Henrique,C,EDM,34,75,18,25,43
96,8478542,Evan Rodrigues,C,FLA,31,76,16,27,43
96,8476826,Yanni Gourde,C,SEA,33,71,14,29,43
96,8476479,Phillip Danault,C,LAK,31,82,13,30,43
96,8477447,Shea Theodore,D,VGK,29,60,8,35,43
96,8478498,Jake DeBrusk,L,VAN,28,74,22,20,42
96,8480459,Pius Suter,C,VAN,28,70,22,20,42
96,8478366,Frank Vatrano,R,ANA,30,70,21,21,42
96,8475799,Nino Niederreiter,R,WPG,32,62,21,21,42
96,8482109,Alexis Lafrenière,L,NYR,23,71,20,22,42
96,8482149,Cole Perfetti,C,WPG,22,69,19,23,42
96,8477021,Alex Kerfoot,C,UTA,30,76,16,26,42
96,8475848,Brendan Gallagher,R,MTL,32,71,14,28,42
96,8477429,Andrew Copp,C,DET,30,81,13,29,42
96,8482660,Kent Johnson,C,CBJ,22,61,13,29,42
96,8482720,Matthew Knies,L,TOR,22,74,11,31,42
96,8478055,Gustav Forsling,D,FLA,28,72,11,31,42
96,8476906,Shayne Gostisbehere,D,CAR,31,75,7,35,42
96,8480014,Gabriel Vilardi,C,WPG,25,63,25,16,41
96,8478472,Mathieu Joseph,R,STL,27,70,21,20,41
96,8478057,Dakota Joshua,C,VAN,28,67,21,20,41
96,8483808,Andrei Kuzmenko,L,CGY,28,74,20,21,41
96,8484166,Adam Fantilli,C,CBJ,20,61,16,25,41
96,8484153,Leo Carlsson,C,ANA,20,76,15,26,41
96,8470613,Brent Burns,D,CAR,39,77,12,29,41
96,8477495,Seth Jones,D,CHI,30,74,11,30,41
96,8475753,Justin Faulk,D,STL,32,72,9,32,41
96,8481577,Philip Tomasino,C,NSH,23,70,9,32,41
96,8475714,Calle Jarnkrok,C,TOR,33,73,23,17,40
96,8482175,JJ Peterka,R,BUF,22,66,22,18,40
96,8477456,J.T. Compher,L,DET,29,79,17,23,40
96,8478401,Pavel Zacha,C,BOS,27,76,15,25,40
96,8482702,Logan Stankoven,C,DAL,21,80,15,25,40
96,8477479,Tyler Bertuzzi,L,CHI,29,67,15,25,40
96,8474679,Gustav Nyquist,C,NSH,35,72,10,30,40
96,8481542,Moritz Seider,D,DET,23,80,5,35,40
96,8476923,Damon Severson,D,CBJ,30,80,5,35,40
96,8474563,Drew Doughty,D,LAK,35,70,4,36,40
96,8482110,Dawson Mercer,C,NJD,23,68,24,15,39
96,8475314,Anders Lee,L,NYI,34,76,21,18,39
96,8475793,Ryan Johansen,C,PHI,32,72,19,20,39
96,8483431,Logan Cooley,C,UTA,20,71,18,21,39
96,8476880,Tom Wilson,R,WSH,30,72,14,25,39
96,8482092,Ridly Greig,C,OTT,22,77,14,25,39
96,8475218,Mattias Ekholm,D,EDM,34,79,12,27,39
96,8475764,Cam Fowler,D,ANA,33,72,6,33,39
96,8477948,Travis Sanheim,D,PHI,28,72,3,36,39
96,8477426,Nicholas Paul,L,TBL,29,82,23,15,38
96,8481618,Alex Newhook,C,MTL,23,72,18,20,38
96,8482705,Cole Sillinger,C,CBJ,21,66,17,21,38
96,8473986,Alex Killorn,L,ANA,35,73,16,22,38
96,8481186,Logan O'Connor,R,COL,28,82,16,22,38
96,8476458,Ryan Strome,C,ANA,31,68,14,24,38
96,8478463,Anthony Beauvillier,L,PIT,27,65,14,24,38
96,8478115,Pierre Engvall,L,NYI,28,75,13,25,38
96,8481581,Thomas Harley,D,DAL,23,75,7,31,38
96,8480015,Owen Tippett,R,PHI,25,75,22,15,37
96,8476885,Jacob Trouba,D,NYR,30,72,17,20,37
96,8473533,Jordan Staal,C,CAR,36,62,16,21,37
96,8480817,K'Andre Miller,D,NYR,24,70,8,29,37
96,8476438,Brandon Saad,L,STL,32,69,21,15,36
96,8476921,Jordan Martinook,L,CAR,32,66,17,19,36
96,8475287,Erik Haula,L,NJD,33,71,16,20,36
96,8478474,Lawson Crouse,L,UTA,27,74,15,21,36
96,8480797,Joel Farabee,L,PHI,24,73,14,22,36
96,8474189,Lars Eller,C,PIT,35,69,14,22,36
96,8476854,Hampus Lindholm,D,BOS,30,74,13,23,36
96,8482671,Owen Power,D,BUF,22,73,13,23,36
96,8481523,Kirby Dach,C,MTL,23,74,13,23,36
96,8480185,Eetu Luostarinen,C,FLA,26,76,8,28,36
96,8476792,Torey Krug,D,STL,33,71,8,28,36
96,8475200,Dmitry Orlov,D,CAR,33,71,7,29,36
96,8479410,Mikhail Sergachev,D,UTA,26,70,5,31,36
96,8480893,Kirill Marchenko,R,CBJ,24,67,19,16,35
96,8482089,Jake Neighbours,L,STL,22,70,19,16,35
96,8478042,Viktor Arvidsson,L,EDM,31,75,17,18,35
96,8482475,Yegor Chinakhov,R,CBJ,23,67,17,18,35
96,8471698,T.J. Oshie,R,WSH,38,66,16,19,35
96,8473422,Nick Foligno,L,CHI,37,64,16,19,35
96,8478466,Daniel Sprong,R,VAN,27,69,12,23,35
96,8482105,Jake Sanderson,D,OTT,22,70,9,26,35
96,8475171,Oliver Ekman-Larsson,D,TOR,33,65,8,27,35
96,8478397,Rasmus Andersson,D,CGY,28,74,7,28,35
96,8478396,Noah Hanifin,D,VGK,27,61,6,29,35
96,8479992,Michael Rasmussen,C,DET,25,80,14,20,34
96,8476469,Joel Armia,R,MTL,31,70,14,20,34
96,8481704,Juuso Parssinen,C,NSH,23,66,13,21,34
96,8477498,Darnell Nurse,D,EDM,29,75,12,22,34
96,8476462,Dougie Hamilton,D,NJD,31,71,11,23,34
96,8478438,Tommy Novak,C,NSH,27,65,10,24,34
96,8478891,Mason Appleton,C,WPG,28,67,10,24,34
96,8476461,Sean Couturier,C,PHI,32,68,10,24,34
96,8482097,Jack Quinn,R,BUF,23,68,8,26,34
96,8480145,Neal Pionk,D,WPG,29,76,4,30,34
96,8475722,Jason Zucker,L,BUF,32,61,18,15,33
96,8481624,Ilya Mikheyev,R,CHI,30,55,18,15,33
96,8477511,Anthony Mantha,R,CGY,30,74,16,17,33
96,8477425,Miles Wood,L,COL,29,80,16,17,33
96,8480009,Eeli Tolvanen,R,SEA,25,72,15,18,33
96,8482133,Thomas Bordeleau,C,SJS,22,58,11,22,33
96,8476869,Brady Skjei,D,NSH,30,76,10,23,33
96,8476463,Jonas Brodin,D,MIN,31,75,6,27,33
96,8479398,Samuel Girard,D,COL,26,64,3,30,33
96,8482055,Drew O'Connor,L,PIT,26,61,20,12,32
96,8477952,Robby Fabbri,C,ANA,28,64,17,15,32
96,8480829,Jesperi Kotkaniemi,C,CAR,24,69,15,17,32
96,8476292,Ondrej Palat,L,NJD,33,71,14,18,32
96,8478046,Danton Heinen,L,VAN,29,72,12,20,32
96,8480798,Philipp Kurashev,C,CHI,25,67,12,20,32
96,8478882,Vladislav Gavrikov,D,LAK,29,72,8,24,32
96,8480434,Sean Durzi,D,UTA,26,63,4,28,32
96,8478500,Ivan Provorov,D,CBJ,27,79,4,28,32
96,8478020,Michael Amadio,R,OTT,28,75,22,9,31
96,8482146,Luke Evangelista,R,NSH,22,65,15,16,31
96,8478413,Jordan Greenway,L,BUF,27,57,12,19,31
96,8480078,Filip Chytil,C,NYR,25,64,11,20,31
96,8475193,Tomas Tatar,L,NJD,34,68,11,20,31
96,8476958,Jaccob Slavin,D,CAR,30,78,8,23,31
96,8476979,Erik Gustafsson,D,DET,32,73,2,29,31
96,8480855,Jack McBain,C,UTA,24,70,16,14,30
96,8479393,Noah Gregor,L,OTT,26,72,14,16,30
96,8480849,Barrett Hayton,C,UTA,24,72,13,17,30
96,8479987,Morgan Geekie,C,BOS,26,80,12,18,30
96,8475763,Kevin Hayes,R,PIT,32,64,11,19,30
96,8474053,Logan Couture,C,SJS,35,57,11,19,30
96,8479661,Tanner Jeannot,L,LAK,27,77,11,19,30
96,8478911,Matt Roy,D,WSH,29,66,11,19,30
96,8479591,Michael Eyssimont,C,TBL,28,81,11,19,30
96,8482809,Jackson Blake,R,CAR,21,58,11,19,30
96,8482101,Danil Gushchin,L,SJS,22,56,9,21,30
96,8479353,Brett Howden,C,VGK,26,71,8,22,30
96,8481606,Jordan Spence,D,LAK,23,67,7,23,30
96,8475760,Nick Bjugstad,C,UTA,32,71,16,13,29
96,8476392,Adam Lowry,C,WPG,31,68,15,14,29
96,8480789,Oliver Wahlstrom,R,NYI,24,68,15,14,29
96,8479351,Sam Steel,C,DAL,26,81,13,16,29
96,8480835,Jack Drury,C,CAR,24,60,13,16,29
96,8481535,Nils Hoglander,L,VAN,24,66,13,16,29
96,8477450,Jason Dickinson,C,CHI,29,59,13,16,29
96,8477505,Alexander Wennberg,C,SJS,30,63,12,17,29
96,8479365,Trent Frederic,C,BOS,26,73,11,18,29
96,8481546,Cam York,D,PHI,23,68,10,19,29
96,8474716,Jared Spurgeon,D,MIN,35,76,9,20,29
96,8477969,Marcus Pettersson,D,PIT,28,80,7,22,29
96,8480336,Sean Walker,D,CAR,30,74,6,23,29
96,8476457,Adam Larsson,D,SEA,32,73,3,26,29
96,8476917,Adam Pelech,D,NYI,30,80,2,27,29
96,8480113,Alex Iafallo,L,WPG,31,65,16,12,28
96,8483491,Ivan Miroshnichenko,L,WSH,20,58,13,15,28
96,8483505,Matthew Poitras,C,BOS,20,76,12,16,28
96,8480068,Ryan Poehling,C,PHI,25,70,12,16,28
96,8477919,Frederick Gaudreau,C,MIN,31,66,12,16,28
96,8481441,Joe Snively,C,DET,28,70,11,17,28
96,8477839,Conor Sheary,L,TBL,32,81,10,18,28
96,8478133,Jake Evans,C,MTL,28,70,8,20,28
96,8482712,Oskar Olausson,R,COL,22,76,7,21,28
96,8482122,Brock Faber,D,MIN,22,75,7,21,28
96,8480043,Timothy Liljegren,D,TOR,25,69,3,25,28
96,8474151,Ryan McDonagh,D,TBL,35,76,3,25,28
96,8482079,Marco Rossi,C,MIN,23,64,15,12,27
96,8484203,Bradly Nadeau,L,CAR,19,65,13,14,27
96,8479316,Luke Kunin,C,SJS,27,50,13,14,27
96,8480748,Kiefer Sherwood,L,VAN,29,58,12,15,27
96,8475791,Taylor Hall,L,CHI,33,52,10,17,27
96,8477478,William Carrier,L,CAR,30,56,10,17,27
96,8479066,Ryan Lomberg,L,CGY,30,67,10,17,27
96,8476927,Teddy Blueger,C,VAN,30,66,9,18,27
96,8476925,Colton Sissons,C,NSH,31,63,8,19,27
96,8476892,Colton Parayko,D,STL,31,68,6,21,27
96,8480222,Sebastian Aho,D,PIT,28,77,4,23,27
96,8477947,Sonny Milano,L,WSH,28,65,12,14,26
96,8483499,Liam Ohgren,L,MIN,20,62,11,15,26
96,8476278,Colin Blackwell,C,DAL,31,74,11,15,26
96,8476480,Vladislav Namestnikov,C,WPG,32,72,10,16,26
96,8484145,Zach Benson,L,BUF,19,69,10,16,26
96,8478013,Jake Walman,D,SJS,28,74,10,16,26
96,8480871,Adam Boqvist,D,FLA,24,61,7,19,26
96,8476897,Oskar Sundqvist,C,STL,30,70,7,19,26
96,8480873,Rasmus Sandin,D,WSH,24,62,2,24,26
96,8479619,Michael Carcone,L,UTA,28,65,16,9,25
96,8477953,Kasperi Kapanen,R,STL,28,64,13,12,25
96,8481093,Rafael Harvey-Pinard,L,MTL,25,65,11,14,25
96,8476872,Scott Laughton,C,PHI,30,73,9,16,25
96,8476525,Colin Miller,D,WPG,32,62,8,17,25
96,8479315,Joey Anderson,R,CHI,26,46,8,17,25
96,8476422,Mike Reilly,D,NYI,31,77,6,19,25
96,8480891,Michael Kesselring,D,UTA,24,62,3,22,25
96,8481580,Connor McMichael,C,WSH,23,59,15,9,24
96,8482259,Bobby McMann,C,TOR,28,70,15,9,24
96,8479941,Justin Danforth,R,CBJ,31,56,14,10,24
96,8481601,Simon Holmstrom,R,NYI,23,69,14,10,24
96,8479390,Taylor Raddysh,R,WSH,26,63,13,11,24
96,8481554,Kaapo Kakko,R,NYR,23,69,12,12,24
96,8477392,Hudson Fasching,R,NYI,29,64,12,12,24
96,8481517,Brett Leason,R,ANA,25,54,12,12,24
96,8475149,Marcus Johansson,L,MIN,34,63,11,13,24
96,8478432,Christian Fischer,R,DET,27,74,11,13,24
96,8478109,Victor Olofsson,L,VGK,29,69,10,14,24
96,8473563,Nicklas Backstrom,C,WSH,37,57,8,16,24
96,8477987,Ryan Donato,C,CHI,28,61,8,16,24
96,8481521,Ronnie Attard,D,PHI,25,60,8,16,24
96,8483445,Cutter Gauthier,L,ANA,20,63,7,17,24
96,8483565,Nick Blankenburg,D,NSH,26,59,7,17,24
96,8478507,John Marino,D,UTA,27,72,4,20,24
96,8481014,Alexander Romanov,D,NYI,24,76,2,22,24
96,8480802,Ryan McLeod,C,BUF,25,60,14,9,23
96,8479336,Carl Grundstrom,R,SJS,27,56,14,9,23
96,8481582,Nicholas Robertson,L,TOR,23,65,12,11,23
96,8476981,Josh Anderson,R,MTL,30,72,11,12,23
96,8475231,Casey Cizikas,C,NYI,33,74,11,12,23
96,8483457,Lane Hutson,D,MTL,20,64,11,12,23
96,8480806,Isac Lundestrom,C,ANA,25,59,10,13,23
96,8477488,Brett Pesce,D,NJD,30,69,8,15,23
96,8477220,Nate Schmidt,D,FLA,33,73,8,15,23
96,8482157,Will Cuylle,L,NYR,22,65,8,15,23
96,8477989,Christian Dvorak,C,MTL,28,62,6,17,23
96,8479983,Mario Ferraro,D,SJS,26,69,6,17,23
96,8477506,Ryan Pulock,D,NYI,30,78,5,18,23
96,8475181,Nick Leddy,D,STL,33,65,3,20,23
96,8473507,Jeff Petry,D,DET,37,68,2,21,23
96,8474574,Tyler Myers,D,VAN,34,72,2,21,23
96,8480448,Parker Kelly,L,COL,25,76,14,8,22
96,8481032,Paul Cotter,C,NJD,25,56,13,9,22
96,8482730,Brandt Clarke,D,LAK,21,46,12,10,22
96,8482117,Lukas Reichel,L,CHI,22,61,11,11,22
96,8479414,Nathan Bastian,R,NJD,27,64,11,11,22
96,8481481,Blake Lizotte,C,PIT,27,62,11,11,22
96,8482125,Alexander Holtz,R,VGK,22,67,10,12,22
96,8475855,Jesper Fast,R,CAR,33,58,10,12,22
96,8478569,Noel Acciari,C,PIT,33,51,10,12,22
96,8480878,Nils Lundkvist,D,DAL,24,77,10,12,22
96,8476873,Mark Jankowski,C,NSH,30,57,9,13,22
96,8481656,Aliaksei Protas,C,WSH,23,66,8,14,22
96,8476329,Travis Boyd,C,MIN,31,55,7,15,22
96,8483524,Shane Wright,C,SEA,20,63,5,17,22
96,8479324,Ryan Lindgren,D,NYR,26,54,5,17,22
96,8476331,Dylan DeMelo,D,WPG,31,72,5,17,22
96,8479976,Juuso Valimaki,D,UTA,26,66,4,18,22
96,8475324,Nick Jensen,D,OTT,34,64,3,19,22
96,8476931,Jake McCabe,D,TOR,31,69,3,19,22
96,8477435,Ryan Graves,D,PIT,29,76,2,20,22
96,8480021,Jack Studnicka,C,LAK,25,64,12,9,21
96,8478434,Keegan Kolesar,R,VGK,27,70,11,10,21
96,8480144,David Kampf,C,TOR,29,76,10,11,21
96,8479994,Jaret Anderson-Dolan,C,WPG,25,36,10,11,21
96,8479293,Brandon Tanev,L,SEA,33,70,9,12,21
96,8480813,Joe Veleno,C,DET,24,78,8,13,21
96,8476889,Radek Faksa,C,STL,30,70,8,13,21
96,8479328,Julien Gauthier,R,NYI,27,66,8,13,21
96,8477507,Nikita Zadorov,D,BOS,29,69,7,14,21
96,8483493,Frank Nazar,C,CHI,20,50,7,14,21
96,8483468,Jiri Kulich,C,BUF,20,59,6,15,21
96,8476467,Jamie Oleksiak,D,SEA,32,67,5,16,21
96,8481522,Peyton Krebs,C,BUF,23,61,5,16,21
96,8476429,Scott Mayfield,D,NYI,32,70,1,20,21
96,8482077,Dylan Holloway,L,EDM,23,53,16,4,20
96,8480281,Alexey Toropchenko,R,STL,25,48,15,5,20
96,8480003,Jesper Boqvist,C,FLA,26,68,12,8,20
96,8477015,Connor Brown,R,EDM,30,63,11,9,20
96,8482074,Connor Zary,C,CGY,23,69,10,10,20
96,8482749,Joshua Roy,R,MTL,21,62,10,10,20
96,8479368,Max Jones,L,BOS,26,67,10,10,20
96,8482624,Daniil Miromanov,D,CGY,27,63,9,11,20
96,8477446,Michael McCarron,R,NSH,29,54,9,11,20
96,8480220,Noah Cates,L,PHI,25,70,8,12,20
96,8478043,Sam Lafferty,C,BUF,29,64,8,12,20
96,8476624,Barclay Goodrow,C,SJS,31,53,8,12,20
96,8476312,Josh Manson,D,COL,33,56,8,12,20
96,8479639,Dylan Coghlan,D,WPG,26,67,7,13,20
96,8482111,Justin Barron,D,MTL,23,58,7,13,20
96,8479291,Kevin Rooney,C,CGY,31,52,7,13,20
96,8480995,Pontus Holmberg,R,TOR,25,55,7,13,20
96,8482737,Zack Bolduc,C,STL,21,61,6,14,20
96,8476891,Matthew Grzelcyk,D,PIT,30,76,6,14,20
96,8481527,Kaedan Korczak,D,VGK,23,54,6,14,20
96,8479980,Nicolas Hague,D,VGK,26,57,4,16,20
96,8476902,Esa Lindell,D,DAL,30,75,3,17,20
96,8479998,Mikey Anderson,D,LAK,25,56,3,17,20
96,8480049,Dylan Samberg,D,WPG,25,60,2,18,20
96,8480807,Mattias Samuelsson,D,BUF,24,59,2,18,20
96,8474673,TJ Brodie,D,CHI,34,64,0,20,20
96,8476474,Stefan Noesen,R,NJD,31,68,11,8,19
96,8482679,Matt Coronato,R,CGY,22,61,10,9,19
96,8480252,Cole Guttman,C,CHI,25,39,9,10,19
96,8476960,Andreas Athanasiou,C,CHI,30,54,8,11,19
96,8482803,Olen Zellweger,D,ANA,21,64,8,11,19
96,8477380,Jonny Brodzinski,C,NYR,31,54,8,11,19
96,8483482,Tristan Luneau,D,ANA,20,59,7,12,19
96,8480025,MacKenzie Entwistle,R,FLA,25,56,7,12,19
96,8482166,Shakir Mukhamadullin,D,SJS,22,58,7,12,19
96,8480796,Martin Fehervary,D,WSH,25,62,5,14,19
96,8479982,Conor Timmins,D,TOR,26,59,4,15,19
96,8482067,Connor Mackey,D,NYR,28,65,4,15,19
96,8475233,David Savard,D,MTL,34,68,4,15,19
96,8479026,Philippe Myers,D,TOR,27,61,4,15,19
96,8481059,Scott Perunovich,D,STL,26,61,2,17,19
96,8482659,Josh Doan,R,UTA,22,51,14,4,18
96,8478508,Yakov Trenin,C,MIN,27,57,9,9,18
96,8480289,Morgan Barron,C,WPG,26,47,9,9,18
96,8475842,Sam Carrick,C,NYR,32,57,8,10,18
96,8477508,Curtis Lazar,C,NJD,29,68,8,10,18
96,8481553,Bobby Brink,R,PHI,23,62,7,11,18
96,8478831,Kevin Stenlund,C,UTA,28,51,7,11,18
96,8476856,Mathew Dumba,D,DAL,30,72,6,12,18
96,8477979,Nicolas Aube-Kubel,R,BUF,28,60,5,13,18
96,8474715,Cameron Atkinson,R,TBL,35,81,4,14,18
96,8478851,Alexandre Carrier,D,NSH,28,64,3,15,18
96,8475462,Radko Gudas,D,ANA,34,74,2,16,18
96,8479371,Dante Fabbro,D,NSH,26,67,2,16,18
96,8482192,Isaak Phillips,D,CHI,23,53,0,18,18
96,8477406,Mattias Janmark,C,EDM,32,64,10,7,17
96,8470621,Corey Perry,R,EDM,39,69,9,8,17
96,8476878,Zemgus Girgensons,C,TBL,30,79,9,8,17
96,8480980,Connor Dewar,C,TOR,25,66,8,9,17
96,8479520,Brandon Duhaime,R,WSH,27,52,8,9,17
96,8476918,Jimmy Vesey,L,NYR,31,70,7,10,17
96,8480192,Johnathan Kovacevic,D,NJD,27,60,7,10,17
96,8482142,Jamie Drysdale,D,PHI,22,65,5,12,17
96,8478970,Jalen Chatfield,D,CAR,28,69,4,13,17
96,8481178,Egor Zamula,D,PHI,24,53,4,13,17
96,8482073,Braden Schneider,D,NYR,23,60,4,13,17
96,8477365,Connor Clifton,D,BUF,29,58,3,14,17
96,8479402,Jake Bean,D,CGY,26,61,2,15,17
96,8482087,Kaiden Guhle,D,MTL,22,66,2,15,17
96,8482148,Hendrix Lapierre,C,WSH,22,49,8,8,16
96,8482176,Wyatt Kaiser,D,CHI,22,59,7,9,16
96,8477903,Garnet Hathaway,R,PHI,33,65,7,9,16
96,8477369,Carson Soucy,D,VAN,30,68,6,10,16
96,8476867,Brendan Gaunce,C,MIN,30,37,6,10,16
96,8481019,David Gustafsson,C,WPG,24,43,6,10,16
96,8480950,Ilya Lyubushkin,D,DAL,30,60,6,10,16
96,8482744,James Malatesta,L,CBJ,21,46,5,11,16
96,8477931,Tomas Nosek,L,FLA,32,69,5,11,16
96,8479344,Jesse Puljujarvi,R,PIT,26,54,4,12,16
96,8478136,Jake Middleton,D,MIN,28,74,3,13,16
96,8476988,Matt Benning,D,SJS,30,61,3,13,16
96,8475790,Erik Gudbranson,D,CBJ,32,77,2,14,16
96,8478178,Darren Raddysh,D,TBL,28,70,1,15,16
96,8481599,Victor Soderstrom,D,UTA,23,48,1,15,16
96,8480074,Alexandre Texier,C,STL,25,59,8,7,15
96,8479996,Cody Glass,C,NSH,25,57,8,7,15
96,8480205,Emil Bemstrom,C,PIT,25,54,8,7,15
96,8480007,Jonas Rondbjerg,R,VGK,25,45,7,8,15
96,8481537,Nikita Okhotiuk,D,CGY,24,56,7,8,15
96,8475279,Ben Chiarot,D,DET,33,66,6,9,15
96,8475220,Marcus Foligno,L,MIN,33,56,6,9,15
96,8478585,Derek Ryan,C,EDM,38,68,5,10,15
96,8476879,Cody Ceci,D,EDM,31,70,5,10,15
96,8481028,Martin Pospisil,C,CGY,25,52,4,11,15
96,8476874,Olli Maatta,D,DET,30,60,4,11,15
96,8480073,Erik Brannstrom,D,COL,25,66,4,11,15
96,8471709,Marc-Edouard Vlasic,D,SJS,37,54,3,12,15
96,8482655,Janis Moser,D,TBL,24,74,3,12,15
96,8480860,Kevin Bahl,D,CGY,24,62,3,12,15
96,8480246,Nick Perbix,D,TBL,26,76,2,13,15
96,8476967,Brett Kulak,D,EDM,30,62,2,13,15
96,8478399,Jonas Siegenthaler,D,NJD,27,54,1,14,15
96,8477938,Haydn Fleury,D,WPG,28,43,1,14,15
96,8481477,Nico Sturm,C,SJS,29,59,9,5,14
96,8475225,Craig Smith,C,CHI,35,54,9,5,14
96,8479671,Mathieu Olivier,R,CBJ,27,53,9,5,14
96,8476374,Sean Kuraly,C,CBJ,31,60,8,6,14
96,8480762,Eric Robinson,L,CAR,29,60,6,8,14
96,8480848,Ty Dellandrea,C,SJS,24,49,6,8,14
96,8477353,Tyler Motte,C,DET,29,68,5,9,14
96,8475343,Nic Dowd,C,WSH,34,62,5,9,14
96,8479249,Andrew Poturalski,C,SJS,30,38,5,9,14
96,8482634,Alex Steeves,C,TOR,25,44,4,10,14
96,8475208,Brian Dumoulin,D,ANA,33,55,4,10,14
96,8478452,Caleb Jones,D,LAK,27,61,4,10,14
96,8481708,Zac Jones,D,NYR,24,51,4,10,14
96,8478416,Erik Cernak,D,TBL,27,73,3,11,14
96,8480172,Jan Rutta,D,SJS,34,66,3,11,14
96,8477962,Brendan Lemieux,L,CAR,28,40,3,11,14
96,8480727,Zach Whitecloud,D,VGK,28,50,3,11,14
96,8480887,Jordan Harris,D,MTL,24,54,2,12,14
96,8482245,Artem Zub,D,OTT,29,62,2,12,14
96,8475179,Dmitry Kulikov,D,FLA,34,65,2,12,14
96,8479968,Vinni Lettieri,C,BOS,29,45,10,3,13
96,8483570,Ben Meyers,C,SEA,26,34,8,5,13
96,8477573,Nathan Walker,L,STL,30,46,6,7,13
96,8476822,Luke Glendening,C,TBL,35,79,6,7,13
96,8484149,Gavin Brindley,C,CBJ,20,55,6,7,13
96,8479718,Alex Barré-Boulet,C,MTL,27,45,6,7,13
96,8480011,Klim Kostin,C,SJS,25,47,6,7,13
96,8474166,Alec Martinez,D,CHI,37,47,5,8,13
96,8477482,Zachary Sanford,L,CHI,30,42,5,8,13
96,8480001,Urho Vaakanainen,D,ANA,25,56,3,10,13
96,8476952,Dominic Toninato,C,WPG,30,40,2,11,13
96,8475188,Brayden McNabb,D,VGK,33,58,0,13,13
96,8475690,Chris Tanev,D,TOR,35,55,0,13,13
96,8482155,Alex Laferriere,R,LAK,23,66,9,3,12
96,8471817,Ryan Reaves,R,TOR,37,51,8,4,12
96,8479944,Zach Aston-Reese,C,VGK,30,41,7,5,12
96,8483466,Kevin Korchinski,D,CHI,20,46,6,6,12
96,8476442,Matt Nieto,L,PIT,32,44,6,6,12
96,8479439,Jacob MacDonald,D,COL,31,51,5,7,12
96,8474090,Brendan Smith,D,DAL,35,51,5,7,12
96,8481518,Nolan Foote,L,NJD,24,49,4,8,12
96,8475718,Justin Holl,D,DET,32,55,3,9,12
96,8476994,Vinnie Hinostroza,C,NSH,30,43,1,11,12
96,8481568,Alex Vlasic,D,CHI,23,52,1,11,12
96,8474013,Ian Cole,D,UTA,35,43,0,12,12
96,8482861,Vincent Iorio,D,WSH,22,39,0,12,12
96,8481754,Nikita Nesterenko,C,ANA,23,47,8,3,11
96,8474034,Patrick Maroon,L,CHI,36,43,7,4,11
96,8481161,Jake Christiansen,D,CBJ,25,62,7,4,11
96,8482496,Nils Aman,C,VAN,24,34,7,4,11
96,8473453,Trevor Lewis,C,LAK,37,72,6,5,11
96,8476934,Brock McGinn,L,ANA,30,52,6,5,11
96,8482859,Zack Ostapchuk,C,OTT,21,52,6,5,11
96,8479359,Beck Malenstyn,L,BUF,26,43,5,6,11
96,8477018,Ben Hutton,D,VGK,31,37,4,7,11
96,8482964,Arber Xhekaj,D,MTL,23,48,4,7,11
96,8480355,Mark Kastelic,C,BOS,25,65,4,7,11
96,8482652,Walker Duehr,R,CGY,27,38,4,7,11
96,8480441,Trey Fix-Wolansky,R,CBJ,25,34,4,7,11
96,8475455,Brenden Dillon,D,NJD,34,54,3,8,11
96,8471677,Jack Johnson,D,CBJ,37,60,3,8,11
96,8480157,Calle Rosen,D,COL,30,44,3,8,11
96,8479372,Joshua Mahura,D,SEA,26,49,3,8,11
96,8479442,Troy Stecher,D,EDM,30,52,2,9,11
96,8477845,Trevor van Riemsdyk,D,WSH,33,60,1,10,11
96,8483460,David Jiricek,D,CBJ,21,55,1,10,11
96,8474567,Zach Bogosian,D,MIN,34,59,1,10,11
96,8481550,Adam Beckman,L,NJD,23,30,1,10,11
96,8478451,Ethan Bear,D,WSH,27,45,0,11,11
96,8482762,Simon Edvinsson,D,DET,21,62,8,2,10
96,8478421,A.J. Greer,L,FLA,28,55,7,3,10
96,8476858,Phillip Di Giuseppe,L,VAN,31,38,7,3,10
96,8483495,Simon Nemec,D,NJD,20,59,6,4,10
96,8478211,Dryden Hunt,L,CGY,29,49,6,4,10
96,8478424,Jansen Harkins,C,ANA,27,39,6,4,10
96,8481641,Joel Kiviranta,L,COL,28,72,5,5,10
96,8482784,Zach Dean,C,STL,21,40,5,5,10
96,8484911,Collin Graf,R,SJS,22,39,4,6,10
96,8481751,Lukas Rousek,R,BUF,25,45,4,6,10
96,8482733,Logan Mailloux,D,MTL,31,37,4,6,10
96,8476473,Connor Murphy,D,CHI,31,37,3,7,10
96,8476913,Devin Shore,C,MIN,30,33,3,7,10
96,8481598,Philip Broberg,D,EDM,23,40,2,8,10
96,8482451,Mikael Pyyhtia,L,CBJ,23,39,1,9,10
96,8477034,Jaycob Megna,D,FLA,32,49,1,9,10
96,8474612,Travis Hamonic,D,OTT,34,48,1,9,10
96,8482807,Ethan Del Mastro,D,CHI,21,48,6,3,9
96,8478017,Mark Friedman,D,VAN,29,41,6,3,9
96,8477499,Rasmus Ristolainen,D,PHI,30,53,4,5,9
96,8479370,Tyson Jost,C,CAR,26,45,4,5,9
96,8482062,Cole Smith,L,NSH,29,54,4,5,9
96,8482145,Mavrik Bourque,C,DAL,22,58,4,5,9
96,8480292,Carson Meyer,R,ANA,27,36,4,5,9
96,8483630,Pavol Regenda,L,ANA,25,30,4,5,9
96,8478468,Jeremy Lauzon,D,NSH,27,51,3,6,9
96,8478840,Will Borgen,D,SEA,28,66,3,6,9
96,8481567,Henry Thrun,D,SJS,23,49,2,7,9
96,8475750,Jon Merrill,D,MIN,32,59,2,7,9
96,8479972,Mason Shaw,C,WPG,26,36,2,7,9
96,8480035,Henri Jokiharju,D,BUF,25,61,1,8,9
96,8476441,Joel Edmundson,D,LAK,31,46,1,8,9
96,8470600,Ryan Suter,D,STL,39,63,0,9,9
96,8478443,Brandon Carlo,D,BOS,28,58,0,9,9
96,8475762,Derek Forbort,D,VAN,32,39,0,9,9
96,8479369,Andrew Peeke,D,BOS,26,57,0,9,9
96,8482858,Ryker Evans,D,SEA,23,24,5,3,8
96,8481013,Jonatan Berggren,R,DET,24,56,4,4,8
96,8480070,Ian Mitchell,D,BOS,25,42,4,4,8
96,8479638,Justin Brazeau,R,BOS,26,31,3,5,8
96,8482666,Scott Morrow,D,CAR,22,48,3,5,8
96,8480879,Jacob Bernard-Docker,D,OTT,24,48,3,5,8
96,8481056,Spencer Stastney,D,NSH,24,33,3,5,8
96,8473446,Erik Johnson,D,PHI,36,54,2,6,8
96,8481541,Samuel Bolduc,D,NYI,24,22,2,6,8
96,8482751,Ryan Winterton,C,SEA,21,34,2,6,8
96,8483619,Filip Roos,D,OTT,25,41,2,6,8
96,8482095,Tyler Kleven,D,OTT,22,47,1,7,8
96,8478450,Parker Wotherspoon,D,BOS,27,41,1,7,8
96,8477851,Jordan Oesterle,D,BOS,32,36,1,7,8
96,8479986,Kole Lind,R,DAL,26,47,1,7,8
96,8481789,Tye Kartye,L,SEA,23,34,6,1,7
96,8481716,Dmitri Voronkov,L,CBJ,24,44,4,3,7
96,8481617,Vasily Podkolzin,R,VAN,23,45,4,3,7
96,8477070,Liam O'Brien,C,UTA,30,46,3,4,7
96,8483549,Lucas Condotta,L,MTL,27,27,3,4,7
96,8481147,Reese Johnson,C,MIN,26,33,3,4,7
96,8481122,Simon Benoit,D,TOR,26,36,3,4,7
96,8479991,Jake Leschyshyn,C,NYR,25,25,3,4,7
96,8477887,Patrick Brown,C,BOS,32,50,3,4,7
96,8474568,Luke Schenn,D,NSH,35,46,3,4,7
96,8479543,Michael Pezzetta,L,MTL,26,58,2,5,7
96,8479772,Zack MacEwen,R,OTT,28,56,2,5,7
96,8478874,Adam Gaudette,R,OTT,28,44,2,5,7
96,8475177,Calvin de Haan,D,COL,33,47,2,5,7
96,8481679,Maxence Guenette,D,OTT,23,42,2,5,7
96,8482511,Mason Lohrei,D,BOS,23,36,2,5,7
96,8477384,Joshua Brown,D,EDM,30,35,0,7,7
96,8479536,Axel Jonsson-Fjallby,L,WPG,26,33,5,1,6
96,8481609,Vladislav Kolyachonok,D,UTA,23,35,4,2,6
96,8484287,Cole McWard,D,VAN,23,24,4,2,6
96,8479379,Givani Smith,R,SJS,26,35,4,2,6
96,8481600,Tobias Bjornfot,D,FLA,23,37,3,3,6
96,8476372,Nick Seeler,D,PHI,31,45,3,3,6
96,8481592,Jakob Pelletier,L,CGY,23,42,3,3,6
96,8482153,Brendan Brisson,C,VGK,23,35,3,3,6
96,8483397,Marc McLaughlin,C,BOS,25,35,3,3,6
96,8478409,Anthony Richard,C,PHI,28,25,3,3,6
96,8480267,Sammy Walker,C,MIN,25,20,3,3,6
96,8480870,Bo Groulx,C,NYR,24,34,2,4,6
96,8475235,Nicolas Deslauriers,L,PHI,33,50,2,4,6
96,8480890,Jan Jenik,C,OTT,24,26,2,4,6
96,8478859,Niko Mikkola,D,FLA,28,47,1,5,6
96,8475958,Michael Sgarbossa,C,WSH,32,22,1,5,6
96,8480990,Declan Chisholm,D,MIN,24,42,0,6,6
96,8477149,Scott Sabourin,R,SJS,32,18,0,6,6
96,8482070,Mitchell Chaffee,R,TBL,26,52,4,1,5
96,8479981,Jonah Gadjovich,L,FLA,26,49,3,2,5
96,8477401,John Hayden,C,SEA,29,30,3,2,5
96,8481556,John Beecher,C,BOS,23,37,3,2,5
96,8481532,Alex Turcotte,C,LAK,23,33,3,2,5
96,8483012,Logan Morrison,C,SEA,22,33,3,2,5
96,8477335,Kyle Burroughs,D,LAK,29,41,2,3,5
96,8480834,Ty Emberson,D,SJS,24,31,2,3,5
96,8483763,Maksymilian Szuber,D,UTA,22,29,2,3,5
96,8480880,Jakub Lauko,C,MIN,24,30,2,3,5
96,8479419,Brett Murray,L,BUF,26,21,2,3,5
96,8482177,Marat Khusnutdinov,C,MIN,22,32,2,3,5
96,8480468,James Hamblin,L,EDM,25,19,2,3,5
96,8481043,Cole Koepke,L,BOS,26,18,2,3,5
96,8481701,Santeri Hatakka,D,NJD,23,38,1,4,5
96,8478146,Matthew Highmore,C,OTT,28,27,1,4,5
96,8484258,Sam Malinski,D,COL,26,23,1,4,5
96,8482141,Lukas Cormier,D,VGK,22,28,1,4,5
96,8479985,Cale Fleury,D,SEA,26,27,1,4,5
96,8482747,Brennan Othmann,L,NYR,21,35,0,5,5
96,8481167,Brayden Pachal,D,CGY,25,40,0,5,5
96,8480058,Pierre-Olivier Joseph,D,STL,25,61,0,5,5
96,8479378,Logan Stanley,D,WPG,26,38,0,5,5
96,8479348,Kale Clague,D,BUF,26,33,0,5,5
96,8480844,Grigori Denisenko,L,VGK,24,28,3,1,4
96,8477467,Gustav Olofsson,D,SEA,30,26,3,1,4
96,8482165,Yan Kuznetsov,D,CGY,22,16,3,1,4
96,8481593,Jayden Struble,D,MTL,23,21,3,1,4
96,8480845,Rasmus Kupari,C,WPG,24,39,2,2,4
96,8478502,Dennis Gilbert,D,BUF,28,18,2,2,4
96,8481422,Jake Lucchini,C,NSH,29,20,2,2,4
96,8481605,Jackson LaCombe,D,ANA,23,35,1,3,4
96,8477244,Chad Ruhwedel,D,NYR,34,45,1,3,4
96,8477527,Ross Johnston,L,ANA,30,28,0,4,4
96,8480196,Jacob Bryson,D,BUF,27,40,0,4,4
96,8475795,Dylan McIlrath,D,WSH,32,12,0,4,4
96,8482765,Isak Rosen,R,BUF,21,34,3,0,3
96,8481462,Mason Morelli,L,VGK,28,10,3,0,3
96,8478454,Noah Juulsen,D,VAN,27,38,2,1,3
96,8482172,Landon Slaggert,L,CHI,22,25,2,1,3
96,8482144,Jack Thompson,D,SJS,22,30,2,1,3
96,8482516,Matthew Kessel,D,STL,24,18,2,1,3
96,8482713,Mackie Samoskevich,R,FLA,22,31,2,1,3
96,8477073,Kurtis MacDermid,L,NJD,30,23,2,1,3
96,8483597,Milos Kelemen,L,UTA,25,16,2,1,3
96,8481006,Tyler Tucker,D,STL,24,13,2,1,3
96,8482470,Ilya Solovyov,D,CGY,24,22,1,2,3
96,8477810,Joel Hanley,D,CGY,33,21,1,2,3
96,8482250,Callahan Burke,C,VGK,27,19,0,3,3
96,8482088,Justin Sourdif,R,FLA,22,18,0,3,3
96,8477320,Anton Blidh,L,NYR,29,21,0,3,3
96,8481024,Linus Karlsson,C,VAN,25,8,0,3,3
96,8479576,Vincent Desharnais,D,VAN,28,35,2,0,2
96,8477971,Andreas Englund,D,LAK,28,29,2,0,2
96,8481743,Marc Del Gaizo,D,NSH,25,25,2,0,2
96,8481578,Graeme Clarke,R,MIN,23,10,2,0,2
96,8483471,Brad Lambert,C,WPG,31,13,2,0,2
96,8480245,Olle Lycksell,R,PHI,25,32,1,1,2
96,8480851,Akil Thomas,C,LAK,24,23,1,1,2
96,8479362,Riley Tufte,L,BOS,26,15,1,1,2
96,8481030,Jack St. Ivany,D,PIT,25,15,1,1,2
96,8478051,Max Willman,C,NJD,29,15,1,1,2
96,8482162,Roby Jarventie,L,EDM,22,20,1,1,2
96,8482201,Gage Goncalves,C,TBL,23,21,1,1,2
96,8475780,Chris Wagner,R,COL,33,5,1,1,2
96,8478881,Brett Seney,L,CHI,28,10,1,1,2
96,8480874,Adam Ginning,D,PHI,24,9,1,1,2
96,8481806,Louis Crevier,D,CHI,23,12,1,1,2
96,8481564,Ryan Johnson,D,BUF,23,11,1,1,2
96,8478446,Glenn Gawdin,C,LAK,27,12,1,1,2
96,8477993,Justin Kirkland,C,CGY,28,10,1,1,2
96,8484254,Akito Hirose,D,VAN,25,32,0,2,2
96,8484325,Waltteri Merela,C,TBL,26,20,0,2,2
96,8477462,Robert Hagg,D,VGK,29,22,0,2,2
96,8481699,Aku Raty,R,UTA,23,17,0,2,2
96,8478477,Mitchell Stephens,C,SEA,27,16,0,2,2
96,8480084,Nick DeSimone,D,NJD,30,11,0,2,2
96,8484255,Jason Polin,R,COL,25,4,0,2,2
96,8482929,Emil Lilleberg,D,TBL,23,14,1,0,1
96,8480032,Shane Bowers,C,NJD,25,14,1,0,1
96,8479320,Maxime Lajoie,D,SEA,27,16,1,0,1
96,8481065,Angus Crookshank,L,OTT,25,14,1,0,1
96,8482102,Vasily Ponomarev,C,PIT,22,16,1,0,1
96,8481237,Kyle MacLean,C,NYI,25,20,1,0,1
96,8482460,Matt Rempe,C,NYR,22,16,1,0,1
96,8483567,Georgii Merkulov,C,BOS,24,10,1,0,1
96,8478021,William Lagesson,D,DET,28,28,0,1,1
96,8479367,William Lockwood,R,FLA,26,22,0,1,1
96,8481543,Nikita Alexandrov,C,STL,24,18,0,1,1
96,8481206,John Ludvig,D,PIT,24,6,0,1,1
96,8483512,Matthew Savoie,C,EDM,20,18,0,1,1
96,8479587,Rhett Gardner,C,PHI,28,25,0,1,1
96,8483531,Brian Halonen,L,NJD,25,3,0,1,1
96,8480075,Cameron Crotty,D,MIN,25,10,0,1,1
96,8481726,Adam Edstrom,C,NYR,24,5,0,1,1
96,8483546,Marshall Rifai,D,TOR,26,2,0,1,1
96,8483489,Fraser Minten,C,TOR,31,13,0,1,1
96,8483398,Declan Carlile,D,TBL,31,12,0,1,1
96,8476323,Max McCormick,L,SEA,32,5,0,1,1
96,8477473,Justin Bailey,R,SJS,29,17,0,0,0
96,8478011,Louie Belpedio,D,PHI,28,11,0,0,0
96,8482147,Jean-Luc Foudy,C,COL,22,24,0,0,0
96,8482118,Sam Colangelo,R,ANA,23,8,0,0,0
96,8482094,Daemon Hunt,D,MIN,22,22,0,0,0
96,8483395,Arshdeep Bains,L,VAN,23,10,0,0,0
96,8478147,Bokondji Imama,L,PIT,28,6,0,0,0
96,8482061,Brandon Biro,L,SEA,26,10,0,0,0
96,8481585,Egor Afanasyev,L,SJS,23,18,0,0,0
96,8483407,Brandon Scanlin,D,NYR,25,4,0,0,0
96,8475413,Justin Dowling,C,NJD,34,14,0,0,0
96,8481719,Maxwell Crozier,D,TBL,24,18,0,0,0
96,8482476,Emil Heineman,L,MTL,23,5,0,0,0
96,8480823,Alexander Alexeyev,D,WSH,25,8,0,0,0
96,8482787,Nikita Chibrikov,R,WPG,31,9,0,0,0
96,8483920,Pierrick Dube,R,WSH,23,4,0,0,0
96,8478854,Ryan Shea,D,PIT,27,6,0,0,0
96,8479522,Hardy Haman Aktell,D,WSH,26,2,0,0,0
96,8474062,Riley Nash,C,NYR,35,13,0,0,0
96,8475755,Alexander Petrovic,D,DAL,32,8,0,0,0
96,8484304,Uvis Balinskis,D,FLA,28,14,0,0,0
96,8481534,Raphael Lavoie,C,EDM,24,2,0,0,0
96,8483432,Luca Del Bel Belluz,C,CBJ,31,5,0,0,0
96,8482197,Adam Raska,R,MIN,23,5,0,0,0
96,8481655,Cole Schwindt,R,CGY,23,2,0,0,0
96,8483609,Adam Klapka,R,CGY,24,2,0,0,0
96,8477541,Dakota Mermis,D,TOR,30,6,0,0,0
96,8480306,Grant Hutton,D,NYI,29,7,0,0,0
96,8479330,Brandon Gignac,C,MTL,27,6,0,0,0
96,8482126,Emil Andrae,D,PHI,31,2,0,0,0
96,8479421,Jacob Moverare,D,LAK,26,4,0,0,0
96,8484321,Nikolas Matinpalo,D,OTT,26,0,0,0,0
96,8483401,Marc Johnstone,R,PIT,28,3,0,0,0
96,8484326,Patrik Koch,D,UTA,28,4,0,0,0
96,8478956,Samuel Laberge,L,NJD,27,3,0,0,0
96,8480274,Philip Kemp,D,EDM,25,3,0,0,0
96,8484259,Ondrej Pavel,C,COL,31,1,0,0,0
96,8470794,Joe Pavelski,C,,40,0,0,0,0
96,8479321,Lucas Johansen,D,,27,0,0,0,0
96,8477950,Tony DeAngelo,D,,29,0,0,0,0
96,8471218,Blake Wheeler,R,,38,0,0,0,0
96,8475197,Tyson Barrie,D,,33,0,0,0,0
96,8474157,Max Pacioretty,L,,36,0,0,0,0
96,8475744,Evgeny Kuznetsov,C,,32,0,0,0,0
96,8474037,James van Riemsdyk,L,,35,0,0,0,0
96,8476907,Mackenzie MacEachern,L,,30,0,0,0,0
96,8480216,Jacob Peterson,C,,25,0,0,0,0
96,8474602,Justin Schultz,D,,34,0,0,0,0
96,8482222,Alexander Barabanov,L,,30,0,0,0,0
96,8474031,Kevin Shattenkirk,D,,35,0,0,0,0
96,8477330,Dominik Kubalik,L,,29,0,0,0,0
96,8480884,Calen Addison,D,,24,0,0,0,0
96,8475906,John Klingberg,D,,32,0,0,0,0
96,8480008,Adam Ruzicka,C,,25,0,0,0,0
96,8476884,Derrick Pouliot,D,,30,0,0,0,0
96,8476919,Chris Tierney,C,,30,0,0,0,0
96,8479415,Michael McLeod,C,,26,0,0,0,0
96,8474870,Tyler Johnson,C,,34,0,0,0,0
96,8470604,Jeff Carter,C,,39,0,0,0,0
96,8478104,Sammy Blais,L,,28,0,0,0,0
96,8474884,Mike Hoffman,C,,35,0,0,0,0
96,8481591,Sam Poulin,R,,23,0,0,0,0
96,8471274,Alex Goligoski,D,,39,0,0,0,0
96,8476871,Tanner Pearson,L,,32,0,0,0,0
96,8476393,Nick Cousins,C,,31,0,0,0,0
96,8479977,Kailer Yamamoto,R,,26,0,0,0,0
96,8479346,Dillon Dube,C,,26,0,0,0,0
96,8480184,Gustav Lindstrom,D,,26,0,0,0,0
96,8479376,Victor Mete,D,,26,0,0,0,0
96,8473449,Kyle Okposo,R,,36,0,0,0,0
96,8481058,Jesse Ylonen,R,,25,0,0,0,0
96,8475752,Tyler Pitlick,C,,33,0,0,0,0
96,8481239,Samuel Fagemo,L,,24,0,0,0,0
96,8480821,Filip Zadina,R,,25,0,0,0,0
96,8470966,Mark Giordano,D,,41,0,0,0,0
96,8478495,Denis Gurianov,R,,27,0,0,0,0
96,8477464,Nic Petan,C,,29,0,0,0,0
96,8478099,Kevin Labanc,R,,29,0,0,0,0
96,8482241,Radim Zohorna,L,,28,0,0,0,0
96,8474040,Sam Gagner,C,,35,0,0,0,0
96,8479514,Rem Pitlick,C,,27,0,0,0,0
96,8478430,Oliver Kylington,D,,27,0,0,0,0
96,8479533,Joona Koppanen,L,,26,0,0,0,0
96,8479984,Cal Foote,D,,26,0,0,0,0
96,8477126,Jayson Megna,C,,34,0,0,0,0
96,8475164,Jakob Silfverberg,R,,34,0,0,0,0
96,8474009,Nick Bonino,C,,36,0,0,0,0
96,8479458,Nikita Zaitsev,D,,33,0,0,0,0
96,8477944,Jakub Vrana,L,,28,0,0,0,0
96,8471699,Andrew Cogliano,C,,37,0,0,0,0
96,8478067,Oskar Lindblom,L,,28,0,0,0,0
96,8471686,Marc Staal,D,,37,0,0,0,0
96,8470610,Zach Parise,L,,40,0,0,0,0
96,8478904,Steven Lorentz,C,,28,0,0,0,0
96,8473473,Milan Lucic,L,,36,0,0,0,0
96,8480031,Maxime Comtois,L,,25,0,0,0,0
96,8478512,Austin Czarnik,C,,32,0,0,0,0
96,8473504,Cal Clutterbuck,R,,37,0,0,0,0
96,8477454,Adam Erne,L,,29,0,0,0,0
96,8479383,Boris Katchouk,L,,26,0,0,0,0
96,8475825,Jani Hakanpää,D,,32,0,0,0,0
96,8477846,Ryan Carpenter,C,,33,0,0,0,0
96,8477930,Pierre-Edouard Bellemare,L,,39,0,0,0,0
96,8478400,Colin White,C,,27,0,0,0,0
96,8480226,Marián Studenic,R,,26,0,0,0,0
96,8480853,Liam Foudy,C,,24,0,0,0,0
96,8475797,Jarred Tinordi,D,,32,0,0,0,0
96,8479423,Alex Nylander,L,,26,0,0,0,0
96,8474618,Marco Scandella,D,,34,0,0,0,0
96,8478028,Fredrik Olofsson,L,,28,0,0,0,0
96,8474709,Matt Martin,L,,35,0,0,0,0
96,8481070,Hugh McGing,L,,26,0,0,0,0
96,8479546,Oskar Steen,C,,26,0,0,0,0
96,8474145,Robert Bortuzzo,D,,35,0,0,0,0
96,8476915,Jujhar Khaira,L,,30,0,0,0,0
96,8475278,Byron Froese,C,,33,0,0,0,0
96,8481812,Nikolai Knyzhov,D,,27,0,0,0,0
96,8478408,Travis Dermott,D,,28,0,0,0,0
96,8481077,John Leonard,L,,26,0,0,0,0
96,8479547,Matthew Phillips,R,,26,0,0,0,0
96,8480836,Jonathan Gruden,C,,24,0,0,0,0
96,8481690,Tyler Angle,C,,24,0,0,0,0
96,8475766,Austin Watson,L,,32,0,0,0,0
96,8481016,Ruslan Iskhakov,C,,24,0,0,0,0
96,8478078,Rourke Chartier,C,,28,0,0,0,0
96,8480776,Sheldon Rempal,R,,29,0,0,0,0
96,8483045,Cameron Butler,R,CBJ,31,0,0,0,0
96,8484314,Jiri Smejkal,L,,28,0,0,0,0
97,8478402,Connor McDavid,C,EDM,27,72,41,108,149
97,8477492,Nathan MacKinnon,C,COL,29,80,62,84,146
97,8476453,Nikita Kucherov,R,TBL,31,82,45,77,122
97,8477934,Leon Draisaitl,C,EDM,29,79,41,78,119
97,8477956,David Pastrnak,R,BOS,28,82,58,58,116
97,8479318,Auston Matthews,C,TOR,27,80,57,56,113
97,8477493,Aleksander Barkov,C,FLA,29,75,37,75,112
97,8481559,Jack Hughes,C,NJD,23,78,34,75,109
97,8480801,Brady Tkachuk,L,OTT,25,81,40,65,105
97,8476468,J.T. Miller,C,VAN,31,78,40,64,104
97,8478420,Mikko Rantanen,R,COL,28,82,36,68,104
97,8479314,Matthew Tkachuk,L,FLA,27,81,27,76,103
97,8478483,Mitch Marner,R,TOR,27,80,28,72,100
97,8477942,Kevin Fiala,L,LAK,28,80,28,72,100
97,8479420,Tage Thompson,C,BUF,27,75,47,49,96
97,8478010,Brayden Point,C,TBL,28,82,45,51,96
97,8478550,Artemi Panarin,L,NYR,33,74,26,67,93
97,8477409,Carter Verhaeghe,C,FLA,29,76,49,43,92
97,8477933,Sam Reinhart,C,FLA,29,76,45,46,91
97,8474600,Roman Josi,D,NSH,34,76,21,70,91
97,8478864,Kirill Kaprizov,L,MIN,27,77,35,55,90
97,8482116,Tim Stützle,C,OTT,22,78,30,59,89
97,8476887,Filip Forsberg,L,NSH,30,74,33,55,88
97,8476454,Ryan Nugent-Hopkins,C,EDM,31,78,28,60,88
97,8480012,Elias Pettersson,C,VAN,26,75,32,54,86
97,8478439,Travis Konecny,R,PHI,27,76,31,54,85
97,8477960,Adrian Kempe,R,LAK,28,81,36,48,84
97,8471215,Evgeni Malkin,C,PIT,38,73,39,44,83
97,8479385,Jordan Kyrou,C,STL,26,78,35,48,83
97,8477402,Pavel Buchnevich,L,STL,29,77,35,48,83
97,8474564,Steven Stamkos,C,NSH,34,74,34,49,83
97,8480069,Cale Makar,D,COL,26,74,26,56,82
97,8479407,Jesper Bratt,L,NJD,26,73,26,56,82
97,8475810,Bryan Rust,R,PIT,32,76,42,39,81
97,8471675,Sidney Crosby,C,PIT,37,76,36,44,80
97,8478440,Dylan Strome,C,WSH,27,72,33,47,80
97,8477404,Jake Guentzel,C,TBL,30,82,31,49,80
97,8478444,Brock Boeser,R,VAN,27,75,40,39,79
97,8480027,Jason Robertson,L,DAL,25,82,36,43,79
97,8478427,Sebastian Aho,C,CAR,27,74,31,48,79
97,8475172,Nazem Kadri,C,CGY,34,75,28,51,79
97,8480023,Robert Thomas,C,STL,25,73,20,59,79
97,8477504,Josh Morrissey,D,WPG,29,79,19,60,79
97,8475784,Jeff Skinner,C,EDM,32,79,40,38,78
97,8480002,Nico Hischier,C,NJD,25,79,30,48,78
97,8477946,Dylan Larkin,C,DET,28,79,41,36,77
97,8477939,William Nylander,R,TOR,28,77,38,39,77
97,8479343,Clayton Keller,R,UTA,26,75,30,47,77
97,8478398,Kyle Connor,L,WPG,28,74,41,35,76
97,8475786,Zach Hyman,L,EDM,32,80,40,36,76
97,8480830,Andrei Svechnikov,R,CAR,24,68,29,47,76
97,8475913,Mark Stone,R,VGK,32,77,28,48,76
97,8476539,Jonathan Marchessault,R,NSH,34,73,44,31,75
97,8480839,Rasmus Dahlin,D,BUF,24,69,21,54,75
97,8476389,Vincent Trocheck,C,NYR,31,77,32,42,74
97,8477503,Max Domi,C,TOR,29,80,25,49,74
97,8480803,Evan Bouchard,D,EDM,25,76,16,58,74
97,8475184,Chris Kreider,L,NYR,33,78,40,33,73
97,8478401,Pavel Zacha,C,BOS,27,80,28,45,73
97,8480800,Quinn Hughes,D,VAN,25,73,9,64,73
97,8471214,Alex Ovechkin,L,WSH,39,74,35,37,72
97,8475166,John Tavares,C,TOR,34,79,24,48,72
97,8477949,Alex Tuch,R,BUF,28,77,20,52,72
97,8478445,Mathew Barzal,C,NYI,27,79,16,56,72
97,8479323,Adam Fox,D,NYR,26,72,15,57,72
97,8480036,Miro Heiskanen,D,DAL,25,79,15,57,72
97,8476881,Tomas Hertl,C,VGK,31,76,36,35,71
97,8482740,Wyatt Johnston,C,DAL,21,82,32,39,71
97,8481557,Matt Boldy,L,MIN,23,71,26,45,71
97,8476456,Jonathan Huberdeau,C,CGY,31,77,18,53,71
97,8473419,Brad Marchand,L,BOS,36,80,32,38,70
97,8475754,Brock Nelson,C,NYI,33,79,25,45,70
97,8474141,Patrick Kane,R,DET,36,80,22,48,70
97,8479542,Brandon Hagel,L,TBL,26,82,31,38,69
97,8478403,Jack Eichel,C,VGK,28,82,30,39,69
97,8479675,Trevor Moore,L,LAK,29,80,29,40,69
97,8478873,Troy Terry,R,ANA,27,80,29,39,68
97,8477501,Valeri Nichushkin,R,COL,29,80,36,31,67
97,8478460,Zach Werenski,D,CBJ,27,81,17,50,67
97,8477500,Bo Horvat,C,NYI,29,81,36,30,66
97,8473512,Claude Giroux,R,OTT,36,78,29,37,66
97,8478498,Jake DeBrusk,L,VAN,28,80,28,38,66
97,8480208,Drake Batherson,R,OTT,26,78,27,39,66
97,8476460,Mark Scheifele,C,WPG,31,70,26,40,66
97,8475167,Victor Hedman,D,TBL,34,77,15,51,66
97,8480014,Gabriel Vilardi,C,WPG,25,72,38,26,64
97,8475170,Brayden Schenn,C,STL,33,75,27,37,64
97,8477940,Nikolaj Ehlers,L,WPG,28,71,24,40,64
97,8476905,Chandler Stephenson,C,SEA,30,75,21,43,64
97,8474578,Erik Karlsson,D,PIT,34,77,14,50,64
97,8482745,Mason McTavish,C,ANA,21,72,31,31,62
97,8475726,Tyler Toffoli,C,SJS,32,71,30,32,62
97,8482159,Tyson Foerster,R,PHI,22,78,26,36,62
97,8471685,Anze Kopitar,C,LAK,37,77,23,39,62
97,8477951,Nick Schmaltz,C,UTA,28,78,30,31,61
97,8478366,Frank Vatrano,R,ANA,30,71,29,32,61
97,8476459,Mika Zibanejad,C,NYR,31,76,23,38,61
97,8484144,Connor Bedard,C,CHI,19,69,15,46,61
97,8480865,Noah Dobson,D,NYI,24,78,11,50,61
97,8478438,Tommy Novak,C,NSH,27,66,31,29,60
97,8482093,Seth Jarvis,C,CAR,22,66,26,34,60
97,8477935,Sam Bennett,C,FLA,28,77,25,35,60
97,8481533,Trevor Zegras,C,ANA,23,75,22,38,60
97,8477346,MacKenzie Weegar,D,CGY,30,77,21,39,60
97,8477494,Jonathan Drouin,L,COL,29,81,16,44,60
97,8476853,Morgan Rielly,D,TOR,30,71,10,50,60
97,8478449,Roope Hintz,C,DAL,28,81,31,28,59
97,8476399,Blake Coleman,C,CGY,33,79,25,34,59
97,8475745,Charlie Coyle,C,BOS,32,79,24,35,59
97,8479400,Pierre-Luc Dubois,L,WSH,26,74,23,36,59
97,8479999,Casey Mittelstadt,C,COL,26,81,15,44,59
97,8476346,Johnny Gaudreau,L,CBJ,31,71,14,45,59
97,8478414,Timo Meier,R,NJD,28,75,29,29,58
97,8483808,Andrei Kuzmenko,L,CGY,28,74,27,31,58
97,8476448,William Karlsson,C,VGK,31,79,25,32,57
97,8478493,Joel Eriksson Ek,C,MIN,27,73,24,33,57
97,8481528,Dylan Cozens,C,BUF,23,65,23,34,57
97,8482078,Lucas Raymond,L,DET,22,80,21,36,57
97,8474102,David Perron,L,OTT,36,73,18,39,57
97,8477476,Artturi Lehkonen,L,COL,29,81,30,26,56
97,8479337,Alex DeBrincat,R,DET,27,82,27,29,56
97,8475169,Evander Kane,L,EDM,33,76,27,29,56
97,8476479,Phillip Danault,C,LAK,31,80,26,30,56
97,8476882,Teuvo Teravainen,C,CHI,30,62,25,31,56
97,8477955,Jared McCann,L,SEA,28,76,24,32,56
97,8477496,Elias Lindholm,C,BOS,30,80,22,34,56
97,8478042,Viktor Arvidsson,L,EDM,31,76,20,36,56
97,8477447,Shea Theodore,D,VGK,29,64,11,44,55
97,8479525,Ross Colton,C,COL,28,81,28,26,54
97,8482110,Dawson Mercer,C,NJD,23,71,28,26,54
97,8480039,Martin Necas,C,CAR,25,72,27,27,54
97,8475151,Kyle Palmieri,C,NYI,33,77,23,31,54
97,8478975,Mason Marchment,L,DAL,29,79,21,33,54
97,8475168,Matt Duchene,C,DAL,33,82,21,33,54
97,8478542,Evan Rodrigues,C,FLA,31,74,20,34,54
97,8475692,Mats Zuccarello,R,MIN,37,70,16,38,54
97,8481596,Shane Pinto,C,OTT,24,79,23,30,53
97,8481577,Philip Tomasino,C,NSH,23,72,16,37,53
97,8478407,Vince Dunn,D,SEA,28,79,10,43,53
97,8478047,Michael Bunting,L,PIT,29,70,25,27,52
97,8482720,Matthew Knies,L,TOR,22,71,25,27,52
97,8482665,Matty Beniers,C,SEA,22,73,24,28,52
97,8480015,Owen Tippett,R,PHI,25,76,23,29,52
97,8471698,T.J. Oshie,R,WSH,38,70,22,30,52
97,8481540,Cole Caufield,R,MTL,23,74,21,31,52
97,8475798,Mikael Granlund,C,SJS,32,70,14,38,52
97,8484145,Zach Benson,L,BUF,19,73,22,29,51
97,8473986,Alex Killorn,L,ANA,35,76,17,34,51
97,8475765,Vladimir Tarasenko,R,DET,33,80,16,35,51
97,8477932,Aaron Ekblad,D,FLA,28,66,15,36,51
97,8480064,Josh Norris,C,OTT,25,75,26,24,50
97,8473994,Jamie Benn,L,DAL,35,81,21,29,50
97,8477416,Oliver Bjorkstrand,R,SEA,29,70,21,29,50
97,8480028,Morgan Frost,C,PHI,25,73,20,30,50
97,8475191,Reilly Smith,R,NYR,33,73,17,33,50
97,8476792,Torey Krug,D,STL,33,70,13,37,50
97,8474563,Drew Doughty,D,LAK,35,77,10,40,50
97,8482149,Cole Perfetti,C,WPG,22,62,28,21,49
97,8476826,Yanni Gourde,C,SEA,33,73,18,31,49
97,8480797,Joel Farabee,L,PHI,24,71,18,31,49
97,8481711,Matias Maccelli,L,UTA,24,77,16,33,49
97,8476906,Shayne Gostisbehere,D,CAR,31,75,11,38,49
97,8471724,Kris Letang,D,PIT,37,79,10,39,49
97,8476875,Mike Matheson,D,MTL,30,68,10,39,49
97,8478396,Noah Hanifin,D,VGK,27,64,9,40,49
97,8482092,Ridly Greig,C,OTT,22,76,23,25,48
97,8474586,Jordan Eberle,R,SEA,34,75,22,26,48
97,8475158,Ryan O'Reilly,C,NSH,33,67,20,28,48
97,8478057,Dakota Joshua,C,VAN,28,75,19,29,48
97,8483431,Logan Cooley,C,UTA,20,74,19,29,48
97,8474150,Mikael Backlund,C,CGY,35,80,18,30,48
97,8476869,Brady Skjei,D,NSH,30,69,16,32,48
97,8478469,Thomas Chabot,D,OTT,27,73,15,33,48
97,8479425,Filip Hronek,D,VAN,27,72,10,38,48
97,8475794,Tyler Seguin,C,DAL,32,82,22,25,47
97,8482124,Quinton Byfield,R,LAK,22,76,22,25,47
97,8483515,Juraj Slafkovsky,L,MTL,20,73,18,29,47
97,8477986,Brandon Montour,D,SEA,30,74,13,34,47
97,8476462,Dougie Hamilton,D,NJD,31,73,12,35,47
97,8470613,Brent Burns,D,CAR,39,74,9,38,47
97,8479325,Charlie McAvoy,D,BOS,27,76,6,41,47
97,8482699,Dylan Guenther,R,UTA,21,79,25,21,46
97,8482146,Luke Evangelista,R,NSH,22,66,23,23,46
97,8476880,Tom Wilson,R,WSH,30,62,22,24,46
97,8477511,Anthony Mantha,R,CGY,30,74,21,25,46
97,8479339,Patrik Laine,L,CBJ,26,64,20,26,46
97,8480220,Noah Cates,L,PHI,25,78,20,26,46
97,8480871,Adam Boqvist,D,FLA,24,69,17,29,46
97,8476463,Jonas Brodin,D,MIN,31,80,10,36,46
97,8474679,Gustav Nyquist,C,NSH,35,67,6,40,46
97,8475722,Jason Zucker,L,BUF,32,73,20,25,45
97,8477426,Nicholas Paul,L,TBL,29,82,18,27,45
97,8482667,William Eklund,L,SJS,22,68,17,28,45
97,8476292,Ondrej Palat,L,NJD,33,67,17,28,45
97,8475218,Mattias Ekholm,D,EDM,34,77,16,29,45
97,8480018,Nick Suzuki,C,MTL,25,75,14,31,45
97,8478397,Rasmus Andersson,D,CGY,28,69,9,36,45
97,8477495,Seth Jones,D,CHI,30,68,8,37,45
97,8481606,Jordan Spence,D,LAK,23,76,6,39,45
97,8478474,Lawson Crouse,L,UTA,27,74,22,22,44
97,8478519,Anthony Cirelli,C,TBL,27,81,20,24,44
97,8478462,Nicolas Roy,C,VGK,27,77,18,26,44
97,8478856,Conor Garland,R,VAN,28,74,17,27,44
97,8483505,Matthew Poitras,C,BOS,20,78,15,29,44
97,8477456,J.T. Compher,L,DET,29,82,14,30,44
97,8475753,Justin Faulk,D,STL,32,70,13,31,44
97,8478038,Devon Toews,D,COL,30,63,12,32,44
97,8476458,Ryan Strome,C,ANA,31,72,12,32,44
97,8479410,Mikhail Sergachev,D,UTA,26,73,7,37,44
97,8480145,Neal Pionk,D,WPG,29,74,7,37,44
97,8482175,JJ Peterka,R,BUF,22,63,23,20,43
97,8482109,Alexis Lafrenière,L,NYR,23,74,20,23,43
97,8476483,Rickard Rakell,R,PIT,31,69,19,24,43
97,8476958,Jaccob Slavin,D,CAR,30,75,8,35,43
97,8480188,Fabian Zetterlund,L,SJS,25,64,25,17,42
97,8484153,Leo Carlsson,C,ANA,20,77,19,23,42
97,8474149,Evgenii Dadonov,R,DAL,35,77,18,24,42
97,8478233,Andrew Mangiapane,L,WSH,28,63,18,24,42
97,8475793,Ryan Johansen,C,PHI,32,72,18,24,42
97,8477407,Anthony Duclair,L,NYI,29,74,17,25,42
97,8484166,Adam Fantilli,C,CBJ,20,64,17,25,42
97,8478466,Daniel Sprong,R,VAN,27,66,13,29,42
97,8477451,Ryan Hartman,R,MIN,30,73,12,30,42
97,8478055,Gustav Forsling,D,FLA,28,68,8,34,42
97,8477964,Ivan Barbashev,C,VGK,29,73,18,23,41
97,8482097,Jack Quinn,R,BUF,23,69,15,26,41
97,8476854,Hampus Lindholm,D,BOS,30,75,6,35,41
97,8478115,Pierre Engvall,L,NYI,28,80,23,17,40
97,8478458,John (Jack) Roslovic,C,CAR,27,71,16,24,40
97,8477444,Andre Burakovsky,L,SEA,29,71,15,25,40
97,8482113,Anton Lundell,C,FLA,23,78,11,29,40
97,8480434,Sean Durzi,D,UTA,26,68,6,34,40
97,8477497,Sean Monahan,C,CBJ,30,64,21,18,39
97,8475287,Erik Haula,L,NJD,33,69,18,21,39
97,8480849,Barrett Hayton,C,UTA,24,75,16,23,39
97,8476921,Jordan Martinook,L,CAR,32,70,14,25,39
97,8482671,Owen Power,D,BUF,22,70,10,29,39
97,8475314,Anders Lee,L,NYI,34,75,24,14,38
97,8476432,Boone Jenner,C,CBJ,31,67,23,15,38
97,8476438,Brandon Saad,L,STL,32,76,19,19,38
97,8479992,Michael Rasmussen,C,DET,25,79,19,19,38
97,8475768,Jaden Schwartz,C,SEA,32,64,16,22,38
97,8484203,Bradly Nadeau,L,CAR,19,62,15,23,38
97,8477505,Alexander Wennberg,C,SJS,30,67,10,28,38
97,8481546,Cam York,D,PHI,23,66,10,28,38
97,8474590,John Carlson,D,WSH,34,69,7,31,38
97,8478500,Ivan Provorov,D,CBJ,27,80,5,33,38
97,8474641,Adam Henrique,C,EDM,34,75,23,14,37
97,8481560,Arthur Kaliyev,R,LAK,23,78,22,15,37
97,8481524,Bowen Byram,D,BUF,23,64,15,22,37
97,8479393,Noah Gregor,L,OTT,26,76,15,22,37
97,8478463,Anthony Beauvillier,L,PIT,27,66,13,24,37
97,8483490,Pavel Mintyukov,D,ANA,21,75,8,29,37
97,8481581,Thomas Harley,D,DAL,23,80,7,30,37
97,8476312,Josh Manson,D,COL,33,59,4,33,37
97,8477479,Tyler Bertuzzi,L,CHI,29,66,17,19,36
97,8480459,Pius Suter,C,VAN,28,67,16,20,36
97,8475799,Nino Niederreiter,R,WPG,32,69,16,20,36
97,8477425,Miles Wood,L,COL,29,78,16,20,36
97,8478472,Mathieu Joseph,R,STL,27,69,13,23,36
97,8477435,Ryan Graves,D,PIT,29,78,10,26,36
97,8477948,Travis Sanheim,D,PHI,28,72,9,27,36
97,8482105,Jake Sanderson,D,OTT,22,78,8,28,36
97,8480798,Philipp Kurashev,C,CHI,25,64,8,28,36
97,8481604,Pavel Dorofeyev,L,VGK,24,72,23,12,35
97,8477498,Darnell Nurse,D,EDM,29,75,15,20,35
97,8482624,Daniil Miromanov,D,CGY,27,69,11,24,35
97,8479345,Jakob Chychrun,D,WSH,26,64,10,25,35
97,8477021,Alex Kerfoot,C,UTA,30,73,7,28,35
97,8480893,Kirill Marchenko,R,CBJ,24,64,21,13,34
97,8478046,Danton Heinen,L,VAN,29,68,21,13,34
97,8475760,Nick Bjugstad,C,UTA,32,73,21,13,34
97,8481068,Yegor Sharangovich,C,CGY,26,74,20,14,34
97,8475714,Calle Jarnkrok,C,TOR,33,74,18,16,34
97,8481554,Kaapo Kakko,R,NYR,23,67,18,16,34
97,8483445,Cutter Gauthier,L,ANA,20,62,18,16,34
97,8474716,Jared Spurgeon,D,MIN,35,75,14,20,34
97,8477987,Ryan Donato,C,CHI,28,57,14,20,34
97,8476885,Jacob Trouba,D,NYR,30,75,11,23,34
97,8479987,Morgan Geekie,C,BOS,26,79,11,23,34
97,8474565,Alex Pietrangelo,D,VGK,34,62,7,27,34
97,8482684,Luke Hughes,D,NJD,21,69,6,28,34
97,8478020,Michael Amadio,R,OTT,28,73,17,16,33
97,8480113,Alex Iafallo,L,WPG,31,70,17,16,33
97,8482702,Logan Stankoven,C,DAL,21,77,16,17,33
97,8477947,Sonny Milano,L,WSH,28,59,15,18,33
97,8476474,Stefan Noesen,R,NJD,31,65,15,18,33
97,8478891,Mason Appleton,C,WPG,28,64,13,20,33
97,8476872,Scott Laughton,C,PHI,30,75,12,21,33
97,8477429,Andrew Copp,C,DET,30,77,11,22,33
97,8478013,Jake Walman,D,SJS,28,72,11,22,33
97,8482122,Brock Faber,D,MIN,22,77,8,25,33
97,8481542,Moritz Seider,D,DET,23,74,5,28,33
97,8477998,Warren Foegele,L,LAK,28,77,17,15,32
97,8476925,Colton Sissons,C,NSH,31,69,17,15,32
97,8480068,Ryan Poehling,C,PHI,25,68,16,16,32
97,8481656,Aliaksei Protas,C,WSH,23,70,15,17,32
97,8480185,Eetu Luostarinen,C,FLA,26,73,14,18,32
97,8480078,Filip Chytil,C,NYR,25,72,11,21,32
97,8480829,Jesperi Kotkaniemi,C,CAR,24,68,17,14,31
97,8483524,Shane Wright,C,SEA,20,62,15,16,31
97,8476927,Teddy Blueger,C,VAN,30,66,13,18,31
97,8476897,Oskar Sundqvist,C,STL,30,67,13,18,31
97,8475231,Casey Cizikas,C,NYI,33,69,11,20,31
97,8481704,Juuso Parssinen,C,NSH,23,63,10,21,31
97,8478970,Jalen Chatfield,D,CAR,28,74,10,21,31
97,8476923,Damon Severson,D,CBJ,30,81,7,24,31
97,8476892,Colton Parayko,D,STL,31,73,6,25,31
97,8481582,Nicholas Robertson,L,TOR,23,71,20,10,30
97,8478421,A.J. Greer,L,FLA,28,63,18,12,30
97,8475149,Marcus Johansson,L,MIN,34,63,17,13,30
97,8482705,Cole Sillinger,C,CBJ,21,71,15,15,30
97,8482475,Yegor Chinakhov,R,CBJ,23,66,14,16,30
97,8473533,Jordan Staal,C,CAR,36,57,12,18,30
97,8481186,Logan O'Connor,R,COL,28,79,11,19,30
97,8479390,Taylor Raddysh,R,WSH,26,63,17,12,29
97,8476878,Zemgus Girgensons,C,TBL,30,81,17,12,29
97,8479365,Trent Frederic,C,BOS,26,73,15,14,29
97,8480003,Jesper Boqvist,C,FLA,26,71,15,14,29
97,8479941,Justin Danforth,R,CBJ,31,55,14,15,29
97,8480281,Alexey Toropchenko,R,STL,25,61,14,15,29
97,8470621,Corey Perry,R,EDM,39,68,14,15,29
97,8478133,Jake Evans,C,MTL,28,65,9,20,29
97,8478432,Christian Fischer,R,DET,27,74,7,22,29
97,8475181,Nick Leddy,D,STL,33,71,3,26,29
97,8480802,Ryan McLeod,C,BUF,25,64,16,12,28
97,8473422,Nick Foligno,L,CHI,37,59,14,14,28
97,8479293,Brandon Tanev,L,SEA,33,62,13,15,28
97,8477903,Garnet Hathaway,R,PHI,33,69,12,16,28
97,8480009,Eeli Tolvanen,R,SEA,25,68,11,17,28
97,8481618,Alex Newhook,C,MTL,23,70,10,18,28
97,8481523,Kirby Dach,C,MTL,23,72,10,18,28
97,8477953,Kasperi Kapanen,R,STL,28,71,10,18,28
97,8481527,Kaedan Korczak,D,VGK,23,52,10,18,28
97,8479591,Michael Eyssimont,C,TBL,28,79,8,20,28
97,8475200,Dmitry Orlov,D,CAR,33,73,7,21,28
97,8482133,Thomas Bordeleau,C,SJS,22,60,7,21,28
97,8482712,Oskar Olausson,R,COL,22,73,3,25,28
97,8475764,Cam Fowler,D,ANA,33,75,2,26,28
97,8481624,Ilya Mikheyev,R,CHI,30,57,13,14,27
97,8482055,Drew O'Connor,L,PIT,26,64,13,14,27
97,8481517,Brett Leason,R,ANA,25,59,12,15,27
97,8478413,Jordan Greenway,L,BUF,27,63,11,16,27
97,8476392,Adam Lowry,C,WPG,31,67,11,16,27
97,8477478,William Carrier,L,CAR,30,55,9,18,27
97,8476917,Adam Pelech,D,NYI,30,76,4,23,27
97,8475790,Erik Gudbranson,D,CBJ,32,79,4,23,27
97,8481535,Nils Hoglander,L,VAN,24,65,20,6,26
97,8475848,Brendan Gallagher,R,MTL,32,69,15,11,26
97,8475193,Tomas Tatar,L,NJD,34,72,13,13,26
97,8480813,Joe Veleno,C,DET,24,75,13,13,26
97,8479368,Max Jones,L,BOS,26,65,13,13,26
97,8475220,Marcus Foligno,L,MIN,33,66,13,13,26
97,8480762,Eric Robinson,L,CAR,29,52,12,14,26
97,8474053,Logan Couture,C,SJS,35,58,10,16,26
97,8474715,Cameron Atkinson,R,TBL,35,82,9,17,26
97,8476419,Jean-Gabriel Pageau,C,NYI,32,77,8,18,26
97,8476480,Vladislav Namestnikov,C,WPG,32,58,7,19,26
97,8480806,Isac Lundestrom,C,ANA,25,60,7,19,26
97,8482073,Braden Schneider,D,NYR,23,61,5,21,26
97,8481703,Valtteri Puustinen,R,PIT,25,61,4,22,26
97,8477499,Rasmus Ristolainen,D,PHI,30,61,4,22,26
97,8475171,Oliver Ekman-Larsson,D,TOR,33,72,2,24,26
97,8475208,Brian Dumoulin,D,ANA,33,58,0,26,26
97,8476918,Jimmy Vesey,L,NYR,31,68,17,8,25
97,8477952,Robby Fabbri,C,ANA,28,61,14,11,25
97,8475225,Craig Smith,C,CHI,35,57,13,12,25
97,8482749,Joshua Roy,R,MTL,21,68,12,13,25
97,8482737,Zack Bolduc,C,STL,21,56,12,13,25
97,8481553,Bobby Brink,R,PHI,23,57,10,15,25
97,8477979,Nicolas Aube-Kubel,R,BUF,28,60,10,15,25
97,8480205,Emil Bemstrom,C,PIT,25,52,10,15,25
97,8475791,Taylor Hall,L,CHI,33,49,8,17,25
97,8475763,Kevin Hayes,R,PIT,32,63,7,18,25
97,8482655,Janis Moser,D,TBL,24,78,7,18,25
97,8482660,Kent Johnson,C,CBJ,22,60,5,20,25
97,8476457,Adam Larsson,D,SEA,32,73,5,20,25
97,8477488,Brett Pesce,D,NJD,30,63,4,21,25
97,8479398,Samuel Girard,D,COL,26,65,3,22,25
97,8477969,Marcus Pettersson,D,PIT,28,77,3,22,25
97,8474673,TJ Brodie,D,CHI,34,60,3,22,25
97,8482117,Lukas Reichel,L,CHI,22,61,14,10,24
97,8479315,Joey Anderson,R,CHI,26,48,12,12,24
97,8481093,Rafael Harvey-Pinard,L,MTL,25,59,10,14,24
97,8478109,Victor Olofsson,L,VGK,29,66,9,15,24
97,8481522,Peyton Krebs,C,BUF,23,62,9,15,24
97,8480817,K'Andre Miller,D,NYR,24,67,6,18,24
97,8481481,Blake Lizotte,C,PIT,27,64,6,18,24
97,8479639,Dylan Coghlan,D,WPG,26,62,5,19,24
97,8478851,Alexandre Carrier,D,NSH,28,66,5,19,24
97,8476331,Dylan DeMelo,D,WPG,31,71,2,22,24
97,8480873,Rasmus Sandin,D,WSH,24,73,1,23,24
97,8482089,Jake Neighbours,L,STL,22,60,14,9,23
97,8482079,Marco Rossi,C,MIN,23,55,13,10,23
97,8479619,Michael Carcone,L,UTA,28,58,13,10,23
97,8480448,Parker Kelly,L,COL,25,76,11,12,23
97,8479353,Brett Howden,C,VGK,26,68,9,14,23
97,8482803,Olen Zellweger,D,ANA,21,63,9,14,23
97,8479316,Luke Kunin,C,SJS,27,62,7,16,23
97,8482142,Jamie Drysdale,D,PHI,22,62,7,16,23
97,8476891,Matthew Grzelcyk,D,PIT,30,76,6,17,23
97,8476525,Colin Miller,D,WPG,32,61,2,21,23
97,8482067,Connor Mackey,D,NYR,28,65,1,22,23
97,8482155,Alex Laferriere,R,LAK,23,67,16,6,22
97,8481601,Simon Holmstrom,R,NYI,23,75,15,7,22
97,8481032,Paul Cotter,C,NJD,25,62,13,9,22
97,8480835,Jack Drury,C,CAR,24,56,12,10,22
97,8476461,Sean Couturier,C,PHI,32,60,10,12,22
97,8483491,Ivan Miroshnichenko,L,WSH,20,60,10,12,22
97,8476278,Colin Blackwell,C,DAL,31,77,10,12,22
97,8477931,Tomas Nosek,L,FLA,32,61,9,13,22
97,8482101,Danil Gushchin,L,SJS,22,60,8,14,22
97,8479351,Sam Steel,C,DAL,26,77,7,15,22
97,8482111,Justin Barron,D,MTL,23,63,7,15,22
97,8480025,MacKenzie Entwistle,R,FLA,25,60,7,15,22
97,8474189,Lars Eller,C,PIT,35,67,6,16,22
97,8480855,Jack McBain,C,UTA,24,69,6,16,22
97,8479661,Tanner Jeannot,L,LAK,27,67,5,17,22
97,8475188,Brayden McNabb,D,VGK,33,50,4,18,22
97,8477220,Nate Schmidt,D,FLA,33,59,3,19,22
97,8473507,Jeff Petry,D,DET,37,70,3,19,22
97,8474574,Tyler Myers,D,VAN,34,68,3,19,22
97,8480049,Dylan Samberg,D,WPG,25,65,3,19,22
97,8480043,Timothy Liljegren,D,TOR,25,67,2,20,22
97,8478507,John Marino,D,UTA,27,70,2,20,22
97,8475324,Nick Jensen,D,OTT,34,76,2,20,22
97,8480035,Henri Jokiharju,D,BUF,25,69,1,21,22
97,8478508,Yakov Trenin,C,MIN,27,62,15,6,21
97,8479336,Carl Grundstrom,R,SJS,27,52,14,7,21
97,8475842,Sam Carrick,C,NYR,32,61,14,7,21
97,8482679,Matt Coronato,R,CGY,22,70,11,10,21
97,8479996,Cody Glass,C,NSH,25,56,11,10,21
97,8481477,Nico Sturm,C,SJS,29,58,9,12,21
97,8480355,Mark Kastelic,C,BOS,25,62,9,12,21
97,8477919,Frederick Gaudreau,C,MIN,31,63,8,13,21
97,8480748,Kiefer Sherwood,L,VAN,29,55,8,13,21
97,8481641,Joel Kiviranta,L,COL,28,73,8,13,21
97,8479543,Michael Pezzetta,L,MTL,26,63,8,13,21
97,8480336,Sean Walker,D,CAR,30,70,7,14,21
97,8473563,Nicklas Backstrom,C,WSH,37,53,7,14,21
97,8479983,Mario Ferraro,D,SJS,26,60,7,14,21
97,8480796,Martin Fehervary,D,WSH,25,66,3,18,21
97,8478882,Vladislav Gavrikov,D,LAK,29,65,0,21,21
97,8476981,Josh Anderson,R,MTL,30,71,13,7,20
97,8482125,Alexander Holtz,R,VGK,22,67,11,9,20
97,8483493,Frank Nazar,C,CHI,20,52,10,10,20
97,8480011,Klim Kostin,C,SJS,25,55,10,10,20
97,8482077,Dylan Holloway,L,EDM,23,56,9,11,20
97,8482062,Cole Smith,L,NSH,29,56,9,11,20
97,8481521,Ronnie Attard,D,PHI,25,60,7,13,20
97,8474151,Ryan McDonagh,D,TBL,35,76,6,14,20
97,8476902,Esa Lindell,D,DAL,30,75,5,15,20
97,8479369,Andrew Peeke,D,BOS,26,63,5,15,20
97,8477365,Connor Clifton,D,BUF,29,53,4,16,20
97,8482087,Kaiden Guhle,D,MTL,22,66,3,17,20
97,8476879,Cody Ceci,D,EDM,31,72,3,17,20
97,8482245,Artem Zub,D,OTT,29,68,3,17,20
97,8478178,Darren Raddysh,D,TBL,28,70,2,18,20
97,8476469,Joel Armia,R,MTL,31,68,14,5,19
97,8480995,Pontus Holmberg,R,TOR,25,57,11,8,19
97,8476873,Mark Jankowski,C,NSH,30,52,8,11,19
97,8477369,Carson Soucy,D,VAN,30,62,7,12,19
97,8476329,Travis Boyd,C,MIN,31,53,6,13,19
97,8480073,Erik Brannstrom,D,COL,25,67,6,13,19
97,8483468,Jiri Kulich,C,BUF,20,58,4,15,19
97,8476931,Jake McCabe,D,TOR,31,60,3,16,19
97,8479998,Mikey Anderson,D,LAK,25,69,3,16,19
97,8478136,Jake Middleton,D,MIN,28,74,2,17,19
97,8477989,Christian Dvorak,C,MTL,28,58,10,8,18
97,8479414,Nathan Bastian,R,NJD,27,56,10,8,18
97,8475855,Jesper Fast,R,CAR,33,59,9,9,18
97,8482809,Jackson Blake,R,CAR,21,61,7,11,18
97,8480789,Oliver Wahlstrom,R,NYI,24,64,7,11,18
97,8473453,Trevor Lewis,C,LAK,37,78,7,11,18
97,8478911,Matt Roy,D,WSH,29,57,6,12,18
97,8479982,Conor Timmins,D,TOR,26,64,6,12,18
97,8477406,Mattias Janmark,C,EDM,32,57,6,12,18
97,8477573,Nathan Walker,L,STL,30,49,6,12,18
97,8476979,Erik Gustafsson,D,DET,32,73,5,13,18
97,8480878,Nils Lundkvist,D,DAL,24,70,4,14,18
97,8479402,Jake Bean,D,CGY,26,66,4,14,18
97,8475179,Dmitry Kulikov,D,FLA,34,63,4,14,18
97,8479976,Juuso Valimaki,D,UTA,26,67,3,15,18
97,8477507,Nikita Zadorov,D,BOS,29,70,3,15,18
97,8480860,Kevin Bahl,D,CGY,24,63,3,15,18
97,8474034,Patrick Maroon,L,CHI,36,48,3,15,18
97,8477506,Ryan Pulock,D,NYI,30,79,1,17,18
97,8477392,Hudson Fasching,R,NYI,29,64,10,7,17
97,8476822,Luke Glendening,C,TBL,35,77,8,9,17
97,8481580,Connor McMichael,C,WSH,23,59,7,10,17
97,8478569,Noel Acciari,C,PIT,33,50,6,11,17
97,8480021,Jack Studnicka,C,LAK,25,65,6,11,17
97,8475343,Nic Dowd,C,WSH,34,70,5,12,17
97,8476624,Barclay Goodrow,C,SJS,31,52,4,13,17
97,8481019,David Gustafsson,C,WPG,24,49,4,13,17
97,8476988,Matt Benning,D,SJS,30,59,4,13,17
97,8476429,Scott Mayfield,D,NYI,32,72,3,14,17
97,8475462,Radko Gudas,D,ANA,34,67,3,14,17
97,8478452,Caleb Jones,D,LAK,27,56,3,14,17
97,8479348,Kale Clague,D,BUF,26,47,2,15,17
97,8481567,Henry Thrun,D,SJS,23,54,1,16,17
97,8477845,Trevor van Riemsdyk,D,WSH,33,54,0,17,17
97,8481789,Tye Kartye,L,SEA,23,36,12,4,16
97,8476960,Andreas Athanasiou,C,CHI,30,53,11,5,16
97,8482744,James Malatesta,L,CBJ,21,45,10,6,16
97,8481617,Vasily Podkolzin,R,VAN,23,52,9,7,16
97,8479344,Jesse Puljujarvi,R,PIT,26,55,8,8,16
97,8478585,Derek Ryan,C,EDM,38,66,7,9,16
97,8482807,Ethan Del Mastro,D,CHI,21,52,7,9,16
97,8480980,Connor Dewar,C,TOR,25,67,6,10,16
97,8481599,Victor Soderstrom,D,UTA,23,47,6,10,16
97,8480727,Zach Whitecloud,D,VGK,28,49,6,10,16
97,8475718,Justin Holl,D,DET,32,62,6,10,16
97,8477450,Jason Dickinson,C,CHI,29,57,5,11,16
97,8482192,Isaak Phillips,D,CHI,23,53,5,11,16
97,8476467,Jamie Oleksiak,D,SEA,32,64,4,12,16
97,8475233,David Savard,D,MTL,34,72,4,12,16
97,8476994,Vinnie Hinostroza,C,NSH,30,48,4,12,16
97,8474567,Zach Bogosian,D,MIN,34,58,3,13,16
97,8480246,Nick Perbix,D,TBL,26,76,2,14,16
97,8478399,Jonas Siegenthaler,D,NJD,27,59,2,14,16
97,8478859,Niko Mikkola,D,FLA,28,61,1,15,16
97,8476889,Radek Faksa,C,STL,30,48,10,5,15
97,8478043,Sam Lafferty,C,BUF,29,57,10,5,15
97,8477353,Tyler Motte,C,DET,29,73,9,6,15
97,8479968,Vinni Lettieri,C,BOS,29,53,9,6,15
97,8481754,Nikita Nesterenko,C,ANA,23,38,7,8,15
97,8477015,Connor Brown,R,EDM,30,64,6,9,15
97,8479944,Zach Aston-Reese,C,VGK,30,50,6,9,15
97,8478443,Brandon Carlo,D,BOS,28,58,5,10,15
97,8476856,Mathew Dumba,D,DAL,30,74,4,11,15
97,8479370,Tyson Jost,C,CAR,26,52,4,11,15
97,8480144,David Kampf,C,TOR,29,71,3,12,15
97,8471709,Marc-Edouard Vlasic,D,SJS,37,63,3,12,15
97,8474013,Ian Cole,D,UTA,35,49,3,12,15
97,8481441,Joe Snively,C,DET,28,69,2,13,15
97,8480222,Sebastian Aho,D,PIT,28,66,2,13,15
97,8480807,Mattias Samuelsson,D,BUF,24,49,1,14,15
97,8482259,Bobby McMann,C,TOR,28,66,11,3,14
97,8477446,Michael McCarron,R,NSH,29,60,7,7,14
97,8482666,Scott Morrow,D,CAR,22,51,7,7,14
97,8482157,Will Cuylle,L,NYR,22,62,6,8,14
97,8477508,Curtis Lazar,C,NJD,29,59,6,8,14
97,8480074,Alexandre Texier,C,STL,25,54,6,8,14
97,8476374,Sean Kuraly,C,CBJ,31,67,6,8,14
97,8481161,Jake Christiansen,D,CBJ,25,60,6,8,14
97,8480157,Calle Rosen,D,COL,30,43,6,8,14
97,8470600,Ryan Suter,D,STL,39,61,6,8,14
97,8477839,Conor Sheary,L,TBL,32,80,5,9,14
97,8479066,Ryan Lomberg,L,CGY,30,69,5,9,14
97,8483499,Liam Ohgren,L,MIN,20,53,5,9,14
97,8476422,Mike Reilly,D,NYI,31,76,5,9,14
97,8481592,Jakob Pelletier,L,CGY,23,38,5,9,14
97,8483565,Nick Blankenburg,D,NSH,26,62,4,10,14
97,8481550,Adam Beckman,L,NJD,23,34,4,10,14
97,8479324,Ryan Lindgren,D,NYR,26,57,3,11,14
97,8479328,Julien Gauthier,R,NYI,27,65,3,11,14
97,8479372,Joshua Mahura,D,SEA,26,57,2,12,14
97,8477851,Jordan Oesterle,D,BOS,32,42,2,12,14
97,8476967,Brett Kulak,D,EDM,30,61,1,13,14
97,8480891,Michael Kesselring,D,UTA,24,53,0,14,14
97,8478840,Will Borgen,D,SEA,28,64,0,14,14
97,8479439,Jacob MacDonald,D,COL,31,48,9,4,13
97,8481537,Nikita Okhotiuk,D,CGY,24,58,5,8,13
97,8484149,Gavin Brindley,C,CBJ,20,50,5,8,13
97,8482074,Connor Zary,C,CGY,23,50,4,9,13
97,8474166,Alec Martinez,D,CHI,37,51,4,9,13
97,8480172,Jan Rutta,D,SJS,34,60,3,10,13
97,8477034,Jaycob Megna,D,FLA,32,52,3,10,13
97,8481059,Scott Perunovich,D,STL,26,58,2,11,13
97,8478416,Erik Cernak,D,TBL,27,70,2,11,13
97,8482861,Vincent Iorio,D,WSH,22,38,2,11,13
97,8479442,Troy Stecher,D,EDM,30,47,2,11,13
97,8481178,Egor Zamula,D,PHI,24,53,1,12,13
97,8480887,Jordan Harris,D,MTL,24,63,1,12,13
97,8482451,Mikael Pyyhtia,L,CBJ,23,46,1,12,13
97,8479291,Kevin Rooney,C,CGY,31,48,8,4,12
97,8476442,Matt Nieto,L,PIT,32,50,8,4,12
97,8482730,Brandt Clarke,D,LAK,21,54,6,6,12
97,8483457,Lane Hutson,D,MTL,20,64,5,7,12
97,8482166,Shakir Mukhamadullin,D,SJS,22,58,5,7,12
97,8482659,Josh Doan,R,UTA,22,53,5,7,12
97,8475279,Ben Chiarot,D,DET,33,75,5,7,12
97,8471817,Ryan Reaves,R,TOR,37,54,5,7,12
97,8483482,Tristan Luneau,D,ANA,20,61,4,8,12
97,8480289,Morgan Barron,C,WPG,26,52,4,8,12
97,8483495,Simon Nemec,D,NJD,20,61,4,8,12
97,8481751,Lukas Rousek,R,BUF,25,36,4,8,12
97,8479718,Alex Barré-Boulet,C,MTL,27,48,3,9,12
97,8483466,Kevin Korchinski,D,CHI,20,51,3,9,12
97,8476441,Joel Edmundson,D,LAK,31,36,3,9,12
97,8479026,Philippe Myers,D,TOR,27,53,2,10,12
97,8482176,Wyatt Kaiser,D,CHI,22,48,2,10,12
97,8481708,Zac Jones,D,NYR,24,58,2,10,12
97,8480196,Jacob Bryson,D,BUF,27,42,2,10,12
97,8480001,Urho Vaakanainen,D,ANA,25,52,1,11,12
97,8475455,Brenden Dillon,D,NJD,34,62,1,11,12
97,8476372,Nick Seeler,D,PHI,31,43,0,12,12
97,8477070,Liam O'Brien,C,UTA,30,51,8,3,11
97,8475235,Nicolas Deslauriers,L,PHI,33,50,7,4,11
97,8480252,Cole Guttman,C,CHI,25,41,6,5,11
97,8479536,Axel Jonsson-Fjallby,L,WPG,26,45,6,5,11
97,8481028,Martin Pospisil,C,CGY,25,60,5,6,11
97,8478434,Keegan Kolesar,R,VGK,27,57,4,7,11
97,8477380,Jonny Brodzinski,C,NYR,31,53,4,7,11
97,8482747,Brennan Othmann,L,NYR,21,35,4,7,11
97,8476952,Dominic Toninato,C,WPG,30,39,3,8,11
97,8474090,Brendan Smith,D,DAL,35,52,3,8,11
97,8476934,Brock McGinn,L,ANA,30,48,3,8,11
97,8480441,Trey Fix-Wolansky,R,CBJ,25,38,3,8,11
97,8474568,Luke Schenn,D,NSH,35,53,3,8,11
97,8481605,Jackson LaCombe,D,ANA,23,41,3,8,11
97,8477938,Haydn Fleury,D,WPG,28,40,2,9,11
97,8478831,Kevin Stenlund,C,UTA,28,50,8,2,10
97,8482148,Hendrix Lapierre,C,WSH,22,51,8,2,10
97,8481518,Nolan Foote,L,NJD,24,41,7,3,10
97,8475958,Michael Sgarbossa,C,WSH,32,32,7,3,10
97,8479972,Mason Shaw,C,WPG,26,39,6,4,10
97,8479981,Jonah Gadjovich,L,FLA,26,43,6,4,10
97,8479378,Logan Stanley,D,WPG,26,40,6,4,10
97,8479520,Brandon Duhaime,R,WSH,27,48,4,6,10
97,8476874,Olli Maatta,D,DET,30,65,4,6,10
97,8482634,Alex Steeves,C,TOR,25,49,4,6,10
97,8477482,Zachary Sanford,L,CHI,30,45,4,6,10
97,8479359,Beck Malenstyn,L,BUF,26,48,4,6,10
97,8481013,Jonatan Berggren,R,DET,24,54,4,6,10
97,8474612,Travis Hamonic,D,OTT,34,51,3,7,10
97,8483619,Filip Roos,D,OTT,25,27,3,7,10
97,8479249,Andrew Poturalski,C,SJS,30,27,2,8,10
97,8475762,Derek Forbort,D,VAN,32,46,2,8,10
97,8479371,Dante Fabbro,D,NSH,26,60,1,9,10
97,8475690,Chris Tanev,D,TOR,35,55,1,9,10
97,8480058,Pierre-Olivier Joseph,D,STL,25,56,1,9,10
97,8482964,Arber Xhekaj,D,MTL,23,51,6,3,9
97,8482652,Walker Duehr,R,CGY,27,47,6,3,9
97,8478409,Anthony Richard,C,PHI,28,35,5,4,9
97,8476858,Phillip Di Giuseppe,L,VAN,31,37,4,5,9
97,8481147,Reese Johnson,C,MIN,26,36,4,5,9
97,8477887,Patrick Brown,C,BOS,32,46,4,5,9
97,8481014,Alexander Romanov,D,NYI,24,79,3,6,9
97,8482859,Zack Ostapchuk,C,OTT,21,54,3,6,9
97,8478017,Mark Friedman,D,VAN,29,38,3,6,9
97,8477335,Kyle Burroughs,D,LAK,29,37,3,6,9
97,8481701,Santeri Hatakka,D,NJD,23,42,3,6,9
97,8480848,Ty Dellandrea,C,SJS,24,41,2,7,9
97,8475750,Jon Merrill,D,MIN,32,61,1,8,9
97,8480070,Ian Mitchell,D,BOS,25,41,1,8,9
97,8482095,Tyler Kleven,D,OTT,22,45,1,8,9
97,8479671,Mathieu Olivier,R,CBJ,27,46,4,4,8
97,8481532,Alex Turcotte,C,LAK,23,47,4,4,8
97,8481543,Nikita Alexandrov,C,STL,24,31,4,4,8
97,8483763,Maksymilian Szuber,D,UTA,22,29,3,5,8
97,8471677,Jack Johnson,D,CBJ,37,55,2,6,8
97,8483460,David Jiricek,D,CBJ,21,56,2,6,8
97,8479986,Kole Lind,R,DAL,26,52,2,6,8
97,8479980,Nicolas Hague,D,VGK,26,55,1,7,8
97,8480192,Johnathan Kovacevic,D,NJD,27,46,1,7,8
97,8480950,Ilya Lyubushkin,D,DAL,30,52,1,7,8
97,8481598,Philip Broberg,D,EDM,23,44,1,7,8
97,8478450,Parker Wotherspoon,D,BOS,27,32,1,7,8
97,8480845,Rasmus Kupari,C,WPG,24,35,1,7,8
97,8477018,Ben Hutton,D,VGK,31,46,0,8,8
97,8478451,Ethan Bear,D,WSH,27,45,0,8,8
97,8480890,Jan Jenik,C,OTT,24,23,0,8,8
97,8478454,Noah Juulsen,D,VAN,27,32,0,8,8
97,8484911,Collin Graf,R,SJS,22,38,5,2,7
97,8481600,Tobias Bjornfot,D,FLA,23,45,5,2,7
97,8480292,Carson Meyer,R,ANA,27,29,4,3,7
97,8479772,Zack MacEwen,R,OTT,28,55,4,3,7
97,8482153,Brendan Brisson,C,VGK,23,38,4,3,7
97,8478502,Dennis Gilbert,D,BUF,28,17,3,4,7
97,8481568,Alex Vlasic,D,CHI,23,55,2,5,7
97,8482496,Nils Aman,C,VAN,24,32,2,5,7
97,8478211,Dryden Hunt,L,CGY,29,60,2,5,7
97,8481716,Dmitri Voronkov,L,CBJ,24,37,2,5,7
97,8482511,Mason Lohrei,D,BOS,23,35,2,5,7
97,8481237,Kyle MacLean,C,NYI,25,25,2,5,7
97,8477962,Brendan Lemieux,L,CAR,28,41,1,6,7
97,8477401,John Hayden,C,SEA,29,40,1,6,7
97,8481167,Brayden Pachal,D,CGY,25,37,1,6,7
97,8484254,Akito Hirose,D,VAN,25,33,1,6,7
97,8481056,Spencer Stastney,D,NSH,24,32,0,7,7
97,8483570,Ben Meyers,C,SEA,26,32,6,0,6
97,8484287,Cole McWard,D,VAN,23,25,6,0,6
97,8481422,Jake Lucchini,C,NSH,29,21,4,2,6
97,8477473,Justin Bailey,R,SJS,29,22,4,2,6
97,8476473,Connor Murphy,D,CHI,31,39,3,3,6
97,8475177,Calvin de Haan,D,COL,33,47,3,3,6
97,8482516,Matthew Kessel,D,STL,24,15,3,3,6
97,8482713,Mackie Samoskevich,R,FLA,22,41,3,3,6
97,8478468,Jeremy Lauzon,D,NSH,27,54,2,4,6
97,8479379,Givani Smith,R,SJS,26,32,2,4,6
97,8482177,Marat Khusnutdinov,C,MIN,22,41,2,4,6
97,8477244,Chad Ruhwedel,D,NYR,34,32,2,4,6
97,8480879,Jacob Bernard-Docker,D,OTT,24,44,1,5,6
97,8482751,Ryan Winterton,C,SEA,21,40,1,5,6
97,8477467,Gustav Olofsson,D,SEA,30,15,1,5,6
97,8482144,Jack Thompson,D,SJS,22,26,1,5,6
97,8481006,Tyler Tucker,D,STL,24,18,1,5,6
97,8482145,Mavrik Bourque,C,DAL,22,55,5,0,5
97,8478424,Jansen Harkins,C,ANA,27,36,4,1,5
97,8479638,Justin Brazeau,R,BOS,26,29,4,1,5
97,8482147,Jean-Luc Foudy,C,COL,22,30,4,1,5
97,8480880,Jakub Lauko,C,MIN,24,34,3,2,5
97,8479994,Jaret Anderson-Dolan,C,WPG,25,36,2,3,5
97,8483630,Pavol Regenda,L,ANA,25,30,2,3,5
97,8481679,Maxence Guenette,D,OTT,23,29,2,3,5
97,8480870,Bo Groulx,C,NYR,24,29,2,3,5
97,8480834,Ty Emberson,D,SJS,24,40,2,3,5
97,8478146,Matthew Highmore,C,OTT,28,40,2,3,5
97,8480844,Grigori Denisenko,L,VGK,24,30,2,3,5
97,8480245,Olle Lycksell,R,PHI,25,30,2,3,5
97,8479367,William Lockwood,R,FLA,26,20,2,3,5
97,8482762,Simon Edvinsson,D,DET,21,49,1,4,5
97,8476913,Devin Shore,C,MIN,30,28,1,4,5
97,8481743,Marc Del Gaizo,D,NSH,25,20,1,4,5
97,8474062,Riley Nash,C,NYR,35,18,1,4,5
97,8473446,Erik Johnson,D,PHI,36,48,0,5,5
97,8480990,Declan Chisholm,D,MIN,24,49,0,5,5
97,8477149,Scott Sabourin,R,SJS,32,20,0,5,5
97,8482250,Callahan Burke,C,VGK,27,25,0,5,5
97,8477462,Robert Hagg,D,VGK,29,22,0,5,5
97,8482102,Vasily Ponomarev,C,PIT,22,22,3,1,4
97,8481556,John Beecher,C,BOS,23,33,2,2,4
97,8481030,Jack St. Ivany,D,PIT,25,22,2,2,4
97,8482162,Roby Jarventie,L,EDM,22,15,2,2,4
97,8480007,Jonas Rondbjerg,R,VGK,25,34,1,3,4
97,8481609,Vladislav Kolyachonok,D,UTA,23,34,1,3,4
97,8481593,Jayden Struble,D,MTL,23,18,1,3,4
97,8481462,Mason Morelli,L,VGK,28,13,1,3,4
97,8479576,Vincent Desharnais,D,VAN,28,43,1,3,4
97,8482784,Zach Dean,C,STL,21,39,0,4,4
97,8483549,Lucas Condotta,L,MTL,27,33,0,4,4
97,8477384,Joshua Brown,D,EDM,30,39,0,4,4
97,8478051,Max Willman,C,NJD,29,21,0,4,4
97,8483012,Logan Morrison,C,SEA,22,31,3,0,3
97,8482141,Lukas Cormier,D,VGK,22,28,3,0,3
97,8476867,Brendan Gaunce,C,MIN,30,31,2,1,3
97,8479419,Brett Murray,L,BUF,26,18,2,1,3
97,8480468,James Hamblin,L,EDM,25,15,2,1,3
97,8479985,Cale Fleury,D,SEA,26,30,2,1,3
97,8482088,Justin Sourdif,R,FLA,22,15,2,1,3
97,8477320,Anton Blidh,L,NYR,29,21,2,1,3
97,8478881,Brett Seney,L,CHI,28,17,2,1,3
97,8484325,Waltteri Merela,C,TBL,26,16,2,1,3
97,8482061,Brandon Biro,L,SEA,26,13,2,1,3
97,8481043,Cole Koepke,L,BOS,26,14,1,2,3
97,8482172,Landon Slaggert,L,CHI,22,22,1,2,3
97,8482201,Gage Goncalves,C,TBL,23,25,1,2,3
97,8480874,Adam Ginning,D,PHI,24,9,1,2,3
97,8482733,Logan Mailloux,D,MTL,31,27,0,3,3
97,8478874,Adam Gaudette,R,OTT,28,33,0,3,3
97,8482070,Mitchell Chaffee,R,TBL,26,53,0,3,3
97,8477810,Joel Hanley,D,CGY,33,12,0,3,3
97,8483398,Declan Carlile,D,TBL,31,8,0,3,3
97,8482765,Isak Rosen,R,BUF,21,23,2,0,2
97,8479362,Riley Tufte,L,BOS,26,7,2,0,2
97,8478011,Louie Belpedio,D,PHI,28,12,2,0,2
97,8483397,Marc McLaughlin,C,BOS,25,32,1,1,2
97,8478446,Glenn Gawdin,C,LAK,27,13,1,1,2
97,8480032,Shane Bowers,C,NJD,25,11,1,1,2
97,8481726,Adam Edstrom,C,NYR,24,12,1,1,2
97,8483546,Marshall Rifai,D,TOR,26,7,1,1,2
97,8477541,Dakota Mermis,D,TOR,30,11,1,1,2
97,8482126,Emil Andrae,D,PHI,31,6,1,1,2
97,8484258,Sam Malinski,D,COL,26,26,0,2,2
97,8477527,Ross Johnston,L,ANA,30,29,0,2,2
97,8475795,Dylan McIlrath,D,WSH,32,15,0,2,2
97,8482470,Ilya Solovyov,D,CGY,24,17,0,2,2
97,8477971,Andreas Englund,D,LAK,28,18,0,2,2
97,8481806,Louis Crevier,D,CHI,23,15,0,2,2
97,8479320,Maxime Lajoie,D,SEA,27,20,0,2,2
97,8482118,Sam Colangelo,R,ANA,23,9,0,2,2
97,8475755,Alexander Petrovic,D,DAL,32,10,0,2,2
97,8482165,Yan Kuznetsov,D,CGY,22,24,1,0,1
97,8480851,Akil Thomas,C,LAK,24,18,1,0,1
97,8481699,Aku Raty,R,UTA,23,10,1,0,1
97,8480084,Nick DeSimone,D,NJD,30,17,1,0,1
97,8481534,Raphael Lavoie,C,EDM,24,5,1,0,1
97,8481541,Samuel Bolduc,D,NYI,24,26,0,1,1
97,8481122,Simon Benoit,D,TOR,26,32,0,1,1
97,8479991,Jake Leschyshyn,C,NYR,25,25,0,1,1
97,8480267,Sammy Walker,C,MIN,25,13,0,1,1
97,8477073,Kurtis MacDermid,L,NJD,30,30,0,1,1
97,8481024,Linus Karlsson,C,VAN,25,10,0,1,1
97,8481578,Graeme Clarke,R,MIN,23,17,0,1,1
97,8481564,Ryan Johnson,D,BUF,23,12,0,1,1
97,8478477,Mitchell Stephens,C,SEA,27,19,0,1,1
97,8481065,Angus Crookshank,L,OTT,25,12,0,1,1
97,8478021,William Lagesson,D,DET,28,24,0,1,1
97,8479587,Rhett Gardner,C,PHI,28,16,0,1,1
97,8481719,Maxwell Crozier,D,TBL,24,19,0,1,1
97,8482476,Emil Heineman,L,MTL,23,7,0,1,1
97,8484304,Uvis Balinskis,D,FLA,28,9,0,1,1
97,8483432,Luca Del Bel Belluz,C,CBJ,31,9,0,1,1
97,8479330,Brandon Gignac,C,MTL,27,11,0,1,1
97,8482858,Ryker Evans,D,SEA,23,16,0,0,0
97,8483597,Milos Kelemen,L,UTA,25,15,0,0,0
97,8483471,Brad Lambert,C,WPG,31,8,0,0,0
97,8475780,Chris Wagner,R,COL,33,8,0,0,0
97,8477993,Justin Kirkland,C,CGY,28,2,0,0,0
97,8484255,Jason Polin,R,COL,25,1,0,0,0
97,8482929,Emil Lilleberg,D,TBL,23,18,0,0,0
97,8482460,Matt Rempe,C,NYR,22,9,0,0,0
97,8483567,Georgii Merkulov,C,BOS,24,12,0,0,0
97,8481206,John Ludvig,D,PIT,24,8,0,0,0
97,8483512,Matthew Savoie,C,EDM,20,23,0,0,0
97,8483531,Brian Halonen,L,NJD,25,4,0,0,0
97,8480075,Cameron Crotty,D,MIN,25,8,0,0,0
97,8483489,Fraser Minten,C,TOR,31,8,0,0,0
97,8476323,Max McCormick,L,SEA,32,4,0,0,0
97,8482094,Daemon Hunt,D,MIN,22,10,0,0,0
97,8483395,Arshdeep Bains,L,VAN,23,9,0,0,0
97,8478147,Bokondji Imama,L,PIT,28,5,0,0,0
97,8481585,Egor Afanasyev,L,SJS,23,7,0,0,0
97,8483407,Brandon Scanlin,D,NYR,25,5,0,0,0
97,8475413,Justin Dowling,C,NJD,34,15,0,0,0
97,8480823,Alexander Alexeyev,D,WSH,25,9,0,0,0
97,8482787,Nikita Chibrikov,R,WPG,31,4,0,0,0
97,8483920,Pierrick Dube,R,WSH,23,4,0,0,0
97,8478854,Ryan Shea,D,PIT,27,9,0,0,0
97,8479522,Hardy Haman Aktell,D,WSH,26,2,0,0,0
97,8482197,Adam Raska,R,MIN,23,5,0,0,0
97,8481655,Cole Schwindt,R,CGY,23,4,0,0,0
97,8483609,Adam Klapka,R,CGY,24,3,0,0,0
97,8480306,Grant Hutton,D,NYI,29,6,0,0,0
97,8479421,Jacob Moverare,D,LAK,26,4,0,0,0
97,8484321,Nikolas Matinpalo,D,OTT,26,1,0,0,0
97,8483401,Marc Johnstone,R,PIT,28,1,0,0,0
97,8484326,Patrik Koch,D,UTA,28,2,0,0,0
97,8478956,Samuel Laberge,L,NJD,27,2,0,0,0
97,8480274,Philip Kemp,D,EDM,25,1,0,0,0
97,8484259,Ondrej Pavel,C,COL,31,0,0,0,0
97,8470794,Joe Pavelski,C,,40,0,0,0,0
97,8479321,Lucas Johansen,D,,27,0,0,0,0
97,8477950,Tony DeAngelo,D,,29,0,0,0,0
97,8471218,Blake Wheeler,R,,38,0,0,0,0
97,8475197,Tyson Barrie,D,,33,0,0,0,0
97,8474157,Max Pacioretty,L,,36,0,0,0,0
97,8475744,Evgeny Kuznetsov,C,,32,0,0,0,0
97,8474037,James van Riemsdyk,L,,35,0,0,0,0
97,8476907,Mackenzie MacEachern,L,,30,0,0,0,0
97,8480216,Jacob Peterson,C,,25,0,0,0,0
97,8474602,Justin Schultz,D,,34,0,0,0,0
97,8482222,Alexander Barabanov,L,,30,0,0,0,0
97,8474031,Kevin Shattenkirk,D,,35,0,0,0,0
97,8477330,Dominik Kubalik,L,,29,0,0,0,0
97,8480884,Calen Addison,D,,24,0,0,0,0
97,8475906,John Klingberg,D,,32,0,0,0,0
97,8480008,Adam Ruzicka,C,,25,0,0,0,0
97,8476884,Derrick Pouliot,D,,30,0,0,0,0
97,8476919,Chris Tierney,C,,30,0,0,0,0
97,8479415,Michael McLeod,C,,26,0,0,0,0
97,8474870,Tyler Johnson,C,,34,0,0,0,0
97,8470604,Jeff Carter,C,,39,0,0,0,0
97,8478104,Sammy Blais,L,,28,0,0,0,0
97,8474884,Mike Hoffman,C,,35,0,0,0,0
97,8481591,Sam Poulin,R,,23,0,0,0,0
97,8471274,Alex Goligoski,D,,39,0,0,0,0
97,8476871,Tanner Pearson,L,,32,0,0,0,0
97,8476393,Nick Cousins,C,,31,0,0,0,0
97,8479977,Kailer Yamamoto,R,,26,0,0,0,0
97,8479346,Dillon Dube,C,,26,0,0,0,0
97,8480184,Gustav Lindstrom,D,,26,0,0,0,0
97,8479376,Victor Mete,D,,26,0,0,0,0
97,8473449,Kyle Okposo,R,,36,0,0,0,0
97,8481058,Jesse Ylonen,R,,25,0,0,0,0
97,8475752,Tyler Pitlick,C,,33,0,0,0,0
97,8481239,Samuel Fagemo,L,,24,0,0,0,0
97,8480821,Filip Zadina,R,,25,0,0,0,0
97,8470966,Mark Giordano,D,,41,0,0,0,0
97,8478495,Denis Gurianov,R,,27,0,0,0,0
97,8477464,Nic Petan,C,,29,0,0,0,0
97,8478099,Kevin Labanc,R,,29,0,0,0,0
97,8482241,Radim Zohorna,L,,28,0,0,0,0
97,8474040,Sam Gagner,C,,35,0,0,0,0
97,8479514,Rem Pitlick,C,,27,0,0,0,0
97,8478430,Oliver Kylington,D,,27,0,0,0,0
97,8479533,Joona Koppanen,L,,26,0,0,0,0
97,8479984,Cal Foote,D,,26,0,0,0,0
97,8477126,Jayson Megna,C,,34,0,0,0,0
97,8475164,Jakob Silfverberg,R,,34,0,0,0,0
97,8474009,Nick Bonino,C,,36,0,0,0,0
97,8479458,Nikita Zaitsev,D,,33,0,0,0,0
97,8477944,Jakub Vrana,L,,28,0,0,0,0
97,8471699,Andrew Cogliano,C,,37,0,0,0,0
97,8478067,Oskar Lindblom,L,,28,0,0,0,0
97,8471686,Marc Staal,D,,37,0,0,0,0
97,8470610,Zach Parise,L,,40,0,0,0,0
97,8478904,Steven Lorentz,C,,28,0,0,0,0
97,8473473,Milan Lucic,L,,36,0,0,0,0
97,8480031,Maxime Comtois,L,,25,0,0,0,0
97,8478512,Austin Czarnik,C,,32,0,0,0,0
97,8473504,Cal Clutterbuck,R,,37,0,0,0,0
97,8477454,Adam Erne,L,,29,0,0,0,0
97,8479383,Boris Katchouk,L,,26,0,0,0,0
97,8475825,Jani Hakanpää,D,,32,0,0,0,0
97,8477846,Ryan Carpenter,C,,33,0,0,0,0
97,8477930,Pierre-Edouard Bellemare,L,,39,0,0,0,0
97,8478400,Colin White,C,,27,0,0,0,0
97,8480226,Marián Studenic,R,,26,0,0,0,0
97,8480853,Liam Foudy,C,,24,0,0,0,0
97,8475797,Jarred Tinordi,D,,32,0,0,0,0
97,8479423,Alex Nylander,L,,26,0,0,0,0
97,8474618,Marco Scandella,D,,34,0,0,0,0
97,8478028,Fredrik Olofsson,L,,28,0,0,0,0
97,8474709,Matt Martin,L,,35,0,0,0,0
97,8481070,Hugh McGing,L,,26,0,0,0,0
97,8479546,Oskar Steen,C,,26,0,0,0,0
97,8474145,Robert Bortuzzo,D,,35,0,0,0,0
97,8476915,Jujhar Khaira,L,,30,0,0,0,0
97,8475278,Byron Froese,C,,33,0,0,0,0
97,8481812,Nikolai Knyzhov,D,,27,0,0,0,0
97,8478408,Travis Dermott,D,,28,0,0,0,0
97,8481077,John Leonard,L,,26,0,0,0,0
97,8479547,Matthew Phillips,R,,26,0,0,0,0
97,8480836,Jonathan Gruden,C,,24,0,0,0,0
97,8481690,Tyler Angle,C,,24,0,0,0,0
97,8475766,Austin Watson,L,,32,0,0,0,0
97,8481016,Ruslan Iskhakov,C,,24,0,0,0,0
97,8478078,Rourke Chartier,C,,28,0,0,0,0
97,8480776,Sheldon Rempal,R,,29,0,0,0,0
97,8483045,Cameron Butler,R,CBJ,31,0,0,0,0
97,8484314,Jiri Smejkal,L,,28,0,0,0,0
