Simulation,PlayerID,Player,Position,Team,Age,Games Played,Goals,Assists,Points
1,8479318,Auston Matthews,C,TOR,27,82,72,54,126
1,8478402,Connor McDavid,C,EDM,27,82,31,89,120
1,8476453,Nikita Kucherov,R,TBL,31,82,40,74,114
1,8480800,Quinn Hughes,D,VAN,25,82,27,79,106
1,8480012,Elias Pettersson,C,VAN,26,82,41,64,105
1,8477956,David Pastrnak,R,BOS,28,82,49,55,104
1,8481559,Jack Hughes,C,NJD,23,82,35,64,99
1,8475786,Zach Hyman,L,EDM,32,82,59,38,97
1,8477934,Leon Draisaitl,C,EDM,29,82,23,73,96
1,8478864,Kirill Kaprizov,L,MIN,27,82,48,47,95
1,8476887,Filip Forsberg,L,NSH,30,82,44,51,95
1,8478010,Brayden Point,C,TBL,28,82,48,45,93
1,8476468,J.T. Miller,C,VAN,31,82,36,57,93
1,8478550,Artemi Panarin,L,NYR,33,82,38,54,92
1,8477493,Aleksander Barkov,C,FLA,29,82,26,65,91
1,8478427,Sebastian Aho,C,CAR,27,82,40,49,89
1,8479314,Matthew Tkachuk,L,FLA,27,82,34,55,89
1,8477404,Jake Guentzel,C,CAR,30,82,41,47,88
1,8477492,Nathan MacKinnon,C,COL,29,82,39,49,88
1,8480002,Nico Hischier,C,NJD,25,82,34,53,87
1,8474600,Roman Josi,D,NSH,34,82,24,63,87
1,8475692,Mats Zuccarello,R,MIN,37,82,19,68,87
1,8477942,Kevin Fiala,L,LAK,28,82,36,50,86
1,8476454,Ryan Nugent-Hopkins,C,EDM,31,82,28,58,86
1,8478420,Mikko Rantanen,R,COL,28,82,38,47,85
1,8477933,Sam Reinhart,C,FLA,29,82,47,35,82
1,8473512,Claude Giroux,R,OTT,36,82,26,56,82
1,8482116,Tim Stützle,C,OTT,22,82,36,45,81
1,8481557,Matt Boldy,L,MIN,23,82,35,46,81
1,8481523,Kirby Dach,C,MTL,23,82,15,66,81
1,8480023,Robert Thomas,C,STL,25,82,28,52,80
1,8479407,Jesper Bratt,L,NJD,26,82,26,53,79
1,8475167,Victor Hedman,D,TBL,34,82,16,63,79
1,8478398,Kyle Connor,L,WPG,28,82,37,41,78
1,8479343,Clayton Keller,R,ARI,26,82,33,45,78
1,8475166,John Tavares,C,TOR,34,82,32,46,78
1,8477939,William Nylander,R,TOR,28,82,26,52,78
1,8476346,Johnny Gaudreau,L,CBJ,31,82,20,58,78
1,8480027,Jason Robertson,L,DAL,25,82,31,46,77
1,8476853,Morgan Rielly,D,TOR,30,82,10,66,76
1,8477501,Valeri Nichushkin,R,COL,29,82,36,39,75
1,8478445,Mathew Barzal,C,NYI,27,82,23,52,75
1,8477946,Dylan Larkin,C,DET,28,82,38,36,74
1,8471214,Alex Ovechkin,L,WSH,39,82,38,35,73
1,8478403,Jack Eichel,C,VGK,28,82,30,43,73
1,8473419,Brad Marchand,L,BOS,36,82,27,46,73
1,8477955,Jared McCann,L,SEA,28,82,38,34,72
1,8480014,Gabriel Vilardi,C,WPG,25,82,38,34,72
1,8477409,Carter Verhaeghe,C,FLA,29,82,33,39,72
1,8476456,Jonathan Huberdeau,C,CGY,31,82,26,46,72
1,8471675,Sidney Crosby,C,PIT,37,82,36,35,71
1,8480801,Brady Tkachuk,L,OTT,25,82,35,36,71
1,8477951,Nick Schmaltz,C,ARI,28,82,30,41,71
1,8477416,Oliver Bjorkstrand,R,SEA,29,82,31,39,70
1,8480803,Evan Bouchard,D,EDM,25,82,18,52,70
1,8480865,Noah Dobson,D,NYI,24,82,13,57,70
1,8478042,Viktor Arvidsson,R,LAK,31,82,32,37,69
1,8475158,Ryan O'Reilly,C,NSH,33,82,26,43,69
1,8480208,Drake Batherson,R,OTT,26,82,26,43,69
1,8476460,Mark Scheifele,C,WPG,31,82,21,48,69
1,8477500,Bo Horvat,C,NYI,29,82,33,35,68
1,8474564,Steven Stamkos,C,TBL,34,82,31,37,68
1,8480188,Fabian Zetterlund,L,SJS,25,82,31,37,68
1,8480018,Nick Suzuki,C,MTL,25,82,29,39,68
1,8471215,Evgeni Malkin,C,PIT,38,82,27,41,68
1,8480069,Cale Makar,D,COL,26,82,18,50,68
1,8475913,Mark Stone,R,VGK,32,82,31,36,67
1,8479420,Tage Thompson,C,BUF,27,82,31,36,67
1,8478439,Travis Konecny,R,PHI,27,82,28,39,67
1,8475172,Nazem Kadri,C,CGY,34,82,28,39,67
1,8478440,Dylan Strome,C,WSH,27,82,22,45,67
1,8477949,Alex Tuch,R,BUF,28,82,21,46,67
1,8478414,Timo Meier,R,NJD,28,82,38,28,66
1,8476462,Dougie Hamilton,D,NJD,31,82,22,44,66
1,8482124,Quinton Byfield,R,LAK,22,82,20,46,66
1,8476459,Mika Zibanejad,C,NYR,31,82,32,33,65
1,8477479,Tyler Bertuzzi,L,TOR,29,82,32,33,65
1,8475765,Vladimir Tarasenko,R,FLA,33,82,29,36,65
1,8479385,Jordan Kyrou,C,STL,26,82,27,38,65
1,8480028,Morgan Frost,C,PHI,25,82,24,40,64
1,8482093,Seth Jarvis,C,CAR,22,82,22,42,64
1,8476539,Jonathan Marchessault,R,VGK,34,82,30,33,63
1,8479542,Brandon Hagel,L,TBL,26,82,22,41,63
1,8474590,John Carlson,D,WSH,34,82,11,52,63
1,8477447,Shea Theodore,D,VGK,29,82,9,54,63
1,8477940,Nikolaj Ehlers,L,WPG,28,82,26,36,62
1,8477402,Pavel Buchnevich,L,STL,29,82,25,37,62
1,8482078,Lucas Raymond,L,DET,22,82,24,38,62
1,8481533,Trevor Zegras,C,ANA,23,82,21,41,62
1,8480830,Andrei Svechnikov,R,CAR,24,82,19,43,62
1,8475169,Evander Kane,L,EDM,33,82,32,29,61
1,8478047,Michael Bunting,L,PIT,29,82,29,32,61
1,8475168,Matt Duchene,C,DAL,33,82,27,34,61
1,8475784,Jeff Skinner,C,BUF,32,82,27,34,61
1,8479337,Alex DeBrincat,R,DET,27,82,25,36,61
1,8475184,Chris Kreider,L,NYR,33,82,35,25,60
1,8478444,Brock Boeser,R,VAN,27,82,29,31,60
1,8474679,Gustav Nyquist,C,NSH,35,82,23,37,60
1,8479323,Adam Fox,D,NYR,26,82,15,45,60
1,8474578,Erik Karlsson,D,PIT,34,82,14,46,60
1,8479410,Mikhail Sergachev,D,TBL,26,82,9,51,60
1,8476389,Vincent Trocheck,C,NYR,31,82,34,25,59
1,8476905,Chandler Stephenson,C,VGK,30,82,21,38,59
1,8478460,Zach Werenski,D,CBJ,27,82,16,43,59
1,8482684,Luke Hughes,D,NJD,21,82,16,43,59
1,8477504,Josh Morrissey,D,WPG,29,82,10,49,59
1,8474641,Adam Henrique,C,EDM,34,82,26,32,58
1,8474102,David Perron,L,DET,36,82,26,32,58
1,8477476,Artturi Lehkonen,L,COL,29,82,25,33,58
1,8474157,Max Pacioretty,L,WSH,36,82,25,33,58
1,8482665,Matty Beniers,C,SEA,22,82,23,35,58
1,8481540,Cole Caufield,R,MTL,23,82,40,17,57
1,8475754,Brock Nelson,C,NYI,33,82,29,28,57
1,8477960,Adrian Kempe,R,LAK,28,82,26,31,57
1,8479675,Trevor Moore,L,LAK,29,82,26,31,57
1,8482745,Mason McTavish,C,ANA,21,82,24,33,57
1,8475810,Bryan Rust,R,PIT,32,82,20,37,57
1,8471685,Anze Kopitar,C,LAK,37,82,18,39,57
1,8476458,Ryan Strome,C,ANA,31,82,15,42,57
1,8478407,Vince Dunn,D,SEA,28,82,10,47,57
1,8474141,Patrick Kane,R,DET,36,82,26,30,56
1,8476881,Tomas Hertl,C,VGK,31,82,25,31,56
1,8480036,Miro Heiskanen,D,DAL,25,82,17,39,56
1,8481711,Matias Maccelli,L,ARI,24,82,10,46,56
1,8475151,Kyle Palmieri,C,NYI,33,82,34,21,55
1,8475726,Tyler Toffoli,C,WPG,32,82,23,32,55
1,8478449,Roope Hintz,C,DAL,28,82,19,36,55
1,8474150,Mikael Backlund,C,CGY,35,82,17,38,55
1,8475745,Charlie Coyle,C,BOS,32,82,17,38,55
1,8475798,Mikael Granlund,C,SJS,32,82,16,39,55
1,8479339,Patrik Laine,L,CBJ,26,82,25,29,54
1,8480015,Owen Tippett,R,PHI,25,82,25,29,54
1,8478873,Troy Terry,R,ANA,27,82,23,31,54
1,8482097,Jack Quinn,R,BUF,23,82,23,31,54
1,8478474,Lawson Crouse,L,ARI,27,82,19,35,54
1,8480039,Martin Necas,C,CAR,25,82,18,36,54
1,8477503,Max Domi,C,TOR,29,82,16,38,54
1,8479325,Charlie McAvoy,D,BOS,27,82,10,44,54
1,8480064,Josh Norris,C,OTT,25,82,27,26,53
1,8473986,Alex Killorn,L,ANA,35,82,22,31,53
1,8478519,Anthony Cirelli,C,TBL,27,82,21,32,53
1,8482740,Wyatt Johnston,C,DAL,21,82,20,33,53
1,8478396,Noah Hanifin,D,VGK,27,82,13,40,53
1,8482109,Alexis Lafrenière,L,NYR,23,82,23,29,52
1,8481528,Dylan Cozens,C,BUF,23,82,20,32,52
1,8477407,Anthony Duclair,L,TBL,29,82,20,32,52
1,8480220,Noah Cates,L,PHI,25,82,18,34,52
1,8478397,Rasmus Andersson,D,CGY,28,82,5,47,52
1,8476329,Travis Boyd,C,ARI,31,82,25,26,51
1,8477496,Elias Lindholm,C,VAN,30,82,20,31,51
1,8478401,Pavel Zacha,C,BOS,27,82,17,34,51
1,8478856,Conor Garland,R,VAN,28,82,17,34,51
1,8481068,Yegor Sharangovich,C,CGY,26,82,28,22,50
1,8475794,Tyler Seguin,C,DAL,32,82,24,26,50
1,8470794,Joe Pavelski,C,DAL,40,82,17,33,50
1,8477964,Ivan Barbashev,C,VGK,29,82,16,34,50
1,8477935,Sam Bennett,C,FLA,28,82,23,26,49
1,8484144,Connor Bedard,C,CHI,19,82,21,28,49
1,8473994,Jamie Benn,L,DAL,35,82,18,31,49
1,8480839,Rasmus Dahlin,D,BUF,24,82,12,37,49
1,8476432,Boone Jenner,C,CBJ,31,82,28,20,48
1,8475722,Jason Zucker,L,NSH,32,82,24,24,48
1,8478498,Jake DeBrusk,L,BOS,28,82,21,27,48
1,8476882,Teuvo Teravainen,L,CAR,30,82,20,28,48
1,8478493,Joel Eriksson Ek,C,MIN,27,82,17,31,48
1,8479999,Casey Mittelstadt,C,COL,26,82,16,32,48
1,8475744,Evgeny Kuznetsov,C,CAR,32,82,14,34,48
1,8476826,Yanni Gourde,C,SEA,33,82,14,34,48
1,8480031,Maxime Comtois,L,CAR,25,82,10,38,48
1,8476880,Tom Wilson,R,WSH,30,82,25,22,47
1,8476483,Rickard Rakell,R,PIT,31,82,23,24,47
1,8477932,Aaron Ekblad,D,FLA,28,82,12,35,47
1,8476906,Shayne Gostisbehere,D,DET,31,82,11,36,47
1,8477986,Brandon Montour,D,FLA,30,82,10,37,47
1,8477494,Jonathan Drouin,L,COL,29,82,9,38,47
1,8475287,Erik Haula,L,NJD,33,82,22,24,46
1,8475170,Brayden Schenn,C,STL,33,82,20,26,46
1,8483808,Andrei Kuzmenko,L,CGY,28,82,20,26,46
1,8474037,James van Riemsdyk,L,BOS,35,82,20,26,46
1,8477495,Seth Jones,D,CHI,30,82,14,32,46
1,8475768,Jaden Schwartz,C,SEA,32,82,14,32,46
1,8481606,Jordan Spence,D,LAK,23,82,6,40,46
1,8480893,Kirill Marchenko,R,CBJ,24,82,18,27,45
1,8476399,Blake Coleman,C,CGY,33,82,17,28,45
1,8475218,Mattias Ekholm,D,EDM,34,82,16,29,45
1,8477998,Warren Foegele,L,EDM,28,82,16,29,45
1,8482475,Yegor Chinakhov,R,CBJ,23,82,15,30,45
1,8481596,Shane Pinto,C,OTT,24,82,14,31,45
1,8475753,Justin Faulk,D,STL,32,82,11,34,45
1,8477451,Ryan Hartman,R,MIN,30,82,24,20,44
1,8482101,Danil Gushchin,L,SJS,22,82,23,21,44
1,8482699,Dylan Guenther,R,ARI,21,82,22,22,44
1,8476872,Scott Laughton,C,PHI,30,82,19,25,44
1,8476419,Jean-Gabriel Pageau,C,NYI,32,82,16,28,44
1,8478469,Thomas Chabot,D,OTT,27,82,15,29,44
1,8480798,Philipp Kurashev,C,CHI,25,82,15,29,44
1,8478462,Nicolas Roy,C,VGK,27,82,15,29,44
1,8482720,Matthew Knies,L,TOR,22,82,15,29,44
1,8477021,Alex Kerfoot,C,ARI,30,82,13,31,44
1,8474563,Drew Doughty,D,LAK,35,82,9,35,44
1,8478233,Andrew Mangiapane,L,CGY,28,82,22,21,43
1,8480459,Pius Suter,C,VAN,28,82,22,21,43
1,8481624,Ilya Mikheyev,R,VAN,30,82,20,23,43
1,8477497,Sean Monahan,C,WPG,30,82,15,28,43
1,8479987,Morgan Geekie,C,BOS,26,82,12,31,43
1,8478975,Mason Marchment,L,DAL,29,82,11,32,43
1,8478438,Tommy Novak,C,NSH,27,82,11,32,43
1,8476875,Mike Matheson,D,MTL,30,82,9,34,43
1,8481699,Aku Raty,R,ARI,23,82,7,36,43
1,8475799,Nino Niederreiter,R,WPG,32,82,25,17,42
1,8477456,J.T. Compher,L,DET,29,82,20,22,42
1,8479400,Pierre-Luc Dubois,L,LAK,26,82,20,22,42
1,8475191,Reilly Smith,R,PIT,33,82,19,23,42
1,8476479,Phillip Danault,C,LAK,31,82,15,27,42
1,8471218,Blake Wheeler,R,NYR,38,82,12,30,42
1,8478038,Devon Toews,D,COL,30,82,9,33,42
1,8479425,Filip Hronek,D,VAN,27,82,9,33,42
1,8483471,Brad Lambert,C,WPG,31,82,6,36,42
1,8475764,Cam Fowler,D,ANA,33,82,5,37,42
1,8476792,Torey Krug,D,STL,33,82,3,39,42
1,8483397,Marc McLaughlin,C,BOS,25,82,36,5,41
1,8476448,William Karlsson,C,VGK,31,82,19,22,41
1,8482159,Tyson Foerster,R,PHI,22,82,18,23,41
1,8482113,Anton Lundell,C,FLA,23,82,18,23,41
1,8483445,Cutter Gauthier,L,ANA,20,82,14,27,41
1,8478046,Danton Heinen,L,BOS,29,82,13,28,41
1,8478472,Mathieu Joseph,R,OTT,27,82,12,29,41
1,8478366,Frank Vatrano,R,ANA,30,82,24,16,40
1,8480849,Barrett Hayton,C,ARI,24,82,23,17,40
1,8480797,Joel Farabee,L,PHI,24,82,20,20,40
1,8477511,Anthony Mantha,R,VGK,30,82,19,21,40
1,8479345,Jakob Chychrun,D,OTT,26,82,17,23,40
1,8476292,Ondrej Palat,L,NJD,33,82,16,24,40
1,8482222,Alexander Barabanov,L,SJS,30,82,15,25,40
1,8470613,Brent Burns,D,CAR,39,82,13,27,40
1,8474053,Logan Couture,C,SJS,35,82,10,30,40
1,8478500,Ivan Provorov,D,CBJ,27,82,9,31,40
1,8476869,Brady Skjei,D,CAR,30,82,7,33,40
1,8475906,John Klingberg,D,TOR,32,82,7,33,40
1,8477346,MacKenzie Weegar,D,CGY,30,82,6,34,40
1,8471698,T.J. Oshie,R,WSH,38,82,25,14,39
1,8481560,Arthur Kaliyev,R,LAK,23,82,19,20,39
1,8478542,Evan Rodrigues,C,FLA,31,82,16,23,39
1,8484153,Leo Carlsson,C,ANA,20,82,14,25,39
1,8481581,Thomas Harley,D,DAL,23,82,11,28,39
1,8474565,Alex Pietrangelo,D,VGK,34,82,8,31,39
1,8482105,Jake Sanderson,D,OTT,22,82,6,33,39
1,8481542,Moritz Seider,D,DET,23,82,6,33,39
1,8483524,Shane Wright,C,SEA,20,82,32,6,38
1,8478463,Anthony Beauvillier,L,NSH,27,82,19,19,38
1,8479992,Michael Rasmussen,C,DET,25,82,17,21,38
1,8478458,Jack Roslovic,C,NYR,27,82,14,24,38
1,8476960,Andreas Athanasiou,C,CHI,30,82,13,25,38
1,8478466,Daniel Sprong,R,DET,27,82,13,25,38
1,8480434,Sean Durzi,D,ARI,26,82,11,27,38
1,8475197,Tyson Barrie,D,NSH,33,82,9,29,38
1,8473563,Nicklas Backstrom,C,WSH,37,82,9,29,38
1,8471724,Kris Letang,D,PIT,37,82,7,31,38
1,8476854,Hampus Lindholm,D,BOS,30,82,6,32,38
1,8483493,Frank Nazar,C,CHI,20,82,24,13,37
1,8479423,Alex Nylander,L,CBJ,26,82,21,16,37
1,8483515,Juraj Slafkovsky,L,MTL,20,82,19,18,37
1,8482055,Drew O'Connor,L,PIT,26,82,18,19,37
1,8482175,JJ Peterka,R,BUF,22,82,15,22,37
1,8478891,Mason Appleton,C,WPG,28,82,15,22,37
1,8477488,Brett Pesce,D,CAR,30,82,11,26,37
1,8477948,Travis Sanheim,D,PHI,28,82,10,27,37
1,8477989,Christian Dvorak,C,MTL,28,82,21,15,36
1,8480113,Alex Iafallo,L,WPG,31,82,20,16,36
1,8482667,William Eklund,L,SJS,22,82,15,21,36
1,8479415,Michael McLeod,C,NJD,26,82,15,21,36
1,8478413,Jordan Greenway,L,BUF,27,82,13,23,36
1,8481656,Aliaksei Protas,C,WSH,23,82,10,26,36
1,8476979,Erik Gustafsson,D,NYR,32,82,6,30,36
1,8483457,Lane Hutson,D,MTL,20,82,1,35,36
1,8482110,Dawson Mercer,C,NJD,23,82,18,17,35
1,8482705,Cole Sillinger,C,CBJ,21,82,17,18,35
1,8477444,Andre Burakovsky,L,SEA,29,82,17,18,35
1,8482092,Ridly Greig,C,OTT,22,82,16,19,35
1,8482146,Luke Evangelista,R,NSH,22,82,14,21,35
1,8479996,Cody Glass,C,NSH,25,82,14,21,35
1,8475200,Dmitry Orlov,D,CAR,33,82,9,26,35
1,8481013,Jonatan Berggren,R,DET,24,82,8,27,35
1,8480873,Rasmus Sandin,D,WSH,24,82,7,28,35
1,8482671,Owen Power,D,BUF,22,82,6,29,35
1,8474151,Ryan McDonagh,D,NSH,35,82,5,30,35
1,8482259,Bobby McMann,C,TOR,28,82,22,12,34
1,8484166,Adam Fantilli,C,CBJ,20,82,17,17,34
1,8474715,Cam Atkinson,R,PHI,35,82,15,19,34
1,8478178,Darren Raddysh,D,TBL,28,82,11,23,34
1,8477506,Ryan Pulock,D,NYI,30,82,8,26,34
1,8482733,Logan Mailloux,D,MTL,31,82,5,29,34
1,8481016,Ruslan Iskhakov,C,NYI,24,82,5,29,34
1,8482089,Jake Neighbours,L,STL,22,82,23,10,33
1,8481604,Pavel Dorofeyev,L,VGK,24,82,20,13,33
1,8475714,Calle Jarnkrok,C,TOR,33,82,19,14,33
1,8474870,Tyler Johnson,C,CHI,34,82,17,16,33
1,8478020,Michael Amadio,C,VGK,28,82,16,17,33
1,8478057,Dakota Joshua,C,VAN,28,82,14,19,33
1,8480802,Ryan McLeod,C,EDM,25,82,13,20,33
1,8479353,Brett Howden,C,VGK,26,82,13,20,33
1,8477429,Andrew Copp,C,DET,30,82,12,21,33
1,8479525,Ross Colton,C,COL,28,82,12,21,33
1,8480009,Eeli Tolvanen,R,SEA,25,82,11,22,33
1,8476917,Adam Pelech,D,NYI,30,82,5,28,33
1,8475760,Nick Bjugstad,C,ARI,32,82,21,11,32
1,8477952,Robby Fabbri,C,DET,28,82,20,12,32
1,8476438,Brandon Saad,L,STL,32,82,17,15,32
1,8482624,Daniil Miromanov,D,CGY,27,82,12,20,32
1,8475763,Kevin Hayes,R,STL,32,82,11,21,32
1,8480817,K'Andre Miller,D,NYR,24,82,10,22,32
1,8476927,Teddy Blueger,C,VAN,30,82,9,23,32
1,8479983,Mario Ferraro,D,SJS,26,82,7,25,32
1,8474716,Jared Spurgeon,D,MIN,35,82,7,25,32
1,8476958,Jaccob Slavin,D,CAR,30,82,5,27,32
1,8480821,Filip Zadina,R,SJS,25,82,19,12,31
1,8482111,Justin Barron,D,MTL,23,82,15,16,31
1,8470604,Jeff Carter,C,PIT,39,82,15,16,31
1,8474586,Jordan Eberle,R,SEA,34,82,12,19,31
1,8479346,Dillon Dube,C,CGY,26,82,12,19,31
1,8480185,Eetu Luostarinen,C,FLA,26,82,11,20,31
1,8478882,Vladislav Gavrikov,D,LAK,29,82,10,21,31
1,8475791,Taylor Hall,L,CHI,33,82,10,21,31
1,8480806,Isac Lundestrom,C,ANA,25,82,10,21,31
1,8479977,Kailer Yamamoto,R,SEA,26,82,10,21,31
1,8477953,Kasperi Kapanen,R,STL,28,82,7,24,31
1,8480043,Timothy Liljegren,D,TOR,25,82,5,26,31
1,8480871,Adam Boqvist,D,CBJ,24,82,16,14,30
1,8473422,Nick Foligno,L,CHI,37,82,16,14,30
1,8476392,Adam Lowry,C,WPG,31,82,15,15,30
1,8478508,Yakov Trenin,C,COL,27,82,15,15,30
1,8477426,Nicholas Paul,L,TBL,29,82,14,16,30
1,8476925,Colton Sissons,C,NSH,31,82,14,16,30
1,8479365,Trent Frederic,C,BOS,26,82,14,16,30
1,8474149,Evgenii Dadonov,R,DAL,35,82,12,18,30
1,8478055,Gustav Forsling,D,FLA,28,82,10,20,30
1,8483491,Ivan Miroshnichenko,L,WSH,20,82,10,20,30
1,8481546,Cam York,D,PHI,23,82,7,23,30
1,8480145,Neal Pionk,D,WPG,29,82,6,24,30
1,8478851,Alexandre Carrier,D,NSH,28,82,5,25,30
1,8477969,Marcus Pettersson,D,PIT,28,82,4,26,30
1,8481703,Valtteri Puustinen,R,PIT,25,82,3,27,30
1,8484145,Zach Benson,L,BUF,19,82,17,12,29
1,8475848,Brendan Gallagher,R,MTL,32,82,17,12,29
1,8479591,Michael Eyssimont,C,TBL,28,82,16,13,29
1,8473449,Kyle Okposo,R,FLA,36,82,14,15,29
1,8479941,Justin Danforth,R,CBJ,31,82,12,17,29
1,8480068,Ryan Poehling,C,PHI,25,82,11,18,29
1,8475793,Ryan Johansen,C,PHI,32,82,9,20,29
1,8482087,Kaiden Guhle,D,MTL,22,82,6,23,29
1,8482118,Sam Colangelo,R,ANA,23,82,21,7,28
1,8475314,Anders Lee,L,NYI,34,82,18,10,28
1,8481093,Rafael Harvey-Pinard,L,MTL,25,82,17,11,28
1,8478115,Pierre Engvall,L,NYI,28,82,14,14,28
1,8481535,Nils Hoglander,L,VAN,24,82,13,15,28
1,8477947,Sonny Milano,L,WSH,28,82,11,17,28
1,8482079,Marco Rossi,C,MIN,23,82,10,18,28
1,8475343,Nic Dowd,C,WSH,34,82,10,18,28
1,8476480,Vladislav Namestnikov,C,WPG,32,82,10,18,28
1,8478430,Oliver Kylington,D,CGY,27,82,9,19,28
1,8477450,Jason Dickinson,C,CHI,29,82,9,19,28
1,8481618,Alex Newhook,C,MTL,23,82,9,19,28
1,8476331,Dylan DeMelo,D,WPG,31,82,7,21,28
1,8483490,Pavel Mintyukov,D,ANA,21,82,7,21,28
1,8476967,Brett Kulak,D,EDM,30,82,7,21,28
1,8479398,Samuel Girard,D,COL,26,82,5,23,28
1,8483431,Logan Cooley,C,ARI,20,82,19,8,27
1,8476921,Jordan Martinook,L,CAR,32,82,16,11,27
1,8470610,Zach Parise,L,COL,40,82,15,12,27
1,8479316,Luke Kunin,C,SJS,27,82,14,13,27
1,8480074,Alexandre Texier,C,CBJ,25,82,14,13,27
1,8479661,Tanner Jeannot,L,TBL,27,82,14,13,27
1,8482142,Jamie Drysdale,D,PHI,22,82,13,14,27
1,8481553,Bobby Brink,R,PHI,23,82,13,14,27
1,8470621,Corey Perry,R,EDM,39,82,12,15,27
1,8481554,Kaapo Kakko,R,NYR,23,82,11,16,27
1,8479514,Rem Pitlick,C,CHI,27,82,9,18,27
1,8474034,Pat Maroon,L,BOS,36,82,9,18,27
1,8476892,Colton Parayko,D,STL,31,82,8,19,27
1,8477507,Nikita Zadorov,D,VAN,29,82,8,19,27
1,8480078,Filip Chytil,C,NYR,25,82,7,20,27
1,8478911,Matt Roy,D,LAK,29,82,6,21,27
1,8475171,Oliver Ekman-Larsson,D,FLA,33,82,4,23,27
1,8482122,Brock Faber,D,MIN,22,82,2,25,27
1,8480281,Alexey Toropchenko,R,STL,25,82,18,8,26
1,8476469,Joel Armia,R,MTL,31,82,15,11,26
1,8481186,Logan O'Connor,R,COL,28,82,15,11,26
1,8477944,Jakub Vrana,L,STL,28,82,14,12,26
1,8476873,Mark Jankowski,C,NSH,30,82,14,12,26
1,8479293,Brandon Tanev,L,SEA,33,82,13,13,26
1,8478451,Ethan Bear,D,WSH,27,82,11,15,26
1,8477498,Darnell Nurse,D,EDM,29,82,10,16,26
1,8478569,Noel Acciari,C,PIT,33,82,9,17,26
1,8477839,Conor Sheary,L,TBL,32,82,9,17,26
1,8480813,Joe Veleno,C,DET,24,82,8,18,26
1,8476871,Tanner Pearson,L,MTL,32,82,8,18,26
1,8474673,TJ Brodie,D,TOR,34,82,6,20,26
1,8479976,Juuso Valimaki,D,ARI,26,82,6,20,26
1,8476885,Jacob Trouba,D,NYR,30,82,4,22,26
1,8481178,Egor Zamula,D,PHI,24,82,2,24,26
1,8475842,Sam Carrick,C,EDM,32,82,19,6,25
1,8478109,Victor Olofsson,L,BUF,29,82,15,10,25
1,8481580,Connor McMichael,C,WSH,23,82,14,11,25
1,8482125,Alexander Holtz,R,NJD,22,82,11,14,25
1,8475149,Marcus Johansson,L,MIN,34,82,10,15,25
1,8480144,David Kampf,C,TOR,29,82,9,16,25
1,8481481,Blake Lizotte,C,LAK,27,82,9,16,25
1,8475220,Marcus Foligno,L,MIN,33,82,8,17,25
1,8477425,Miles Wood,L,COL,29,82,8,17,25
1,8480855,Jack McBain,C,ARI,24,82,8,17,25
1,8481567,Henry Thrun,D,SJS,23,82,6,19,25
1,8483495,Simon Nemec,D,NJD,20,82,6,19,25
1,8482133,Thomas Bordeleau,C,SJS,22,82,6,19,25
1,8478859,Niko Mikkola,D,FLA,28,82,5,20,25
1,8476931,Jake McCabe,D,TOR,31,82,4,21,25
1,8480796,Martin Fehervary,D,WSH,25,82,4,21,25
1,8478013,Jake Walman,D,DET,28,82,4,21,25
1,8470966,Mark Giordano,D,TOR,41,82,4,21,25
1,8482702,Logan Stankoven,C,DAL,21,82,17,7,24
1,8483499,Liam Ohgren,L,MIN,20,82,14,10,24
1,8474884,Mike Hoffman,C,SJS,35,82,13,11,24
1,8479351,Sam Steel,C,DAL,26,82,13,11,24
1,8476461,Sean Couturier,C,PHI,32,82,12,12,24
1,8483505,Matthew Poitras,C,BOS,20,82,11,13,24
1,8474189,Lars Eller,C,PIT,35,82,10,14,24
1,8481704,Juuso Parssinen,C,NSH,23,82,9,15,24
1,8476463,Jonas Brodin,D,MIN,31,82,8,16,24
1,8476312,Josh Manson,D,COL,33,82,7,17,24
1,8477392,Hudson Fasching,R,NYI,29,82,7,17,24
1,8478133,Jake Evans,C,MTL,28,82,6,18,24
1,8475181,Nick Leddy,D,STL,33,82,5,19,24
1,8477435,Ryan Graves,D,PIT,29,82,5,19,24
1,8477220,Nate Schmidt,D,WPG,33,82,5,19,24
1,8476525,Colin Miller,D,WPG,32,82,5,19,24
1,8476923,Damon Severson,D,CBJ,30,82,3,21,24
1,8475179,Dmitry Kulikov,D,FLA,34,82,2,22,24
1,8476879,Cody Ceci,D,EDM,31,82,1,23,24
1,8473507,Jeff Petry,D,DET,37,82,1,23,24
1,8482145,Mavrik Bourque,C,DAL,22,82,17,6,23
1,8482155,Alex Laferriere,R,LAK,23,82,13,10,23
1,8481601,Simon Holmstrom,R,NYI,23,82,13,10,23
1,8476278,Colin Blackwell,C,CHI,31,82,12,11,23
1,8478043,Sam Lafferty,C,VAN,29,82,11,12,23
1,8481517,Brett Leason,R,ANA,25,82,9,14,23
1,8479369,Andrew Peeke,D,BOS,26,82,6,17,23
1,8477369,Carson Soucy,D,VAN,30,82,6,17,23
1,8480172,Jan Rutta,D,SJS,34,82,5,18,23
1,8482712,Oskar Olausson,R,COL,22,82,5,18,23
1,8474574,Tyler Myers,D,VAN,34,82,2,21,23
1,8479324,Ryan Lindgren,D,NYR,26,82,2,21,23
1,8482737,Zack Bolduc,C,STL,21,82,13,9,22
1,8476981,Josh Anderson,R,MTL,30,82,11,11,22
1,8473533,Jordan Staal,C,CAR,36,82,11,11,22
1,8482679,Matt Coronato,R,CGY,22,82,10,12,22
1,8482074,Connor Zary,C,CGY,23,82,9,13,22
1,8482117,Lukas Reichel,L,CHI,22,82,8,14,22
1,8476897,Oskar Sundqvist,C,STL,30,82,7,15,22
1,8476891,Matt Grzelcyk,D,BOS,30,82,6,16,22
1,8479371,Dante Fabbro,D,NSH,26,82,6,16,22
1,8476457,Adam Larsson,D,SEA,32,82,5,17,22
1,8480073,Erik Brannstrom,D,OTT,25,82,4,18,22
1,8475188,Brayden McNabb,D,VGK,33,82,3,19,22
1,8477499,Rasmus Ristolainen,D,PHI,30,82,3,19,22
1,8475762,Derek Forbort,D,BOS,32,82,2,20,22
1,8480246,Nick Perbix,D,TBL,26,82,2,20,22
1,8484203,Bradly Nadeau,L,CAR,19,82,16,5,21
1,8475164,Jakob Silfverberg,R,ANA,34,82,11,10,21
1,8474009,Nick Bonino,C,NYR,36,82,11,10,21
1,8479383,Boris Katchouk,L,OTT,26,82,10,11,21
1,8473453,Trevor Lewis,C,LAK,37,82,9,12,21
1,8482803,Olen Zellweger,D,ANA,21,82,7,14,21
1,8477015,Connor Brown,R,EDM,30,82,7,14,21
1,8478840,Will Borgen,D,SEA,28,82,6,15,21
1,8476902,Esa Lindell,D,DAL,30,82,5,16,21
1,8481524,Bowen Byram,D,BUF,23,82,5,16,21
1,8478399,Jonas Siegenthaler,D,NJD,27,82,5,16,21
1,8470600,Ryan Suter,D,DAL,39,82,4,17,21
1,8480336,Sean Walker,D,COL,30,82,4,17,21
1,8479442,Troy Stecher,D,EDM,30,82,4,17,21
1,8480860,Kevin Bahl,D,NJD,24,82,4,17,21
1,8480058,Pierre-Olivier Joseph,D,PIT,25,82,4,17,21
1,8478507,John Marino,D,NJD,27,82,3,18,21
1,8479390,Taylor Raddysh,R,CHI,26,82,11,9,20
1,8477919,Frederick Gaudreau,C,MIN,31,82,11,9,20
1,8476374,Sean Kuraly,C,CBJ,31,82,10,10,20
1,8476442,Matt Nieto,L,PIT,32,82,10,10,20
1,8480980,Connor Dewar,C,TOR,25,82,9,11,20
1,8479998,Mikey Anderson,D,LAK,25,82,8,12,20
1,8475455,Brenden Dillon,D,WPG,34,82,5,15,20
1,8478416,Erik Cernak,D,TBL,27,82,4,16,20
1,8475324,Nick Jensen,D,WSH,34,82,3,17,20
1,8475233,David Savard,D,MTL,34,82,2,18,20
1,8482809,Jackson Blake,R,CAR,21,82,12,7,19
1,8481537,Nikita Okhotiuk,D,CGY,24,82,9,10,19
1,8481522,Peyton Krebs,C,BUF,23,82,9,10,19
1,8482062,Cole Smith,L,NSH,29,82,8,11,19
1,8482245,Artem Zub,D,OTT,29,82,5,14,19
1,8477845,Trevor van Riemsdyk,D,WSH,33,82,4,15,19
1,8480834,Ty Emberson,D,SJS,24,82,4,15,19
1,8477034,Jaycob Megna,D,CHI,32,82,4,15,19
1,8483565,Nick Blankenburg,D,CBJ,26,82,4,15,19
1,8475462,Radko Gudas,D,ANA,34,82,3,16,19
1,8478443,Brandon Carlo,D,BOS,28,82,2,17,19
1,8475790,Erik Gudbranson,D,CBJ,32,82,2,17,19
1,8476467,Jamie Oleksiak,D,SEA,32,82,2,17,19
1,8477365,Connor Clifton,D,BUF,29,82,2,17,19
1,8477330,Dominik Kubalik,L,OTT,29,82,12,6,18
1,8482666,Scott Morrow,D,CAR,22,82,11,7,18
1,8479393,Noah Gregor,C,TOR,26,82,9,9,18
1,8480448,Parker Kelly,L,OTT,25,82,9,9,18
1,8483482,Tristan Luneau,D,ANA,20,82,6,12,18
1,8479980,Nicolas Hague,D,VGK,26,82,5,13,18
1,8477505,Alexander Wennberg,C,NYR,30,82,5,13,18
1,8481014,Alexander Romanov,D,NYI,24,82,4,14,18
1,8482166,Shakir Mukhamadullin,D,SJS,22,82,3,15,18
1,8475690,Chris Tanev,D,DAL,35,82,3,15,18
1,8478408,Travis Dermott,D,ARI,28,82,3,15,18
1,8476858,Phillip Di Giuseppe,L,VAN,31,82,10,7,17
1,8476624,Barclay Goodrow,C,NYR,31,82,8,9,17
1,8477931,Tomas Nosek,L,NJD,32,82,8,9,17
1,8473504,Cal Clutterbuck,R,NYI,37,82,8,9,17
1,8477353,Tyler Motte,C,TBL,29,82,7,10,17
1,8482730,Brandt Clarke,D,LAK,21,82,5,12,17
1,8478468,Jeremy Lauzon,D,NSH,27,82,4,13,17
1,8476429,Scott Mayfield,D,NYI,32,82,3,14,17
1,8482655,J.J. Moser,D,ARI,24,82,2,15,17
1,8475279,Ben Chiarot,D,DET,33,82,2,15,17
1,8474166,Alec Martinez,D,VGK,37,82,2,15,17
1,8476473,Connor Murphy,D,CHI,31,82,1,16,17
1,8482762,Simon Edvinsson,D,DET,21,82,8,8,16
1,8477406,Mattias Janmark,C,EDM,32,82,7,9,16
1,8479291,Kevin Rooney,C,CGY,31,82,7,9,16
1,8484911,Collin Graf,R,SJS,22,82,5,11,16
1,8475231,Casey Cizikas,C,NYI,33,82,5,11,16
1,8478136,Jake Middleton,D,MIN,28,82,4,12,16
1,8477335,Kyle Burroughs,D,SJS,29,82,4,12,16
1,8476372,Nick Seeler,D,PHI,31,82,4,12,16
1,8483466,Kevin Korchinski,D,CHI,20,82,3,13,16
1,8481605,Jackson LaCombe,D,ANA,23,82,3,13,16
1,8476422,Mike Reilly,D,NYI,31,82,3,13,16
1,8480035,Henri Jokiharju,D,BUF,25,82,2,14,16
1,8483012,Logan Morrison,C,SEA,22,82,8,7,15
1,8482807,Ethan Del Mastro,D,CHI,21,82,3,12,15
1,8480879,Jacob Bernard-Docker,D,OTT,24,82,3,12,15
1,8477508,Curtis Lazar,C,NJD,29,82,2,13,15
1,8476822,Luke Glendening,C,TBL,35,82,9,5,14
1,8476878,Zemgus Girgensons,L,BUF,30,82,6,8,14
1,8478831,Kevin Stenlund,C,FLA,28,82,4,10,14
1,8482858,Ryker Evans,D,SEA,23,82,2,12,14
1,8482470,Ilya Solovyov,D,CGY,24,82,2,12,14
1,8481477,Nico Sturm,C,SJS,29,82,8,5,13
1,8475825,Jani Hakanpää,D,DAL,32,82,5,8,13
1,8474567,Zach Bogosian,D,MIN,34,82,5,8,13
1,8475177,Calvin de Haan,D,TBL,33,82,5,8,13
1,8480807,Mattias Samuelsson,D,BUF,24,82,2,11,13
1,8482516,Matthew Kessel,D,STL,24,82,1,12,13
1,8481568,Alex Vlasic,D,CHI,23,82,0,13,13
1,8474013,Ian Cole,D,VAN,35,82,5,7,12
1,8481028,Martin Pospisil,C,CGY,25,82,4,8,12
1,8481059,Scott Perunovich,D,STL,26,82,2,10,12
1,8479359,Beck Malenstyn,L,WSH,26,82,5,6,11
1,8482859,Zack Ostapchuk,C,OTT,21,82,0,11,11
1,8482177,Marat Khusnutdinov,C,MIN,22,82,3,7,10
1,8481578,Graeme Clarke,R,NJD,23,82,5,4,9
1,8471677,Jack Johnson,D,COL,37,82,3,6,9
1,8482073,Braden Schneider,D,NYR,23,82,1,8,9
1,8475208,Brian Dumoulin,D,SEA,33,82,0,9,9
1,8481030,Jack St. Ivany,D,PIT,25,82,0,9,9
1,8476915,Jujhar Khaira,L,MIN,30,82,3,5,8
1,8484149,Gavin Brindley,C,CBJ,20,82,2,6,8
1,8480990,Declan Chisholm,D,MIN,24,82,6,1,7
1,8482713,Mackie Samoskevich,R,FLA,22,82,3,3,6
1,8481599,Victor Soderstrom,D,ARI,23,82,0,5,5
1,8483468,Jiri Kulich,C,BUF,20,82,1,3,4
1,8483489,Fraser Minten,C,TOR,31,82,2,1,3
1,8483763,Maksymilian Szuber,D,ARI,22,82,0,2,2
1,8482141,Lukas Cormier,D,VGK,22,0,0,0,0
1,8476988,Matt Benning,D,SJS,30,0,0,0,0
1,8480727,Zach Whitecloud,D,VGK,28,0,0,0,0
1,8480887,Jordan Harris,D,MTL,24,0,0,0,0
1,8478450,Parker Wotherspoon,D,BOS,27,0,0,0,0
1,8481812,Nikolai Knyzhov,D,SJS,27,0,0,0,0
1,8480001,Urho Vaakanainen,D,ANA,25,0,0,0,0
1,8482176,Wyatt Kaiser,D,CHI,22,0,0,0,0
1,8481122,Simon Benoit,D,TOR,26,0,0,0,0
1,8476441,Joel Edmundson,D,TOR,31,0,0,0,0
1,8480884,Calen Addison,D,SJS,24,0,0,0,0
1,8482511,Mason Lohrei,D,BOS,23,0,0,0,0
1,8482192,Isaak Phillips,D,CHI,23,0,0,0,0
1,8480950,Ilya Lyubushkin,D,TOR,30,0,0,0,0
1,8474031,Kevin Shattenkirk,D,BOS,35,0,0,0,0
1,8475718,Justin Holl,D,DET,32,0,0,0,0
1,8479402,Jake Bean,D,CBJ,26,0,0,0,0
1,8474602,Justin Schultz,D,SEA,34,0,0,0,0
1,8477950,Tony DeAngelo,D,CAR,29,0,0,0,0
1,8481743,Marc Del Gaizo,D,NSH,25,0,0,0,0
1,8481527,Kaedan Korczak,D,VGK,23,0,0,0,0
1,8480192,Johnathan Kovacevic,D,MTL,27,0,0,0,0
1,8476874,Olli Maatta,D,DET,30,0,0,0,0
1,8482144,Jack Thompson,D,SJS,22,0,0,0,0
1,8480222,Sebastian Aho,D,NYI,28,0,0,0,0
1,8479458,Nikita Zaitsev,D,CHI,33,0,0,0,0
1,8471709,Marc-Edouard Vlasic,D,SJS,37,0,0,0,0
1,8482929,Emil Lilleberg,D,TBL,23,0,0,0,0
1,8477018,Ben Hutton,D,VGK,31,0,0,0,0
1,8481056,Spencer Stastney,D,NSH,24,0,0,0,0
1,8481593,Jayden Struble,D,MTL,23,0,0,0,0
1,8479982,Conor Timmins,D,TOR,26,0,0,0,0
1,8474090,Brendan Smith,D,NJD,35,0,0,0,0
1,8482964,Arber Xhekaj,D,MTL,23,0,0,0,0
1,8480891,Michael Kesselring,D,ARI,24,0,0,0,0
1,8477938,Haydn Fleury,D,TBL,28,0,0,0,0
1,8481806,Louis Crevier,D,CHI,23,0,0,0,0
1,8471274,Alex Goligoski,D,MIN,39,0,0,0,0
1,8481600,Tobias Bjornfot,D,FLA,23,0,0,0,0
1,8475797,Jarred Tinordi,D,CHI,32,0,0,0,0
1,8481521,Ronnie Attard,D,PHI,25,0,0,0,0
1,8474612,Travis Hamonic,D,OTT,34,0,0,0,0
1,8479576,Vincent Desharnais,D,EDM,28,0,0,0,0
1,8480049,Dylan Samberg,D,WPG,25,0,0,0,0
1,8483619,Filip Roos,D,CHI,25,0,0,0,0
1,8474568,Luke Schenn,D,NSH,35,0,0,0,0
1,8480184,Gustav Lindstrom,D,ANA,26,0,0,0,0
1,8480070,Ian Mitchell,D,BOS,25,0,0,0,0
1,8480196,Jacob Bryson,D,BUF,27,0,0,0,0
1,8471686,Marc Staal,D,PHI,37,0,0,0,0
1,8477467,Gustav Olofsson,D,SEA,30,0,0,0,0
1,8478970,Jalen Chatfield,D,CAR,28,0,0,0,0
1,8479348,Kale Clague,D,BUF,26,0,0,0,0
1,8473446,Erik Johnson,D,PHI,36,0,0,0,0
1,8477462,Robert Hagg,D,ANA,29,0,0,0,0
1,8478454,Noah Juulsen,D,VAN,27,0,0,0,0
1,8477384,Josh Brown,D,ARI,30,0,0,0,0
1,8481708,Zac Jones,D,NYR,24,0,0,0,0
1,8481167,Brayden Pachal,D,CGY,25,0,0,0,0
1,8482067,Connor Mackey,D,NYR,28,0,0,0,0
1,8483460,David Jiricek,D,CBJ,21,0,0,0,0
1,8481701,Santeri Hatakka,D,NJD,23,0,0,0,0
1,8478021,William Lagesson,D,ANA,28,0,0,0,0
1,8477851,Jordan Oesterle,D,CGY,32,0,0,0,0
1,8478452,Caleb Jones,D,COL,27,0,0,0,0
1,8479984,Cal Foote,D,NJD,26,0,0,0,0
1,8479639,Dylan Coghlan,D,CAR,26,0,0,0,0
1,8480874,Adam Ginning,D,PHI,24,0,0,0,0
1,8479321,Lucas Johansen,D,WSH,27,0,0,0,0
1,8480878,Nils Lundkvist,D,DAL,24,0,0,0,0
1,8482165,Yan Kuznetsov,D,CGY,22,0,0,0,0
1,8484258,Sam Malinski,D,COL,26,0,0,0,0
1,8480157,Calle Rosen,D,STL,30,0,0,0,0
1,8484304,Uvis Balinskis,D,FLA,28,0,0,0,0
1,8479985,Cale Fleury,D,SEA,26,0,0,0,0
1,8479378,Logan Stanley,D,WPG,26,0,0,0,0
1,8477541,Dakota Mermis,D,MIN,30,0,0,0,0
1,8481609,Vladislav Kolyachonok,D,ARI,23,0,0,0,0
1,8480823,Alexander Alexeyev,D,WSH,25,0,0,0,0
1,8481679,Maxence Guenette,D,OTT,23,0,0,0,0
1,8481564,Ryan Johnson,D,BUF,23,0,0,0,0
1,8479376,Victor Mete,D,PHI,26,0,0,0,0
1,8484254,Akito Hirose,D,VAN,25,0,0,0,0
1,8482660,Kent Johnson,C,CBJ,22,0,0,0,0
1,8482149,Cole Perfetti,C,WPG,22,0,0,0,0
1,8477987,Ryan Donato,C,CHI,28,0,0,0,0
1,8475755,Alexander Petrovic,D,DAL,32,0,0,0,0
1,8477810,Joel Hanley,D,CGY,33,0,0,0,0
1,8474145,Robert Bortuzzo,D,NYI,35,0,0,0,0
1,8481161,Jake Christiansen,D,CBJ,25,0,0,0,0
1,8476884,Derrick Pouliot,D,DAL,30,0,0,0,0
1,8481716,Dmitri Voronkov,L,CBJ,24,0,0,0,0
1,8480084,Nick DeSimone,D,NJD,30,0,0,0,0
1,8475750,Jon Merrill,D,MIN,32,0,0,0,0
1,8479315,Joey Anderson,R,CHI,26,0,0,0,0
1,8478011,Louie Belpedio,D,PHI,28,0,0,0,0
1,8482451,Mikael Pyyhtia,L,CBJ,23,0,0,0,0
1,8481541,Samuel Bolduc,D,NYI,24,0,0,0,0
1,8482126,Emil Andrae,D,PHI,31,0,0,0,0
1,8474618,Marco Scandella,D,STL,34,0,0,0,0
1,8477244,Chad Ruhwedel,D,NYR,34,0,0,0,0
1,8477971,Andreas Englund,D,LAK,28,0,0,0,0
1,8480829,Jesperi Kotkaniemi,C,CAR,24,0,0,0,0
1,8479372,Josh Mahura,D,FLA,26,0,0,0,0
1,8482095,Tyler Kleven,D,OTT,22,0,0,0,0
1,8481719,Maxwell Crozier,D,TBL,24,0,0,0,0
1,8475855,Jesper Fast,R,CAR,33,0,0,0,0
1,8480848,Ty Dellandrea,C,DAL,24,0,0,0,0
1,8475193,Tomas Tatar,L,SEA,34,0,0,0,0
1,8476889,Radek Faksa,C,DAL,30,0,0,0,0
1,8478495,Denis Gurianov,R,PHI,27,0,0,0,0
1,8480216,Jacob Peterson,C,SJS,25,0,0,0,0
1,8480252,Cole Guttman,C,CHI,25,0,0,0,0
1,8479026,Philippe Myers,D,TBL,27,0,0,0,0
1,8481006,Tyler Tucker,D,STL,24,0,0,0,0
1,8481032,Paul Cotter,C,VGK,25,0,0,0,0
1,8481577,Philip Tomasino,C,NSH,23,0,0,0,0
1,8476918,Jimmy Vesey,L,NYR,31,0,0,0,0
1,8479320,Max Lajoie,D,TOR,27,0,0,0,0
1,8478017,Mark Friedman,D,VAN,29,0,0,0,0
1,8481754,Nikita Nesterenko,C,ANA,23,0,0,0,0
1,8483407,Brandon Scanlin,D,NYR,25,0,0,0,0
1,8482659,Josh Doan,R,ARI,22,0,0,0,0
1,8477446,Michael McCarron,R,NSH,29,0,0,0,0
1,8477903,Garnet Hathaway,R,PHI,33,0,0,0,0
1,8482153,Brendan Brisson,C,VGK,23,0,0,0,0
1,8483546,Marshall Rifai,D,TOR,26,0,0,0,0
1,8484287,Cole McWard,D,VAN,23,0,0,0,0
1,8478854,Ryan Shea,D,PIT,27,0,0,0,0
1,8481585,Egor Afanasyev,L,NSH,23,0,0,0,0
1,8483398,Declan Carlile,D,TBL,31,0,0,0,0
1,8478502,Dennis Gilbert,D,CGY,28,0,0,0,0
1,8482749,Joshua Roy,R,MTL,21,0,0,0,0
1,8481598,Philip Broberg,D,EDM,23,0,0,0,0
1,8480835,Jack Drury,C,CAR,24,0,0,0,0
1,8480748,Kiefer Sherwood,L,NSH,29,0,0,0,0
1,8476934,Brock McGinn,L,ANA,30,0,0,0,0
1,8480870,Bo Groulx,C,ANA,24,0,0,0,0
1,8479368,Max Jones,L,ANA,26,0,0,0,0
1,8478099,Kevin Labanc,R,SJS,29,0,0,0,0
1,8478067,Oskar Lindblom,L,SJS,28,0,0,0,0
1,8476393,Nick Cousins,C,FLA,31,0,0,0,0
1,8483395,Arshdeep Bains,L,VAN,23,0,0,0,0
1,8480762,Eric Robinson,L,BUF,29,0,0,0,0
1,8479439,Jacob MacDonald,D,SJS,31,0,0,0,0
1,8476474,Stefan Noesen,R,CAR,31,0,0,0,0
1,8482787,Nikita Chibrikov,R,WPG,31,0,0,0,0
1,8478432,Christian Fischer,R,DET,27,0,0,0,0
1,8477979,Nicolas Aube-Kubel,R,WSH,28,0,0,0,0
1,8481789,Tye Kartye,L,SEA,23,0,0,0,0
1,8479330,Brandon Gignac,C,MTL,27,0,0,0,0
1,8480075,Cameron Crotty,D,ARI,25,0,0,0,0
1,8473473,Milan Lucic,L,BOS,36,0,0,0,0
1,8482094,Daemon Hunt,D,MIN,22,0,0,0,0
1,8481206,John Ludvig,D,PIT,24,0,0,0,0
1,8483630,Pavol Regenda,L,ANA,25,0,0,0,0
1,8481617,Vasily Podkolzin,R,VAN,23,0,0,0,0
1,8480306,Grant Hutton,D,NYI,29,0,0,0,0
1,8480995,Pontus Holmberg,R,TOR,25,0,0,0,0
1,8482148,Hendrix Lapierre,C,WSH,22,0,0,0,0
1,8477478,William Carrier,L,VGK,30,0,0,0,0
1,8480003,Jesper Boqvist,C,BOS,26,0,0,0,0
1,8482172,Landon Slaggert,L,CHI,22,0,0,0,0
1,8480789,Oliver Wahlstrom,R,NYI,24,0,0,0,0
1,8474062,Riley Nash,C,NYR,35,0,0,0,0
1,8480021,Jack Studnicka,C,SJS,25,0,0,0,0
1,8480025,MacKenzie Entwistle,R,CHI,25,0,0,0,0
1,8481582,Nicholas Robertson,L,TOR,23,0,0,0,0
1,8476867,Brendan Gaunce,C,CBJ,30,0,0,0,0
1,8479619,Michael Carcone,L,ARI,28,0,0,0,0
1,8479370,Tyson Jost,C,BUF,26,0,0,0,0
1,8479671,Mathieu Olivier,R,CBJ,27,0,0,0,0
1,8476994,Vinnie Hinostroza,C,PIT,30,0,0,0,0
1,8482070,Mitchell Chaffee,R,TBL,26,0,0,0,0
1,8477473,Justin Bailey,R,SJS,29,0,0,0,0
1,8479344,Jesse Puljujarvi,R,PIT,26,0,0,0,0
1,8480205,Emil Bemstrom,C,PIT,25,0,0,0,0
1,8479718,Alex Barré-Boulet,C,TBL,27,0,0,0,0
1,8482061,Brandon Biro,L,BUF,26,0,0,0,0
1,8479638,Justin Brazeau,R,BOS,26,0,0,0,0
1,8474040,Sam Gagner,C,EDM,35,0,0,0,0
1,8477846,Ryan Carpenter,C,SJS,33,0,0,0,0
1,8482077,Dylan Holloway,L,EDM,23,0,0,0,0
1,8482157,Will Cuylle,L,NYR,22,0,0,0,0
1,8480007,Jonas Rondbjerg,R,VGK,25,0,0,0,0
1,8478874,Adam Gaudette,C,STL,28,0,0,0,0
1,8478434,Keegan Kolesar,R,VGK,27,0,0,0,0
1,8480441,Trey Fix-Wolansky,R,CBJ,25,0,0,0,0
1,8479994,Jaret Anderson-Dolan,C,NSH,25,0,0,0,0
1,8483567,Georgii Merkulov,C,BOS,24,0,0,0,0
1,8477380,Jonny Brodzinski,C,NYR,31,0,0,0,0
1,8482201,Gage Goncalves,C,TBL,23,0,0,0,0
1,8478211,Dryden Hunt,L,CGY,29,0,0,0,0
1,8471699,Andrew Cogliano,C,COL,37,0,0,0,0
1,8479421,Jacob Moverare,D,LAK,26,0,0,0,0
1,8478881,Brett Seney,L,CHI,28,0,0,0,0
1,8477464,Nic Petan,C,MIN,29,0,0,0,0
1,8475958,Michael Sgarbossa,C,WSH,32,0,0,0,0
1,8481147,Reese Johnson,C,CHI,26,0,0,0,0
1,8479336,Carl Grundstrom,R,LAK,27,0,0,0,0
1,8480853,Liam Foudy,C,NSH,24,0,0,0,0
1,8479522,Hardy Haman Aktell,D,WSH,26,0,0,0,0
1,8481462,Mason Morelli,L,VGK,28,0,0,0,0
1,8482102,Vasily Ponomarev,C,CAR,22,0,0,0,0
1,8480844,Grigori Denisenko,L,VGK,24,0,0,0,0
1,8479944,Zach Aston-Reese,C,DET,30,0,0,0,0
1,8482784,Zach Dean,C,STL,21,0,0,0,0
1,8479419,Brett Murray,L,BUF,26,0,0,0,0
1,8479520,Brandon Duhaime,R,COL,27,0,0,0,0
1,8477573,Nathan Walker,L,STL,30,0,0,0,0
1,8478078,Rourke Chartier,C,OTT,28,0,0,0,0
1,8475795,Dylan McIlrath,D,WSH,32,0,0,0,0
1,8482496,Nils Aman,C,VAN,24,0,0,0,0
1,8480289,Morgan Barron,C,WPG,26,0,0,0,0
1,8481751,Lukas Rousek,R,BUF,25,0,0,0,0
1,8480011,Klim Kostin,C,SJS,25,0,0,0,0
1,8481556,John Beecher,C,BOS,23,0,0,0,0
1,8475278,Byron Froese,C,VGK,33,0,0,0,0
1,8475225,Craig Smith,C,DAL,35,0,0,0,0
1,8484326,Patrik Koch,D,ARI,28,0,0,0,0
1,8477930,Pierre-Edouard Bellemare,L,SEA,39,0,0,0,0
1,8478409,Anthony Richard,C,BOS,28,0,0,0,0
1,8481024,Linus Karlsson,C,VAN,25,0,0,0,0
1,8479986,Kole Lind,R,SEA,26,0,0,0,0
1,8479414,Nathan Bastian,R,NJD,27,0,0,0,0
1,8479362,Riley Tufte,L,COL,26,0,0,0,0
1,8481058,Jesse Ylönen,R,MTL,25,0,0,0,0
1,8482476,Emil Heineman,L,MTL,23,0,0,0,0
1,8482861,Vincent Iorio,D,WSH,22,0,0,0,0
1,8483432,Luca Del Bel Belluz,C,CBJ,31,0,0,0,0
1,8482744,James Malatesta,L,CBJ,21,0,0,0,0
1,8477887,Patrick Brown,C,BOS,32,0,0,0,0
1,8478585,Derek Ryan,C,EDM,38,0,0,0,0
1,8481441,Joe Snively,C,WSH,28,0,0,0,0
1,8481592,Jakob Pelletier,L,CGY,23,0,0,0,0
1,8482634,Alex Steeves,C,TOR,25,0,0,0,0
1,8477126,Jayson Megna,C,BOS,34,0,0,0,0
1,8475752,Tyler Pitlick,C,NYR,33,0,0,0,0
1,8480008,Adam Ruzicka,C,ARI,25,0,0,0,0
1,8481065,Angus Crookshank,L,OTT,25,0,0,0,0
1,8479547,Matthew Phillips,R,WSH,26,0,0,0,0
1,8480226,Marián Studenic,R,SEA,26,0,0,0,0
1,8481237,Kyle MacLean,C,NYI,25,0,0,0,0
1,8475413,Justin Dowling,C,NJD,34,0,0,0,0
1,8481641,Joel Kiviranta,L,COL,28,0,0,0,0
1,8478104,Sammy Blais,L,STL,28,0,0,0,0
1,8477454,Adam Erne,L,EDM,29,0,0,0,0
1,8481518,Nolan Foote,L,NJD,24,0,0,0,0
1,8480245,Olle Lycksell,R,PHI,25,0,0,0,0
1,8483570,Ben Meyers,C,ANA,26,0,0,0,0
1,8480776,Sheldon Rempal,R,VGK,29,0,0,0,0
1,8483920,Pierrick Dube,R,WSH,23,0,0,0,0
1,8480267,Sammy Walker,C,MIN,25,0,0,0,0
1,8482747,Brennan Othmann,L,NYR,21,0,0,0,0
1,8479991,Jake Leschyshyn,C,NYR,25,0,0,0,0
1,8478400,Colin White,C,MTL,27,0,0,0,0
1,8479328,Julien Gauthier,R,NYI,27,0,0,0,0
1,8484325,Waltteri Merela,C,TBL,26,0,0,0,0
1,8479066,Ryan Lomberg,L,FLA,30,0,0,0,0
1,8477070,Liam O'Brien,C,ARI,30,0,0,0,0
1,8478146,Matthew Highmore,C,OTT,28,0,0,0,0
1,8478028,Fredrik Olofsson,L,COL,28,0,0,0,0
1,8480880,Jakub Lauko,C,BOS,24,0,0,0,0
1,8479968,Vinni Lettieri,C,MIN,29,0,0,0,0
1,8474709,Matt Martin,L,NYI,35,0,0,0,0
1,8480845,Rasmus Kupari,C,WPG,24,0,0,0,0
1,8481550,Adam Beckman,L,MIN,23,0,0,0,0
1,8481422,Jacob Lucchini,C,MIN,29,0,0,0,0
1,8477401,John Hayden,C,SEA,29,0,0,0,0
1,8478904,Steven Lorentz,C,FLA,28,0,0,0,0
1,8482088,Justin Sourdif,R,FLA,22,0,0,0,0
1,8482751,Ryan Winterton,C,SEA,21,0,0,0,0
1,8482241,Radim Zohorna,L,PIT,28,0,0,0,0
1,8481690,Tyler Angle,C,CBJ,24,0,0,0,0
1,8476952,Dominic Toninato,C,WPG,30,0,0,0,0
1,8476919,Chris Tierney,C,NJD,30,0,0,0,0
1,8480032,Shane Bowers,C,NJD,25,0,0,0,0
1,8484314,Jiri Smejkal,L,OTT,28,0,0,0,0
1,8481239,Samuel Fagemo,L,LAK,24,0,0,0,0
1,8481532,Alex Turcotte,C,LAK,23,0,0,0,0
1,8481019,David Gustafsson,C,WPG,24,0,0,0,0
1,8478477,Mitchell Stephens,C,MTL,27,0,0,0,0
1,8479546,Oskar Steen,C,BOS,26,0,0,0,0
1,8480292,Carson Meyer,R,CBJ,27,0,0,0,0
1,8478446,Glenn Gawdin,C,ANA,27,0,0,0,0
1,8483531,Brian Halonen,L,NJD,25,0,0,0,0
1,8477149,Scott Sabourin,R,SJS,32,0,0,0,0
1,8479972,Mason Shaw,C,MIN,26,0,0,0,0
1,8480890,Jan Jenik,R,ARI,24,0,0,0,0
1,8478051,Max Willman,C,NJD,29,0,0,0,0
1,8480851,Akil Thomas,C,LAK,24,0,0,0,0
1,8482765,Isak Rosen,R,BUF,21,0,0,0,0
1,8478421,A.J. Greer,L,CGY,28,0,0,0,0
1,8478512,Austin Czarnik,C,DET,32,0,0,0,0
1,8479536,Axel Jonsson-Fjallby,L,WPG,26,0,0,0,0
1,8477320,Anton Blidh,L,NYR,29,0,0,0,0
1,8481543,Nikita Alexandrov,C,STL,24,0,0,0,0
1,8475235,Nicolas Deslauriers,L,PHI,33,0,0,0,0
1,8481070,Hugh McGing,L,STL,26,0,0,0,0
1,8480836,Jonathan Gruden,C,PIT,24,0,0,0,0
1,8481591,Sam Poulin,R,PIT,23,0,0,0,0
1,8477962,Brendan Lemieux,L,CAR,28,0,0,0,0
1,8483401,Marc Johnstone,R,PIT,28,0,0,0,0
1,8482250,Callahan Burke,C,CAR,27,0,0,0,0
1,8481726,Adam Edstrom,C,NYR,24,0,0,0,0
1,8471817,Ryan Reaves,R,TOR,37,0,0,0,0
1,8479587,Rhett Gardner,C,PHI,28,0,0,0,0
1,8475766,Austin Watson,L,TBL,32,0,0,0,0
1,8479367,William Lockwood,R,FLA,26,0,0,0,0
1,8478424,Jansen Harkins,C,PIT,27,0,0,0,0
1,8476913,Devin Shore,C,SEA,30,0,0,0,0
1,8482652,Walker Duehr,R,CGY,27,0,0,0,0
1,8477527,Ross Johnston,L,ANA,30,0,0,0,0
1,8481077,John Leonard,L,ARI,26,0,0,0,0
1,8483549,Lucas Condotta,L,MTL,27,0,0,0,0
1,8480468,James Hamblin,L,EDM,25,0,0,0,0
1,8476907,Mackenzie MacEachern,L,STL,30,0,0,0,0
1,8479543,Michael Pezzetta,L,MTL,26,0,0,0,0
1,8480355,Mark Kastelic,C,OTT,25,0,0,0,0
1,8482162,Roby Jarventie,L,OTT,22,0,0,0,0
1,8479772,Zack MacEwen,R,OTT,28,0,0,0,0
1,8483597,Milos Kelemen,L,ARI,25,0,0,0,0
1,8479379,Givani Smith,R,SJS,26,0,0,0,0
1,8481655,Cole Schwindt,R,CGY,23,0,0,0,0
1,8479981,Jonah Gadjovich,L,FLA,26,0,0,0,0
1,8482147,Jean-Luc Foudy,C,COL,22,0,0,0,0
1,8484255,Jason Polin,R,COL,25,0,0,0,0
1,8477993,Justin Kirkland,C,ARI,28,0,0,0,0
1,8479249,Andrew Poturalski,C,SEA,30,0,0,0,0
1,8482197,Adam Raska,R,MIN,23,0,0,0,0
1,8475780,Chris Wagner,R,COL,33,0,0,0,0
1,8479533,Joona Koppanen,L,PIT,26,0,0,0,0
1,8481534,Raphael Lavoie,C,EDM,24,0,0,0,0
1,8484321,Nikolas Matinpalo,D,OTT,26,0,0,0,0
1,8481043,Cole Koepke,L,TBL,26,0,0,0,0
1,8476323,Max McCormick,L,SEA,32,0,0,0,0
1,8483609,Adam Klapka,R,CGY,24,0,0,0,0
1,8483512,Matt Savoie,C,BUF,20,0,0,0,0
1,8484259,Ondrej Pavel,C,COL,31,0,0,0,0
1,8478147,Bokondji Imama,L,OTT,28,0,0,0,0
1,8482460,Matt Rempe,C,NYR,22,0,0,0,0
1,8477073,Kurtis MacDermid,L,NJD,30,0,0,0,0
1,8480274,Philip Kemp,D,EDM,25,0,0,0,0
1,8478956,Samuel Laberge,L,NJD,27,0,0,0,0
1,8483045,Cameron Butler,R,CBJ,31,0,0,0,0
2,8478402,Connor McDavid,C,EDM,27,82,51,88,139
2,8476453,Nikita Kucherov,R,TBL,31,82,43,89,132
2,8479318,Auston Matthews,C,TOR,27,82,64,54,118
2,8477956,David Pastrnak,R,BOS,28,82,43,74,117
2,8477492,Nathan MacKinnon,C,COL,29,82,49,65,114
2,8478550,Artemi Panarin,L,NYR,33,82,43,60,103
2,8477934,Leon Draisaitl,C,EDM,29,82,38,60,98
2,8480027,Jason Robertson,L,DAL,25,82,31,67,98
2,8478010,Brayden Point,C,TBL,28,82,50,46,96
2,8480002,Nico Hischier,C,NJD,25,82,40,56,96
2,8471675,Sidney Crosby,C,PIT,37,82,37,52,89
2,8477939,William Nylander,R,TOR,28,82,36,53,89
2,8476887,Filip Forsberg,L,NSH,30,82,43,45,88
2,8481559,Jack Hughes,C,NJD,23,82,34,54,88
2,8479314,Matthew Tkachuk,L,FLA,27,82,31,57,88
2,8474600,Roman Josi,D,NSH,34,82,23,65,88
2,8480801,Brady Tkachuk,L,OTT,25,82,42,44,86
2,8477946,Dylan Larkin,C,DET,28,82,32,51,83
2,8478864,Kirill Kaprizov,L,MIN,27,82,42,40,82
2,8475172,Nazem Kadri,C,CGY,34,82,33,49,82
2,8476468,J.T. Miller,C,VAN,31,82,27,55,82
2,8475692,Mats Zuccarello,R,MIN,37,82,24,58,82
2,8480069,Cale Makar,D,COL,26,82,20,62,82
2,8477404,Jake Guentzel,C,CAR,30,82,37,44,81
2,8470794,Joe Pavelski,C,DAL,40,82,29,52,81
2,8479343,Clayton Keller,R,ARI,26,82,37,43,80
2,8477409,Carter Verhaeghe,C,FLA,29,82,37,43,80
2,8482116,Tim Stützle,C,OTT,22,82,34,46,80
2,8478420,Mikko Rantanen,R,COL,28,82,24,55,79
2,8471214,Alex Ovechkin,L,WSH,39,82,41,37,78
2,8480012,Elias Pettersson,C,VAN,26,82,32,45,77
2,8480800,Quinn Hughes,D,VAN,25,82,14,63,77
2,8477501,Valeri Nichushkin,R,COL,29,82,38,38,76
2,8478445,Mathew Barzal,C,NYI,27,82,26,50,76
2,8476454,Ryan Nugent-Hopkins,C,EDM,31,82,25,51,76
2,8479542,Brandon Hagel,L,TBL,26,82,34,41,75
2,8476346,Johnny Gaudreau,L,CBJ,31,82,16,59,75
2,8478398,Kyle Connor,L,WPG,28,82,38,36,74
2,8471215,Evgeni Malkin,C,PIT,38,82,24,50,74
2,8479407,Jesper Bratt,L,NJD,26,82,23,51,74
2,8477933,Sam Reinhart,C,FLA,29,82,34,39,73
2,8475786,Zach Hyman,L,EDM,32,82,33,40,73
2,8481557,Matt Boldy,L,MIN,23,82,35,37,72
2,8479420,Tage Thompson,C,BUF,27,82,34,38,72
2,8480830,Andrei Svechnikov,R,CAR,24,82,26,46,72
2,8478439,Travis Konecny,R,PHI,27,82,24,48,72
2,8474564,Steven Stamkos,C,TBL,34,82,21,51,72
2,8478449,Roope Hintz,C,DAL,28,82,39,32,71
2,8477955,Jared McCann,L,SEA,28,82,29,42,71
2,8478444,Brock Boeser,R,VAN,27,82,28,43,71
2,8480023,Robert Thomas,C,STL,25,82,22,49,71
2,8480036,Miro Heiskanen,D,DAL,25,82,11,59,70
2,8482109,Alexis Lafrenière,L,NYR,23,82,40,29,69
2,8478047,Michael Bunting,L,PIT,29,82,29,40,69
2,8480865,Noah Dobson,D,NYI,24,82,17,52,69
2,8476853,Morgan Rielly,D,TOR,30,82,10,59,69
2,8478414,Timo Meier,R,NJD,28,82,43,25,68
2,8478403,Jack Eichel,C,VGK,28,82,29,39,68
2,8476905,Chandler Stephenson,C,VGK,30,82,25,43,68
2,8481523,Kirby Dach,C,MTL,23,82,8,60,68
2,8481540,Cole Caufield,R,MTL,23,82,36,31,67
2,8477402,Pavel Buchnevich,L,STL,29,82,20,47,67
2,8477500,Bo Horvat,C,NYI,29,82,32,34,66
2,8477935,Sam Bennett,C,FLA,28,82,29,37,66
2,8478427,Sebastian Aho,C,CAR,27,82,27,39,66
2,8476459,Mika Zibanejad,C,NYR,31,82,26,40,66
2,8482078,Lucas Raymond,L,DET,22,82,26,40,66
2,8473419,Brad Marchand,L,BOS,36,82,20,46,66
2,8482684,Luke Hughes,D,NJD,21,82,19,47,66
2,8475166,John Tavares,C,TOR,34,82,26,39,65
2,8475913,Mark Stone,R,VGK,32,82,25,40,65
2,8475798,Mikael Granlund,C,SJS,32,82,14,51,65
2,8476881,Tomas Hertl,C,VGK,31,82,33,31,64
2,8477416,Oliver Bjorkstrand,R,SEA,29,82,31,33,64
2,8479385,Jordan Kyrou,C,STL,26,82,27,37,64
2,8476460,Mark Scheifele,C,WPG,31,82,27,36,63
2,8477493,Aleksander Barkov,C,FLA,29,82,25,38,63
2,8477951,Nick Schmaltz,C,ARI,28,82,25,38,63
2,8478493,Joel Eriksson Ek,C,MIN,27,82,24,39,63
2,8478873,Troy Terry,R,ANA,27,82,20,43,63
2,8476456,Jonathan Huberdeau,C,CGY,31,82,18,45,63
2,8474141,Patrick Kane,R,DET,36,82,15,48,63
2,8471685,Anze Kopitar,C,LAK,37,82,14,49,63
2,8482740,Wyatt Johnston,C,DAL,21,82,34,28,62
2,8480018,Nick Suzuki,C,MTL,25,82,24,38,62
2,8477447,Shea Theodore,D,VGK,29,82,11,51,62
2,8475810,Bryan Rust,R,PIT,32,82,31,30,61
2,8475184,Chris Kreider,L,NYR,33,82,30,31,61
2,8475754,Brock Nelson,C,NYI,33,82,29,32,61
2,8481068,Yegor Sharangovich,C,CGY,26,82,24,36,60
2,8477942,Kevin Fiala,L,LAK,28,82,20,40,60
2,8475158,Ryan O'Reilly,C,NSH,33,82,20,40,60
2,8475726,Tyler Toffoli,C,WPG,32,82,32,27,59
2,8477960,Adrian Kempe,R,LAK,28,82,28,31,59
2,8476389,Vincent Trocheck,C,NYR,31,82,23,36,59
2,8477940,Nikolaj Ehlers,L,WPG,28,82,22,37,59
2,8480839,Rasmus Dahlin,D,BUF,24,82,17,42,59
2,8474578,Erik Karlsson,D,PIT,34,82,15,44,59
2,8475167,Victor Hedman,D,TBL,34,82,6,53,59
2,8475784,Jeff Skinner,C,BUF,32,82,32,26,58
2,8477476,Artturi Lehkonen,L,COL,29,82,24,34,58
2,8479325,Charlie McAvoy,D,BOS,27,82,11,47,58
2,8479323,Adam Fox,D,NYR,26,82,5,53,58
2,8480188,Fabian Zetterlund,L,SJS,25,82,31,26,57
2,8476539,Jonathan Marchessault,R,VGK,34,82,29,28,57
2,8479339,Patrik Laine,L,CBJ,26,82,26,31,57
2,8478401,Pavel Zacha,C,BOS,27,82,21,36,57
2,8482093,Seth Jarvis,C,CAR,22,82,19,38,57
2,8480803,Evan Bouchard,D,EDM,25,82,12,45,57
2,8479337,Alex DeBrincat,R,DET,27,82,29,27,56
2,8480039,Martin Necas,C,CAR,25,82,23,33,56
2,8478440,Dylan Strome,C,WSH,27,82,22,34,56
2,8479675,Trevor Moore,L,LAK,29,82,21,35,56
2,8473512,Claude Giroux,R,OTT,36,82,15,41,56
2,8477504,Josh Morrissey,D,WPG,29,82,14,42,56
2,8480015,Owen Tippett,R,PHI,25,82,30,24,54
2,8481596,Shane Pinto,C,OTT,24,82,23,31,54
2,8473986,Alex Killorn,L,ANA,35,82,22,32,54
2,8475168,Matt Duchene,C,DAL,33,82,18,36,54
2,8474586,Jordan Eberle,R,SEA,34,82,18,36,54
2,8475170,Brayden Schenn,C,STL,33,82,17,37,54
2,8478407,Vince Dunn,D,SEA,28,82,12,42,54
2,8475794,Tyler Seguin,C,DAL,32,82,26,27,53
2,8478233,Andrew Mangiapane,L,CGY,28,82,26,27,53
2,8482745,Mason McTavish,C,ANA,21,82,17,36,53
2,8475745,Charlie Coyle,C,BOS,32,82,17,36,53
2,8483471,Brad Lambert,C,WPG,31,82,5,48,53
2,8477407,Anthony Duclair,L,TBL,29,82,32,20,52
2,8479400,Pierre-Luc Dubois,L,LAK,26,82,26,26,52
2,8481533,Trevor Zegras,C,ANA,23,82,20,32,52
2,8476826,Yanni Gourde,C,SEA,33,82,14,38,52
2,8483808,Andrei Kuzmenko,L,CGY,28,82,27,24,51
2,8480208,Drake Batherson,R,OTT,26,82,21,30,51
2,8484144,Connor Bedard,C,CHI,19,82,21,30,51
2,8476448,William Karlsson,C,VGK,31,82,20,31,51
2,8473994,Jamie Benn,L,DAL,35,82,18,33,51
2,8477949,Alex Tuch,R,BUF,28,82,14,37,51
2,8476458,Ryan Strome,C,ANA,31,82,14,37,51
2,8474590,John Carlson,D,WSH,34,82,12,39,51
2,8478397,Rasmus Andersson,D,CGY,28,82,9,42,51
2,8478498,Jake DeBrusk,L,BOS,28,82,26,24,50
2,8475765,Vladimir Tarasenko,R,FLA,33,82,22,28,50
2,8479999,Casey Mittelstadt,C,COL,26,82,20,30,50
2,8478042,Viktor Arvidsson,R,LAK,31,82,19,31,50
2,8476875,Mike Matheson,D,MTL,30,82,10,40,50
2,8483397,Marc McLaughlin,C,BOS,25,82,45,4,49
2,8480014,Gabriel Vilardi,C,WPG,25,82,30,19,49
2,8482222,Alexander Barabanov,L,SJS,30,82,19,30,49
2,8476882,Teuvo Teravainen,L,CAR,30,82,14,35,49
2,8476462,Dougie Hamilton,D,NJD,31,82,13,36,49
2,8483445,Cutter Gauthier,L,ANA,20,82,13,36,49
2,8471698,T.J. Oshie,R,WSH,38,82,26,22,48
2,8481528,Dylan Cozens,C,BUF,23,82,21,27,48
2,8478856,Conor Garland,R,VAN,28,82,20,28,48
2,8477444,Andre Burakovsky,L,SEA,29,82,19,29,48
2,8478438,Tommy Novak,C,NSH,27,82,18,30,48
2,8479345,Jakob Chychrun,D,OTT,26,82,17,31,48
2,8482665,Matty Beniers,C,SEA,22,82,16,32,48
2,8471724,Kris Letang,D,PIT,37,82,15,33,48
2,8477503,Max Domi,C,TOR,29,82,14,34,48
2,8481711,Matias Maccelli,L,ARI,24,82,11,37,48
2,8478519,Anthony Cirelli,C,TBL,27,82,26,21,47
2,8475791,Taylor Hall,L,CHI,33,82,26,21,47
2,8476880,Tom Wilson,R,WSH,30,82,21,26,47
2,8482101,Danil Gushchin,L,SJS,22,82,21,26,47
2,8475722,Jason Zucker,L,NSH,32,82,20,27,47
2,8478542,Evan Rodrigues,C,FLA,31,82,15,32,47
2,8480031,Maxime Comtois,L,CAR,25,82,13,34,47
2,8479410,Mikhail Sergachev,D,TBL,26,82,9,38,47
2,8477496,Elias Lindholm,C,VAN,30,82,25,21,46
2,8476432,Boone Jenner,C,CBJ,31,82,24,22,46
2,8478472,Mathieu Joseph,R,OTT,27,82,15,31,46
2,8477932,Aaron Ekblad,D,FLA,28,82,11,35,46
2,8477986,Brandon Montour,D,FLA,30,82,5,41,46
2,8478366,Frank Vatrano,R,ANA,30,82,28,17,45
2,8475169,Evander Kane,L,EDM,33,82,27,18,45
2,8475151,Kyle Palmieri,C,NYI,33,82,25,20,45
2,8476483,Rickard Rakell,R,PIT,31,82,23,22,45
2,8482699,Dylan Guenther,R,ARI,21,82,23,22,45
2,8478462,Nicolas Roy,C,VGK,27,82,18,27,45
2,8475287,Erik Haula,L,NJD,33,82,17,28,45
2,8478055,Gustav Forsling,D,FLA,28,82,17,28,45
2,8478460,Zach Werenski,D,CBJ,27,82,15,30,45
2,8482671,Owen Power,D,BUF,22,82,7,38,45
2,8477495,Seth Jones,D,CHI,30,82,4,41,45
2,8482097,Jack Quinn,R,BUF,23,82,24,20,44
2,8476479,Phillip Danault,C,LAK,31,82,23,21,44
2,8475768,Jaden Schwartz,C,SEA,32,82,17,27,44
2,8474679,Gustav Nyquist,C,NSH,35,82,15,29,44
2,8474102,David Perron,L,DET,36,82,15,29,44
2,8477497,Sean Monahan,C,WPG,30,82,15,29,44
2,8476869,Brady Skjei,D,CAR,30,82,14,30,44
2,8476480,Vladislav Namestnikov,C,WPG,32,82,12,32,44
2,8477494,Jonathan Drouin,L,COL,29,82,11,33,44
2,8478469,Thomas Chabot,D,OTT,27,82,7,37,44
2,8474150,Mikael Backlund,C,CGY,35,82,20,23,43
2,8480797,Joel Farabee,L,PHI,24,82,20,23,43
2,8477511,Anthony Mantha,R,VGK,30,82,19,24,43
2,8478975,Mason Marchment,L,DAL,29,82,16,27,43
2,8475753,Justin Faulk,D,STL,32,82,13,30,43
2,8475764,Cam Fowler,D,ANA,33,82,2,41,43
2,8478474,Lawson Crouse,L,ARI,27,82,26,16,42
2,8475799,Nino Niederreiter,R,WPG,32,82,26,16,42
2,8476399,Blake Coleman,C,CGY,33,82,24,18,42
2,8478046,Danton Heinen,L,BOS,29,82,20,22,42
2,8476925,Colton Sissons,C,NSH,31,82,17,25,42
2,8482133,Thomas Bordeleau,C,SJS,22,82,16,26,42
2,8474565,Alex Pietrangelo,D,VGK,34,82,13,29,42
2,8478458,Jack Roslovic,C,NYR,27,82,12,30,42
2,8478038,Devon Toews,D,COL,30,82,11,31,42
2,8478396,Noah Hanifin,D,VGK,27,82,8,34,42
2,8481699,Aku Raty,R,ARI,23,82,4,38,42
2,8481618,Alex Newhook,C,MTL,23,82,23,18,41
2,8477998,Warren Foegele,L,EDM,28,82,20,21,41
2,8482159,Tyson Foerster,R,PHI,22,82,20,21,41
2,8482055,Drew O'Connor,L,PIT,26,82,20,21,41
2,8475760,Nick Bjugstad,C,ARI,32,82,20,21,41
2,8477429,Andrew Copp,C,DET,30,82,19,22,41
2,8482079,Marco Rossi,C,MIN,23,82,19,22,41
2,8482702,Logan Stankoven,C,DAL,21,82,19,22,41
2,8475191,Reilly Smith,R,PIT,33,82,15,26,41
2,8477953,Kasperi Kapanen,R,STL,28,82,15,26,41
2,8480798,Philipp Kurashev,C,CHI,25,82,14,27,41
2,8482124,Quinton Byfield,R,LAK,22,82,13,28,41
2,8480220,Noah Cates,L,PHI,25,82,11,30,41
2,8475197,Tyson Barrie,D,NSH,33,82,7,34,41
2,8480064,Josh Norris,C,OTT,25,82,24,16,40
2,8474641,Adam Henrique,C,EDM,34,82,22,18,40
2,8482089,Jake Neighbours,L,STL,22,82,19,21,40
2,8473422,Nick Foligno,L,CHI,37,82,19,21,40
2,8474157,Max Pacioretty,L,WSH,36,82,18,22,40
2,8479987,Morgan Geekie,C,BOS,26,82,18,22,40
2,8479365,Trent Frederic,C,BOS,26,82,17,23,40
2,8476461,Sean Couturier,C,PHI,32,82,15,25,40
2,8477451,Ryan Hartman,R,MIN,30,82,13,27,40
2,8477479,Tyler Bertuzzi,L,TOR,29,82,11,29,40
2,8476329,Travis Boyd,C,ARI,31,82,9,31,40
2,8481546,Cam York,D,PHI,23,82,7,33,40
2,8476923,Damon Severson,D,CBJ,30,82,6,34,40
2,8479425,Filip Hronek,D,VAN,27,82,5,35,40
2,8480849,Barrett Hayton,C,ARI,24,82,20,19,39
2,8478891,Mason Appleton,C,WPG,28,82,14,25,39
2,8480028,Morgan Frost,C,PHI,25,82,13,26,39
2,8482175,JJ Peterka,R,BUF,22,82,12,27,39
2,8477426,Nicholas Paul,L,TBL,29,82,21,17,38
2,8480009,Eeli Tolvanen,R,SEA,25,82,19,19,38
2,8480113,Alex Iafallo,L,WPG,31,82,17,21,38
2,8482113,Anton Lundell,C,FLA,23,82,15,23,38
2,8482667,William Eklund,L,SJS,22,82,14,24,38
2,8474053,Logan Couture,C,SJS,35,82,13,25,38
2,8476792,Torey Krug,D,STL,33,82,9,29,38
2,8476292,Ondrej Palat,L,NJD,33,82,9,29,38
2,8481581,Thomas Harley,D,DAL,23,82,8,30,38
2,8476958,Jaccob Slavin,D,CAR,30,82,7,31,38
2,8481016,Ruslan Iskhakov,C,NYI,24,82,5,33,38
2,8480893,Kirill Marchenko,R,CBJ,24,82,22,15,37
2,8474037,James van Riemsdyk,L,BOS,35,82,17,20,37
2,8474870,Tyler Johnson,C,CHI,34,82,17,20,37
2,8479525,Ross Colton,C,COL,28,82,15,22,37
2,8477021,Alex Kerfoot,C,ARI,30,82,10,27,37
2,8477450,Jason Dickinson,C,CHI,29,82,10,27,37
2,8480434,Sean Durzi,D,ARI,26,82,7,30,37
2,8477944,Jakub Vrana,L,STL,28,82,24,12,36
2,8478463,Anthony Beauvillier,L,NSH,27,82,17,19,36
2,8481554,Kaapo Kakko,R,NYR,23,82,15,21,36
2,8474149,Evgenii Dadonov,R,DAL,35,82,14,22,36
2,8475744,Evgeny Kuznetsov,C,CAR,32,82,10,26,36
2,8482110,Dawson Mercer,C,NJD,23,82,20,15,35
2,8478057,Dakota Joshua,C,VAN,28,82,16,19,35
2,8480185,Eetu Luostarinen,C,FLA,26,82,14,21,35
2,8476278,Colin Blackwell,C,CHI,31,82,13,22,35
2,8477919,Frederick Gaudreau,C,MIN,31,82,13,22,35
2,8478466,Daniel Sprong,R,DET,27,82,11,24,35
2,8476392,Adam Lowry,C,WPG,31,82,10,25,35
2,8475218,Mattias Ekholm,D,EDM,34,82,9,26,35
2,8476892,Colton Parayko,D,STL,31,82,9,26,35
2,8477346,MacKenzie Weegar,D,CGY,30,82,7,28,35
2,8477948,Travis Sanheim,D,PHI,28,82,5,30,35
2,8482122,Brock Faber,D,MIN,22,82,4,31,35
2,8479423,Alex Nylander,L,CBJ,26,82,19,15,34
2,8483499,Liam Ohgren,L,MIN,20,82,19,15,34
2,8477952,Robby Fabbri,C,DET,28,82,16,18,34
2,8480821,Filip Zadina,R,SJS,25,82,15,19,34
2,8479316,Luke Kunin,C,SJS,27,82,14,20,34
2,8478115,Pierre Engvall,L,NYI,28,82,13,21,34
2,8482092,Ridly Greig,C,OTT,22,82,10,24,34
2,8479977,Kailer Yamamoto,R,SEA,26,82,9,25,34
2,8475149,Marcus Johansson,L,MIN,34,82,8,26,34
2,8483431,Logan Cooley,C,ARI,20,82,17,16,33
2,8476873,Mark Jankowski,C,NSH,30,82,17,16,33
2,8480855,Jack McBain,C,ARI,24,82,17,16,33
2,8483515,Juraj Slafkovsky,L,MTL,20,82,16,17,33
2,8475848,Brendan Gallagher,R,MTL,32,82,16,17,33
2,8476438,Brandon Saad,L,STL,32,82,15,18,33
2,8474884,Mike Hoffman,C,SJS,35,82,15,18,33
2,8477507,Nikita Zadorov,D,VAN,29,82,12,21,33
2,8477456,J.T. Compher,L,DET,29,82,11,22,33
2,8477964,Ivan Barbashev,C,VGK,29,82,10,23,33
2,8476854,Hampus Lindholm,D,BOS,30,82,6,27,33
2,8481703,Valtteri Puustinen,R,PIT,25,82,6,27,33
2,8482105,Jake Sanderson,D,OTT,22,82,5,28,33
2,8483457,Lane Hutson,D,MTL,20,82,4,29,33
2,8476981,Josh Anderson,R,MTL,30,82,16,16,32
2,8482259,Bobby McMann,C,TOR,28,82,14,18,32
2,8480802,Ryan McLeod,C,EDM,25,82,12,20,32
2,8479415,Michael McLeod,C,NJD,26,82,10,22,32
2,8480078,Filip Chytil,C,NYR,25,82,9,23,32
2,8480145,Neal Pionk,D,WPG,29,82,8,24,32
2,8482142,Jamie Drysdale,D,PHI,22,82,8,24,32
2,8480336,Sean Walker,D,COL,30,82,7,25,32
2,8477969,Marcus Pettersson,D,PIT,28,82,6,26,32
2,8482733,Logan Mailloux,D,MTL,31,82,5,27,32
2,8474563,Drew Doughty,D,LAK,35,82,4,28,32
2,8483524,Shane Wright,C,SEA,20,82,22,9,31
2,8482737,Zack Bolduc,C,STL,21,82,22,9,31
2,8478020,Michael Amadio,C,VGK,28,82,19,12,31
2,8482705,Cole Sillinger,C,CBJ,21,82,15,16,31
2,8473449,Kyle Okposo,R,FLA,36,82,15,16,31
2,8480074,Alexandre Texier,C,CBJ,25,82,15,16,31
2,8481704,Juuso Parssinen,C,NSH,23,82,14,17,31
2,8481028,Martin Pospisil,C,CGY,25,82,13,18,31
2,8480817,K'Andre Miller,D,NYR,24,82,11,20,31
2,8476906,Shayne Gostisbehere,D,DET,31,82,7,24,31
2,8476879,Cody Ceci,D,EDM,31,82,5,26,31
2,8470610,Zach Parise,L,COL,40,82,20,10,30
2,8481560,Arthur Kaliyev,R,LAK,23,82,19,11,30
2,8479941,Justin Danforth,R,CBJ,31,82,18,12,30
2,8476872,Scott Laughton,C,PHI,30,82,17,13,30
2,8470621,Corey Perry,R,EDM,39,82,16,14,30
2,8471218,Blake Wheeler,R,NYR,38,82,15,15,30
2,8484166,Adam Fantilli,C,CBJ,20,82,15,15,30
2,8481481,Blake Lizotte,C,LAK,27,82,14,16,30
2,8475793,Ryan Johansen,C,PHI,32,82,13,17,30
2,8476871,Tanner Pearson,L,MTL,32,82,13,17,30
2,8479390,Taylor Raddysh,R,CHI,26,82,13,17,30
2,8476960,Andreas Athanasiou,C,CHI,30,82,12,18,30
2,8483482,Tristan Luneau,D,ANA,20,82,12,18,30
2,8477989,Christian Dvorak,C,MTL,28,82,10,20,30
2,8482146,Luke Evangelista,R,NSH,22,82,10,20,30
2,8477498,Darnell Nurse,D,EDM,29,82,10,20,30
2,8482624,Daniil Miromanov,D,CGY,27,82,9,21,30
2,8475763,Kevin Hayes,R,STL,32,82,9,21,30
2,8475906,John Klingberg,D,TOR,32,82,7,23,30
2,8473563,Nicklas Backstrom,C,WSH,37,82,7,23,30
2,8478178,Darren Raddysh,D,TBL,28,82,7,23,30
2,8478500,Ivan Provorov,D,CBJ,27,82,6,24,30
2,8481542,Moritz Seider,D,DET,23,82,6,24,30
2,8475714,Calle Jarnkrok,C,TOR,33,82,16,13,29
2,8484153,Leo Carlsson,C,ANA,20,82,15,14,29
2,8479992,Michael Rasmussen,C,DET,25,82,15,14,29
2,8481186,Logan O'Connor,R,COL,28,82,14,15,29
2,8478013,Jake Walman,D,DET,28,82,14,15,29
2,8475231,Casey Cizikas,C,NYI,33,82,14,15,29
2,8479293,Brandon Tanev,L,SEA,33,82,13,16,29
2,8481624,Ilya Mikheyev,R,VAN,30,82,12,17,29
2,8473533,Jordan Staal,C,CAR,36,82,12,17,29
2,8482074,Connor Zary,C,CGY,23,82,12,17,29
2,8474715,Cam Atkinson,R,PHI,35,82,11,18,29
2,8470613,Brent Burns,D,CAR,39,82,6,23,29
2,8474151,Ryan McDonagh,D,NSH,35,82,4,25,29
2,8477330,Dominik Kubalik,L,OTT,29,82,17,11,28
2,8480459,Pius Suter,C,VAN,28,82,16,12,28
2,8475314,Anders Lee,L,NYI,34,82,16,12,28
2,8476927,Teddy Blueger,C,VAN,30,82,13,15,28
2,8478413,Jordan Greenway,L,BUF,27,82,12,16,28
2,8481535,Nils Hoglander,L,VAN,24,82,12,16,28
2,8481601,Simon Holmstrom,R,NYI,23,82,12,16,28
2,8477947,Sonny Milano,L,WSH,28,82,10,18,28
2,8475200,Dmitry Orlov,D,CAR,33,82,9,19,28
2,8479371,Dante Fabbro,D,NSH,26,82,9,19,28
2,8482475,Yegor Chinakhov,R,CBJ,23,82,8,20,28
2,8478911,Matt Roy,D,LAK,29,82,8,20,28
2,8476457,Adam Larsson,D,SEA,32,82,8,20,28
2,8483466,Kevin Korchinski,D,CHI,20,82,8,20,28
2,8481606,Jordan Spence,D,LAK,23,82,7,21,28
2,8479398,Samuel Girard,D,COL,26,82,7,21,28
2,8480035,Henri Jokiharju,D,BUF,25,82,7,21,28
2,8476979,Erik Gustafsson,D,NYR,32,82,6,22,28
2,8477499,Rasmus Ristolainen,D,PHI,30,82,6,22,28
2,8475171,Oliver Ekman-Larsson,D,FLA,33,82,5,23,28
2,8480873,Rasmus Sandin,D,WSH,24,82,4,24,28
2,8470600,Ryan Suter,D,DAL,39,82,4,24,28
2,8477845,Trevor van Riemsdyk,D,WSH,33,82,3,25,28
2,8475188,Brayden McNabb,D,VGK,33,82,2,26,28
2,8478508,Yakov Trenin,C,COL,27,82,17,10,27
2,8479996,Cody Glass,C,NSH,25,82,15,12,27
2,8481013,Jonatan Berggren,R,DET,24,82,12,15,27
2,8477425,Miles Wood,L,COL,29,82,12,15,27
2,8478133,Jake Evans,C,MTL,28,82,11,16,27
2,8481522,Peyton Krebs,C,BUF,23,82,10,17,27
2,8476525,Colin Miller,D,WPG,32,82,8,19,27
2,8474716,Jared Spurgeon,D,MIN,35,82,6,21,27
2,8480871,Adam Boqvist,D,CBJ,24,82,5,22,27
2,8476463,Jonas Brodin,D,MIN,31,82,5,22,27
2,8478851,Alexandre Carrier,D,NSH,28,82,4,23,27
2,8480043,Timothy Liljegren,D,TOR,25,82,3,24,27
2,8474166,Alec Martinez,D,VGK,37,82,2,25,27
2,8480068,Ryan Poehling,C,PHI,25,82,16,10,26
2,8481604,Pavel Dorofeyev,L,VGK,24,82,14,12,26
2,8474189,Lars Eller,C,PIT,35,82,12,14,26
2,8481580,Connor McMichael,C,WSH,23,82,11,15,26
2,8481656,Aliaksei Protas,C,WSH,23,82,9,17,26
2,8479514,Rem Pitlick,C,CHI,27,82,8,18,26
2,8477435,Ryan Graves,D,PIT,29,82,7,19,26
2,8476467,Jamie Oleksiak,D,SEA,32,82,7,19,26
2,8475181,Nick Leddy,D,STL,33,82,6,20,26
2,8476917,Adam Pelech,D,NYI,30,82,5,21,26
2,8480807,Mattias Samuelsson,D,BUF,24,82,5,21,26
2,8481568,Alex Vlasic,D,CHI,23,82,2,24,26
2,8474009,Nick Bonino,C,NYR,36,82,19,6,25
2,8483493,Frank Nazar,C,CHI,20,82,18,7,25
2,8481477,Nico Sturm,C,SJS,29,82,17,8,25
2,8482125,Alexander Holtz,R,NJD,22,82,14,11,25
2,8482111,Justin Barron,D,MTL,23,82,10,15,25
2,8476419,Jean-Gabriel Pageau,C,NYI,32,82,9,16,25
2,8477839,Conor Sheary,L,TBL,32,82,9,16,25
2,8479346,Dillon Dube,C,CGY,26,82,8,17,25
2,8478451,Ethan Bear,D,WSH,27,82,8,17,25
2,8476312,Josh Manson,D,COL,33,82,6,19,25
2,8478507,John Marino,D,NJD,27,82,6,19,25
2,8483565,Nick Blankenburg,D,CBJ,26,82,6,19,25
2,8480860,Kevin Bahl,D,NJD,24,82,5,20,25
2,8479369,Andrew Peeke,D,BOS,26,82,4,21,25
2,8478043,Sam Lafferty,C,VAN,29,82,15,9,24
2,8476469,Joel Armia,R,MTL,31,82,14,10,24
2,8476374,Sean Kuraly,C,CBJ,31,82,12,12,24
2,8480448,Parker Kelly,L,OTT,25,82,11,13,24
2,8479591,Michael Eyssimont,C,TBL,28,82,10,14,24
2,8482720,Matthew Knies,L,TOR,22,82,9,15,24
2,8479351,Sam Steel,C,DAL,26,82,7,17,24
2,8476331,Dylan DeMelo,D,WPG,31,82,5,19,24
2,8479976,Juuso Valimaki,D,ARI,26,82,4,20,24
2,8476891,Matt Grzelcyk,D,BOS,30,82,1,23,24
2,8478109,Victor Olofsson,L,BUF,29,82,12,11,23
2,8476897,Oskar Sundqvist,C,STL,30,82,10,13,23
2,8479383,Boris Katchouk,L,OTT,26,82,10,13,23
2,8479980,Nicolas Hague,D,VGK,26,82,8,15,23
2,8477488,Brett Pesce,D,CAR,30,82,7,16,23
2,8481537,Nikita Okhotiuk,D,CGY,24,82,6,17,23
2,8476429,Scott Mayfield,D,NYI,32,82,6,17,23
2,8482655,J.J. Moser,D,ARI,24,82,6,17,23
2,8477506,Ryan Pulock,D,NYI,30,82,5,18,23
2,8476885,Jacob Trouba,D,NYR,30,82,3,20,23
2,8474574,Tyler Myers,D,VAN,34,82,1,22,23
2,8482145,Mavrik Bourque,C,DAL,22,82,20,2,22
2,8482809,Jackson Blake,R,CAR,21,82,15,7,22
2,8481553,Bobby Brink,R,PHI,23,82,13,9,22
2,8476915,Jujhar Khaira,L,MIN,30,82,12,10,22
2,8473453,Trevor Lewis,C,LAK,37,82,11,11,22
2,8476921,Jordan Martinook,L,CAR,32,82,9,13,22
2,8477406,Mattias Janmark,C,EDM,32,82,7,15,22
2,8482087,Kaiden Guhle,D,MTL,22,82,6,16,22
2,8476902,Esa Lindell,D,DAL,30,82,6,16,22
2,8482730,Brandt Clarke,D,LAK,21,82,6,16,22
2,8476473,Connor Murphy,D,CHI,31,82,6,16,22
2,8482073,Braden Schneider,D,NYR,23,82,5,17,22
2,8481524,Bowen Byram,D,BUF,23,82,4,18,22
2,8478416,Erik Cernak,D,TBL,27,82,2,20,22
2,8484203,Bradly Nadeau,L,CAR,19,82,14,7,21
2,8481517,Brett Leason,R,ANA,25,82,12,9,21
2,8482062,Cole Smith,L,NSH,29,82,12,9,21
2,8478430,Oliver Kylington,D,CGY,27,82,7,14,21
2,8482155,Alex Laferriere,R,LAK,23,82,7,14,21
2,8481014,Alexander Romanov,D,NYI,24,82,6,15,21
2,8481059,Scott Perunovich,D,STL,26,82,6,15,21
2,8483505,Matthew Poitras,C,BOS,20,82,5,16,21
2,8475324,Nick Jensen,D,WSH,34,82,5,16,21
2,8479983,Mario Ferraro,D,SJS,26,82,4,17,21
2,8480172,Jan Rutta,D,SJS,34,82,4,17,21
2,8480246,Nick Perbix,D,TBL,26,82,4,17,21
2,8484911,Collin Graf,R,SJS,22,82,4,17,21
2,8475233,David Savard,D,MTL,34,82,3,18,21
2,8478443,Brandon Carlo,D,BOS,28,82,2,19,21
2,8482118,Sam Colangelo,R,ANA,23,82,16,4,20
2,8481093,Rafael Harvey-Pinard,L,MTL,25,82,15,5,20
2,8480806,Isac Lundestrom,C,ANA,25,82,11,9,20
2,8484145,Zach Benson,L,BUF,19,82,10,10,20
2,8483491,Ivan Miroshnichenko,L,WSH,20,82,9,11,20
2,8474034,Pat Maroon,L,BOS,36,82,8,12,20
2,8475220,Marcus Foligno,L,MIN,33,82,8,12,20
2,8479661,Tanner Jeannot,L,TBL,27,82,7,13,20
2,8480834,Ty Emberson,D,SJS,24,82,5,15,20
2,8475790,Erik Gudbranson,D,CBJ,32,82,5,15,20
2,8481178,Egor Zamula,D,PHI,24,82,4,16,20
2,8480058,Pierre-Olivier Joseph,D,PIT,25,82,4,16,20
2,8482245,Artem Zub,D,OTT,29,82,3,17,20
2,8480281,Alexey Toropchenko,R,STL,25,82,11,8,19
2,8480813,Joe Veleno,C,DET,24,82,8,11,19
2,8479353,Brett Howden,C,VGK,26,82,7,12,19
2,8483490,Pavel Mintyukov,D,ANA,21,82,7,12,19
2,8476858,Phillip Di Giuseppe,L,VAN,31,82,7,12,19
2,8475179,Dmitry Kulikov,D,FLA,34,82,6,13,19
2,8481567,Henry Thrun,D,SJS,23,82,4,15,19
2,8476931,Jake McCabe,D,TOR,31,82,4,15,19
2,8478136,Jake Middleton,D,MIN,28,82,4,15,19
2,8481605,Jackson LaCombe,D,ANA,23,82,4,15,19
2,8475279,Ben Chiarot,D,DET,33,82,3,16,19
2,8482712,Oskar Olausson,R,COL,22,82,2,17,19
2,8479393,Noah Gregor,C,TOR,26,82,14,4,18
2,8482679,Matt Coronato,R,CGY,22,82,11,7,18
2,8476878,Zemgus Girgensons,L,BUF,30,82,10,8,18
2,8473504,Cal Clutterbuck,R,NYI,37,82,9,9,18
2,8475842,Sam Carrick,C,EDM,32,82,8,10,18
2,8477392,Hudson Fasching,R,NYI,29,82,7,11,18
2,8475343,Nic Dowd,C,WSH,34,82,6,12,18
2,8476372,Nick Seeler,D,PHI,31,82,6,12,18
2,8475177,Calvin de Haan,D,TBL,33,82,6,12,18
2,8481578,Graeme Clarke,R,NJD,23,82,6,12,18
2,8480073,Erik Brannstrom,D,OTT,25,82,1,17,18
2,8483012,Logan Morrison,C,SEA,22,82,12,5,17
2,8475164,Jakob Silfverberg,R,ANA,34,82,11,6,17
2,8476822,Luke Glendening,C,TBL,35,82,10,7,17
2,8480144,David Kampf,C,TOR,29,82,9,8,17
2,8480796,Martin Fehervary,D,WSH,25,82,5,12,17
2,8471677,Jack Johnson,D,COL,37,82,5,12,17
2,8483495,Simon Nemec,D,NJD,20,82,4,13,17
2,8479998,Mikey Anderson,D,LAK,25,82,4,13,17
2,8475462,Radko Gudas,D,ANA,34,82,4,13,17
2,8475455,Brenden Dillon,D,WPG,34,82,3,14,17
2,8482166,Shakir Mukhamadullin,D,SJS,22,82,3,14,17
2,8473507,Jeff Petry,D,DET,37,82,2,15,17
2,8474673,TJ Brodie,D,TOR,34,82,1,16,17
2,8470604,Jeff Carter,C,PIT,39,82,13,3,16
2,8482666,Scott Morrow,D,CAR,22,82,9,7,16
2,8479359,Beck Malenstyn,L,WSH,26,82,7,9,16
2,8476442,Matt Nieto,L,PIT,32,82,5,11,16
2,8477931,Tomas Nosek,L,NJD,32,82,5,11,16
2,8476967,Brett Kulak,D,EDM,30,82,4,12,16
2,8470966,Mark Giordano,D,TOR,41,82,4,12,16
2,8478399,Jonas Siegenthaler,D,NJD,27,82,2,14,16
2,8480879,Jacob Bernard-Docker,D,OTT,24,82,2,14,16
2,8478831,Kevin Stenlund,C,FLA,28,82,10,5,15
2,8482117,Lukas Reichel,L,CHI,22,82,8,7,15
2,8477015,Connor Brown,R,EDM,30,82,8,7,15
2,8477369,Carson Soucy,D,VAN,30,82,7,8,15
2,8476624,Barclay Goodrow,C,NYR,31,82,5,10,15
2,8478882,Vladislav Gavrikov,D,LAK,29,82,4,11,15
2,8478859,Niko Mikkola,D,FLA,28,82,4,11,15
2,8479442,Troy Stecher,D,EDM,30,82,3,12,15
2,8480980,Connor Dewar,C,TOR,25,82,7,7,14
2,8477353,Tyler Motte,C,TBL,29,82,6,8,14
2,8482762,Simon Edvinsson,D,DET,21,82,5,9,14
2,8476422,Mike Reilly,D,NYI,31,82,5,9,14
2,8478569,Noel Acciari,C,PIT,33,82,4,10,14
2,8478840,Will Borgen,D,SEA,28,82,4,10,14
2,8477365,Connor Clifton,D,BUF,29,82,4,10,14
2,8482516,Matthew Kessel,D,STL,24,82,4,10,14
2,8475690,Chris Tanev,D,DAL,35,82,3,11,14
2,8479291,Kevin Rooney,C,CGY,31,82,3,11,14
2,8482858,Ryker Evans,D,SEA,23,82,3,11,14
2,8475208,Brian Dumoulin,D,SEA,33,82,3,11,14
2,8479324,Ryan Lindgren,D,NYR,26,82,5,8,13
2,8478408,Travis Dermott,D,ARI,28,82,5,8,13
2,8474567,Zach Bogosian,D,MIN,34,82,4,9,13
2,8482803,Olen Zellweger,D,ANA,21,82,3,10,13
2,8481599,Victor Soderstrom,D,ARI,23,82,3,10,13
2,8481030,Jack St. Ivany,D,PIT,25,82,2,11,13
2,8483763,Maksymilian Szuber,D,ARI,22,82,6,6,12
2,8477508,Curtis Lazar,C,NJD,29,82,5,7,12
2,8477034,Jaycob Megna,D,CHI,32,82,4,8,12
2,8483468,Jiri Kulich,C,BUF,20,82,4,8,12
2,8477220,Nate Schmidt,D,WPG,33,82,3,9,12
2,8475825,Jani Hakanpää,D,DAL,32,82,3,9,12
2,8474013,Ian Cole,D,VAN,35,82,2,10,12
2,8477505,Alexander Wennberg,C,NYR,30,82,2,9,11
2,8482807,Ethan Del Mastro,D,CHI,21,82,6,4,10
2,8478468,Jeremy Lauzon,D,NSH,27,82,4,6,10
2,8477335,Kyle Burroughs,D,SJS,29,82,3,7,10
2,8482859,Zack Ostapchuk,C,OTT,21,82,3,7,10
2,8482177,Marat Khusnutdinov,C,MIN,22,82,3,7,10
2,8482470,Ilya Solovyov,D,CGY,24,82,0,9,9
2,8482713,Mackie Samoskevich,R,FLA,22,82,3,5,8
2,8484149,Gavin Brindley,C,CBJ,20,82,2,6,8
2,8480990,Declan Chisholm,D,MIN,24,82,1,7,8
2,8475762,Derek Forbort,D,BOS,32,82,0,8,8
2,8483489,Fraser Minten,C,TOR,31,82,4,3,7
2,8482141,Lukas Cormier,D,VGK,22,0,0,0,0
2,8476988,Matt Benning,D,SJS,30,0,0,0,0
2,8480727,Zach Whitecloud,D,VGK,28,0,0,0,0
2,8480887,Jordan Harris,D,MTL,24,0,0,0,0
2,8478450,Parker Wotherspoon,D,BOS,27,0,0,0,0
2,8481812,Nikolai Knyzhov,D,SJS,27,0,0,0,0
2,8480001,Urho Vaakanainen,D,ANA,25,0,0,0,0
2,8482176,Wyatt Kaiser,D,CHI,22,0,0,0,0
2,8481122,Simon Benoit,D,TOR,26,0,0,0,0
2,8476441,Joel Edmundson,D,TOR,31,0,0,0,0
2,8480884,Calen Addison,D,SJS,24,0,0,0,0
2,8482511,Mason Lohrei,D,BOS,23,0,0,0,0
2,8482192,Isaak Phillips,D,CHI,23,0,0,0,0
2,8480950,Ilya Lyubushkin,D,TOR,30,0,0,0,0
2,8474031,Kevin Shattenkirk,D,BOS,35,0,0,0,0
2,8475718,Justin Holl,D,DET,32,0,0,0,0
2,8479402,Jake Bean,D,CBJ,26,0,0,0,0
2,8474602,Justin Schultz,D,SEA,34,0,0,0,0
2,8477950,Tony DeAngelo,D,CAR,29,0,0,0,0
2,8481743,Marc Del Gaizo,D,NSH,25,0,0,0,0
2,8481527,Kaedan Korczak,D,VGK,23,0,0,0,0
2,8480192,Johnathan Kovacevic,D,MTL,27,0,0,0,0
2,8476874,Olli Maatta,D,DET,30,0,0,0,0
2,8482144,Jack Thompson,D,SJS,22,0,0,0,0
2,8480222,Sebastian Aho,D,NYI,28,0,0,0,0
2,8479458,Nikita Zaitsev,D,CHI,33,0,0,0,0
2,8471709,Marc-Edouard Vlasic,D,SJS,37,0,0,0,0
2,8482929,Emil Lilleberg,D,TBL,23,0,0,0,0
2,8477018,Ben Hutton,D,VGK,31,0,0,0,0
2,8481056,Spencer Stastney,D,NSH,24,0,0,0,0
2,8481593,Jayden Struble,D,MTL,23,0,0,0,0
2,8479982,Conor Timmins,D,TOR,26,0,0,0,0
2,8474090,Brendan Smith,D,NJD,35,0,0,0,0
2,8482964,Arber Xhekaj,D,MTL,23,0,0,0,0
2,8480891,Michael Kesselring,D,ARI,24,0,0,0,0
2,8477938,Haydn Fleury,D,TBL,28,0,0,0,0
2,8481806,Louis Crevier,D,CHI,23,0,0,0,0
2,8471274,Alex Goligoski,D,MIN,39,0,0,0,0
2,8481600,Tobias Bjornfot,D,FLA,23,0,0,0,0
2,8475797,Jarred Tinordi,D,CHI,32,0,0,0,0
2,8481521,Ronnie Attard,D,PHI,25,0,0,0,0
2,8474612,Travis Hamonic,D,OTT,34,0,0,0,0
2,8479576,Vincent Desharnais,D,EDM,28,0,0,0,0
2,8480049,Dylan Samberg,D,WPG,25,0,0,0,0
2,8483619,Filip Roos,D,CHI,25,0,0,0,0
2,8474568,Luke Schenn,D,NSH,35,0,0,0,0
2,8480184,Gustav Lindstrom,D,ANA,26,0,0,0,0
2,8480070,Ian Mitchell,D,BOS,25,0,0,0,0
2,8480196,Jacob Bryson,D,BUF,27,0,0,0,0
2,8471686,Marc Staal,D,PHI,37,0,0,0,0
2,8477467,Gustav Olofsson,D,SEA,30,0,0,0,0
2,8478970,Jalen Chatfield,D,CAR,28,0,0,0,0
2,8479348,Kale Clague,D,BUF,26,0,0,0,0
2,8473446,Erik Johnson,D,PHI,36,0,0,0,0
2,8477462,Robert Hagg,D,ANA,29,0,0,0,0
2,8478454,Noah Juulsen,D,VAN,27,0,0,0,0
2,8477384,Josh Brown,D,ARI,30,0,0,0,0
2,8481708,Zac Jones,D,NYR,24,0,0,0,0
2,8481167,Brayden Pachal,D,CGY,25,0,0,0,0
2,8482067,Connor Mackey,D,NYR,28,0,0,0,0
2,8483460,David Jiricek,D,CBJ,21,0,0,0,0
2,8481701,Santeri Hatakka,D,NJD,23,0,0,0,0
2,8478021,William Lagesson,D,ANA,28,0,0,0,0
2,8477851,Jordan Oesterle,D,CGY,32,0,0,0,0
2,8478452,Caleb Jones,D,COL,27,0,0,0,0
2,8479984,Cal Foote,D,NJD,26,0,0,0,0
2,8479639,Dylan Coghlan,D,CAR,26,0,0,0,0
2,8480874,Adam Ginning,D,PHI,24,0,0,0,0
2,8479321,Lucas Johansen,D,WSH,27,0,0,0,0
2,8480878,Nils Lundkvist,D,DAL,24,0,0,0,0
2,8482165,Yan Kuznetsov,D,CGY,22,0,0,0,0
2,8484258,Sam Malinski,D,COL,26,0,0,0,0
2,8480157,Calle Rosen,D,STL,30,0,0,0,0
2,8484304,Uvis Balinskis,D,FLA,28,0,0,0,0
2,8479985,Cale Fleury,D,SEA,26,0,0,0,0
2,8479378,Logan Stanley,D,WPG,26,0,0,0,0
2,8477541,Dakota Mermis,D,MIN,30,0,0,0,0
2,8481609,Vladislav Kolyachonok,D,ARI,23,0,0,0,0
2,8480823,Alexander Alexeyev,D,WSH,25,0,0,0,0
2,8481679,Maxence Guenette,D,OTT,23,0,0,0,0
2,8481564,Ryan Johnson,D,BUF,23,0,0,0,0
2,8479376,Victor Mete,D,PHI,26,0,0,0,0
2,8484254,Akito Hirose,D,VAN,25,0,0,0,0
2,8482660,Kent Johnson,C,CBJ,22,0,0,0,0
2,8482149,Cole Perfetti,C,WPG,22,0,0,0,0
2,8477987,Ryan Donato,C,CHI,28,0,0,0,0
2,8475755,Alexander Petrovic,D,DAL,32,0,0,0,0
2,8477810,Joel Hanley,D,CGY,33,0,0,0,0
2,8474145,Robert Bortuzzo,D,NYI,35,0,0,0,0
2,8481161,Jake Christiansen,D,CBJ,25,0,0,0,0
2,8476884,Derrick Pouliot,D,DAL,30,0,0,0,0
2,8481716,Dmitri Voronkov,L,CBJ,24,0,0,0,0
2,8480084,Nick DeSimone,D,NJD,30,0,0,0,0
2,8475750,Jon Merrill,D,MIN,32,0,0,0,0
2,8479315,Joey Anderson,R,CHI,26,0,0,0,0
2,8478011,Louie Belpedio,D,PHI,28,0,0,0,0
2,8482451,Mikael Pyyhtia,L,CBJ,23,0,0,0,0
2,8481541,Samuel Bolduc,D,NYI,24,0,0,0,0
2,8482126,Emil Andrae,D,PHI,31,0,0,0,0
2,8474618,Marco Scandella,D,STL,34,0,0,0,0
2,8477244,Chad Ruhwedel,D,NYR,34,0,0,0,0
2,8477971,Andreas Englund,D,LAK,28,0,0,0,0
2,8480829,Jesperi Kotkaniemi,C,CAR,24,0,0,0,0
2,8479372,Josh Mahura,D,FLA,26,0,0,0,0
2,8482095,Tyler Kleven,D,OTT,22,0,0,0,0
2,8481719,Maxwell Crozier,D,TBL,24,0,0,0,0
2,8475855,Jesper Fast,R,CAR,33,0,0,0,0
2,8480848,Ty Dellandrea,C,DAL,24,0,0,0,0
2,8475193,Tomas Tatar,L,SEA,34,0,0,0,0
2,8476889,Radek Faksa,C,DAL,30,0,0,0,0
2,8478495,Denis Gurianov,R,PHI,27,0,0,0,0
2,8480216,Jacob Peterson,C,SJS,25,0,0,0,0
2,8480252,Cole Guttman,C,CHI,25,0,0,0,0
2,8479026,Philippe Myers,D,TBL,27,0,0,0,0
2,8481006,Tyler Tucker,D,STL,24,0,0,0,0
2,8481032,Paul Cotter,C,VGK,25,0,0,0,0
2,8481577,Philip Tomasino,C,NSH,23,0,0,0,0
2,8476918,Jimmy Vesey,L,NYR,31,0,0,0,0
2,8479320,Max Lajoie,D,TOR,27,0,0,0,0
2,8478017,Mark Friedman,D,VAN,29,0,0,0,0
2,8481754,Nikita Nesterenko,C,ANA,23,0,0,0,0
2,8483407,Brandon Scanlin,D,NYR,25,0,0,0,0
2,8482659,Josh Doan,R,ARI,22,0,0,0,0
2,8477446,Michael McCarron,R,NSH,29,0,0,0,0
2,8477903,Garnet Hathaway,R,PHI,33,0,0,0,0
2,8482153,Brendan Brisson,C,VGK,23,0,0,0,0
2,8483546,Marshall Rifai,D,TOR,26,0,0,0,0
2,8484287,Cole McWard,D,VAN,23,0,0,0,0
2,8478854,Ryan Shea,D,PIT,27,0,0,0,0
2,8481585,Egor Afanasyev,L,NSH,23,0,0,0,0
2,8483398,Declan Carlile,D,TBL,31,0,0,0,0
2,8478502,Dennis Gilbert,D,CGY,28,0,0,0,0
2,8482749,Joshua Roy,R,MTL,21,0,0,0,0
2,8481598,Philip Broberg,D,EDM,23,0,0,0,0
2,8480835,Jack Drury,C,CAR,24,0,0,0,0
2,8480748,Kiefer Sherwood,L,NSH,29,0,0,0,0
2,8476934,Brock McGinn,L,ANA,30,0,0,0,0
2,8480870,Bo Groulx,C,ANA,24,0,0,0,0
2,8479368,Max Jones,L,ANA,26,0,0,0,0
2,8478099,Kevin Labanc,R,SJS,29,0,0,0,0
2,8478067,Oskar Lindblom,L,SJS,28,0,0,0,0
2,8476393,Nick Cousins,C,FLA,31,0,0,0,0
2,8483395,Arshdeep Bains,L,VAN,23,0,0,0,0
2,8480762,Eric Robinson,L,BUF,29,0,0,0,0
2,8479439,Jacob MacDonald,D,SJS,31,0,0,0,0
2,8476474,Stefan Noesen,R,CAR,31,0,0,0,0
2,8482787,Nikita Chibrikov,R,WPG,31,0,0,0,0
2,8478432,Christian Fischer,R,DET,27,0,0,0,0
2,8477979,Nicolas Aube-Kubel,R,WSH,28,0,0,0,0
2,8481789,Tye Kartye,L,SEA,23,0,0,0,0
2,8479330,Brandon Gignac,C,MTL,27,0,0,0,0
2,8480075,Cameron Crotty,D,ARI,25,0,0,0,0
2,8473473,Milan Lucic,L,BOS,36,0,0,0,0
2,8482094,Daemon Hunt,D,MIN,22,0,0,0,0
2,8481206,John Ludvig,D,PIT,24,0,0,0,0
2,8483630,Pavol Regenda,L,ANA,25,0,0,0,0
2,8481617,Vasily Podkolzin,R,VAN,23,0,0,0,0
2,8480306,Grant Hutton,D,NYI,29,0,0,0,0
2,8480995,Pontus Holmberg,R,TOR,25,0,0,0,0
2,8482148,Hendrix Lapierre,C,WSH,22,0,0,0,0
2,8477478,William Carrier,L,VGK,30,0,0,0,0
2,8480003,Jesper Boqvist,C,BOS,26,0,0,0,0
2,8482172,Landon Slaggert,L,CHI,22,0,0,0,0
2,8480789,Oliver Wahlstrom,R,NYI,24,0,0,0,0
2,8474062,Riley Nash,C,NYR,35,0,0,0,0
2,8480021,Jack Studnicka,C,SJS,25,0,0,0,0
2,8480025,MacKenzie Entwistle,R,CHI,25,0,0,0,0
2,8481582,Nicholas Robertson,L,TOR,23,0,0,0,0
2,8476867,Brendan Gaunce,C,CBJ,30,0,0,0,0
2,8479619,Michael Carcone,L,ARI,28,0,0,0,0
2,8479370,Tyson Jost,C,BUF,26,0,0,0,0
2,8479671,Mathieu Olivier,R,CBJ,27,0,0,0,0
2,8476994,Vinnie Hinostroza,C,PIT,30,0,0,0,0
2,8482070,Mitchell Chaffee,R,TBL,26,0,0,0,0
2,8477473,Justin Bailey,R,SJS,29,0,0,0,0
2,8479344,Jesse Puljujarvi,R,PIT,26,0,0,0,0
2,8480205,Emil Bemstrom,C,PIT,25,0,0,0,0
2,8479718,Alex Barré-Boulet,C,TBL,27,0,0,0,0
2,8482061,Brandon Biro,L,BUF,26,0,0,0,0
2,8479638,Justin Brazeau,R,BOS,26,0,0,0,0
2,8474040,Sam Gagner,C,EDM,35,0,0,0,0
2,8477846,Ryan Carpenter,C,SJS,33,0,0,0,0
2,8482077,Dylan Holloway,L,EDM,23,0,0,0,0
2,8482157,Will Cuylle,L,NYR,22,0,0,0,0
2,8480007,Jonas Rondbjerg,R,VGK,25,0,0,0,0
2,8478874,Adam Gaudette,C,STL,28,0,0,0,0
2,8478434,Keegan Kolesar,R,VGK,27,0,0,0,0
2,8480441,Trey Fix-Wolansky,R,CBJ,25,0,0,0,0
2,8479994,Jaret Anderson-Dolan,C,NSH,25,0,0,0,0
2,8483567,Georgii Merkulov,C,BOS,24,0,0,0,0
2,8477380,Jonny Brodzinski,C,NYR,31,0,0,0,0
2,8482201,Gage Goncalves,C,TBL,23,0,0,0,0
2,8478211,Dryden Hunt,L,CGY,29,0,0,0,0
2,8471699,Andrew Cogliano,C,COL,37,0,0,0,0
2,8479421,Jacob Moverare,D,LAK,26,0,0,0,0
2,8478881,Brett Seney,L,CHI,28,0,0,0,0
2,8477464,Nic Petan,C,MIN,29,0,0,0,0
2,8475958,Michael Sgarbossa,C,WSH,32,0,0,0,0
2,8481147,Reese Johnson,C,CHI,26,0,0,0,0
2,8479336,Carl Grundstrom,R,LAK,27,0,0,0,0
2,8480853,Liam Foudy,C,NSH,24,0,0,0,0
2,8479522,Hardy Haman Aktell,D,WSH,26,0,0,0,0
2,8481462,Mason Morelli,L,VGK,28,0,0,0,0
2,8482102,Vasily Ponomarev,C,CAR,22,0,0,0,0
2,8480844,Grigori Denisenko,L,VGK,24,0,0,0,0
2,8479944,Zach Aston-Reese,C,DET,30,0,0,0,0
2,8482784,Zach Dean,C,STL,21,0,0,0,0
2,8479419,Brett Murray,L,BUF,26,0,0,0,0
2,8479520,Brandon Duhaime,R,COL,27,0,0,0,0
2,8477573,Nathan Walker,L,STL,30,0,0,0,0
2,8478078,Rourke Chartier,C,OTT,28,0,0,0,0
2,8475795,Dylan McIlrath,D,WSH,32,0,0,0,0
2,8482496,Nils Aman,C,VAN,24,0,0,0,0
2,8480289,Morgan Barron,C,WPG,26,0,0,0,0
2,8481751,Lukas Rousek,R,BUF,25,0,0,0,0
2,8480011,Klim Kostin,C,SJS,25,0,0,0,0
2,8481556,John Beecher,C,BOS,23,0,0,0,0
2,8475278,Byron Froese,C,VGK,33,0,0,0,0
2,8475225,Craig Smith,C,DAL,35,0,0,0,0
2,8484326,Patrik Koch,D,ARI,28,0,0,0,0
2,8477930,Pierre-Edouard Bellemare,L,SEA,39,0,0,0,0
2,8478409,Anthony Richard,C,BOS,28,0,0,0,0
2,8481024,Linus Karlsson,C,VAN,25,0,0,0,0
2,8479986,Kole Lind,R,SEA,26,0,0,0,0
2,8479414,Nathan Bastian,R,NJD,27,0,0,0,0
2,8479362,Riley Tufte,L,COL,26,0,0,0,0
2,8481058,Jesse Ylönen,R,MTL,25,0,0,0,0
2,8482476,Emil Heineman,L,MTL,23,0,0,0,0
2,8482861,Vincent Iorio,D,WSH,22,0,0,0,0
2,8483432,Luca Del Bel Belluz,C,CBJ,31,0,0,0,0
2,8482744,James Malatesta,L,CBJ,21,0,0,0,0
2,8477887,Patrick Brown,C,BOS,32,0,0,0,0
2,8478585,Derek Ryan,C,EDM,38,0,0,0,0
2,8481441,Joe Snively,C,WSH,28,0,0,0,0
2,8481592,Jakob Pelletier,L,CGY,23,0,0,0,0
2,8482634,Alex Steeves,C,TOR,25,0,0,0,0
2,8477126,Jayson Megna,C,BOS,34,0,0,0,0
2,8475752,Tyler Pitlick,C,NYR,33,0,0,0,0
2,8480008,Adam Ruzicka,C,ARI,25,0,0,0,0
2,8481065,Angus Crookshank,L,OTT,25,0,0,0,0
2,8479547,Matthew Phillips,R,WSH,26,0,0,0,0
2,8480226,Marián Studenic,R,SEA,26,0,0,0,0
2,8481237,Kyle MacLean,C,NYI,25,0,0,0,0
2,8475413,Justin Dowling,C,NJD,34,0,0,0,0
2,8481641,Joel Kiviranta,L,COL,28,0,0,0,0
2,8478104,Sammy Blais,L,STL,28,0,0,0,0
2,8477454,Adam Erne,L,EDM,29,0,0,0,0
2,8481518,Nolan Foote,L,NJD,24,0,0,0,0
2,8480245,Olle Lycksell,R,PHI,25,0,0,0,0
2,8483570,Ben Meyers,C,ANA,26,0,0,0,0
2,8480776,Sheldon Rempal,R,VGK,29,0,0,0,0
2,8483920,Pierrick Dube,R,WSH,23,0,0,0,0
2,8480267,Sammy Walker,C,MIN,25,0,0,0,0
2,8482747,Brennan Othmann,L,NYR,21,0,0,0,0
2,8479991,Jake Leschyshyn,C,NYR,25,0,0,0,0
2,8478400,Colin White,C,MTL,27,0,0,0,0
2,8479328,Julien Gauthier,R,NYI,27,0,0,0,0
2,8484325,Waltteri Merela,C,TBL,26,0,0,0,0
2,8479066,Ryan Lomberg,L,FLA,30,0,0,0,0
2,8477070,Liam O'Brien,C,ARI,30,0,0,0,0
2,8478146,Matthew Highmore,C,OTT,28,0,0,0,0
2,8478028,Fredrik Olofsson,L,COL,28,0,0,0,0
2,8480880,Jakub Lauko,C,BOS,24,0,0,0,0
2,8479968,Vinni Lettieri,C,MIN,29,0,0,0,0
2,8474709,Matt Martin,L,NYI,35,0,0,0,0
2,8480845,Rasmus Kupari,C,WPG,24,0,0,0,0
2,8481550,Adam Beckman,L,MIN,23,0,0,0,0
2,8481422,Jacob Lucchini,C,MIN,29,0,0,0,0
2,8477401,John Hayden,C,SEA,29,0,0,0,0
2,8478904,Steven Lorentz,C,FLA,28,0,0,0,0
2,8482088,Justin Sourdif,R,FLA,22,0,0,0,0
2,8482751,Ryan Winterton,C,SEA,21,0,0,0,0
2,8482241,Radim Zohorna,L,PIT,28,0,0,0,0
2,8481690,Tyler Angle,C,CBJ,24,0,0,0,0
2,8476952,Dominic Toninato,C,WPG,30,0,0,0,0
2,8476919,Chris Tierney,C,NJD,30,0,0,0,0
2,8480032,Shane Bowers,C,NJD,25,0,0,0,0
2,8484314,Jiri Smejkal,L,OTT,28,0,0,0,0
2,8481239,Samuel Fagemo,L,LAK,24,0,0,0,0
2,8481532,Alex Turcotte,C,LAK,23,0,0,0,0
2,8481019,David Gustafsson,C,WPG,24,0,0,0,0
2,8478477,Mitchell Stephens,C,MTL,27,0,0,0,0
2,8479546,Oskar Steen,C,BOS,26,0,0,0,0
2,8480292,Carson Meyer,R,CBJ,27,0,0,0,0
2,8478446,Glenn Gawdin,C,ANA,27,0,0,0,0
2,8483531,Brian Halonen,L,NJD,25,0,0,0,0
2,8477149,Scott Sabourin,R,SJS,32,0,0,0,0
2,8479972,Mason Shaw,C,MIN,26,0,0,0,0
2,8480890,Jan Jenik,R,ARI,24,0,0,0,0
2,8478051,Max Willman,C,NJD,29,0,0,0,0
2,8480851,Akil Thomas,C,LAK,24,0,0,0,0
2,8482765,Isak Rosen,R,BUF,21,0,0,0,0
2,8478421,A.J. Greer,L,CGY,28,0,0,0,0
2,8478512,Austin Czarnik,C,DET,32,0,0,0,0
2,8479536,Axel Jonsson-Fjallby,L,WPG,26,0,0,0,0
2,8477320,Anton Blidh,L,NYR,29,0,0,0,0
2,8481543,Nikita Alexandrov,C,STL,24,0,0,0,0
2,8475235,Nicolas Deslauriers,L,PHI,33,0,0,0,0
2,8481070,Hugh McGing,L,STL,26,0,0,0,0
2,8480836,Jonathan Gruden,C,PIT,24,0,0,0,0
2,8481591,Sam Poulin,R,PIT,23,0,0,0,0
2,8477962,Brendan Lemieux,L,CAR,28,0,0,0,0
2,8483401,Marc Johnstone,R,PIT,28,0,0,0,0
2,8482250,Callahan Burke,C,CAR,27,0,0,0,0
2,8481726,Adam Edstrom,C,NYR,24,0,0,0,0
2,8471817,Ryan Reaves,R,TOR,37,0,0,0,0
2,8479587,Rhett Gardner,C,PHI,28,0,0,0,0
2,8475766,Austin Watson,L,TBL,32,0,0,0,0
2,8479367,William Lockwood,R,FLA,26,0,0,0,0
2,8478424,Jansen Harkins,C,PIT,27,0,0,0,0
2,8476913,Devin Shore,C,SEA,30,0,0,0,0
2,8482652,Walker Duehr,R,CGY,27,0,0,0,0
2,8477527,Ross Johnston,L,ANA,30,0,0,0,0
2,8481077,John Leonard,L,ARI,26,0,0,0,0
2,8483549,Lucas Condotta,L,MTL,27,0,0,0,0
2,8480468,James Hamblin,L,EDM,25,0,0,0,0
2,8476907,Mackenzie MacEachern,L,STL,30,0,0,0,0
2,8479543,Michael Pezzetta,L,MTL,26,0,0,0,0
2,8480355,Mark Kastelic,C,OTT,25,0,0,0,0
2,8482162,Roby Jarventie,L,OTT,22,0,0,0,0
2,8479772,Zack MacEwen,R,OTT,28,0,0,0,0
2,8483597,Milos Kelemen,L,ARI,25,0,0,0,0
2,8479379,Givani Smith,R,SJS,26,0,0,0,0
2,8481655,Cole Schwindt,R,CGY,23,0,0,0,0
2,8479981,Jonah Gadjovich,L,FLA,26,0,0,0,0
2,8482147,Jean-Luc Foudy,C,COL,22,0,0,0,0
2,8484255,Jason Polin,R,COL,25,0,0,0,0
2,8477993,Justin Kirkland,C,ARI,28,0,0,0,0
2,8479249,Andrew Poturalski,C,SEA,30,0,0,0,0
2,8482197,Adam Raska,R,MIN,23,0,0,0,0
2,8475780,Chris Wagner,R,COL,33,0,0,0,0
2,8479533,Joona Koppanen,L,PIT,26,0,0,0,0
2,8481534,Raphael Lavoie,C,EDM,24,0,0,0,0
2,8484321,Nikolas Matinpalo,D,OTT,26,0,0,0,0
2,8481043,Cole Koepke,L,TBL,26,0,0,0,0
2,8476323,Max McCormick,L,SEA,32,0,0,0,0
2,8483609,Adam Klapka,R,CGY,24,0,0,0,0
2,8483512,Matt Savoie,C,BUF,20,0,0,0,0
2,8484259,Ondrej Pavel,C,COL,31,0,0,0,0
2,8478147,Bokondji Imama,L,OTT,28,0,0,0,0
2,8482460,Matt Rempe,C,NYR,22,0,0,0,0
2,8477073,Kurtis MacDermid,L,NJD,30,0,0,0,0
2,8480274,Philip Kemp,D,EDM,25,0,0,0,0
2,8478956,Samuel Laberge,L,NJD,27,0,0,0,0
2,8483045,Cameron Butler,R,CBJ,31,0,0,0,0
3,8478402,Connor McDavid,C,EDM,27,82,41,97,138
3,8477492,Nathan MacKinnon,C,COL,29,82,46,82,128
3,8476453,Nikita Kucherov,R,TBL,31,82,27,88,115
3,8477956,David Pastrnak,R,BOS,28,82,41,69,110
3,8481559,Jack Hughes,C,NJD,23,82,46,63,109
3,8477934,Leon Draisaitl,C,EDM,29,82,32,72,104
3,8478550,Artemi Panarin,L,NYR,33,82,37,64,101
3,8479318,Auston Matthews,C,TOR,27,82,59,41,100
3,8477404,Jake Guentzel,C,CAR,30,82,38,61,99
3,8476887,Filip Forsberg,L,NSH,30,82,43,50,93
3,8479385,Jordan Kyrou,C,STL,26,82,38,55,93
3,8479314,Matthew Tkachuk,L,FLA,27,82,34,58,92
3,8474564,Steven Stamkos,C,TBL,34,82,46,45,91
3,8475786,Zach Hyman,L,EDM,32,82,56,34,90
3,8477939,William Nylander,R,TOR,28,82,41,49,90
3,8478420,Mikko Rantanen,R,COL,28,82,35,55,90
3,8476459,Mika Zibanejad,C,NYR,31,82,30,59,89
3,8480069,Cale Makar,D,COL,26,82,27,62,89
3,8480800,Quinn Hughes,D,VAN,25,82,11,78,89
3,8477946,Dylan Larkin,C,DET,28,82,33,55,88
3,8480023,Robert Thomas,C,STL,25,82,27,61,88
3,8478010,Brayden Point,C,TBL,28,82,40,45,85
3,8476468,J.T. Miller,C,VAN,31,82,26,59,85
3,8481523,Kirby Dach,C,MTL,23,82,15,70,85
3,8480027,Jason Robertson,L,DAL,25,82,31,53,84
3,8477942,Kevin Fiala,L,LAK,28,82,32,51,83
3,8475166,John Tavares,C,TOR,34,82,40,42,82
3,8480801,Brady Tkachuk,L,OTT,25,82,30,51,81
3,8474600,Roman Josi,D,NSH,34,82,21,59,80
3,8471675,Sidney Crosby,C,PIT,37,82,43,36,79
3,8478427,Sebastian Aho,C,CAR,27,82,29,50,79
3,8478403,Jack Eichel,C,VGK,28,82,34,44,78
3,8478445,Mathew Barzal,C,NYI,27,82,23,55,78
3,8478864,Kirill Kaprizov,L,MIN,27,82,40,37,77
3,8481557,Matt Boldy,L,MIN,23,82,35,42,77
3,8482116,Tim Stützle,C,OTT,22,82,30,47,77
3,8480012,Elias Pettersson,C,VAN,26,82,35,41,76
3,8475172,Nazem Kadri,C,CGY,34,82,33,43,76
3,8479323,Adam Fox,D,NYR,26,82,13,61,74
3,8476460,Mark Scheifele,C,WPG,31,82,32,41,73
3,8478042,Viktor Arvidsson,R,LAK,31,82,25,48,73
3,8480002,Nico Hischier,C,NJD,25,82,30,42,72
3,8478873,Troy Terry,R,ANA,27,82,25,47,72
3,8477501,Valeri Nichushkin,R,COL,29,82,38,33,71
3,8482109,Alexis Lafrenière,L,NYR,23,82,37,34,71
3,8480208,Drake Batherson,R,OTT,26,82,33,38,71
3,8477493,Aleksander Barkov,C,FLA,29,82,31,40,71
3,8473512,Claude Giroux,R,OTT,36,82,26,45,71
3,8482745,Mason McTavish,C,ANA,21,82,25,46,71
3,8471214,Alex Ovechkin,L,WSH,39,82,39,31,70
3,8477940,Nikolaj Ehlers,L,WPG,28,82,24,46,70
3,8479407,Jesper Bratt,L,NJD,26,82,23,47,70
3,8478398,Kyle Connor,L,WPG,28,82,28,41,69
3,8480830,Andrei Svechnikov,R,CAR,24,82,22,47,69
3,8476853,Morgan Rielly,D,TOR,30,82,11,58,69
3,8475184,Chris Kreider,L,NYR,33,82,50,18,68
3,8479337,Alex DeBrincat,R,DET,27,82,27,41,68
3,8477416,Oliver Bjorkstrand,R,SEA,29,82,26,42,68
3,8477949,Alex Tuch,R,BUF,28,82,24,44,68
3,8480839,Rasmus Dahlin,D,BUF,24,82,13,55,68
3,8479542,Brandon Hagel,L,TBL,26,82,30,37,67
3,8480865,Noah Dobson,D,NYI,24,82,10,57,67
3,8477955,Jared McCann,L,SEA,28,82,33,33,66
3,8475168,Matt Duchene,C,DAL,33,82,25,41,66
3,8477933,Sam Reinhart,C,FLA,29,82,33,32,65
3,8476346,Johnny Gaudreau,L,CBJ,31,82,20,45,65
3,8475784,Jeff Skinner,C,BUF,32,82,39,25,64
3,8478444,Brock Boeser,R,VAN,27,82,31,33,64
3,8477402,Pavel Buchnevich,L,STL,29,82,21,43,64
3,8479675,Trevor Moore,L,LAK,29,82,33,30,63
3,8478439,Travis Konecny,R,PHI,27,82,25,38,63
3,8475810,Bryan Rust,R,PIT,32,82,23,40,63
3,8478401,Pavel Zacha,C,BOS,27,82,20,43,63
3,8478440,Dylan Strome,C,WSH,27,82,19,44,63
3,8479420,Tage Thompson,C,BUF,27,82,30,32,62
3,8478519,Anthony Cirelli,C,TBL,27,82,27,35,62
3,8477479,Tyler Bertuzzi,L,TOR,29,82,21,41,62
3,8477935,Sam Bennett,C,FLA,28,82,30,31,61
3,8479343,Clayton Keller,R,ARI,26,82,21,40,61
3,8477504,Josh Morrissey,D,WPG,29,82,17,44,61
3,8475692,Mats Zuccarello,R,MIN,37,82,16,45,61
3,8474141,Patrick Kane,R,DET,36,82,14,47,61
3,8480039,Martin Necas,C,CAR,25,82,14,47,61
3,8476389,Vincent Trocheck,C,NYR,31,82,29,31,60
3,8477951,Nick Schmaltz,C,ARI,28,82,24,36,60
3,8475913,Mark Stone,R,VGK,32,82,19,41,60
3,8471685,Anze Kopitar,C,LAK,37,82,17,43,60
3,8481540,Cole Caufield,R,MTL,23,82,26,33,59
3,8477409,Carter Verhaeghe,C,FLA,29,82,23,36,59
3,8477496,Elias Lindholm,C,VAN,30,82,23,36,59
3,8482684,Luke Hughes,D,NJD,21,82,20,39,59
3,8475167,Victor Hedman,D,TBL,34,82,11,48,59
3,8482078,Lucas Raymond,L,DET,22,82,33,25,58
3,8480014,Gabriel Vilardi,C,WPG,25,82,33,25,58
3,8477960,Adrian Kempe,R,LAK,28,82,29,29,58
3,8479339,Patrik Laine,L,CBJ,26,82,24,34,58
3,8481528,Dylan Cozens,C,BUF,23,82,22,36,58
3,8477021,Alex Kerfoot,C,ARI,30,82,15,43,58
3,8480803,Evan Bouchard,D,EDM,25,82,14,44,58
3,8473994,Jamie Benn,L,DAL,35,82,25,32,57
3,8478493,Joel Eriksson Ek,C,MIN,27,82,24,33,57
3,8471218,Blake Wheeler,R,NYR,38,82,17,40,57
3,8476454,Ryan Nugent-Hopkins,C,EDM,31,82,16,41,57
3,8476875,Mike Matheson,D,MTL,30,82,16,41,57
3,8480036,Miro Heiskanen,D,DAL,25,82,9,48,57
3,8475169,Evander Kane,L,EDM,33,82,33,23,56
3,8482159,Tyson Foerster,R,PHI,22,82,25,31,56
3,8477500,Bo Horvat,C,NYI,29,82,23,33,56
3,8474102,David Perron,L,DET,36,82,23,33,56
3,8478407,Vince Dunn,D,SEA,28,82,14,42,56
3,8477503,Max Domi,C,TOR,29,82,14,42,56
3,8478449,Roope Hintz,C,DAL,28,82,32,23,55
3,8473419,Brad Marchand,L,BOS,36,82,23,32,55
3,8474150,Mikael Backlund,C,CGY,35,82,19,36,55
3,8481533,Trevor Zegras,C,ANA,23,82,16,39,55
3,8470794,Joe Pavelski,C,DAL,40,82,15,40,55
3,8476456,Jonathan Huberdeau,C,CGY,31,82,14,41,55
3,8477447,Shea Theodore,D,VGK,29,82,12,43,55
3,8475798,Mikael Granlund,C,SJS,32,82,7,48,55
3,8478498,Jake DeBrusk,L,BOS,28,82,34,20,54
3,8476881,Tomas Hertl,C,VGK,31,82,29,25,54
3,8481068,Yegor Sharangovich,C,CGY,26,82,23,31,54
3,8482097,Jack Quinn,R,BUF,23,82,22,32,54
3,8474578,Erik Karlsson,D,PIT,34,82,15,39,54
3,8476905,Chandler Stephenson,C,VGK,30,82,14,40,54
3,8478460,Zach Werenski,D,CBJ,27,82,11,43,54
3,8478414,Timo Meier,R,NJD,28,82,31,22,53
3,8475794,Tyler Seguin,C,DAL,32,82,24,29,53
3,8476882,Teuvo Teravainen,L,CAR,30,82,23,30,53
3,8479999,Casey Mittelstadt,C,COL,26,82,21,32,53
3,8479325,Charlie McAvoy,D,BOS,27,82,11,42,53
3,8482093,Seth Jarvis,C,CAR,22,82,26,26,52
3,8476399,Blake Coleman,C,CGY,33,82,26,26,52
3,8474157,Max Pacioretty,L,WSH,36,82,23,29,52
3,8477444,Andre Burakovsky,L,SEA,29,82,18,34,52
3,8474590,John Carlson,D,WSH,34,82,11,41,52
3,8475726,Tyler Toffoli,C,WPG,32,82,30,21,51
3,8475754,Brock Nelson,C,NYI,33,82,24,27,51
3,8480018,Nick Suzuki,C,MTL,25,82,22,29,51
3,8477998,Warren Foegele,L,EDM,28,82,21,30,51
3,8483808,Andrei Kuzmenko,L,CGY,28,82,20,31,51
3,8476826,Yanni Gourde,C,SEA,33,82,18,33,51
3,8477494,Jonathan Drouin,L,COL,29,82,18,33,51
3,8480798,Philipp Kurashev,C,CHI,25,82,16,35,51
3,8478366,Frank Vatrano,R,ANA,30,82,29,21,50
3,8476432,Boone Jenner,C,CBJ,31,82,26,24,50
3,8476539,Jonathan Marchessault,R,VGK,34,82,25,25,50
3,8476329,Travis Boyd,C,ARI,31,82,20,30,50
3,8478397,Rasmus Andersson,D,CGY,28,82,11,39,50
3,8476880,Tom Wilson,R,WSH,30,82,25,24,49
3,8475170,Brayden Schenn,C,STL,33,82,24,25,49
3,8482110,Dawson Mercer,C,NJD,23,82,22,27,49
3,8476479,Phillip Danault,C,LAK,31,82,18,31,49
3,8479400,Pierre-Luc Dubois,L,LAK,26,82,17,32,49
3,8477429,Andrew Copp,C,DET,30,82,15,34,49
3,8478975,Mason Marchment,L,DAL,29,82,14,35,49
3,8482665,Matty Beniers,C,SEA,22,82,12,37,49
3,8477451,Ryan Hartman,R,MIN,30,82,25,23,48
3,8482740,Wyatt Johnston,C,DAL,21,82,21,27,48
3,8476869,Brady Skjei,D,CAR,30,82,21,27,48
3,8479525,Ross Colton,C,COL,28,82,21,27,48
3,8481596,Shane Pinto,C,OTT,24,82,19,29,48
3,8475745,Charlie Coyle,C,BOS,32,82,18,30,48
3,8475744,Evgeny Kuznetsov,C,CAR,32,82,18,30,48
3,8474586,Jordan Eberle,R,SEA,34,82,16,32,48
3,8475791,Taylor Hall,L,CHI,33,82,16,32,48
3,8474679,Gustav Nyquist,C,NSH,35,82,15,33,48
3,8478469,Thomas Chabot,D,OTT,27,82,15,33,48
3,8478038,Devon Toews,D,COL,30,82,15,33,48
3,8481711,Matias Maccelli,L,ARI,24,82,14,34,48
3,8479410,Mikhail Sergachev,D,TBL,26,82,10,38,48
3,8477476,Artturi Lehkonen,L,COL,29,82,24,23,47
3,8480797,Joel Farabee,L,PHI,24,82,23,24,47
3,8482113,Anton Lundell,C,FLA,23,82,16,31,47
3,8480078,Filip Chytil,C,NYR,25,82,16,31,47
3,8477495,Seth Jones,D,CHI,30,82,10,37,47
3,8474037,James van Riemsdyk,L,BOS,35,82,21,25,46
3,8478466,Daniel Sprong,R,DET,27,82,20,26,46
3,8475793,Ryan Johansen,C,PHI,32,82,19,27,46
3,8482699,Dylan Guenther,R,ARI,21,82,17,29,46
3,8476448,William Karlsson,C,VGK,31,82,16,30,46
3,8479425,Filip Hronek,D,VAN,27,82,12,34,46
3,8476958,Jaccob Slavin,D,CAR,30,82,11,35,46
3,8474563,Drew Doughty,D,LAK,35,82,11,35,46
3,8475764,Cam Fowler,D,ANA,33,82,10,36,46
3,8477948,Travis Sanheim,D,PHI,28,82,10,36,46
3,8475314,Anders Lee,L,NYI,34,82,29,16,45
3,8473986,Alex Killorn,L,ANA,35,82,21,24,45
3,8471698,T.J. Oshie,R,WSH,38,82,21,24,45
3,8477407,Anthony Duclair,L,TBL,29,82,19,26,45
3,8474641,Adam Henrique,C,EDM,34,82,19,26,45
3,8482667,William Eklund,L,SJS,22,82,18,27,45
3,8484144,Connor Bedard,C,CHI,19,82,16,29,45
3,8475287,Erik Haula,L,NJD,33,82,13,32,45
3,8478047,Michael Bunting,L,PIT,29,82,12,33,45
3,8483471,Brad Lambert,C,WPG,31,82,3,42,45
3,8475151,Kyle Palmieri,C,NYI,33,82,21,23,44
3,8481581,Thomas Harley,D,DAL,23,82,14,30,44
3,8470613,Brent Burns,D,CAR,39,82,14,30,44
3,8480031,Maxime Comtois,L,CAR,25,82,8,36,44
3,8475753,Justin Faulk,D,STL,32,82,8,36,44
3,8480459,Pius Suter,C,VAN,28,82,21,22,43
3,8476923,Damon Severson,D,CBJ,30,82,12,31,43
3,8482124,Quinton Byfield,R,LAK,22,82,11,32,43
3,8478472,Mathieu Joseph,R,OTT,27,82,10,33,43
3,8477426,Nicholas Paul,L,TBL,29,82,22,20,42
3,8480188,Fabian Zetterlund,L,SJS,25,82,21,21,42
3,8476483,Rickard Rakell,R,PIT,31,82,19,23,42
3,8477989,Christian Dvorak,C,MTL,28,82,19,23,42
3,8478542,Evan Rodrigues,C,FLA,31,82,16,26,42
3,8477952,Robby Fabbri,C,DET,28,82,13,29,42
3,8476462,Dougie Hamilton,D,NJD,31,82,8,34,42
3,8480015,Owen Tippett,R,PHI,25,82,22,19,41
3,8476960,Andreas Athanasiou,C,CHI,30,82,17,24,41
3,8478046,Danton Heinen,L,BOS,29,82,16,25,41
3,8476872,Scott Laughton,C,PHI,30,82,14,27,41
3,8482222,Alexander Barabanov,L,SJS,30,82,13,28,41
3,8479345,Jakob Chychrun,D,OTT,26,82,12,29,41
3,8476906,Shayne Gostisbehere,D,DET,31,82,12,29,41
3,8471724,Kris Letang,D,PIT,37,82,9,32,41
3,8480064,Josh Norris,C,OTT,25,82,23,17,40
3,8475722,Jason Zucker,L,NSH,32,82,22,18,40
3,8476392,Adam Lowry,C,WPG,31,82,19,21,40
3,8483515,Juraj Slafkovsky,L,MTL,20,82,16,24,40
3,8474053,Logan Couture,C,SJS,35,82,15,25,40
3,8475197,Tyson Barrie,D,NSH,33,82,10,30,40
3,8475906,John Klingberg,D,TOR,32,82,3,37,40
3,8483524,Shane Wright,C,SEA,20,82,28,11,39
3,8480849,Barrett Hayton,C,ARI,24,82,23,16,39
3,8478233,Andrew Mangiapane,L,CGY,28,82,21,18,39
3,8475799,Nino Niederreiter,R,WPG,32,82,20,19,39
3,8482175,JJ Peterka,R,BUF,22,82,20,19,39
3,8479977,Kailer Yamamoto,R,SEA,26,82,19,20,39
3,8476461,Sean Couturier,C,PHI,32,82,18,21,39
3,8482705,Cole Sillinger,C,CBJ,21,82,17,22,39
3,8478891,Mason Appleton,C,WPG,28,82,15,24,39
3,8476438,Brandon Saad,L,STL,32,82,15,24,39
3,8475218,Mattias Ekholm,D,EDM,34,82,13,26,39
3,8477964,Ivan Barbashev,C,VGK,29,82,12,27,39
3,8475765,Vladimir Tarasenko,R,FLA,33,82,9,30,39
3,8475760,Nick Bjugstad,C,ARI,32,82,27,11,38
3,8473533,Jordan Staal,C,CAR,36,82,18,20,38
3,8471215,Evgeni Malkin,C,PIT,38,82,17,21,38
3,8480009,Eeli Tolvanen,R,SEA,25,82,17,21,38
3,8475768,Jaden Schwartz,C,SEA,32,82,16,22,38
3,8482092,Ridly Greig,C,OTT,22,82,15,23,38
3,8477932,Aaron Ekblad,D,FLA,28,82,14,24,38
3,8477346,MacKenzie Weegar,D,CGY,30,82,10,28,38
3,8478911,Matt Roy,D,LAK,29,82,10,28,38
3,8476927,Teddy Blueger,C,VAN,30,82,8,30,38
3,8480434,Sean Durzi,D,ARI,26,82,6,32,38
3,8481703,Valtteri Puustinen,R,PIT,25,82,6,32,38
3,8474870,Tyler Johnson,C,CHI,34,82,21,16,37
3,8475158,Ryan O'Reilly,C,NSH,33,82,19,18,37
3,8482133,Thomas Bordeleau,C,SJS,22,82,19,18,37
3,8481624,Ilya Mikheyev,R,VAN,30,82,19,18,37
3,8481618,Alex Newhook,C,MTL,23,82,18,19,37
3,8478856,Conor Garland,R,VAN,28,82,17,20,37
3,8480028,Morgan Frost,C,PHI,25,82,17,20,37
3,8476792,Torey Krug,D,STL,33,82,9,28,37
3,8482105,Jake Sanderson,D,OTT,22,82,9,28,37
3,8481699,Aku Raty,R,ARI,23,82,5,32,37
3,8480893,Kirill Marchenko,R,CBJ,24,82,21,15,36
3,8476292,Ondrej Palat,L,NJD,33,82,20,16,36
3,8470610,Zach Parise,L,COL,40,82,20,16,36
3,8479365,Trent Frederic,C,BOS,26,82,19,17,36
3,8475191,Reilly Smith,R,PIT,33,82,18,18,36
3,8477947,Sonny Milano,L,WSH,28,82,18,18,36
3,8483431,Logan Cooley,C,ARI,20,82,17,19,36
3,8481560,Arthur Kaliyev,R,LAK,23,82,17,19,36
3,8477456,J.T. Compher,L,DET,29,82,16,20,36
3,8477511,Anthony Mantha,R,VGK,30,82,14,22,36
3,8482475,Yegor Chinakhov,R,CBJ,23,82,14,22,36
3,8477497,Sean Monahan,C,WPG,30,82,12,24,36
3,8482720,Matthew Knies,L,TOR,22,82,11,25,36
3,8480145,Neal Pionk,D,WPG,29,82,8,28,36
3,8483445,Cutter Gauthier,L,ANA,20,82,7,29,36
3,8476374,Sean Kuraly,C,CBJ,31,82,15,20,35
3,8476458,Ryan Strome,C,ANA,31,82,14,21,35
3,8483499,Liam Ohgren,L,MIN,20,82,13,22,35
3,8482055,Drew O'Connor,L,PIT,26,82,10,25,35
3,8478462,Nicolas Roy,C,VGK,27,82,9,26,35
3,8482142,Jamie Drysdale,D,PHI,22,82,7,28,35
3,8479398,Samuel Girard,D,COL,26,82,7,28,35
3,8481542,Moritz Seider,D,DET,23,82,6,29,35
3,8483397,Marc McLaughlin,C,BOS,25,82,29,5,34
3,8476480,Vladislav Namestnikov,C,WPG,32,82,15,19,34
3,8482079,Marco Rossi,C,MIN,23,82,15,19,34
3,8476892,Colton Parayko,D,STL,31,82,12,22,34
3,8478115,Pierre Engvall,L,NYI,28,82,12,22,34
3,8477498,Darnell Nurse,D,EDM,29,82,12,22,34
3,8479351,Sam Steel,C,DAL,26,82,12,22,34
3,8482146,Luke Evangelista,R,NSH,22,82,10,24,34
3,8480871,Adam Boqvist,D,CBJ,24,82,4,30,34
3,8475714,Calle Jarnkrok,C,TOR,33,82,18,15,33
3,8476419,Jean-Gabriel Pageau,C,NYI,32,82,17,16,33
3,8478413,Jordan Greenway,L,BUF,27,82,16,17,33
3,8480068,Ryan Poehling,C,PHI,25,82,13,20,33
3,8479359,Beck Malenstyn,L,WSH,26,82,13,20,33
3,8478438,Tommy Novak,C,NSH,27,82,10,23,33
3,8480220,Noah Cates,L,PHI,25,82,10,23,33
3,8474565,Alex Pietrangelo,D,VGK,34,82,9,24,33
3,8479987,Morgan Geekie,C,BOS,26,82,9,24,33
3,8481546,Cam York,D,PHI,23,82,8,25,33
3,8476885,Jacob Trouba,D,NYR,30,82,7,26,33
3,8482122,Brock Faber,D,MIN,22,82,6,27,33
3,8476463,Jonas Brodin,D,MIN,31,82,6,27,33
3,8478474,Lawson Crouse,L,ARI,27,82,20,12,32
3,8474884,Mike Hoffman,C,SJS,35,82,17,15,32
3,8481093,Rafael Harvey-Pinard,L,MTL,25,82,16,16,32
3,8478463,Anthony Beauvillier,L,NSH,27,82,15,17,32
3,8481554,Kaapo Kakko,R,NYR,23,82,15,17,32
3,8481580,Connor McMichael,C,WSH,23,82,15,17,32
3,8482671,Owen Power,D,BUF,22,82,8,24,32
3,8476854,Hampus Lindholm,D,BOS,30,82,6,26,32
3,8483457,Lane Hutson,D,MTL,20,82,6,26,32
3,8480043,Timothy Liljegren,D,TOR,25,82,6,26,32
3,8482702,Logan Stankoven,C,DAL,21,82,19,12,31
3,8476871,Tanner Pearson,L,MTL,32,82,17,14,31
3,8477919,Frederick Gaudreau,C,MIN,31,82,12,19,31
3,8479346,Dillon Dube,C,CGY,26,82,11,20,31
3,8478055,Gustav Forsling,D,FLA,28,82,10,21,31
3,8482073,Braden Schneider,D,NYR,23,82,7,24,31
3,8478500,Ivan Provorov,D,CBJ,27,82,6,25,31
3,8482101,Danil Gushchin,L,SJS,22,82,20,10,30
3,8479390,Taylor Raddysh,R,CHI,26,82,18,12,30
3,8478057,Dakota Joshua,C,VAN,28,82,15,15,30
3,8479941,Justin Danforth,R,CBJ,31,82,15,15,30
3,8478396,Noah Hanifin,D,VGK,27,82,11,19,30
3,8473422,Nick Foligno,L,CHI,37,82,11,19,30
3,8480113,Alex Iafallo,L,WPG,31,82,11,19,30
3,8480802,Ryan McLeod,C,EDM,25,82,10,20,30
3,8476897,Oskar Sundqvist,C,STL,30,82,9,21,30
3,8477450,Jason Dickinson,C,CHI,29,82,8,22,30
3,8482118,Sam Colangelo,R,ANA,23,82,22,7,29
3,8482089,Jake Neighbours,L,STL,22,82,20,9,29
3,8474189,Lars Eller,C,PIT,35,82,15,14,29
3,8477506,Ryan Pulock,D,NYI,30,82,12,17,29
3,8479316,Luke Kunin,C,SJS,27,82,11,18,29
3,8479415,Michael McLeod,C,NJD,26,82,11,18,29
3,8478416,Erik Cernak,D,TBL,27,82,11,18,29
3,8480185,Eetu Luostarinen,C,FLA,26,82,10,19,29
3,8477435,Ryan Graves,D,PIT,29,82,10,19,29
3,8480336,Sean Walker,D,COL,30,82,9,20,29
3,8481656,Aliaksei Protas,C,WSH,23,82,9,20,29
3,8474673,TJ Brodie,D,TOR,34,82,6,23,29
3,8478840,Will Borgen,D,SEA,28,82,6,23,29
3,8478882,Vladislav Gavrikov,D,LAK,29,82,5,24,29
3,8482733,Logan Mailloux,D,MTL,31,82,4,25,29
3,8477944,Jakub Vrana,L,STL,28,82,17,11,28
3,8478020,Michael Amadio,C,VGK,28,82,16,12,28
3,8478013,Jake Walman,D,DET,28,82,15,13,28
3,8482259,Bobby McMann,C,TOR,28,82,14,14,28
3,8481028,Martin Pospisil,C,CGY,25,82,12,16,28
3,8470621,Corey Perry,R,EDM,39,82,11,17,28
3,8482624,Daniil Miromanov,D,CGY,27,82,11,17,28
3,8479996,Cody Glass,C,NSH,25,82,10,18,28
3,8476921,Jordan Martinook,L,CAR,32,82,10,18,28
3,8482117,Lukas Reichel,L,CHI,22,82,9,19,28
3,8477986,Brandon Montour,D,FLA,30,82,7,21,28
3,8475171,Oliver Ekman-Larsson,D,FLA,33,82,6,22,28
3,8474716,Jared Spurgeon,D,MIN,35,82,6,22,28
3,8476979,Erik Gustafsson,D,NYR,32,82,5,23,28
3,8479514,Rem Pitlick,C,CHI,27,82,5,23,28
3,8479998,Mikey Anderson,D,LAK,25,82,5,23,28
3,8475181,Nick Leddy,D,STL,33,82,4,24,28
3,8476981,Josh Anderson,R,MTL,30,82,17,10,27
3,8484166,Adam Fantilli,C,CBJ,20,82,13,14,27
3,8479992,Michael Rasmussen,C,DET,25,82,13,14,27
3,8470604,Jeff Carter,C,PIT,39,82,13,14,27
3,8482155,Alex Laferriere,R,LAK,23,82,12,15,27
3,8478458,Jack Roslovic,C,NYR,27,82,11,16,27
3,8481186,Logan O'Connor,R,COL,28,82,11,16,27
3,8474149,Evgenii Dadonov,R,DAL,35,82,10,17,27
3,8478133,Jake Evans,C,MTL,28,82,10,17,27
3,8480817,K'Andre Miller,D,NYR,24,82,9,18,27
3,8482062,Cole Smith,L,NSH,29,82,8,19,27
3,8483466,Kevin Korchinski,D,CHI,20,82,5,22,27
3,8474574,Tyler Myers,D,VAN,34,82,5,22,27
3,8483493,Frank Nazar,C,CHI,20,82,21,5,26
3,8482125,Alexander Holtz,R,NJD,22,82,17,9,26
3,8480074,Alexandre Texier,C,CBJ,25,82,14,12,26
3,8481535,Nils Hoglander,L,VAN,24,82,13,13,26
3,8477507,Nikita Zadorov,D,VAN,29,82,12,14,26
3,8481013,Jonatan Berggren,R,DET,24,82,11,15,26
3,8481606,Jordan Spence,D,LAK,23,82,10,16,26
3,8480813,Joe Veleno,C,DET,24,82,10,16,26
3,8473563,Nicklas Backstrom,C,WSH,37,82,9,17,26
3,8477220,Nate Schmidt,D,WPG,33,82,8,18,26
3,8480873,Rasmus Sandin,D,WSH,24,82,5,21,26
3,8475324,Nick Jensen,D,WSH,34,82,3,23,26
3,8479423,Alex Nylander,L,CBJ,26,82,16,9,25
3,8476278,Colin Blackwell,C,CHI,31,82,15,10,25
3,8481604,Pavel Dorofeyev,L,VGK,24,82,15,10,25
3,8476925,Colton Sissons,C,NSH,31,82,14,11,25
3,8475343,Nic Dowd,C,WSH,34,82,12,13,25
3,8478831,Kevin Stenlund,C,FLA,28,82,11,14,25
3,8481517,Brett Leason,R,ANA,25,82,10,15,25
3,8483505,Matthew Poitras,C,BOS,20,82,10,15,25
3,8480980,Connor Dewar,C,TOR,25,82,10,15,25
3,8483482,Tristan Luneau,D,ANA,20,82,9,16,25
3,8477839,Conor Sheary,L,TBL,32,82,8,17,25
3,8477392,Hudson Fasching,R,NYI,29,82,8,17,25
3,8481016,Ruslan Iskhakov,C,NYI,24,82,5,20,25
3,8481524,Bowen Byram,D,BUF,23,82,4,21,25
3,8477969,Marcus Pettersson,D,PIT,28,82,3,22,25
3,8476879,Cody Ceci,D,EDM,31,82,3,22,25
3,8475790,Erik Gudbranson,D,CBJ,32,82,3,22,25
3,8470966,Mark Giordano,D,TOR,41,82,3,22,25
3,8477845,Trevor van Riemsdyk,D,WSH,33,82,2,23,25
3,8479393,Noah Gregor,C,TOR,26,82,16,8,24
3,8474715,Cam Atkinson,R,PHI,35,82,15,9,24
3,8482145,Mavrik Bourque,C,DAL,22,82,14,10,24
3,8479293,Brandon Tanev,L,SEA,33,82,12,12,24
3,8481481,Blake Lizotte,C,LAK,27,82,11,13,24
3,8481704,Juuso Parssinen,C,NSH,23,82,9,15,24
3,8475763,Kevin Hayes,R,STL,32,82,9,15,24
3,8475149,Marcus Johansson,L,MIN,34,82,6,18,24
3,8476467,Jamie Oleksiak,D,SEA,32,82,6,18,24
3,8482655,J.J. Moser,D,ARI,24,82,4,20,24
3,8483490,Pavel Mintyukov,D,ANA,21,82,3,21,24
3,8476331,Dylan DeMelo,D,WPG,31,82,2,22,24
3,8482245,Artem Zub,D,OTT,29,82,2,22,24
3,8479369,Andrew Peeke,D,BOS,26,82,1,23,24
3,8478043,Sam Lafferty,C,VAN,29,82,15,8,23
3,8480855,Jack McBain,C,ARI,24,82,14,9,23
3,8477330,Dominik Kubalik,L,OTT,29,82,13,10,23
3,8483491,Ivan Miroshnichenko,L,WSH,20,82,13,10,23
3,8475848,Brendan Gallagher,R,MTL,32,82,12,11,23
3,8475164,Jakob Silfverberg,R,ANA,34,82,12,11,23
3,8474009,Nick Bonino,C,NYR,36,82,10,13,23
3,8478430,Oliver Kylington,D,CGY,27,82,8,15,23
3,8484145,Zach Benson,L,BUF,19,82,8,15,23
3,8478851,Alexandre Carrier,D,NSH,28,82,6,17,23
3,8477488,Brett Pesce,D,CAR,30,82,6,17,23
3,8480796,Martin Fehervary,D,WSH,25,82,6,17,23
3,8482470,Ilya Solovyov,D,CGY,24,82,5,18,23
3,8479976,Juuso Valimaki,D,ARI,26,82,4,19,23
3,8482087,Kaiden Guhle,D,MTL,22,82,4,19,23
3,8476312,Josh Manson,D,COL,33,82,3,20,23
3,8473507,Jeff Petry,D,DET,37,82,3,20,23
3,8477953,Kasperi Kapanen,R,STL,28,82,11,11,22
3,8479661,Tanner Jeannot,L,TBL,27,82,11,11,22
3,8476873,Mark Jankowski,C,NSH,30,82,10,12,22
3,8478109,Victor Olofsson,L,BUF,29,82,10,12,22
3,8476878,Zemgus Girgensons,L,BUF,30,82,9,13,22
3,8482730,Brandt Clarke,D,LAK,21,82,7,15,22
3,8476457,Adam Larsson,D,SEA,32,82,6,16,22
3,8479983,Mario Ferraro,D,SJS,26,82,6,16,22
3,8475220,Marcus Foligno,L,MIN,33,82,5,17,22
3,8477499,Rasmus Ristolainen,D,PHI,30,82,4,18,22
3,8481568,Alex Vlasic,D,CHI,23,82,4,18,22
3,8474034,Pat Maroon,L,BOS,36,82,4,18,22
3,8476917,Adam Pelech,D,NYI,30,82,3,19,22
3,8480246,Nick Perbix,D,TBL,26,82,2,20,22
3,8479353,Brett Howden,C,VGK,26,82,14,7,21
3,8479383,Boris Katchouk,L,OTT,26,82,13,8,21
3,8480821,Filip Zadina,R,SJS,25,82,11,10,21
3,8482666,Scott Morrow,D,CAR,22,82,11,10,21
3,8482737,Zack Bolduc,C,STL,21,82,10,11,21
3,8475231,Casey Cizikas,C,NYI,33,82,10,11,21
3,8482074,Connor Zary,C,CGY,23,82,10,11,21
3,8477353,Tyler Motte,C,TBL,29,82,10,11,21
3,8481601,Simon Holmstrom,R,NYI,23,82,9,12,21
3,8478508,Yakov Trenin,C,COL,27,82,9,12,21
3,8480806,Isac Lundestrom,C,ANA,25,82,9,12,21
3,8482679,Matt Coronato,R,CGY,22,82,9,12,21
3,8481014,Alexander Romanov,D,NYI,24,82,5,16,21
3,8480834,Ty Emberson,D,SJS,24,82,5,16,21
3,8476422,Mike Reilly,D,NYI,31,82,5,16,21
3,8477505,Alexander Wennberg,C,NYR,30,82,5,16,21
3,8474166,Alec Martinez,D,VGK,37,82,3,18,21
3,8481567,Henry Thrun,D,SJS,23,82,3,18,21
3,8481605,Jackson LaCombe,D,ANA,23,82,2,19,21
3,8484203,Bradly Nadeau,L,CAR,19,82,15,5,20
3,8480144,David Kampf,C,TOR,29,82,7,13,20
3,8479371,Dante Fabbro,D,NSH,26,82,6,14,20
3,8483565,Nick Blankenburg,D,CBJ,26,82,6,14,20
3,8484911,Collin Graf,R,SJS,22,82,6,14,20
3,8480058,Pierre-Olivier Joseph,D,PIT,25,82,5,15,20
3,8475690,Chris Tanev,D,DAL,35,82,5,15,20
3,8475188,Brayden McNabb,D,VGK,33,82,4,16,20
3,8476372,Nick Seeler,D,PHI,31,82,4,16,20
3,8481522,Peyton Krebs,C,BUF,23,82,3,17,20
3,8475462,Radko Gudas,D,ANA,34,82,3,17,20
3,8476891,Matt Grzelcyk,D,BOS,30,82,2,18,20
3,8483495,Simon Nemec,D,NJD,20,82,2,18,20
3,8478399,Jonas Siegenthaler,D,NJD,27,82,1,19,20
3,8477365,Connor Clifton,D,BUF,29,82,1,19,20
3,8475233,David Savard,D,MTL,34,82,0,20,20
3,8482809,Jackson Blake,R,CAR,21,82,11,8,19
3,8480281,Alexey Toropchenko,R,STL,25,82,11,8,19
3,8478569,Noel Acciari,C,PIT,33,82,11,8,19
3,8478408,Travis Dermott,D,ARI,28,82,10,9,19
3,8484153,Leo Carlsson,C,ANA,20,82,8,11,19
3,8476473,Connor Murphy,D,CHI,31,82,7,12,19
3,8482803,Olen Zellweger,D,ANA,21,82,7,12,19
3,8477931,Tomas Nosek,L,NJD,32,82,6,13,19
3,8478136,Jake Middleton,D,MIN,28,82,5,14,19
3,8477508,Curtis Lazar,C,NJD,29,82,5,14,19
3,8483763,Maksymilian Szuber,D,ARI,22,82,3,16,19
3,8478451,Ethan Bear,D,WSH,27,82,2,17,19
3,8476967,Brett Kulak,D,EDM,30,82,1,18,19
3,8476442,Matt Nieto,L,PIT,32,82,11,7,18
3,8480448,Parker Kelly,L,OTT,25,82,10,8,18
3,8479591,Michael Eyssimont,C,TBL,28,82,10,8,18
3,8475200,Dmitry Orlov,D,CAR,33,82,6,12,18
3,8476931,Jake McCabe,D,TOR,31,82,5,13,18
3,8481178,Egor Zamula,D,PHI,24,82,4,14,18
3,8474151,Ryan McDonagh,D,NSH,35,82,3,15,18
3,8479324,Ryan Lindgren,D,NYR,26,82,3,15,18
3,8476902,Esa Lindell,D,DAL,30,82,2,16,18
3,8475455,Brenden Dillon,D,WPG,34,82,1,17,18
3,8482111,Justin Barron,D,MTL,23,82,12,5,17
3,8481477,Nico Sturm,C,SJS,29,82,9,8,17
3,8477015,Connor Brown,R,EDM,30,82,9,8,17
3,8474013,Ian Cole,D,VAN,35,82,6,11,17
3,8480035,Henri Jokiharju,D,BUF,25,82,5,12,17
3,8476525,Colin Miller,D,WPG,32,82,5,12,17
3,8479980,Nicolas Hague,D,VGK,26,82,5,12,17
3,8477369,Carson Soucy,D,VAN,30,82,5,12,17
3,8481537,Nikita Okhotiuk,D,CGY,24,82,4,13,17
3,8481553,Bobby Brink,R,PHI,23,82,4,13,17
3,8478507,John Marino,D,NJD,27,82,3,14,17
3,8478178,Darren Raddysh,D,TBL,28,82,2,15,17
3,8475208,Brian Dumoulin,D,SEA,33,82,2,15,17
3,8480807,Mattias Samuelsson,D,BUF,24,82,1,16,17
3,8480073,Erik Brannstrom,D,OTT,25,82,1,16,17
3,8477406,Mattias Janmark,C,EDM,32,82,9,7,16
3,8473449,Kyle Okposo,R,FLA,36,82,8,8,16
3,8476858,Phillip Di Giuseppe,L,VAN,31,82,8,8,16
3,8477425,Miles Wood,L,COL,29,82,7,9,16
3,8475279,Ben Chiarot,D,DET,33,82,5,11,16
3,8479442,Troy Stecher,D,EDM,30,82,4,12,16
3,8475179,Dmitry Kulikov,D,FLA,34,82,3,13,16
3,8478859,Niko Mikkola,D,FLA,28,82,1,15,16
3,8473453,Trevor Lewis,C,LAK,37,82,12,3,15
3,8476469,Joel Armia,R,MTL,31,82,7,8,15
3,8473504,Cal Clutterbuck,R,NYI,37,82,7,8,15
3,8479291,Kevin Rooney,C,CGY,31,82,6,9,15
3,8480172,Jan Rutta,D,SJS,34,82,5,10,15
3,8482166,Shakir Mukhamadullin,D,SJS,22,82,5,10,15
3,8474567,Zach Bogosian,D,MIN,34,82,4,11,15
3,8482712,Oskar Olausson,R,COL,22,82,3,12,15
3,8477034,Jaycob Megna,D,CHI,32,82,2,13,15
3,8483012,Logan Morrison,C,SEA,22,82,6,8,14
3,8476624,Barclay Goodrow,C,NYR,31,82,5,9,14
3,8478443,Brandon Carlo,D,BOS,28,82,4,10,14
3,8482516,Matthew Kessel,D,STL,24,82,3,11,14
3,8481599,Victor Soderstrom,D,ARI,23,82,3,11,14
3,8477335,Kyle Burroughs,D,SJS,29,82,1,13,14
3,8483489,Fraser Minten,C,TOR,31,82,8,5,13
3,8478468,Jeremy Lauzon,D,NSH,27,82,6,7,13
3,8475762,Derek Forbort,D,BOS,32,82,4,9,13
3,8480879,Jacob Bernard-Docker,D,OTT,24,82,3,10,13
3,8482858,Ryker Evans,D,SEA,23,82,3,9,12
3,8476429,Scott Mayfield,D,NYI,32,82,2,10,12
3,8475825,Jani Hakanpää,D,DAL,32,82,2,10,12
3,8483468,Jiri Kulich,C,BUF,20,82,5,6,11
3,8482807,Ethan Del Mastro,D,CHI,21,82,4,7,11
3,8484149,Gavin Brindley,C,CBJ,20,82,3,8,11
3,8475177,Calvin de Haan,D,TBL,33,82,1,10,11
3,8476915,Jujhar Khaira,L,MIN,30,82,8,2,10
3,8480990,Declan Chisholm,D,MIN,24,82,4,6,10
3,8481030,Jack St. Ivany,D,PIT,25,82,3,7,10
3,8470600,Ryan Suter,D,DAL,39,82,1,9,10
3,8476822,Luke Glendening,C,TBL,35,82,4,5,9
3,8482177,Marat Khusnutdinov,C,MIN,22,82,2,7,9
3,8481059,Scott Perunovich,D,STL,26,82,1,8,9
3,8475842,Sam Carrick,C,EDM,32,82,6,2,8
3,8482762,Simon Edvinsson,D,DET,21,82,3,5,8
3,8482859,Zack Ostapchuk,C,OTT,21,82,3,5,8
3,8480860,Kevin Bahl,D,NJD,24,82,1,7,8
3,8481578,Graeme Clarke,R,NJD,23,82,2,5,7
3,8471677,Jack Johnson,D,COL,37,82,1,6,7
3,8482713,Mackie Samoskevich,R,FLA,22,82,2,3,5
3,8482141,Lukas Cormier,D,VGK,22,0,0,0,0
3,8476988,Matt Benning,D,SJS,30,0,0,0,0
3,8480727,Zach Whitecloud,D,VGK,28,0,0,0,0
3,8480887,Jordan Harris,D,MTL,24,0,0,0,0
3,8478450,Parker Wotherspoon,D,BOS,27,0,0,0,0
3,8481812,Nikolai Knyzhov,D,SJS,27,0,0,0,0
3,8480001,Urho Vaakanainen,D,ANA,25,0,0,0,0
3,8482176,Wyatt Kaiser,D,CHI,22,0,0,0,0
3,8481122,Simon Benoit,D,TOR,26,0,0,0,0
3,8476441,Joel Edmundson,D,TOR,31,0,0,0,0
3,8480884,Calen Addison,D,SJS,24,0,0,0,0
3,8482511,Mason Lohrei,D,BOS,23,0,0,0,0
3,8482192,Isaak Phillips,D,CHI,23,0,0,0,0
3,8480950,Ilya Lyubushkin,D,TOR,30,0,0,0,0
3,8474031,Kevin Shattenkirk,D,BOS,35,0,0,0,0
3,8475718,Justin Holl,D,DET,32,0,0,0,0
3,8479402,Jake Bean,D,CBJ,26,0,0,0,0
3,8474602,Justin Schultz,D,SEA,34,0,0,0,0
3,8477950,Tony DeAngelo,D,CAR,29,0,0,0,0
3,8481743,Marc Del Gaizo,D,NSH,25,0,0,0,0
3,8481527,Kaedan Korczak,D,VGK,23,0,0,0,0
3,8480192,Johnathan Kovacevic,D,MTL,27,0,0,0,0
3,8476874,Olli Maatta,D,DET,30,0,0,0,0
3,8482144,Jack Thompson,D,SJS,22,0,0,0,0
3,8480222,Sebastian Aho,D,NYI,28,0,0,0,0
3,8479458,Nikita Zaitsev,D,CHI,33,0,0,0,0
3,8471709,Marc-Edouard Vlasic,D,SJS,37,0,0,0,0
3,8482929,Emil Lilleberg,D,TBL,23,0,0,0,0
3,8477018,Ben Hutton,D,VGK,31,0,0,0,0
3,8481056,Spencer Stastney,D,NSH,24,0,0,0,0
3,8481593,Jayden Struble,D,MTL,23,0,0,0,0
3,8479982,Conor Timmins,D,TOR,26,0,0,0,0
3,8474090,Brendan Smith,D,NJD,35,0,0,0,0
3,8482964,Arber Xhekaj,D,MTL,23,0,0,0,0
3,8480891,Michael Kesselring,D,ARI,24,0,0,0,0
3,8477938,Haydn Fleury,D,TBL,28,0,0,0,0
3,8481806,Louis Crevier,D,CHI,23,0,0,0,0
3,8471274,Alex Goligoski,D,MIN,39,0,0,0,0
3,8481600,Tobias Bjornfot,D,FLA,23,0,0,0,0
3,8475797,Jarred Tinordi,D,CHI,32,0,0,0,0
3,8481521,Ronnie Attard,D,PHI,25,0,0,0,0
3,8474612,Travis Hamonic,D,OTT,34,0,0,0,0
3,8479576,Vincent Desharnais,D,EDM,28,0,0,0,0
3,8480049,Dylan Samberg,D,WPG,25,0,0,0,0
3,8483619,Filip Roos,D,CHI,25,0,0,0,0
3,8474568,Luke Schenn,D,NSH,35,0,0,0,0
3,8480184,Gustav Lindstrom,D,ANA,26,0,0,0,0
3,8480070,Ian Mitchell,D,BOS,25,0,0,0,0
3,8480196,Jacob Bryson,D,BUF,27,0,0,0,0
3,8471686,Marc Staal,D,PHI,37,0,0,0,0
3,8477467,Gustav Olofsson,D,SEA,30,0,0,0,0
3,8478970,Jalen Chatfield,D,CAR,28,0,0,0,0
3,8479348,Kale Clague,D,BUF,26,0,0,0,0
3,8473446,Erik Johnson,D,PHI,36,0,0,0,0
3,8477462,Robert Hagg,D,ANA,29,0,0,0,0
3,8478454,Noah Juulsen,D,VAN,27,0,0,0,0
3,8477384,Josh Brown,D,ARI,30,0,0,0,0
3,8481708,Zac Jones,D,NYR,24,0,0,0,0
3,8481167,Brayden Pachal,D,CGY,25,0,0,0,0
3,8482067,Connor Mackey,D,NYR,28,0,0,0,0
3,8483460,David Jiricek,D,CBJ,21,0,0,0,0
3,8481701,Santeri Hatakka,D,NJD,23,0,0,0,0
3,8478021,William Lagesson,D,ANA,28,0,0,0,0
3,8477851,Jordan Oesterle,D,CGY,32,0,0,0,0
3,8478452,Caleb Jones,D,COL,27,0,0,0,0
3,8479984,Cal Foote,D,NJD,26,0,0,0,0
3,8479639,Dylan Coghlan,D,CAR,26,0,0,0,0
3,8480874,Adam Ginning,D,PHI,24,0,0,0,0
3,8479321,Lucas Johansen,D,WSH,27,0,0,0,0
3,8480878,Nils Lundkvist,D,DAL,24,0,0,0,0
3,8482165,Yan Kuznetsov,D,CGY,22,0,0,0,0
3,8484258,Sam Malinski,D,COL,26,0,0,0,0
3,8480157,Calle Rosen,D,STL,30,0,0,0,0
3,8484304,Uvis Balinskis,D,FLA,28,0,0,0,0
3,8479985,Cale Fleury,D,SEA,26,0,0,0,0
3,8479378,Logan Stanley,D,WPG,26,0,0,0,0
3,8477541,Dakota Mermis,D,MIN,30,0,0,0,0
3,8481609,Vladislav Kolyachonok,D,ARI,23,0,0,0,0
3,8480823,Alexander Alexeyev,D,WSH,25,0,0,0,0
3,8481679,Maxence Guenette,D,OTT,23,0,0,0,0
3,8481564,Ryan Johnson,D,BUF,23,0,0,0,0
3,8479376,Victor Mete,D,PHI,26,0,0,0,0
3,8484254,Akito Hirose,D,VAN,25,0,0,0,0
3,8482660,Kent Johnson,C,CBJ,22,0,0,0,0
3,8482149,Cole Perfetti,C,WPG,22,0,0,0,0
3,8477987,Ryan Donato,C,CHI,28,0,0,0,0
3,8475755,Alexander Petrovic,D,DAL,32,0,0,0,0
3,8477810,Joel Hanley,D,CGY,33,0,0,0,0
3,8474145,Robert Bortuzzo,D,NYI,35,0,0,0,0
3,8481161,Jake Christiansen,D,CBJ,25,0,0,0,0
3,8476884,Derrick Pouliot,D,DAL,30,0,0,0,0
3,8481716,Dmitri Voronkov,L,CBJ,24,0,0,0,0
3,8480084,Nick DeSimone,D,NJD,30,0,0,0,0
3,8475750,Jon Merrill,D,MIN,32,0,0,0,0
3,8479315,Joey Anderson,R,CHI,26,0,0,0,0
3,8478011,Louie Belpedio,D,PHI,28,0,0,0,0
3,8482451,Mikael Pyyhtia,L,CBJ,23,0,0,0,0
3,8481541,Samuel Bolduc,D,NYI,24,0,0,0,0
3,8482126,Emil Andrae,D,PHI,31,0,0,0,0
3,8474618,Marco Scandella,D,STL,34,0,0,0,0
3,8477244,Chad Ruhwedel,D,NYR,34,0,0,0,0
3,8477971,Andreas Englund,D,LAK,28,0,0,0,0
3,8480829,Jesperi Kotkaniemi,C,CAR,24,0,0,0,0
3,8479372,Josh Mahura,D,FLA,26,0,0,0,0
3,8482095,Tyler Kleven,D,OTT,22,0,0,0,0
3,8481719,Maxwell Crozier,D,TBL,24,0,0,0,0
3,8475855,Jesper Fast,R,CAR,33,0,0,0,0
3,8480848,Ty Dellandrea,C,DAL,24,0,0,0,0
3,8475193,Tomas Tatar,L,SEA,34,0,0,0,0
3,8476889,Radek Faksa,C,DAL,30,0,0,0,0
3,8478495,Denis Gurianov,R,PHI,27,0,0,0,0
3,8480216,Jacob Peterson,C,SJS,25,0,0,0,0
3,8480252,Cole Guttman,C,CHI,25,0,0,0,0
3,8479026,Philippe Myers,D,TBL,27,0,0,0,0
3,8481006,Tyler Tucker,D,STL,24,0,0,0,0
3,8481032,Paul Cotter,C,VGK,25,0,0,0,0
3,8481577,Philip Tomasino,C,NSH,23,0,0,0,0
3,8476918,Jimmy Vesey,L,NYR,31,0,0,0,0
3,8479320,Max Lajoie,D,TOR,27,0,0,0,0
3,8478017,Mark Friedman,D,VAN,29,0,0,0,0
3,8481754,Nikita Nesterenko,C,ANA,23,0,0,0,0
3,8483407,Brandon Scanlin,D,NYR,25,0,0,0,0
3,8482659,Josh Doan,R,ARI,22,0,0,0,0
3,8477446,Michael McCarron,R,NSH,29,0,0,0,0
3,8477903,Garnet Hathaway,R,PHI,33,0,0,0,0
3,8482153,Brendan Brisson,C,VGK,23,0,0,0,0
3,8483546,Marshall Rifai,D,TOR,26,0,0,0,0
3,8484287,Cole McWard,D,VAN,23,0,0,0,0
3,8478854,Ryan Shea,D,PIT,27,0,0,0,0
3,8481585,Egor Afanasyev,L,NSH,23,0,0,0,0
3,8483398,Declan Carlile,D,TBL,31,0,0,0,0
3,8478502,Dennis Gilbert,D,CGY,28,0,0,0,0
3,8482749,Joshua Roy,R,MTL,21,0,0,0,0
3,8481598,Philip Broberg,D,EDM,23,0,0,0,0
3,8480835,Jack Drury,C,CAR,24,0,0,0,0
3,8480748,Kiefer Sherwood,L,NSH,29,0,0,0,0
3,8476934,Brock McGinn,L,ANA,30,0,0,0,0
3,8480870,Bo Groulx,C,ANA,24,0,0,0,0
3,8479368,Max Jones,L,ANA,26,0,0,0,0
3,8478099,Kevin Labanc,R,SJS,29,0,0,0,0
3,8478067,Oskar Lindblom,L,SJS,28,0,0,0,0
3,8476393,Nick Cousins,C,FLA,31,0,0,0,0
3,8483395,Arshdeep Bains,L,VAN,23,0,0,0,0
3,8480762,Eric Robinson,L,BUF,29,0,0,0,0
3,8479439,Jacob MacDonald,D,SJS,31,0,0,0,0
3,8476474,Stefan Noesen,R,CAR,31,0,0,0,0
3,8482787,Nikita Chibrikov,R,WPG,31,0,0,0,0
3,8478432,Christian Fischer,R,DET,27,0,0,0,0
3,8477979,Nicolas Aube-Kubel,R,WSH,28,0,0,0,0
3,8481789,Tye Kartye,L,SEA,23,0,0,0,0
3,8479330,Brandon Gignac,C,MTL,27,0,0,0,0
3,8480075,Cameron Crotty,D,ARI,25,0,0,0,0
3,8473473,Milan Lucic,L,BOS,36,0,0,0,0
3,8482094,Daemon Hunt,D,MIN,22,0,0,0,0
3,8481206,John Ludvig,D,PIT,24,0,0,0,0
3,8483630,Pavol Regenda,L,ANA,25,0,0,0,0
3,8481617,Vasily Podkolzin,R,VAN,23,0,0,0,0
3,8480306,Grant Hutton,D,NYI,29,0,0,0,0
3,8480995,Pontus Holmberg,R,TOR,25,0,0,0,0
3,8482148,Hendrix Lapierre,C,WSH,22,0,0,0,0
3,8477478,William Carrier,L,VGK,30,0,0,0,0
3,8480003,Jesper Boqvist,C,BOS,26,0,0,0,0
3,8482172,Landon Slaggert,L,CHI,22,0,0,0,0
3,8480789,Oliver Wahlstrom,R,NYI,24,0,0,0,0
3,8474062,Riley Nash,C,NYR,35,0,0,0,0
3,8480021,Jack Studnicka,C,SJS,25,0,0,0,0
3,8480025,MacKenzie Entwistle,R,CHI,25,0,0,0,0
3,8481582,Nicholas Robertson,L,TOR,23,0,0,0,0
3,8476867,Brendan Gaunce,C,CBJ,30,0,0,0,0
3,8479619,Michael Carcone,L,ARI,28,0,0,0,0
3,8479370,Tyson Jost,C,BUF,26,0,0,0,0
3,8479671,Mathieu Olivier,R,CBJ,27,0,0,0,0
3,8476994,Vinnie Hinostroza,C,PIT,30,0,0,0,0
3,8482070,Mitchell Chaffee,R,TBL,26,0,0,0,0
3,8477473,Justin Bailey,R,SJS,29,0,0,0,0
3,8479344,Jesse Puljujarvi,R,PIT,26,0,0,0,0
3,8480205,Emil Bemstrom,C,PIT,25,0,0,0,0
3,8479718,Alex Barré-Boulet,C,TBL,27,0,0,0,0
3,8482061,Brandon Biro,L,BUF,26,0,0,0,0
3,8479638,Justin Brazeau,R,BOS,26,0,0,0,0
3,8474040,Sam Gagner,C,EDM,35,0,0,0,0
3,8477846,Ryan Carpenter,C,SJS,33,0,0,0,0
3,8482077,Dylan Holloway,L,EDM,23,0,0,0,0
3,8482157,Will Cuylle,L,NYR,22,0,0,0,0
3,8480007,Jonas Rondbjerg,R,VGK,25,0,0,0,0
3,8478874,Adam Gaudette,C,STL,28,0,0,0,0
3,8478434,Keegan Kolesar,R,VGK,27,0,0,0,0
3,8480441,Trey Fix-Wolansky,R,CBJ,25,0,0,0,0
3,8479994,Jaret Anderson-Dolan,C,NSH,25,0,0,0,0
3,8483567,Georgii Merkulov,C,BOS,24,0,0,0,0
3,8477380,Jonny Brodzinski,C,NYR,31,0,0,0,0
3,8482201,Gage Goncalves,C,TBL,23,0,0,0,0
3,8478211,Dryden Hunt,L,CGY,29,0,0,0,0
3,8471699,Andrew Cogliano,C,COL,37,0,0,0,0
3,8479421,Jacob Moverare,D,LAK,26,0,0,0,0
3,8478881,Brett Seney,L,CHI,28,0,0,0,0
3,8477464,Nic Petan,C,MIN,29,0,0,0,0
3,8475958,Michael Sgarbossa,C,WSH,32,0,0,0,0
3,8481147,Reese Johnson,C,CHI,26,0,0,0,0
3,8479336,Carl Grundstrom,R,LAK,27,0,0,0,0
3,8480853,Liam Foudy,C,NSH,24,0,0,0,0
3,8479522,Hardy Haman Aktell,D,WSH,26,0,0,0,0
3,8481462,Mason Morelli,L,VGK,28,0,0,0,0
3,8482102,Vasily Ponomarev,C,CAR,22,0,0,0,0
3,8480844,Grigori Denisenko,L,VGK,24,0,0,0,0
3,8479944,Zach Aston-Reese,C,DET,30,0,0,0,0
3,8482784,Zach Dean,C,STL,21,0,0,0,0
3,8479419,Brett Murray,L,BUF,26,0,0,0,0
3,8479520,Brandon Duhaime,R,COL,27,0,0,0,0
3,8477573,Nathan Walker,L,STL,30,0,0,0,0
3,8478078,Rourke Chartier,C,OTT,28,0,0,0,0
3,8475795,Dylan McIlrath,D,WSH,32,0,0,0,0
3,8482496,Nils Aman,C,VAN,24,0,0,0,0
3,8480289,Morgan Barron,C,WPG,26,0,0,0,0
3,8481751,Lukas Rousek,R,BUF,25,0,0,0,0
3,8480011,Klim Kostin,C,SJS,25,0,0,0,0
3,8481556,John Beecher,C,BOS,23,0,0,0,0
3,8475278,Byron Froese,C,VGK,33,0,0,0,0
3,8475225,Craig Smith,C,DAL,35,0,0,0,0
3,8484326,Patrik Koch,D,ARI,28,0,0,0,0
3,8477930,Pierre-Edouard Bellemare,L,SEA,39,0,0,0,0
3,8478409,Anthony Richard,C,BOS,28,0,0,0,0
3,8481024,Linus Karlsson,C,VAN,25,0,0,0,0
3,8479986,Kole Lind,R,SEA,26,0,0,0,0
3,8479414,Nathan Bastian,R,NJD,27,0,0,0,0
3,8479362,Riley Tufte,L,COL,26,0,0,0,0
3,8481058,Jesse Ylönen,R,MTL,25,0,0,0,0
3,8482476,Emil Heineman,L,MTL,23,0,0,0,0
3,8482861,Vincent Iorio,D,WSH,22,0,0,0,0
3,8483432,Luca Del Bel Belluz,C,CBJ,31,0,0,0,0
3,8482744,James Malatesta,L,CBJ,21,0,0,0,0
3,8477887,Patrick Brown,C,BOS,32,0,0,0,0
3,8478585,Derek Ryan,C,EDM,38,0,0,0,0
3,8481441,Joe Snively,C,WSH,28,0,0,0,0
3,8481592,Jakob Pelletier,L,CGY,23,0,0,0,0
3,8482634,Alex Steeves,C,TOR,25,0,0,0,0
3,8477126,Jayson Megna,C,BOS,34,0,0,0,0
3,8475752,Tyler Pitlick,C,NYR,33,0,0,0,0
3,8480008,Adam Ruzicka,C,ARI,25,0,0,0,0
3,8481065,Angus Crookshank,L,OTT,25,0,0,0,0
3,8479547,Matthew Phillips,R,WSH,26,0,0,0,0
3,8480226,Marián Studenic,R,SEA,26,0,0,0,0
3,8481237,Kyle MacLean,C,NYI,25,0,0,0,0
3,8475413,Justin Dowling,C,NJD,34,0,0,0,0
3,8481641,Joel Kiviranta,L,COL,28,0,0,0,0
3,8478104,Sammy Blais,L,STL,28,0,0,0,0
3,8477454,Adam Erne,L,EDM,29,0,0,0,0
3,8481518,Nolan Foote,L,NJD,24,0,0,0,0
3,8480245,Olle Lycksell,R,PHI,25,0,0,0,0
3,8483570,Ben Meyers,C,ANA,26,0,0,0,0
3,8480776,Sheldon Rempal,R,VGK,29,0,0,0,0
3,8483920,Pierrick Dube,R,WSH,23,0,0,0,0
3,8480267,Sammy Walker,C,MIN,25,0,0,0,0
3,8482747,Brennan Othmann,L,NYR,21,0,0,0,0
3,8479991,Jake Leschyshyn,C,NYR,25,0,0,0,0
3,8478400,Colin White,C,MTL,27,0,0,0,0
3,8479328,Julien Gauthier,R,NYI,27,0,0,0,0
3,8484325,Waltteri Merela,C,TBL,26,0,0,0,0
3,8479066,Ryan Lomberg,L,FLA,30,0,0,0,0
3,8477070,Liam O'Brien,C,ARI,30,0,0,0,0
3,8478146,Matthew Highmore,C,OTT,28,0,0,0,0
3,8478028,Fredrik Olofsson,L,COL,28,0,0,0,0
3,8480880,Jakub Lauko,C,BOS,24,0,0,0,0
3,8479968,Vinni Lettieri,C,MIN,29,0,0,0,0
3,8474709,Matt Martin,L,NYI,35,0,0,0,0
3,8480845,Rasmus Kupari,C,WPG,24,0,0,0,0
3,8481550,Adam Beckman,L,MIN,23,0,0,0,0
3,8481422,Jacob Lucchini,C,MIN,29,0,0,0,0
3,8477401,John Hayden,C,SEA,29,0,0,0,0
3,8478904,Steven Lorentz,C,FLA,28,0,0,0,0
3,8482088,Justin Sourdif,R,FLA,22,0,0,0,0
3,8482751,Ryan Winterton,C,SEA,21,0,0,0,0
3,8482241,Radim Zohorna,L,PIT,28,0,0,0,0
3,8481690,Tyler Angle,C,CBJ,24,0,0,0,0
3,8476952,Dominic Toninato,C,WPG,30,0,0,0,0
3,8476919,Chris Tierney,C,NJD,30,0,0,0,0
3,8480032,Shane Bowers,C,NJD,25,0,0,0,0
3,8484314,Jiri Smejkal,L,OTT,28,0,0,0,0
3,8481239,Samuel Fagemo,L,LAK,24,0,0,0,0
3,8481532,Alex Turcotte,C,LAK,23,0,0,0,0
3,8481019,David Gustafsson,C,WPG,24,0,0,0,0
3,8478477,Mitchell Stephens,C,MTL,27,0,0,0,0
3,8479546,Oskar Steen,C,BOS,26,0,0,0,0
3,8480292,Carson Meyer,R,CBJ,27,0,0,0,0
3,8478446,Glenn Gawdin,C,ANA,27,0,0,0,0
3,8483531,Brian Halonen,L,NJD,25,0,0,0,0
3,8477149,Scott Sabourin,R,SJS,32,0,0,0,0
3,8479972,Mason Shaw,C,MIN,26,0,0,0,0
3,8480890,Jan Jenik,R,ARI,24,0,0,0,0
3,8478051,Max Willman,C,NJD,29,0,0,0,0
3,8480851,Akil Thomas,C,LAK,24,0,0,0,0
3,8482765,Isak Rosen,R,BUF,21,0,0,0,0
3,8478421,A.J. Greer,L,CGY,28,0,0,0,0
3,8478512,Austin Czarnik,C,DET,32,0,0,0,0
3,8479536,Axel Jonsson-Fjallby,L,WPG,26,0,0,0,0
3,8477320,Anton Blidh,L,NYR,29,0,0,0,0
3,8481543,Nikita Alexandrov,C,STL,24,0,0,0,0
3,8475235,Nicolas Deslauriers,L,PHI,33,0,0,0,0
3,8481070,Hugh McGing,L,STL,26,0,0,0,0
3,8480836,Jonathan Gruden,C,PIT,24,0,0,0,0
3,8481591,Sam Poulin,R,PIT,23,0,0,0,0
3,8477962,Brendan Lemieux,L,CAR,28,0,0,0,0
3,8483401,Marc Johnstone,R,PIT,28,0,0,0,0
3,8482250,Callahan Burke,C,CAR,27,0,0,0,0
3,8481726,Adam Edstrom,C,NYR,24,0,0,0,0
3,8471817,Ryan Reaves,R,TOR,37,0,0,0,0
3,8479587,Rhett Gardner,C,PHI,28,0,0,0,0
3,8475766,Austin Watson,L,TBL,32,0,0,0,0
3,8479367,William Lockwood,R,FLA,26,0,0,0,0
3,8478424,Jansen Harkins,C,PIT,27,0,0,0,0
3,8476913,Devin Shore,C,SEA,30,0,0,0,0
3,8482652,Walker Duehr,R,CGY,27,0,0,0,0
3,8477527,Ross Johnston,L,ANA,30,0,0,0,0
3,8481077,John Leonard,L,ARI,26,0,0,0,0
3,8483549,Lucas Condotta,L,MTL,27,0,0,0,0
3,8480468,James Hamblin,L,EDM,25,0,0,0,0
3,8476907,Mackenzie MacEachern,L,STL,30,0,0,0,0
3,8479543,Michael Pezzetta,L,MTL,26,0,0,0,0
3,8480355,Mark Kastelic,C,OTT,25,0,0,0,0
3,8482162,Roby Jarventie,L,OTT,22,0,0,0,0
3,8479772,Zack MacEwen,R,OTT,28,0,0,0,0
3,8483597,Milos Kelemen,L,ARI,25,0,0,0,0
3,8479379,Givani Smith,R,SJS,26,0,0,0,0
3,8481655,Cole Schwindt,R,CGY,23,0,0,0,0
3,8479981,Jonah Gadjovich,L,FLA,26,0,0,0,0
3,8482147,Jean-Luc Foudy,C,COL,22,0,0,0,0
3,8484255,Jason Polin,R,COL,25,0,0,0,0
3,8477993,Justin Kirkland,C,ARI,28,0,0,0,0
3,8479249,Andrew Poturalski,C,SEA,30,0,0,0,0
3,8482197,Adam Raska,R,MIN,23,0,0,0,0
3,8475780,Chris Wagner,R,COL,33,0,0,0,0
3,8479533,Joona Koppanen,L,PIT,26,0,0,0,0
3,8481534,Raphael Lavoie,C,EDM,24,0,0,0,0
3,8484321,Nikolas Matinpalo,D,OTT,26,0,0,0,0
3,8481043,Cole Koepke,L,TBL,26,0,0,0,0
3,8476323,Max McCormick,L,SEA,32,0,0,0,0
3,8483609,Adam Klapka,R,CGY,24,0,0,0,0
3,8483512,Matt Savoie,C,BUF,20,0,0,0,0
3,8484259,Ondrej Pavel,C,COL,31,0,0,0,0
3,8478147,Bokondji Imama,L,OTT,28,0,0,0,0
3,8482460,Matt Rempe,C,NYR,22,0,0,0,0
3,8477073,Kurtis MacDermid,L,NJD,30,0,0,0,0
3,8480274,Philip Kemp,D,EDM,25,0,0,0,0
3,8478956,Samuel Laberge,L,NJD,27,0,0,0,0
3,8483045,Cameron Butler,R,CBJ,31,0,0,0,0
4,8478402,Connor McDavid,C,EDM,27,82,44,83,127
4,8476453,Nikita Kucherov,R,TBL,31,82,36,82,118
4,8479318,Auston Matthews,C,TOR,27,82,66,51,117
4,8477956,David Pastrnak,R,BOS,28,82,54,54,108
4,8480801,Brady Tkachuk,L,OTT,25,82,46,59,105
4,8477492,Nathan MacKinnon,C,COL,29,82,34,71,105
4,8477934,Leon Draisaitl,C,EDM,29,82,28,72,100
4,8477404,Jake Guentzel,C,CAR,30,82,34,62,96
4,8480023,Robert Thomas,C,STL,25,82,24,71,95
4,8478010,Brayden Point,C,TBL,28,82,54,39,93
4,8478420,Mikko Rantanen,R,COL,28,82,43,49,92
4,8471675,Sidney Crosby,C,PIT,37,82,42,47,89
4,8479314,Matthew Tkachuk,L,FLA,27,82,31,58,89
4,8476887,Filip Forsberg,L,NSH,30,82,40,47,87
4,8480027,Jason Robertson,L,DAL,25,82,37,50,87
4,8477939,William Nylander,R,TOR,28,82,33,54,87
4,8480069,Cale Makar,D,COL,26,82,26,61,87
4,8479343,Clayton Keller,R,ARI,26,82,32,54,86
4,8478445,Mathew Barzal,C,NYI,27,82,24,61,85
4,8475166,John Tavares,C,TOR,34,82,30,54,84
4,8479323,Adam Fox,D,NYR,26,82,15,68,83
4,8477493,Aleksander Barkov,C,FLA,29,82,27,54,81
4,8478864,Kirill Kaprizov,L,MIN,27,82,44,36,80
4,8480208,Drake Batherson,R,OTT,26,82,30,50,80
4,8480012,Elias Pettersson,C,VAN,26,82,36,43,79
4,8478550,Artemi Panarin,L,NYR,33,82,34,45,79
4,8481559,Jack Hughes,C,NJD,23,82,28,51,79
4,8479407,Jesper Bratt,L,NJD,26,82,23,56,79
4,8476454,Ryan Nugent-Hopkins,C,EDM,31,82,21,57,78
4,8477933,Sam Reinhart,C,FLA,29,82,43,34,77
4,8476460,Mark Scheifele,C,WPG,31,82,34,43,77
4,8478439,Travis Konecny,R,PHI,27,82,33,43,76
4,8479337,Alex DeBrincat,R,DET,27,82,31,45,76
4,8481523,Kirby Dach,C,MTL,23,82,18,58,76
4,8478449,Roope Hintz,C,DAL,28,82,42,33,75
4,8475810,Bryan Rust,R,PIT,32,82,40,35,75
4,8471214,Alex Ovechkin,L,WSH,39,82,39,36,75
4,8478403,Jack Eichel,C,VGK,28,82,34,41,75
4,8477409,Carter Verhaeghe,C,FLA,29,82,36,38,74
4,8476468,J.T. Miller,C,VAN,31,82,31,43,74
4,8478427,Sebastian Aho,C,CAR,27,82,38,35,73
4,8477942,Kevin Fiala,L,LAK,28,82,31,42,73
4,8471215,Evgeni Malkin,C,PIT,38,82,29,44,73
4,8477960,Adrian Kempe,R,LAK,28,82,35,37,72
4,8474564,Steven Stamkos,C,TBL,34,82,34,37,71
4,8478042,Viktor Arvidsson,R,LAK,31,82,32,39,71
4,8479385,Jordan Kyrou,C,STL,26,82,27,44,71
4,8477946,Dylan Larkin,C,DET,28,82,32,38,70
4,8482097,Jack Quinn,R,BUF,23,82,28,42,70
4,8480002,Nico Hischier,C,NJD,25,82,32,37,69
4,8482116,Tim Stützle,C,OTT,22,82,27,42,69
4,8475167,Victor Hedman,D,TBL,34,82,13,56,69
4,8480830,Andrei Svechnikov,R,CAR,24,82,28,40,68
4,8475172,Nazem Kadri,C,CGY,34,82,26,42,68
4,8479325,Charlie McAvoy,D,BOS,27,82,11,57,68
4,8478398,Kyle Connor,L,WPG,28,82,34,33,67
4,8477402,Pavel Buchnevich,L,STL,29,82,29,37,66
4,8475765,Vladimir Tarasenko,R,FLA,33,82,23,43,66
4,8474600,Roman Josi,D,NSH,34,82,16,50,66
4,8478407,Vince Dunn,D,SEA,28,82,14,52,66
4,8474590,John Carlson,D,WSH,34,82,12,54,66
4,8475786,Zach Hyman,L,EDM,32,82,45,20,65
4,8476456,Jonathan Huberdeau,C,CGY,31,82,20,45,65
4,8477447,Shea Theodore,D,VGK,29,82,16,49,65
4,8470794,Joe Pavelski,C,DAL,40,82,29,35,64
4,8476389,Vincent Trocheck,C,NYR,31,82,24,40,64
4,8473419,Brad Marchand,L,BOS,36,82,24,40,64
4,8477949,Alex Tuch,R,BUF,28,82,22,42,64
4,8471685,Anze Kopitar,C,LAK,37,82,22,42,64
4,8477496,Elias Lindholm,C,VAN,30,82,22,42,64
4,8480031,Maxime Comtois,L,CAR,25,82,17,47,64
4,8476346,Johnny Gaudreau,L,CBJ,31,82,16,48,64
4,8480800,Quinn Hughes,D,VAN,25,82,10,54,64
4,8473986,Alex Killorn,L,ANA,35,82,33,30,63
4,8475158,Ryan O'Reilly,C,NSH,33,82,28,35,63
4,8480018,Nick Suzuki,C,MTL,25,82,24,39,63
4,8473512,Claude Giroux,R,OTT,36,82,22,41,63
4,8480803,Evan Bouchard,D,EDM,25,82,18,45,63
4,8481557,Matt Boldy,L,MIN,23,82,16,47,63
4,8474141,Patrick Kane,R,DET,36,82,27,35,62
4,8475168,Matt Duchene,C,DAL,33,82,26,36,62
4,8475754,Brock Nelson,C,NYI,33,82,36,25,61
4,8477500,Bo Horvat,C,NYI,29,82,33,28,61
4,8475170,Brayden Schenn,C,STL,33,82,21,40,61
4,8483445,Cutter Gauthier,L,ANA,20,82,14,47,61
4,8476880,Tom Wilson,R,WSH,30,82,36,24,60
4,8484144,Connor Bedard,C,CHI,19,82,26,34,60
4,8477451,Ryan Hartman,R,MIN,30,82,24,36,60
4,8481711,Matias Maccelli,L,ARI,24,82,22,38,60
4,8482113,Anton Lundell,C,FLA,23,82,20,40,60
4,8480839,Rasmus Dahlin,D,BUF,24,82,17,43,60
4,8475184,Chris Kreider,L,NYR,33,82,36,23,59
4,8482093,Seth Jarvis,C,CAR,22,82,21,38,59
4,8477504,Josh Morrissey,D,WPG,29,82,11,48,59
4,8480039,Martin Necas,C,CAR,25,82,30,28,58
4,8478366,Frank Vatrano,R,ANA,30,82,29,29,58
4,8477501,Valeri Nichushkin,R,COL,29,82,27,31,58
4,8478438,Tommy Novak,C,NSH,27,82,25,33,58
4,8477503,Max Domi,C,TOR,29,82,24,34,58
4,8481596,Shane Pinto,C,OTT,24,82,21,37,58
4,8479400,Pierre-Luc Dubois,L,LAK,26,82,20,38,58
4,8481533,Trevor Zegras,C,ANA,23,82,18,40,58
4,8480865,Noah Dobson,D,NYI,24,82,12,46,58
4,8482740,Wyatt Johnston,C,DAL,21,82,23,34,57
4,8478873,Troy Terry,R,ANA,27,82,22,35,57
4,8480798,Philipp Kurashev,C,CHI,25,82,14,43,57
4,8475726,Tyler Toffoli,C,WPG,32,82,30,26,56
4,8478444,Brock Boeser,R,VAN,27,82,24,32,56
4,8477951,Nick Schmaltz,C,ARI,28,82,24,32,56
4,8475692,Mats Zuccarello,R,MIN,37,82,17,39,56
4,8479410,Mikhail Sergachev,D,TBL,26,82,8,48,56
4,8478493,Joel Eriksson Ek,C,MIN,27,82,31,24,55
4,8482699,Dylan Guenther,R,ARI,21,82,27,28,55
4,8479542,Brandon Hagel,L,TBL,26,82,24,31,55
4,8479420,Tage Thompson,C,BUF,27,82,24,31,55
4,8478440,Dylan Strome,C,WSH,27,82,23,32,55
4,8482745,Mason McTavish,C,ANA,21,82,19,36,55
4,8475798,Mikael Granlund,C,SJS,32,82,11,44,55
4,8478414,Timo Meier,R,NJD,28,82,29,25,54
4,8476459,Mika Zibanejad,C,NYR,31,82,28,26,54
4,8477940,Nikolaj Ehlers,L,WPG,28,82,27,27,54
4,8475794,Tyler Seguin,C,DAL,32,82,26,28,54
4,8481618,Alex Newhook,C,MTL,23,82,26,28,54
4,8477955,Jared McCann,L,SEA,28,82,25,29,54
4,8480028,Morgan Frost,C,PHI,25,82,22,32,54
4,8475191,Reilly Smith,R,PIT,33,82,23,30,53
4,8481540,Cole Caufield,R,MTL,23,82,22,31,53
4,8478498,Jake DeBrusk,L,BOS,28,82,21,32,53
4,8476905,Chandler Stephenson,C,VGK,30,82,18,35,53
4,8474679,Gustav Nyquist,C,NSH,35,82,15,38,53
4,8480064,Josh Norris,C,OTT,25,82,29,23,52
4,8475784,Jeff Skinner,C,BUF,32,82,27,25,52
4,8479675,Trevor Moore,L,LAK,29,82,25,27,52
4,8478458,Jack Roslovic,C,NYR,27,82,23,29,52
4,8477986,Brandon Montour,D,FLA,30,82,14,38,52
4,8476853,Morgan Rielly,D,TOR,30,82,11,41,52
4,8471724,Kris Letang,D,PIT,37,82,11,41,52
4,8480188,Fabian Zetterlund,L,SJS,25,82,26,25,51
4,8477021,Alex Kerfoot,C,ARI,30,82,18,33,51
4,8477476,Artturi Lehkonen,L,COL,29,82,29,21,50
4,8482175,JJ Peterka,R,BUF,22,82,27,23,50
4,8476438,Brandon Saad,L,STL,32,82,24,26,50
4,8478401,Pavel Zacha,C,BOS,27,82,22,28,50
4,8476448,William Karlsson,C,VGK,31,82,22,28,50
4,8478856,Conor Garland,R,VAN,28,82,22,28,50
4,8475913,Mark Stone,R,VGK,32,82,21,29,50
4,8477494,Jonathan Drouin,L,COL,29,82,16,34,50
4,8478047,Michael Bunting,L,PIT,29,82,15,35,50
4,8475764,Cam Fowler,D,ANA,33,82,6,44,50
4,8478519,Anthony Cirelli,C,TBL,27,82,23,26,49
4,8482667,William Eklund,L,SJS,22,82,21,28,49
4,8479999,Casey Mittelstadt,C,COL,26,82,20,29,49
4,8478055,Gustav Forsling,D,FLA,28,82,20,29,49
4,8474157,Max Pacioretty,L,WSH,36,82,19,30,49
4,8482665,Matty Beniers,C,SEA,22,82,18,31,49
4,8471698,T.J. Oshie,R,WSH,38,82,18,31,49
4,8480036,Miro Heiskanen,D,DAL,25,82,5,44,49
4,8476539,Jonathan Marchessault,R,VGK,34,82,24,24,48
4,8478460,Zach Werenski,D,CBJ,27,82,17,31,48
4,8482684,Luke Hughes,D,NJD,21,82,14,34,48
4,8476792,Torey Krug,D,STL,33,82,9,39,48
4,8482159,Tyson Foerster,R,PHI,22,82,26,21,47
4,8475714,Calle Jarnkrok,C,TOR,33,82,25,22,47
4,8476432,Boone Jenner,C,CBJ,31,82,24,23,47
4,8480893,Kirill Marchenko,R,CBJ,24,82,23,24,47
4,8482109,Alexis Lafrenière,L,NYR,23,82,22,25,47
4,8477407,Anthony Duclair,L,TBL,29,82,18,29,47
4,8479345,Jakob Chychrun,D,OTT,26,82,18,29,47
4,8474150,Mikael Backlund,C,CGY,35,82,17,30,47
4,8476882,Teuvo Teravainen,L,CAR,30,82,17,30,47
4,8478975,Mason Marchment,L,DAL,29,82,16,31,47
4,8481528,Dylan Cozens,C,BUF,23,82,15,32,47
4,8474578,Erik Karlsson,D,PIT,34,82,13,34,47
4,8481068,Yegor Sharangovich,C,CGY,26,82,22,24,46
4,8477497,Sean Monahan,C,WPG,30,82,14,32,46
4,8483524,Shane Wright,C,SEA,20,82,38,7,45
4,8477952,Robby Fabbri,C,DET,28,82,23,22,45
4,8477416,Oliver Bjorkstrand,R,SEA,29,82,19,26,45
4,8477953,Kasperi Kapanen,R,STL,28,82,17,28,45
4,8476479,Phillip Danault,C,LAK,31,82,16,29,45
4,8479339,Patrik Laine,L,CBJ,26,82,12,33,45
4,8470613,Brent Burns,D,CAR,39,82,8,37,45
4,8480015,Owen Tippett,R,PHI,25,82,23,21,44
4,8474102,David Perron,L,DET,36,82,21,23,44
4,8480009,Eeli Tolvanen,R,SEA,25,82,21,23,44
4,8476881,Tomas Hertl,C,VGK,31,82,19,25,44
4,8473994,Jamie Benn,L,DAL,35,82,15,29,44
4,8475753,Justin Faulk,D,STL,32,82,14,30,44
4,8476869,Brady Skjei,D,CAR,30,82,12,32,44
4,8475197,Tyson Barrie,D,NSH,33,82,8,36,44
4,8480014,Gabriel Vilardi,C,WPG,25,82,26,17,43
4,8475314,Anders Lee,L,NYI,34,82,26,17,43
4,8477498,Darnell Nurse,D,EDM,29,82,21,22,43
4,8480078,Filip Chytil,C,NYR,25,82,19,24,43
4,8483808,Andrei Kuzmenko,L,CGY,28,82,18,25,43
4,8478413,Jordan Greenway,L,BUF,27,82,18,25,43
4,8482078,Lucas Raymond,L,DET,22,82,13,30,43
4,8476462,Dougie Hamilton,D,NJD,31,82,13,30,43
4,8476458,Ryan Strome,C,ANA,31,82,13,30,43
4,8483397,Marc McLaughlin,C,BOS,25,82,36,6,42
4,8482110,Dawson Mercer,C,NJD,23,82,20,22,42
4,8475151,Kyle Palmieri,C,NYI,33,82,19,23,42
4,8476483,Rickard Rakell,R,PIT,31,82,19,23,42
4,8477444,Andre Burakovsky,L,SEA,29,82,18,24,42
4,8478466,Daniel Sprong,R,DET,27,82,17,25,42
4,8474641,Adam Henrique,C,EDM,34,82,17,25,42
4,8475744,Evgeny Kuznetsov,C,CAR,32,82,12,30,42
4,8477495,Seth Jones,D,CHI,30,82,11,31,42
4,8475169,Evander Kane,L,EDM,33,82,22,19,41
4,8478474,Lawson Crouse,L,ARI,27,82,21,20,41
4,8475848,Brendan Gallagher,R,MTL,32,82,16,25,41
4,8478542,Evan Rodrigues,C,FLA,31,82,10,31,41
4,8478396,Noah Hanifin,D,VGK,27,82,9,32,41
4,8474565,Alex Pietrangelo,D,VGK,34,82,7,34,41
4,8483493,Frank Nazar,C,CHI,20,82,24,16,40
4,8478115,Pierre Engvall,L,NYI,28,82,19,21,40
4,8479987,Morgan Geekie,C,BOS,26,82,18,22,40
4,8482101,Danil Gushchin,L,SJS,22,82,17,23,40
4,8478469,Thomas Chabot,D,OTT,27,82,15,25,40
4,8474870,Tyler Johnson,C,CHI,34,82,15,25,40
4,8478038,Devon Toews,D,COL,30,82,14,26,40
4,8476875,Mike Matheson,D,MTL,30,82,9,31,40
4,8478397,Rasmus Andersson,D,CGY,28,82,8,32,40
4,8477511,Anthony Mantha,R,VGK,30,82,17,22,39
4,8480821,Filip Zadina,R,SJS,25,82,17,22,39
4,8471218,Blake Wheeler,R,NYR,38,82,16,23,39
4,8477998,Warren Foegele,L,EDM,28,82,16,23,39
4,8477932,Aaron Ekblad,D,FLA,28,82,16,23,39
4,8476329,Travis Boyd,C,ARI,31,82,15,24,39
4,8475768,Jaden Schwartz,C,SEA,32,82,15,24,39
4,8478891,Mason Appleton,C,WPG,28,82,14,25,39
4,8478233,Andrew Mangiapane,L,CGY,28,82,13,26,39
4,8482475,Yegor Chinakhov,R,CBJ,23,82,13,26,39
4,8474586,Jordan Eberle,R,SEA,34,82,12,27,39
4,8482124,Quinton Byfield,R,LAK,22,82,11,28,39
4,8476872,Scott Laughton,C,PHI,30,82,11,28,39
4,8482671,Owen Power,D,BUF,22,82,11,28,39
4,8481699,Aku Raty,R,ARI,23,82,2,37,39
4,8481535,Nils Hoglander,L,VAN,24,82,25,13,38
4,8476399,Blake Coleman,C,CGY,33,82,24,14,38
4,8475722,Jason Zucker,L,NSH,32,82,22,16,38
4,8482089,Jake Neighbours,L,STL,22,82,22,16,38
4,8475791,Taylor Hall,L,CHI,33,82,21,17,38
4,8484166,Adam Fantilli,C,CBJ,20,82,20,18,38
4,8475763,Kevin Hayes,R,STL,32,82,18,20,38
4,8477429,Andrew Copp,C,DET,30,82,17,21,38
4,8481542,Moritz Seider,D,DET,23,82,9,29,38
4,8480873,Rasmus Sandin,D,WSH,24,82,8,30,38
4,8479425,Filip Hronek,D,VAN,27,82,7,31,38
4,8474563,Drew Doughty,D,LAK,35,82,7,31,38
4,8479423,Alex Nylander,L,CBJ,26,82,27,10,37
4,8477426,Nicholas Paul,L,TBL,29,82,22,15,37
4,8477935,Sam Bennett,C,FLA,28,82,20,17,37
4,8478472,Mathieu Joseph,R,OTT,27,82,16,21,37
4,8481656,Aliaksei Protas,C,WSH,23,82,13,24,37
4,8476463,Jonas Brodin,D,MIN,31,82,10,27,37
4,8476958,Jaccob Slavin,D,CAR,30,82,8,29,37
4,8484203,Bradly Nadeau,L,CAR,19,82,22,14,36
4,8479365,Trent Frederic,C,BOS,26,82,18,18,36
4,8478057,Dakota Joshua,C,VAN,28,82,17,19,36
4,8475287,Erik Haula,L,NJD,33,82,16,20,36
4,8477479,Tyler Bertuzzi,L,TOR,29,82,12,24,36
4,8482055,Drew O'Connor,L,PIT,26,82,12,24,36
4,8479992,Michael Rasmussen,C,DET,25,82,12,24,36
4,8481013,Jonatan Berggren,R,DET,24,82,12,24,36
4,8482222,Alexander Barabanov,L,SJS,30,82,11,25,36
4,8477964,Ivan Barbashev,C,VGK,29,82,10,26,36
4,8482122,Brock Faber,D,MIN,22,82,10,26,36
4,8480797,Joel Farabee,L,PHI,24,82,9,27,36
4,8479398,Samuel Girard,D,COL,26,82,7,29,36
4,8483457,Lane Hutson,D,MTL,20,82,3,33,36
4,8477944,Jakub Vrana,L,STL,28,82,19,16,35
4,8475760,Nick Bjugstad,C,ARI,32,82,14,21,35
4,8474053,Logan Couture,C,SJS,35,82,13,22,35
4,8483515,Juraj Slafkovsky,L,MTL,20,82,12,23,35
4,8475745,Charlie Coyle,C,BOS,32,82,11,24,35
4,8475793,Ryan Johansen,C,PHI,32,82,10,25,35
4,8480434,Sean Durzi,D,ARI,26,82,10,25,35
4,8481580,Connor McMichael,C,WSH,23,82,19,15,34
4,8477456,J.T. Compher,L,DET,29,82,12,22,34
4,8476960,Andreas Athanasiou,C,CHI,30,82,11,23,34
4,8476927,Teddy Blueger,C,VAN,30,82,11,23,34
4,8478462,Nicolas Roy,C,VGK,27,82,8,26,34
4,8481016,Ruslan Iskhakov,C,NYI,24,82,6,28,34
4,8475906,John Klingberg,D,TOR,32,82,5,29,34
4,8476854,Hampus Lindholm,D,BOS,30,82,5,29,34
4,8476392,Adam Lowry,C,WPG,31,82,18,15,33
4,8480459,Pius Suter,C,VAN,28,82,15,18,33
4,8479525,Ross Colton,C,COL,28,82,14,19,33
4,8476292,Ondrej Palat,L,NJD,33,82,13,20,33
4,8482079,Marco Rossi,C,MIN,23,82,12,21,33
4,8474189,Lars Eller,C,PIT,35,82,12,21,33
4,8477948,Travis Sanheim,D,PHI,28,82,11,22,33
4,8477346,MacKenzie Weegar,D,CGY,30,82,10,23,33
4,8482133,Thomas Bordeleau,C,SJS,22,82,8,25,33
4,8480220,Noah Cates,L,PHI,25,82,8,25,33
4,8480817,K'Andre Miller,D,NYR,24,82,7,26,33
4,8483471,Brad Lambert,C,WPG,31,82,5,28,33
4,8475218,Mattias Ekholm,D,EDM,34,82,3,30,33
4,8476921,Jordan Martinook,L,CAR,32,82,18,14,32
4,8478463,Anthony Beauvillier,L,NSH,27,82,17,15,32
4,8476871,Tanner Pearson,L,MTL,32,82,16,16,32
4,8474149,Evgenii Dadonov,R,DAL,35,82,15,17,32
4,8481517,Brett Leason,R,ANA,25,82,15,17,32
4,8481604,Pavel Dorofeyev,L,VGK,24,82,13,19,32
4,8475149,Marcus Johansson,L,MIN,34,82,13,19,32
4,8477015,Connor Brown,R,EDM,30,82,12,20,32
4,8479415,Michael McLeod,C,NJD,26,82,11,21,32
4,8476374,Sean Kuraly,C,CBJ,31,82,10,22,32
4,8480068,Ryan Poehling,C,PHI,25,82,10,22,32
4,8479390,Taylor Raddysh,R,CHI,26,82,10,22,32
4,8481624,Ilya Mikheyev,R,VAN,30,82,9,23,32
4,8476480,Vladislav Namestnikov,C,WPG,32,82,6,26,32
4,8476892,Colton Parayko,D,STL,31,82,4,28,32
4,8480043,Timothy Liljegren,D,TOR,25,82,4,28,32
4,8470621,Corey Perry,R,EDM,39,82,19,12,31
4,8480849,Barrett Hayton,C,ARI,24,82,14,17,31
4,8474884,Mike Hoffman,C,SJS,35,82,13,18,31
4,8477919,Frederick Gaudreau,C,MIN,31,82,13,18,31
4,8478569,Noel Acciari,C,PIT,33,82,13,18,31
4,8482146,Luke Evangelista,R,NSH,22,82,12,19,31
4,8476826,Yanni Gourde,C,SEA,33,82,11,20,31
4,8479351,Sam Steel,C,DAL,26,82,11,20,31
4,8478109,Victor Olofsson,L,BUF,29,82,10,21,31
4,8478500,Ivan Provorov,D,CBJ,27,82,6,25,31
4,8476979,Erik Gustafsson,D,NYR,32,82,3,28,31
4,8481581,Thomas Harley,D,DAL,23,82,2,29,31
4,8479316,Luke Kunin,C,SJS,27,82,19,11,30
4,8476981,Josh Anderson,R,MTL,30,82,17,13,30
4,8476897,Oskar Sundqvist,C,STL,30,82,14,16,30
4,8481704,Juuso Parssinen,C,NSH,23,82,12,18,30
4,8482117,Lukas Reichel,L,CHI,22,82,10,20,30
4,8478046,Danton Heinen,L,BOS,29,82,9,21,30
4,8476419,Jean-Gabriel Pageau,C,NYI,32,82,9,21,30
4,8476422,Mike Reilly,D,NYI,31,82,7,23,30
4,8476906,Shayne Gostisbehere,D,DET,31,82,6,24,30
4,8475181,Nick Leddy,D,STL,33,82,3,27,30
4,8477947,Sonny Milano,L,WSH,28,82,15,14,29
4,8476925,Colton Sissons,C,NSH,31,82,14,15,29
4,8482092,Ridly Greig,C,OTT,22,82,11,18,29
4,8482702,Logan Stankoven,C,DAL,21,82,11,18,29
4,8480802,Ryan McLeod,C,EDM,25,82,11,18,29
4,8480813,Joe Veleno,C,DET,24,82,11,18,29
4,8479996,Cody Glass,C,NSH,25,82,9,20,29
4,8479661,Tanner Jeannot,L,TBL,27,82,9,20,29
4,8480871,Adam Boqvist,D,CBJ,24,82,8,21,29
4,8480035,Henri Jokiharju,D,BUF,25,82,7,22,29
4,8475799,Nino Niederreiter,R,WPG,32,82,19,9,28
4,8479353,Brett Howden,C,VGK,26,82,15,13,28
4,8476461,Sean Couturier,C,PHI,32,82,13,15,28
4,8482737,Zack Bolduc,C,STL,21,82,13,15,28
4,8481186,Logan O'Connor,R,COL,28,82,12,16,28
4,8482624,Daniil Miromanov,D,CGY,27,82,11,17,28
4,8474037,James van Riemsdyk,L,BOS,35,82,10,18,28
4,8480113,Alex Iafallo,L,WPG,31,82,10,18,28
4,8475220,Marcus Foligno,L,MIN,33,82,10,18,28
4,8480806,Isac Lundestrom,C,ANA,25,82,10,18,28
4,8477392,Hudson Fasching,R,NYI,29,82,7,21,28
4,8476917,Adam Pelech,D,NYI,30,82,2,26,28
4,8483431,Logan Cooley,C,ARI,20,82,16,11,27
4,8479941,Justin Danforth,R,CBJ,31,82,15,12,27
4,8478020,Michael Amadio,C,VGK,28,82,15,12,27
4,8481554,Kaapo Kakko,R,NYR,23,82,14,13,27
4,8479293,Brandon Tanev,L,SEA,33,82,14,13,27
4,8480855,Jack McBain,C,ARI,24,82,13,14,27
4,8476873,Mark Jankowski,C,NSH,30,82,13,14,27
4,8475164,Jakob Silfverberg,R,ANA,34,82,12,15,27
4,8477506,Ryan Pulock,D,NYI,30,82,9,18,27
4,8473563,Nicklas Backstrom,C,WSH,37,82,9,18,27
4,8482705,Cole Sillinger,C,CBJ,21,82,7,20,27
4,8483505,Matthew Poitras,C,BOS,20,82,7,20,27
4,8475200,Dmitry Orlov,D,CAR,33,82,5,22,27
4,8481703,Valtteri Puustinen,R,PIT,25,82,4,23,27
4,8478840,Will Borgen,D,SEA,28,82,4,23,27
4,8475690,Chris Tanev,D,DAL,35,82,4,23,27
4,8478507,John Marino,D,NJD,27,82,4,23,27
4,8473533,Jordan Staal,C,CAR,36,82,13,13,26
4,8476278,Colin Blackwell,C,CHI,31,82,13,13,26
4,8482111,Justin Barron,D,MTL,23,82,13,13,26
4,8470610,Zach Parise,L,COL,40,82,12,14,26
4,8480185,Eetu Luostarinen,C,FLA,26,82,10,16,26
4,8482074,Connor Zary,C,CGY,23,82,10,16,26
4,8479977,Kailer Yamamoto,R,SEA,26,82,9,17,26
4,8476885,Jacob Trouba,D,NYR,30,82,9,17,26
4,8478013,Jake Walman,D,DET,28,82,9,17,26
4,8482730,Brandt Clarke,D,LAK,21,82,9,17,26
4,8482803,Olen Zellweger,D,ANA,21,82,9,17,26
4,8478133,Jake Evans,C,MTL,28,82,8,18,26
4,8482142,Jamie Drysdale,D,PHI,22,82,7,19,26
4,8479359,Beck Malenstyn,L,WSH,26,82,7,19,26
4,8477969,Marcus Pettersson,D,PIT,28,82,7,19,26
4,8481546,Cam York,D,PHI,23,82,6,20,26
4,8479371,Dante Fabbro,D,NSH,26,82,6,20,26
4,8478399,Jonas Siegenthaler,D,NJD,27,82,6,20,26
4,8478136,Jake Middleton,D,MIN,28,82,6,20,26
4,8474716,Jared Spurgeon,D,MIN,35,82,4,22,26
4,8476312,Josh Manson,D,COL,33,82,4,22,26
4,8480145,Neal Pionk,D,WPG,29,82,3,23,26
4,8476879,Cody Ceci,D,EDM,31,82,1,25,26
4,8482118,Sam Colangelo,R,ANA,23,82,20,5,25
4,8481093,Rafael Harvey-Pinard,L,MTL,25,82,16,9,25
4,8477989,Christian Dvorak,C,MTL,28,82,15,10,25
4,8481560,Arthur Kaliyev,R,LAK,23,82,11,14,25
4,8475343,Nic Dowd,C,WSH,34,82,11,14,25
4,8476469,Joel Armia,R,MTL,31,82,11,14,25
4,8482720,Matthew Knies,L,TOR,22,82,8,17,25
4,8478882,Vladislav Gavrikov,D,LAK,29,82,8,17,25
4,8482073,Braden Schneider,D,NYR,23,82,6,19,25
4,8481014,Alexander Romanov,D,NYI,24,82,6,19,25
4,8475279,Ben Chiarot,D,DET,33,82,6,19,25
4,8482655,J.J. Moser,D,ARI,24,82,5,20,25
4,8476902,Esa Lindell,D,DAL,30,82,3,22,25
4,8480073,Erik Brannstrom,D,OTT,25,82,3,22,25
4,8482145,Mavrik Bourque,C,DAL,22,82,19,5,24
4,8482155,Alex Laferriere,R,LAK,23,82,13,11,24
4,8483491,Ivan Miroshnichenko,L,WSH,20,82,13,11,24
4,8477406,Mattias Janmark,C,EDM,32,82,12,12,24
4,8476878,Zemgus Girgensons,L,BUF,30,82,11,13,24
4,8484153,Leo Carlsson,C,ANA,20,82,11,13,24
4,8479346,Dillon Dube,C,CGY,26,82,10,14,24
4,8473422,Nick Foligno,L,CHI,37,82,10,14,24
4,8479514,Rem Pitlick,C,CHI,27,82,10,14,24
4,8477839,Conor Sheary,L,TBL,32,82,8,16,24
4,8481524,Bowen Byram,D,BUF,23,82,6,18,24
4,8479369,Andrew Peeke,D,BOS,26,82,5,19,24
4,8477365,Connor Clifton,D,BUF,29,82,5,19,24
4,8470600,Ryan Suter,D,DAL,39,82,5,19,24
4,8476923,Damon Severson,D,CBJ,30,82,4,20,24
4,8476457,Adam Larsson,D,SEA,32,82,4,20,24
4,8473507,Jeff Petry,D,DET,37,82,2,22,24
4,8477845,Trevor van Riemsdyk,D,WSH,33,82,0,24,24
4,8482125,Alexander Holtz,R,NJD,22,82,15,8,23
4,8474715,Cam Atkinson,R,PHI,35,82,15,8,23
4,8480281,Alexey Toropchenko,R,STL,25,82,14,9,23
4,8481477,Nico Sturm,C,SJS,29,82,13,10,23
4,8470604,Jeff Carter,C,PIT,39,82,10,13,23
4,8477507,Nikita Zadorov,D,VAN,29,82,10,13,23
4,8484145,Zach Benson,L,BUF,19,82,10,13,23
4,8482166,Shakir Mukhamadullin,D,SJS,22,82,8,15,23
4,8475462,Radko Gudas,D,ANA,34,82,7,16,23
4,8477220,Nate Schmidt,D,WPG,33,82,4,19,23
4,8473449,Kyle Okposo,R,FLA,36,82,13,9,22
4,8478508,Yakov Trenin,C,COL,27,82,12,10,22
4,8482809,Jackson Blake,R,CAR,21,82,11,11,22
4,8475177,Calvin de Haan,D,TBL,33,82,8,14,22
4,8475179,Dmitry Kulikov,D,FLA,34,82,4,18,22
4,8478859,Niko Mikkola,D,FLA,28,82,4,18,22
4,8478178,Darren Raddysh,D,TBL,28,82,3,19,22
4,8475231,Casey Cizikas,C,NYI,33,82,10,11,21
4,8483499,Liam Ohgren,L,MIN,20,82,9,12,21
4,8480074,Alexandre Texier,C,CBJ,25,82,9,12,21
4,8481028,Martin Pospisil,C,CGY,25,82,8,13,21
4,8473453,Trevor Lewis,C,LAK,37,82,8,13,21
4,8477435,Ryan Graves,D,PIT,29,82,6,15,21
4,8478043,Sam Lafferty,C,VAN,29,82,6,15,21
4,8477330,Dominik Kubalik,L,OTT,29,82,5,16,21
4,8479983,Mario Ferraro,D,SJS,26,82,5,16,21
4,8479980,Nicolas Hague,D,VGK,26,82,5,16,21
4,8477425,Miles Wood,L,COL,29,82,5,16,21
4,8474574,Tyler Myers,D,VAN,34,82,4,17,21
4,8477488,Brett Pesce,D,CAR,30,82,4,17,21
4,8481606,Jordan Spence,D,LAK,23,82,3,18,21
4,8482087,Kaiden Guhle,D,MTL,22,82,3,18,21
4,8475171,Oliver Ekman-Larsson,D,FLA,33,82,2,19,21
4,8475790,Erik Gudbranson,D,CBJ,32,82,2,19,21
4,8480246,Nick Perbix,D,TBL,26,82,1,20,21
4,8480144,David Kampf,C,TOR,29,82,9,11,20
4,8475233,David Savard,D,MTL,34,82,8,12,20
4,8481481,Blake Lizotte,C,LAK,27,82,7,13,20
4,8478430,Oliver Kylington,D,CGY,27,82,6,14,20
4,8477353,Tyler Motte,C,TBL,29,82,6,14,20
4,8483482,Tristan Luneau,D,ANA,20,82,5,15,20
4,8476331,Dylan DeMelo,D,WPG,31,82,5,15,20
4,8480807,Mattias Samuelsson,D,BUF,24,82,5,15,20
4,8481059,Scott Perunovich,D,STL,26,82,5,15,20
4,8476967,Brett Kulak,D,EDM,30,82,4,16,20
4,8481178,Egor Zamula,D,PHI,24,82,4,16,20
4,8479324,Ryan Lindgren,D,NYR,26,82,2,18,20
4,8474034,Pat Maroon,L,BOS,36,82,11,8,19
4,8479393,Noah Gregor,C,TOR,26,82,10,9,19
4,8479591,Michael Eyssimont,C,TBL,28,82,10,9,19
4,8482679,Matt Coronato,R,CGY,22,82,9,10,19
4,8476442,Matt Nieto,L,PIT,32,82,8,11,19
4,8481553,Bobby Brink,R,PHI,23,82,8,11,19
4,8474166,Alec Martinez,D,VGK,37,82,6,13,19
4,8477369,Carson Soucy,D,VAN,30,82,6,13,19
4,8481537,Nikita Okhotiuk,D,CGY,24,82,6,13,19
4,8478911,Matt Roy,D,LAK,29,82,4,15,19
4,8476931,Jake McCabe,D,TOR,31,82,3,16,19
4,8478468,Jeremy Lauzon,D,NSH,27,82,3,16,19
4,8476372,Nick Seeler,D,PHI,31,82,2,17,19
4,8476891,Matt Grzelcyk,D,BOS,30,82,2,17,19
4,8474151,Ryan McDonagh,D,NSH,35,82,2,17,19
4,8476525,Colin Miller,D,WPG,32,82,1,18,19
4,8481601,Simon Holmstrom,R,NYI,23,82,13,5,18
4,8482062,Cole Smith,L,NSH,29,82,9,9,18
4,8475842,Sam Carrick,C,EDM,32,82,8,10,18
4,8480980,Connor Dewar,C,TOR,25,82,7,11,18
4,8477931,Tomas Nosek,L,NJD,32,82,7,11,18
4,8477508,Curtis Lazar,C,NJD,29,82,7,11,18
4,8482259,Bobby McMann,C,TOR,28,82,6,12,18
4,8480336,Sean Walker,D,COL,30,82,5,13,18
4,8483495,Simon Nemec,D,NJD,20,82,5,13,18
4,8479976,Juuso Valimaki,D,ARI,26,82,4,14,18
4,8482105,Jake Sanderson,D,OTT,22,82,2,16,18
4,8482733,Logan Mailloux,D,MTL,31,82,2,16,18
4,8483466,Kevin Korchinski,D,CHI,20,82,2,16,18
4,8483490,Pavel Mintyukov,D,ANA,21,82,2,16,18
4,8478443,Brandon Carlo,D,BOS,28,82,1,17,18
4,8476822,Luke Glendening,C,TBL,35,82,7,10,17
4,8481522,Peyton Krebs,C,BUF,23,82,5,12,17
4,8478416,Erik Cernak,D,TBL,27,82,4,13,17
4,8470966,Mark Giordano,D,TOR,41,82,4,13,17
4,8482245,Artem Zub,D,OTT,29,82,4,13,17
4,8477505,Alexander Wennberg,C,NYR,30,82,4,13,17
4,8479442,Troy Stecher,D,EDM,30,82,4,13,17
4,8476429,Scott Mayfield,D,NYI,32,82,3,14,17
4,8478851,Alexandre Carrier,D,NSH,28,82,2,15,17
4,8482712,Oskar Olausson,R,COL,22,82,2,15,17
4,8475324,Nick Jensen,D,WSH,34,82,1,16,17
4,8477450,Jason Dickinson,C,CHI,29,82,10,6,16
4,8476624,Barclay Goodrow,C,NYR,31,82,7,9,16
4,8479291,Kevin Rooney,C,CGY,31,82,6,10,16
4,8481568,Alex Vlasic,D,CHI,23,82,5,11,16
4,8475188,Brayden McNabb,D,VGK,33,82,5,11,16
4,8482516,Matthew Kessel,D,STL,24,82,4,12,16
4,8471677,Jack Johnson,D,COL,37,82,3,13,16
4,8476473,Connor Murphy,D,CHI,31,82,2,14,16
4,8482807,Ethan Del Mastro,D,CHI,21,82,2,14,16
4,8480448,Parker Kelly,L,OTT,25,82,9,6,15
4,8473504,Cal Clutterbuck,R,NYI,37,82,8,7,15
4,8480172,Jan Rutta,D,SJS,34,82,5,10,15
4,8480796,Martin Fehervary,D,WSH,25,82,4,11,15
4,8477335,Kyle Burroughs,D,SJS,29,82,4,11,15
4,8482858,Ryker Evans,D,SEA,23,82,4,11,15
4,8480834,Ty Emberson,D,SJS,24,82,3,12,15
4,8481605,Jackson LaCombe,D,ANA,23,82,3,12,15
4,8480058,Pierre-Olivier Joseph,D,PIT,25,82,3,12,15
4,8479383,Boris Katchouk,L,OTT,26,82,4,10,14
4,8483468,Jiri Kulich,C,BUF,20,82,4,10,14
4,8474009,Nick Bonino,C,NYR,36,82,3,11,14
4,8478451,Ethan Bear,D,WSH,27,82,3,11,14
4,8480879,Jacob Bernard-Docker,D,OTT,24,82,3,11,14
4,8476467,Jamie Oleksiak,D,SEA,32,82,2,12,14
4,8481567,Henry Thrun,D,SJS,23,82,2,12,14
4,8474673,TJ Brodie,D,TOR,34,82,1,13,14
4,8476858,Phillip Di Giuseppe,L,VAN,31,82,7,6,13
4,8483012,Logan Morrison,C,SEA,22,82,7,6,13
4,8478831,Kevin Stenlund,C,FLA,28,82,6,7,13
4,8479998,Mikey Anderson,D,LAK,25,82,5,8,13
4,8475825,Jani Hakanpää,D,DAL,32,82,3,10,13
4,8482470,Ilya Solovyov,D,CGY,24,82,2,11,13
4,8475208,Brian Dumoulin,D,SEA,33,82,0,13,13
4,8483565,Nick Blankenburg,D,CBJ,26,82,6,6,12
4,8474013,Ian Cole,D,VAN,35,82,6,6,12
4,8477034,Jaycob Megna,D,CHI,32,82,5,7,12
4,8483763,Maksymilian Szuber,D,ARI,22,82,4,8,12
4,8476915,Jujhar Khaira,L,MIN,30,82,4,8,12
4,8474567,Zach Bogosian,D,MIN,34,82,3,9,12
4,8480860,Kevin Bahl,D,NJD,24,82,3,9,12
4,8481030,Jack St. Ivany,D,PIT,25,82,2,10,12
4,8480990,Declan Chisholm,D,MIN,24,82,3,8,11
4,8478408,Travis Dermott,D,ARI,28,82,2,9,11
4,8475762,Derek Forbort,D,BOS,32,82,2,9,11
4,8484911,Collin Graf,R,SJS,22,82,1,10,11
4,8482177,Marat Khusnutdinov,C,MIN,22,82,1,10,11
4,8483489,Fraser Minten,C,TOR,31,82,6,4,10
4,8482666,Scott Morrow,D,CAR,22,82,4,6,10
4,8475455,Brenden Dillon,D,WPG,34,82,1,9,10
4,8482859,Zack Ostapchuk,C,OTT,21,82,3,5,8
4,8484149,Gavin Brindley,C,CBJ,20,82,2,6,8
4,8482713,Mackie Samoskevich,R,FLA,22,82,3,4,7
4,8481599,Victor Soderstrom,D,ARI,23,82,0,7,7
4,8477499,Rasmus Ristolainen,D,PHI,30,82,3,3,6
4,8482762,Simon Edvinsson,D,DET,21,82,2,4,6
4,8481578,Graeme Clarke,R,NJD,23,82,2,4,6
4,8482141,Lukas Cormier,D,VGK,22,0,0,0,0
4,8476988,Matt Benning,D,SJS,30,0,0,0,0
4,8480727,Zach Whitecloud,D,VGK,28,0,0,0,0
4,8480887,Jordan Harris,D,MTL,24,0,0,0,0
4,8478450,Parker Wotherspoon,D,BOS,27,0,0,0,0
4,8481812,Nikolai Knyzhov,D,SJS,27,0,0,0,0
4,8480001,Urho Vaakanainen,D,ANA,25,0,0,0,0
4,8482176,Wyatt Kaiser,D,CHI,22,0,0,0,0
4,8481122,Simon Benoit,D,TOR,26,0,0,0,0
4,8476441,Joel Edmundson,D,TOR,31,0,0,0,0
4,8480884,Calen Addison,D,SJS,24,0,0,0,0
4,8482511,Mason Lohrei,D,BOS,23,0,0,0,0
4,8482192,Isaak Phillips,D,CHI,23,0,0,0,0
4,8480950,Ilya Lyubushkin,D,TOR,30,0,0,0,0
4,8474031,Kevin Shattenkirk,D,BOS,35,0,0,0,0
4,8475718,Justin Holl,D,DET,32,0,0,0,0
4,8479402,Jake Bean,D,CBJ,26,0,0,0,0
4,8474602,Justin Schultz,D,SEA,34,0,0,0,0
4,8477950,Tony DeAngelo,D,CAR,29,0,0,0,0
4,8481743,Marc Del Gaizo,D,NSH,25,0,0,0,0
4,8481527,Kaedan Korczak,D,VGK,23,0,0,0,0
4,8480192,Johnathan Kovacevic,D,MTL,27,0,0,0,0
4,8476874,Olli Maatta,D,DET,30,0,0,0,0
4,8482144,Jack Thompson,D,SJS,22,0,0,0,0
4,8480222,Sebastian Aho,D,NYI,28,0,0,0,0
4,8479458,Nikita Zaitsev,D,CHI,33,0,0,0,0
4,8471709,Marc-Edouard Vlasic,D,SJS,37,0,0,0,0
4,8482929,Emil Lilleberg,D,TBL,23,0,0,0,0
4,8477018,Ben Hutton,D,VGK,31,0,0,0,0
4,8481056,Spencer Stastney,D,NSH,24,0,0,0,0
4,8481593,Jayden Struble,D,MTL,23,0,0,0,0
4,8479982,Conor Timmins,D,TOR,26,0,0,0,0
4,8474090,Brendan Smith,D,NJD,35,0,0,0,0
4,8482964,Arber Xhekaj,D,MTL,23,0,0,0,0
4,8480891,Michael Kesselring,D,ARI,24,0,0,0,0
4,8477938,Haydn Fleury,D,TBL,28,0,0,0,0
4,8481806,Louis Crevier,D,CHI,23,0,0,0,0
4,8471274,Alex Goligoski,D,MIN,39,0,0,0,0
4,8481600,Tobias Bjornfot,D,FLA,23,0,0,0,0
4,8475797,Jarred Tinordi,D,CHI,32,0,0,0,0
4,8481521,Ronnie Attard,D,PHI,25,0,0,0,0
4,8474612,Travis Hamonic,D,OTT,34,0,0,0,0
4,8479576,Vincent Desharnais,D,EDM,28,0,0,0,0
4,8480049,Dylan Samberg,D,WPG,25,0,0,0,0
4,8483619,Filip Roos,D,CHI,25,0,0,0,0
4,8474568,Luke Schenn,D,NSH,35,0,0,0,0
4,8480184,Gustav Lindstrom,D,ANA,26,0,0,0,0
4,8480070,Ian Mitchell,D,BOS,25,0,0,0,0
4,8480196,Jacob Bryson,D,BUF,27,0,0,0,0
4,8471686,Marc Staal,D,PHI,37,0,0,0,0
4,8477467,Gustav Olofsson,D,SEA,30,0,0,0,0
4,8478970,Jalen Chatfield,D,CAR,28,0,0,0,0
4,8479348,Kale Clague,D,BUF,26,0,0,0,0
4,8473446,Erik Johnson,D,PHI,36,0,0,0,0
4,8477462,Robert Hagg,D,ANA,29,0,0,0,0
4,8478454,Noah Juulsen,D,VAN,27,0,0,0,0
4,8477384,Josh Brown,D,ARI,30,0,0,0,0
4,8481708,Zac Jones,D,NYR,24,0,0,0,0
4,8481167,Brayden Pachal,D,CGY,25,0,0,0,0
4,8482067,Connor Mackey,D,NYR,28,0,0,0,0
4,8483460,David Jiricek,D,CBJ,21,0,0,0,0
4,8481701,Santeri Hatakka,D,NJD,23,0,0,0,0
4,8478021,William Lagesson,D,ANA,28,0,0,0,0
4,8477851,Jordan Oesterle,D,CGY,32,0,0,0,0
4,8478452,Caleb Jones,D,COL,27,0,0,0,0
4,8479984,Cal Foote,D,NJD,26,0,0,0,0
4,8479639,Dylan Coghlan,D,CAR,26,0,0,0,0
4,8480874,Adam Ginning,D,PHI,24,0,0,0,0
4,8479321,Lucas Johansen,D,WSH,27,0,0,0,0
4,8480878,Nils Lundkvist,D,DAL,24,0,0,0,0
4,8482165,Yan Kuznetsov,D,CGY,22,0,0,0,0
4,8484258,Sam Malinski,D,COL,26,0,0,0,0
4,8480157,Calle Rosen,D,STL,30,0,0,0,0
4,8484304,Uvis Balinskis,D,FLA,28,0,0,0,0
4,8479985,Cale Fleury,D,SEA,26,0,0,0,0
4,8479378,Logan Stanley,D,WPG,26,0,0,0,0
4,8477541,Dakota Mermis,D,MIN,30,0,0,0,0
4,8481609,Vladislav Kolyachonok,D,ARI,23,0,0,0,0
4,8480823,Alexander Alexeyev,D,WSH,25,0,0,0,0
4,8481679,Maxence Guenette,D,OTT,23,0,0,0,0
4,8481564,Ryan Johnson,D,BUF,23,0,0,0,0
4,8479376,Victor Mete,D,PHI,26,0,0,0,0
4,8484254,Akito Hirose,D,VAN,25,0,0,0,0
4,8482660,Kent Johnson,C,CBJ,22,0,0,0,0
4,8482149,Cole Perfetti,C,WPG,22,0,0,0,0
4,8477987,Ryan Donato,C,CHI,28,0,0,0,0
4,8475755,Alexander Petrovic,D,DAL,32,0,0,0,0
4,8477810,Joel Hanley,D,CGY,33,0,0,0,0
4,8474145,Robert Bortuzzo,D,NYI,35,0,0,0,0
4,8481161,Jake Christiansen,D,CBJ,25,0,0,0,0
4,8476884,Derrick Pouliot,D,DAL,30,0,0,0,0
4,8481716,Dmitri Voronkov,L,CBJ,24,0,0,0,0
4,8480084,Nick DeSimone,D,NJD,30,0,0,0,0
4,8475750,Jon Merrill,D,MIN,32,0,0,0,0
4,8479315,Joey Anderson,R,CHI,26,0,0,0,0
4,8478011,Louie Belpedio,D,PHI,28,0,0,0,0
4,8482451,Mikael Pyyhtia,L,CBJ,23,0,0,0,0
4,8481541,Samuel Bolduc,D,NYI,24,0,0,0,0
4,8482126,Emil Andrae,D,PHI,31,0,0,0,0
4,8474618,Marco Scandella,D,STL,34,0,0,0,0
4,8477244,Chad Ruhwedel,D,NYR,34,0,0,0,0
4,8477971,Andreas Englund,D,LAK,28,0,0,0,0
4,8480829,Jesperi Kotkaniemi,C,CAR,24,0,0,0,0
4,8479372,Josh Mahura,D,FLA,26,0,0,0,0
4,8482095,Tyler Kleven,D,OTT,22,0,0,0,0
4,8481719,Maxwell Crozier,D,TBL,24,0,0,0,0
4,8475855,Jesper Fast,R,CAR,33,0,0,0,0
4,8480848,Ty Dellandrea,C,DAL,24,0,0,0,0
4,8475193,Tomas Tatar,L,SEA,34,0,0,0,0
4,8476889,Radek Faksa,C,DAL,30,0,0,0,0
4,8478495,Denis Gurianov,R,PHI,27,0,0,0,0
4,8480216,Jacob Peterson,C,SJS,25,0,0,0,0
4,8480252,Cole Guttman,C,CHI,25,0,0,0,0
4,8479026,Philippe Myers,D,TBL,27,0,0,0,0
4,8481006,Tyler Tucker,D,STL,24,0,0,0,0
4,8481032,Paul Cotter,C,VGK,25,0,0,0,0
4,8481577,Philip Tomasino,C,NSH,23,0,0,0,0
4,8476918,Jimmy Vesey,L,NYR,31,0,0,0,0
4,8479320,Max Lajoie,D,TOR,27,0,0,0,0
4,8478017,Mark Friedman,D,VAN,29,0,0,0,0
4,8481754,Nikita Nesterenko,C,ANA,23,0,0,0,0
4,8483407,Brandon Scanlin,D,NYR,25,0,0,0,0
4,8482659,Josh Doan,R,ARI,22,0,0,0,0
4,8477446,Michael McCarron,R,NSH,29,0,0,0,0
4,8477903,Garnet Hathaway,R,PHI,33,0,0,0,0
4,8482153,Brendan Brisson,C,VGK,23,0,0,0,0
4,8483546,Marshall Rifai,D,TOR,26,0,0,0,0
4,8484287,Cole McWard,D,VAN,23,0,0,0,0
4,8478854,Ryan Shea,D,PIT,27,0,0,0,0
4,8481585,Egor Afanasyev,L,NSH,23,0,0,0,0
4,8483398,Declan Carlile,D,TBL,31,0,0,0,0
4,8478502,Dennis Gilbert,D,CGY,28,0,0,0,0
4,8482749,Joshua Roy,R,MTL,21,0,0,0,0
4,8481598,Philip Broberg,D,EDM,23,0,0,0,0
4,8480835,Jack Drury,C,CAR,24,0,0,0,0
4,8480748,Kiefer Sherwood,L,NSH,29,0,0,0,0
4,8476934,Brock McGinn,L,ANA,30,0,0,0,0
4,8480870,Bo Groulx,C,ANA,24,0,0,0,0
4,8479368,Max Jones,L,ANA,26,0,0,0,0
4,8478099,Kevin Labanc,R,SJS,29,0,0,0,0
4,8478067,Oskar Lindblom,L,SJS,28,0,0,0,0
4,8476393,Nick Cousins,C,FLA,31,0,0,0,0
4,8483395,Arshdeep Bains,L,VAN,23,0,0,0,0
4,8480762,Eric Robinson,L,BUF,29,0,0,0,0
4,8479439,Jacob MacDonald,D,SJS,31,0,0,0,0
4,8476474,Stefan Noesen,R,CAR,31,0,0,0,0
4,8482787,Nikita Chibrikov,R,WPG,31,0,0,0,0
4,8478432,Christian Fischer,R,DET,27,0,0,0,0
4,8477979,Nicolas Aube-Kubel,R,WSH,28,0,0,0,0
4,8481789,Tye Kartye,L,SEA,23,0,0,0,0
4,8479330,Brandon Gignac,C,MTL,27,0,0,0,0
4,8480075,Cameron Crotty,D,ARI,25,0,0,0,0
4,8473473,Milan Lucic,L,BOS,36,0,0,0,0
4,8482094,Daemon Hunt,D,MIN,22,0,0,0,0
4,8481206,John Ludvig,D,PIT,24,0,0,0,0
4,8483630,Pavol Regenda,L,ANA,25,0,0,0,0
4,8481617,Vasily Podkolzin,R,VAN,23,0,0,0,0
4,8480306,Grant Hutton,D,NYI,29,0,0,0,0
4,8480995,Pontus Holmberg,R,TOR,25,0,0,0,0
4,8482148,Hendrix Lapierre,C,WSH,22,0,0,0,0
4,8477478,William Carrier,L,VGK,30,0,0,0,0
4,8480003,Jesper Boqvist,C,BOS,26,0,0,0,0
4,8482172,Landon Slaggert,L,CHI,22,0,0,0,0
4,8480789,Oliver Wahlstrom,R,NYI,24,0,0,0,0
4,8474062,Riley Nash,C,NYR,35,0,0,0,0
4,8480021,Jack Studnicka,C,SJS,25,0,0,0,0
4,8480025,MacKenzie Entwistle,R,CHI,25,0,0,0,0
4,8481582,Nicholas Robertson,L,TOR,23,0,0,0,0
4,8476867,Brendan Gaunce,C,CBJ,30,0,0,0,0
4,8479619,Michael Carcone,L,ARI,28,0,0,0,0
4,8479370,Tyson Jost,C,BUF,26,0,0,0,0
4,8479671,Mathieu Olivier,R,CBJ,27,0,0,0,0
4,8476994,Vinnie Hinostroza,C,PIT,30,0,0,0,0
4,8482070,Mitchell Chaffee,R,TBL,26,0,0,0,0
4,8477473,Justin Bailey,R,SJS,29,0,0,0,0
4,8479344,Jesse Puljujarvi,R,PIT,26,0,0,0,0
4,8480205,Emil Bemstrom,C,PIT,25,0,0,0,0
4,8479718,Alex Barré-Boulet,C,TBL,27,0,0,0,0
4,8482061,Brandon Biro,L,BUF,26,0,0,0,0
4,8479638,Justin Brazeau,R,BOS,26,0,0,0,0
4,8474040,Sam Gagner,C,EDM,35,0,0,0,0
4,8477846,Ryan Carpenter,C,SJS,33,0,0,0,0
4,8482077,Dylan Holloway,L,EDM,23,0,0,0,0
4,8482157,Will Cuylle,L,NYR,22,0,0,0,0
4,8480007,Jonas Rondbjerg,R,VGK,25,0,0,0,0
4,8478874,Adam Gaudette,C,STL,28,0,0,0,0
4,8478434,Keegan Kolesar,R,VGK,27,0,0,0,0
4,8480441,Trey Fix-Wolansky,R,CBJ,25,0,0,0,0
4,8479994,Jaret Anderson-Dolan,C,NSH,25,0,0,0,0
4,8483567,Georgii Merkulov,C,BOS,24,0,0,0,0
4,8477380,Jonny Brodzinski,C,NYR,31,0,0,0,0
4,8482201,Gage Goncalves,C,TBL,23,0,0,0,0
4,8478211,Dryden Hunt,L,CGY,29,0,0,0,0
4,8471699,Andrew Cogliano,C,COL,37,0,0,0,0
4,8479421,Jacob Moverare,D,LAK,26,0,0,0,0
4,8478881,Brett Seney,L,CHI,28,0,0,0,0
4,8477464,Nic Petan,C,MIN,29,0,0,0,0
4,8475958,Michael Sgarbossa,C,WSH,32,0,0,0,0
4,8481147,Reese Johnson,C,CHI,26,0,0,0,0
4,8479336,Carl Grundstrom,R,LAK,27,0,0,0,0
4,8480853,Liam Foudy,C,NSH,24,0,0,0,0
4,8479522,Hardy Haman Aktell,D,WSH,26,0,0,0,0
4,8481462,Mason Morelli,L,VGK,28,0,0,0,0
4,8482102,Vasily Ponomarev,C,CAR,22,0,0,0,0
4,8480844,Grigori Denisenko,L,VGK,24,0,0,0,0
4,8479944,Zach Aston-Reese,C,DET,30,0,0,0,0
4,8482784,Zach Dean,C,STL,21,0,0,0,0
4,8479419,Brett Murray,L,BUF,26,0,0,0,0
4,8479520,Brandon Duhaime,R,COL,27,0,0,0,0
4,8477573,Nathan Walker,L,STL,30,0,0,0,0
4,8478078,Rourke Chartier,C,OTT,28,0,0,0,0
4,8475795,Dylan McIlrath,D,WSH,32,0,0,0,0
4,8482496,Nils Aman,C,VAN,24,0,0,0,0
4,8480289,Morgan Barron,C,WPG,26,0,0,0,0
4,8481751,Lukas Rousek,R,BUF,25,0,0,0,0
4,8480011,Klim Kostin,C,SJS,25,0,0,0,0
4,8481556,John Beecher,C,BOS,23,0,0,0,0
4,8475278,Byron Froese,C,VGK,33,0,0,0,0
4,8475225,Craig Smith,C,DAL,35,0,0,0,0
4,8484326,Patrik Koch,D,ARI,28,0,0,0,0
4,8477930,Pierre-Edouard Bellemare,L,SEA,39,0,0,0,0
4,8478409,Anthony Richard,C,BOS,28,0,0,0,0
4,8481024,Linus Karlsson,C,VAN,25,0,0,0,0
4,8479986,Kole Lind,R,SEA,26,0,0,0,0
4,8479414,Nathan Bastian,R,NJD,27,0,0,0,0
4,8479362,Riley Tufte,L,COL,26,0,0,0,0
4,8481058,Jesse Ylönen,R,MTL,25,0,0,0,0
4,8482476,Emil Heineman,L,MTL,23,0,0,0,0
4,8482861,Vincent Iorio,D,WSH,22,0,0,0,0
4,8483432,Luca Del Bel Belluz,C,CBJ,31,0,0,0,0
4,8482744,James Malatesta,L,CBJ,21,0,0,0,0
4,8477887,Patrick Brown,C,BOS,32,0,0,0,0
4,8478585,Derek Ryan,C,EDM,38,0,0,0,0
4,8481441,Joe Snively,C,WSH,28,0,0,0,0
4,8481592,Jakob Pelletier,L,CGY,23,0,0,0,0
4,8482634,Alex Steeves,C,TOR,25,0,0,0,0
4,8477126,Jayson Megna,C,BOS,34,0,0,0,0
4,8475752,Tyler Pitlick,C,NYR,33,0,0,0,0
4,8480008,Adam Ruzicka,C,ARI,25,0,0,0,0
4,8481065,Angus Crookshank,L,OTT,25,0,0,0,0
4,8479547,Matthew Phillips,R,WSH,26,0,0,0,0
4,8480226,Marián Studenic,R,SEA,26,0,0,0,0
4,8481237,Kyle MacLean,C,NYI,25,0,0,0,0
4,8475413,Justin Dowling,C,NJD,34,0,0,0,0
4,8481641,Joel Kiviranta,L,COL,28,0,0,0,0
4,8478104,Sammy Blais,L,STL,28,0,0,0,0
4,8477454,Adam Erne,L,EDM,29,0,0,0,0
4,8481518,Nolan Foote,L,NJD,24,0,0,0,0
4,8480245,Olle Lycksell,R,PHI,25,0,0,0,0
4,8483570,Ben Meyers,C,ANA,26,0,0,0,0
4,8480776,Sheldon Rempal,R,VGK,29,0,0,0,0
4,8483920,Pierrick Dube,R,WSH,23,0,0,0,0
4,8480267,Sammy Walker,C,MIN,25,0,0,0,0
4,8482747,Brennan Othmann,L,NYR,21,0,0,0,0
4,8479991,Jake Leschyshyn,C,NYR,25,0,0,0,0
4,8478400,Colin White,C,MTL,27,0,0,0,0
4,8479328,Julien Gauthier,R,NYI,27,0,0,0,0
4,8484325,Waltteri Merela,C,TBL,26,0,0,0,0
4,8479066,Ryan Lomberg,L,FLA,30,0,0,0,0
4,8477070,Liam O'Brien,C,ARI,30,0,0,0,0
4,8478146,Matthew Highmore,C,OTT,28,0,0,0,0
4,8478028,Fredrik Olofsson,L,COL,28,0,0,0,0
4,8480880,Jakub Lauko,C,BOS,24,0,0,0,0
4,8479968,Vinni Lettieri,C,MIN,29,0,0,0,0
4,8474709,Matt Martin,L,NYI,35,0,0,0,0
4,8480845,Rasmus Kupari,C,WPG,24,0,0,0,0
4,8481550,Adam Beckman,L,MIN,23,0,0,0,0
4,8481422,Jacob Lucchini,C,MIN,29,0,0,0,0
4,8477401,John Hayden,C,SEA,29,0,0,0,0
4,8478904,Steven Lorentz,C,FLA,28,0,0,0,0
4,8482088,Justin Sourdif,R,FLA,22,0,0,0,0
4,8482751,Ryan Winterton,C,SEA,21,0,0,0,0
4,8482241,Radim Zohorna,L,PIT,28,0,0,0,0
4,8481690,Tyler Angle,C,CBJ,24,0,0,0,0
4,8476952,Dominic Toninato,C,WPG,30,0,0,0,0
4,8476919,Chris Tierney,C,NJD,30,0,0,0,0
4,8480032,Shane Bowers,C,NJD,25,0,0,0,0
4,8484314,Jiri Smejkal,L,OTT,28,0,0,0,0
4,8481239,Samuel Fagemo,L,LAK,24,0,0,0,0
4,8481532,Alex Turcotte,C,LAK,23,0,0,0,0
4,8481019,David Gustafsson,C,WPG,24,0,0,0,0
4,8478477,Mitchell Stephens,C,MTL,27,0,0,0,0
4,8479546,Oskar Steen,C,BOS,26,0,0,0,0
4,8480292,Carson Meyer,R,CBJ,27,0,0,0,0
4,8478446,Glenn Gawdin,C,ANA,27,0,0,0,0
4,8483531,Brian Halonen,L,NJD,25,0,0,0,0
4,8477149,Scott Sabourin,R,SJS,32,0,0,0,0
4,8479972,Mason Shaw,C,MIN,26,0,0,0,0
4,8480890,Jan Jenik,R,ARI,24,0,0,0,0
4,8478051,Max Willman,C,NJD,29,0,0,0,0
4,8480851,Akil Thomas,C,LAK,24,0,0,0,0
4,8482765,Isak Rosen,R,BUF,21,0,0,0,0
4,8478421,A.J. Greer,L,CGY,28,0,0,0,0
4,8478512,Austin Czarnik,C,DET,32,0,0,0,0
4,8479536,Axel Jonsson-Fjallby,L,WPG,26,0,0,0,0
4,8477320,Anton Blidh,L,NYR,29,0,0,0,0
4,8481543,Nikita Alexandrov,C,STL,24,0,0,0,0
4,8475235,Nicolas Deslauriers,L,PHI,33,0,0,0,0
4,8481070,Hugh McGing,L,STL,26,0,0,0,0
4,8480836,Jonathan Gruden,C,PIT,24,0,0,0,0
4,8481591,Sam Poulin,R,PIT,23,0,0,0,0
4,8477962,Brendan Lemieux,L,CAR,28,0,0,0,0
4,8483401,Marc Johnstone,R,PIT,28,0,0,0,0
4,8482250,Callahan Burke,C,CAR,27,0,0,0,0
4,8481726,Adam Edstrom,C,NYR,24,0,0,0,0
4,8471817,Ryan Reaves,R,TOR,37,0,0,0,0
4,8479587,Rhett Gardner,C,PHI,28,0,0,0,0
4,8475766,Austin Watson,L,TBL,32,0,0,0,0
4,8479367,William Lockwood,R,FLA,26,0,0,0,0
4,8478424,Jansen Harkins,C,PIT,27,0,0,0,0
4,8476913,Devin Shore,C,SEA,30,0,0,0,0
4,8482652,Walker Duehr,R,CGY,27,0,0,0,0
4,8477527,Ross Johnston,L,ANA,30,0,0,0,0
4,8481077,John Leonard,L,ARI,26,0,0,0,0
4,8483549,Lucas Condotta,L,MTL,27,0,0,0,0
4,8480468,James Hamblin,L,EDM,25,0,0,0,0
4,8476907,Mackenzie MacEachern,L,STL,30,0,0,0,0
4,8479543,Michael Pezzetta,L,MTL,26,0,0,0,0
4,8480355,Mark Kastelic,C,OTT,25,0,0,0,0
4,8482162,Roby Jarventie,L,OTT,22,0,0,0,0
4,8479772,Zack MacEwen,R,OTT,28,0,0,0,0
4,8483597,Milos Kelemen,L,ARI,25,0,0,0,0
4,8479379,Givani Smith,R,SJS,26,0,0,0,0
4,8481655,Cole Schwindt,R,CGY,23,0,0,0,0
4,8479981,Jonah Gadjovich,L,FLA,26,0,0,0,0
4,8482147,Jean-Luc Foudy,C,COL,22,0,0,0,0
4,8484255,Jason Polin,R,COL,25,0,0,0,0
4,8477993,Justin Kirkland,C,ARI,28,0,0,0,0
4,8479249,Andrew Poturalski,C,SEA,30,0,0,0,0
4,8482197,Adam Raska,R,MIN,23,0,0,0,0
4,8475780,Chris Wagner,R,COL,33,0,0,0,0
4,8479533,Joona Koppanen,L,PIT,26,0,0,0,0
4,8481534,Raphael Lavoie,C,EDM,24,0,0,0,0
4,8484321,Nikolas Matinpalo,D,OTT,26,0,0,0,0
4,8481043,Cole Koepke,L,TBL,26,0,0,0,0
4,8476323,Max McCormick,L,SEA,32,0,0,0,0
4,8483609,Adam Klapka,R,CGY,24,0,0,0,0
4,8483512,Matt Savoie,C,BUF,20,0,0,0,0
4,8484259,Ondrej Pavel,C,COL,31,0,0,0,0
4,8478147,Bokondji Imama,L,OTT,28,0,0,0,0
4,8482460,Matt Rempe,C,NYR,22,0,0,0,0
4,8477073,Kurtis MacDermid,L,NJD,30,0,0,0,0
4,8480274,Philip Kemp,D,EDM,25,0,0,0,0
4,8478956,Samuel Laberge,L,NJD,27,0,0,0,0
4,8483045,Cameron Butler,R,CBJ,31,0,0,0,0
5,8476453,Nikita Kucherov,R,TBL,31,82,44,98,142
5,8478402,Connor McDavid,C,EDM,27,82,37,92,129
5,8479318,Auston Matthews,C,TOR,27,82,62,53,115
5,8477492,Nathan MacKinnon,C,COL,29,82,46,63,109
5,8481559,Jack Hughes,C,NJD,23,82,44,65,109
5,8477956,David Pastrnak,R,BOS,28,82,47,60,107
5,8478550,Artemi Panarin,L,NYR,33,82,42,61,103
5,8479314,Matthew Tkachuk,L,FLA,27,82,37,63,100
5,8478420,Mikko Rantanen,R,COL,28,82,44,55,99
5,8475166,John Tavares,C,TOR,34,82,52,46,98
5,8478864,Kirill Kaprizov,L,MIN,27,82,47,48,95
5,8477934,Leon Draisaitl,C,EDM,29,82,32,59,91
5,8476887,Filip Forsberg,L,NSH,30,82,53,37,90
5,8480027,Jason Robertson,L,DAL,25,82,36,52,88
5,8471675,Sidney Crosby,C,PIT,37,82,35,53,88
5,8477939,William Nylander,R,TOR,28,82,39,48,87
5,8479343,Clayton Keller,R,ARI,26,82,36,50,86
5,8474600,Roman Josi,D,NSH,34,82,24,59,83
5,8477946,Dylan Larkin,C,DET,28,82,43,39,82
5,8480801,Brady Tkachuk,L,OTT,25,82,32,49,81
5,8480002,Nico Hischier,C,NJD,25,82,26,55,81
5,8482116,Tim Stützle,C,OTT,22,82,26,55,81
5,8478427,Sebastian Aho,C,CAR,27,82,42,38,80
5,8481557,Matt Boldy,L,MIN,23,82,37,43,80
5,8477404,Jake Guentzel,C,CAR,30,82,27,52,79
5,8478445,Mathew Barzal,C,NYI,27,82,26,53,79
5,8474564,Steven Stamkos,C,TBL,34,82,35,43,78
5,8477942,Kevin Fiala,L,LAK,28,82,29,49,78
5,8473419,Brad Marchand,L,BOS,36,82,28,50,78
5,8479407,Jesper Bratt,L,NJD,26,82,31,46,77
5,8479337,Alex DeBrincat,R,DET,27,82,27,50,77
5,8476346,Johnny Gaudreau,L,CBJ,31,82,26,51,77
5,8481523,Kirby Dach,C,MTL,23,82,18,59,77
5,8481540,Cole Caufield,R,MTL,23,82,40,36,76
5,8478010,Brayden Point,C,TBL,28,82,37,38,75
5,8478493,Joel Eriksson Ek,C,MIN,27,82,36,39,75
5,8478439,Travis Konecny,R,PHI,27,82,34,41,75
5,8480069,Cale Makar,D,COL,26,82,26,49,75
5,8480208,Drake Batherson,R,OTT,26,82,32,42,74
5,8478042,Viktor Arvidsson,R,LAK,31,82,30,43,73
5,8477493,Aleksander Barkov,C,FLA,29,82,29,44,73
5,8480012,Elias Pettersson,C,VAN,26,82,28,45,73
5,8480018,Nick Suzuki,C,MTL,25,82,28,45,73
5,8476468,J.T. Miller,C,VAN,31,82,21,52,73
5,8480839,Rasmus Dahlin,D,BUF,24,82,18,55,73
5,8480800,Quinn Hughes,D,VAN,25,82,12,61,73
5,8476460,Mark Scheifele,C,WPG,31,82,32,40,72
5,8478398,Kyle Connor,L,WPG,28,82,31,41,72
5,8471215,Evgeni Malkin,C,PIT,38,82,29,42,71
5,8471214,Alex Ovechkin,L,WSH,39,82,37,33,70
5,8478414,Timo Meier,R,NJD,28,82,33,37,70
5,8479542,Brandon Hagel,L,TBL,26,82,29,41,70
5,8478440,Dylan Strome,C,WSH,27,82,26,44,70
5,8475692,Mats Zuccarello,R,MIN,37,82,16,54,70
5,8477933,Sam Reinhart,C,FLA,29,82,34,35,69
5,8475172,Nazem Kadri,C,CGY,34,82,27,42,69
5,8479385,Jordan Kyrou,C,STL,26,82,31,37,68
5,8478407,Vince Dunn,D,SEA,28,82,22,46,68
5,8480803,Evan Bouchard,D,EDM,25,82,22,46,68
5,8475169,Evander Kane,L,EDM,33,82,38,29,67
5,8478444,Brock Boeser,R,VAN,27,82,31,36,67
5,8476389,Vincent Trocheck,C,NYR,31,82,29,38,67
5,8476456,Jonathan Huberdeau,C,CGY,31,82,19,48,67
5,8475184,Chris Kreider,L,NYR,33,82,38,28,66
5,8475754,Brock Nelson,C,NYI,33,82,33,33,66
5,8478403,Jack Eichel,C,VGK,28,82,26,40,66
5,8480865,Noah Dobson,D,NYI,24,82,14,52,66
5,8479323,Adam Fox,D,NYR,26,82,9,57,66
5,8474679,Gustav Nyquist,C,NSH,35,82,21,44,65
5,8475913,Mark Stone,R,VGK,32,82,32,32,64
5,8482740,Wyatt Johnston,C,DAL,21,82,29,35,64
5,8482093,Seth Jarvis,C,CAR,22,82,27,37,64
5,8474141,Patrick Kane,R,DET,36,82,26,38,64
5,8477940,Nikolaj Ehlers,L,WPG,28,82,26,38,64
5,8482684,Luke Hughes,D,NJD,21,82,18,46,64
5,8477935,Sam Bennett,C,FLA,28,82,39,24,63
5,8477500,Bo Horvat,C,NYI,29,82,32,31,63
5,8475786,Zach Hyman,L,EDM,32,82,31,32,63
5,8480830,Andrei Svechnikov,R,CAR,24,82,26,37,63
5,8475170,Brayden Schenn,C,STL,33,82,26,37,63
5,8476454,Ryan Nugent-Hopkins,C,EDM,31,82,19,44,63
5,8480036,Miro Heiskanen,D,DAL,25,82,18,45,63
5,8479410,Mikhail Sergachev,D,TBL,26,82,12,51,63
5,8476853,Morgan Rielly,D,TOR,30,82,8,55,63
5,8476539,Jonathan Marchessault,R,VGK,34,82,30,32,62
5,8477501,Valeri Nichushkin,R,COL,29,82,28,34,62
5,8475158,Ryan O'Reilly,C,NSH,33,82,25,37,62
5,8473512,Claude Giroux,R,OTT,36,82,24,38,62
5,8480023,Robert Thomas,C,STL,25,82,18,44,62
5,8477447,Shea Theodore,D,VGK,29,82,13,49,62
5,8477960,Adrian Kempe,R,LAK,28,82,28,33,61
5,8475791,Taylor Hall,L,CHI,33,82,26,35,61
5,8477451,Ryan Hartman,R,MIN,30,82,22,39,61
5,8480064,Josh Norris,C,OTT,25,82,28,32,60
5,8482745,Mason McTavish,C,ANA,21,82,27,33,60
5,8471685,Anze Kopitar,C,LAK,37,82,20,40,60
5,8482665,Matty Beniers,C,SEA,22,82,20,40,60
5,8475794,Tyler Seguin,C,DAL,32,82,22,37,59
5,8476459,Mika Zibanejad,C,NYR,31,82,12,47,59
5,8476462,Dougie Hamilton,D,NJD,31,82,29,29,58
5,8482078,Lucas Raymond,L,DET,22,82,27,31,58
5,8477949,Alex Tuch,R,BUF,28,82,26,32,58
5,8477416,Oliver Bjorkstrand,R,SEA,29,82,24,34,58
5,8475168,Matt Duchene,C,DAL,33,82,19,39,58
5,8475798,Mikael Granlund,C,SJS,32,82,15,43,58
5,8475167,Victor Hedman,D,TBL,34,82,10,48,58
5,8482159,Tyson Foerster,R,PHI,22,82,24,33,57
5,8477402,Pavel Buchnevich,L,STL,29,82,18,39,57
5,8481068,Yegor Sharangovich,C,CGY,26,82,27,29,56
5,8483808,Andrei Kuzmenko,L,CGY,28,82,27,29,56
5,8470794,Joe Pavelski,C,DAL,40,82,24,32,56
5,8480797,Joel Farabee,L,PHI,24,82,22,34,56
5,8475765,Vladimir Tarasenko,R,FLA,33,82,13,43,56
5,8475810,Bryan Rust,R,PIT,32,82,35,20,55
5,8482097,Jack Quinn,R,BUF,23,82,24,31,55
5,8477409,Carter Verhaeghe,C,FLA,29,82,23,32,55
5,8481528,Dylan Cozens,C,BUF,23,82,23,32,55
5,8478047,Michael Bunting,L,PIT,29,82,21,34,55
5,8477951,Nick Schmaltz,C,ARI,28,82,20,35,55
5,8476479,Phillip Danault,C,LAK,31,82,20,35,55
5,8478873,Troy Terry,R,ANA,27,82,27,27,54
5,8475726,Tyler Toffoli,C,WPG,32,82,26,28,54
5,8475784,Jeff Skinner,C,BUF,32,82,23,31,54
5,8476880,Tom Wilson,R,WSH,30,82,21,33,54
5,8477476,Artturi Lehkonen,L,COL,29,82,20,34,54
5,8480039,Martin Necas,C,CAR,25,82,16,38,54
5,8479400,Pierre-Luc Dubois,L,LAK,26,82,21,32,53
5,8475745,Charlie Coyle,C,BOS,32,82,21,32,53
5,8478401,Pavel Zacha,C,BOS,27,82,19,34,53
5,8482124,Quinton Byfield,R,LAK,22,82,19,34,53
5,8478472,Mathieu Joseph,R,OTT,27,82,18,35,53
5,8474590,John Carlson,D,WSH,34,82,14,39,53
5,8476432,Boone Jenner,C,CBJ,31,82,31,21,52
5,8478233,Andrew Mangiapane,L,CGY,28,82,27,25,52
5,8478366,Frank Vatrano,R,ANA,30,82,26,26,52
5,8479345,Jakob Chychrun,D,OTT,26,82,26,26,52
5,8480015,Owen Tippett,R,PHI,25,82,25,27,52
5,8478438,Tommy Novak,C,NSH,27,82,22,30,52
5,8481533,Trevor Zegras,C,ANA,23,82,16,36,52
5,8474578,Erik Karlsson,D,PIT,34,82,12,40,52
5,8481542,Moritz Seider,D,DET,23,82,12,40,52
5,8478449,Roope Hintz,C,DAL,28,82,26,25,51
5,8476448,William Karlsson,C,VGK,31,82,24,27,51
5,8476881,Tomas Hertl,C,VGK,31,82,24,27,51
5,8477955,Jared McCann,L,SEA,28,82,20,31,51
5,8476872,Scott Laughton,C,PHI,30,82,12,39,51
5,8478469,Thomas Chabot,D,OTT,27,82,11,40,51
5,8476906,Shayne Gostisbehere,D,DET,31,82,7,44,51
5,8475314,Anders Lee,L,NYI,34,82,29,21,50
5,8474157,Max Pacioretty,L,WSH,36,82,24,26,50
5,8482699,Dylan Guenther,R,ARI,21,82,23,27,50
5,8479420,Tage Thompson,C,BUF,27,82,22,28,50
5,8475287,Erik Haula,L,NJD,33,82,19,31,50
5,8477479,Tyler Bertuzzi,L,TOR,29,82,19,31,50
5,8481711,Matias Maccelli,L,ARI,24,82,14,36,50
5,8476875,Mike Matheson,D,MTL,30,82,11,39,50
5,8477346,MacKenzie Weegar,D,CGY,30,82,11,39,50
5,8478460,Zach Werenski,D,CBJ,27,82,10,40,50
5,8478397,Rasmus Andersson,D,CGY,28,82,9,41,50
5,8480014,Gabriel Vilardi,C,WPG,25,82,35,14,49
5,8478498,Jake DeBrusk,L,BOS,28,82,19,30,49
5,8475744,Evgeny Kuznetsov,C,CAR,32,82,17,32,49
5,8481699,Aku Raty,R,ARI,23,82,2,47,49
5,8481560,Arthur Kaliyev,R,LAK,23,82,25,23,48
5,8476399,Blake Coleman,C,CGY,33,82,23,25,48
5,8479339,Patrik Laine,L,CBJ,26,82,21,27,48
5,8479675,Trevor Moore,L,LAK,29,82,20,28,48
5,8478891,Mason Appleton,C,WPG,28,82,16,32,48
5,8477504,Josh Morrissey,D,WPG,29,82,12,36,48
5,8480434,Sean Durzi,D,ARI,26,82,12,36,48
5,8471724,Kris Letang,D,PIT,37,82,10,38,48
5,8474563,Drew Doughty,D,LAK,35,82,9,39,48
5,8483397,Marc McLaughlin,C,BOS,25,82,39,8,47
5,8477407,Anthony Duclair,L,TBL,29,82,23,24,47
5,8474586,Jordan Eberle,R,SEA,34,82,18,29,47
5,8473986,Alex Killorn,L,ANA,35,82,17,30,47
5,8481618,Alex Newhook,C,MTL,23,82,16,31,47
5,8478463,Anthony Beauvillier,L,NSH,27,82,16,31,47
5,8477495,Seth Jones,D,CHI,30,82,13,34,47
5,8480078,Filip Chytil,C,NYR,25,82,12,35,47
5,8479325,Charlie McAvoy,D,BOS,27,82,7,40,47
5,8477497,Sean Monahan,C,WPG,30,82,24,22,46
5,8476438,Brandon Saad,L,STL,32,82,21,25,46
5,8482113,Anton Lundell,C,FLA,23,82,20,26,46
5,8471698,T.J. Oshie,R,WSH,38,82,20,26,46
5,8476882,Teuvo Teravainen,L,CAR,30,82,19,27,46
5,8480188,Fabian Zetterlund,L,SJS,25,82,15,31,46
5,8476905,Chandler Stephenson,C,VGK,30,82,13,33,46
5,8474053,Logan Couture,C,SJS,35,82,20,25,45
5,8478975,Mason Marchment,L,DAL,29,82,18,27,45
5,8474102,David Perron,L,DET,36,82,17,28,45
5,8481596,Shane Pinto,C,OTT,24,82,16,29,45
5,8473994,Jamie Benn,L,DAL,35,82,16,29,45
5,8477456,J.T. Compher,L,DET,29,82,15,30,45
5,8479999,Casey Mittelstadt,C,COL,26,82,14,31,45
5,8480031,Maxime Comtois,L,CAR,25,82,9,36,45
5,8476792,Torey Krug,D,STL,33,82,9,36,45
5,8475197,Tyson Barrie,D,NSH,33,82,6,39,45
5,8475151,Kyle Palmieri,C,NYI,33,82,23,21,44
5,8480817,K'Andre Miller,D,NYR,24,82,17,27,44
5,8475714,Calle Jarnkrok,C,TOR,33,82,16,28,44
5,8483445,Cutter Gauthier,L,ANA,20,82,12,32,44
5,8477444,Andre Burakovsky,L,SEA,29,82,10,34,44
5,8483524,Shane Wright,C,SEA,20,82,34,9,43
5,8475760,Nick Bjugstad,C,ARI,32,82,26,17,43
5,8482133,Thomas Bordeleau,C,SJS,22,82,19,24,43
5,8476826,Yanni Gourde,C,SEA,33,82,19,24,43
5,8477998,Warren Foegele,L,EDM,28,82,18,25,43
5,8480798,Philipp Kurashev,C,CHI,25,82,15,28,43
5,8473563,Nicklas Backstrom,C,WSH,37,82,15,28,43
5,8474565,Alex Pietrangelo,D,VGK,34,82,14,29,43
5,8477503,Max Domi,C,TOR,29,82,12,31,43
5,8477986,Brandon Montour,D,FLA,30,82,10,33,43
5,8475764,Cam Fowler,D,ANA,33,82,8,35,43
5,8482055,Drew O'Connor,L,PIT,26,82,26,16,42
5,8478856,Conor Garland,R,VAN,28,82,19,23,42
5,8480849,Barrett Hayton,C,ARI,24,82,19,23,42
5,8484144,Connor Bedard,C,CHI,19,82,16,26,42
5,8478542,Evan Rodrigues,C,FLA,31,82,16,26,42
5,8474150,Mikael Backlund,C,CGY,35,82,14,28,42
5,8476458,Ryan Strome,C,ANA,31,82,14,28,42
5,8480220,Noah Cates,L,PHI,25,82,12,30,42
5,8477021,Alex Kerfoot,C,ARI,30,82,9,33,42
5,8478396,Noah Hanifin,D,VGK,27,82,7,35,42
5,8483457,Lane Hutson,D,MTL,20,82,5,37,42
5,8477944,Jakub Vrana,L,STL,28,82,26,15,41
5,8482101,Danil Gushchin,L,SJS,22,82,23,18,41
5,8475191,Reilly Smith,R,PIT,33,82,18,23,41
5,8477947,Sonny Milano,L,WSH,28,82,16,25,41
5,8475763,Kevin Hayes,R,STL,32,82,13,28,41
5,8470613,Brent Burns,D,CAR,39,82,12,29,41
5,8475753,Justin Faulk,D,STL,32,82,12,29,41
5,8482105,Jake Sanderson,D,OTT,22,82,9,32,41
5,8477494,Jonathan Drouin,L,COL,29,82,8,33,41
5,8478055,Gustav Forsling,D,FLA,28,82,8,33,41
5,8478038,Devon Toews,D,COL,30,82,8,33,41
5,8481581,Thomas Harley,D,DAL,23,82,7,34,41
5,8482733,Logan Mailloux,D,MTL,31,82,7,34,41
5,8482109,Alexis Lafrenière,L,NYR,23,82,22,18,40
5,8482667,William Eklund,L,SJS,22,82,20,20,40
5,8477496,Elias Lindholm,C,VAN,30,82,16,24,40
5,8478458,Jack Roslovic,C,NYR,27,82,16,24,40
5,8476854,Hampus Lindholm,D,BOS,30,82,11,29,40
5,8479987,Morgan Geekie,C,BOS,26,82,9,31,40
5,8481604,Pavel Dorofeyev,L,VGK,24,82,24,15,39
5,8478466,Daniel Sprong,R,DET,27,82,20,19,39
5,8474641,Adam Henrique,C,EDM,34,82,18,21,39
5,8476483,Rickard Rakell,R,PIT,31,82,15,24,39
5,8477450,Jason Dickinson,C,CHI,29,82,15,24,39
5,8482079,Marco Rossi,C,MIN,23,82,13,26,39
5,8477932,Aaron Ekblad,D,FLA,28,82,10,29,39
5,8481546,Cam York,D,PHI,23,82,10,29,39
5,8482671,Owen Power,D,BUF,22,82,9,30,39
5,8478046,Danton Heinen,L,BOS,29,82,16,22,38
5,8482705,Cole Sillinger,C,CBJ,21,82,14,24,38
5,8471218,Blake Wheeler,R,NYR,38,82,12,26,38
5,8475218,Mattias Ekholm,D,EDM,34,82,11,27,38
5,8477948,Travis Sanheim,D,PHI,28,82,10,28,38
5,8478413,Jordan Greenway,L,BUF,27,82,16,21,37
5,8475768,Jaden Schwartz,C,SEA,32,82,15,22,37
5,8481656,Aliaksei Protas,C,WSH,23,82,13,24,37
5,8480873,Rasmus Sandin,D,WSH,24,82,8,29,37
5,8475906,John Klingberg,D,TOR,32,82,8,29,37
5,8476869,Brady Skjei,D,CAR,30,82,7,30,37
5,8479425,Filip Hronek,D,VAN,27,82,6,31,37
5,8481016,Ruslan Iskhakov,C,NYI,24,82,5,32,37
5,8482089,Jake Neighbours,L,STL,22,82,20,16,36
5,8477426,Nicholas Paul,L,TBL,29,82,19,17,36
5,8482110,Dawson Mercer,C,NJD,23,82,17,19,36
5,8479365,Trent Frederic,C,BOS,26,82,15,21,36
5,8477511,Anthony Mantha,R,VGK,30,82,14,22,36
5,8484145,Zach Benson,L,BUF,19,82,14,22,36
5,8482117,Lukas Reichel,L,CHI,22,82,13,23,36
5,8479525,Ross Colton,C,COL,28,82,23,12,35
5,8478057,Dakota Joshua,C,VAN,28,82,20,15,35
5,8478474,Lawson Crouse,L,ARI,27,82,19,16,35
5,8476925,Colton Sissons,C,NSH,31,82,18,17,35
5,8476960,Andreas Athanasiou,C,CHI,30,82,14,21,35
5,8474037,James van Riemsdyk,L,BOS,35,82,13,22,35
5,8475722,Jason Zucker,L,NSH,32,82,12,23,35
5,8477498,Darnell Nurse,D,EDM,29,82,11,24,35
5,8480871,Adam Boqvist,D,CBJ,24,82,7,28,35
5,8483471,Brad Lambert,C,WPG,31,82,0,35,35
5,8477964,Ivan Barbashev,C,VGK,29,82,14,20,34
5,8476480,Vladislav Namestnikov,C,WPG,32,82,14,20,34
5,8481186,Logan O'Connor,R,COL,28,82,14,20,34
5,8482475,Yegor Chinakhov,R,CBJ,23,82,10,24,34
5,8479359,Beck Malenstyn,L,WSH,26,82,10,24,34
5,8482222,Alexander Barabanov,L,SJS,30,82,9,25,34
5,8474151,Ryan McDonagh,D,NSH,35,82,5,29,34
5,8483431,Logan Cooley,C,ARI,20,82,19,14,33
5,8480806,Isac Lundestrom,C,ANA,25,82,16,17,33
5,8484153,Leo Carlsson,C,ANA,20,82,15,18,33
5,8476958,Jaccob Slavin,D,CAR,30,82,10,23,33
5,8476292,Ondrej Palat,L,NJD,33,82,10,23,33
5,8476392,Adam Lowry,C,WPG,31,82,9,24,33
5,8476917,Adam Pelech,D,NYI,30,82,3,30,33
5,8478519,Anthony Cirelli,C,TBL,27,82,14,18,32
5,8476871,Tanner Pearson,L,MTL,32,82,13,19,32
5,8475799,Nino Niederreiter,R,WPG,32,82,13,19,32
5,8470966,Mark Giordano,D,TOR,41,82,12,20,32
5,8477429,Andrew Copp,C,DET,30,82,11,21,32
5,8479992,Michael Rasmussen,C,DET,25,82,11,21,32
5,8475149,Marcus Johansson,L,MIN,34,82,11,21,32
5,8479976,Juuso Valimaki,D,ARI,26,82,11,21,32
5,8482092,Ridly Greig,C,OTT,22,82,10,22,32
5,8476463,Jonas Brodin,D,MIN,31,82,9,23,32
5,8480802,Ryan McLeod,C,EDM,25,82,7,25,32
5,8482655,J.J. Moser,D,ARI,24,82,7,25,32
5,8480043,Timothy Liljegren,D,TOR,25,82,6,26,32
5,8474716,Jared Spurgeon,D,MIN,35,82,6,26,32
5,8478851,Alexandre Carrier,D,NSH,28,82,5,27,32
5,8482624,Daniil Miromanov,D,CGY,27,82,4,28,32
5,8481535,Nils Hoglander,L,VAN,24,82,18,13,31
5,8474870,Tyler Johnson,C,CHI,34,82,17,14,31
5,8481624,Ilya Mikheyev,R,VAN,30,82,17,14,31
5,8475848,Brendan Gallagher,R,MTL,32,82,16,15,31
5,8483505,Matthew Poitras,C,BOS,20,82,16,15,31
5,8473533,Jordan Staal,C,CAR,36,82,16,15,31
5,8482175,JJ Peterka,R,BUF,22,82,15,16,31
5,8480185,Eetu Luostarinen,C,FLA,26,82,15,16,31
5,8473449,Kyle Okposo,R,FLA,36,82,14,17,31
5,8479996,Cody Glass,C,NSH,25,82,11,20,31
5,8476885,Jacob Trouba,D,NYR,30,82,11,20,31
5,8482122,Brock Faber,D,MIN,22,82,5,26,31
5,8478911,Matt Roy,D,LAK,29,82,5,26,31
5,8477488,Brett Pesce,D,CAR,30,82,2,29,31
5,8481554,Kaapo Kakko,R,NYR,23,82,21,9,30
5,8478133,Jake Evans,C,MTL,28,82,14,16,30
5,8476469,Joel Armia,R,MTL,31,82,14,16,30
5,8482146,Luke Evangelista,R,NSH,22,82,11,19,30
5,8480009,Eeli Tolvanen,R,SEA,25,82,10,20,30
5,8479398,Samuel Girard,D,COL,26,82,8,22,30
5,8478462,Nicolas Roy,C,VGK,27,82,8,22,30
5,8476927,Teddy Blueger,C,VAN,30,82,7,23,30
5,8476525,Colin Miller,D,WPG,32,82,6,24,30
5,8483493,Frank Nazar,C,CHI,20,82,22,7,29
5,8475793,Ryan Johansen,C,PHI,32,82,17,12,29
5,8479293,Brandon Tanev,L,SEA,33,82,17,12,29
5,8478020,Michael Amadio,C,VGK,28,82,16,13,29
5,8476873,Mark Jankowski,C,NSH,30,82,16,13,29
5,8479390,Taylor Raddysh,R,CHI,26,82,13,16,29
5,8478115,Pierre Engvall,L,NYI,28,82,12,17,29
5,8480145,Neal Pionk,D,WPG,29,82,11,18,29
5,8473422,Nick Foligno,L,CHI,37,82,9,20,29
5,8476923,Damon Severson,D,CBJ,30,82,8,21,29
5,8475171,Oliver Ekman-Larsson,D,FLA,33,82,6,23,29
5,8482720,Matthew Knies,L,TOR,22,82,5,24,29
5,8480336,Sean Walker,D,COL,30,82,5,24,29
5,8477989,Christian Dvorak,C,MTL,28,82,17,11,28
5,8475343,Nic Dowd,C,WSH,34,82,15,13,28
5,8480893,Kirill Marchenko,R,CBJ,24,82,14,14,28
5,8479941,Justin Danforth,R,CBJ,31,82,11,17,28
5,8480459,Pius Suter,C,VAN,28,82,10,18,28
5,8476329,Travis Boyd,C,ARI,31,82,9,19,28
5,8478013,Jake Walman,D,DET,28,82,8,20,28
5,8483565,Nick Blankenburg,D,CBJ,26,82,7,21,28
5,8480028,Morgan Frost,C,PHI,25,82,6,22,28
5,8475181,Nick Leddy,D,STL,33,82,3,25,28
5,8478882,Vladislav Gavrikov,D,LAK,29,82,3,25,28
5,8481568,Alex Vlasic,D,CHI,23,82,2,26,28
5,8476981,Josh Anderson,R,MTL,30,82,19,8,27
5,8474884,Mike Hoffman,C,SJS,35,82,16,11,27
5,8478109,Victor Olofsson,L,BUF,29,82,15,12,27
5,8482259,Bobby McMann,C,TOR,28,82,15,12,27
5,8479316,Luke Kunin,C,SJS,27,82,12,15,27
5,8479977,Kailer Yamamoto,R,SEA,26,82,12,15,27
5,8476419,Jean-Gabriel Pageau,C,NYI,32,82,9,18,27
5,8481013,Jonatan Berggren,R,DET,24,82,8,19,27
5,8479980,Nicolas Hague,D,VGK,26,82,8,19,27
5,8482087,Kaiden Guhle,D,MTL,22,82,8,19,27
5,8477506,Ryan Pulock,D,NYI,30,82,7,20,27
5,8480073,Erik Brannstrom,D,OTT,25,82,7,20,27
5,8480113,Alex Iafallo,L,WPG,31,82,6,21,27
5,8483482,Tristan Luneau,D,ANA,20,82,6,21,27
5,8481606,Jordan Spence,D,LAK,23,82,5,22,27
5,8476429,Scott Mayfield,D,NYI,32,82,4,23,27
5,8475179,Dmitry Kulikov,D,FLA,34,82,3,24,27
5,8476931,Jake McCabe,D,TOR,31,82,2,25,27
5,8477952,Robby Fabbri,C,DET,28,82,15,11,26
5,8476921,Jordan Martinook,L,CAR,32,82,13,13,26
5,8478569,Noel Acciari,C,PIT,33,82,13,13,26
5,8478430,Oliver Kylington,D,CGY,27,82,12,14,26
5,8479393,Noah Gregor,C,TOR,26,82,12,14,26
5,8480074,Alexandre Texier,C,CBJ,25,82,11,15,26
5,8481481,Blake Lizotte,C,LAK,27,82,11,15,26
5,8480068,Ryan Poehling,C,PHI,25,82,10,16,26
5,8482730,Brandt Clarke,D,LAK,21,82,10,16,26
5,8479346,Dillon Dube,C,CGY,26,82,8,18,26
5,8480035,Henri Jokiharju,D,BUF,25,82,6,20,26
5,8481703,Valtteri Puustinen,R,PIT,25,82,5,21,26
5,8482145,Mavrik Bourque,C,DAL,22,82,20,5,25
5,8479423,Alex Nylander,L,CBJ,26,82,17,8,25
5,8480281,Alexey Toropchenko,R,STL,25,82,13,12,25
5,8474189,Lars Eller,C,PIT,35,82,11,14,25
5,8477330,Dominik Kubalik,L,OTT,29,82,11,14,25
5,8479415,Michael McLeod,C,NJD,26,82,10,15,25
5,8482111,Justin Barron,D,MTL,23,82,10,15,25
5,8482062,Cole Smith,L,NSH,29,82,8,17,25
5,8478500,Ivan Provorov,D,CBJ,27,82,7,18,25
5,8476892,Colton Parayko,D,STL,31,82,6,19,25
5,8477425,Miles Wood,L,COL,29,82,6,19,25
5,8478507,John Marino,D,NJD,27,82,4,21,25
5,8478840,Will Borgen,D,SEA,28,82,2,23,25
5,8477919,Frederick Gaudreau,C,MIN,31,82,17,7,24
5,8475231,Casey Cizikas,C,NYI,33,82,16,8,24
5,8484203,Bradly Nadeau,L,CAR,19,82,15,9,24
5,8480821,Filip Zadina,R,SJS,25,82,14,10,24
5,8470610,Zach Parise,L,COL,40,82,14,10,24
5,8482679,Matt Coronato,R,CGY,22,82,14,10,24
5,8477953,Kasperi Kapanen,R,STL,28,82,12,12,24
5,8476374,Sean Kuraly,C,CBJ,31,82,12,12,24
5,8474715,Cam Atkinson,R,PHI,35,82,12,12,24
5,8481093,Rafael Harvey-Pinard,L,MTL,25,82,11,13,24
5,8481028,Martin Pospisil,C,CGY,25,82,11,13,24
5,8481553,Bobby Brink,R,PHI,23,82,10,14,24
5,8476897,Oskar Sundqvist,C,STL,30,82,9,15,24
5,8482142,Jamie Drysdale,D,PHI,22,82,9,15,24
5,8474149,Evgenii Dadonov,R,DAL,35,82,7,17,24
5,8481477,Nico Sturm,C,SJS,29,82,6,18,24
5,8476331,Dylan DeMelo,D,WPG,31,82,6,18,24
5,8481537,Nikita Okhotiuk,D,CGY,24,82,6,18,24
5,8479369,Andrew Peeke,D,BOS,26,82,5,19,24
5,8477435,Ryan Graves,D,PIT,29,82,2,22,24
5,8473453,Trevor Lewis,C,LAK,37,82,16,7,23
5,8470621,Corey Perry,R,EDM,39,82,13,10,23
5,8480855,Jack McBain,C,ARI,24,82,11,12,23
5,8479353,Brett Howden,C,VGK,26,82,10,13,23
5,8476461,Sean Couturier,C,PHI,32,82,8,15,23
5,8478451,Ethan Bear,D,WSH,27,82,7,16,23
5,8478831,Kevin Stenlund,C,FLA,28,82,7,16,23
5,8476891,Matt Grzelcyk,D,BOS,30,82,6,17,23
5,8478416,Erik Cernak,D,TBL,27,82,4,19,23
5,8478399,Jonas Siegenthaler,D,NJD,27,82,3,20,23
5,8480058,Pierre-Olivier Joseph,D,PIT,25,82,3,20,23
5,8476467,Jamie Oleksiak,D,SEA,32,82,3,20,23
5,8479998,Mikey Anderson,D,LAK,25,82,2,21,23
5,8481580,Connor McMichael,C,WSH,23,82,13,9,22
5,8483515,Juraj Slafkovsky,L,MTL,20,82,12,10,22
5,8481601,Simon Holmstrom,R,NYI,23,82,10,12,22
5,8482666,Scott Morrow,D,CAR,22,82,10,12,22
5,8480144,David Kampf,C,TOR,29,82,9,13,22
5,8476442,Matt Nieto,L,PIT,32,82,8,14,22
5,8483763,Maksymilian Szuber,D,ARI,22,82,8,14,22
5,8476422,Mike Reilly,D,NYI,31,82,7,15,22
5,8475690,Chris Tanev,D,DAL,35,82,6,16,22
5,8476979,Erik Gustafsson,D,NYR,32,82,5,17,22
5,8478178,Darren Raddysh,D,TBL,28,82,3,19,22
5,8480246,Nick Perbix,D,TBL,26,82,2,20,22
5,8481517,Brett Leason,R,ANA,25,82,13,8,21
5,8479661,Tanner Jeannot,L,TBL,27,82,13,8,21
5,8482074,Connor Zary,C,CGY,23,82,13,8,21
5,8477369,Carson Soucy,D,VAN,30,82,8,13,21
5,8477505,Alexander Wennberg,C,NYR,30,82,8,13,21
5,8474009,Nick Bonino,C,NYR,36,82,8,13,21
5,8476457,Adam Larsson,D,SEA,32,82,6,15,21
5,8478468,Jeremy Lauzon,D,NSH,27,82,6,15,21
5,8470604,Jeff Carter,C,PIT,39,82,5,16,21
5,8480834,Ty Emberson,D,SJS,24,82,4,17,21
5,8477845,Trevor van Riemsdyk,D,WSH,33,82,3,18,21
5,8474574,Tyler Myers,D,VAN,34,82,3,18,21
5,8475208,Brian Dumoulin,D,SEA,33,82,3,18,21
5,8480448,Parker Kelly,L,OTT,25,82,16,4,20
5,8484166,Adam Fantilli,C,CBJ,20,82,11,9,20
5,8477353,Tyler Motte,C,TBL,29,82,11,9,20
5,8477507,Nikita Zadorov,D,VAN,29,82,10,10,20
5,8477406,Mattias Janmark,C,EDM,32,82,9,11,20
5,8480813,Joe Veleno,C,DET,24,82,8,12,20
5,8477839,Conor Sheary,L,TBL,32,82,7,13,20
5,8477931,Tomas Nosek,L,NJD,32,82,7,13,20
5,8480796,Martin Fehervary,D,WSH,25,82,7,13,20
5,8476879,Cody Ceci,D,EDM,31,82,6,14,20
5,8482073,Braden Schneider,D,NYR,23,82,6,14,20
5,8483466,Kevin Korchinski,D,CHI,20,82,6,14,20
5,8470600,Ryan Suter,D,DAL,39,82,5,15,20
5,8475462,Radko Gudas,D,ANA,34,82,4,16,20
5,8474166,Alec Martinez,D,VGK,37,82,4,16,20
5,8483495,Simon Nemec,D,NJD,20,82,4,16,20
5,8474673,TJ Brodie,D,TOR,34,82,2,18,20
5,8475188,Brayden McNabb,D,VGK,33,82,1,19,20
5,8482118,Sam Colangelo,R,ANA,23,82,14,5,19
5,8482702,Logan Stankoven,C,DAL,21,82,13,6,19
5,8483499,Liam Ohgren,L,MIN,20,82,11,8,19
5,8479514,Rem Pitlick,C,CHI,27,82,8,11,19
5,8478408,Travis Dermott,D,ARI,28,82,8,11,19
5,8476372,Nick Seeler,D,PHI,31,82,7,12,19
5,8482245,Artem Zub,D,OTT,29,82,6,13,19
5,8479351,Sam Steel,C,DAL,26,82,5,14,19
5,8482803,Olen Zellweger,D,ANA,21,82,5,14,19
5,8481567,Henry Thrun,D,SJS,23,82,5,14,19
5,8475200,Dmitry Orlov,D,CAR,33,82,4,15,19
5,8482516,Matthew Kessel,D,STL,24,82,4,15,19
5,8481605,Jackson LaCombe,D,ANA,23,82,3,16,19
5,8480860,Kevin Bahl,D,NJD,24,82,3,16,19
5,8475324,Nick Jensen,D,WSH,34,82,1,18,19
5,8476902,Esa Lindell,D,DAL,30,82,0,19,19
5,8482125,Alexander Holtz,R,NJD,22,82,10,8,18
5,8475842,Sam Carrick,C,EDM,32,82,10,8,18
5,8479371,Dante Fabbro,D,NSH,26,82,7,11,18
5,8479591,Michael Eyssimont,C,TBL,28,82,7,11,18
5,8479291,Kevin Rooney,C,CGY,31,82,7,11,18
5,8477392,Hudson Fasching,R,NYI,29,82,6,12,18
5,8474013,Ian Cole,D,VAN,35,82,6,12,18
5,8481522,Peyton Krebs,C,BUF,23,82,5,13,18
5,8475220,Marcus Foligno,L,MIN,33,82,4,14,18
5,8481178,Egor Zamula,D,PHI,24,82,4,14,18
5,8483490,Pavel Mintyukov,D,ANA,21,82,4,14,18
5,8479383,Boris Katchouk,L,OTT,26,82,4,14,18
5,8476473,Connor Murphy,D,CHI,31,82,2,16,18
5,8477969,Marcus Pettersson,D,PIT,28,82,1,17,18
5,8480807,Mattias Samuelsson,D,BUF,24,82,1,17,18
5,8482737,Zack Bolduc,C,STL,21,82,10,7,17
5,8476278,Colin Blackwell,C,CHI,31,82,10,7,17
5,8476878,Zemgus Girgensons,L,BUF,30,82,10,7,17
5,8475164,Jakob Silfverberg,R,ANA,34,82,7,10,17
5,8483491,Ivan Miroshnichenko,L,WSH,20,82,7,10,17
5,8481059,Scott Perunovich,D,STL,26,82,5,12,17
5,8480172,Jan Rutta,D,SJS,34,82,5,12,17
5,8478136,Jake Middleton,D,MIN,28,82,4,13,17
5,8481014,Alexander Romanov,D,NYI,24,82,4,13,17
5,8482177,Marat Khusnutdinov,C,MIN,22,82,4,13,17
5,8475279,Ben Chiarot,D,DET,33,82,3,14,17
5,8474567,Zach Bogosian,D,MIN,34,82,3,14,17
5,8475762,Derek Forbort,D,BOS,32,82,3,14,17
5,8482807,Ethan Del Mastro,D,CHI,21,82,2,15,17
5,8480879,Jacob Bernard-Docker,D,OTT,24,82,2,15,17
5,8477365,Connor Clifton,D,BUF,29,82,0,17,17
5,8482809,Jackson Blake,R,CAR,21,82,7,9,16
5,8481524,Bowen Byram,D,BUF,23,82,6,10,16
5,8475455,Brenden Dillon,D,WPG,34,82,4,12,16
5,8476312,Josh Manson,D,COL,33,82,3,13,16
5,8478859,Niko Mikkola,D,FLA,28,82,3,13,16
5,8475233,David Savard,D,MTL,34,82,3,13,16
5,8476624,Barclay Goodrow,C,NYR,31,82,3,13,16
5,8484911,Collin Graf,R,SJS,22,82,2,14,16
5,8483012,Logan Morrison,C,SEA,22,82,10,5,15
5,8481704,Juuso Parssinen,C,NSH,23,82,9,6,15
5,8478043,Sam Lafferty,C,VAN,29,82,9,6,15
5,8478508,Yakov Trenin,C,COL,27,82,8,7,15
5,8476858,Phillip Di Giuseppe,L,VAN,31,82,8,7,15
5,8482166,Shakir Mukhamadullin,D,SJS,22,82,7,8,15
5,8482155,Alex Laferriere,R,LAK,23,82,6,9,15
5,8477015,Connor Brown,R,EDM,30,82,5,10,15
5,8476967,Brett Kulak,D,EDM,30,82,4,11,15
5,8474034,Pat Maroon,L,BOS,36,82,2,13,15
5,8473504,Cal Clutterbuck,R,NYI,37,82,6,8,14
5,8480980,Connor Dewar,C,TOR,25,82,5,9,14
5,8482858,Ryker Evans,D,SEA,23,82,5,9,14
5,8482712,Oskar Olausson,R,COL,22,82,4,10,14
5,8477220,Nate Schmidt,D,WPG,33,82,3,11,14
5,8475825,Jani Hakanpää,D,DAL,32,82,2,12,14
5,8477034,Jaycob Megna,D,CHI,32,82,1,13,14
5,8477508,Curtis Lazar,C,NJD,29,82,7,6,13
5,8475177,Calvin de Haan,D,TBL,33,82,6,7,13
5,8477335,Kyle Burroughs,D,SJS,29,82,5,8,13
5,8476822,Luke Glendening,C,TBL,35,82,7,5,12
5,8482762,Simon Edvinsson,D,DET,21,82,7,5,12
5,8473507,Jeff Petry,D,DET,37,82,3,9,12
5,8475790,Erik Gudbranson,D,CBJ,32,82,3,9,12
5,8482470,Ilya Solovyov,D,CGY,24,82,1,11,12
5,8479324,Ryan Lindgren,D,NYR,26,82,4,7,11
5,8479442,Troy Stecher,D,EDM,30,82,3,8,11
5,8479983,Mario Ferraro,D,SJS,26,82,2,9,11
5,8481578,Graeme Clarke,R,NJD,23,82,5,5,10
5,8478443,Brandon Carlo,D,BOS,28,82,3,7,10
5,8477499,Rasmus Ristolainen,D,PHI,30,82,2,8,10
5,8482713,Mackie Samoskevich,R,FLA,22,82,6,3,9
5,8476915,Jujhar Khaira,L,MIN,30,82,5,4,9
5,8483468,Jiri Kulich,C,BUF,20,82,3,6,9
5,8480990,Declan Chisholm,D,MIN,24,82,1,8,9
5,8482859,Zack Ostapchuk,C,OTT,21,82,4,4,8
5,8471677,Jack Johnson,D,COL,37,82,1,7,8
5,8481030,Jack St. Ivany,D,PIT,25,82,1,7,8
5,8483489,Fraser Minten,C,TOR,31,82,4,2,6
5,8481599,Victor Soderstrom,D,ARI,23,82,1,4,5
5,8484149,Gavin Brindley,C,CBJ,20,82,0,3,3
5,8482141,Lukas Cormier,D,VGK,22,0,0,0,0
5,8476988,Matt Benning,D,SJS,30,0,0,0,0
5,8480727,Zach Whitecloud,D,VGK,28,0,0,0,0
5,8480887,Jordan Harris,D,MTL,24,0,0,0,0
5,8478450,Parker Wotherspoon,D,BOS,27,0,0,0,0
5,8481812,Nikolai Knyzhov,D,SJS,27,0,0,0,0
5,8480001,Urho Vaakanainen,D,ANA,25,0,0,0,0
5,8482176,Wyatt Kaiser,D,CHI,22,0,0,0,0
5,8481122,Simon Benoit,D,TOR,26,0,0,0,0
5,8476441,Joel Edmundson,D,TOR,31,0,0,0,0
5,8480884,Calen Addison,D,SJS,24,0,0,0,0
5,8482511,Mason Lohrei,D,BOS,23,0,0,0,0
5,8482192,Isaak Phillips,D,CHI,23,0,0,0,0
5,8480950,Ilya Lyubushkin,D,TOR,30,0,0,0,0
5,8474031,Kevin Shattenkirk,D,BOS,35,0,0,0,0
5,8475718,Justin Holl,D,DET,32,0,0,0,0
5,8479402,Jake Bean,D,CBJ,26,0,0,0,0
5,8474602,Justin Schultz,D,SEA,34,0,0,0,0
5,8477950,Tony DeAngelo,D,CAR,29,0,0,0,0
5,8481743,Marc Del Gaizo,D,NSH,25,0,0,0,0
5,8481527,Kaedan Korczak,D,VGK,23,0,0,0,0
5,8480192,Johnathan Kovacevic,D,MTL,27,0,0,0,0
5,8476874,Olli Maatta,D,DET,30,0,0,0,0
5,8482144,Jack Thompson,D,SJS,22,0,0,0,0
5,8480222,Sebastian Aho,D,NYI,28,0,0,0,0
5,8479458,Nikita Zaitsev,D,CHI,33,0,0,0,0
5,8471709,Marc-Edouard Vlasic,D,SJS,37,0,0,0,0
5,8482929,Emil Lilleberg,D,TBL,23,0,0,0,0
5,8477018,Ben Hutton,D,VGK,31,0,0,0,0
5,8481056,Spencer Stastney,D,NSH,24,0,0,0,0
5,8481593,Jayden Struble,D,MTL,23,0,0,0,0
5,8479982,Conor Timmins,D,TOR,26,0,0,0,0
5,8474090,Brendan Smith,D,NJD,35,0,0,0,0
5,8482964,Arber Xhekaj,D,MTL,23,0,0,0,0
5,8480891,Michael Kesselring,D,ARI,24,0,0,0,0
5,8477938,Haydn Fleury,D,TBL,28,0,0,0,0
5,8481806,Louis Crevier,D,CHI,23,0,0,0,0
5,8471274,Alex Goligoski,D,MIN,39,0,0,0,0
5,8481600,Tobias Bjornfot,D,FLA,23,0,0,0,0
5,8475797,Jarred Tinordi,D,CHI,32,0,0,0,0
5,8481521,Ronnie Attard,D,PHI,25,0,0,0,0
5,8474612,Travis Hamonic,D,OTT,34,0,0,0,0
5,8479576,Vincent Desharnais,D,EDM,28,0,0,0,0
5,8480049,Dylan Samberg,D,WPG,25,0,0,0,0
5,8483619,Filip Roos,D,CHI,25,0,0,0,0
5,8474568,Luke Schenn,D,NSH,35,0,0,0,0
5,8480184,Gustav Lindstrom,D,ANA,26,0,0,0,0
5,8480070,Ian Mitchell,D,BOS,25,0,0,0,0
5,8480196,Jacob Bryson,D,BUF,27,0,0,0,0
5,8471686,Marc Staal,D,PHI,37,0,0,0,0
5,8477467,Gustav Olofsson,D,SEA,30,0,0,0,0
5,8478970,Jalen Chatfield,D,CAR,28,0,0,0,0
5,8479348,Kale Clague,D,BUF,26,0,0,0,0
5,8473446,Erik Johnson,D,PHI,36,0,0,0,0
5,8477462,Robert Hagg,D,ANA,29,0,0,0,0
5,8478454,Noah Juulsen,D,VAN,27,0,0,0,0
5,8477384,Josh Brown,D,ARI,30,0,0,0,0
5,8481708,Zac Jones,D,NYR,24,0,0,0,0
5,8481167,Brayden Pachal,D,CGY,25,0,0,0,0
5,8482067,Connor Mackey,D,NYR,28,0,0,0,0
5,8483460,David Jiricek,D,CBJ,21,0,0,0,0
5,8481701,Santeri Hatakka,D,NJD,23,0,0,0,0
5,8478021,William Lagesson,D,ANA,28,0,0,0,0
5,8477851,Jordan Oesterle,D,CGY,32,0,0,0,0
5,8478452,Caleb Jones,D,COL,27,0,0,0,0
5,8479984,Cal Foote,D,NJD,26,0,0,0,0
5,8479639,Dylan Coghlan,D,CAR,26,0,0,0,0
5,8480874,Adam Ginning,D,PHI,24,0,0,0,0
5,8479321,Lucas Johansen,D,WSH,27,0,0,0,0
5,8480878,Nils Lundkvist,D,DAL,24,0,0,0,0
5,8482165,Yan Kuznetsov,D,CGY,22,0,0,0,0
5,8484258,Sam Malinski,D,COL,26,0,0,0,0
5,8480157,Calle Rosen,D,STL,30,0,0,0,0
5,8484304,Uvis Balinskis,D,FLA,28,0,0,0,0
5,8479985,Cale Fleury,D,SEA,26,0,0,0,0
5,8479378,Logan Stanley,D,WPG,26,0,0,0,0
5,8477541,Dakota Mermis,D,MIN,30,0,0,0,0
5,8481609,Vladislav Kolyachonok,D,ARI,23,0,0,0,0
5,8480823,Alexander Alexeyev,D,WSH,25,0,0,0,0
5,8481679,Maxence Guenette,D,OTT,23,0,0,0,0
5,8481564,Ryan Johnson,D,BUF,23,0,0,0,0
5,8479376,Victor Mete,D,PHI,26,0,0,0,0
5,8484254,Akito Hirose,D,VAN,25,0,0,0,0
5,8482660,Kent Johnson,C,CBJ,22,0,0,0,0
5,8482149,Cole Perfetti,C,WPG,22,0,0,0,0
5,8477987,Ryan Donato,C,CHI,28,0,0,0,0
5,8475755,Alexander Petrovic,D,DAL,32,0,0,0,0
5,8477810,Joel Hanley,D,CGY,33,0,0,0,0
5,8474145,Robert Bortuzzo,D,NYI,35,0,0,0,0
5,8481161,Jake Christiansen,D,CBJ,25,0,0,0,0
5,8476884,Derrick Pouliot,D,DAL,30,0,0,0,0
5,8481716,Dmitri Voronkov,L,CBJ,24,0,0,0,0
5,8480084,Nick DeSimone,D,NJD,30,0,0,0,0
5,8475750,Jon Merrill,D,MIN,32,0,0,0,0
5,8479315,Joey Anderson,R,CHI,26,0,0,0,0
5,8478011,Louie Belpedio,D,PHI,28,0,0,0,0
5,8482451,Mikael Pyyhtia,L,CBJ,23,0,0,0,0
5,8481541,Samuel Bolduc,D,NYI,24,0,0,0,0
5,8482126,Emil Andrae,D,PHI,31,0,0,0,0
5,8474618,Marco Scandella,D,STL,34,0,0,0,0
5,8477244,Chad Ruhwedel,D,NYR,34,0,0,0,0
5,8477971,Andreas Englund,D,LAK,28,0,0,0,0
5,8480829,Jesperi Kotkaniemi,C,CAR,24,0,0,0,0
5,8479372,Josh Mahura,D,FLA,26,0,0,0,0
5,8482095,Tyler Kleven,D,OTT,22,0,0,0,0
5,8481719,Maxwell Crozier,D,TBL,24,0,0,0,0
5,8475855,Jesper Fast,R,CAR,33,0,0,0,0
5,8480848,Ty Dellandrea,C,DAL,24,0,0,0,0
5,8475193,Tomas Tatar,L,SEA,34,0,0,0,0
5,8476889,Radek Faksa,C,DAL,30,0,0,0,0
5,8478495,Denis Gurianov,R,PHI,27,0,0,0,0
5,8480216,Jacob Peterson,C,SJS,25,0,0,0,0
5,8480252,Cole Guttman,C,CHI,25,0,0,0,0
5,8479026,Philippe Myers,D,TBL,27,0,0,0,0
5,8481006,Tyler Tucker,D,STL,24,0,0,0,0
5,8481032,Paul Cotter,C,VGK,25,0,0,0,0
5,8481577,Philip Tomasino,C,NSH,23,0,0,0,0
5,8476918,Jimmy Vesey,L,NYR,31,0,0,0,0
5,8479320,Max Lajoie,D,TOR,27,0,0,0,0
5,8478017,Mark Friedman,D,VAN,29,0,0,0,0
5,8481754,Nikita Nesterenko,C,ANA,23,0,0,0,0
5,8483407,Brandon Scanlin,D,NYR,25,0,0,0,0
5,8482659,Josh Doan,R,ARI,22,0,0,0,0
5,8477446,Michael McCarron,R,NSH,29,0,0,0,0
5,8477903,Garnet Hathaway,R,PHI,33,0,0,0,0
5,8482153,Brendan Brisson,C,VGK,23,0,0,0,0
5,8483546,Marshall Rifai,D,TOR,26,0,0,0,0
5,8484287,Cole McWard,D,VAN,23,0,0,0,0
5,8478854,Ryan Shea,D,PIT,27,0,0,0,0
5,8481585,Egor Afanasyev,L,NSH,23,0,0,0,0
5,8483398,Declan Carlile,D,TBL,31,0,0,0,0
5,8478502,Dennis Gilbert,D,CGY,28,0,0,0,0
5,8482749,Joshua Roy,R,MTL,21,0,0,0,0
5,8481598,Philip Broberg,D,EDM,23,0,0,0,0
5,8480835,Jack Drury,C,CAR,24,0,0,0,0
5,8480748,Kiefer Sherwood,L,NSH,29,0,0,0,0
5,8476934,Brock McGinn,L,ANA,30,0,0,0,0
5,8480870,Bo Groulx,C,ANA,24,0,0,0,0
5,8479368,Max Jones,L,ANA,26,0,0,0,0
5,8478099,Kevin Labanc,R,SJS,29,0,0,0,0
5,8478067,Oskar Lindblom,L,SJS,28,0,0,0,0
5,8476393,Nick Cousins,C,FLA,31,0,0,0,0
5,8483395,Arshdeep Bains,L,VAN,23,0,0,0,0
5,8480762,Eric Robinson,L,BUF,29,0,0,0,0
5,8479439,Jacob MacDonald,D,SJS,31,0,0,0,0
5,8476474,Stefan Noesen,R,CAR,31,0,0,0,0
5,8482787,Nikita Chibrikov,R,WPG,31,0,0,0,0
5,8478432,Christian Fischer,R,DET,27,0,0,0,0
5,8477979,Nicolas Aube-Kubel,R,WSH,28,0,0,0,0
5,8481789,Tye Kartye,L,SEA,23,0,0,0,0
5,8479330,Brandon Gignac,C,MTL,27,0,0,0,0
5,8480075,Cameron Crotty,D,ARI,25,0,0,0,0
5,8473473,Milan Lucic,L,BOS,36,0,0,0,0
5,8482094,Daemon Hunt,D,MIN,22,0,0,0,0
5,8481206,John Ludvig,D,PIT,24,0,0,0,0
5,8483630,Pavol Regenda,L,ANA,25,0,0,0,0
5,8481617,Vasily Podkolzin,R,VAN,23,0,0,0,0
5,8480306,Grant Hutton,D,NYI,29,0,0,0,0
5,8480995,Pontus Holmberg,R,TOR,25,0,0,0,0
5,8482148,Hendrix Lapierre,C,WSH,22,0,0,0,0
5,8477478,William Carrier,L,VGK,30,0,0,0,0
5,8480003,Jesper Boqvist,C,BOS,26,0,0,0,0
5,8482172,Landon Slaggert,L,CHI,22,0,0,0,0
5,8480789,Oliver Wahlstrom,R,NYI,24,0,0,0,0
5,8474062,Riley Nash,C,NYR,35,0,0,0,0
5,8480021,Jack Studnicka,C,SJS,25,0,0,0,0
5,8480025,MacKenzie Entwistle,R,CHI,25,0,0,0,0
5,8481582,Nicholas Robertson,L,TOR,23,0,0,0,0
5,8476867,Brendan Gaunce,C,CBJ,30,0,0,0,0
5,8479619,Michael Carcone,L,ARI,28,0,0,0,0
5,8479370,Tyson Jost,C,BUF,26,0,0,0,0
5,8479671,Mathieu Olivier,R,CBJ,27,0,0,0,0
5,8476994,Vinnie Hinostroza,C,PIT,30,0,0,0,0
5,8482070,Mitchell Chaffee,R,TBL,26,0,0,0,0
5,8477473,Justin Bailey,R,SJS,29,0,0,0,0
5,8479344,Jesse Puljujarvi,R,PIT,26,0,0,0,0
5,8480205,Emil Bemstrom,C,PIT,25,0,0,0,0
5,8479718,Alex Barré-Boulet,C,TBL,27,0,0,0,0
5,8482061,Brandon Biro,L,BUF,26,0,0,0,0
5,8479638,Justin Brazeau,R,BOS,26,0,0,0,0
5,8474040,Sam Gagner,C,EDM,35,0,0,0,0
5,8477846,Ryan Carpenter,C,SJS,33,0,0,0,0
5,8482077,Dylan Holloway,L,EDM,23,0,0,0,0
5,8482157,Will Cuylle,L,NYR,22,0,0,0,0
5,8480007,Jonas Rondbjerg,R,VGK,25,0,0,0,0
5,8478874,Adam Gaudette,C,STL,28,0,0,0,0
5,8478434,Keegan Kolesar,R,VGK,27,0,0,0,0
5,8480441,Trey Fix-Wolansky,R,CBJ,25,0,0,0,0
5,8479994,Jaret Anderson-Dolan,C,NSH,25,0,0,0,0
5,8483567,Georgii Merkulov,C,BOS,24,0,0,0,0
5,8477380,Jonny Brodzinski,C,NYR,31,0,0,0,0
5,8482201,Gage Goncalves,C,TBL,23,0,0,0,0
5,8478211,Dryden Hunt,L,CGY,29,0,0,0,0
5,8471699,Andrew Cogliano,C,COL,37,0,0,0,0
5,8479421,Jacob Moverare,D,LAK,26,0,0,0,0
5,8478881,Brett Seney,L,CHI,28,0,0,0,0
5,8477464,Nic Petan,C,MIN,29,0,0,0,0
5,8475958,Michael Sgarbossa,C,WSH,32,0,0,0,0
5,8481147,Reese Johnson,C,CHI,26,0,0,0,0
5,8479336,Carl Grundstrom,R,LAK,27,0,0,0,0
5,8480853,Liam Foudy,C,NSH,24,0,0,0,0
5,8479522,Hardy Haman Aktell,D,WSH,26,0,0,0,0
5,8481462,Mason Morelli,L,VGK,28,0,0,0,0
5,8482102,Vasily Ponomarev,C,CAR,22,0,0,0,0
5,8480844,Grigori Denisenko,L,VGK,24,0,0,0,0
5,8479944,Zach Aston-Reese,C,DET,30,0,0,0,0
5,8482784,Zach Dean,C,STL,21,0,0,0,0
5,8479419,Brett Murray,L,BUF,26,0,0,0,0
5,8479520,Brandon Duhaime,R,COL,27,0,0,0,0
5,8477573,Nathan Walker,L,STL,30,0,0,0,0
5,8478078,Rourke Chartier,C,OTT,28,0,0,0,0
5,8475795,Dylan McIlrath,D,WSH,32,0,0,0,0
5,8482496,Nils Aman,C,VAN,24,0,0,0,0
5,8480289,Morgan Barron,C,WPG,26,0,0,0,0
5,8481751,Lukas Rousek,R,BUF,25,0,0,0,0
5,8480011,Klim Kostin,C,SJS,25,0,0,0,0
5,8481556,John Beecher,C,BOS,23,0,0,0,0
5,8475278,Byron Froese,C,VGK,33,0,0,0,0
5,8475225,Craig Smith,C,DAL,35,0,0,0,0
5,8484326,Patrik Koch,D,ARI,28,0,0,0,0
5,8477930,Pierre-Edouard Bellemare,L,SEA,39,0,0,0,0
5,8478409,Anthony Richard,C,BOS,28,0,0,0,0
5,8481024,Linus Karlsson,C,VAN,25,0,0,0,0
5,8479986,Kole Lind,R,SEA,26,0,0,0,0
5,8479414,Nathan Bastian,R,NJD,27,0,0,0,0
5,8479362,Riley Tufte,L,COL,26,0,0,0,0
5,8481058,Jesse Ylönen,R,MTL,25,0,0,0,0
5,8482476,Emil Heineman,L,MTL,23,0,0,0,0
5,8482861,Vincent Iorio,D,WSH,22,0,0,0,0
5,8483432,Luca Del Bel Belluz,C,CBJ,31,0,0,0,0
5,8482744,James Malatesta,L,CBJ,21,0,0,0,0
5,8477887,Patrick Brown,C,BOS,32,0,0,0,0
5,8478585,Derek Ryan,C,EDM,38,0,0,0,0
5,8481441,Joe Snively,C,WSH,28,0,0,0,0
5,8481592,Jakob Pelletier,L,CGY,23,0,0,0,0
5,8482634,Alex Steeves,C,TOR,25,0,0,0,0
5,8477126,Jayson Megna,C,BOS,34,0,0,0,0
5,8475752,Tyler Pitlick,C,NYR,33,0,0,0,0
5,8480008,Adam Ruzicka,C,ARI,25,0,0,0,0
5,8481065,Angus Crookshank,L,OTT,25,0,0,0,0
5,8479547,Matthew Phillips,R,WSH,26,0,0,0,0
5,8480226,Marián Studenic,R,SEA,26,0,0,0,0
5,8481237,Kyle MacLean,C,NYI,25,0,0,0,0
5,8475413,Justin Dowling,C,NJD,34,0,0,0,0
5,8481641,Joel Kiviranta,L,COL,28,0,0,0,0
5,8478104,Sammy Blais,L,STL,28,0,0,0,0
5,8477454,Adam Erne,L,EDM,29,0,0,0,0
5,8481518,Nolan Foote,L,NJD,24,0,0,0,0
5,8480245,Olle Lycksell,R,PHI,25,0,0,0,0
5,8483570,Ben Meyers,C,ANA,26,0,0,0,0
5,8480776,Sheldon Rempal,R,VGK,29,0,0,0,0
5,8483920,Pierrick Dube,R,WSH,23,0,0,0,0
5,8480267,Sammy Walker,C,MIN,25,0,0,0,0
5,8482747,Brennan Othmann,L,NYR,21,0,0,0,0
5,8479991,Jake Leschyshyn,C,NYR,25,0,0,0,0
5,8478400,Colin White,C,MTL,27,0,0,0,0
5,8479328,Julien Gauthier,R,NYI,27,0,0,0,0
5,8484325,Waltteri Merela,C,TBL,26,0,0,0,0
5,8479066,Ryan Lomberg,L,FLA,30,0,0,0,0
5,8477070,Liam O'Brien,C,ARI,30,0,0,0,0
5,8478146,Matthew Highmore,C,OTT,28,0,0,0,0
5,8478028,Fredrik Olofsson,L,COL,28,0,0,0,0
5,8480880,Jakub Lauko,C,BOS,24,0,0,0,0
5,8479968,Vinni Lettieri,C,MIN,29,0,0,0,0
5,8474709,Matt Martin,L,NYI,35,0,0,0,0
5,8480845,Rasmus Kupari,C,WPG,24,0,0,0,0
5,8481550,Adam Beckman,L,MIN,23,0,0,0,0
5,8481422,Jacob Lucchini,C,MIN,29,0,0,0,0
5,8477401,John Hayden,C,SEA,29,0,0,0,0
5,8478904,Steven Lorentz,C,FLA,28,0,0,0,0
5,8482088,Justin Sourdif,R,FLA,22,0,0,0,0
5,8482751,Ryan Winterton,C,SEA,21,0,0,0,0
5,8482241,Radim Zohorna,L,PIT,28,0,0,0,0
5,8481690,Tyler Angle,C,CBJ,24,0,0,0,0
5,8476952,Dominic Toninato,C,WPG,30,0,0,0,0
5,8476919,Chris Tierney,C,NJD,30,0,0,0,0
5,8480032,Shane Bowers,C,NJD,25,0,0,0,0
5,8484314,Jiri Smejkal,L,OTT,28,0,0,0,0
5,8481239,Samuel Fagemo,L,LAK,24,0,0,0,0
5,8481532,Alex Turcotte,C,LAK,23,0,0,0,0
5,8481019,David Gustafsson,C,WPG,24,0,0,0,0
5,8478477,Mitchell Stephens,C,MTL,27,0,0,0,0
5,8479546,Oskar Steen,C,BOS,26,0,0,0,0
5,8480292,Carson Meyer,R,CBJ,27,0,0,0,0
5,8478446,Glenn Gawdin,C,ANA,27,0,0,0,0
5,8483531,Brian Halonen,L,NJD,25,0,0,0,0
5,8477149,Scott Sabourin,R,SJS,32,0,0,0,0
5,8479972,Mason Shaw,C,MIN,26,0,0,0,0
5,8480890,Jan Jenik,R,ARI,24,0,0,0,0
5,8478051,Max Willman,C,NJD,29,0,0,0,0
5,8480851,Akil Thomas,C,LAK,24,0,0,0,0
5,8482765,Isak Rosen,R,BUF,21,0,0,0,0
5,8478421,A.J. Greer,L,CGY,28,0,0,0,0
5,8478512,Austin Czarnik,C,DET,32,0,0,0,0
5,8479536,Axel Jonsson-Fjallby,L,WPG,26,0,0,0,0
5,8477320,Anton Blidh,L,NYR,29,0,0,0,0
5,8481543,Nikita Alexandrov,C,STL,24,0,0,0,0
5,8475235,Nicolas Deslauriers,L,PHI,33,0,0,0,0
5,8481070,Hugh McGing,L,STL,26,0,0,0,0
5,8480836,Jonathan Gruden,C,PIT,24,0,0,0,0
5,8481591,Sam Poulin,R,PIT,23,0,0,0,0
5,8477962,Brendan Lemieux,L,CAR,28,0,0,0,0
5,8483401,Marc Johnstone,R,PIT,28,0,0,0,0
5,8482250,Callahan Burke,C,CAR,27,0,0,0,0
5,8481726,Adam Edstrom,C,NYR,24,0,0,0,0
5,8471817,Ryan Reaves,R,TOR,37,0,0,0,0
5,8479587,Rhett Gardner,C,PHI,28,0,0,0,0
5,8475766,Austin Watson,L,TBL,32,0,0,0,0
5,8479367,William Lockwood,R,FLA,26,0,0,0,0
5,8478424,Jansen Harkins,C,PIT,27,0,0,0,0
5,8476913,Devin Shore,C,SEA,30,0,0,0,0
5,8482652,Walker Duehr,R,CGY,27,0,0,0,0
5,8477527,Ross Johnston,L,ANA,30,0,0,0,0
5,8481077,John Leonard,L,ARI,26,0,0,0,0
5,8483549,Lucas Condotta,L,MTL,27,0,0,0,0
5,8480468,James Hamblin,L,EDM,25,0,0,0,0
5,8476907,Mackenzie MacEachern,L,STL,30,0,0,0,0
5,8479543,Michael Pezzetta,L,MTL,26,0,0,0,0
5,8480355,Mark Kastelic,C,OTT,25,0,0,0,0
5,8482162,Roby Jarventie,L,OTT,22,0,0,0,0
5,8479772,Zack MacEwen,R,OTT,28,0,0,0,0
5,8483597,Milos Kelemen,L,ARI,25,0,0,0,0
5,8479379,Givani Smith,R,SJS,26,0,0,0,0
5,8481655,Cole Schwindt,R,CGY,23,0,0,0,0
5,8479981,Jonah Gadjovich,L,FLA,26,0,0,0,0
5,8482147,Jean-Luc Foudy,C,COL,22,0,0,0,0
5,8484255,Jason Polin,R,COL,25,0,0,0,0
5,8477993,Justin Kirkland,C,ARI,28,0,0,0,0
5,8479249,Andrew Poturalski,C,SEA,30,0,0,0,0
5,8482197,Adam Raska,R,MIN,23,0,0,0,0
5,8475780,Chris Wagner,R,COL,33,0,0,0,0
5,8479533,Joona Koppanen,L,PIT,26,0,0,0,0
5,8481534,Raphael Lavoie,C,EDM,24,0,0,0,0
5,8484321,Nikolas Matinpalo,D,OTT,26,0,0,0,0
5,8481043,Cole Koepke,L,TBL,26,0,0,0,0
5,8476323,Max McCormick,L,SEA,32,0,0,0,0
5,8483609,Adam Klapka,R,CGY,24,0,0,0,0
5,8483512,Matt Savoie,C,BUF,20,0,0,0,0
5,8484259,Ondrej Pavel,C,COL,31,0,0,0,0
5,8478147,Bokondji Imama,L,OTT,28,0,0,0,0
5,8482460,Matt Rempe,C,NYR,22,0,0,0,0
5,8477073,Kurtis MacDermid,L,NJD,30,0,0,0,0
5,8480274,Philip Kemp,D,EDM,25,0,0,0,0
5,8478956,Samuel Laberge,L,NJD,27,0,0,0,0
5,8483045,Cameron Butler,R,CBJ,31,0,0,0,0
6,8479318,Auston Matthews,C,TOR,27,82,77,50,127
6,8476453,Nikita Kucherov,R,TBL,31,82,38,88,126
6,8477492,Nathan MacKinnon,C,COL,29,82,56,60,116
6,8478402,Connor McDavid,C,EDM,27,82,37,78,115
6,8477934,Leon Draisaitl,C,EDM,29,82,40,74,114
6,8481559,Jack Hughes,C,NJD,23,82,44,69,113
6,8478420,Mikko Rantanen,R,COL,28,82,47,64,111
6,8478864,Kirill Kaprizov,L,MIN,27,82,50,53,103
6,8476468,J.T. Miller,C,VAN,31,82,41,58,99
6,8478550,Artemi Panarin,L,NYR,33,82,34,62,96
6,8480027,Jason Robertson,L,DAL,25,82,29,66,95
6,8476887,Filip Forsberg,L,NSH,30,82,42,52,94
6,8477493,Aleksander Barkov,C,FLA,29,82,34,60,94
6,8477933,Sam Reinhart,C,FLA,29,82,52,39,91
6,8480012,Elias Pettersson,C,VAN,26,82,29,62,91
6,8475786,Zach Hyman,L,EDM,32,82,48,41,89
6,8477956,David Pastrnak,R,BOS,28,82,41,48,89
6,8478010,Brayden Point,C,TBL,28,82,43,45,88
6,8480069,Cale Makar,D,COL,26,82,21,66,87
6,8477946,Dylan Larkin,C,DET,28,82,34,52,86
6,8474600,Roman Josi,D,NSH,34,82,23,63,86
6,8479407,Jesper Bratt,L,NJD,26,82,28,57,85
6,8479337,Alex DeBrincat,R,DET,27,82,33,50,83
6,8477939,William Nylander,R,TOR,28,82,31,52,83
6,8475166,John Tavares,C,TOR,34,82,39,43,82
6,8479314,Matthew Tkachuk,L,FLA,27,82,34,47,81
6,8477496,Elias Lindholm,C,VAN,30,82,29,52,81
6,8481557,Matt Boldy,L,MIN,23,82,28,53,81
6,8476460,Mark Scheifele,C,WPG,31,82,28,53,81
6,8475172,Nazem Kadri,C,CGY,34,82,25,56,81
6,8479343,Clayton Keller,R,ARI,26,82,25,55,80
6,8477494,Jonathan Drouin,L,COL,29,82,24,56,80
6,8479385,Jordan Kyrou,C,STL,26,82,29,50,79
6,8482116,Tim Stützle,C,OTT,22,82,26,53,79
6,8476462,Dougie Hamilton,D,NJD,31,82,21,56,77
6,8478407,Vince Dunn,D,SEA,28,82,18,58,76
6,8477942,Kevin Fiala,L,LAK,28,82,33,42,75
6,8473419,Brad Marchand,L,BOS,36,82,27,48,75
6,8478427,Sebastian Aho,C,CAR,27,82,22,53,75
6,8481523,Kirby Dach,C,MTL,23,82,9,66,75
6,8478398,Kyle Connor,L,WPG,28,82,34,40,74
6,8480830,Andrei Svechnikov,R,CAR,24,82,33,41,74
6,8479420,Tage Thompson,C,BUF,27,82,30,44,74
6,8477404,Jake Guentzel,C,CAR,30,82,27,47,74
6,8480800,Quinn Hughes,D,VAN,25,82,8,66,74
6,8474141,Patrick Kane,R,DET,36,82,30,43,73
6,8479323,Adam Fox,D,NYR,26,82,16,57,73
6,8474564,Steven Stamkos,C,TBL,34,82,27,45,72
6,8476456,Jonathan Huberdeau,C,CGY,31,82,18,54,72
6,8478449,Roope Hintz,C,DAL,28,82,37,34,71
6,8475692,Mats Zuccarello,R,MIN,37,82,21,50,71
6,8479542,Brandon Hagel,L,TBL,26,82,26,44,70
6,8477409,Carter Verhaeghe,C,FLA,29,82,26,43,69
6,8480023,Robert Thomas,C,STL,25,82,20,49,69
6,8478439,Travis Konecny,R,PHI,27,82,36,32,68
6,8477501,Valeri Nichushkin,R,COL,29,82,36,32,68
6,8475810,Bryan Rust,R,PIT,32,82,31,37,68
6,8480002,Nico Hischier,C,NJD,25,82,29,39,68
6,8475168,Matt Duchene,C,DAL,33,82,22,46,68
6,8480803,Evan Bouchard,D,EDM,25,82,13,55,68
6,8474590,John Carlson,D,WSH,34,82,10,58,68
6,8476454,Ryan Nugent-Hopkins,C,EDM,31,82,17,50,67
6,8471675,Sidney Crosby,C,PIT,37,82,34,32,66
6,8477500,Bo Horvat,C,NYI,29,82,33,33,66
6,8477402,Pavel Buchnevich,L,STL,29,82,25,41,66
6,8478440,Dylan Strome,C,WSH,27,82,24,42,66
6,8475158,Ryan O'Reilly,C,NSH,33,82,24,42,66
6,8478401,Pavel Zacha,C,BOS,27,82,20,46,66
6,8482475,Yegor Chinakhov,R,CBJ,23,82,35,30,65
6,8477951,Nick Schmaltz,C,ARI,28,82,27,38,65
6,8480036,Miro Heiskanen,D,DAL,25,82,17,48,65
6,8475754,Brock Nelson,C,NYI,33,82,34,30,64
6,8471698,T.J. Oshie,R,WSH,38,82,30,34,64
6,8480018,Nick Suzuki,C,MTL,25,82,28,36,64
6,8477949,Alex Tuch,R,BUF,28,82,23,41,64
6,8476346,Johnny Gaudreau,L,CBJ,31,82,18,46,64
6,8480014,Gabriel Vilardi,C,WPG,25,82,31,32,63
6,8470794,Joe Pavelski,C,DAL,40,82,26,37,63
6,8478403,Jack Eichel,C,VGK,28,82,24,39,63
6,8478042,Viktor Arvidsson,R,LAK,31,82,21,42,63
6,8481540,Cole Caufield,R,MTL,23,82,34,28,62
6,8478414,Timo Meier,R,NJD,28,82,32,30,62
6,8477955,Jared McCann,L,SEA,28,82,24,38,62
6,8482684,Luke Hughes,D,NJD,21,82,22,40,62
6,8481528,Dylan Cozens,C,BUF,23,82,20,42,62
6,8474578,Erik Karlsson,D,PIT,34,82,20,42,62
6,8476882,Teuvo Teravainen,L,CAR,30,82,20,42,62
6,8478445,Mathew Barzal,C,NYI,27,82,15,47,62
6,8475184,Chris Kreider,L,NYR,33,82,35,26,61
6,8480208,Drake Batherson,R,OTT,26,82,24,37,61
6,8473512,Claude Giroux,R,OTT,36,82,21,40,61
6,8471685,Anze Kopitar,C,LAK,37,82,19,42,61
6,8482093,Seth Jarvis,C,CAR,22,82,29,31,60
6,8478856,Conor Garland,R,VAN,28,82,28,32,60
6,8471215,Evgeni Malkin,C,PIT,38,82,25,35,60
6,8477504,Josh Morrissey,D,WPG,29,82,8,52,60
6,8480801,Brady Tkachuk,L,OTT,25,82,35,24,59
6,8475726,Tyler Toffoli,C,WPG,32,82,34,25,59
6,8477447,Shea Theodore,D,VGK,29,82,18,41,59
6,8471214,Alex Ovechkin,L,WSH,39,82,32,26,58
6,8477940,Nikolaj Ehlers,L,WPG,28,82,27,31,58
6,8476459,Mika Zibanejad,C,NYR,31,82,27,31,58
6,8478975,Mason Marchment,L,DAL,29,82,26,32,58
6,8482740,Wyatt Johnston,C,DAL,21,82,24,34,58
6,8478873,Troy Terry,R,ANA,27,82,22,36,58
6,8481711,Matias Maccelli,L,ARI,24,82,16,42,58
6,8479400,Pierre-Luc Dubois,L,LAK,26,82,29,28,57
6,8477935,Sam Bennett,C,FLA,28,82,26,31,57
6,8474679,Gustav Nyquist,C,NSH,35,82,21,36,57
6,8478493,Joel Eriksson Ek,C,MIN,27,82,20,37,57
6,8474586,Jordan Eberle,R,SEA,34,82,20,37,57
6,8478444,Brock Boeser,R,VAN,27,82,32,24,56
6,8474150,Mikael Backlund,C,CGY,35,82,27,29,56
6,8476483,Rickard Rakell,R,PIT,31,82,27,29,56
6,8482078,Lucas Raymond,L,DET,22,82,26,30,56
6,8477416,Oliver Bjorkstrand,R,SEA,29,82,25,31,56
6,8481533,Trevor Zegras,C,ANA,23,82,20,36,56
6,8473994,Jamie Benn,L,DAL,35,82,20,36,56
6,8480839,Rasmus Dahlin,D,BUF,24,82,18,38,56
6,8480865,Noah Dobson,D,NYI,24,82,8,48,56
6,8476881,Tomas Hertl,C,VGK,31,82,32,23,55
6,8473986,Alex Killorn,L,ANA,35,82,29,26,55
6,8476389,Vincent Trocheck,C,NYR,31,82,27,28,55
6,8482097,Jack Quinn,R,BUF,23,82,23,32,55
6,8479410,Mikhail Sergachev,D,TBL,26,82,12,43,55
6,8482110,Dawson Mercer,C,NJD,23,82,25,29,54
6,8475784,Jeff Skinner,C,BUF,32,82,24,30,54
6,8477476,Artturi Lehkonen,L,COL,29,82,22,32,54
6,8475167,Victor Hedman,D,TBL,34,82,6,48,54
6,8476539,Jonathan Marchessault,R,VGK,34,82,31,22,53
6,8477960,Adrian Kempe,R,LAK,28,82,26,27,53
6,8475765,Vladimir Tarasenko,R,FLA,33,82,17,36,53
6,8482665,Matty Beniers,C,SEA,22,82,14,39,53
6,8479325,Charlie McAvoy,D,BOS,27,82,11,42,53
6,8475314,Anders Lee,L,NYI,34,82,35,17,52
6,8477451,Ryan Hartman,R,MIN,30,82,29,23,52
6,8476432,Boone Jenner,C,CBJ,31,82,27,25,52
6,8478498,Jake DeBrusk,L,BOS,28,82,27,25,52
6,8476905,Chandler Stephenson,C,VGK,30,82,19,33,52
6,8477503,Max Domi,C,TOR,29,82,13,39,52
6,8478396,Noah Hanifin,D,VGK,27,82,11,41,52
6,8478038,Devon Toews,D,COL,30,82,9,43,52
6,8475760,Nick Bjugstad,C,ARI,32,82,32,19,51
6,8479675,Trevor Moore,L,LAK,29,82,26,25,51
6,8475791,Taylor Hall,L,CHI,33,82,21,30,51
6,8479339,Patrik Laine,L,CBJ,26,82,19,32,51
6,8478055,Gustav Forsling,D,FLA,28,82,10,41,51
6,8476853,Morgan Rielly,D,TOR,30,82,6,45,51
6,8480039,Martin Necas,C,CAR,25,82,29,21,50
6,8480015,Owen Tippett,R,PHI,25,82,28,22,50
6,8477407,Anthony Duclair,L,TBL,29,82,25,25,50
6,8482055,Drew O'Connor,L,PIT,26,82,24,26,50
6,8474102,David Perron,L,DET,36,82,22,28,50
6,8479999,Casey Mittelstadt,C,COL,26,82,18,32,50
6,8477479,Tyler Bertuzzi,L,TOR,29,82,17,33,50
6,8480798,Philipp Kurashev,C,CHI,25,82,14,36,50
6,8482175,JJ Peterka,R,BUF,22,82,24,25,49
6,8478233,Andrew Mangiapane,L,CGY,28,82,22,27,49
6,8475745,Charlie Coyle,C,BOS,32,82,17,32,49
6,8477497,Sean Monahan,C,WPG,30,82,17,32,49
6,8476448,William Karlsson,C,VGK,31,82,16,33,49
6,8475798,Mikael Granlund,C,SJS,32,82,10,39,49
6,8470613,Brent Burns,D,CAR,39,82,10,39,49
6,8481068,Yegor Sharangovich,C,CGY,26,82,27,21,48
6,8476880,Tom Wilson,R,WSH,30,82,24,24,48
6,8475191,Reilly Smith,R,PIT,33,82,21,27,48
6,8478458,Jack Roslovic,C,NYR,27,82,21,27,48
6,8478047,Michael Bunting,L,PIT,29,82,20,28,48
6,8477511,Anthony Mantha,R,VGK,30,82,20,28,48
6,8480031,Maxime Comtois,L,CAR,25,82,11,37,48
6,8476792,Torey Krug,D,STL,33,82,9,39,48
6,8481542,Moritz Seider,D,DET,23,82,7,41,48
6,8475151,Kyle Palmieri,C,NYI,33,82,20,27,47
6,8481596,Shane Pinto,C,OTT,24,82,19,28,47
6,8475913,Mark Stone,R,VGK,32,82,18,29,47
6,8478469,Thomas Chabot,D,OTT,27,82,13,34,47
6,8477021,Alex Kerfoot,C,ARI,30,82,13,34,47
6,8471724,Kris Letang,D,PIT,37,82,7,40,47
6,8483524,Shane Wright,C,SEA,20,82,35,11,46
6,8474157,Max Pacioretty,L,WSH,36,82,21,25,46
6,8477456,J.T. Compher,L,DET,29,82,21,25,46
6,8484144,Connor Bedard,C,CHI,19,82,20,26,46
6,8480849,Barrett Hayton,C,ARI,24,82,18,28,46
6,8480188,Fabian Zetterlund,L,SJS,25,82,16,30,46
6,8482105,Jake Sanderson,D,OTT,22,82,10,36,46
6,8479425,Filip Hronek,D,VAN,27,82,8,38,46
6,8479423,Alex Nylander,L,CBJ,26,82,26,19,45
6,8477998,Warren Foegele,L,EDM,28,82,25,20,45
6,8482101,Danil Gushchin,L,SJS,22,82,23,22,45
6,8474641,Adam Henrique,C,EDM,34,82,22,23,45
6,8478519,Anthony Cirelli,C,TBL,27,82,22,23,45
6,8476479,Phillip Danault,C,LAK,31,82,19,26,45
6,8475744,Evgeny Kuznetsov,C,CAR,32,82,19,26,45
6,8482745,Mason McTavish,C,ANA,21,82,18,27,45
6,8475170,Brayden Schenn,C,STL,33,82,13,32,45
6,8478460,Zach Werenski,D,CBJ,27,82,10,35,45
6,8474565,Alex Pietrangelo,D,VGK,34,82,8,37,45
6,8480064,Josh Norris,C,OTT,25,82,22,22,44
6,8477964,Ivan Barbashev,C,VGK,29,82,19,25,44
6,8482699,Dylan Guenther,R,ARI,21,82,18,26,44
6,8480185,Eetu Luostarinen,C,FLA,26,82,17,27,44
6,8476329,Travis Boyd,C,ARI,31,82,14,30,44
6,8481581,Thomas Harley,D,DAL,23,82,12,32,44
6,8475753,Justin Faulk,D,STL,32,82,10,34,44
6,8476906,Shayne Gostisbehere,D,DET,31,82,8,36,44
6,8476923,Damon Severson,D,CBJ,30,82,8,36,44
6,8482733,Logan Mailloux,D,MTL,31,82,7,37,44
6,8481624,Ilya Mikheyev,R,VAN,30,82,25,18,43
6,8483808,Andrei Kuzmenko,L,CGY,28,82,22,21,43
6,8475287,Erik Haula,L,NJD,33,82,22,21,43
6,8480893,Kirill Marchenko,R,CBJ,24,82,21,22,43
6,8482146,Luke Evangelista,R,NSH,22,82,20,23,43
6,8478057,Dakota Joshua,C,VAN,28,82,18,25,43
6,8474037,James van Riemsdyk,L,BOS,35,82,16,27,43
6,8482124,Quinton Byfield,R,LAK,22,82,13,30,43
6,8474053,Logan Couture,C,SJS,35,82,13,30,43
6,8480434,Sean Durzi,D,ARI,26,82,11,32,43
6,8476958,Jaccob Slavin,D,CAR,30,82,6,37,43
6,8475764,Cam Fowler,D,ANA,33,82,3,40,43
6,8475768,Jaden Schwartz,C,SEA,32,82,24,18,42
6,8475197,Tyson Barrie,D,NSH,33,82,11,31,42
6,8474563,Drew Doughty,D,LAK,35,82,9,33,42
6,8483397,Marc McLaughlin,C,BOS,25,82,34,7,41
6,8476981,Josh Anderson,R,MTL,30,82,22,19,41
6,8478046,Danton Heinen,L,BOS,29,82,20,21,41
6,8478366,Frank Vatrano,R,ANA,30,82,17,24,41
6,8477429,Andrew Copp,C,DET,30,82,11,30,41
6,8480009,Eeli Tolvanen,R,SEA,25,82,22,18,40
6,8477944,Jakub Vrana,L,STL,28,82,21,19,40
6,8481618,Alex Newhook,C,MTL,23,82,20,20,40
6,8476399,Blake Coleman,C,CGY,33,82,18,22,40
6,8476419,Jean-Gabriel Pageau,C,NYI,32,82,17,23,40
6,8479987,Morgan Geekie,C,BOS,26,82,16,24,40
6,8483515,Juraj Slafkovsky,L,MTL,20,82,16,24,40
6,8478438,Tommy Novak,C,NSH,27,82,15,25,40
6,8482705,Cole Sillinger,C,CBJ,21,82,15,25,40
6,8476869,Brady Skjei,D,CAR,30,82,15,25,40
6,8482092,Ridly Greig,C,OTT,22,82,15,25,40
6,8476292,Ondrej Palat,L,NJD,33,82,14,26,40
6,8476872,Scott Laughton,C,PHI,30,82,10,30,40
6,8483445,Cutter Gauthier,L,ANA,20,82,10,30,40
6,8477444,Andre Burakovsky,L,SEA,29,82,10,30,40
6,8476875,Mike Matheson,D,MTL,30,82,7,33,40
6,8477986,Brandon Montour,D,FLA,30,82,7,33,40
6,8478397,Rasmus Andersson,D,CGY,28,82,4,36,40
6,8482089,Jake Neighbours,L,STL,22,82,28,11,39
6,8475722,Jason Zucker,L,NSH,32,82,22,17,39
6,8479345,Jakob Chychrun,D,OTT,26,82,20,19,39
6,8475714,Calle Jarnkrok,C,TOR,33,82,20,19,39
6,8475169,Evander Kane,L,EDM,33,82,19,20,39
6,8477426,Nicholas Paul,L,TBL,29,82,19,20,39
6,8482159,Tyson Foerster,R,PHI,22,82,14,25,39
6,8478472,Mathieu Joseph,R,OTT,27,82,14,25,39
6,8477346,MacKenzie Weegar,D,CGY,30,82,13,26,39
6,8480028,Morgan Frost,C,PHI,25,82,13,26,39
6,8482222,Alexander Barabanov,L,SJS,30,82,12,27,39
6,8482113,Anton Lundell,C,FLA,23,82,10,29,39
6,8480078,Filip Chytil,C,NYR,25,82,9,30,39
6,8482109,Alexis Lafrenière,L,NYR,23,82,25,13,38
6,8475848,Brendan Gallagher,R,MTL,32,82,22,16,38
6,8482702,Logan Stankoven,C,DAL,21,82,22,16,38
6,8479525,Ross Colton,C,COL,28,82,21,17,38
6,8482111,Justin Barron,D,MTL,23,82,19,19,38
6,8478463,Anthony Beauvillier,L,NSH,27,82,18,20,38
6,8476873,Mark Jankowski,C,NSH,30,82,16,22,38
6,8482079,Marco Rossi,C,MIN,23,82,9,29,38
6,8481699,Aku Raty,R,ARI,23,82,3,35,38
6,8481016,Ruslan Iskhakov,C,NYI,24,82,3,35,38
6,8478474,Lawson Crouse,L,ARI,27,82,20,17,37
6,8480855,Jack McBain,C,ARI,24,82,19,18,37
6,8476826,Yanni Gourde,C,SEA,33,82,12,25,37
6,8483457,Lane Hutson,D,MTL,20,82,7,30,37
6,8480145,Neal Pionk,D,WPG,29,82,7,30,37
6,8480797,Joel Farabee,L,PHI,24,82,21,15,36
6,8479992,Michael Rasmussen,C,DET,25,82,19,17,36
6,8476927,Teddy Blueger,C,VAN,30,82,16,20,36
6,8478542,Evan Rodrigues,C,FLA,31,82,15,21,36
6,8475763,Kevin Hayes,R,STL,32,82,13,23,36
6,8482667,William Eklund,L,SJS,22,82,13,23,36
6,8477495,Seth Jones,D,CHI,30,82,11,25,36
6,8482720,Matthew Knies,L,TOR,22,82,11,25,36
6,8477506,Ryan Pulock,D,NYI,30,82,10,26,36
6,8477948,Travis Sanheim,D,PHI,28,82,8,28,36
6,8480336,Sean Walker,D,COL,30,82,8,28,36
6,8483471,Brad Lambert,C,WPG,31,82,6,30,36
6,8476854,Hampus Lindholm,D,BOS,30,82,4,32,36
6,8475906,John Klingberg,D,TOR,32,82,4,32,36
6,8475799,Nino Niederreiter,R,WPG,32,82,21,14,35
6,8481560,Arthur Kaliyev,R,LAK,23,82,19,16,35
6,8477450,Jason Dickinson,C,CHI,29,82,17,18,35
6,8481535,Nils Hoglander,L,VAN,24,82,15,20,35
6,8479365,Trent Frederic,C,BOS,26,82,14,21,35
6,8475218,Mattias Ekholm,D,EDM,34,82,13,22,35
6,8475149,Marcus Johansson,L,MIN,34,82,13,22,35
6,8477932,Aaron Ekblad,D,FLA,28,82,11,24,35
6,8476892,Colton Parayko,D,STL,31,82,11,24,35
6,8481546,Cam York,D,PHI,23,82,9,26,35
6,8480871,Adam Boqvist,D,CBJ,24,82,5,30,35
6,8476438,Brandon Saad,L,STL,32,82,20,14,34
6,8478115,Pierre Engvall,L,NYI,28,82,19,15,34
6,8480459,Pius Suter,C,VAN,28,82,17,17,34
6,8480113,Alex Iafallo,L,WPG,31,82,17,17,34
6,8484166,Adam Fantilli,C,CBJ,20,82,13,21,34
6,8479996,Cody Glass,C,NSH,25,82,12,22,34
6,8474149,Evgenii Dadonov,R,DAL,35,82,12,22,34
6,8476871,Tanner Pearson,L,MTL,32,82,11,23,34
6,8473563,Nicklas Backstrom,C,WSH,37,82,10,24,34
6,8478462,Nicolas Roy,C,VGK,27,82,9,25,34
6,8473422,Nick Foligno,L,CHI,37,82,9,25,34
6,8476902,Esa Lindell,D,DAL,30,82,8,26,34
6,8478507,John Marino,D,NJD,27,82,7,27,34
6,8482142,Jamie Drysdale,D,PHI,22,82,7,27,34
6,8476885,Jacob Trouba,D,NYR,30,82,4,30,34
6,8481568,Alex Vlasic,D,CHI,23,82,3,31,34
6,8474715,Cam Atkinson,R,PHI,35,82,19,14,33
6,8476925,Colton Sissons,C,NSH,31,82,18,15,33
6,8475794,Tyler Seguin,C,DAL,32,82,17,16,33
6,8481554,Kaapo Kakko,R,NYR,23,82,17,16,33
6,8471218,Blake Wheeler,R,NYR,38,82,16,17,33
6,8479977,Kailer Yamamoto,R,SEA,26,82,15,18,33
6,8478466,Daniel Sprong,R,DET,27,82,13,20,33
6,8484153,Leo Carlsson,C,ANA,20,82,13,20,33
6,8477989,Christian Dvorak,C,MTL,28,82,12,21,33
6,8477507,Nikita Zadorov,D,VAN,29,82,10,23,33
6,8479398,Samuel Girard,D,COL,26,82,6,27,33
6,8480817,K'Andre Miller,D,NYR,24,82,5,28,33
6,8476457,Adam Larsson,D,SEA,32,82,5,28,33
6,8481703,Valtteri Puustinen,R,PIT,25,82,3,30,33
6,8482118,Sam Colangelo,R,ANA,23,82,26,6,32
6,8484203,Bradly Nadeau,L,CAR,19,82,22,10,32
6,8483493,Frank Nazar,C,CHI,20,82,18,14,32
6,8482074,Connor Zary,C,CGY,23,82,17,15,32
6,8475231,Casey Cizikas,C,NYI,33,82,16,16,32
6,8483499,Liam Ohgren,L,MIN,20,82,14,18,32
6,8481013,Jonatan Berggren,R,DET,24,82,13,19,32
6,8480144,David Kampf,C,TOR,29,82,10,22,32
6,8475793,Ryan Johansen,C,PHI,32,82,9,23,32
6,8474151,Ryan McDonagh,D,NSH,35,82,3,29,32
6,8481604,Pavel Dorofeyev,L,VGK,24,82,19,12,31
6,8475343,Nic Dowd,C,WSH,34,82,16,15,31
6,8481477,Nico Sturm,C,SJS,29,82,15,16,31
6,8477947,Sonny Milano,L,WSH,28,82,14,17,31
6,8479415,Michael McLeod,C,NJD,26,82,14,17,31
6,8476480,Vladislav Namestnikov,C,WPG,32,82,13,18,31
6,8476392,Adam Lowry,C,WPG,31,82,13,18,31
6,8481580,Connor McMichael,C,WSH,23,82,13,18,31
6,8476458,Ryan Strome,C,ANA,31,82,11,20,31
6,8477425,Miles Wood,L,COL,29,82,11,20,31
6,8474189,Lars Eller,C,PIT,35,82,10,21,31
6,8478840,Will Borgen,D,SEA,28,82,6,25,31
6,8482245,Artem Zub,D,OTT,29,82,6,25,31
6,8482087,Kaiden Guhle,D,MTL,22,82,5,26,31
6,8481704,Juuso Parssinen,C,NSH,23,82,13,17,30
6,8481186,Logan O'Connor,R,COL,28,82,12,18,30
6,8482133,Thomas Bordeleau,C,SJS,22,82,10,20,30
6,8479976,Juuso Valimaki,D,ARI,26,82,9,21,30
6,8476960,Andreas Athanasiou,C,CHI,30,82,6,24,30
6,8482803,Olen Zellweger,D,ANA,21,82,6,24,30
6,8482155,Alex Laferriere,R,LAK,23,82,14,15,29
6,8480806,Isac Lundestrom,C,ANA,25,82,13,16,29
6,8475220,Marcus Foligno,L,MIN,33,82,12,17,29
6,8480220,Noah Cates,L,PHI,25,82,10,19,29
6,8479351,Sam Steel,C,DAL,26,82,10,19,29
6,8482125,Alexander Holtz,R,NJD,22,82,10,19,29
6,8480043,Timothy Liljegren,D,TOR,25,82,5,24,29
6,8477969,Marcus Pettersson,D,PIT,28,82,4,25,29
6,8474673,TJ Brodie,D,TOR,34,82,2,27,29
6,8482145,Mavrik Bourque,C,DAL,22,82,21,7,28
6,8482259,Bobby McMann,C,TOR,28,82,18,10,28
6,8477353,Tyler Motte,C,TBL,29,82,17,11,28
6,8483431,Logan Cooley,C,ARI,20,82,16,12,28
6,8478013,Jake Walman,D,DET,28,82,14,14,28
6,8479941,Justin Danforth,R,CBJ,31,82,13,15,28
6,8480068,Ryan Poehling,C,PHI,25,82,12,16,28
6,8482737,Zack Bolduc,C,STL,21,82,12,16,28
6,8477508,Curtis Lazar,C,NJD,29,82,12,16,28
6,8478109,Victor Olofsson,L,BUF,29,82,11,17,28
6,8482624,Daniil Miromanov,D,CGY,27,82,9,19,28
6,8477952,Robby Fabbri,C,DET,28,82,8,20,28
6,8475200,Dmitry Orlov,D,CAR,33,82,7,21,28
6,8476331,Dylan DeMelo,D,WPG,31,82,6,22,28
6,8483490,Pavel Mintyukov,D,ANA,21,82,4,24,28
6,8480073,Erik Brannstrom,D,OTT,25,82,3,25,28
6,8476979,Erik Gustafsson,D,NYR,32,82,2,26,28
6,8477919,Frederick Gaudreau,C,MIN,31,82,15,12,27
6,8476278,Colin Blackwell,C,CHI,31,82,15,12,27
6,8482117,Lukas Reichel,L,CHI,22,82,13,14,27
6,8478413,Jordan Greenway,L,BUF,27,82,12,15,27
6,8477498,Darnell Nurse,D,EDM,29,82,10,17,27
6,8480813,Joe Veleno,C,DET,24,82,9,18,27
6,8477488,Brett Pesce,D,CAR,30,82,8,19,27
6,8483495,Simon Nemec,D,NJD,20,82,7,20,27
6,8478891,Mason Appleton,C,WPG,28,82,6,21,27
6,8478911,Matt Roy,D,LAK,29,82,6,21,27
6,8477845,Trevor van Riemsdyk,D,WSH,33,82,4,23,27
6,8476917,Adam Pelech,D,NYI,30,82,3,24,27
6,8470610,Zach Parise,L,COL,40,82,15,11,26
6,8479591,Michael Eyssimont,C,TBL,28,82,13,13,26
6,8473449,Kyle Okposo,R,FLA,36,82,12,14,26
6,8479390,Taylor Raddysh,R,CHI,26,82,11,15,26
6,8480074,Alexandre Texier,C,CBJ,25,82,11,15,26
6,8481601,Simon Holmstrom,R,NYI,23,82,11,15,26
6,8482679,Matt Coronato,R,CGY,22,82,9,17,26
6,8477953,Kasperi Kapanen,R,STL,28,82,8,18,26
6,8482671,Owen Power,D,BUF,22,82,7,19,26
6,8477931,Tomas Nosek,L,NJD,32,82,7,19,26
6,8474716,Jared Spurgeon,D,MIN,35,82,4,22,26
6,8476879,Cody Ceci,D,EDM,31,82,3,23,26
6,8473507,Jeff Petry,D,DET,37,82,3,23,26
6,8482122,Brock Faber,D,MIN,22,82,1,25,26
6,8481605,Jackson LaCombe,D,ANA,23,82,0,26,26
6,8474884,Mike Hoffman,C,SJS,35,82,17,8,25
6,8477330,Dominik Kubalik,L,OTT,29,82,16,9,25
6,8474009,Nick Bonino,C,NYR,36,82,13,12,25
6,8481553,Bobby Brink,R,PHI,23,82,11,14,25
6,8477839,Conor Sheary,L,TBL,32,82,11,14,25
6,8473533,Jordan Staal,C,CAR,36,82,9,16,25
6,8478133,Jake Evans,C,MTL,28,82,9,16,25
6,8481522,Peyton Krebs,C,BUF,23,82,9,16,25
6,8476467,Jamie Oleksiak,D,SEA,32,82,5,20,25
6,8475790,Erik Gudbranson,D,CBJ,32,82,5,20,25
6,8476931,Jake McCabe,D,TOR,31,82,4,21,25
6,8480246,Nick Perbix,D,TBL,26,82,1,24,25
6,8479359,Beck Malenstyn,L,WSH,26,82,14,10,24
6,8480821,Filip Zadina,R,SJS,25,82,11,13,24
6,8475842,Sam Carrick,C,EDM,32,82,11,13,24
6,8478020,Michael Amadio,C,VGK,28,82,10,14,24
6,8477505,Alexander Wennberg,C,NYR,30,82,10,14,24
6,8474870,Tyler Johnson,C,CHI,34,82,9,15,24
6,8480802,Ryan McLeod,C,EDM,25,82,8,16,24
6,8481656,Aliaksei Protas,C,WSH,23,82,6,18,24
6,8478569,Noel Acciari,C,PIT,33,82,6,18,24
6,8475188,Brayden McNabb,D,VGK,33,82,6,18,24
6,8480873,Rasmus Sandin,D,WSH,24,82,5,19,24
6,8470604,Jeff Carter,C,PIT,39,82,13,10,23
6,8479661,Tanner Jeannot,L,TBL,27,82,12,11,23
6,8479293,Brandon Tanev,L,SEA,33,82,10,13,23
6,8479346,Dillon Dube,C,CGY,26,82,10,13,23
6,8483565,Nick Blankenburg,D,CBJ,26,82,9,14,23
6,8476897,Oskar Sundqvist,C,STL,30,82,9,14,23
6,8479980,Nicolas Hague,D,VGK,26,82,8,15,23
6,8478508,Yakov Trenin,C,COL,27,82,8,15,23
6,8479353,Brett Howden,C,VGK,26,82,7,16,23
6,8476469,Joel Armia,R,MTL,31,82,12,10,22
6,8480448,Parker Kelly,L,OTT,25,82,10,12,22
6,8481028,Martin Pospisil,C,CGY,25,82,9,13,22
6,8476463,Jonas Brodin,D,MIN,31,82,7,15,22
6,8476525,Colin Miller,D,WPG,32,82,6,16,22
6,8482712,Oskar Olausson,R,COL,22,82,6,16,22
6,8476374,Sean Kuraly,C,CBJ,31,82,5,17,22
6,8475279,Ben Chiarot,D,DET,33,82,5,17,22
6,8476429,Scott Mayfield,D,NYI,32,82,4,18,22
6,8475179,Dmitry Kulikov,D,FLA,34,82,3,19,22
6,8470600,Ryan Suter,D,DAL,39,82,2,20,22
6,8475455,Brenden Dillon,D,WPG,34,82,2,20,22
6,8478500,Ivan Provorov,D,CBJ,27,82,1,21,22
6,8478043,Sam Lafferty,C,VAN,29,82,7,14,21
6,8476312,Josh Manson,D,COL,33,82,6,15,21
6,8479369,Andrew Peeke,D,BOS,26,82,5,16,21
6,8480990,Declan Chisholm,D,MIN,24,82,5,16,21
6,8478430,Oliver Kylington,D,CGY,27,82,4,17,21
6,8481567,Henry Thrun,D,SJS,23,82,4,17,21
6,8478451,Ethan Bear,D,WSH,27,82,3,18,21
6,8479316,Luke Kunin,C,SJS,27,82,13,7,20
6,8481093,Rafael Harvey-Pinard,L,MTL,25,82,12,8,20
6,8482762,Simon Edvinsson,D,DET,21,82,10,10,20
6,8479393,Noah Gregor,C,TOR,26,82,8,12,20
6,8482062,Cole Smith,L,NSH,29,82,7,13,20
6,8478416,Erik Cernak,D,TBL,27,82,6,14,20
6,8481481,Blake Lizotte,C,LAK,27,82,5,15,20
6,8477015,Connor Brown,R,EDM,30,82,5,15,20
6,8474574,Tyler Myers,D,VAN,34,82,4,16,20
6,8481524,Bowen Byram,D,BUF,23,82,4,16,20
6,8478443,Brandon Carlo,D,BOS,28,82,4,16,20
6,8478882,Vladislav Gavrikov,D,LAK,29,82,3,17,20
6,8476891,Matt Grzelcyk,D,BOS,30,82,3,17,20
6,8475233,David Savard,D,MTL,34,82,3,17,20
6,8481178,Egor Zamula,D,PHI,24,82,1,19,20
6,8479383,Boris Katchouk,L,OTT,26,82,12,7,19
6,8483012,Logan Morrison,C,SEA,22,82,12,7,19
6,8479514,Rem Pitlick,C,CHI,27,82,11,8,19
6,8476878,Zemgus Girgensons,L,BUF,30,82,10,9,19
6,8475164,Jakob Silfverberg,R,ANA,34,82,10,9,19
6,8478831,Kevin Stenlund,C,FLA,28,82,8,11,19
6,8470966,Mark Giordano,D,TOR,41,82,7,12,19
6,8481014,Alexander Romanov,D,NYI,24,82,7,12,19
6,8484145,Zach Benson,L,BUF,19,82,6,13,19
6,8483505,Matthew Poitras,C,BOS,20,82,6,13,19
6,8477392,Hudson Fasching,R,NYI,29,82,6,13,19
6,8480035,Henri Jokiharju,D,BUF,25,82,5,14,19
6,8478859,Niko Mikkola,D,FLA,28,82,5,14,19
6,8482073,Braden Schneider,D,NYR,23,82,4,15,19
6,8480058,Pierre-Olivier Joseph,D,PIT,25,82,3,16,19
6,8475324,Nick Jensen,D,WSH,34,82,3,16,19
6,8479324,Ryan Lindgren,D,NYR,26,82,1,18,19
6,8480281,Alexey Toropchenko,R,STL,25,82,11,7,18
6,8476858,Phillip Di Giuseppe,L,VAN,31,82,8,10,18
6,8482166,Shakir Mukhamadullin,D,SJS,22,82,7,11,18
6,8483491,Ivan Miroshnichenko,L,WSH,20,82,6,12,18
6,8475171,Oliver Ekman-Larsson,D,FLA,33,82,5,13,18
6,8474166,Alec Martinez,D,VGK,37,82,3,15,18
6,8478178,Darren Raddysh,D,TBL,28,82,2,16,18
6,8476442,Matt Nieto,L,PIT,32,82,11,6,17
6,8482809,Jackson Blake,R,CAR,21,82,9,8,17
6,8476624,Barclay Goodrow,C,NYR,31,82,7,10,17
6,8473453,Trevor Lewis,C,LAK,37,82,6,11,17
6,8475208,Brian Dumoulin,D,SEA,33,82,5,12,17
6,8476473,Connor Murphy,D,CHI,31,82,5,12,17
6,8477406,Mattias Janmark,C,EDM,32,82,4,13,17
6,8482858,Ryker Evans,D,SEA,23,82,4,13,17
6,8477220,Nate Schmidt,D,WPG,33,82,4,13,17
6,8471677,Jack Johnson,D,COL,37,82,4,13,17
6,8480860,Kevin Bahl,D,NJD,24,82,3,14,17
6,8475181,Nick Leddy,D,STL,33,82,2,15,17
6,8479998,Mikey Anderson,D,LAK,25,82,2,15,17
6,8479371,Dante Fabbro,D,NSH,26,82,2,15,17
6,8479983,Mario Ferraro,D,SJS,26,82,2,15,17
6,8470621,Corey Perry,R,EDM,39,82,10,6,16
6,8480834,Ty Emberson,D,SJS,24,82,6,10,16
6,8479291,Kevin Rooney,C,CGY,31,82,6,10,16
6,8482807,Ethan Del Mastro,D,CHI,21,82,6,10,16
6,8480796,Martin Fehervary,D,WSH,25,82,4,12,16
6,8478408,Travis Dermott,D,ARI,28,82,4,12,16
6,8481059,Scott Perunovich,D,STL,26,82,4,12,16
6,8474034,Pat Maroon,L,BOS,36,82,4,12,16
6,8475462,Radko Gudas,D,ANA,34,82,3,13,16
6,8478399,Jonas Siegenthaler,D,NJD,27,82,2,14,16
6,8475690,Chris Tanev,D,DAL,35,82,1,15,16
6,8483482,Tristan Luneau,D,ANA,20,82,8,7,15
6,8477369,Carson Soucy,D,VAN,30,82,6,9,15
6,8477034,Jaycob Megna,D,CHI,32,82,6,9,15
6,8481537,Nikita Okhotiuk,D,CGY,24,82,5,10,15
6,8476461,Sean Couturier,C,PHI,32,82,5,10,15
6,8478136,Jake Middleton,D,MIN,28,82,5,10,15
6,8483468,Jiri Kulich,C,BUF,20,82,5,10,15
6,8478851,Alexandre Carrier,D,NSH,28,82,4,11,15
6,8477435,Ryan Graves,D,PIT,29,82,4,11,15
6,8476422,Mike Reilly,D,NYI,31,82,4,11,15
6,8483466,Kevin Korchinski,D,CHI,20,82,4,11,15
6,8474567,Zach Bogosian,D,MIN,34,82,4,11,15
6,8481606,Jordan Spence,D,LAK,23,82,2,13,15
6,8480807,Mattias Samuelsson,D,BUF,24,82,2,13,15
6,8477365,Connor Clifton,D,BUF,29,82,2,13,15
6,8476921,Jordan Martinook,L,CAR,32,82,7,7,14
6,8480980,Connor Dewar,C,TOR,25,82,6,8,14
6,8474013,Ian Cole,D,VAN,35,82,3,11,14
6,8477499,Rasmus Ristolainen,D,PHI,30,82,3,11,14
6,8482859,Zack Ostapchuk,C,OTT,21,82,2,12,14
6,8480879,Jacob Bernard-Docker,D,OTT,24,82,1,13,14
6,8481517,Brett Leason,R,ANA,25,82,9,4,13
6,8476915,Jujhar Khaira,L,MIN,30,82,7,6,13
6,8482730,Brandt Clarke,D,LAK,21,82,4,9,13
6,8482470,Ilya Solovyov,D,CGY,24,82,3,10,13
6,8484149,Gavin Brindley,C,CBJ,20,82,3,10,13
6,8478468,Jeremy Lauzon,D,NSH,27,82,2,11,13
6,8480172,Jan Rutta,D,SJS,34,82,2,11,13
6,8479442,Troy Stecher,D,EDM,30,82,4,8,12
6,8482516,Matthew Kessel,D,STL,24,82,3,9,12
6,8482177,Marat Khusnutdinov,C,MIN,22,82,3,9,12
6,8482655,J.J. Moser,D,ARI,24,82,2,10,12
6,8475177,Calvin de Haan,D,TBL,33,82,3,8,11
6,8476967,Brett Kulak,D,EDM,30,82,2,9,11
6,8481599,Victor Soderstrom,D,ARI,23,82,2,9,11
6,8475762,Derek Forbort,D,BOS,32,82,1,10,11
6,8476822,Luke Glendening,C,TBL,35,82,4,6,10
6,8476372,Nick Seeler,D,PHI,31,82,2,8,10
6,8481578,Graeme Clarke,R,NJD,23,82,6,3,9
6,8477335,Kyle Burroughs,D,SJS,29,82,4,5,9
6,8483763,Maksymilian Szuber,D,ARI,22,82,5,3,8
6,8484911,Collin Graf,R,SJS,22,82,3,5,8
6,8473504,Cal Clutterbuck,R,NYI,37,82,3,5,8
6,8475825,Jani Hakanpää,D,DAL,32,82,1,7,8
6,8482666,Scott Morrow,D,CAR,22,82,3,4,7
6,8482713,Mackie Samoskevich,R,FLA,22,82,3,3,6
6,8481030,Jack St. Ivany,D,PIT,25,82,1,5,6
6,8483489,Fraser Minten,C,TOR,31,82,4,1,5
6,8482141,Lukas Cormier,D,VGK,22,0,0,0,0
6,8476988,Matt Benning,D,SJS,30,0,0,0,0
6,8480727,Zach Whitecloud,D,VGK,28,0,0,0,0
6,8480887,Jordan Harris,D,MTL,24,0,0,0,0
6,8478450,Parker Wotherspoon,D,BOS,27,0,0,0,0
6,8481812,Nikolai Knyzhov,D,SJS,27,0,0,0,0
6,8480001,Urho Vaakanainen,D,ANA,25,0,0,0,0
6,8482176,Wyatt Kaiser,D,CHI,22,0,0,0,0
6,8481122,Simon Benoit,D,TOR,26,0,0,0,0
6,8476441,Joel Edmundson,D,TOR,31,0,0,0,0
6,8480884,Calen Addison,D,SJS,24,0,0,0,0
6,8482511,Mason Lohrei,D,BOS,23,0,0,0,0
6,8482192,Isaak Phillips,D,CHI,23,0,0,0,0
6,8480950,Ilya Lyubushkin,D,TOR,30,0,0,0,0
6,8474031,Kevin Shattenkirk,D,BOS,35,0,0,0,0
6,8475718,Justin Holl,D,DET,32,0,0,0,0
6,8479402,Jake Bean,D,CBJ,26,0,0,0,0
6,8474602,Justin Schultz,D,SEA,34,0,0,0,0
6,8477950,Tony DeAngelo,D,CAR,29,0,0,0,0
6,8481743,Marc Del Gaizo,D,NSH,25,0,0,0,0
6,8481527,Kaedan Korczak,D,VGK,23,0,0,0,0
6,8480192,Johnathan Kovacevic,D,MTL,27,0,0,0,0
6,8476874,Olli Maatta,D,DET,30,0,0,0,0
6,8482144,Jack Thompson,D,SJS,22,0,0,0,0
6,8480222,Sebastian Aho,D,NYI,28,0,0,0,0
6,8479458,Nikita Zaitsev,D,CHI,33,0,0,0,0
6,8471709,Marc-Edouard Vlasic,D,SJS,37,0,0,0,0
6,8482929,Emil Lilleberg,D,TBL,23,0,0,0,0
6,8477018,Ben Hutton,D,VGK,31,0,0,0,0
6,8481056,Spencer Stastney,D,NSH,24,0,0,0,0
6,8481593,Jayden Struble,D,MTL,23,0,0,0,0
6,8479982,Conor Timmins,D,TOR,26,0,0,0,0
6,8474090,Brendan Smith,D,NJD,35,0,0,0,0
6,8482964,Arber Xhekaj,D,MTL,23,0,0,0,0
6,8480891,Michael Kesselring,D,ARI,24,0,0,0,0
6,8477938,Haydn Fleury,D,TBL,28,0,0,0,0
6,8481806,Louis Crevier,D,CHI,23,0,0,0,0
6,8471274,Alex Goligoski,D,MIN,39,0,0,0,0
6,8481600,Tobias Bjornfot,D,FLA,23,0,0,0,0
6,8475797,Jarred Tinordi,D,CHI,32,0,0,0,0
6,8481521,Ronnie Attard,D,PHI,25,0,0,0,0
6,8474612,Travis Hamonic,D,OTT,34,0,0,0,0
6,8479576,Vincent Desharnais,D,EDM,28,0,0,0,0
6,8480049,Dylan Samberg,D,WPG,25,0,0,0,0
6,8483619,Filip Roos,D,CHI,25,0,0,0,0
6,8474568,Luke Schenn,D,NSH,35,0,0,0,0
6,8480184,Gustav Lindstrom,D,ANA,26,0,0,0,0
6,8480070,Ian Mitchell,D,BOS,25,0,0,0,0
6,8480196,Jacob Bryson,D,BUF,27,0,0,0,0
6,8471686,Marc Staal,D,PHI,37,0,0,0,0
6,8477467,Gustav Olofsson,D,SEA,30,0,0,0,0
6,8478970,Jalen Chatfield,D,CAR,28,0,0,0,0
6,8479348,Kale Clague,D,BUF,26,0,0,0,0
6,8473446,Erik Johnson,D,PHI,36,0,0,0,0
6,8477462,Robert Hagg,D,ANA,29,0,0,0,0
6,8478454,Noah Juulsen,D,VAN,27,0,0,0,0
6,8477384,Josh Brown,D,ARI,30,0,0,0,0
6,8481708,Zac Jones,D,NYR,24,0,0,0,0
6,8481167,Brayden Pachal,D,CGY,25,0,0,0,0
6,8482067,Connor Mackey,D,NYR,28,0,0,0,0
6,8483460,David Jiricek,D,CBJ,21,0,0,0,0
6,8481701,Santeri Hatakka,D,NJD,23,0,0,0,0
6,8478021,William Lagesson,D,ANA,28,0,0,0,0
6,8477851,Jordan Oesterle,D,CGY,32,0,0,0,0
6,8478452,Caleb Jones,D,COL,27,0,0,0,0
6,8479984,Cal Foote,D,NJD,26,0,0,0,0
6,8479639,Dylan Coghlan,D,CAR,26,0,0,0,0
6,8480874,Adam Ginning,D,PHI,24,0,0,0,0
6,8479321,Lucas Johansen,D,WSH,27,0,0,0,0
6,8480878,Nils Lundkvist,D,DAL,24,0,0,0,0
6,8482165,Yan Kuznetsov,D,CGY,22,0,0,0,0
6,8484258,Sam Malinski,D,COL,26,0,0,0,0
6,8480157,Calle Rosen,D,STL,30,0,0,0,0
6,8484304,Uvis Balinskis,D,FLA,28,0,0,0,0
6,8479985,Cale Fleury,D,SEA,26,0,0,0,0
6,8479378,Logan Stanley,D,WPG,26,0,0,0,0
6,8477541,Dakota Mermis,D,MIN,30,0,0,0,0
6,8481609,Vladislav Kolyachonok,D,ARI,23,0,0,0,0
6,8480823,Alexander Alexeyev,D,WSH,25,0,0,0,0
6,8481679,Maxence Guenette,D,OTT,23,0,0,0,0
6,8481564,Ryan Johnson,D,BUF,23,0,0,0,0
6,8479376,Victor Mete,D,PHI,26,0,0,0,0
6,8484254,Akito Hirose,D,VAN,25,0,0,0,0
6,8482660,Kent Johnson,C,CBJ,22,0,0,0,0
6,8482149,Cole Perfetti,C,WPG,22,0,0,0,0
6,8477987,Ryan Donato,C,CHI,28,0,0,0,0
6,8475755,Alexander Petrovic,D,DAL,32,0,0,0,0
6,8477810,Joel Hanley,D,CGY,33,0,0,0,0
6,8474145,Robert Bortuzzo,D,NYI,35,0,0,0,0
6,8481161,Jake Christiansen,D,CBJ,25,0,0,0,0
6,8476884,Derrick Pouliot,D,DAL,30,0,0,0,0
6,8481716,Dmitri Voronkov,L,CBJ,24,0,0,0,0
6,8480084,Nick DeSimone,D,NJD,30,0,0,0,0
6,8475750,Jon Merrill,D,MIN,32,0,0,0,0
6,8479315,Joey Anderson,R,CHI,26,0,0,0,0
6,8478011,Louie Belpedio,D,PHI,28,0,0,0,0
6,8482451,Mikael Pyyhtia,L,CBJ,23,0,0,0,0
6,8481541,Samuel Bolduc,D,NYI,24,0,0,0,0
6,8482126,Emil Andrae,D,PHI,31,0,0,0,0
6,8474618,Marco Scandella,D,STL,34,0,0,0,0
6,8477244,Chad Ruhwedel,D,NYR,34,0,0,0,0
6,8477971,Andreas Englund,D,LAK,28,0,0,0,0
6,8480829,Jesperi Kotkaniemi,C,CAR,24,0,0,0,0
6,8479372,Josh Mahura,D,FLA,26,0,0,0,0
6,8482095,Tyler Kleven,D,OTT,22,0,0,0,0
6,8481719,Maxwell Crozier,D,TBL,24,0,0,0,0
6,8475855,Jesper Fast,R,CAR,33,0,0,0,0
6,8480848,Ty Dellandrea,C,DAL,24,0,0,0,0
6,8475193,Tomas Tatar,L,SEA,34,0,0,0,0
6,8476889,Radek Faksa,C,DAL,30,0,0,0,0
6,8478495,Denis Gurianov,R,PHI,27,0,0,0,0
6,8480216,Jacob Peterson,C,SJS,25,0,0,0,0
6,8480252,Cole Guttman,C,CHI,25,0,0,0,0
6,8479026,Philippe Myers,D,TBL,27,0,0,0,0
6,8481006,Tyler Tucker,D,STL,24,0,0,0,0
6,8481032,Paul Cotter,C,VGK,25,0,0,0,0
6,8481577,Philip Tomasino,C,NSH,23,0,0,0,0
6,8476918,Jimmy Vesey,L,NYR,31,0,0,0,0
6,8479320,Max Lajoie,D,TOR,27,0,0,0,0
6,8478017,Mark Friedman,D,VAN,29,0,0,0,0
6,8481754,Nikita Nesterenko,C,ANA,23,0,0,0,0
6,8483407,Brandon Scanlin,D,NYR,25,0,0,0,0
6,8482659,Josh Doan,R,ARI,22,0,0,0,0
6,8477446,Michael McCarron,R,NSH,29,0,0,0,0
6,8477903,Garnet Hathaway,R,PHI,33,0,0,0,0
6,8482153,Brendan Brisson,C,VGK,23,0,0,0,0
6,8483546,Marshall Rifai,D,TOR,26,0,0,0,0
6,8484287,Cole McWard,D,VAN,23,0,0,0,0
6,8478854,Ryan Shea,D,PIT,27,0,0,0,0
6,8481585,Egor Afanasyev,L,NSH,23,0,0,0,0
6,8483398,Declan Carlile,D,TBL,31,0,0,0,0
6,8478502,Dennis Gilbert,D,CGY,28,0,0,0,0
6,8482749,Joshua Roy,R,MTL,21,0,0,0,0
6,8481598,Philip Broberg,D,EDM,23,0,0,0,0
6,8480835,Jack Drury,C,CAR,24,0,0,0,0
6,8480748,Kiefer Sherwood,L,NSH,29,0,0,0,0
6,8476934,Brock McGinn,L,ANA,30,0,0,0,0
6,8480870,Bo Groulx,C,ANA,24,0,0,0,0
6,8479368,Max Jones,L,ANA,26,0,0,0,0
6,8478099,Kevin Labanc,R,SJS,29,0,0,0,0
6,8478067,Oskar Lindblom,L,SJS,28,0,0,0,0
6,8476393,Nick Cousins,C,FLA,31,0,0,0,0
6,8483395,Arshdeep Bains,L,VAN,23,0,0,0,0
6,8480762,Eric Robinson,L,BUF,29,0,0,0,0
6,8479439,Jacob MacDonald,D,SJS,31,0,0,0,0
6,8476474,Stefan Noesen,R,CAR,31,0,0,0,0
6,8482787,Nikita Chibrikov,R,WPG,31,0,0,0,0
6,8478432,Christian Fischer,R,DET,27,0,0,0,0
6,8477979,Nicolas Aube-Kubel,R,WSH,28,0,0,0,0
6,8481789,Tye Kartye,L,SEA,23,0,0,0,0
6,8479330,Brandon Gignac,C,MTL,27,0,0,0,0
6,8480075,Cameron Crotty,D,ARI,25,0,0,0,0
6,8473473,Milan Lucic,L,BOS,36,0,0,0,0
6,8482094,Daemon Hunt,D,MIN,22,0,0,0,0
6,8481206,John Ludvig,D,PIT,24,0,0,0,0
6,8483630,Pavol Regenda,L,ANA,25,0,0,0,0
6,8481617,Vasily Podkolzin,R,VAN,23,0,0,0,0
6,8480306,Grant Hutton,D,NYI,29,0,0,0,0
6,8480995,Pontus Holmberg,R,TOR,25,0,0,0,0
6,8482148,Hendrix Lapierre,C,WSH,22,0,0,0,0
6,8477478,William Carrier,L,VGK,30,0,0,0,0
6,8480003,Jesper Boqvist,C,BOS,26,0,0,0,0
6,8482172,Landon Slaggert,L,CHI,22,0,0,0,0
6,8480789,Oliver Wahlstrom,R,NYI,24,0,0,0,0
6,8474062,Riley Nash,C,NYR,35,0,0,0,0
6,8480021,Jack Studnicka,C,SJS,25,0,0,0,0
6,8480025,MacKenzie Entwistle,R,CHI,25,0,0,0,0
6,8481582,Nicholas Robertson,L,TOR,23,0,0,0,0
6,8476867,Brendan Gaunce,C,CBJ,30,0,0,0,0
6,8479619,Michael Carcone,L,ARI,28,0,0,0,0
6,8479370,Tyson Jost,C,BUF,26,0,0,0,0
6,8479671,Mathieu Olivier,R,CBJ,27,0,0,0,0
6,8476994,Vinnie Hinostroza,C,PIT,30,0,0,0,0
6,8482070,Mitchell Chaffee,R,TBL,26,0,0,0,0
6,8477473,Justin Bailey,R,SJS,29,0,0,0,0
6,8479344,Jesse Puljujarvi,R,PIT,26,0,0,0,0
6,8480205,Emil Bemstrom,C,PIT,25,0,0,0,0
6,8479718,Alex Barré-Boulet,C,TBL,27,0,0,0,0
6,8482061,Brandon Biro,L,BUF,26,0,0,0,0
6,8479638,Justin Brazeau,R,BOS,26,0,0,0,0
6,8474040,Sam Gagner,C,EDM,35,0,0,0,0
6,8477846,Ryan Carpenter,C,SJS,33,0,0,0,0
6,8482077,Dylan Holloway,L,EDM,23,0,0,0,0
6,8482157,Will Cuylle,L,NYR,22,0,0,0,0
6,8480007,Jonas Rondbjerg,R,VGK,25,0,0,0,0
6,8478874,Adam Gaudette,C,STL,28,0,0,0,0
6,8478434,Keegan Kolesar,R,VGK,27,0,0,0,0
6,8480441,Trey Fix-Wolansky,R,CBJ,25,0,0,0,0
6,8479994,Jaret Anderson-Dolan,C,NSH,25,0,0,0,0
6,8483567,Georgii Merkulov,C,BOS,24,0,0,0,0
6,8477380,Jonny Brodzinski,C,NYR,31,0,0,0,0
6,8482201,Gage Goncalves,C,TBL,23,0,0,0,0
6,8478211,Dryden Hunt,L,CGY,29,0,0,0,0
6,8471699,Andrew Cogliano,C,COL,37,0,0,0,0
6,8479421,Jacob Moverare,D,LAK,26,0,0,0,0
6,8478881,Brett Seney,L,CHI,28,0,0,0,0
6,8477464,Nic Petan,C,MIN,29,0,0,0,0
6,8475958,Michael Sgarbossa,C,WSH,32,0,0,0,0
6,8481147,Reese Johnson,C,CHI,26,0,0,0,0
6,8479336,Carl Grundstrom,R,LAK,27,0,0,0,0
6,8480853,Liam Foudy,C,NSH,24,0,0,0,0
6,8479522,Hardy Haman Aktell,D,WSH,26,0,0,0,0
6,8481462,Mason Morelli,L,VGK,28,0,0,0,0
6,8482102,Vasily Ponomarev,C,CAR,22,0,0,0,0
6,8480844,Grigori Denisenko,L,VGK,24,0,0,0,0
6,8479944,Zach Aston-Reese,C,DET,30,0,0,0,0
6,8482784,Zach Dean,C,STL,21,0,0,0,0
6,8479419,Brett Murray,L,BUF,26,0,0,0,0
6,8479520,Brandon Duhaime,R,COL,27,0,0,0,0
6,8477573,Nathan Walker,L,STL,30,0,0,0,0
6,8478078,Rourke Chartier,C,OTT,28,0,0,0,0
6,8475795,Dylan McIlrath,D,WSH,32,0,0,0,0
6,8482496,Nils Aman,C,VAN,24,0,0,0,0
6,8480289,Morgan Barron,C,WPG,26,0,0,0,0
6,8481751,Lukas Rousek,R,BUF,25,0,0,0,0
6,8480011,Klim Kostin,C,SJS,25,0,0,0,0
6,8481556,John Beecher,C,BOS,23,0,0,0,0
6,8475278,Byron Froese,C,VGK,33,0,0,0,0
6,8475225,Craig Smith,C,DAL,35,0,0,0,0
6,8484326,Patrik Koch,D,ARI,28,0,0,0,0
6,8477930,Pierre-Edouard Bellemare,L,SEA,39,0,0,0,0
6,8478409,Anthony Richard,C,BOS,28,0,0,0,0
6,8481024,Linus Karlsson,C,VAN,25,0,0,0,0
6,8479986,Kole Lind,R,SEA,26,0,0,0,0
6,8479414,Nathan Bastian,R,NJD,27,0,0,0,0
6,8479362,Riley Tufte,L,COL,26,0,0,0,0
6,8481058,Jesse Ylönen,R,MTL,25,0,0,0,0
6,8482476,Emil Heineman,L,MTL,23,0,0,0,0
6,8482861,Vincent Iorio,D,WSH,22,0,0,0,0
6,8483432,Luca Del Bel Belluz,C,CBJ,31,0,0,0,0
6,8482744,James Malatesta,L,CBJ,21,0,0,0,0
6,8477887,Patrick Brown,C,BOS,32,0,0,0,0
6,8478585,Derek Ryan,C,EDM,38,0,0,0,0
6,8481441,Joe Snively,C,WSH,28,0,0,0,0
6,8481592,Jakob Pelletier,L,CGY,23,0,0,0,0
6,8482634,Alex Steeves,C,TOR,25,0,0,0,0
6,8477126,Jayson Megna,C,BOS,34,0,0,0,0
6,8475752,Tyler Pitlick,C,NYR,33,0,0,0,0
6,8480008,Adam Ruzicka,C,ARI,25,0,0,0,0
6,8481065,Angus Crookshank,L,OTT,25,0,0,0,0
6,8479547,Matthew Phillips,R,WSH,26,0,0,0,0
6,8480226,Marián Studenic,R,SEA,26,0,0,0,0
6,8481237,Kyle MacLean,C,NYI,25,0,0,0,0
6,8475413,Justin Dowling,C,NJD,34,0,0,0,0
6,8481641,Joel Kiviranta,L,COL,28,0,0,0,0
6,8478104,Sammy Blais,L,STL,28,0,0,0,0
6,8477454,Adam Erne,L,EDM,29,0,0,0,0
6,8481518,Nolan Foote,L,NJD,24,0,0,0,0
6,8480245,Olle Lycksell,R,PHI,25,0,0,0,0
6,8483570,Ben Meyers,C,ANA,26,0,0,0,0
6,8480776,Sheldon Rempal,R,VGK,29,0,0,0,0
6,8483920,Pierrick Dube,R,WSH,23,0,0,0,0
6,8480267,Sammy Walker,C,MIN,25,0,0,0,0
6,8482747,Brennan Othmann,L,NYR,21,0,0,0,0
6,8479991,Jake Leschyshyn,C,NYR,25,0,0,0,0
6,8478400,Colin White,C,MTL,27,0,0,0,0
6,8479328,Julien Gauthier,R,NYI,27,0,0,0,0
6,8484325,Waltteri Merela,C,TBL,26,0,0,0,0
6,8479066,Ryan Lomberg,L,FLA,30,0,0,0,0
6,8477070,Liam O'Brien,C,ARI,30,0,0,0,0
6,8478146,Matthew Highmore,C,OTT,28,0,0,0,0
6,8478028,Fredrik Olofsson,L,COL,28,0,0,0,0
6,8480880,Jakub Lauko,C,BOS,24,0,0,0,0
6,8479968,Vinni Lettieri,C,MIN,29,0,0,0,0
6,8474709,Matt Martin,L,NYI,35,0,0,0,0
6,8480845,Rasmus Kupari,C,WPG,24,0,0,0,0
6,8481550,Adam Beckman,L,MIN,23,0,0,0,0
6,8481422,Jacob Lucchini,C,MIN,29,0,0,0,0
6,8477401,John Hayden,C,SEA,29,0,0,0,0
6,8478904,Steven Lorentz,C,FLA,28,0,0,0,0
6,8482088,Justin Sourdif,R,FLA,22,0,0,0,0
6,8482751,Ryan Winterton,C,SEA,21,0,0,0,0
6,8482241,Radim Zohorna,L,PIT,28,0,0,0,0
6,8481690,Tyler Angle,C,CBJ,24,0,0,0,0
6,8476952,Dominic Toninato,C,WPG,30,0,0,0,0
6,8476919,Chris Tierney,C,NJD,30,0,0,0,0
6,8480032,Shane Bowers,C,NJD,25,0,0,0,0
6,8484314,Jiri Smejkal,L,OTT,28,0,0,0,0
6,8481239,Samuel Fagemo,L,LAK,24,0,0,0,0
6,8481532,Alex Turcotte,C,LAK,23,0,0,0,0
6,8481019,David Gustafsson,C,WPG,24,0,0,0,0
6,8478477,Mitchell Stephens,C,MTL,27,0,0,0,0
6,8479546,Oskar Steen,C,BOS,26,0,0,0,0
6,8480292,Carson Meyer,R,CBJ,27,0,0,0,0
6,8478446,Glenn Gawdin,C,ANA,27,0,0,0,0
6,8483531,Brian Halonen,L,NJD,25,0,0,0,0
6,8477149,Scott Sabourin,R,SJS,32,0,0,0,0
6,8479972,Mason Shaw,C,MIN,26,0,0,0,0
6,8480890,Jan Jenik,R,ARI,24,0,0,0,0
6,8478051,Max Willman,C,NJD,29,0,0,0,0
6,8480851,Akil Thomas,C,LAK,24,0,0,0,0
6,8482765,Isak Rosen,R,BUF,21,0,0,0,0
6,8478421,A.J. Greer,L,CGY,28,0,0,0,0
6,8478512,Austin Czarnik,C,DET,32,0,0,0,0
6,8479536,Axel Jonsson-Fjallby,L,WPG,26,0,0,0,0
6,8477320,Anton Blidh,L,NYR,29,0,0,0,0
6,8481543,Nikita Alexandrov,C,STL,24,0,0,0,0
6,8475235,Nicolas Deslauriers,L,PHI,33,0,0,0,0
6,8481070,Hugh McGing,L,STL,26,0,0,0,0
6,8480836,Jonathan Gruden,C,PIT,24,0,0,0,0
6,8481591,Sam Poulin,R,PIT,23,0,0,0,0
6,8477962,Brendan Lemieux,L,CAR,28,0,0,0,0
6,8483401,Marc Johnstone,R,PIT,28,0,0,0,0
6,8482250,Callahan Burke,C,CAR,27,0,0,0,0
6,8481726,Adam Edstrom,C,NYR,24,0,0,0,0
6,8471817,Ryan Reaves,R,TOR,37,0,0,0,0
6,8479587,Rhett Gardner,C,PHI,28,0,0,0,0
6,8475766,Austin Watson,L,TBL,32,0,0,0,0
6,8479367,William Lockwood,R,FLA,26,0,0,0,0
6,8478424,Jansen Harkins,C,PIT,27,0,0,0,0
6,8476913,Devin Shore,C,SEA,30,0,0,0,0
6,8482652,Walker Duehr,R,CGY,27,0,0,0,0
6,8477527,Ross Johnston,L,ANA,30,0,0,0,0
6,8481077,John Leonard,L,ARI,26,0,0,0,0
6,8483549,Lucas Condotta,L,MTL,27,0,0,0,0
6,8480468,James Hamblin,L,EDM,25,0,0,0,0
6,8476907,Mackenzie MacEachern,L,STL,30,0,0,0,0
6,8479543,Michael Pezzetta,L,MTL,26,0,0,0,0
6,8480355,Mark Kastelic,C,OTT,25,0,0,0,0
6,8482162,Roby Jarventie,L,OTT,22,0,0,0,0
6,8479772,Zack MacEwen,R,OTT,28,0,0,0,0
6,8483597,Milos Kelemen,L,ARI,25,0,0,0,0
6,8479379,Givani Smith,R,SJS,26,0,0,0,0
6,8481655,Cole Schwindt,R,CGY,23,0,0,0,0
6,8479981,Jonah Gadjovich,L,FLA,26,0,0,0,0
6,8482147,Jean-Luc Foudy,C,COL,22,0,0,0,0
6,8484255,Jason Polin,R,COL,25,0,0,0,0
6,8477993,Justin Kirkland,C,ARI,28,0,0,0,0
6,8479249,Andrew Poturalski,C,SEA,30,0,0,0,0
6,8482197,Adam Raska,R,MIN,23,0,0,0,0
6,8475780,Chris Wagner,R,COL,33,0,0,0,0
6,8479533,Joona Koppanen,L,PIT,26,0,0,0,0
6,8481534,Raphael Lavoie,C,EDM,24,0,0,0,0
6,8484321,Nikolas Matinpalo,D,OTT,26,0,0,0,0
6,8481043,Cole Koepke,L,TBL,26,0,0,0,0
6,8476323,Max McCormick,L,SEA,32,0,0,0,0
6,8483609,Adam Klapka,R,CGY,24,0,0,0,0
6,8483512,Matt Savoie,C,BUF,20,0,0,0,0
6,8484259,Ondrej Pavel,C,COL,31,0,0,0,0
6,8478147,Bokondji Imama,L,OTT,28,0,0,0,0
6,8482460,Matt Rempe,C,NYR,22,0,0,0,0
6,8477073,Kurtis MacDermid,L,NJD,30,0,0,0,0
6,8480274,Philip Kemp,D,EDM,25,0,0,0,0
6,8478956,Samuel Laberge,L,NJD,27,0,0,0,0
6,8483045,Cameron Butler,R,CBJ,31,0,0,0,0
7,8476453,Nikita Kucherov,R,TBL,31,82,42,101,143
7,8478402,Connor McDavid,C,EDM,27,82,43,89,132
7,8478864,Kirill Kaprizov,L,MIN,27,82,47,65,112
7,8481559,Jack Hughes,C,NJD,23,82,44,64,108
7,8479318,Auston Matthews,C,TOR,27,82,65,41,106
7,8477492,Nathan MacKinnon,C,COL,29,82,51,54,105
7,8478550,Artemi Panarin,L,NYR,33,82,40,65,105
7,8477933,Sam Reinhart,C,FLA,29,82,51,53,104
7,8476468,J.T. Miller,C,VAN,31,82,41,60,101
7,8474564,Steven Stamkos,C,TBL,34,82,52,47,99
7,8480027,Jason Robertson,L,DAL,25,82,35,63,98
7,8477493,Aleksander Barkov,C,FLA,29,82,27,70,97
7,8478420,Mikko Rantanen,R,COL,28,82,36,60,96
7,8477934,Leon Draisaitl,C,EDM,29,82,35,58,93
7,8477956,David Pastrnak,R,BOS,28,82,35,56,91
7,8476887,Filip Forsberg,L,NSH,30,82,47,40,87
7,8475172,Nazem Kadri,C,CGY,34,82,32,54,86
7,8480012,Elias Pettersson,C,VAN,26,82,33,52,85
7,8478010,Brayden Point,C,TBL,28,82,38,45,83
7,8478427,Sebastian Aho,C,CAR,27,82,28,55,83
7,8476460,Mark Scheifele,C,WPG,31,82,35,47,82
7,8479407,Jesper Bratt,L,NJD,26,82,26,55,81
7,8477404,Jake Guentzel,C,CAR,30,82,34,46,80
7,8477402,Pavel Buchnevich,L,STL,29,82,30,50,80
7,8480002,Nico Hischier,C,NJD,25,82,32,47,79
7,8478445,Mathew Barzal,C,NYI,27,82,24,55,79
7,8479323,Adam Fox,D,NYR,26,82,17,60,77
7,8480801,Brady Tkachuk,L,OTT,25,82,37,39,76
7,8479314,Matthew Tkachuk,L,FLA,27,82,26,50,76
7,8481557,Matt Boldy,L,MIN,23,82,23,53,76
7,8479343,Clayton Keller,R,ARI,26,82,38,37,75
7,8477939,William Nylander,R,TOR,28,82,33,41,74
7,8480830,Andrei Svechnikov,R,CAR,24,82,32,42,74
7,8477955,Jared McCann,L,SEA,28,82,30,43,73
7,8471675,Sidney Crosby,C,PIT,37,82,26,47,73
7,8482116,Tim Stützle,C,OTT,22,82,20,53,73
7,8476346,Johnny Gaudreau,L,CBJ,31,82,17,56,73
7,8477960,Adrian Kempe,R,LAK,28,82,30,42,72
7,8477409,Carter Verhaeghe,C,FLA,29,82,33,38,71
7,8478449,Roope Hintz,C,DAL,28,82,28,43,71
7,8479542,Brandon Hagel,L,TBL,26,82,28,43,71
7,8480023,Robert Thomas,C,STL,25,82,12,59,71
7,8480800,Quinn Hughes,D,VAN,25,82,11,60,71
7,8482109,Alexis Lafrenière,L,NYR,23,82,36,34,70
7,8475913,Mark Stone,R,VGK,32,82,30,40,70
7,8475167,Victor Hedman,D,TBL,34,82,16,54,70
7,8475184,Chris Kreider,L,NYR,33,82,41,28,69
7,8471215,Evgeni Malkin,C,PIT,38,82,28,41,69
7,8476459,Mika Zibanejad,C,NYR,31,82,28,41,69
7,8474141,Patrick Kane,R,DET,36,82,35,33,68
7,8475754,Brock Nelson,C,NYI,33,82,34,34,68
7,8482684,Luke Hughes,D,NJD,21,82,26,42,68
7,8475166,John Tavares,C,TOR,34,82,24,44,68
7,8475786,Zach Hyman,L,EDM,32,82,37,30,67
7,8477942,Kevin Fiala,L,LAK,28,82,30,37,67
7,8476905,Chandler Stephenson,C,VGK,30,82,20,47,67
7,8476462,Dougie Hamilton,D,NJD,31,82,17,50,67
7,8478042,Viktor Arvidsson,R,LAK,31,82,32,34,66
7,8477946,Dylan Larkin,C,DET,28,82,29,37,66
7,8475158,Ryan O'Reilly,C,NSH,33,82,28,38,66
7,8475765,Vladimir Tarasenko,R,FLA,33,82,26,40,66
7,8481523,Kirby Dach,C,MTL,23,82,13,53,66
7,8478403,Jack Eichel,C,VGK,28,82,25,40,65
7,8474578,Erik Karlsson,D,PIT,34,82,20,45,65
7,8478444,Brock Boeser,R,VAN,27,82,35,29,64
7,8478414,Timo Meier,R,NJD,28,82,33,31,64
7,8480018,Nick Suzuki,C,MTL,25,82,27,37,64
7,8471685,Anze Kopitar,C,LAK,37,82,25,39,64
7,8470794,Joe Pavelski,C,DAL,40,82,24,40,64
7,8474600,Roman Josi,D,NSH,34,82,20,44,64
7,8475692,Mats Zuccarello,R,MIN,37,82,16,48,64
7,8475168,Matt Duchene,C,DAL,33,82,28,35,63
7,8477951,Nick Schmaltz,C,ARI,28,82,26,37,63
7,8480803,Evan Bouchard,D,EDM,25,82,12,51,63
7,8471214,Alex Ovechkin,L,WSH,39,82,34,28,62
7,8482078,Lucas Raymond,L,DET,22,82,23,39,62
7,8477949,Alex Tuch,R,BUF,28,82,21,41,62
7,8476882,Teuvo Teravainen,L,CAR,30,82,18,44,62
7,8480839,Rasmus Dahlin,D,BUF,24,82,17,45,62
7,8478401,Pavel Zacha,C,BOS,27,82,28,33,61
7,8476454,Ryan Nugent-Hopkins,C,EDM,31,82,25,36,61
7,8477940,Nikolaj Ehlers,L,WPG,28,82,25,36,61
7,8476881,Tomas Hertl,C,VGK,31,82,24,37,61
7,8480069,Cale Makar,D,COL,26,82,16,45,61
7,8475191,Reilly Smith,R,PIT,33,82,33,27,60
7,8478398,Kyle Connor,L,WPG,28,82,26,34,60
7,8478047,Michael Bunting,L,PIT,29,82,20,40,60
7,8476456,Jonathan Huberdeau,C,CGY,31,82,12,48,60
7,8480208,Drake Batherson,R,OTT,26,82,25,34,59
7,8481533,Trevor Zegras,C,ANA,23,82,22,37,59
7,8477497,Sean Monahan,C,WPG,30,82,18,41,59
7,8478469,Thomas Chabot,D,OTT,27,82,14,45,59
7,8477986,Brandon Montour,D,FLA,30,82,13,46,59
7,8477935,Sam Bennett,C,FLA,28,82,31,27,58
7,8482093,Seth Jarvis,C,CAR,22,82,30,28,58
7,8475794,Tyler Seguin,C,DAL,32,82,29,29,58
7,8481068,Yegor Sharangovich,C,CGY,26,82,25,33,58
7,8482745,Mason McTavish,C,ANA,21,82,23,35,58
7,8483808,Andrei Kuzmenko,L,CGY,28,82,20,38,58
7,8481711,Matias Maccelli,L,ARI,24,82,19,39,58
7,8481540,Cole Caufield,R,MTL,23,82,32,25,57
7,8476539,Jonathan Marchessault,R,VGK,34,82,29,28,57
7,8476399,Blake Coleman,C,CGY,33,82,28,29,57
7,8476389,Vincent Trocheck,C,NYR,31,82,27,30,57
7,8476880,Tom Wilson,R,WSH,30,82,27,30,57
7,8476479,Phillip Danault,C,LAK,31,82,25,32,57
7,8477447,Shea Theodore,D,VGK,29,82,13,44,57
7,8479425,Filip Hronek,D,VAN,27,82,11,46,57
7,8477500,Bo Horvat,C,NYI,29,82,31,25,56
7,8475726,Tyler Toffoli,C,WPG,32,82,26,30,56
7,8475151,Kyle Palmieri,C,NYI,33,82,25,31,56
7,8480039,Martin Necas,C,CAR,25,82,24,32,56
7,8473994,Jamie Benn,L,DAL,35,82,19,37,56
7,8475744,Evgeny Kuznetsov,C,CAR,32,82,18,38,56
7,8480865,Noah Dobson,D,NYI,24,82,13,43,56
7,8479385,Jordan Kyrou,C,STL,26,82,28,27,55
7,8479420,Tage Thompson,C,BUF,27,82,23,32,55
7,8473419,Brad Marchand,L,BOS,36,82,20,35,55
7,8478397,Rasmus Andersson,D,CGY,28,82,16,39,55
7,8480031,Maxime Comtois,L,CAR,25,82,15,40,55
7,8478439,Travis Konecny,R,PHI,27,82,24,30,54
7,8476853,Morgan Rielly,D,TOR,30,82,8,46,54
7,8478498,Jake DeBrusk,L,BOS,28,82,27,26,53
7,8475784,Jeff Skinner,C,BUF,32,82,26,27,53
7,8477407,Anthony Duclair,L,TBL,29,82,25,28,53
7,8477451,Ryan Hartman,R,MIN,30,82,24,29,53
7,8482097,Jack Quinn,R,BUF,23,82,23,30,53
7,8477479,Tyler Bertuzzi,L,TOR,29,82,21,32,53
7,8479999,Casey Mittelstadt,C,COL,26,82,13,40,53
7,8478873,Troy Terry,R,ANA,27,82,11,42,53
7,8474563,Drew Doughty,D,LAK,35,82,8,45,53
7,8474590,John Carlson,D,WSH,34,82,4,49,53
7,8477501,Valeri Nichushkin,R,COL,29,82,28,24,52
7,8474102,David Perron,L,DET,36,82,26,26,52
7,8475722,Jason Zucker,L,NSH,32,82,20,32,52
7,8474679,Gustav Nyquist,C,NSH,35,82,19,33,52
7,8474586,Jordan Eberle,R,SEA,34,82,15,37,52
7,8478055,Gustav Forsling,D,FLA,28,82,13,39,52
7,8478407,Vince Dunn,D,SEA,28,82,12,40,52
7,8476432,Boone Jenner,C,CBJ,31,82,29,22,51
7,8474157,Max Pacioretty,L,WSH,36,82,26,25,51
7,8478542,Evan Rodrigues,C,FLA,31,82,20,31,51
7,8475798,Mikael Granlund,C,SJS,32,82,18,33,51
7,8478440,Dylan Strome,C,WSH,27,82,16,35,51
7,8480078,Filip Chytil,C,NYR,25,82,14,37,51
7,8478396,Noah Hanifin,D,VGK,27,82,13,38,51
7,8478460,Zach Werenski,D,CBJ,27,82,13,38,51
7,8477503,Max Domi,C,TOR,29,82,10,41,51
7,8478493,Joel Eriksson Ek,C,MIN,27,82,28,22,50
7,8476483,Rickard Rakell,R,PIT,31,82,27,23,50
7,8478856,Conor Garland,R,VAN,28,82,26,24,50
7,8484144,Connor Bedard,C,CHI,19,82,26,24,50
7,8480015,Owen Tippett,R,PHI,25,82,25,25,50
7,8474641,Adam Henrique,C,EDM,34,82,25,25,50
7,8477416,Oliver Bjorkstrand,R,SEA,29,82,20,30,50
7,8482113,Anton Lundell,C,FLA,23,82,19,31,50
7,8475745,Charlie Coyle,C,BOS,32,82,15,35,50
7,8481581,Thomas Harley,D,DAL,23,82,8,42,50
7,8476927,Teddy Blueger,C,VAN,30,82,7,43,50
7,8482740,Wyatt Johnston,C,DAL,21,82,26,23,49
7,8477496,Elias Lindholm,C,VAN,30,82,22,27,49
7,8480798,Philipp Kurashev,C,CHI,25,82,20,29,49
7,8477456,J.T. Compher,L,DET,29,82,14,35,49
7,8476292,Ondrej Palat,L,NJD,33,82,14,35,49
7,8477504,Josh Morrissey,D,WPG,29,82,9,40,49
7,8475287,Erik Haula,L,NJD,33,82,23,25,48
7,8481528,Dylan Cozens,C,BUF,23,82,22,26,48
7,8475170,Brayden Schenn,C,STL,33,82,21,27,48
7,8480064,Josh Norris,C,OTT,25,82,19,29,48
7,8477511,Anthony Mantha,R,VGK,30,82,18,30,48
7,8479987,Morgan Geekie,C,BOS,26,82,15,33,48
7,8478458,Jack Roslovic,C,NYR,27,82,13,35,48
7,8475810,Bryan Rust,R,PIT,32,82,22,25,47
7,8478519,Anthony Cirelli,C,TBL,27,82,21,26,47
7,8473512,Claude Giroux,R,OTT,36,82,19,28,47
7,8482667,William Eklund,L,SJS,22,82,19,28,47
7,8476826,Yanni Gourde,C,SEA,33,82,18,29,47
7,8476875,Mike Matheson,D,MTL,30,82,9,38,47
7,8481699,Aku Raty,R,ARI,23,82,2,45,47
7,8483524,Shane Wright,C,SEA,20,82,33,13,46
7,8475169,Evander Kane,L,EDM,33,82,27,19,46
7,8481624,Ilya Mikheyev,R,VAN,30,82,23,23,46
7,8482699,Dylan Guenther,R,ARI,21,82,22,24,46
7,8480185,Eetu Luostarinen,C,FLA,26,82,22,24,46
7,8478975,Mason Marchment,L,DAL,29,82,20,26,46
7,8476872,Scott Laughton,C,PHI,30,82,19,27,46
7,8477495,Seth Jones,D,CHI,30,82,12,34,46
7,8475218,Mattias Ekholm,D,EDM,34,82,8,38,46
7,8479410,Mikhail Sergachev,D,TBL,26,82,5,41,46
7,8473986,Alex Killorn,L,ANA,35,82,20,25,45
7,8483445,Cutter Gauthier,L,ANA,20,82,15,30,45
7,8479325,Charlie McAvoy,D,BOS,27,82,10,35,45
7,8480036,Miro Heiskanen,D,DAL,25,82,8,37,45
7,8483457,Lane Hutson,D,MTL,20,82,5,40,45
7,8483471,Brad Lambert,C,WPG,31,82,2,43,45
7,8482702,Logan Stankoven,C,DAL,21,82,27,17,44
7,8478233,Andrew Mangiapane,L,CGY,28,82,19,25,44
7,8476329,Travis Boyd,C,ARI,31,82,18,26,44
7,8475768,Jaden Schwartz,C,SEA,32,82,18,26,44
7,8479339,Patrik Laine,L,CBJ,26,82,17,27,44
7,8482159,Tyson Foerster,R,PHI,22,82,17,27,44
7,8482124,Quinton Byfield,R,LAK,22,82,16,28,44
7,8479337,Alex DeBrincat,R,DET,27,82,13,31,44
7,8477444,Andre Burakovsky,L,SEA,29,82,13,31,44
7,8477021,Alex Kerfoot,C,ARI,30,82,11,33,44
7,8480434,Sean Durzi,D,ARI,26,82,10,34,44
7,8477932,Aaron Ekblad,D,FLA,28,82,8,36,44
7,8478438,Tommy Novak,C,NSH,27,82,7,37,44
7,8480014,Gabriel Vilardi,C,WPG,25,82,33,10,43
7,8475314,Anders Lee,L,NYI,34,82,25,18,43
7,8476981,Josh Anderson,R,MTL,30,82,23,20,43
7,8476438,Brandon Saad,L,STL,32,82,21,22,43
7,8482665,Matty Beniers,C,SEA,22,82,18,25,43
7,8477346,MacKenzie Weegar,D,CGY,30,82,17,26,43
7,8478463,Anthony Beauvillier,L,NSH,27,82,15,28,43
7,8481542,Moritz Seider,D,DET,23,82,8,35,43
7,8482101,Danil Gushchin,L,SJS,22,82,21,21,42
7,8478462,Nicolas Roy,C,VGK,27,82,16,26,42
7,8476458,Ryan Strome,C,ANA,31,82,11,31,42
7,8475171,Oliver Ekman-Larsson,D,FLA,33,82,7,35,42
7,8483397,Marc McLaughlin,C,BOS,25,82,36,5,41
7,8478366,Frank Vatrano,R,ANA,30,82,26,15,41
7,8475791,Taylor Hall,L,CHI,33,82,21,20,41
7,8475763,Kevin Hayes,R,STL,32,82,20,21,41
7,8481596,Shane Pinto,C,OTT,24,82,19,22,41
7,8477964,Ivan Barbashev,C,VGK,29,82,16,25,41
7,8476461,Sean Couturier,C,PHI,32,82,14,27,41
7,8482122,Brock Faber,D,MIN,22,82,10,31,41
7,8482671,Owen Power,D,BUF,22,82,7,34,41
7,8480188,Fabian Zetterlund,L,SJS,25,82,24,16,40
7,8478474,Lawson Crouse,L,ARI,27,82,24,16,40
7,8482175,JJ Peterka,R,BUF,22,82,23,17,40
7,8477476,Artturi Lehkonen,L,COL,29,82,18,22,40
7,8477426,Nicholas Paul,L,TBL,29,82,17,23,40
7,8480797,Joel Farabee,L,PHI,24,82,17,23,40
7,8478109,Victor Olofsson,L,BUF,29,82,17,23,40
7,8483515,Juraj Slafkovsky,L,MTL,20,82,15,25,40
7,8471698,T.J. Oshie,R,WSH,38,82,14,26,40
7,8480028,Morgan Frost,C,PHI,25,82,6,34,40
7,8477998,Warren Foegele,L,EDM,28,82,22,17,39
7,8475799,Nino Niederreiter,R,WPG,32,82,22,17,39
7,8482475,Yegor Chinakhov,R,CBJ,23,82,19,20,39
7,8474149,Evgenii Dadonov,R,DAL,35,82,14,25,39
7,8476448,William Karlsson,C,VGK,31,82,12,27,39
7,8481546,Cam York,D,PHI,23,82,8,31,39
7,8476792,Torey Krug,D,STL,33,82,7,32,39
7,8481604,Pavel Dorofeyev,L,VGK,24,82,24,14,38
7,8482089,Jake Neighbours,L,STL,22,82,20,18,38
7,8474884,Mike Hoffman,C,SJS,35,82,19,19,38
7,8481618,Alex Newhook,C,MTL,23,82,18,20,38
7,8481560,Arthur Kaliyev,R,LAK,23,82,18,20,38
7,8479675,Trevor Moore,L,LAK,29,82,13,25,38
7,8475753,Justin Faulk,D,STL,32,82,13,25,38
7,8484145,Zach Benson,L,BUF,19,82,13,25,38
7,8475197,Tyson Barrie,D,NSH,33,82,6,32,38
7,8479423,Alex Nylander,L,CBJ,26,82,18,19,37
7,8479591,Michael Eyssimont,C,TBL,28,82,17,20,37
7,8478046,Danton Heinen,L,BOS,29,82,16,21,37
7,8478466,Daniel Sprong,R,DET,27,82,15,22,37
7,8479992,Michael Rasmussen,C,DET,25,82,14,23,37
7,8471218,Blake Wheeler,R,NYR,38,82,13,24,37
7,8482105,Jake Sanderson,D,OTT,22,82,12,25,37
7,8476906,Shayne Gostisbehere,D,DET,31,82,11,26,37
7,8476979,Erik Gustafsson,D,NYR,32,82,10,27,37
7,8482118,Sam Colangelo,R,ANA,23,82,26,10,36
7,8482110,Dawson Mercer,C,NJD,23,82,19,17,36
7,8482055,Drew O'Connor,L,PIT,26,82,18,18,36
7,8477839,Conor Sheary,L,TBL,32,82,18,18,36
7,8474870,Tyler Johnson,C,CHI,34,82,15,21,36
7,8481656,Aliaksei Protas,C,WSH,23,82,11,25,36
7,8479400,Pierre-Luc Dubois,L,LAK,26,82,15,20,35
7,8476873,Mark Jankowski,C,NSH,30,82,14,21,35
7,8482624,Daniil Miromanov,D,CGY,27,82,14,21,35
7,8480220,Noah Cates,L,PHI,25,82,13,22,35
7,8476869,Brady Skjei,D,CAR,30,82,12,23,35
7,8482705,Cole Sillinger,C,CBJ,21,82,11,24,35
7,8477425,Miles Wood,L,COL,29,82,10,25,35
7,8478038,Devon Toews,D,COL,30,82,8,27,35
7,8474037,James van Riemsdyk,L,BOS,35,82,8,27,35
7,8479345,Jakob Chychrun,D,OTT,26,82,7,28,35
7,8476463,Jonas Brodin,D,MIN,31,82,3,32,35
7,8475848,Brendan Gallagher,R,MTL,32,82,22,12,34
7,8482146,Luke Evangelista,R,NSH,22,82,15,19,34
7,8477952,Robby Fabbri,C,DET,28,82,15,19,34
7,8481704,Juuso Parssinen,C,NSH,23,82,14,20,34
7,8480893,Kirill Marchenko,R,CBJ,24,82,13,21,34
7,8482092,Ridly Greig,C,OTT,22,82,13,21,34
7,8480009,Eeli Tolvanen,R,SEA,25,82,12,22,34
7,8474565,Alex Pietrangelo,D,VGK,34,82,8,26,34
7,8482222,Alexander Barabanov,L,SJS,30,82,8,26,34
7,8480817,K'Andre Miller,D,NYR,24,82,7,27,34
7,8479398,Samuel Girard,D,COL,26,82,6,28,34
7,8471724,Kris Letang,D,PIT,37,82,5,29,34
7,8483493,Frank Nazar,C,CHI,20,82,27,6,33
7,8482079,Marco Rossi,C,MIN,23,82,20,13,33
7,8478020,Michael Amadio,C,VGK,28,82,19,14,33
7,8475343,Nic Dowd,C,WSH,34,82,18,15,33
7,8478057,Dakota Joshua,C,VAN,28,82,15,18,33
7,8474053,Logan Couture,C,SJS,35,82,11,22,33
7,8477494,Jonathan Drouin,L,COL,29,82,10,23,33
7,8482111,Justin Barron,D,MTL,23,82,9,24,33
7,8479390,Taylor Raddysh,R,CHI,26,82,9,24,33
7,8473507,Jeff Petry,D,DET,37,82,4,29,33
7,8477969,Marcus Pettersson,D,PIT,28,82,3,30,33
7,8482733,Logan Mailloux,D,MTL,31,82,1,32,33
7,8475760,Nick Bjugstad,C,ARI,32,82,20,12,32
7,8479941,Justin Danforth,R,CBJ,31,82,19,13,32
7,8473533,Jordan Staal,C,CAR,36,82,19,13,32
7,8476469,Joel Armia,R,MTL,31,82,18,14,32
7,8478413,Jordan Greenway,L,BUF,27,82,17,15,32
7,8480459,Pius Suter,C,VAN,28,82,13,19,32
7,8476925,Colton Sissons,C,NSH,31,82,13,19,32
7,8474150,Mikael Backlund,C,CGY,35,82,12,20,32
7,8477947,Sonny Milano,L,WSH,28,82,11,21,32
7,8479525,Ross Colton,C,COL,28,82,10,22,32
7,8477488,Brett Pesce,D,CAR,30,82,2,30,32
7,8475714,Calle Jarnkrok,C,TOR,33,82,19,12,31
7,8480068,Ryan Poehling,C,PHI,25,82,17,14,31
7,8481580,Connor McMichael,C,WSH,23,82,16,15,31
7,8481601,Simon Holmstrom,R,NYI,23,82,13,18,31
7,8482062,Cole Smith,L,NSH,29,82,13,18,31
7,8483499,Liam Ohgren,L,MIN,20,82,12,19,31
7,8476392,Adam Lowry,C,WPG,31,82,12,19,31
7,8477919,Frederick Gaudreau,C,MIN,31,82,11,20,31
7,8480802,Ryan McLeod,C,EDM,25,82,11,20,31
7,8477353,Tyler Motte,C,TBL,29,82,10,21,31
7,8477498,Darnell Nurse,D,EDM,29,82,8,23,31
7,8478472,Mathieu Joseph,R,OTT,27,82,6,25,31
7,8480873,Rasmus Sandin,D,WSH,24,82,4,27,31
7,8480246,Nick Perbix,D,TBL,26,82,3,28,31
7,8478115,Pierre Engvall,L,NYI,28,82,16,14,30
7,8479996,Cody Glass,C,NSH,25,82,16,14,30
7,8482720,Matthew Knies,L,TOR,22,82,15,15,30
7,8473563,Nicklas Backstrom,C,WSH,37,82,14,16,30
7,8481481,Blake Lizotte,C,LAK,27,82,14,16,30
7,8479365,Trent Frederic,C,BOS,26,82,7,23,30
7,8476958,Jaccob Slavin,D,CAR,30,82,5,25,30
7,8481016,Ruslan Iskhakov,C,NYI,24,82,3,27,30
7,8481535,Nils Hoglander,L,VAN,24,82,17,12,29
7,8477429,Andrew Copp,C,DET,30,82,13,16,29
7,8479351,Sam Steel,C,DAL,26,82,12,17,29
7,8481703,Valtteri Puustinen,R,PIT,25,82,10,19,29
7,8470621,Corey Perry,R,EDM,39,82,10,19,29
7,8473422,Nick Foligno,L,CHI,37,82,8,21,29
7,8482730,Brandt Clarke,D,LAK,21,82,8,21,29
7,8477450,Jason Dickinson,C,CHI,29,82,7,22,29
7,8470613,Brent Burns,D,CAR,39,82,6,23,29
7,8479415,Michael McLeod,C,NJD,26,82,6,23,29
7,8478500,Ivan Provorov,D,CBJ,27,82,5,24,29
7,8475181,Nick Leddy,D,STL,33,82,3,26,29
7,8477944,Jakub Vrana,L,STL,28,82,16,12,28
7,8475220,Marcus Foligno,L,MIN,33,82,14,14,28
7,8478569,Noel Acciari,C,PIT,33,82,14,14,28
7,8480849,Barrett Hayton,C,ARI,24,82,13,15,28
7,8480806,Isac Lundestrom,C,ANA,25,82,13,15,28
7,8483431,Logan Cooley,C,ARI,20,82,11,17,28
7,8475149,Marcus Johansson,L,MIN,34,82,10,18,28
7,8477506,Ryan Pulock,D,NYI,30,82,7,21,28
7,8476902,Esa Lindell,D,DAL,30,82,5,23,28
7,8482142,Jamie Drysdale,D,PHI,22,82,5,23,28
7,8482133,Thomas Bordeleau,C,SJS,22,82,5,23,28
7,8474673,TJ Brodie,D,TOR,34,82,5,23,28
7,8481568,Alex Vlasic,D,CHI,23,82,4,24,28
7,8482087,Kaiden Guhle,D,MTL,22,82,3,25,28
7,8477330,Dominik Kubalik,L,OTT,29,82,16,11,27
7,8473449,Kyle Okposo,R,FLA,36,82,15,12,27
7,8479977,Kailer Yamamoto,R,SEA,26,82,14,13,27
7,8474716,Jared Spurgeon,D,MIN,35,82,13,14,27
7,8479293,Brandon Tanev,L,SEA,33,82,13,14,27
7,8476480,Vladislav Namestnikov,C,WPG,32,82,11,16,27
7,8479346,Dillon Dube,C,CGY,26,82,11,16,27
7,8479353,Brett Howden,C,VGK,26,82,10,17,27
7,8484153,Leo Carlsson,C,ANA,20,82,9,18,27
7,8477953,Kasperi Kapanen,R,STL,28,82,9,18,27
7,8476419,Jean-Gabriel Pageau,C,NYI,32,82,7,20,27
7,8480871,Adam Boqvist,D,CBJ,24,82,7,20,27
7,8474034,Pat Maroon,L,BOS,36,82,6,21,27
7,8477435,Ryan Graves,D,PIT,29,82,6,21,27
7,8479976,Juuso Valimaki,D,ARI,26,82,5,22,27
7,8481606,Jordan Spence,D,LAK,23,82,4,23,27
7,8478508,Yakov Trenin,C,COL,27,82,17,9,26
7,8482737,Zack Bolduc,C,STL,21,82,16,10,26
7,8481554,Kaapo Kakko,R,NYR,23,82,15,11,26
7,8480821,Filip Zadina,R,SJS,25,82,15,11,26
7,8470604,Jeff Carter,C,PIT,39,82,14,12,26
7,8482117,Lukas Reichel,L,CHI,22,82,11,15,26
7,8478133,Jake Evans,C,MTL,28,82,11,15,26
7,8478443,Brandon Carlo,D,BOS,28,82,11,15,26
7,8476960,Andreas Athanasiou,C,CHI,30,82,10,16,26
7,8481014,Alexander Romanov,D,NYI,24,82,8,18,26
7,8475764,Cam Fowler,D,ANA,33,82,6,20,26
7,8478911,Matt Roy,D,LAK,29,82,6,20,26
7,8479514,Rem Pitlick,C,CHI,27,82,6,20,26
7,8478136,Jake Middleton,D,MIN,28,82,4,22,26
7,8479661,Tanner Jeannot,L,TBL,27,82,14,11,25
7,8483505,Matthew Poitras,C,BOS,20,82,11,14,25
7,8477948,Travis Sanheim,D,PHI,28,82,10,15,25
7,8482245,Artem Zub,D,OTT,29,82,9,16,25
7,8482073,Braden Schneider,D,NYR,23,82,9,16,25
7,8476892,Colton Parayko,D,STL,31,82,7,18,25
7,8477505,Alexander Wennberg,C,NYR,30,82,7,18,25
7,8478840,Will Borgen,D,SEA,28,82,6,19,25
7,8474151,Ryan McDonagh,D,NSH,35,82,5,20,25
7,8479371,Dante Fabbro,D,NSH,26,82,5,20,25
7,8476457,Adam Larsson,D,SEA,32,82,4,21,25
7,8476331,Dylan DeMelo,D,WPG,31,82,4,21,25
7,8478178,Darren Raddysh,D,TBL,28,82,4,21,25
7,8475690,Chris Tanev,D,DAL,35,82,4,21,25
7,8476854,Hampus Lindholm,D,BOS,30,82,1,24,25
7,8477989,Christian Dvorak,C,MTL,28,82,14,10,24
7,8478891,Mason Appleton,C,WPG,28,82,13,11,24
7,8476871,Tanner Pearson,L,MTL,32,82,12,12,24
7,8479383,Boris Katchouk,L,OTT,26,82,12,12,24
7,8480113,Alex Iafallo,L,WPG,31,82,10,14,24
7,8481517,Brett Leason,R,ANA,25,82,9,15,24
7,8479359,Beck Malenstyn,L,WSH,26,82,8,16,24
7,8482655,J.J. Moser,D,ARI,24,82,8,16,24
7,8476923,Damon Severson,D,CBJ,30,82,6,18,24
7,8480860,Kevin Bahl,D,NJD,24,82,6,18,24
7,8480043,Timothy Liljegren,D,TOR,25,82,5,19,24
7,8480073,Erik Brannstrom,D,OTT,25,82,4,20,24
7,8476467,Jamie Oleksiak,D,SEA,32,82,3,21,24
7,8480145,Neal Pionk,D,WPG,29,82,2,22,24
7,8476885,Jacob Trouba,D,NYR,30,82,2,22,24
7,8474574,Tyler Myers,D,VAN,34,82,1,23,24
7,8475793,Ryan Johansen,C,PHI,32,82,15,8,23
7,8481093,Rafael Harvey-Pinard,L,MTL,25,82,14,9,23
7,8476921,Jordan Martinook,L,CAR,32,82,13,10,23
7,8479316,Luke Kunin,C,SJS,27,82,11,12,23
7,8475231,Casey Cizikas,C,NYI,33,82,9,14,23
7,8476624,Barclay Goodrow,C,NYR,31,82,9,14,23
7,8476879,Cody Ceci,D,EDM,31,82,5,18,23
7,8478507,John Marino,D,NJD,27,82,4,19,23
7,8478851,Alexandre Carrier,D,NSH,28,82,4,19,23
7,8475906,John Klingberg,D,TOR,32,82,3,20,23
7,8482074,Connor Zary,C,CGY,23,82,12,10,22
7,8480855,Jack McBain,C,ARI,24,82,10,12,22
7,8477508,Curtis Lazar,C,NJD,29,82,10,12,22
7,8476374,Sean Kuraly,C,CBJ,31,82,10,12,22
7,8474715,Cam Atkinson,R,PHI,35,82,9,13,22
7,8481028,Martin Pospisil,C,CGY,25,82,9,13,22
7,8475164,Jakob Silfverberg,R,ANA,34,82,7,15,22
7,8481013,Jonatan Berggren,R,DET,24,82,6,16,22
7,8475200,Dmitry Orlov,D,CAR,33,82,6,16,22
7,8476897,Oskar Sundqvist,C,STL,30,82,6,16,22
7,8476525,Colin Miller,D,WPG,32,82,6,16,22
7,8477392,Hudson Fasching,R,NYI,29,82,6,16,22
7,8483490,Pavel Mintyukov,D,ANA,21,82,5,17,22
7,8475233,David Savard,D,MTL,34,82,3,19,22
7,8481178,Egor Zamula,D,PHI,24,82,3,19,22
7,8480035,Henri Jokiharju,D,BUF,25,82,2,20,22
7,8480074,Alexandre Texier,C,CBJ,25,82,13,8,21
7,8482259,Bobby McMann,C,TOR,28,82,9,12,21
7,8474009,Nick Bonino,C,NYR,36,82,8,13,21
7,8476422,Mike Reilly,D,NYI,31,82,8,13,21
7,8477507,Nikita Zadorov,D,VAN,29,82,7,14,21
7,8473453,Trevor Lewis,C,LAK,37,82,7,14,21
7,8475455,Brenden Dillon,D,WPG,34,82,5,16,21
7,8474166,Alec Martinez,D,VGK,37,82,5,16,21
7,8477365,Connor Clifton,D,BUF,29,82,4,17,21
7,8479983,Mario Ferraro,D,SJS,26,82,2,19,21
7,8481186,Logan O'Connor,R,COL,28,82,11,9,20
7,8482155,Alex Laferriere,R,LAK,23,82,11,9,20
7,8484166,Adam Fantilli,C,CBJ,20,82,9,11,20
7,8476858,Phillip Di Giuseppe,L,VAN,31,82,9,11,20
7,8479393,Noah Gregor,C,TOR,26,82,7,13,20
7,8480796,Martin Fehervary,D,WSH,25,82,7,13,20
7,8478399,Jonas Siegenthaler,D,NJD,27,82,6,14,20
7,8480144,David Kampf,C,TOR,29,82,5,15,20
7,8481567,Henry Thrun,D,SJS,23,82,5,15,20
7,8475208,Brian Dumoulin,D,SEA,33,82,5,15,20
7,8479291,Kevin Rooney,C,CGY,31,82,5,15,20
7,8479980,Nicolas Hague,D,VGK,26,82,4,16,20
7,8475279,Ben Chiarot,D,DET,33,82,4,16,20
7,8481059,Scott Perunovich,D,STL,26,82,4,16,20
7,8477220,Nate Schmidt,D,WPG,33,82,3,17,20
7,8475462,Radko Gudas,D,ANA,34,82,3,17,20
7,8470610,Zach Parise,L,COL,40,82,11,8,19
7,8482679,Matt Coronato,R,CGY,22,82,11,8,19
7,8476278,Colin Blackwell,C,CHI,31,82,8,11,19
7,8481553,Bobby Brink,R,PHI,23,82,8,11,19
7,8482803,Olen Zellweger,D,ANA,21,82,7,12,19
7,8478451,Ethan Bear,D,WSH,27,82,5,14,19
7,8479324,Ryan Lindgren,D,NYR,26,82,5,14,19
7,8477015,Connor Brown,R,EDM,30,82,4,15,19
7,8476429,Scott Mayfield,D,NYI,32,82,3,16,19
7,8476917,Adam Pelech,D,NYI,30,82,2,17,19
7,8478859,Niko Mikkola,D,FLA,28,82,2,17,19
7,8475188,Brayden McNabb,D,VGK,33,82,1,18,19
7,8484203,Bradly Nadeau,L,CAR,19,82,13,5,18
7,8482125,Alexander Holtz,R,NJD,22,82,11,7,18
7,8478468,Jeremy Lauzon,D,NSH,27,82,11,7,18
7,8475842,Sam Carrick,C,EDM,32,82,9,9,18
7,8480813,Joe Veleno,C,DET,24,82,8,10,18
7,8480980,Connor Dewar,C,TOR,25,82,8,10,18
7,8478013,Jake Walman,D,DET,28,82,7,11,18
7,8477931,Tomas Nosek,L,NJD,32,82,7,11,18
7,8483012,Logan Morrison,C,SEA,22,82,7,11,18
7,8480336,Sean Walker,D,COL,30,82,5,13,18
7,8476891,Matt Grzelcyk,D,BOS,30,82,5,13,18
7,8476931,Jake McCabe,D,TOR,31,82,4,14,18
7,8481524,Bowen Byram,D,BUF,23,82,4,14,18
7,8482470,Ilya Solovyov,D,CGY,24,82,4,14,18
7,8470966,Mark Giordano,D,TOR,41,82,3,15,18
7,8483495,Simon Nemec,D,NJD,20,82,2,16,18
7,8479998,Mikey Anderson,D,LAK,25,82,2,16,18
7,8482145,Mavrik Bourque,C,DAL,22,82,12,5,17
7,8481477,Nico Sturm,C,SJS,29,82,10,7,17
7,8478831,Kevin Stenlund,C,FLA,28,82,8,9,17
7,8477369,Carson Soucy,D,VAN,30,82,7,10,17
7,8480807,Mattias Samuelsson,D,BUF,24,82,7,10,17
7,8474189,Lars Eller,C,PIT,35,82,6,11,17
7,8482516,Matthew Kessel,D,STL,24,82,6,11,17
7,8477406,Mattias Janmark,C,EDM,32,82,5,12,17
7,8481537,Nikita Okhotiuk,D,CGY,24,82,5,12,17
7,8475177,Calvin de Haan,D,TBL,33,82,5,12,17
7,8475762,Derek Forbort,D,BOS,32,82,5,12,17
7,8481605,Jackson LaCombe,D,ANA,23,82,4,13,17
7,8481522,Peyton Krebs,C,BUF,23,82,4,13,17
7,8475790,Erik Gudbranson,D,CBJ,32,82,3,14,17
7,8480879,Jacob Bernard-Docker,D,OTT,24,82,3,14,17
7,8476312,Josh Manson,D,COL,33,82,2,15,17
7,8480058,Pierre-Olivier Joseph,D,PIT,25,82,2,15,17
7,8483466,Kevin Korchinski,D,CHI,20,82,2,15,17
7,8478043,Sam Lafferty,C,VAN,29,82,8,8,16
7,8482809,Jackson Blake,R,CAR,21,82,8,8,16
7,8476822,Luke Glendening,C,TBL,35,82,8,8,16
7,8476878,Zemgus Girgensons,L,BUF,30,82,7,9,16
7,8483482,Tristan Luneau,D,ANA,20,82,5,11,16
7,8483565,Nick Blankenburg,D,CBJ,26,82,4,12,16
7,8477499,Rasmus Ristolainen,D,PHI,30,82,4,12,16
7,8476372,Nick Seeler,D,PHI,31,82,3,13,16
7,8475825,Jani Hakanpää,D,DAL,32,82,3,13,16
7,8482166,Shakir Mukhamadullin,D,SJS,22,82,2,14,16
7,8480172,Jan Rutta,D,SJS,34,82,2,14,16
7,8478408,Travis Dermott,D,ARI,28,82,5,10,15
7,8474567,Zach Bogosian,D,MIN,34,82,5,10,15
7,8480834,Ty Emberson,D,SJS,24,82,4,11,15
7,8478882,Vladislav Gavrikov,D,LAK,29,82,3,12,15
7,8482858,Ryker Evans,D,SEA,23,82,3,12,15
7,8479369,Andrew Peeke,D,BOS,26,82,2,13,15
7,8477845,Trevor van Riemsdyk,D,WSH,33,82,0,15,15
7,8480448,Parker Kelly,L,OTT,25,82,10,4,14
7,8480281,Alexey Toropchenko,R,STL,25,82,6,8,14
7,8483491,Ivan Miroshnichenko,L,WSH,20,82,6,8,14
7,8482666,Scott Morrow,D,CAR,22,82,6,8,14
7,8484911,Collin Graf,R,SJS,22,82,5,9,14
7,8478430,Oliver Kylington,D,CGY,27,82,4,10,14
7,8483468,Jiri Kulich,C,BUF,20,82,4,10,14
7,8470600,Ryan Suter,D,DAL,39,82,2,12,14
7,8478416,Erik Cernak,D,TBL,27,82,2,12,14
7,8471677,Jack Johnson,D,COL,37,82,1,13,14
7,8482807,Ethan Del Mastro,D,CHI,21,82,5,8,13
7,8477034,Jaycob Megna,D,CHI,32,82,2,11,13
7,8475179,Dmitry Kulikov,D,FLA,34,82,0,13,13
7,8473504,Cal Clutterbuck,R,NYI,37,82,6,6,12
7,8480990,Declan Chisholm,D,MIN,24,82,5,7,12
7,8476967,Brett Kulak,D,EDM,30,82,5,7,12
7,8476473,Connor Murphy,D,CHI,31,82,4,8,12
7,8479442,Troy Stecher,D,EDM,30,82,4,8,12
7,8475324,Nick Jensen,D,WSH,34,82,2,10,12
7,8474013,Ian Cole,D,VAN,35,82,2,10,12
7,8482762,Simon Edvinsson,D,DET,21,82,7,4,11
7,8482712,Oskar Olausson,R,COL,22,82,4,7,11
7,8477335,Kyle Burroughs,D,SJS,29,82,4,7,11
7,8476442,Matt Nieto,L,PIT,32,82,3,8,11
7,8481599,Victor Soderstrom,D,ARI,23,82,1,10,11
7,8483763,Maksymilian Szuber,D,ARI,22,82,1,10,11
7,8482713,Mackie Samoskevich,R,FLA,22,82,4,6,10
7,8483489,Fraser Minten,C,TOR,31,82,4,6,10
7,8476915,Jujhar Khaira,L,MIN,30,82,5,4,9
7,8482177,Marat Khusnutdinov,C,MIN,22,82,2,6,8
7,8481578,Graeme Clarke,R,NJD,23,82,3,4,7
7,8481030,Jack St. Ivany,D,PIT,25,82,2,4,6
7,8482859,Zack Ostapchuk,C,OTT,21,82,2,3,5
7,8484149,Gavin Brindley,C,CBJ,20,82,0,5,5
7,8482141,Lukas Cormier,D,VGK,22,0,0,0,0
7,8476988,Matt Benning,D,SJS,30,0,0,0,0
7,8480727,Zach Whitecloud,D,VGK,28,0,0,0,0
7,8480887,Jordan Harris,D,MTL,24,0,0,0,0
7,8478450,Parker Wotherspoon,D,BOS,27,0,0,0,0
7,8481812,Nikolai Knyzhov,D,SJS,27,0,0,0,0
7,8480001,Urho Vaakanainen,D,ANA,25,0,0,0,0
7,8482176,Wyatt Kaiser,D,CHI,22,0,0,0,0
7,8481122,Simon Benoit,D,TOR,26,0,0,0,0
7,8476441,Joel Edmundson,D,TOR,31,0,0,0,0
7,8480884,Calen Addison,D,SJS,24,0,0,0,0
7,8482511,Mason Lohrei,D,BOS,23,0,0,0,0
7,8482192,Isaak Phillips,D,CHI,23,0,0,0,0
7,8480950,Ilya Lyubushkin,D,TOR,30,0,0,0,0
7,8474031,Kevin Shattenkirk,D,BOS,35,0,0,0,0
7,8475718,Justin Holl,D,DET,32,0,0,0,0
7,8479402,Jake Bean,D,CBJ,26,0,0,0,0
7,8474602,Justin Schultz,D,SEA,34,0,0,0,0
7,8477950,Tony DeAngelo,D,CAR,29,0,0,0,0
7,8481743,Marc Del Gaizo,D,NSH,25,0,0,0,0
7,8481527,Kaedan Korczak,D,VGK,23,0,0,0,0
7,8480192,Johnathan Kovacevic,D,MTL,27,0,0,0,0
7,8476874,Olli Maatta,D,DET,30,0,0,0,0
7,8482144,Jack Thompson,D,SJS,22,0,0,0,0
7,8480222,Sebastian Aho,D,NYI,28,0,0,0,0
7,8479458,Nikita Zaitsev,D,CHI,33,0,0,0,0
7,8471709,Marc-Edouard Vlasic,D,SJS,37,0,0,0,0
7,8482929,Emil Lilleberg,D,TBL,23,0,0,0,0
7,8477018,Ben Hutton,D,VGK,31,0,0,0,0
7,8481056,Spencer Stastney,D,NSH,24,0,0,0,0
7,8481593,Jayden Struble,D,MTL,23,0,0,0,0
7,8479982,Conor Timmins,D,TOR,26,0,0,0,0
7,8474090,Brendan Smith,D,NJD,35,0,0,0,0
7,8482964,Arber Xhekaj,D,MTL,23,0,0,0,0
7,8480891,Michael Kesselring,D,ARI,24,0,0,0,0
7,8477938,Haydn Fleury,D,TBL,28,0,0,0,0
7,8481806,Louis Crevier,D,CHI,23,0,0,0,0
7,8471274,Alex Goligoski,D,MIN,39,0,0,0,0
7,8481600,Tobias Bjornfot,D,FLA,23,0,0,0,0
7,8475797,Jarred Tinordi,D,CHI,32,0,0,0,0
7,8481521,Ronnie Attard,D,PHI,25,0,0,0,0
7,8474612,Travis Hamonic,D,OTT,34,0,0,0,0
7,8479576,Vincent Desharnais,D,EDM,28,0,0,0,0
7,8480049,Dylan Samberg,D,WPG,25,0,0,0,0
7,8483619,Filip Roos,D,CHI,25,0,0,0,0
7,8474568,Luke Schenn,D,NSH,35,0,0,0,0
7,8480184,Gustav Lindstrom,D,ANA,26,0,0,0,0
7,8480070,Ian Mitchell,D,BOS,25,0,0,0,0
7,8480196,Jacob Bryson,D,BUF,27,0,0,0,0
7,8471686,Marc Staal,D,PHI,37,0,0,0,0
7,8477467,Gustav Olofsson,D,SEA,30,0,0,0,0
7,8478970,Jalen Chatfield,D,CAR,28,0,0,0,0
7,8479348,Kale Clague,D,BUF,26,0,0,0,0
7,8473446,Erik Johnson,D,PHI,36,0,0,0,0
7,8477462,Robert Hagg,D,ANA,29,0,0,0,0
7,8478454,Noah Juulsen,D,VAN,27,0,0,0,0
7,8477384,Josh Brown,D,ARI,30,0,0,0,0
7,8481708,Zac Jones,D,NYR,24,0,0,0,0
7,8481167,Brayden Pachal,D,CGY,25,0,0,0,0
7,8482067,Connor Mackey,D,NYR,28,0,0,0,0
7,8483460,David Jiricek,D,CBJ,21,0,0,0,0
7,8481701,Santeri Hatakka,D,NJD,23,0,0,0,0
7,8478021,William Lagesson,D,ANA,28,0,0,0,0
7,8477851,Jordan Oesterle,D,CGY,32,0,0,0,0
7,8478452,Caleb Jones,D,COL,27,0,0,0,0
7,8479984,Cal Foote,D,NJD,26,0,0,0,0
7,8479639,Dylan Coghlan,D,CAR,26,0,0,0,0
7,8480874,Adam Ginning,D,PHI,24,0,0,0,0
7,8479321,Lucas Johansen,D,WSH,27,0,0,0,0
7,8480878,Nils Lundkvist,D,DAL,24,0,0,0,0
7,8482165,Yan Kuznetsov,D,CGY,22,0,0,0,0
7,8484258,Sam Malinski,D,COL,26,0,0,0,0
7,8480157,Calle Rosen,D,STL,30,0,0,0,0
7,8484304,Uvis Balinskis,D,FLA,28,0,0,0,0
7,8479985,Cale Fleury,D,SEA,26,0,0,0,0
7,8479378,Logan Stanley,D,WPG,26,0,0,0,0
7,8477541,Dakota Mermis,D,MIN,30,0,0,0,0
7,8481609,Vladislav Kolyachonok,D,ARI,23,0,0,0,0
7,8480823,Alexander Alexeyev,D,WSH,25,0,0,0,0
7,8481679,Maxence Guenette,D,OTT,23,0,0,0,0
7,8481564,Ryan Johnson,D,BUF,23,0,0,0,0
7,8479376,Victor Mete,D,PHI,26,0,0,0,0
7,8484254,Akito Hirose,D,VAN,25,0,0,0,0
7,8482660,Kent Johnson,C,CBJ,22,0,0,0,0
7,8482149,Cole Perfetti,C,WPG,22,0,0,0,0
7,8477987,Ryan Donato,C,CHI,28,0,0,0,0
7,8475755,Alexander Petrovic,D,DAL,32,0,0,0,0
7,8477810,Joel Hanley,D,CGY,33,0,0,0,0
7,8474145,Robert Bortuzzo,D,NYI,35,0,0,0,0
7,8481161,Jake Christiansen,D,CBJ,25,0,0,0,0
7,8476884,Derrick Pouliot,D,DAL,30,0,0,0,0
7,8481716,Dmitri Voronkov,L,CBJ,24,0,0,0,0
7,8480084,Nick DeSimone,D,NJD,30,0,0,0,0
7,8475750,Jon Merrill,D,MIN,32,0,0,0,0
7,8479315,Joey Anderson,R,CHI,26,0,0,0,0
7,8478011,Louie Belpedio,D,PHI,28,0,0,0,0
7,8482451,Mikael Pyyhtia,L,CBJ,23,0,0,0,0
7,8481541,Samuel Bolduc,D,NYI,24,0,0,0,0
7,8482126,Emil Andrae,D,PHI,31,0,0,0,0
7,8474618,Marco Scandella,D,STL,34,0,0,0,0
7,8477244,Chad Ruhwedel,D,NYR,34,0,0,0,0
7,8477971,Andreas Englund,D,LAK,28,0,0,0,0
7,8480829,Jesperi Kotkaniemi,C,CAR,24,0,0,0,0
7,8479372,Josh Mahura,D,FLA,26,0,0,0,0
7,8482095,Tyler Kleven,D,OTT,22,0,0,0,0
7,8481719,Maxwell Crozier,D,TBL,24,0,0,0,0
7,8475855,Jesper Fast,R,CAR,33,0,0,0,0
7,8480848,Ty Dellandrea,C,DAL,24,0,0,0,0
7,8475193,Tomas Tatar,L,SEA,34,0,0,0,0
7,8476889,Radek Faksa,C,DAL,30,0,0,0,0
7,8478495,Denis Gurianov,R,PHI,27,0,0,0,0
7,8480216,Jacob Peterson,C,SJS,25,0,0,0,0
7,8480252,Cole Guttman,C,CHI,25,0,0,0,0
7,8479026,Philippe Myers,D,TBL,27,0,0,0,0
7,8481006,Tyler Tucker,D,STL,24,0,0,0,0
7,8481032,Paul Cotter,C,VGK,25,0,0,0,0
7,8481577,Philip Tomasino,C,NSH,23,0,0,0,0
7,8476918,Jimmy Vesey,L,NYR,31,0,0,0,0
7,8479320,Max Lajoie,D,TOR,27,0,0,0,0
7,8478017,Mark Friedman,D,VAN,29,0,0,0,0
7,8481754,Nikita Nesterenko,C,ANA,23,0,0,0,0
7,8483407,Brandon Scanlin,D,NYR,25,0,0,0,0
7,8482659,Josh Doan,R,ARI,22,0,0,0,0
7,8477446,Michael McCarron,R,NSH,29,0,0,0,0
7,8477903,Garnet Hathaway,R,PHI,33,0,0,0,0
7,8482153,Brendan Brisson,C,VGK,23,0,0,0,0
7,8483546,Marshall Rifai,D,TOR,26,0,0,0,0
7,8484287,Cole McWard,D,VAN,23,0,0,0,0
7,8478854,Ryan Shea,D,PIT,27,0,0,0,0
7,8481585,Egor Afanasyev,L,NSH,23,0,0,0,0
7,8483398,Declan Carlile,D,TBL,31,0,0,0,0
7,8478502,Dennis Gilbert,D,CGY,28,0,0,0,0
7,8482749,Joshua Roy,R,MTL,21,0,0,0,0
7,8481598,Philip Broberg,D,EDM,23,0,0,0,0
7,8480835,Jack Drury,C,CAR,24,0,0,0,0
7,8480748,Kiefer Sherwood,L,NSH,29,0,0,0,0
7,8476934,Brock McGinn,L,ANA,30,0,0,0,0
7,8480870,Bo Groulx,C,ANA,24,0,0,0,0
7,8479368,Max Jones,L,ANA,26,0,0,0,0
7,8478099,Kevin Labanc,R,SJS,29,0,0,0,0
7,8478067,Oskar Lindblom,L,SJS,28,0,0,0,0
7,8476393,Nick Cousins,C,FLA,31,0,0,0,0
7,8483395,Arshdeep Bains,L,VAN,23,0,0,0,0
7,8480762,Eric Robinson,L,BUF,29,0,0,0,0
7,8479439,Jacob MacDonald,D,SJS,31,0,0,0,0
7,8476474,Stefan Noesen,R,CAR,31,0,0,0,0
7,8482787,Nikita Chibrikov,R,WPG,31,0,0,0,0
7,8478432,Christian Fischer,R,DET,27,0,0,0,0
7,8477979,Nicolas Aube-Kubel,R,WSH,28,0,0,0,0
7,8481789,Tye Kartye,L,SEA,23,0,0,0,0
7,8479330,Brandon Gignac,C,MTL,27,0,0,0,0
7,8480075,Cameron Crotty,D,ARI,25,0,0,0,0
7,8473473,Milan Lucic,L,BOS,36,0,0,0,0
7,8482094,Daemon Hunt,D,MIN,22,0,0,0,0
7,8481206,John Ludvig,D,PIT,24,0,0,0,0
7,8483630,Pavol Regenda,L,ANA,25,0,0,0,0
7,8481617,Vasily Podkolzin,R,VAN,23,0,0,0,0
7,8480306,Grant Hutton,D,NYI,29,0,0,0,0
7,8480995,Pontus Holmberg,R,TOR,25,0,0,0,0
7,8482148,Hendrix Lapierre,C,WSH,22,0,0,0,0
7,8477478,William Carrier,L,VGK,30,0,0,0,0
7,8480003,Jesper Boqvist,C,BOS,26,0,0,0,0
7,8482172,Landon Slaggert,L,CHI,22,0,0,0,0
7,8480789,Oliver Wahlstrom,R,NYI,24,0,0,0,0
7,8474062,Riley Nash,C,NYR,35,0,0,0,0
7,8480021,Jack Studnicka,C,SJS,25,0,0,0,0
7,8480025,MacKenzie Entwistle,R,CHI,25,0,0,0,0
7,8481582,Nicholas Robertson,L,TOR,23,0,0,0,0
7,8476867,Brendan Gaunce,C,CBJ,30,0,0,0,0
7,8479619,Michael Carcone,L,ARI,28,0,0,0,0
7,8479370,Tyson Jost,C,BUF,26,0,0,0,0
7,8479671,Mathieu Olivier,R,CBJ,27,0,0,0,0
7,8476994,Vinnie Hinostroza,C,PIT,30,0,0,0,0
7,8482070,Mitchell Chaffee,R,TBL,26,0,0,0,0
7,8477473,Justin Bailey,R,SJS,29,0,0,0,0
7,8479344,Jesse Puljujarvi,R,PIT,26,0,0,0,0
7,8480205,Emil Bemstrom,C,PIT,25,0,0,0,0
7,8479718,Alex Barré-Boulet,C,TBL,27,0,0,0,0
7,8482061,Brandon Biro,L,BUF,26,0,0,0,0
7,8479638,Justin Brazeau,R,BOS,26,0,0,0,0
7,8474040,Sam Gagner,C,EDM,35,0,0,0,0
7,8477846,Ryan Carpenter,C,SJS,33,0,0,0,0
7,8482077,Dylan Holloway,L,EDM,23,0,0,0,0
7,8482157,Will Cuylle,L,NYR,22,0,0,0,0
7,8480007,Jonas Rondbjerg,R,VGK,25,0,0,0,0
7,8478874,Adam Gaudette,C,STL,28,0,0,0,0
7,8478434,Keegan Kolesar,R,VGK,27,0,0,0,0
7,8480441,Trey Fix-Wolansky,R,CBJ,25,0,0,0,0
7,8479994,Jaret Anderson-Dolan,C,NSH,25,0,0,0,0
7,8483567,Georgii Merkulov,C,BOS,24,0,0,0,0
7,8477380,Jonny Brodzinski,C,NYR,31,0,0,0,0
7,8482201,Gage Goncalves,C,TBL,23,0,0,0,0
7,8478211,Dryden Hunt,L,CGY,29,0,0,0,0
7,8471699,Andrew Cogliano,C,COL,37,0,0,0,0
7,8479421,Jacob Moverare,D,LAK,26,0,0,0,0
7,8478881,Brett Seney,L,CHI,28,0,0,0,0
7,8477464,Nic Petan,C,MIN,29,0,0,0,0
7,8475958,Michael Sgarbossa,C,WSH,32,0,0,0,0
7,8481147,Reese Johnson,C,CHI,26,0,0,0,0
7,8479336,Carl Grundstrom,R,LAK,27,0,0,0,0
7,8480853,Liam Foudy,C,NSH,24,0,0,0,0
7,8479522,Hardy Haman Aktell,D,WSH,26,0,0,0,0
7,8481462,Mason Morelli,L,VGK,28,0,0,0,0
7,8482102,Vasily Ponomarev,C,CAR,22,0,0,0,0
7,8480844,Grigori Denisenko,L,VGK,24,0,0,0,0
7,8479944,Zach Aston-Reese,C,DET,30,0,0,0,0
7,8482784,Zach Dean,C,STL,21,0,0,0,0
7,8479419,Brett Murray,L,BUF,26,0,0,0,0
7,8479520,Brandon Duhaime,R,COL,27,0,0,0,0
7,8477573,Nathan Walker,L,STL,30,0,0,0,0
7,8478078,Rourke Chartier,C,OTT,28,0,0,0,0
7,8475795,Dylan McIlrath,D,WSH,32,0,0,0,0
7,8482496,Nils Aman,C,VAN,24,0,0,0,0
7,8480289,Morgan Barron,C,WPG,26,0,0,0,0
7,8481751,Lukas Rousek,R,BUF,25,0,0,0,0
7,8480011,Klim Kostin,C,SJS,25,0,0,0,0
7,8481556,John Beecher,C,BOS,23,0,0,0,0
7,8475278,Byron Froese,C,VGK,33,0,0,0,0
7,8475225,Craig Smith,C,DAL,35,0,0,0,0
7,8484326,Patrik Koch,D,ARI,28,0,0,0,0
7,8477930,Pierre-Edouard Bellemare,L,SEA,39,0,0,0,0
7,8478409,Anthony Richard,C,BOS,28,0,0,0,0
7,8481024,Linus Karlsson,C,VAN,25,0,0,0,0
7,8479986,Kole Lind,R,SEA,26,0,0,0,0
7,8479414,Nathan Bastian,R,NJD,27,0,0,0,0
7,8479362,Riley Tufte,L,COL,26,0,0,0,0
7,8481058,Jesse Ylönen,R,MTL,25,0,0,0,0
7,8482476,Emil Heineman,L,MTL,23,0,0,0,0
7,8482861,Vincent Iorio,D,WSH,22,0,0,0,0
7,8483432,Luca Del Bel Belluz,C,CBJ,31,0,0,0,0
7,8482744,James Malatesta,L,CBJ,21,0,0,0,0
7,8477887,Patrick Brown,C,BOS,32,0,0,0,0
7,8478585,Derek Ryan,C,EDM,38,0,0,0,0
7,8481441,Joe Snively,C,WSH,28,0,0,0,0
7,8481592,Jakob Pelletier,L,CGY,23,0,0,0,0
7,8482634,Alex Steeves,C,TOR,25,0,0,0,0
7,8477126,Jayson Megna,C,BOS,34,0,0,0,0
7,8475752,Tyler Pitlick,C,NYR,33,0,0,0,0
7,8480008,Adam Ruzicka,C,ARI,25,0,0,0,0
7,8481065,Angus Crookshank,L,OTT,25,0,0,0,0
7,8479547,Matthew Phillips,R,WSH,26,0,0,0,0
7,8480226,Marián Studenic,R,SEA,26,0,0,0,0
7,8481237,Kyle MacLean,C,NYI,25,0,0,0,0
7,8475413,Justin Dowling,C,NJD,34,0,0,0,0
7,8481641,Joel Kiviranta,L,COL,28,0,0,0,0
7,8478104,Sammy Blais,L,STL,28,0,0,0,0
7,8477454,Adam Erne,L,EDM,29,0,0,0,0
7,8481518,Nolan Foote,L,NJD,24,0,0,0,0
7,8480245,Olle Lycksell,R,PHI,25,0,0,0,0
7,8483570,Ben Meyers,C,ANA,26,0,0,0,0
7,8480776,Sheldon Rempal,R,VGK,29,0,0,0,0
7,8483920,Pierrick Dube,R,WSH,23,0,0,0,0
7,8480267,Sammy Walker,C,MIN,25,0,0,0,0
7,8482747,Brennan Othmann,L,NYR,21,0,0,0,0
7,8479991,Jake Leschyshyn,C,NYR,25,0,0,0,0
7,8478400,Colin White,C,MTL,27,0,0,0,0
7,8479328,Julien Gauthier,R,NYI,27,0,0,0,0
7,8484325,Waltteri Merela,C,TBL,26,0,0,0,0
7,8479066,Ryan Lomberg,L,FLA,30,0,0,0,0
7,8477070,Liam O'Brien,C,ARI,30,0,0,0,0
7,8478146,Matthew Highmore,C,OTT,28,0,0,0,0
7,8478028,Fredrik Olofsson,L,COL,28,0,0,0,0
7,8480880,Jakub Lauko,C,BOS,24,0,0,0,0
7,8479968,Vinni Lettieri,C,MIN,29,0,0,0,0
7,8474709,Matt Martin,L,NYI,35,0,0,0,0
7,8480845,Rasmus Kupari,C,WPG,24,0,0,0,0
7,8481550,Adam Beckman,L,MIN,23,0,0,0,0
7,8481422,Jacob Lucchini,C,MIN,29,0,0,0,0
7,8477401,John Hayden,C,SEA,29,0,0,0,0
7,8478904,Steven Lorentz,C,FLA,28,0,0,0,0
7,8482088,Justin Sourdif,R,FLA,22,0,0,0,0
7,8482751,Ryan Winterton,C,SEA,21,0,0,0,0
7,8482241,Radim Zohorna,L,PIT,28,0,0,0,0
7,8481690,Tyler Angle,C,CBJ,24,0,0,0,0
7,8476952,Dominic Toninato,C,WPG,30,0,0,0,0
7,8476919,Chris Tierney,C,NJD,30,0,0,0,0
7,8480032,Shane Bowers,C,NJD,25,0,0,0,0
7,8484314,Jiri Smejkal,L,OTT,28,0,0,0,0
7,8481239,Samuel Fagemo,L,LAK,24,0,0,0,0
7,8481532,Alex Turcotte,C,LAK,23,0,0,0,0
7,8481019,David Gustafsson,C,WPG,24,0,0,0,0
7,8478477,Mitchell Stephens,C,MTL,27,0,0,0,0
7,8479546,Oskar Steen,C,BOS,26,0,0,0,0
7,8480292,Carson Meyer,R,CBJ,27,0,0,0,0
7,8478446,Glenn Gawdin,C,ANA,27,0,0,0,0
7,8483531,Brian Halonen,L,NJD,25,0,0,0,0
7,8477149,Scott Sabourin,R,SJS,32,0,0,0,0
7,8479972,Mason Shaw,C,MIN,26,0,0,0,0
7,8480890,Jan Jenik,R,ARI,24,0,0,0,0
7,8478051,Max Willman,C,NJD,29,0,0,0,0
7,8480851,Akil Thomas,C,LAK,24,0,0,0,0
7,8482765,Isak Rosen,R,BUF,21,0,0,0,0
7,8478421,A.J. Greer,L,CGY,28,0,0,0,0
7,8478512,Austin Czarnik,C,DET,32,0,0,0,0
7,8479536,Axel Jonsson-Fjallby,L,WPG,26,0,0,0,0
7,8477320,Anton Blidh,L,NYR,29,0,0,0,0
7,8481543,Nikita Alexandrov,C,STL,24,0,0,0,0
7,8475235,Nicolas Deslauriers,L,PHI,33,0,0,0,0
7,8481070,Hugh McGing,L,STL,26,0,0,0,0
7,8480836,Jonathan Gruden,C,PIT,24,0,0,0,0
7,8481591,Sam Poulin,R,PIT,23,0,0,0,0
7,8477962,Brendan Lemieux,L,CAR,28,0,0,0,0
7,8483401,Marc Johnstone,R,PIT,28,0,0,0,0
7,8482250,Callahan Burke,C,CAR,27,0,0,0,0
7,8481726,Adam Edstrom,C,NYR,24,0,0,0,0
7,8471817,Ryan Reaves,R,TOR,37,0,0,0,0
7,8479587,Rhett Gardner,C,PHI,28,0,0,0,0
7,8475766,Austin Watson,L,TBL,32,0,0,0,0
7,8479367,William Lockwood,R,FLA,26,0,0,0,0
7,8478424,Jansen Harkins,C,PIT,27,0,0,0,0
7,8476913,Devin Shore,C,SEA,30,0,0,0,0
7,8482652,Walker Duehr,R,CGY,27,0,0,0,0
7,8477527,Ross Johnston,L,ANA,30,0,0,0,0
7,8481077,John Leonard,L,ARI,26,0,0,0,0
7,8483549,Lucas Condotta,L,MTL,27,0,0,0,0
7,8480468,James Hamblin,L,EDM,25,0,0,0,0
7,8476907,Mackenzie MacEachern,L,STL,30,0,0,0,0
7,8479543,Michael Pezzetta,L,MTL,26,0,0,0,0
7,8480355,Mark Kastelic,C,OTT,25,0,0,0,0
7,8482162,Roby Jarventie,L,OTT,22,0,0,0,0
7,8479772,Zack MacEwen,R,OTT,28,0,0,0,0
7,8483597,Milos Kelemen,L,ARI,25,0,0,0,0
7,8479379,Givani Smith,R,SJS,26,0,0,0,0
7,8481655,Cole Schwindt,R,CGY,23,0,0,0,0
7,8479981,Jonah Gadjovich,L,FLA,26,0,0,0,0
7,8482147,Jean-Luc Foudy,C,COL,22,0,0,0,0
7,8484255,Jason Polin,R,COL,25,0,0,0,0
7,8477993,Justin Kirkland,C,ARI,28,0,0,0,0
7,8479249,Andrew Poturalski,C,SEA,30,0,0,0,0
7,8482197,Adam Raska,R,MIN,23,0,0,0,0
7,8475780,Chris Wagner,R,COL,33,0,0,0,0
7,8479533,Joona Koppanen,L,PIT,26,0,0,0,0
7,8481534,Raphael Lavoie,C,EDM,24,0,0,0,0
7,8484321,Nikolas Matinpalo,D,OTT,26,0,0,0,0
7,8481043,Cole Koepke,L,TBL,26,0,0,0,0
7,8476323,Max McCormick,L,SEA,32,0,0,0,0
7,8483609,Adam Klapka,R,CGY,24,0,0,0,0
7,8483512,Matt Savoie,C,BUF,20,0,0,0,0
7,8484259,Ondrej Pavel,C,COL,31,0,0,0,0
7,8478147,Bokondji Imama,L,OTT,28,0,0,0,0
7,8482460,Matt Rempe,C,NYR,22,0,0,0,0
7,8477073,Kurtis MacDermid,L,NJD,30,0,0,0,0
7,8480274,Philip Kemp,D,EDM,25,0,0,0,0
7,8478956,Samuel Laberge,L,NJD,27,0,0,0,0
7,8483045,Cameron Butler,R,CBJ,31,0,0,0,0
8,8478402,Connor McDavid,C,EDM,27,82,43,96,139
8,8477934,Leon Draisaitl,C,EDM,29,82,42,80,122
8,8476453,Nikita Kucherov,R,TBL,31,82,42,76,118
8,8477492,Nathan MacKinnon,C,COL,29,82,48,68,116
8,8479318,Auston Matthews,C,TOR,27,82,53,54,107
8,8478420,Mikko Rantanen,R,COL,28,82,43,64,107
8,8479314,Matthew Tkachuk,L,FLA,27,82,38,67,105
8,8477956,David Pastrnak,R,BOS,28,82,39,60,99
8,8477493,Aleksander Barkov,C,FLA,29,82,36,63,99
8,8476468,J.T. Miller,C,VAN,31,82,33,66,99
8,8477939,William Nylander,R,TOR,28,82,46,51,97
8,8481559,Jack Hughes,C,NJD,23,82,37,60,97
8,8471675,Sidney Crosby,C,PIT,37,82,44,52,96
8,8474564,Steven Stamkos,C,TBL,34,82,36,58,94
8,8476459,Mika Zibanejad,C,NYR,31,82,45,44,89
8,8480801,Brady Tkachuk,L,OTT,25,82,36,53,89
8,8482116,Tim Stützle,C,OTT,22,82,31,57,88
8,8476887,Filip Forsberg,L,NSH,30,82,35,52,87
8,8480800,Quinn Hughes,D,VAN,25,82,18,69,87
8,8478010,Brayden Point,C,TBL,28,82,46,39,85
8,8478550,Artemi Panarin,L,NYR,33,82,27,57,84
8,8475786,Zach Hyman,L,EDM,32,82,48,35,83
8,8477942,Kevin Fiala,L,LAK,28,82,33,50,83
8,8478864,Kirill Kaprizov,L,MIN,27,82,30,53,83
8,8471214,Alex Ovechkin,L,WSH,39,82,37,45,82
8,8477409,Carter Verhaeghe,C,FLA,29,82,39,42,81
8,8476539,Jonathan Marchessault,R,VGK,34,82,37,43,80
8,8479407,Jesper Bratt,L,NJD,26,82,29,50,79
8,8480036,Miro Heiskanen,D,DAL,25,82,12,67,79
8,8478439,Travis Konecny,R,PHI,27,82,37,41,78
8,8479385,Jordan Kyrou,C,STL,26,82,33,45,78
8,8480027,Jason Robertson,L,DAL,25,82,31,46,77
8,8480012,Elias Pettersson,C,VAN,26,82,30,47,77
8,8475913,Mark Stone,R,VGK,32,82,25,52,77
8,8474600,Roman Josi,D,NSH,34,82,21,56,77
8,8479323,Adam Fox,D,NYR,26,82,18,59,77
8,8471685,Anze Kopitar,C,LAK,37,82,21,55,76
8,8480865,Noah Dobson,D,NYI,24,82,16,60,76
8,8477404,Jake Guentzel,C,CAR,30,82,38,37,75
8,8481557,Matt Boldy,L,MIN,23,82,32,43,75
8,8478449,Roope Hintz,C,DAL,28,82,32,43,75
8,8480208,Drake Batherson,R,OTT,26,82,32,42,74
8,8480002,Nico Hischier,C,NJD,25,82,32,41,73
8,8479343,Clayton Keller,R,ARI,26,82,32,41,73
8,8478042,Viktor Arvidsson,R,LAK,31,82,27,46,73
8,8476454,Ryan Nugent-Hopkins,C,EDM,31,82,21,52,73
8,8477402,Pavel Buchnevich,L,STL,29,82,34,38,72
8,8479337,Alex DeBrincat,R,DET,27,82,33,38,71
8,8478403,Jack Eichel,C,VGK,28,82,31,40,71
8,8477933,Sam Reinhart,C,FLA,29,82,29,42,71
8,8476389,Vincent Trocheck,C,NYR,31,82,26,45,71
8,8478427,Sebastian Aho,C,CAR,27,82,35,35,70
8,8477951,Nick Schmaltz,C,ARI,28,82,32,38,70
8,8475172,Nazem Kadri,C,CGY,34,82,29,41,70
8,8475765,Vladimir Tarasenko,R,FLA,33,82,29,41,70
8,8478398,Kyle Connor,L,WPG,28,82,36,33,69
8,8477501,Valeri Nichushkin,R,COL,29,82,33,36,69
8,8480018,Nick Suzuki,C,MTL,25,82,22,47,69
8,8480069,Cale Makar,D,COL,26,82,22,46,68
8,8478407,Vince Dunn,D,SEA,28,82,18,50,68
8,8477960,Adrian Kempe,R,LAK,28,82,38,29,67
8,8475184,Chris Kreider,L,NYR,33,82,37,30,67
8,8478873,Troy Terry,R,ANA,27,82,28,39,67
8,8481523,Kirby Dach,C,MTL,23,82,11,56,67
8,8477946,Dylan Larkin,C,DET,28,82,33,33,66
8,8475754,Brock Nelson,C,NYI,33,82,29,37,66
8,8476346,Johnny Gaudreau,L,CBJ,31,82,23,43,66
8,8479542,Brandon Hagel,L,TBL,26,82,30,35,65
8,8476460,Mark Scheifele,C,WPG,31,82,25,40,65
8,8480839,Rasmus Dahlin,D,BUF,24,82,18,47,65
8,8480830,Andrei Svechnikov,R,CAR,24,82,25,39,64
8,8478975,Mason Marchment,L,DAL,29,82,30,33,63
8,8477416,Oliver Bjorkstrand,R,SEA,29,82,24,39,63
8,8478047,Michael Bunting,L,PIT,29,82,21,42,63
8,8473512,Claude Giroux,R,OTT,36,82,19,44,63
8,8480023,Robert Thomas,C,STL,25,82,16,47,63
8,8478493,Joel Eriksson Ek,C,MIN,27,82,30,32,62
8,8478440,Dylan Strome,C,WSH,27,82,26,36,62
8,8478401,Pavel Zacha,C,BOS,27,82,22,40,62
8,8482745,Mason McTavish,C,ANA,21,82,21,41,62
8,8476853,Morgan Rielly,D,TOR,30,82,7,55,62
8,8476432,Boone Jenner,C,CBJ,31,82,30,31,61
8,8479420,Tage Thompson,C,BUF,27,82,25,36,61
8,8470794,Joe Pavelski,C,DAL,40,82,23,38,61
8,8477504,Josh Morrissey,D,WPG,29,82,10,51,61
8,8474590,John Carlson,D,WSH,34,82,9,52,61
8,8475166,John Tavares,C,TOR,34,82,24,36,60
8,8476881,Tomas Hertl,C,VGK,31,82,33,26,59
8,8477476,Artturi Lehkonen,L,COL,29,82,30,29,59
8,8477940,Nikolaj Ehlers,L,WPG,28,82,24,35,59
8,8479339,Patrik Laine,L,CBJ,26,82,23,36,59
8,8481533,Trevor Zegras,C,ANA,23,82,16,43,59
8,8474141,Patrick Kane,R,DET,36,82,15,44,59
8,8482109,Alexis Lafrenière,L,NYR,23,82,34,24,58
8,8477500,Bo Horvat,C,NYI,29,82,29,29,58
8,8471698,T.J. Oshie,R,WSH,38,82,26,32,58
8,8475692,Mats Zuccarello,R,MIN,37,82,15,43,58
8,8481540,Cole Caufield,R,MTL,23,82,36,21,57
8,8478414,Timo Meier,R,NJD,28,82,29,28,57
8,8484144,Connor Bedard,C,CHI,19,82,28,29,57
8,8475158,Ryan O'Reilly,C,NSH,33,82,24,33,57
8,8475745,Charlie Coyle,C,BOS,32,82,24,33,57
8,8479675,Trevor Moore,L,LAK,29,82,23,34,57
8,8477949,Alex Tuch,R,BUF,28,82,22,35,57
8,8473419,Brad Marchand,L,BOS,36,82,19,38,57
8,8479999,Casey Mittelstadt,C,COL,26,82,18,39,57
8,8478397,Rasmus Andersson,D,CGY,28,82,10,47,57
8,8475167,Victor Hedman,D,TBL,34,82,8,49,57
8,8475798,Mikael Granlund,C,SJS,32,82,8,49,57
8,8480015,Owen Tippett,R,PHI,25,82,21,35,56
8,8482684,Luke Hughes,D,NJD,21,82,19,37,56
8,8479410,Mikhail Sergachev,D,TBL,26,82,12,44,56
8,8475169,Evander Kane,L,EDM,33,82,33,22,55
8,8481618,Alex Newhook,C,MTL,23,82,29,26,55
8,8477935,Sam Bennett,C,FLA,28,82,27,28,55
8,8477955,Jared McCann,L,SEA,28,82,22,33,55
8,8478458,Jack Roslovic,C,NYR,27,82,19,36,55
8,8482133,Thomas Bordeleau,C,SJS,22,82,18,37,55
8,8478445,Mathew Barzal,C,NYI,27,82,17,38,55
8,8480803,Evan Bouchard,D,EDM,25,82,14,41,55
8,8481699,Aku Raty,R,ARI,23,82,3,52,55
8,8482097,Jack Quinn,R,BUF,23,82,25,29,54
8,8475168,Matt Duchene,C,DAL,33,82,22,32,54
8,8473994,Jamie Benn,L,DAL,35,82,20,34,54
8,8478462,Nicolas Roy,C,VGK,27,82,19,35,54
8,8479325,Charlie McAvoy,D,BOS,27,82,9,45,54
8,8475810,Bryan Rust,R,PIT,32,82,27,26,53
8,8477496,Elias Lindholm,C,VAN,30,82,24,29,53
8,8476462,Dougie Hamilton,D,NJD,31,82,18,35,53
8,8476448,William Karlsson,C,VGK,31,82,18,35,53
8,8482078,Lucas Raymond,L,DET,22,82,11,42,53
8,8483445,Cutter Gauthier,L,ANA,20,82,11,42,53
8,8476906,Shayne Gostisbehere,D,DET,31,82,7,46,53
8,8471215,Evgeni Malkin,C,PIT,38,82,25,27,52
8,8474679,Gustav Nyquist,C,NSH,35,82,19,33,52
8,8482124,Quinton Byfield,R,LAK,22,82,13,39,52
8,8478460,Zach Werenski,D,CBJ,27,82,12,40,52
8,8478444,Brock Boeser,R,VAN,27,82,25,26,51
8,8474586,Jordan Eberle,R,SEA,34,82,24,27,51
8,8475784,Jeff Skinner,C,BUF,32,82,21,30,51
8,8478856,Conor Garland,R,VAN,28,82,19,32,51
8,8476905,Chandler Stephenson,C,VGK,30,82,16,35,51
8,8477456,J.T. Compher,L,DET,29,82,15,36,51
8,8480031,Maxime Comtois,L,CAR,25,82,12,39,51
8,8475722,Jason Zucker,L,NSH,32,82,26,24,50
8,8477444,Andre Burakovsky,L,SEA,29,82,22,28,50
8,8480188,Fabian Zetterlund,L,SJS,25,82,19,31,50
8,8475170,Brayden Schenn,C,STL,33,82,18,32,50
8,8474563,Drew Doughty,D,LAK,35,82,13,37,50
8,8480064,Josh Norris,C,OTT,25,82,33,16,49
8,8475151,Kyle Palmieri,C,NYI,33,82,31,18,49
8,8480014,Gabriel Vilardi,C,WPG,25,82,27,22,49
8,8474150,Mikael Backlund,C,CGY,35,82,21,28,49
8,8475726,Tyler Toffoli,C,WPG,32,82,32,16,48
8,8477451,Ryan Hartman,R,MIN,30,82,25,23,48
8,8477998,Warren Foegele,L,EDM,28,82,24,24,48
8,8476880,Tom Wilson,R,WSH,30,82,23,25,48
8,8473986,Alex Killorn,L,ANA,35,82,22,26,48
8,8482740,Wyatt Johnston,C,DAL,21,82,20,28,48
8,8476479,Phillip Danault,C,LAK,31,82,17,31,48
8,8480798,Philipp Kurashev,C,CHI,25,82,17,31,48
8,8482113,Anton Lundell,C,FLA,23,82,12,36,48
8,8477447,Shea Theodore,D,VGK,29,82,9,39,48
8,8481068,Yegor Sharangovich,C,CGY,26,82,27,20,47
8,8474157,Max Pacioretty,L,WSH,36,82,23,24,47
8,8478474,Lawson Crouse,L,ARI,27,82,22,25,47
8,8482093,Seth Jarvis,C,CAR,22,82,20,27,47
8,8474037,James van Riemsdyk,L,BOS,35,82,18,29,47
8,8482665,Matty Beniers,C,SEA,22,82,17,30,47
8,8479345,Jakob Chychrun,D,OTT,26,82,17,30,47
8,8479400,Pierre-Luc Dubois,L,LAK,26,82,16,31,47
8,8475218,Mattias Ekholm,D,EDM,34,82,11,36,47
8,8476923,Damon Severson,D,CBJ,30,82,8,39,47
8,8479425,Filip Hronek,D,VAN,27,82,6,41,47
8,8482699,Dylan Guenther,R,ARI,21,82,23,23,46
8,8483808,Andrei Kuzmenko,L,CGY,28,82,21,25,46
8,8477479,Tyler Bertuzzi,L,TOR,29,82,21,25,46
8,8480871,Adam Boqvist,D,CBJ,24,82,13,33,46
8,8480434,Sean Durzi,D,ARI,26,82,9,37,46
8,8476456,Jonathan Huberdeau,C,CGY,31,82,8,38,46
8,8480797,Joel Farabee,L,PHI,24,82,22,23,45
8,8476927,Teddy Blueger,C,VAN,30,82,15,30,45
8,8480220,Noah Cates,L,PHI,25,82,12,33,45
8,8476869,Brady Skjei,D,CAR,30,82,9,36,45
8,8479525,Ross Colton,C,COL,28,82,22,22,44
8,8477511,Anthony Mantha,R,VGK,30,82,20,24,44
8,8480039,Martin Necas,C,CAR,25,82,17,27,44
8,8475768,Jaden Schwartz,C,SEA,32,82,14,30,44
8,8477932,Aaron Ekblad,D,FLA,28,82,13,31,44
8,8476399,Blake Coleman,C,CGY,33,82,25,18,43
8,8479423,Alex Nylander,L,CBJ,26,82,22,21,43
8,8478519,Anthony Cirelli,C,TBL,27,82,20,23,43
8,8474641,Adam Henrique,C,EDM,34,82,16,27,43
8,8480078,Filip Chytil,C,NYR,25,82,12,31,43
8,8481542,Moritz Seider,D,DET,23,82,11,32,43
8,8478038,Devon Toews,D,COL,30,82,10,33,43
8,8475753,Justin Faulk,D,STL,32,82,9,34,43
8,8475906,John Klingberg,D,TOR,32,82,1,42,43
8,8482720,Matthew Knies,L,TOR,22,82,14,28,42
8,8475314,Anders Lee,L,NYI,34,82,25,16,41
8,8474102,David Perron,L,DET,36,82,24,17,41
8,8481596,Shane Pinto,C,OTT,24,82,18,23,41
8,8478438,Tommy Novak,C,NSH,27,82,13,28,41
8,8477494,Jonathan Drouin,L,COL,29,82,13,28,41
8,8477948,Travis Sanheim,D,PHI,28,82,13,28,41
8,8476882,Teuvo Teravainen,L,CAR,30,82,12,29,41
8,8478469,Thomas Chabot,D,OTT,27,82,12,29,41
8,8478472,Mathieu Joseph,R,OTT,27,82,12,29,41
8,8478396,Noah Hanifin,D,VGK,27,82,10,31,41
8,8480043,Timothy Liljegren,D,TOR,25,82,9,32,41
8,8483431,Logan Cooley,C,ARI,20,82,26,14,40
8,8477426,Nicholas Paul,L,TBL,29,82,21,19,40
8,8480849,Barrett Hayton,C,ARI,24,82,20,20,40
8,8475794,Tyler Seguin,C,DAL,32,82,17,23,40
8,8482146,Luke Evangelista,R,NSH,22,82,16,24,40
8,8478233,Andrew Mangiapane,L,CGY,28,82,15,25,40
8,8480893,Kirill Marchenko,R,CBJ,24,82,15,25,40
8,8477964,Ivan Barbashev,C,VGK,29,82,13,27,40
8,8482222,Alexander Barabanov,L,SJS,30,82,13,27,40
8,8477503,Max Domi,C,TOR,29,82,11,29,40
8,8476458,Ryan Strome,C,ANA,31,82,11,29,40
8,8481581,Thomas Harley,D,DAL,23,82,8,32,40
8,8483471,Brad Lambert,C,WPG,31,82,5,35,40
8,8478463,Anthony Beauvillier,L,NSH,27,82,18,21,39
8,8481186,Logan O'Connor,R,COL,28,82,17,22,39
8,8477407,Anthony Duclair,L,TBL,29,82,15,24,39
8,8481528,Dylan Cozens,C,BUF,23,82,15,24,39
8,8478366,Frank Vatrano,R,ANA,30,82,14,25,39
8,8482475,Yegor Chinakhov,R,CBJ,23,82,14,25,39
8,8477495,Seth Jones,D,CHI,30,82,13,26,39
8,8477497,Sean Monahan,C,WPG,30,82,12,27,39
8,8477986,Brandon Montour,D,FLA,30,82,11,28,39
8,8476792,Torey Krug,D,STL,33,82,9,30,39
8,8474565,Alex Pietrangelo,D,VGK,34,82,8,31,39
8,8484153,Leo Carlsson,C,ANA,20,82,19,19,38
8,8481560,Arthur Kaliyev,R,LAK,23,82,17,21,38
8,8482702,Logan Stankoven,C,DAL,21,82,16,22,38
8,8478046,Danton Heinen,L,BOS,29,82,15,23,38
8,8471218,Blake Wheeler,R,NYR,38,82,15,23,38
8,8477429,Andrew Copp,C,DET,30,82,14,24,38
8,8479415,Michael McLeod,C,NJD,26,82,14,24,38
8,8475791,Taylor Hall,L,CHI,33,82,12,26,38
8,8477021,Alex Kerfoot,C,ARI,30,82,10,28,38
8,8482671,Owen Power,D,BUF,22,82,9,29,38
8,8471724,Kris Letang,D,PIT,37,82,8,30,38
8,8476958,Jaccob Slavin,D,CAR,30,82,3,35,38
8,8483457,Lane Hutson,D,MTL,20,82,1,37,38
8,8483397,Marc McLaughlin,C,BOS,25,82,35,2,37
8,8482159,Tyson Foerster,R,PHI,22,82,23,14,37
8,8480459,Pius Suter,C,VAN,28,82,23,14,37
8,8475760,Nick Bjugstad,C,ARI,32,82,22,15,37
8,8476483,Rickard Rakell,R,PIT,31,82,21,16,37
8,8478109,Victor Olofsson,L,BUF,29,82,16,21,37
8,8482117,Lukas Reichel,L,CHI,22,82,16,21,37
8,8477425,Miles Wood,L,COL,29,82,15,22,37
8,8476925,Colton Sissons,C,NSH,31,82,15,22,37
8,8475191,Reilly Smith,R,PIT,33,82,12,25,37
8,8479992,Michael Rasmussen,C,DET,25,82,12,25,37
8,8477947,Sonny Milano,L,WSH,28,82,11,26,37
8,8475744,Evgeny Kuznetsov,C,CAR,32,82,10,27,37
8,8478500,Ivan Provorov,D,CBJ,27,82,9,28,37
8,8476981,Josh Anderson,R,MTL,30,82,23,13,36
8,8480813,Joe Veleno,C,DET,24,82,18,18,36
8,8482667,William Eklund,L,SJS,22,82,15,21,36
8,8480185,Eetu Luostarinen,C,FLA,26,82,15,21,36
8,8477839,Conor Sheary,L,TBL,32,82,15,21,36
8,8474053,Logan Couture,C,SJS,35,82,15,21,36
8,8476872,Scott Laughton,C,PHI,30,82,14,22,36
8,8480028,Morgan Frost,C,PHI,25,82,14,22,36
8,8474870,Tyler Johnson,C,CHI,34,82,14,22,36
8,8476392,Adam Lowry,C,WPG,31,82,12,24,36
8,8482105,Jake Sanderson,D,OTT,22,82,11,25,36
8,8481711,Matias Maccelli,L,ARI,24,82,8,28,36
8,8478055,Gustav Forsling,D,FLA,28,82,7,29,36
8,8476875,Mike Matheson,D,MTL,30,82,7,29,36
8,8481016,Ruslan Iskhakov,C,NYI,24,82,7,29,36
8,8474578,Erik Karlsson,D,PIT,34,82,5,31,36
8,8483524,Shane Wright,C,SEA,20,82,23,12,35
8,8476438,Brandon Saad,L,STL,32,82,23,12,35
8,8477952,Robby Fabbri,C,DET,28,82,20,15,35
8,8481624,Ilya Mikheyev,R,VAN,30,82,17,18,35
8,8479390,Taylor Raddysh,R,CHI,26,82,17,18,35
8,8481535,Nils Hoglander,L,VAN,24,82,16,19,35
8,8478542,Evan Rodrigues,C,FLA,31,82,14,21,35
8,8476419,Jean-Gabriel Pageau,C,NYI,32,82,14,21,35
8,8482079,Marco Rossi,C,MIN,23,82,12,23,35
8,8476329,Travis Boyd,C,ARI,31,82,10,25,35
8,8473563,Nicklas Backstrom,C,WSH,37,82,10,25,35
8,8477498,Darnell Nurse,D,EDM,29,82,9,26,35
8,8475197,Tyson Barrie,D,NSH,33,82,7,28,35
8,8477488,Brett Pesce,D,CAR,30,82,7,28,35
8,8478466,Daniel Sprong,R,DET,27,82,20,14,34
8,8480009,Eeli Tolvanen,R,SEA,25,82,17,17,34
8,8480802,Ryan McLeod,C,EDM,25,82,17,17,34
8,8475799,Nino Niederreiter,R,WPG,32,82,16,18,34
8,8482175,JJ Peterka,R,BUF,22,82,15,19,34
8,8475287,Erik Haula,L,NJD,33,82,14,20,34
8,8474149,Evgenii Dadonov,R,DAL,35,82,13,21,34
8,8476461,Sean Couturier,C,PHI,32,82,12,22,34
8,8481013,Jonatan Berggren,R,DET,24,82,11,23,34
8,8476826,Yanni Gourde,C,SEA,33,82,10,24,34
8,8481656,Aliaksei Protas,C,WSH,23,82,10,24,34
8,8482122,Brock Faber,D,MIN,22,82,8,26,34
8,8481546,Cam York,D,PHI,23,82,8,26,34
8,8478507,John Marino,D,NJD,27,82,5,29,34
8,8482733,Logan Mailloux,D,MTL,31,82,4,30,34
8,8481093,Rafael Harvey-Pinard,L,MTL,25,82,20,13,33
8,8480074,Alexandre Texier,C,CBJ,25,82,19,14,33
8,8482110,Dawson Mercer,C,NJD,23,82,16,17,33
8,8479353,Brett Howden,C,VGK,26,82,15,18,33
8,8480817,K'Andre Miller,D,NYR,24,82,8,25,33
8,8470613,Brent Burns,D,CAR,39,82,8,25,33
8,8482142,Jamie Drysdale,D,PHI,22,82,7,26,33
8,8483491,Ivan Miroshnichenko,L,WSH,20,82,22,10,32
8,8483515,Juraj Slafkovsky,L,MTL,20,82,16,16,32
8,8477330,Dominik Kubalik,L,OTT,29,82,16,16,32
8,8479987,Morgan Geekie,C,BOS,26,82,13,19,32
8,8481580,Connor McMichael,C,WSH,23,82,12,20,32
8,8479351,Sam Steel,C,DAL,26,82,12,20,32
8,8480855,Jack McBain,C,ARI,24,82,9,23,32
8,8481606,Jordan Spence,D,LAK,23,82,8,24,32
8,8476292,Ondrej Palat,L,NJD,33,82,6,26,32
8,8481703,Valtteri Puustinen,R,PIT,25,82,5,27,32
8,8477346,MacKenzie Weegar,D,CGY,30,82,3,29,32
8,8476854,Hampus Lindholm,D,BOS,30,82,3,29,32
8,8481604,Pavel Dorofeyev,L,VGK,24,82,18,13,31
8,8478020,Michael Amadio,C,VGK,28,82,15,16,31
8,8479365,Trent Frederic,C,BOS,26,82,15,16,31
8,8474189,Lars Eller,C,PIT,35,82,15,16,31
8,8475763,Kevin Hayes,R,STL,32,82,13,18,31
8,8479661,Tanner Jeannot,L,TBL,27,82,13,18,31
8,8477353,Tyler Motte,C,TBL,29,82,12,19,31
8,8480144,David Kampf,C,TOR,29,82,11,20,31
8,8480336,Sean Walker,D,COL,30,82,9,22,31
8,8476979,Erik Gustafsson,D,NYR,32,82,8,23,31
8,8481567,Henry Thrun,D,SJS,23,82,8,23,31
8,8481568,Alex Vlasic,D,CHI,23,82,7,24,31
8,8482624,Daniil Miromanov,D,CGY,27,82,6,25,31
8,8480145,Neal Pionk,D,WPG,29,82,6,25,31
8,8482101,Danil Gushchin,L,SJS,22,82,20,10,30
8,8479941,Justin Danforth,R,CBJ,31,82,20,10,30
8,8478498,Jake DeBrusk,L,BOS,28,82,19,11,30
8,8479591,Michael Eyssimont,C,TBL,28,82,17,13,30
8,8481704,Juuso Parssinen,C,NSH,23,82,16,14,30
8,8481554,Kaapo Kakko,R,NYR,23,82,16,14,30
8,8475793,Ryan Johansen,C,PHI,32,82,15,15,30
8,8484166,Adam Fantilli,C,CBJ,20,82,15,15,30
8,8478115,Pierre Engvall,L,NYI,28,82,14,16,30
8,8479996,Cody Glass,C,NSH,25,82,14,16,30
8,8476892,Colton Parayko,D,STL,31,82,11,19,30
8,8478891,Mason Appleton,C,WPG,28,82,11,19,30
8,8482679,Matt Coronato,R,CGY,22,82,10,20,30
8,8474715,Cam Atkinson,R,PHI,35,82,9,21,30
8,8484145,Zach Benson,L,BUF,19,82,8,22,30
8,8477989,Christian Dvorak,C,MTL,28,82,8,22,30
8,8473422,Nick Foligno,L,CHI,37,82,7,23,30
8,8475764,Cam Fowler,D,ANA,33,82,4,26,30
8,8479398,Samuel Girard,D,COL,26,82,3,27,30
8,8475149,Marcus Johansson,L,MIN,34,82,13,16,29
8,8473449,Kyle Okposo,R,FLA,36,82,12,17,29
8,8476960,Andreas Athanasiou,C,CHI,30,82,9,20,29
8,8474673,TJ Brodie,D,TOR,34,82,6,23,29
8,8482655,J.J. Moser,D,ARI,24,82,6,23,29
8,8476885,Jacob Trouba,D,NYR,30,82,5,24,29
8,8480860,Kevin Bahl,D,NJD,24,82,4,25,29
8,8483493,Frank Nazar,C,CHI,20,82,20,8,28
8,8477944,Jakub Vrana,L,STL,28,82,18,10,28
8,8474884,Mike Hoffman,C,SJS,35,82,16,12,28
8,8475714,Calle Jarnkrok,C,TOR,33,82,14,14,28
8,8481553,Bobby Brink,R,PHI,23,82,14,14,28
8,8470604,Jeff Carter,C,PIT,39,82,12,16,28
8,8480821,Filip Zadina,R,SJS,25,82,11,17,28
8,8482089,Jake Neighbours,L,STL,22,82,9,19,28
8,8476902,Esa Lindell,D,DAL,30,82,9,19,28
8,8474716,Jared Spurgeon,D,MIN,35,82,8,20,28
8,8476917,Adam Pelech,D,NYI,30,82,3,25,28
8,8480246,Nick Perbix,D,TBL,26,82,2,26,28
8,8482145,Mavrik Bourque,C,DAL,22,82,21,6,27
8,8482118,Sam Colangelo,R,ANA,23,82,20,7,27
8,8481481,Blake Lizotte,C,LAK,27,82,15,12,27
8,8470621,Corey Perry,R,EDM,39,82,13,14,27
8,8479346,Dillon Dube,C,CGY,26,82,13,14,27
8,8482055,Drew O'Connor,L,PIT,26,82,12,15,27
8,8477450,Jason Dickinson,C,CHI,29,82,12,15,27
8,8480806,Isac Lundestrom,C,ANA,25,82,12,15,27
8,8475848,Brendan Gallagher,R,MTL,32,82,11,16,27
8,8470610,Zach Parise,L,COL,40,82,11,16,27
8,8478133,Jake Evans,C,MTL,28,82,8,19,27
8,8477953,Kasperi Kapanen,R,STL,28,82,7,20,27
8,8478840,Will Borgen,D,SEA,28,82,7,20,27
8,8478882,Vladislav Gavrikov,D,LAK,29,82,7,20,27
8,8474151,Ryan McDonagh,D,NSH,35,82,3,24,27
8,8478178,Darren Raddysh,D,TBL,28,82,2,25,27
8,8477015,Connor Brown,R,EDM,30,82,17,9,26
8,8475164,Jakob Silfverberg,R,ANA,34,82,16,10,26
8,8481477,Nico Sturm,C,SJS,29,82,14,12,26
8,8479293,Brandon Tanev,L,SEA,33,82,13,13,26
8,8476871,Tanner Pearson,L,MTL,32,82,12,14,26
8,8482705,Cole Sillinger,C,CBJ,21,82,11,15,26
8,8483499,Liam Ohgren,L,MIN,20,82,9,17,26
8,8475171,Oliver Ekman-Larsson,D,FLA,33,82,8,18,26
8,8477969,Marcus Pettersson,D,PIT,28,82,7,19,26
8,8479976,Juuso Valimaki,D,ARI,26,82,7,19,26
8,8478416,Erik Cernak,D,TBL,27,82,7,19,26
8,8477506,Ryan Pulock,D,NYI,30,82,6,20,26
8,8473533,Jordan Staal,C,CAR,36,82,15,10,25
8,8478013,Jake Walman,D,DET,28,82,13,12,25
8,8482074,Connor Zary,C,CGY,23,82,12,13,25
8,8476312,Josh Manson,D,COL,33,82,12,13,25
8,8476873,Mark Jankowski,C,NSH,30,82,11,14,25
8,8481517,Brett Leason,R,ANA,25,82,11,14,25
8,8475231,Casey Cizikas,C,NYI,33,82,11,14,25
8,8478043,Sam Lafferty,C,VAN,29,82,11,14,25
8,8482062,Cole Smith,L,NSH,29,82,10,15,25
8,8476374,Sean Kuraly,C,CBJ,31,82,10,15,25
8,8475343,Nic Dowd,C,WSH,34,82,9,16,25
8,8483505,Matthew Poitras,C,BOS,20,82,8,17,25
8,8480172,Jan Rutta,D,SJS,34,82,8,17,25
8,8482111,Justin Barron,D,MTL,23,82,7,18,25
8,8476457,Adam Larsson,D,SEA,32,82,6,19,25
8,8479983,Mario Ferraro,D,SJS,26,82,6,19,25
8,8473507,Jeff Petry,D,DET,37,82,4,21,25
8,8481014,Alexander Romanov,D,NYI,24,82,4,21,25
8,8476879,Cody Ceci,D,EDM,31,82,2,23,25
8,8478831,Kevin Stenlund,C,FLA,28,82,13,11,24
8,8482087,Kaiden Guhle,D,MTL,22,82,8,16,24
8,8475200,Dmitry Orlov,D,CAR,33,82,7,17,24
8,8478443,Brandon Carlo,D,BOS,28,82,5,19,24
8,8471677,Jack Johnson,D,COL,37,82,4,20,24
8,8476469,Joel Armia,R,MTL,31,82,15,8,23
8,8479393,Noah Gregor,C,TOR,26,82,15,8,23
8,8476921,Jordan Martinook,L,CAR,32,82,13,10,23
8,8482092,Ridly Greig,C,OTT,22,82,9,14,23
8,8476480,Vladislav Namestnikov,C,WPG,32,82,9,14,23
8,8478413,Jordan Greenway,L,BUF,27,82,8,15,23
8,8481028,Martin Pospisil,C,CGY,25,82,7,16,23
8,8483495,Simon Nemec,D,NJD,20,82,7,16,23
8,8476967,Brett Kulak,D,EDM,30,82,7,16,23
8,8480113,Alex Iafallo,L,WPG,31,82,6,17,23
8,8479369,Andrew Peeke,D,BOS,26,82,5,18,23
8,8480073,Erik Brannstrom,D,OTT,25,82,4,19,23
8,8478851,Alexandre Carrier,D,NSH,28,82,3,20,23
8,8476278,Colin Blackwell,C,CHI,31,82,14,8,22
8,8482737,Zack Bolduc,C,STL,21,82,9,13,22
8,8482166,Shakir Mukhamadullin,D,SJS,22,82,9,13,22
8,8482730,Brandt Clarke,D,LAK,21,82,6,16,22
8,8478136,Jake Middleton,D,MIN,28,82,6,16,22
8,8475179,Dmitry Kulikov,D,FLA,34,82,4,18,22
8,8477845,Trevor van Riemsdyk,D,WSH,33,82,3,19,22
8,8481178,Egor Zamula,D,PHI,24,82,2,20,22
8,8475188,Brayden McNabb,D,VGK,33,82,1,21,22
8,8478569,Noel Acciari,C,PIT,33,82,11,10,21
8,8476897,Oskar Sundqvist,C,STL,30,82,10,11,21
8,8480068,Ryan Poehling,C,PHI,25,82,9,12,21
8,8480980,Connor Dewar,C,TOR,25,82,8,13,21
8,8481524,Bowen Byram,D,BUF,23,82,8,13,21
8,8478911,Matt Roy,D,LAK,29,82,7,14,21
8,8477919,Frederick Gaudreau,C,MIN,31,82,6,15,21
8,8478451,Ethan Bear,D,WSH,27,82,6,15,21
8,8481601,Simon Holmstrom,R,NYI,23,82,5,16,21
8,8480834,Ty Emberson,D,SJS,24,82,5,16,21
8,8481059,Scott Perunovich,D,STL,26,82,4,17,21
8,8481605,Jackson LaCombe,D,ANA,23,82,4,17,21
8,8475324,Nick Jensen,D,WSH,34,82,4,17,21
8,8479316,Luke Kunin,C,SJS,27,82,16,4,20
8,8482155,Alex Laferriere,R,LAK,23,82,13,7,20
8,8479359,Beck Malenstyn,L,WSH,26,82,12,8,20
8,8482125,Alexander Holtz,R,NJD,22,82,10,10,20
8,8478468,Jeremy Lauzon,D,NSH,27,82,10,10,20
8,8479371,Dante Fabbro,D,NSH,26,82,6,14,20
8,8476331,Dylan DeMelo,D,WPG,31,82,5,15,20
8,8479980,Nicolas Hague,D,VGK,26,82,5,15,20
8,8476463,Jonas Brodin,D,MIN,31,82,4,16,20
8,8477505,Alexander Wennberg,C,NYR,30,82,4,16,20
8,8483466,Kevin Korchinski,D,CHI,20,82,3,17,20
8,8475181,Nick Leddy,D,STL,33,82,2,18,20
8,8477406,Mattias Janmark,C,EDM,32,82,2,18,20
8,8482245,Artem Zub,D,OTT,29,82,1,19,20
8,8476878,Zemgus Girgensons,L,BUF,30,82,11,8,19
8,8479383,Boris Katchouk,L,OTT,26,82,9,10,19
8,8479977,Kailer Yamamoto,R,SEA,26,82,7,12,19
8,8480796,Martin Fehervary,D,WSH,25,82,7,12,19
8,8477508,Curtis Lazar,C,NJD,29,82,6,13,19
8,8477220,Nate Schmidt,D,WPG,33,82,6,13,19
8,8476429,Scott Mayfield,D,NYI,32,82,5,14,19
8,8470966,Mark Giordano,D,TOR,41,82,5,14,19
8,8475790,Erik Gudbranson,D,CBJ,32,82,4,15,19
8,8482712,Oskar Olausson,R,COL,22,82,4,15,19
8,8475233,David Savard,D,MTL,34,82,3,16,19
8,8477034,Jaycob Megna,D,CHI,32,82,3,16,19
8,8480879,Jacob Bernard-Docker,D,OTT,24,82,2,17,19
8,8476891,Matt Grzelcyk,D,BOS,30,82,1,18,19
8,8476422,Mike Reilly,D,NYI,31,82,10,8,18
8,8477507,Nikita Zadorov,D,VAN,29,82,10,8,18
8,8482762,Simon Edvinsson,D,DET,21,82,9,9,18
8,8478057,Dakota Joshua,C,VAN,28,82,8,10,18
8,8479291,Kevin Rooney,C,CGY,31,82,8,10,18
8,8475220,Marcus Foligno,L,MIN,33,82,6,12,18
8,8475690,Chris Tanev,D,DAL,35,82,5,13,18
8,8479998,Mikey Anderson,D,LAK,25,82,4,14,18
8,8476372,Nick Seeler,D,PHI,31,82,4,14,18
8,8476525,Colin Miller,D,WPG,32,82,3,15,18
8,8478408,Travis Dermott,D,ARI,28,82,2,16,18
8,8480281,Alexey Toropchenko,R,STL,25,82,10,7,17
8,8478508,Yakov Trenin,C,COL,27,82,8,9,17
8,8483482,Tristan Luneau,D,ANA,20,82,7,10,17
8,8481522,Peyton Krebs,C,BUF,23,82,5,12,17
8,8480448,Parker Kelly,L,OTT,25,82,5,12,17
8,8477499,Rasmus Ristolainen,D,PHI,30,82,3,14,17
8,8474574,Tyler Myers,D,VAN,34,82,2,15,17
8,8474166,Alec Martinez,D,VGK,37,82,2,15,17
8,8482470,Ilya Solovyov,D,CGY,24,82,2,15,17
8,8484911,Collin Graf,R,SJS,22,82,1,16,17
8,8473453,Trevor Lewis,C,LAK,37,82,9,7,16
8,8477392,Hudson Fasching,R,NYI,29,82,8,8,16
8,8482259,Bobby McMann,C,TOR,28,82,8,8,16
8,8477931,Tomas Nosek,L,NJD,32,82,8,8,16
8,8481537,Nikita Okhotiuk,D,CGY,24,82,7,9,16
8,8479514,Rem Pitlick,C,CHI,27,82,5,11,16
8,8483490,Pavel Mintyukov,D,ANA,21,82,4,12,16
8,8475177,Calvin de Haan,D,TBL,33,82,4,12,16
8,8480873,Rasmus Sandin,D,WSH,24,82,3,13,16
8,8474034,Pat Maroon,L,BOS,36,82,3,13,16
8,8477365,Connor Clifton,D,BUF,29,82,3,13,16
8,8475462,Radko Gudas,D,ANA,34,82,3,13,16
8,8477369,Carson Soucy,D,VAN,30,82,3,13,16
8,8479442,Troy Stecher,D,EDM,30,82,3,13,16
8,8478399,Jonas Siegenthaler,D,NJD,27,82,1,15,16
8,8475825,Jani Hakanpää,D,DAL,32,82,1,15,16
8,8481578,Graeme Clarke,R,NJD,23,82,10,5,15
8,8484203,Bradly Nadeau,L,CAR,19,82,8,7,15
8,8482809,Jackson Blake,R,CAR,21,82,8,7,15
8,8478430,Oliver Kylington,D,CGY,27,82,7,8,15
8,8476624,Barclay Goodrow,C,NYR,31,82,6,9,15
8,8475279,Ben Chiarot,D,DET,33,82,6,9,15
8,8483565,Nick Blankenburg,D,CBJ,26,82,6,9,15
8,8480990,Declan Chisholm,D,MIN,24,82,6,9,15
8,8475842,Sam Carrick,C,EDM,32,82,5,10,15
8,8477335,Kyle Burroughs,D,SJS,29,82,5,10,15
8,8478859,Niko Mikkola,D,FLA,28,82,4,11,15
8,8476931,Jake McCabe,D,TOR,31,82,3,12,15
8,8482516,Matthew Kessel,D,STL,24,82,3,12,15
8,8476467,Jamie Oleksiak,D,SEA,32,82,2,13,15
8,8482666,Scott Morrow,D,CAR,22,82,8,6,14
8,8482803,Olen Zellweger,D,ANA,21,82,7,7,14
8,8476858,Phillip Di Giuseppe,L,VAN,31,82,6,8,14
8,8482073,Braden Schneider,D,NYR,23,82,5,9,14
8,8480035,Henri Jokiharju,D,BUF,25,82,5,9,14
8,8475208,Brian Dumoulin,D,SEA,33,82,4,10,14
8,8483012,Logan Morrison,C,SEA,22,82,4,10,14
8,8477435,Ryan Graves,D,PIT,29,82,2,12,14
8,8484149,Gavin Brindley,C,CBJ,20,82,5,8,13
8,8474009,Nick Bonino,C,NYR,36,82,3,10,13
8,8474567,Zach Bogosian,D,MIN,34,82,3,10,13
8,8482858,Ryker Evans,D,SEA,23,82,3,10,13
8,8474013,Ian Cole,D,VAN,35,82,3,10,13
8,8480807,Mattias Samuelsson,D,BUF,24,82,2,11,13
8,8480058,Pierre-Olivier Joseph,D,PIT,25,82,2,11,13
8,8483763,Maksymilian Szuber,D,ARI,22,82,2,11,13
8,8481030,Jack St. Ivany,D,PIT,25,82,2,11,13
8,8473504,Cal Clutterbuck,R,NYI,37,82,6,6,12
8,8483489,Fraser Minten,C,TOR,31,82,6,6,12
8,8476442,Matt Nieto,L,PIT,32,82,5,7,12
8,8475455,Brenden Dillon,D,WPG,34,82,1,10,11
8,8470600,Ryan Suter,D,DAL,39,82,1,10,11
8,8476473,Connor Murphy,D,CHI,31,82,1,10,11
8,8482807,Ethan Del Mastro,D,CHI,21,82,2,8,10
8,8482177,Marat Khusnutdinov,C,MIN,22,82,4,5,9
8,8482859,Zack Ostapchuk,C,OTT,21,82,2,7,9
8,8481599,Victor Soderstrom,D,ARI,23,82,7,1,8
8,8476915,Jujhar Khaira,L,MIN,30,82,2,6,8
8,8475762,Derek Forbort,D,BOS,32,82,0,8,8
8,8476822,Luke Glendening,C,TBL,35,82,5,2,7
8,8479324,Ryan Lindgren,D,NYR,26,82,2,5,7
8,8482713,Mackie Samoskevich,R,FLA,22,82,2,5,7
8,8483468,Jiri Kulich,C,BUF,20,82,2,3,5
8,8482141,Lukas Cormier,D,VGK,22,0,0,0,0
8,8476988,Matt Benning,D,SJS,30,0,0,0,0
8,8480727,Zach Whitecloud,D,VGK,28,0,0,0,0
8,8480887,Jordan Harris,D,MTL,24,0,0,0,0
8,8478450,Parker Wotherspoon,D,BOS,27,0,0,0,0
8,8481812,Nikolai Knyzhov,D,SJS,27,0,0,0,0
8,8480001,Urho Vaakanainen,D,ANA,25,0,0,0,0
8,8482176,Wyatt Kaiser,D,CHI,22,0,0,0,0
8,8481122,Simon Benoit,D,TOR,26,0,0,0,0
8,8476441,Joel Edmundson,D,TOR,31,0,0,0,0
8,8480884,Calen Addison,D,SJS,24,0,0,0,0
8,8482511,Mason Lohrei,D,BOS,23,0,0,0,0
8,8482192,Isaak Phillips,D,CHI,23,0,0,0,0
8,8480950,Ilya Lyubushkin,D,TOR,30,0,0,0,0
8,8474031,Kevin Shattenkirk,D,BOS,35,0,0,0,0
8,8475718,Justin Holl,D,DET,32,0,0,0,0
8,8479402,Jake Bean,D,CBJ,26,0,0,0,0
8,8474602,Justin Schultz,D,SEA,34,0,0,0,0
8,8477950,Tony DeAngelo,D,CAR,29,0,0,0,0
8,8481743,Marc Del Gaizo,D,NSH,25,0,0,0,0
8,8481527,Kaedan Korczak,D,VGK,23,0,0,0,0
8,8480192,Johnathan Kovacevic,D,MTL,27,0,0,0,0
8,8476874,Olli Maatta,D,DET,30,0,0,0,0
8,8482144,Jack Thompson,D,SJS,22,0,0,0,0
8,8480222,Sebastian Aho,D,NYI,28,0,0,0,0
8,8479458,Nikita Zaitsev,D,CHI,33,0,0,0,0
8,8471709,Marc-Edouard Vlasic,D,SJS,37,0,0,0,0
8,8482929,Emil Lilleberg,D,TBL,23,0,0,0,0
8,8477018,Ben Hutton,D,VGK,31,0,0,0,0
8,8481056,Spencer Stastney,D,NSH,24,0,0,0,0
8,8481593,Jayden Struble,D,MTL,23,0,0,0,0
8,8479982,Conor Timmins,D,TOR,26,0,0,0,0
8,8474090,Brendan Smith,D,NJD,35,0,0,0,0
8,8482964,Arber Xhekaj,D,MTL,23,0,0,0,0
8,8480891,Michael Kesselring,D,ARI,24,0,0,0,0
8,8477938,Haydn Fleury,D,TBL,28,0,0,0,0
8,8481806,Louis Crevier,D,CHI,23,0,0,0,0
8,8471274,Alex Goligoski,D,MIN,39,0,0,0,0
8,8481600,Tobias Bjornfot,D,FLA,23,0,0,0,0
8,8475797,Jarred Tinordi,D,CHI,32,0,0,0,0
8,8481521,Ronnie Attard,D,PHI,25,0,0,0,0
8,8474612,Travis Hamonic,D,OTT,34,0,0,0,0
8,8479576,Vincent Desharnais,D,EDM,28,0,0,0,0
8,8480049,Dylan Samberg,D,WPG,25,0,0,0,0
8,8483619,Filip Roos,D,CHI,25,0,0,0,0
8,8474568,Luke Schenn,D,NSH,35,0,0,0,0
8,8480184,Gustav Lindstrom,D,ANA,26,0,0,0,0
8,8480070,Ian Mitchell,D,BOS,25,0,0,0,0
8,8480196,Jacob Bryson,D,BUF,27,0,0,0,0
8,8471686,Marc Staal,D,PHI,37,0,0,0,0
8,8477467,Gustav Olofsson,D,SEA,30,0,0,0,0
8,8478970,Jalen Chatfield,D,CAR,28,0,0,0,0
8,8479348,Kale Clague,D,BUF,26,0,0,0,0
8,8473446,Erik Johnson,D,PHI,36,0,0,0,0
8,8477462,Robert Hagg,D,ANA,29,0,0,0,0
8,8478454,Noah Juulsen,D,VAN,27,0,0,0,0
8,8477384,Josh Brown,D,ARI,30,0,0,0,0
8,8481708,Zac Jones,D,NYR,24,0,0,0,0
8,8481167,Brayden Pachal,D,CGY,25,0,0,0,0
8,8482067,Connor Mackey,D,NYR,28,0,0,0,0
8,8483460,David Jiricek,D,CBJ,21,0,0,0,0
8,8481701,Santeri Hatakka,D,NJD,23,0,0,0,0
8,8478021,William Lagesson,D,ANA,28,0,0,0,0
8,8477851,Jordan Oesterle,D,CGY,32,0,0,0,0
8,8478452,Caleb Jones,D,COL,27,0,0,0,0
8,8479984,Cal Foote,D,NJD,26,0,0,0,0
8,8479639,Dylan Coghlan,D,CAR,26,0,0,0,0
8,8480874,Adam Ginning,D,PHI,24,0,0,0,0
8,8479321,Lucas Johansen,D,WSH,27,0,0,0,0
8,8480878,Nils Lundkvist,D,DAL,24,0,0,0,0
8,8482165,Yan Kuznetsov,D,CGY,22,0,0,0,0
8,8484258,Sam Malinski,D,COL,26,0,0,0,0
8,8480157,Calle Rosen,D,STL,30,0,0,0,0
8,8484304,Uvis Balinskis,D,FLA,28,0,0,0,0
8,8479985,Cale Fleury,D,SEA,26,0,0,0,0
8,8479378,Logan Stanley,D,WPG,26,0,0,0,0
8,8477541,Dakota Mermis,D,MIN,30,0,0,0,0
8,8481609,Vladislav Kolyachonok,D,ARI,23,0,0,0,0
8,8480823,Alexander Alexeyev,D,WSH,25,0,0,0,0
8,8481679,Maxence Guenette,D,OTT,23,0,0,0,0
8,8481564,Ryan Johnson,D,BUF,23,0,0,0,0
8,8479376,Victor Mete,D,PHI,26,0,0,0,0
8,8484254,Akito Hirose,D,VAN,25,0,0,0,0
8,8482660,Kent Johnson,C,CBJ,22,0,0,0,0
8,8482149,Cole Perfetti,C,WPG,22,0,0,0,0
8,8477987,Ryan Donato,C,CHI,28,0,0,0,0
8,8475755,Alexander Petrovic,D,DAL,32,0,0,0,0
8,8477810,Joel Hanley,D,CGY,33,0,0,0,0
8,8474145,Robert Bortuzzo,D,NYI,35,0,0,0,0
8,8481161,Jake Christiansen,D,CBJ,25,0,0,0,0
8,8476884,Derrick Pouliot,D,DAL,30,0,0,0,0
8,8481716,Dmitri Voronkov,L,CBJ,24,0,0,0,0
8,8480084,Nick DeSimone,D,NJD,30,0,0,0,0
8,8475750,Jon Merrill,D,MIN,32,0,0,0,0
8,8479315,Joey Anderson,R,CHI,26,0,0,0,0
8,8478011,Louie Belpedio,D,PHI,28,0,0,0,0
8,8482451,Mikael Pyyhtia,L,CBJ,23,0,0,0,0
8,8481541,Samuel Bolduc,D,NYI,24,0,0,0,0
8,8482126,Emil Andrae,D,PHI,31,0,0,0,0
8,8474618,Marco Scandella,D,STL,34,0,0,0,0
8,8477244,Chad Ruhwedel,D,NYR,34,0,0,0,0
8,8477971,Andreas Englund,D,LAK,28,0,0,0,0
8,8480829,Jesperi Kotkaniemi,C,CAR,24,0,0,0,0
8,8479372,Josh Mahura,D,FLA,26,0,0,0,0
8,8482095,Tyler Kleven,D,OTT,22,0,0,0,0
8,8481719,Maxwell Crozier,D,TBL,24,0,0,0,0
8,8475855,Jesper Fast,R,CAR,33,0,0,0,0
8,8480848,Ty Dellandrea,C,DAL,24,0,0,0,0
8,8475193,Tomas Tatar,L,SEA,34,0,0,0,0
8,8476889,Radek Faksa,C,DAL,30,0,0,0,0
8,8478495,Denis Gurianov,R,PHI,27,0,0,0,0
8,8480216,Jacob Peterson,C,SJS,25,0,0,0,0
8,8480252,Cole Guttman,C,CHI,25,0,0,0,0
8,8479026,Philippe Myers,D,TBL,27,0,0,0,0
8,8481006,Tyler Tucker,D,STL,24,0,0,0,0
8,8481032,Paul Cotter,C,VGK,25,0,0,0,0
8,8481577,Philip Tomasino,C,NSH,23,0,0,0,0
8,8476918,Jimmy Vesey,L,NYR,31,0,0,0,0
8,8479320,Max Lajoie,D,TOR,27,0,0,0,0
8,8478017,Mark Friedman,D,VAN,29,0,0,0,0
8,8481754,Nikita Nesterenko,C,ANA,23,0,0,0,0
8,8483407,Brandon Scanlin,D,NYR,25,0,0,0,0
8,8482659,Josh Doan,R,ARI,22,0,0,0,0
8,8477446,Michael McCarron,R,NSH,29,0,0,0,0
8,8477903,Garnet Hathaway,R,PHI,33,0,0,0,0
8,8482153,Brendan Brisson,C,VGK,23,0,0,0,0
8,8483546,Marshall Rifai,D,TOR,26,0,0,0,0
8,8484287,Cole McWard,D,VAN,23,0,0,0,0
8,8478854,Ryan Shea,D,PIT,27,0,0,0,0
8,8481585,Egor Afanasyev,L,NSH,23,0,0,0,0
8,8483398,Declan Carlile,D,TBL,31,0,0,0,0
8,8478502,Dennis Gilbert,D,CGY,28,0,0,0,0
8,8482749,Joshua Roy,R,MTL,21,0,0,0,0
8,8481598,Philip Broberg,D,EDM,23,0,0,0,0
8,8480835,Jack Drury,C,CAR,24,0,0,0,0
8,8480748,Kiefer Sherwood,L,NSH,29,0,0,0,0
8,8476934,Brock McGinn,L,ANA,30,0,0,0,0
8,8480870,Bo Groulx,C,ANA,24,0,0,0,0
8,8479368,Max Jones,L,ANA,26,0,0,0,0
8,8478099,Kevin Labanc,R,SJS,29,0,0,0,0
8,8478067,Oskar Lindblom,L,SJS,28,0,0,0,0
8,8476393,Nick Cousins,C,FLA,31,0,0,0,0
8,8483395,Arshdeep Bains,L,VAN,23,0,0,0,0
8,8480762,Eric Robinson,L,BUF,29,0,0,0,0
8,8479439,Jacob MacDonald,D,SJS,31,0,0,0,0
8,8476474,Stefan Noesen,R,CAR,31,0,0,0,0
8,8482787,Nikita Chibrikov,R,WPG,31,0,0,0,0
8,8478432,Christian Fischer,R,DET,27,0,0,0,0
8,8477979,Nicolas Aube-Kubel,R,WSH,28,0,0,0,0
8,8481789,Tye Kartye,L,SEA,23,0,0,0,0
8,8479330,Brandon Gignac,C,MTL,27,0,0,0,0
8,8480075,Cameron Crotty,D,ARI,25,0,0,0,0
8,8473473,Milan Lucic,L,BOS,36,0,0,0,0
8,8482094,Daemon Hunt,D,MIN,22,0,0,0,0
8,8481206,John Ludvig,D,PIT,24,0,0,0,0
8,8483630,Pavol Regenda,L,ANA,25,0,0,0,0
8,8481617,Vasily Podkolzin,R,VAN,23,0,0,0,0
8,8480306,Grant Hutton,D,NYI,29,0,0,0,0
8,8480995,Pontus Holmberg,R,TOR,25,0,0,0,0
8,8482148,Hendrix Lapierre,C,WSH,22,0,0,0,0
8,8477478,William Carrier,L,VGK,30,0,0,0,0
8,8480003,Jesper Boqvist,C,BOS,26,0,0,0,0
8,8482172,Landon Slaggert,L,CHI,22,0,0,0,0
8,8480789,Oliver Wahlstrom,R,NYI,24,0,0,0,0
8,8474062,Riley Nash,C,NYR,35,0,0,0,0
8,8480021,Jack Studnicka,C,SJS,25,0,0,0,0
8,8480025,MacKenzie Entwistle,R,CHI,25,0,0,0,0
8,8481582,Nicholas Robertson,L,TOR,23,0,0,0,0
8,8476867,Brendan Gaunce,C,CBJ,30,0,0,0,0
8,8479619,Michael Carcone,L,ARI,28,0,0,0,0
8,8479370,Tyson Jost,C,BUF,26,0,0,0,0
8,8479671,Mathieu Olivier,R,CBJ,27,0,0,0,0
8,8476994,Vinnie Hinostroza,C,PIT,30,0,0,0,0
8,8482070,Mitchell Chaffee,R,TBL,26,0,0,0,0
8,8477473,Justin Bailey,R,SJS,29,0,0,0,0
8,8479344,Jesse Puljujarvi,R,PIT,26,0,0,0,0
8,8480205,Emil Bemstrom,C,PIT,25,0,0,0,0
8,8479718,Alex Barré-Boulet,C,TBL,27,0,0,0,0
8,8482061,Brandon Biro,L,BUF,26,0,0,0,0
8,8479638,Justin Brazeau,R,BOS,26,0,0,0,0
8,8474040,Sam Gagner,C,EDM,35,0,0,0,0
8,8477846,Ryan Carpenter,C,SJS,33,0,0,0,0
8,8482077,Dylan Holloway,L,EDM,23,0,0,0,0
8,8482157,Will Cuylle,L,NYR,22,0,0,0,0
8,8480007,Jonas Rondbjerg,R,VGK,25,0,0,0,0
8,8478874,Adam Gaudette,C,STL,28,0,0,0,0
8,8478434,Keegan Kolesar,R,VGK,27,0,0,0,0
8,8480441,Trey Fix-Wolansky,R,CBJ,25,0,0,0,0
8,8479994,Jaret Anderson-Dolan,C,NSH,25,0,0,0,0
8,8483567,Georgii Merkulov,C,BOS,24,0,0,0,0
8,8477380,Jonny Brodzinski,C,NYR,31,0,0,0,0
8,8482201,Gage Goncalves,C,TBL,23,0,0,0,0
8,8478211,Dryden Hunt,L,CGY,29,0,0,0,0
8,8471699,Andrew Cogliano,C,COL,37,0,0,0,0
8,8479421,Jacob Moverare,D,LAK,26,0,0,0,0
8,8478881,Brett Seney,L,CHI,28,0,0,0,0
8,8477464,Nic Petan,C,MIN,29,0,0,0,0
8,8475958,Michael Sgarbossa,C,WSH,32,0,0,0,0
8,8481147,Reese Johnson,C,CHI,26,0,0,0,0
8,8479336,Carl Grundstrom,R,LAK,27,0,0,0,0
8,8480853,Liam Foudy,C,NSH,24,0,0,0,0
8,8479522,Hardy Haman Aktell,D,WSH,26,0,0,0,0
8,8481462,Mason Morelli,L,VGK,28,0,0,0,0
8,8482102,Vasily Ponomarev,C,CAR,22,0,0,0,0
8,8480844,Grigori Denisenko,L,VGK,24,0,0,0,0
8,8479944,Zach Aston-Reese,C,DET,30,0,0,0,0
8,8482784,Zach Dean,C,STL,21,0,0,0,0
8,8479419,Brett Murray,L,BUF,26,0,0,0,0
8,8479520,Brandon Duhaime,R,COL,27,0,0,0,0
8,8477573,Nathan Walker,L,STL,30,0,0,0,0
8,8478078,Rourke Chartier,C,OTT,28,0,0,0,0
8,8475795,Dylan McIlrath,D,WSH,32,0,0,0,0
8,8482496,Nils Aman,C,VAN,24,0,0,0,0
8,8480289,Morgan Barron,C,WPG,26,0,0,0,0
8,8481751,Lukas Rousek,R,BUF,25,0,0,0,0
8,8480011,Klim Kostin,C,SJS,25,0,0,0,0
8,8481556,John Beecher,C,BOS,23,0,0,0,0
8,8475278,Byron Froese,C,VGK,33,0,0,0,0
8,8475225,Craig Smith,C,DAL,35,0,0,0,0
8,8484326,Patrik Koch,D,ARI,28,0,0,0,0
8,8477930,Pierre-Edouard Bellemare,L,SEA,39,0,0,0,0
8,8478409,Anthony Richard,C,BOS,28,0,0,0,0
8,8481024,Linus Karlsson,C,VAN,25,0,0,0,0
8,8479986,Kole Lind,R,SEA,26,0,0,0,0
8,8479414,Nathan Bastian,R,NJD,27,0,0,0,0
8,8479362,Riley Tufte,L,COL,26,0,0,0,0
8,8481058,Jesse Ylönen,R,MTL,25,0,0,0,0
8,8482476,Emil Heineman,L,MTL,23,0,0,0,0
8,8482861,Vincent Iorio,D,WSH,22,0,0,0,0
8,8483432,Luca Del Bel Belluz,C,CBJ,31,0,0,0,0
8,8482744,James Malatesta,L,CBJ,21,0,0,0,0
8,8477887,Patrick Brown,C,BOS,32,0,0,0,0
8,8478585,Derek Ryan,C,EDM,38,0,0,0,0
8,8481441,Joe Snively,C,WSH,28,0,0,0,0
8,8481592,Jakob Pelletier,L,CGY,23,0,0,0,0
8,8482634,Alex Steeves,C,TOR,25,0,0,0,0
8,8477126,Jayson Megna,C,BOS,34,0,0,0,0
8,8475752,Tyler Pitlick,C,NYR,33,0,0,0,0
8,8480008,Adam Ruzicka,C,ARI,25,0,0,0,0
8,8481065,Angus Crookshank,L,OTT,25,0,0,0,0
8,8479547,Matthew Phillips,R,WSH,26,0,0,0,0
8,8480226,Marián Studenic,R,SEA,26,0,0,0,0
8,8481237,Kyle MacLean,C,NYI,25,0,0,0,0
8,8475413,Justin Dowling,C,NJD,34,0,0,0,0
8,8481641,Joel Kiviranta,L,COL,28,0,0,0,0
8,8478104,Sammy Blais,L,STL,28,0,0,0,0
8,8477454,Adam Erne,L,EDM,29,0,0,0,0
8,8481518,Nolan Foote,L,NJD,24,0,0,0,0
8,8480245,Olle Lycksell,R,PHI,25,0,0,0,0
8,8483570,Ben Meyers,C,ANA,26,0,0,0,0
8,8480776,Sheldon Rempal,R,VGK,29,0,0,0,0
8,8483920,Pierrick Dube,R,WSH,23,0,0,0,0
8,8480267,Sammy Walker,C,MIN,25,0,0,0,0
8,8482747,Brennan Othmann,L,NYR,21,0,0,0,0
8,8479991,Jake Leschyshyn,C,NYR,25,0,0,0,0
8,8478400,Colin White,C,MTL,27,0,0,0,0
8,8479328,Julien Gauthier,R,NYI,27,0,0,0,0
8,8484325,Waltteri Merela,C,TBL,26,0,0,0,0
8,8479066,Ryan Lomberg,L,FLA,30,0,0,0,0
8,8477070,Liam O'Brien,C,ARI,30,0,0,0,0
8,8478146,Matthew Highmore,C,OTT,28,0,0,0,0
8,8478028,Fredrik Olofsson,L,COL,28,0,0,0,0
8,8480880,Jakub Lauko,C,BOS,24,0,0,0,0
8,8479968,Vinni Lettieri,C,MIN,29,0,0,0,0
8,8474709,Matt Martin,L,NYI,35,0,0,0,0
8,8480845,Rasmus Kupari,C,WPG,24,0,0,0,0
8,8481550,Adam Beckman,L,MIN,23,0,0,0,0
8,8481422,Jacob Lucchini,C,MIN,29,0,0,0,0
8,8477401,John Hayden,C,SEA,29,0,0,0,0
8,8478904,Steven Lorentz,C,FLA,28,0,0,0,0
8,8482088,Justin Sourdif,R,FLA,22,0,0,0,0
8,8482751,Ryan Winterton,C,SEA,21,0,0,0,0
8,8482241,Radim Zohorna,L,PIT,28,0,0,0,0
8,8481690,Tyler Angle,C,CBJ,24,0,0,0,0
8,8476952,Dominic Toninato,C,WPG,30,0,0,0,0
8,8476919,Chris Tierney,C,NJD,30,0,0,0,0
8,8480032,Shane Bowers,C,NJD,25,0,0,0,0
8,8484314,Jiri Smejkal,L,OTT,28,0,0,0,0
8,8481239,Samuel Fagemo,L,LAK,24,0,0,0,0
8,8481532,Alex Turcotte,C,LAK,23,0,0,0,0
8,8481019,David Gustafsson,C,WPG,24,0,0,0,0
8,8478477,Mitchell Stephens,C,MTL,27,0,0,0,0
8,8479546,Oskar Steen,C,BOS,26,0,0,0,0
8,8480292,Carson Meyer,R,CBJ,27,0,0,0,0
8,8478446,Glenn Gawdin,C,ANA,27,0,0,0,0
8,8483531,Brian Halonen,L,NJD,25,0,0,0,0
8,8477149,Scott Sabourin,R,SJS,32,0,0,0,0
8,8479972,Mason Shaw,C,MIN,26,0,0,0,0
8,8480890,Jan Jenik,R,ARI,24,0,0,0,0
8,8478051,Max Willman,C,NJD,29,0,0,0,0
8,8480851,Akil Thomas,C,LAK,24,0,0,0,0
8,8482765,Isak Rosen,R,BUF,21,0,0,0,0
8,8478421,A.J. Greer,L,CGY,28,0,0,0,0
8,8478512,Austin Czarnik,C,DET,32,0,0,0,0
8,8479536,Axel Jonsson-Fjallby,L,WPG,26,0,0,0,0
8,8477320,Anton Blidh,L,NYR,29,0,0,0,0
8,8481543,Nikita Alexandrov,C,STL,24,0,0,0,0
8,8475235,Nicolas Deslauriers,L,PHI,33,0,0,0,0
8,8481070,Hugh McGing,L,STL,26,0,0,0,0
8,8480836,Jonathan Gruden,C,PIT,24,0,0,0,0
8,8481591,Sam Poulin,R,PIT,23,0,0,0,0
8,8477962,Brendan Lemieux,L,CAR,28,0,0,0,0
8,8483401,Marc Johnstone,R,PIT,28,0,0,0,0
8,8482250,Callahan Burke,C,CAR,27,0,0,0,0
8,8481726,Adam Edstrom,C,NYR,24,0,0,0,0
8,8471817,Ryan Reaves,R,TOR,37,0,0,0,0
8,8479587,Rhett Gardner,C,PHI,28,0,0,0,0
8,8475766,Austin Watson,L,TBL,32,0,0,0,0
8,8479367,William Lockwood,R,FLA,26,0,0,0,0
8,8478424,Jansen Harkins,C,PIT,27,0,0,0,0
8,8476913,Devin Shore,C,SEA,30,0,0,0,0
8,8482652,Walker Duehr,R,CGY,27,0,0,0,0
8,8477527,Ross Johnston,L,ANA,30,0,0,0,0
8,8481077,John Leonard,L,ARI,26,0,0,0,0
8,8483549,Lucas Condotta,L,MTL,27,0,0,0,0
8,8480468,James Hamblin,L,EDM,25,0,0,0,0
8,8476907,Mackenzie MacEachern,L,STL,30,0,0,0,0
8,8479543,Michael Pezzetta,L,MTL,26,0,0,0,0
8,8480355,Mark Kastelic,C,OTT,25,0,0,0,0
8,8482162,Roby Jarventie,L,OTT,22,0,0,0,0
8,8479772,Zack MacEwen,R,OTT,28,0,0,0,0
8,8483597,Milos Kelemen,L,ARI,25,0,0,0,0
8,8479379,Givani Smith,R,SJS,26,0,0,0,0
8,8481655,Cole Schwindt,R,CGY,23,0,0,0,0
8,8479981,Jonah Gadjovich,L,FLA,26,0,0,0,0
8,8482147,Jean-Luc Foudy,C,COL,22,0,0,0,0
8,8484255,Jason Polin,R,COL,25,0,0,0,0
8,8477993,Justin Kirkland,C,ARI,28,0,0,0,0
8,8479249,Andrew Poturalski,C,SEA,30,0,0,0,0
8,8482197,Adam Raska,R,MIN,23,0,0,0,0
8,8475780,Chris Wagner,R,COL,33,0,0,0,0
8,8479533,Joona Koppanen,L,PIT,26,0,0,0,0
8,8481534,Raphael Lavoie,C,EDM,24,0,0,0,0
8,8484321,Nikolas Matinpalo,D,OTT,26,0,0,0,0
8,8481043,Cole Koepke,L,TBL,26,0,0,0,0
8,8476323,Max McCormick,L,SEA,32,0,0,0,0
8,8483609,Adam Klapka,R,CGY,24,0,0,0,0
8,8483512,Matt Savoie,C,BUF,20,0,0,0,0
8,8484259,Ondrej Pavel,C,COL,31,0,0,0,0
8,8478147,Bokondji Imama,L,OTT,28,0,0,0,0
8,8482460,Matt Rempe,C,NYR,22,0,0,0,0
8,8477073,Kurtis MacDermid,L,NJD,30,0,0,0,0
8,8480274,Philip Kemp,D,EDM,25,0,0,0,0
8,8478956,Samuel Laberge,L,NJD,27,0,0,0,0
8,8483045,Cameron Butler,R,CBJ,31,0,0,0,0
9,8478402,Connor McDavid,C,EDM,27,82,35,89,124
9,8478864,Kirill Kaprizov,L,MIN,27,82,51,72,123
9,8479318,Auston Matthews,C,TOR,27,82,64,58,122
9,8477492,Nathan MacKinnon,C,COL,29,82,47,68,115
9,8477934,Leon Draisaitl,C,EDM,29,82,33,78,111
9,8476453,Nikita Kucherov,R,TBL,31,82,32,76,108
9,8477956,David Pastrnak,R,BOS,28,82,47,60,107
9,8479314,Matthew Tkachuk,L,FLA,27,82,43,60,103
9,8476468,J.T. Miller,C,VAN,31,82,40,63,103
9,8477493,Aleksander Barkov,C,FLA,29,82,34,65,99
9,8480800,Quinn Hughes,D,VAN,25,82,21,78,99
9,8476887,Filip Forsberg,L,NSH,30,82,48,49,97
9,8477933,Sam Reinhart,C,FLA,29,82,50,46,96
9,8478042,Viktor Arvidsson,R,LAK,31,82,35,60,95
9,8480027,Jason Robertson,L,DAL,25,82,47,47,94
9,8478420,Mikko Rantanen,R,COL,28,82,41,53,94
9,8477404,Jake Guentzel,C,CAR,30,82,40,53,93
9,8481559,Jack Hughes,C,NJD,23,82,38,54,92
9,8478550,Artemi Panarin,L,NYR,33,82,32,59,91
9,8478010,Brayden Point,C,TBL,28,82,47,41,88
9,8478398,Kyle Connor,L,WPG,28,82,35,50,85
9,8478439,Travis Konecny,R,PHI,27,82,35,48,83
9,8479407,Jesper Bratt,L,NJD,26,82,25,58,83
9,8477942,Kevin Fiala,L,LAK,28,82,26,56,82
9,8480801,Brady Tkachuk,L,OTT,25,82,41,40,81
9,8474564,Steven Stamkos,C,TBL,34,82,37,44,81
9,8477402,Pavel Buchnevich,L,STL,29,82,29,52,81
9,8480023,Robert Thomas,C,STL,25,82,22,59,81
9,8481523,Kirby Dach,C,MTL,23,82,15,66,81
9,8471675,Sidney Crosby,C,PIT,37,82,33,47,80
9,8477939,William Nylander,R,TOR,28,82,32,48,80
9,8480012,Elias Pettersson,C,VAN,26,82,25,55,80
9,8479343,Clayton Keller,R,ARI,26,82,40,38,78
9,8482116,Tim Stützle,C,OTT,22,82,32,46,78
9,8478427,Sebastian Aho,C,CAR,27,82,25,53,78
9,8475166,John Tavares,C,TOR,34,82,33,44,77
9,8476459,Mika Zibanejad,C,NYR,31,82,31,46,77
9,8480830,Andrei Svechnikov,R,CAR,24,82,31,46,77
9,8480208,Drake Batherson,R,OTT,26,82,30,47,77
9,8474141,Patrick Kane,R,DET,36,82,30,47,77
9,8477946,Dylan Larkin,C,DET,28,82,25,52,77
9,8480002,Nico Hischier,C,NJD,25,82,35,41,76
9,8479385,Jordan Kyrou,C,STL,26,82,31,45,76
9,8475913,Mark Stone,R,VGK,32,82,30,46,76
9,8471685,Anze Kopitar,C,LAK,37,82,25,51,76
9,8475692,Mats Zuccarello,R,MIN,37,82,23,53,76
9,8475786,Zach Hyman,L,EDM,32,82,42,33,75
9,8481557,Matt Boldy,L,MIN,23,82,31,44,75
9,8477951,Nick Schmaltz,C,ARI,28,82,29,46,75
9,8476346,Johnny Gaudreau,L,CBJ,31,82,16,59,75
9,8476853,Morgan Rielly,D,TOR,30,82,9,65,74
9,8475172,Nazem Kadri,C,CGY,34,82,27,46,73
9,8478444,Brock Boeser,R,VAN,27,82,34,37,71
9,8479323,Adam Fox,D,NYR,26,82,19,52,71
9,8479337,Alex DeBrincat,R,DET,27,82,31,39,70
9,8477496,Elias Lindholm,C,VAN,30,82,31,39,70
9,8476456,Jonathan Huberdeau,C,CGY,31,82,13,57,70
9,8474600,Roman Josi,D,NSH,34,82,11,59,70
9,8478856,Conor Garland,R,VAN,28,82,36,33,69
9,8475798,Mikael Granlund,C,SJS,32,82,15,54,69
9,8478414,Timo Meier,R,NJD,28,82,40,28,68
9,8481540,Cole Caufield,R,MTL,23,82,34,34,68
9,8478449,Roope Hintz,C,DAL,28,82,33,35,68
9,8476460,Mark Scheifele,C,WPG,31,82,28,40,68
9,8476454,Ryan Nugent-Hopkins,C,EDM,31,82,27,41,68
9,8477409,Carter Verhaeghe,C,FLA,29,82,31,35,66
9,8480018,Nick Suzuki,C,MTL,25,82,27,39,66
9,8479420,Tage Thompson,C,BUF,27,82,23,43,66
9,8478445,Mathew Barzal,C,NYI,27,82,23,43,66
9,8471214,Alex Ovechkin,L,WSH,39,82,30,35,65
9,8482078,Lucas Raymond,L,DET,22,82,25,40,65
9,8480031,Maxime Comtois,L,CAR,25,82,17,48,65
9,8475158,Ryan O'Reilly,C,NSH,33,82,28,36,64
9,8480039,Martin Necas,C,CAR,25,82,26,38,64
9,8476389,Vincent Trocheck,C,NYR,31,82,25,39,64
9,8480803,Evan Bouchard,D,EDM,25,82,18,46,64
9,8478873,Troy Terry,R,ANA,27,82,24,39,63
9,8470794,Joe Pavelski,C,DAL,40,82,19,44,63
9,8481533,Trevor Zegras,C,ANA,23,82,18,45,63
9,8475167,Victor Hedman,D,TBL,34,82,9,54,63
9,8477500,Bo Horvat,C,NYI,29,82,29,33,62
9,8480839,Rasmus Dahlin,D,BUF,24,82,9,53,62
9,8476399,Blake Coleman,C,CGY,33,82,32,29,61
9,8475784,Jeff Skinner,C,BUF,32,82,29,32,61
9,8481068,Yegor Sharangovich,C,CGY,26,82,29,32,61
9,8477955,Jared McCann,L,SEA,28,82,26,35,61
9,8475754,Brock Nelson,C,NYI,33,82,34,26,60
9,8478493,Joel Eriksson Ek,C,MIN,27,82,33,27,60
9,8471215,Evgeni Malkin,C,PIT,38,82,29,31,60
9,8478440,Dylan Strome,C,WSH,27,82,26,34,60
9,8479325,Charlie McAvoy,D,BOS,27,82,8,52,60
9,8477960,Adrian Kempe,R,LAK,28,82,34,25,59
9,8477501,Valeri Nichushkin,R,COL,29,82,33,26,59
9,8479542,Brandon Hagel,L,TBL,26,82,31,28,59
9,8476479,Phillip Danault,C,LAK,31,82,25,34,59
9,8477949,Alex Tuch,R,BUF,28,82,22,37,59
9,8473419,Brad Marchand,L,BOS,36,82,21,38,59
9,8473994,Jamie Benn,L,DAL,35,82,21,38,59
9,8475170,Brayden Schenn,C,STL,33,82,21,38,59
9,8473512,Claude Giroux,R,OTT,36,82,19,40,59
9,8475151,Kyle Palmieri,C,NYI,33,82,27,31,58
9,8475765,Vladimir Tarasenko,R,FLA,33,82,23,35,58
9,8474150,Mikael Backlund,C,CGY,35,82,20,38,58
9,8479675,Trevor Moore,L,LAK,29,82,16,42,58
9,8475794,Tyler Seguin,C,DAL,32,82,28,29,57
9,8477940,Nikolaj Ehlers,L,WPG,28,82,24,33,57
9,8478438,Tommy Novak,C,NSH,27,82,20,37,57
9,8478975,Mason Marchment,L,DAL,29,82,19,38,57
9,8477504,Josh Morrissey,D,WPG,29,82,14,43,57
9,8475810,Bryan Rust,R,PIT,32,82,27,29,56
9,8480009,Eeli Tolvanen,R,SEA,25,82,21,35,56
9,8482159,Tyson Foerster,R,PHI,22,82,29,26,55
9,8475287,Erik Haula,L,NJD,33,82,23,32,55
9,8477986,Brandon Montour,D,FLA,30,82,18,37,55
9,8480069,Cale Makar,D,COL,26,82,13,42,55
9,8476882,Teuvo Teravainen,L,CAR,30,82,13,42,55
9,8478469,Thomas Chabot,D,OTT,27,82,12,43,55
9,8482684,Luke Hughes,D,NJD,21,82,11,44,55
9,8479425,Filip Hronek,D,VAN,27,82,8,47,55
9,8476539,Jonathan Marchessault,R,VGK,34,82,32,22,54
9,8483808,Andrei Kuzmenko,L,CGY,28,82,25,29,54
9,8476432,Boone Jenner,C,CBJ,31,82,23,31,54
9,8481711,Matias Maccelli,L,ARI,24,82,16,38,54
9,8478403,Jack Eichel,C,VGK,28,82,21,32,53
9,8482093,Seth Jarvis,C,CAR,22,82,21,32,53
9,8480036,Miro Heiskanen,D,DAL,25,82,5,48,53
9,8480188,Fabian Zetterlund,L,SJS,25,82,27,25,52
9,8482097,Jack Quinn,R,BUF,23,82,26,26,52
9,8474641,Adam Henrique,C,EDM,34,82,23,29,52
9,8475726,Tyler Toffoli,C,WPG,32,82,20,32,52
9,8482667,William Eklund,L,SJS,22,82,16,36,52
9,8477932,Aaron Ekblad,D,FLA,28,82,14,38,52
9,8477479,Tyler Bertuzzi,L,TOR,29,82,25,26,51
9,8474157,Max Pacioretty,L,WSH,36,82,22,29,51
9,8476462,Dougie Hamilton,D,NJD,31,82,18,33,51
9,8480064,Josh Norris,C,OTT,25,82,27,23,50
9,8482740,Wyatt Johnston,C,DAL,21,82,24,26,50
9,8479400,Pierre-Luc Dubois,L,LAK,26,82,19,31,50
9,8475191,Reilly Smith,R,PIT,33,82,19,31,50
9,8477447,Shea Theodore,D,VGK,29,82,10,40,50
9,8478038,Devon Toews,D,COL,30,82,6,44,50
9,8477426,Nicholas Paul,L,TBL,29,82,31,18,49
9,8474037,James van Riemsdyk,L,BOS,35,82,24,25,49
9,8478047,Michael Bunting,L,PIT,29,82,23,26,49
9,8478401,Pavel Zacha,C,BOS,27,82,21,28,49
9,8482745,Mason McTavish,C,ANA,21,82,21,28,49
9,8484144,Connor Bedard,C,CHI,19,82,21,28,49
9,8475763,Kevin Hayes,R,STL,32,82,21,28,49
9,8479339,Patrik Laine,L,CBJ,26,82,19,30,49
9,8475745,Charlie Coyle,C,BOS,32,82,18,31,49
9,8477416,Oliver Bjorkstrand,R,SEA,29,82,13,36,49
9,8475184,Chris Kreider,L,NYR,33,82,28,20,48
9,8482699,Dylan Guenther,R,ARI,21,82,27,21,48
9,8477456,J.T. Compher,L,DET,29,82,24,24,48
9,8478462,Nicolas Roy,C,VGK,27,82,20,28,48
9,8476881,Tomas Hertl,C,VGK,31,82,16,32,48
9,8476292,Ondrej Palat,L,NJD,33,82,15,33,48
9,8475168,Matt Duchene,C,DAL,33,82,14,34,48
9,8476875,Mike Matheson,D,MTL,30,82,12,36,48
9,8478407,Vince Dunn,D,SEA,28,82,11,37,48
9,8474563,Drew Doughty,D,LAK,35,82,11,37,48
9,8477346,MacKenzie Weegar,D,CGY,30,82,9,39,48
9,8473986,Alex Killorn,L,ANA,35,82,27,20,47
9,8477935,Sam Bennett,C,FLA,28,82,25,22,47
9,8478519,Anthony Cirelli,C,TBL,27,82,21,26,47
9,8478366,Frank Vatrano,R,ANA,30,82,21,26,47
9,8479365,Trent Frederic,C,BOS,26,82,19,28,47
9,8476905,Chandler Stephenson,C,VGK,30,82,18,29,47
9,8479987,Morgan Geekie,C,BOS,26,82,16,31,47
9,8474590,John Carlson,D,WSH,34,82,12,35,47
9,8474578,Erik Karlsson,D,PIT,34,82,12,35,47
9,8474565,Alex Pietrangelo,D,VGK,34,82,9,38,47
9,8482109,Alexis Lafrenière,L,NYR,23,82,23,23,46
9,8477444,Andre Burakovsky,L,SEA,29,82,18,28,46
9,8478474,Lawson Crouse,L,ARI,27,82,18,28,46
9,8480220,Noah Cates,L,PHI,25,82,17,29,46
9,8477964,Ivan Barbashev,C,VGK,29,82,17,29,46
9,8475169,Evander Kane,L,EDM,33,82,16,30,46
9,8478396,Noah Hanifin,D,VGK,27,82,11,35,46
9,8480798,Philipp Kurashev,C,CHI,25,82,10,36,46
9,8477503,Max Domi,C,TOR,29,82,9,37,46
9,8477495,Seth Jones,D,CHI,30,82,8,38,46
9,8483457,Lane Hutson,D,MTL,20,82,4,42,46
9,8483524,Shane Wright,C,SEA,20,82,30,15,45
9,8475314,Anders Lee,L,NYI,34,82,27,18,45
9,8482665,Matty Beniers,C,SEA,22,82,22,23,45
9,8482110,Dawson Mercer,C,NJD,23,82,21,24,45
9,8476448,William Karlsson,C,VGK,31,82,19,26,45
9,8481596,Shane Pinto,C,OTT,24,82,17,28,45
9,8480865,Noah Dobson,D,NYI,24,82,12,33,45
9,8482124,Quinton Byfield,R,LAK,22,82,22,22,44
9,8481560,Arthur Kaliyev,R,LAK,23,82,21,23,44
9,8481528,Dylan Cozens,C,BUF,23,82,20,24,44
9,8477947,Sonny Milano,L,WSH,28,82,19,25,44
9,8478498,Jake DeBrusk,L,BOS,28,82,19,25,44
9,8477451,Ryan Hartman,R,MIN,30,82,16,28,44
9,8477021,Alex Kerfoot,C,ARI,30,82,15,29,44
9,8479345,Jakob Chychrun,D,OTT,26,82,13,31,44
9,8482624,Daniil Miromanov,D,CGY,27,82,13,31,44
9,8482105,Jake Sanderson,D,OTT,22,82,12,32,44
9,8475197,Tyson Barrie,D,NSH,33,82,8,36,44
9,8478397,Rasmus Andersson,D,CGY,28,82,7,37,44
9,8475848,Brendan Gallagher,R,MTL,32,82,26,17,43
9,8475760,Nick Bjugstad,C,ARI,32,82,22,21,43
9,8479999,Casey Mittelstadt,C,COL,26,82,20,23,43
9,8474679,Gustav Nyquist,C,NSH,35,82,17,26,43
9,8480802,Ryan McLeod,C,EDM,25,82,16,27,43
9,8480028,Morgan Frost,C,PHI,25,82,14,29,43
9,8470613,Brent Burns,D,CAR,39,82,8,35,43
9,8480434,Sean Durzi,D,ARI,26,82,4,39,43
9,8476960,Andreas Athanasiou,C,CHI,30,82,31,11,42
9,8481604,Pavel Dorofeyev,L,VGK,24,82,28,14,42
9,8478233,Andrew Mangiapane,L,CGY,28,82,24,18,42
9,8478057,Dakota Joshua,C,VAN,28,82,20,22,42
9,8480893,Kirill Marchenko,R,CBJ,24,82,17,25,42
9,8477494,Jonathan Drouin,L,COL,29,82,15,27,42
9,8477497,Sean Monahan,C,WPG,30,82,15,27,42
9,8482113,Anton Lundell,C,FLA,23,82,13,29,42
9,8482146,Luke Evangelista,R,NSH,22,82,13,29,42
9,8478055,Gustav Forsling,D,FLA,28,82,12,30,42
9,8476329,Travis Boyd,C,ARI,31,82,12,30,42
9,8475753,Justin Faulk,D,STL,32,82,8,34,42
9,8482089,Jake Neighbours,L,STL,22,82,24,17,41
9,8476880,Tom Wilson,R,WSH,30,82,22,19,41
9,8475791,Taylor Hall,L,CHI,33,82,21,20,41
9,8480797,Joel Farabee,L,PHI,24,82,19,22,41
9,8480459,Pius Suter,C,VAN,28,82,19,22,41
9,8477476,Artturi Lehkonen,L,COL,29,82,17,24,41
9,8475218,Mattias Ekholm,D,EDM,34,82,12,29,41
9,8483515,Juraj Slafkovsky,L,MTL,20,82,12,29,41
9,8482101,Danil Gushchin,L,SJS,22,82,24,16,40
9,8480015,Owen Tippett,R,PHI,25,82,19,21,40
9,8476925,Colton Sissons,C,NSH,31,82,19,21,40
9,8478046,Danton Heinen,L,BOS,29,82,13,27,40
9,8475744,Evgeny Kuznetsov,C,CAR,32,82,13,27,40
9,8476906,Shayne Gostisbehere,D,DET,31,82,12,28,40
9,8482079,Marco Rossi,C,MIN,23,82,12,28,40
9,8475171,Oliver Ekman-Larsson,D,FLA,33,82,9,31,40
9,8481699,Aku Raty,R,ARI,23,82,6,34,40
9,8475906,John Klingberg,D,TOR,32,82,6,34,40
9,8475722,Jason Zucker,L,NSH,32,82,23,16,39
9,8481618,Alex Newhook,C,MTL,23,82,20,19,39
9,8476483,Rickard Rakell,R,PIT,31,82,19,20,39
9,8477425,Miles Wood,L,COL,29,82,17,22,39
9,8474586,Jordan Eberle,R,SEA,34,82,16,23,39
9,8478472,Mathieu Joseph,R,OTT,27,82,16,23,39
9,8473422,Nick Foligno,L,CHI,37,82,16,23,39
9,8475768,Jaden Schwartz,C,SEA,32,82,14,25,39
9,8477953,Kasperi Kapanen,R,STL,28,82,14,25,39
9,8474102,David Perron,L,DET,36,82,13,26,39
9,8476461,Sean Couturier,C,PHI,32,82,12,27,39
9,8478460,Zach Werenski,D,CBJ,27,82,11,28,39
9,8479410,Mikhail Sergachev,D,TBL,26,82,4,35,39
9,8480014,Gabriel Vilardi,C,WPG,25,82,24,14,38
9,8478458,Jack Roslovic,C,NYR,27,82,19,19,38
9,8478413,Jordan Greenway,L,BUF,27,82,15,23,38
9,8482475,Yegor Chinakhov,R,CBJ,23,82,14,24,38
9,8482092,Ridly Greig,C,OTT,22,82,13,25,38
9,8476419,Jean-Gabriel Pageau,C,NYI,32,82,11,27,38
9,8480043,Timothy Liljegren,D,TOR,25,82,9,29,38
9,8476958,Jaccob Slavin,D,CAR,30,82,9,29,38
9,8471724,Kris Letang,D,PIT,37,82,3,35,38
9,8477998,Warren Foegele,L,EDM,28,82,20,17,37
9,8476392,Adam Lowry,C,WPG,31,82,16,21,37
9,8481624,Ilya Mikheyev,R,VAN,30,82,15,22,37
9,8476826,Yanni Gourde,C,SEA,33,82,15,22,37
9,8475793,Ryan Johansen,C,PHI,32,82,11,26,37
9,8473449,Kyle Okposo,R,FLA,36,82,11,26,37
9,8480078,Filip Chytil,C,NYR,25,82,10,27,37
9,8476927,Teddy Blueger,C,VAN,30,82,9,28,37
9,8483445,Cutter Gauthier,L,ANA,20,82,6,31,37
9,8475799,Nino Niederreiter,R,WPG,32,82,18,18,36
9,8476897,Oskar Sundqvist,C,STL,30,82,16,20,36
9,8471698,T.J. Oshie,R,WSH,38,82,14,22,36
9,8477407,Anthony Duclair,L,TBL,29,82,13,23,36
9,8482705,Cole Sillinger,C,CBJ,21,82,12,24,36
9,8476892,Colton Parayko,D,STL,31,82,10,26,36
9,8482671,Owen Power,D,BUF,22,82,8,28,36
9,8479976,Juuso Valimaki,D,ARI,26,82,5,31,36
9,8483397,Marc McLaughlin,C,BOS,25,82,32,3,35
9,8474715,Cam Atkinson,R,PHI,35,82,22,13,35
9,8480849,Barrett Hayton,C,ARI,24,82,18,17,35
9,8482074,Connor Zary,C,CGY,23,82,18,17,35
9,8482175,JJ Peterka,R,BUF,22,82,15,20,35
9,8476869,Brady Skjei,D,CAR,30,82,14,21,35
9,8477952,Robby Fabbri,C,DET,28,82,13,22,35
9,8481013,Jonatan Berggren,R,DET,24,82,13,22,35
9,8482655,J.J. Moser,D,ARI,24,82,11,24,35
9,8477948,Travis Sanheim,D,PHI,28,82,7,28,35
9,8483471,Brad Lambert,C,WPG,31,82,7,28,35
9,8476792,Torey Krug,D,STL,33,82,6,29,35
9,8476923,Damon Severson,D,CBJ,30,82,5,30,35
9,8476331,Dylan DeMelo,D,WPG,31,82,4,31,35
9,8476921,Jordan Martinook,L,CAR,32,82,19,15,34
9,8482133,Thomas Bordeleau,C,SJS,22,82,13,21,34
9,8479992,Michael Rasmussen,C,DET,25,82,12,22,34
9,8480185,Eetu Luostarinen,C,FLA,26,82,12,22,34
9,8477839,Conor Sheary,L,TBL,32,82,12,22,34
9,8481580,Connor McMichael,C,WSH,23,82,10,24,34
9,8477429,Andrew Copp,C,DET,30,82,8,26,34
9,8480336,Sean Walker,D,COL,30,82,5,29,34
9,8476469,Joel Armia,R,MTL,31,82,23,10,33
9,8482737,Zack Bolduc,C,STL,21,82,19,14,33
9,8477498,Darnell Nurse,D,EDM,29,82,17,16,33
9,8474053,Logan Couture,C,SJS,35,82,16,17,33
9,8477511,Anthony Mantha,R,VGK,30,82,15,18,33
9,8476458,Ryan Strome,C,ANA,31,82,9,24,33
9,8474870,Tyler Johnson,C,CHI,34,82,7,26,33
9,8481581,Thomas Harley,D,DAL,23,82,6,27,33
9,8475764,Cam Fowler,D,ANA,33,82,5,28,33
9,8481016,Ruslan Iskhakov,C,NYI,24,82,3,30,33
9,8482702,Logan Stankoven,C,DAL,21,82,22,10,32
9,8476438,Brandon Saad,L,STL,32,82,17,15,32
9,8482259,Bobby McMann,C,TOR,28,82,17,15,32
9,8480821,Filip Zadina,R,SJS,25,82,16,16,32
9,8479383,Boris Katchouk,L,OTT,26,82,15,17,32
9,8480813,Joe Veleno,C,DET,24,82,14,18,32
9,8482222,Alexander Barabanov,L,SJS,30,82,12,20,32
9,8476872,Scott Laughton,C,PHI,30,82,10,22,32
9,8483490,Pavel Mintyukov,D,ANA,21,82,10,22,32
9,8478542,Evan Rodrigues,C,FLA,31,82,9,23,32
9,8475343,Nic Dowd,C,WSH,34,82,9,23,32
9,8471218,Blake Wheeler,R,NYR,38,82,8,24,32
9,8476463,Jonas Brodin,D,MIN,31,82,7,25,32
9,8477969,Marcus Pettersson,D,PIT,28,82,6,26,32
9,8478840,Will Borgen,D,SEA,28,82,1,31,32
9,8482118,Sam Colangelo,R,ANA,23,82,25,6,31
9,8479423,Alex Nylander,L,CBJ,26,82,21,10,31
9,8470621,Corey Perry,R,EDM,39,82,17,14,31
9,8481554,Kaapo Kakko,R,NYR,23,82,16,15,31
9,8476871,Tanner Pearson,L,MTL,32,82,16,15,31
9,8478043,Sam Lafferty,C,VAN,29,82,15,16,31
9,8478115,Pierre Engvall,L,NYI,28,82,14,17,31
9,8473563,Nicklas Backstrom,C,WSH,37,82,10,21,31
9,8475149,Marcus Johansson,L,MIN,34,82,10,21,31
9,8481542,Moritz Seider,D,DET,23,82,6,25,31
9,8474716,Jared Spurgeon,D,MIN,35,82,5,26,31
9,8478178,Darren Raddysh,D,TBL,28,82,5,26,31
9,8475714,Calle Jarnkrok,C,TOR,33,82,18,12,30
9,8476480,Vladislav Namestnikov,C,WPG,32,82,16,14,30
9,8481535,Nils Hoglander,L,VAN,24,82,13,17,30
9,8478891,Mason Appleton,C,WPG,28,82,12,18,30
9,8478463,Anthony Beauvillier,L,NSH,27,82,11,19,30
9,8476917,Adam Pelech,D,NYI,30,82,6,24,30
9,8478507,John Marino,D,NJD,27,82,3,27,30
9,8479941,Justin Danforth,R,CBJ,31,82,19,10,29
9,8479415,Michael McLeod,C,NJD,26,82,14,15,29
9,8478466,Daniel Sprong,R,DET,27,82,14,15,29
9,8480068,Ryan Poehling,C,PHI,25,82,12,17,29
9,8479661,Tanner Jeannot,L,TBL,27,82,11,18,29
9,8476979,Erik Gustafsson,D,NYR,32,82,8,21,29
9,8477506,Ryan Pulock,D,NYI,30,82,2,27,29
9,8474884,Mike Hoffman,C,SJS,35,82,15,13,28
9,8479591,Michael Eyssimont,C,TBL,28,82,13,15,28
9,8481704,Juuso Parssinen,C,NSH,23,82,13,15,28
9,8481656,Aliaksei Protas,C,WSH,23,82,10,18,28
9,8479351,Sam Steel,C,DAL,26,82,7,21,28
9,8473507,Jeff Petry,D,DET,37,82,7,21,28
9,8478911,Matt Roy,D,LAK,29,82,5,23,28
9,8477944,Jakub Vrana,L,STL,28,82,16,11,27
9,8477989,Christian Dvorak,C,MTL,28,82,15,12,27
9,8480855,Jack McBain,C,ARI,24,82,14,13,27
9,8479346,Dillon Dube,C,CGY,26,82,14,13,27
9,8480113,Alex Iafallo,L,WPG,31,82,13,14,27
9,8478020,Michael Amadio,C,VGK,28,82,12,15,27
9,8475220,Marcus Foligno,L,MIN,33,82,11,16,27
9,8475231,Casey Cizikas,C,NYI,33,82,9,18,27
9,8480871,Adam Boqvist,D,CBJ,24,82,7,20,27
9,8475233,David Savard,D,MTL,34,82,7,20,27
9,8481606,Jordan Spence,D,LAK,23,82,5,22,27
9,8476879,Cody Ceci,D,EDM,31,82,5,22,27
9,8482733,Logan Mailloux,D,MTL,31,82,4,23,27
9,8481568,Alex Vlasic,D,CHI,23,82,4,23,27
9,8483431,Logan Cooley,C,ARI,20,82,16,10,26
9,8477919,Frederick Gaudreau,C,MIN,31,82,14,12,26
9,8484153,Leo Carlsson,C,ANA,20,82,13,13,26
9,8476873,Mark Jankowski,C,NSH,30,82,13,13,26
9,8479390,Taylor Raddysh,R,CHI,26,82,11,15,26
9,8481517,Brett Leason,R,ANA,25,82,11,15,26
9,8482062,Cole Smith,L,NSH,29,82,11,15,26
9,8482087,Kaiden Guhle,D,MTL,22,82,9,17,26
9,8479514,Rem Pitlick,C,CHI,27,82,9,17,26
9,8482142,Jamie Drysdale,D,PHI,22,82,8,18,26
9,8475200,Dmitry Orlov,D,CAR,33,82,8,18,26
9,8476854,Hampus Lindholm,D,BOS,30,82,6,20,26
9,8479398,Samuel Girard,D,COL,26,82,6,20,26
9,8480073,Erik Brannstrom,D,OTT,25,82,6,20,26
9,8482122,Brock Faber,D,MIN,22,82,5,21,26
9,8481546,Cam York,D,PHI,23,82,5,21,26
9,8474151,Ryan McDonagh,D,NSH,35,82,5,21,26
9,8484203,Bradly Nadeau,L,CAR,19,82,20,5,25
9,8484166,Adam Fantilli,C,CBJ,20,82,18,7,25
9,8481477,Nico Sturm,C,SJS,29,82,16,9,25
9,8482055,Drew O'Connor,L,PIT,26,82,14,11,25
9,8481601,Simon Holmstrom,R,NYI,23,82,14,11,25
9,8473504,Cal Clutterbuck,R,NYI,37,82,14,11,25
9,8479525,Ross Colton,C,COL,28,82,13,12,25
9,8483499,Liam Ohgren,L,MIN,20,82,12,13,25
9,8476278,Colin Blackwell,C,CHI,31,82,11,14,25
9,8479353,Brett Howden,C,VGK,26,82,10,15,25
9,8477450,Jason Dickinson,C,CHI,29,82,10,15,25
9,8473533,Jordan Staal,C,CAR,36,82,10,15,25
9,8482730,Brandt Clarke,D,LAK,21,82,10,15,25
9,8482720,Matthew Knies,L,TOR,22,82,9,16,25
9,8479316,Luke Kunin,C,SJS,27,82,9,16,25
9,8477507,Nikita Zadorov,D,VAN,29,82,9,16,25
9,8481186,Logan O'Connor,R,COL,28,82,8,17,25
9,8482117,Lukas Reichel,L,CHI,22,82,7,18,25
9,8481481,Blake Lizotte,C,LAK,27,82,6,19,25
9,8479369,Andrew Peeke,D,BOS,26,82,6,19,25
9,8477488,Brett Pesce,D,CAR,30,82,5,20,25
9,8481178,Egor Zamula,D,PHI,24,82,3,22,25
9,8476891,Matt Grzelcyk,D,BOS,30,82,1,24,25
9,8480074,Alexandre Texier,C,CBJ,25,82,17,7,24
9,8479293,Brandon Tanev,L,SEA,33,82,15,9,24
9,8480144,David Kampf,C,TOR,29,82,11,13,24
9,8470610,Zach Parise,L,COL,40,82,11,13,24
9,8482125,Alexander Holtz,R,NJD,22,82,8,16,24
9,8479977,Kailer Yamamoto,R,SEA,26,82,8,16,24
9,8474149,Evgenii Dadonov,R,DAL,35,82,7,17,24
9,8477015,Connor Brown,R,EDM,30,82,7,17,24
9,8478831,Kevin Stenlund,C,FLA,28,82,7,17,24
9,8480873,Rasmus Sandin,D,WSH,24,82,6,18,24
9,8480807,Mattias Samuelsson,D,BUF,24,82,6,18,24
9,8474673,TJ Brodie,D,TOR,34,82,5,19,24
9,8475188,Brayden McNabb,D,VGK,33,82,3,21,24
9,8482155,Alex Laferriere,R,LAK,23,82,15,8,23
9,8478508,Yakov Trenin,C,COL,27,82,15,8,23
9,8470604,Jeff Carter,C,PIT,39,82,12,11,23
9,8481028,Martin Pospisil,C,CGY,25,82,9,14,23
9,8477369,Carson Soucy,D,VAN,30,82,8,15,23
9,8483565,Nick Blankenburg,D,CBJ,26,82,7,16,23
9,8476885,Jacob Trouba,D,NYR,30,82,6,17,23
9,8476372,Nick Seeler,D,PHI,31,82,6,17,23
9,8480145,Neal Pionk,D,WPG,29,82,5,18,23
9,8475690,Chris Tanev,D,DAL,35,82,5,18,23
9,8476312,Josh Manson,D,COL,33,82,4,19,23
9,8475181,Nick Leddy,D,STL,33,82,4,19,23
9,8476422,Mike Reilly,D,NYI,31,82,3,20,23
9,8480860,Kevin Bahl,D,NJD,24,82,1,22,23
9,8476981,Josh Anderson,R,MTL,30,82,11,11,22
9,8483491,Ivan Miroshnichenko,L,WSH,20,82,11,11,22
9,8480806,Isac Lundestrom,C,ANA,25,82,9,13,22
9,8478500,Ivan Provorov,D,CBJ,27,82,8,14,22
9,8479359,Beck Malenstyn,L,WSH,26,82,8,14,22
9,8481703,Valtteri Puustinen,R,PIT,25,82,5,17,22
9,8476902,Esa Lindell,D,DAL,30,82,5,17,22
9,8481059,Scott Perunovich,D,STL,26,82,5,17,22
9,8479980,Nicolas Hague,D,VGK,26,82,5,17,22
9,8476467,Jamie Oleksiak,D,SEA,32,82,5,17,22
9,8481567,Henry Thrun,D,SJS,23,82,4,18,22
9,8479998,Mikey Anderson,D,LAK,25,82,4,18,22
9,8484911,Collin Graf,R,SJS,22,82,4,18,22
9,8476931,Jake McCabe,D,TOR,31,82,4,18,22
9,8474567,Zach Bogosian,D,MIN,34,82,4,18,22
9,8482762,Simon Edvinsson,D,DET,21,82,11,10,21
9,8480281,Alexey Toropchenko,R,STL,25,82,11,10,21
9,8479996,Cody Glass,C,NSH,25,82,10,11,21
9,8480817,K'Andre Miller,D,NYR,24,82,8,13,21
9,8484145,Zach Benson,L,BUF,19,82,8,13,21
9,8481522,Peyton Krebs,C,BUF,23,82,8,13,21
9,8475279,Ben Chiarot,D,DET,33,82,8,13,21
9,8478882,Vladislav Gavrikov,D,LAK,29,82,7,14,21
9,8470966,Mark Giordano,D,TOR,41,82,7,14,21
9,8478430,Oliver Kylington,D,CGY,27,82,7,14,21
9,8481553,Bobby Brink,R,PHI,23,82,5,16,21
9,8476967,Brett Kulak,D,EDM,30,82,5,16,21
9,8479324,Ryan Lindgren,D,NYR,26,82,5,16,21
9,8482111,Justin Barron,D,MTL,23,82,4,17,21
9,8480796,Martin Fehervary,D,WSH,25,82,4,17,21
9,8474574,Tyler Myers,D,VAN,34,82,4,17,21
9,8482516,Matthew Kessel,D,STL,24,82,4,17,21
9,8470600,Ryan Suter,D,DAL,39,82,4,17,21
9,8478399,Jonas Siegenthaler,D,NJD,27,82,3,18,21
9,8479393,Noah Gregor,C,TOR,26,82,13,7,20
9,8478109,Victor Olofsson,L,BUF,29,82,9,11,20
9,8478013,Jake Walman,D,DET,28,82,9,11,20
9,8482679,Matt Coronato,R,CGY,22,82,8,12,20
9,8477508,Curtis Lazar,C,NJD,29,82,8,12,20
9,8480448,Parker Kelly,L,OTT,25,82,8,12,20
9,8477220,Nate Schmidt,D,WPG,33,82,7,13,20
9,8475462,Radko Gudas,D,ANA,34,82,7,13,20
9,8478133,Jake Evans,C,MTL,28,82,6,14,20
9,8483505,Matthew Poitras,C,BOS,20,82,6,14,20
9,8477353,Tyler Motte,C,TBL,29,82,5,15,20
9,8480246,Nick Perbix,D,TBL,26,82,5,15,20
9,8481014,Alexander Romanov,D,NYI,24,82,5,15,20
9,8475179,Dmitry Kulikov,D,FLA,34,82,4,16,20
9,8482803,Olen Zellweger,D,ANA,21,82,4,16,20
9,8476457,Adam Larsson,D,SEA,32,82,0,20,20
9,8473453,Trevor Lewis,C,LAK,37,82,13,6,19
9,8482809,Jackson Blake,R,CAR,21,82,13,6,19
9,8477392,Hudson Fasching,R,NYI,29,82,9,10,19
9,8476858,Phillip Di Giuseppe,L,VAN,31,82,8,11,19
9,8474189,Lars Eller,C,PIT,35,82,7,12,19
9,8477365,Connor Clifton,D,BUF,29,82,7,12,19
9,8476624,Barclay Goodrow,C,NYR,31,82,7,12,19
9,8478451,Ethan Bear,D,WSH,27,82,5,14,19
9,8474034,Pat Maroon,L,BOS,36,82,5,14,19
9,8478859,Niko Mikkola,D,FLA,28,82,3,16,19
9,8476878,Zemgus Girgensons,L,BUF,30,82,12,6,18
9,8475164,Jakob Silfverberg,R,ANA,34,82,7,11,18
9,8482073,Braden Schneider,D,NYR,23,82,6,12,18
9,8479371,Dante Fabbro,D,NSH,26,82,5,13,18
9,8482245,Artem Zub,D,OTT,29,82,5,13,18
9,8480172,Jan Rutta,D,SJS,34,82,3,15,18
9,8474013,Ian Cole,D,VAN,35,82,3,15,18
9,8483493,Frank Nazar,C,CHI,20,82,11,6,17
9,8477406,Mattias Janmark,C,EDM,32,82,7,10,17
9,8479291,Kevin Rooney,C,CGY,31,82,6,11,17
9,8481537,Nikita Okhotiuk,D,CGY,24,82,6,11,17
9,8480058,Pierre-Olivier Joseph,D,PIT,25,82,6,11,17
9,8483482,Tristan Luneau,D,ANA,20,82,5,12,17
9,8482166,Shakir Mukhamadullin,D,SJS,22,82,4,13,17
9,8478569,Noel Acciari,C,PIT,33,82,4,13,17
9,8481524,Bowen Byram,D,BUF,23,82,3,14,17
9,8475177,Calvin de Haan,D,TBL,33,82,3,14,17
9,8477931,Tomas Nosek,L,NJD,32,82,6,10,16
9,8483495,Simon Nemec,D,NJD,20,82,5,11,16
9,8477499,Rasmus Ristolainen,D,PHI,30,82,5,11,16
9,8482177,Marat Khusnutdinov,C,MIN,22,82,5,11,16
9,8478443,Brandon Carlo,D,BOS,28,82,4,12,16
9,8478136,Jake Middleton,D,MIN,28,82,4,12,16
9,8478851,Alexandre Carrier,D,NSH,28,82,3,13,16
9,8477845,Trevor van Riemsdyk,D,WSH,33,82,3,13,16
9,8482712,Oskar Olausson,R,COL,22,82,3,13,16
9,8482470,Ilya Solovyov,D,CGY,24,82,3,13,16
9,8477435,Ryan Graves,D,PIT,29,82,2,14,16
9,8475790,Erik Gudbranson,D,CBJ,32,82,1,15,16
9,8477330,Dominik Kubalik,L,OTT,29,82,10,5,15
9,8482145,Mavrik Bourque,C,DAL,22,82,10,5,15
9,8481578,Graeme Clarke,R,NJD,23,82,7,8,15
9,8481599,Victor Soderstrom,D,ARI,23,82,7,8,15
9,8476374,Sean Kuraly,C,CBJ,31,82,3,12,15
9,8475324,Nick Jensen,D,WSH,34,82,3,12,15
9,8476525,Colin Miller,D,WPG,32,82,3,12,15
9,8477335,Kyle Burroughs,D,SJS,29,82,3,12,15
9,8480834,Ty Emberson,D,SJS,24,82,2,13,15
9,8475842,Sam Carrick,C,EDM,32,82,8,6,14
9,8482666,Scott Morrow,D,CAR,22,82,8,6,14
9,8476442,Matt Nieto,L,PIT,32,82,8,6,14
9,8480035,Henri Jokiharju,D,BUF,25,82,6,8,14
9,8479983,Mario Ferraro,D,SJS,26,82,4,10,14
9,8483466,Kevin Korchinski,D,CHI,20,82,4,10,14
9,8479442,Troy Stecher,D,EDM,30,82,3,11,14
9,8475208,Brian Dumoulin,D,SEA,33,82,3,11,14
9,8476429,Scott Mayfield,D,NYI,32,82,2,12,14
9,8483012,Logan Morrison,C,SEA,22,82,8,5,13
9,8480980,Connor Dewar,C,TOR,25,82,6,7,13
9,8474009,Nick Bonino,C,NYR,36,82,6,7,13
9,8477505,Alexander Wennberg,C,NYR,30,82,4,9,13
9,8475455,Brenden Dillon,D,WPG,34,82,4,9,13
9,8483763,Maksymilian Szuber,D,ARI,22,82,3,10,13
9,8476473,Connor Murphy,D,CHI,31,82,3,10,13
9,8481605,Jackson LaCombe,D,ANA,23,82,2,11,13
9,8481093,Rafael Harvey-Pinard,L,MTL,25,82,10,2,12
9,8476822,Luke Glendening,C,TBL,35,82,6,6,12
9,8478408,Travis Dermott,D,ARI,28,82,4,8,12
9,8483489,Fraser Minten,C,TOR,31,82,5,6,11
9,8482807,Ethan Del Mastro,D,CHI,21,82,4,7,11
9,8475762,Derek Forbort,D,BOS,32,82,2,9,11
9,8477034,Jaycob Megna,D,CHI,32,82,2,8,10
9,8471677,Jack Johnson,D,COL,37,82,1,9,10
9,8474166,Alec Martinez,D,VGK,37,82,3,6,9
9,8480990,Declan Chisholm,D,MIN,24,82,3,6,9
9,8475825,Jani Hakanpää,D,DAL,32,82,2,7,9
9,8478416,Erik Cernak,D,TBL,27,82,0,9,9
9,8476915,Jujhar Khaira,L,MIN,30,82,6,2,8
9,8480879,Jacob Bernard-Docker,D,OTT,24,82,2,6,8
9,8478468,Jeremy Lauzon,D,NSH,27,82,2,5,7
9,8483468,Jiri Kulich,C,BUF,20,82,2,5,7
9,8482858,Ryker Evans,D,SEA,23,82,1,6,7
9,8481030,Jack St. Ivany,D,PIT,25,82,1,5,6
9,8482859,Zack Ostapchuk,C,OTT,21,82,1,4,5
9,8484149,Gavin Brindley,C,CBJ,20,82,1,2,3
9,8482713,Mackie Samoskevich,R,FLA,22,82,1,1,2
9,8482141,Lukas Cormier,D,VGK,22,0,0,0,0
9,8476988,Matt Benning,D,SJS,30,0,0,0,0
9,8480727,Zach Whitecloud,D,VGK,28,0,0,0,0
9,8480887,Jordan Harris,D,MTL,24,0,0,0,0
9,8478450,Parker Wotherspoon,D,BOS,27,0,0,0,0
9,8481812,Nikolai Knyzhov,D,SJS,27,0,0,0,0
9,8480001,Urho Vaakanainen,D,ANA,25,0,0,0,0
9,8482176,Wyatt Kaiser,D,CHI,22,0,0,0,0
9,8481122,Simon Benoit,D,TOR,26,0,0,0,0
9,8476441,Joel Edmundson,D,TOR,31,0,0,0,0
9,8480884,Calen Addison,D,SJS,24,0,0,0,0
9,8482511,Mason Lohrei,D,BOS,23,0,0,0,0
9,8482192,Isaak Phillips,D,CHI,23,0,0,0,0
9,8480950,Ilya Lyubushkin,D,TOR,30,0,0,0,0
9,8474031,Kevin Shattenkirk,D,BOS,35,0,0,0,0
9,8475718,Justin Holl,D,DET,32,0,0,0,0
9,8479402,Jake Bean,D,CBJ,26,0,0,0,0
9,8474602,Justin Schultz,D,SEA,34,0,0,0,0
9,8477950,Tony DeAngelo,D,CAR,29,0,0,0,0
9,8481743,Marc Del Gaizo,D,NSH,25,0,0,0,0
9,8481527,Kaedan Korczak,D,VGK,23,0,0,0,0
9,8480192,Johnathan Kovacevic,D,MTL,27,0,0,0,0
9,8476874,Olli Maatta,D,DET,30,0,0,0,0
9,8482144,Jack Thompson,D,SJS,22,0,0,0,0
9,8480222,Sebastian Aho,D,NYI,28,0,0,0,0
9,8479458,Nikita Zaitsev,D,CHI,33,0,0,0,0
9,8471709,Marc-Edouard Vlasic,D,SJS,37,0,0,0,0
9,8482929,Emil Lilleberg,D,TBL,23,0,0,0,0
9,8477018,Ben Hutton,D,VGK,31,0,0,0,0
9,8481056,Spencer Stastney,D,NSH,24,0,0,0,0
9,8481593,Jayden Struble,D,MTL,23,0,0,0,0
9,8479982,Conor Timmins,D,TOR,26,0,0,0,0
9,8474090,Brendan Smith,D,NJD,35,0,0,0,0
9,8482964,Arber Xhekaj,D,MTL,23,0,0,0,0
9,8480891,Michael Kesselring,D,ARI,24,0,0,0,0
9,8477938,Haydn Fleury,D,TBL,28,0,0,0,0
9,8481806,Louis Crevier,D,CHI,23,0,0,0,0
9,8471274,Alex Goligoski,D,MIN,39,0,0,0,0
9,8481600,Tobias Bjornfot,D,FLA,23,0,0,0,0
9,8475797,Jarred Tinordi,D,CHI,32,0,0,0,0
9,8481521,Ronnie Attard,D,PHI,25,0,0,0,0
9,8474612,Travis Hamonic,D,OTT,34,0,0,0,0
9,8479576,Vincent Desharnais,D,EDM,28,0,0,0,0
9,8480049,Dylan Samberg,D,WPG,25,0,0,0,0
9,8483619,Filip Roos,D,CHI,25,0,0,0,0
9,8474568,Luke Schenn,D,NSH,35,0,0,0,0
9,8480184,Gustav Lindstrom,D,ANA,26,0,0,0,0
9,8480070,Ian Mitchell,D,BOS,25,0,0,0,0
9,8480196,Jacob Bryson,D,BUF,27,0,0,0,0
9,8471686,Marc Staal,D,PHI,37,0,0,0,0
9,8477467,Gustav Olofsson,D,SEA,30,0,0,0,0
9,8478970,Jalen Chatfield,D,CAR,28,0,0,0,0
9,8479348,Kale Clague,D,BUF,26,0,0,0,0
9,8473446,Erik Johnson,D,PHI,36,0,0,0,0
9,8477462,Robert Hagg,D,ANA,29,0,0,0,0
9,8478454,Noah Juulsen,D,VAN,27,0,0,0,0
9,8477384,Josh Brown,D,ARI,30,0,0,0,0
9,8481708,Zac Jones,D,NYR,24,0,0,0,0
9,8481167,Brayden Pachal,D,CGY,25,0,0,0,0
9,8482067,Connor Mackey,D,NYR,28,0,0,0,0
9,8483460,David Jiricek,D,CBJ,21,0,0,0,0
9,8481701,Santeri Hatakka,D,NJD,23,0,0,0,0
9,8478021,William Lagesson,D,ANA,28,0,0,0,0
9,8477851,Jordan Oesterle,D,CGY,32,0,0,0,0
9,8478452,Caleb Jones,D,COL,27,0,0,0,0
9,8479984,Cal Foote,D,NJD,26,0,0,0,0
9,8479639,Dylan Coghlan,D,CAR,26,0,0,0,0
9,8480874,Adam Ginning,D,PHI,24,0,0,0,0
9,8479321,Lucas Johansen,D,WSH,27,0,0,0,0
9,8480878,Nils Lundkvist,D,DAL,24,0,0,0,0
9,8482165,Yan Kuznetsov,D,CGY,22,0,0,0,0
9,8484258,Sam Malinski,D,COL,26,0,0,0,0
9,8480157,Calle Rosen,D,STL,30,0,0,0,0
9,8484304,Uvis Balinskis,D,FLA,28,0,0,0,0
9,8479985,Cale Fleury,D,SEA,26,0,0,0,0
9,8479378,Logan Stanley,D,WPG,26,0,0,0,0
9,8477541,Dakota Mermis,D,MIN,30,0,0,0,0
9,8481609,Vladislav Kolyachonok,D,ARI,23,0,0,0,0
9,8480823,Alexander Alexeyev,D,WSH,25,0,0,0,0
9,8481679,Maxence Guenette,D,OTT,23,0,0,0,0
9,8481564,Ryan Johnson,D,BUF,23,0,0,0,0
9,8479376,Victor Mete,D,PHI,26,0,0,0,0
9,8484254,Akito Hirose,D,VAN,25,0,0,0,0
9,8482660,Kent Johnson,C,CBJ,22,0,0,0,0
9,8482149,Cole Perfetti,C,WPG,22,0,0,0,0
9,8477987,Ryan Donato,C,CHI,28,0,0,0,0
9,8475755,Alexander Petrovic,D,DAL,32,0,0,0,0
9,8477810,Joel Hanley,D,CGY,33,0,0,0,0
9,8474145,Robert Bortuzzo,D,NYI,35,0,0,0,0
9,8481161,Jake Christiansen,D,CBJ,25,0,0,0,0
9,8476884,Derrick Pouliot,D,DAL,30,0,0,0,0
9,8481716,Dmitri Voronkov,L,CBJ,24,0,0,0,0
9,8480084,Nick DeSimone,D,NJD,30,0,0,0,0
9,8475750,Jon Merrill,D,MIN,32,0,0,0,0
9,8479315,Joey Anderson,R,CHI,26,0,0,0,0
9,8478011,Louie Belpedio,D,PHI,28,0,0,0,0
9,8482451,Mikael Pyyhtia,L,CBJ,23,0,0,0,0
9,8481541,Samuel Bolduc,D,NYI,24,0,0,0,0
9,8482126,Emil Andrae,D,PHI,31,0,0,0,0
9,8474618,Marco Scandella,D,STL,34,0,0,0,0
9,8477244,Chad Ruhwedel,D,NYR,34,0,0,0,0
9,8477971,Andreas Englund,D,LAK,28,0,0,0,0
9,8480829,Jesperi Kotkaniemi,C,CAR,24,0,0,0,0
9,8479372,Josh Mahura,D,FLA,26,0,0,0,0
9,8482095,Tyler Kleven,D,OTT,22,0,0,0,0
9,8481719,Maxwell Crozier,D,TBL,24,0,0,0,0
9,8475855,Jesper Fast,R,CAR,33,0,0,0,0
9,8480848,Ty Dellandrea,C,DAL,24,0,0,0,0
9,8475193,Tomas Tatar,L,SEA,34,0,0,0,0
9,8476889,Radek Faksa,C,DAL,30,0,0,0,0
9,8478495,Denis Gurianov,R,PHI,27,0,0,0,0
9,8480216,Jacob Peterson,C,SJS,25,0,0,0,0
9,8480252,Cole Guttman,C,CHI,25,0,0,0,0
9,8479026,Philippe Myers,D,TBL,27,0,0,0,0
9,8481006,Tyler Tucker,D,STL,24,0,0,0,0
9,8481032,Paul Cotter,C,VGK,25,0,0,0,0
9,8481577,Philip Tomasino,C,NSH,23,0,0,0,0
9,8476918,Jimmy Vesey,L,NYR,31,0,0,0,0
9,8479320,Max Lajoie,D,TOR,27,0,0,0,0
9,8478017,Mark Friedman,D,VAN,29,0,0,0,0
9,8481754,Nikita Nesterenko,C,ANA,23,0,0,0,0
9,8483407,Brandon Scanlin,D,NYR,25,0,0,0,0
9,8482659,Josh Doan,R,ARI,22,0,0,0,0
9,8477446,Michael McCarron,R,NSH,29,0,0,0,0
9,8477903,Garnet Hathaway,R,PHI,33,0,0,0,0
9,8482153,Brendan Brisson,C,VGK,23,0,0,0,0
9,8483546,Marshall Rifai,D,TOR,26,0,0,0,0
9,8484287,Cole McWard,D,VAN,23,0,0,0,0
9,8478854,Ryan Shea,D,PIT,27,0,0,0,0
9,8481585,Egor Afanasyev,L,NSH,23,0,0,0,0
9,8483398,Declan Carlile,D,TBL,31,0,0,0,0
9,8478502,Dennis Gilbert,D,CGY,28,0,0,0,0
9,8482749,Joshua Roy,R,MTL,21,0,0,0,0
9,8481598,Philip Broberg,D,EDM,23,0,0,0,0
9,8480835,Jack Drury,C,CAR,24,0,0,0,0
9,8480748,Kiefer Sherwood,L,NSH,29,0,0,0,0
9,8476934,Brock McGinn,L,ANA,30,0,0,0,0
9,8480870,Bo Groulx,C,ANA,24,0,0,0,0
9,8479368,Max Jones,L,ANA,26,0,0,0,0
9,8478099,Kevin Labanc,R,SJS,29,0,0,0,0
9,8478067,Oskar Lindblom,L,SJS,28,0,0,0,0
9,8476393,Nick Cousins,C,FLA,31,0,0,0,0
9,8483395,Arshdeep Bains,L,VAN,23,0,0,0,0
9,8480762,Eric Robinson,L,BUF,29,0,0,0,0
9,8479439,Jacob MacDonald,D,SJS,31,0,0,0,0
9,8476474,Stefan Noesen,R,CAR,31,0,0,0,0
9,8482787,Nikita Chibrikov,R,WPG,31,0,0,0,0
9,8478432,Christian Fischer,R,DET,27,0,0,0,0
9,8477979,Nicolas Aube-Kubel,R,WSH,28,0,0,0,0
9,8481789,Tye Kartye,L,SEA,23,0,0,0,0
9,8479330,Brandon Gignac,C,MTL,27,0,0,0,0
9,8480075,Cameron Crotty,D,ARI,25,0,0,0,0
9,8473473,Milan Lucic,L,BOS,36,0,0,0,0
9,8482094,Daemon Hunt,D,MIN,22,0,0,0,0
9,8481206,John Ludvig,D,PIT,24,0,0,0,0
9,8483630,Pavol Regenda,L,ANA,25,0,0,0,0
9,8481617,Vasily Podkolzin,R,VAN,23,0,0,0,0
9,8480306,Grant Hutton,D,NYI,29,0,0,0,0
9,8480995,Pontus Holmberg,R,TOR,25,0,0,0,0
9,8482148,Hendrix Lapierre,C,WSH,22,0,0,0,0
9,8477478,William Carrier,L,VGK,30,0,0,0,0
9,8480003,Jesper Boqvist,C,BOS,26,0,0,0,0
9,8482172,Landon Slaggert,L,CHI,22,0,0,0,0
9,8480789,Oliver Wahlstrom,R,NYI,24,0,0,0,0
9,8474062,Riley Nash,C,NYR,35,0,0,0,0
9,8480021,Jack Studnicka,C,SJS,25,0,0,0,0
9,8480025,MacKenzie Entwistle,R,CHI,25,0,0,0,0
9,8481582,Nicholas Robertson,L,TOR,23,0,0,0,0
9,8476867,Brendan Gaunce,C,CBJ,30,0,0,0,0
9,8479619,Michael Carcone,L,ARI,28,0,0,0,0
9,8479370,Tyson Jost,C,BUF,26,0,0,0,0
9,8479671,Mathieu Olivier,R,CBJ,27,0,0,0,0
9,8476994,Vinnie Hinostroza,C,PIT,30,0,0,0,0
9,8482070,Mitchell Chaffee,R,TBL,26,0,0,0,0
9,8477473,Justin Bailey,R,SJS,29,0,0,0,0
9,8479344,Jesse Puljujarvi,R,PIT,26,0,0,0,0
9,8480205,Emil Bemstrom,C,PIT,25,0,0,0,0
9,8479718,Alex Barré-Boulet,C,TBL,27,0,0,0,0
9,8482061,Brandon Biro,L,BUF,26,0,0,0,0
9,8479638,Justin Brazeau,R,BOS,26,0,0,0,0
9,8474040,Sam Gagner,C,EDM,35,0,0,0,0
9,8477846,Ryan Carpenter,C,SJS,33,0,0,0,0
9,8482077,Dylan Holloway,L,EDM,23,0,0,0,0
9,8482157,Will Cuylle,L,NYR,22,0,0,0,0
9,8480007,Jonas Rondbjerg,R,VGK,25,0,0,0,0
9,8478874,Adam Gaudette,C,STL,28,0,0,0,0
9,8478434,Keegan Kolesar,R,VGK,27,0,0,0,0
9,8480441,Trey Fix-Wolansky,R,CBJ,25,0,0,0,0
9,8479994,Jaret Anderson-Dolan,C,NSH,25,0,0,0,0
9,8483567,Georgii Merkulov,C,BOS,24,0,0,0,0
9,8477380,Jonny Brodzinski,C,NYR,31,0,0,0,0
9,8482201,Gage Goncalves,C,TBL,23,0,0,0,0
9,8478211,Dryden Hunt,L,CGY,29,0,0,0,0
9,8471699,Andrew Cogliano,C,COL,37,0,0,0,0
9,8479421,Jacob Moverare,D,LAK,26,0,0,0,0
9,8478881,Brett Seney,L,CHI,28,0,0,0,0
9,8477464,Nic Petan,C,MIN,29,0,0,0,0
9,8475958,Michael Sgarbossa,C,WSH,32,0,0,0,0
9,8481147,Reese Johnson,C,CHI,26,0,0,0,0
9,8479336,Carl Grundstrom,R,LAK,27,0,0,0,0
9,8480853,Liam Foudy,C,NSH,24,0,0,0,0
9,8479522,Hardy Haman Aktell,D,WSH,26,0,0,0,0
9,8481462,Mason Morelli,L,VGK,28,0,0,0,0
9,8482102,Vasily Ponomarev,C,CAR,22,0,0,0,0
9,8480844,Grigori Denisenko,L,VGK,24,0,0,0,0
9,8479944,Zach Aston-Reese,C,DET,30,0,0,0,0
9,8482784,Zach Dean,C,STL,21,0,0,0,0
9,8479419,Brett Murray,L,BUF,26,0,0,0,0
9,8479520,Brandon Duhaime,R,COL,27,0,0,0,0
9,8477573,Nathan Walker,L,STL,30,0,0,0,0
9,8478078,Rourke Chartier,C,OTT,28,0,0,0,0
9,8475795,Dylan McIlrath,D,WSH,32,0,0,0,0
9,8482496,Nils Aman,C,VAN,24,0,0,0,0
9,8480289,Morgan Barron,C,WPG,26,0,0,0,0
9,8481751,Lukas Rousek,R,BUF,25,0,0,0,0
9,8480011,Klim Kostin,C,SJS,25,0,0,0,0
9,8481556,John Beecher,C,BOS,23,0,0,0,0
9,8475278,Byron Froese,C,VGK,33,0,0,0,0
9,8475225,Craig Smith,C,DAL,35,0,0,0,0
9,8484326,Patrik Koch,D,ARI,28,0,0,0,0
9,8477930,Pierre-Edouard Bellemare,L,SEA,39,0,0,0,0
9,8478409,Anthony Richard,C,BOS,28,0,0,0,0
9,8481024,Linus Karlsson,C,VAN,25,0,0,0,0
9,8479986,Kole Lind,R,SEA,26,0,0,0,0
9,8479414,Nathan Bastian,R,NJD,27,0,0,0,0
9,8479362,Riley Tufte,L,COL,26,0,0,0,0
9,8481058,Jesse Ylönen,R,MTL,25,0,0,0,0
9,8482476,Emil Heineman,L,MTL,23,0,0,0,0
9,8482861,Vincent Iorio,D,WSH,22,0,0,0,0
9,8483432,Luca Del Bel Belluz,C,CBJ,31,0,0,0,0
9,8482744,James Malatesta,L,CBJ,21,0,0,0,0
9,8477887,Patrick Brown,C,BOS,32,0,0,0,0
9,8478585,Derek Ryan,C,EDM,38,0,0,0,0
9,8481441,Joe Snively,C,WSH,28,0,0,0,0
9,8481592,Jakob Pelletier,L,CGY,23,0,0,0,0
9,8482634,Alex Steeves,C,TOR,25,0,0,0,0
9,8477126,Jayson Megna,C,BOS,34,0,0,0,0
9,8475752,Tyler Pitlick,C,NYR,33,0,0,0,0
9,8480008,Adam Ruzicka,C,ARI,25,0,0,0,0
9,8481065,Angus Crookshank,L,OTT,25,0,0,0,0
9,8479547,Matthew Phillips,R,WSH,26,0,0,0,0
9,8480226,Marián Studenic,R,SEA,26,0,0,0,0
9,8481237,Kyle MacLean,C,NYI,25,0,0,0,0
9,8475413,Justin Dowling,C,NJD,34,0,0,0,0
9,8481641,Joel Kiviranta,L,COL,28,0,0,0,0
9,8478104,Sammy Blais,L,STL,28,0,0,0,0
9,8477454,Adam Erne,L,EDM,29,0,0,0,0
9,8481518,Nolan Foote,L,NJD,24,0,0,0,0
9,8480245,Olle Lycksell,R,PHI,25,0,0,0,0
9,8483570,Ben Meyers,C,ANA,26,0,0,0,0
9,8480776,Sheldon Rempal,R,VGK,29,0,0,0,0
9,8483920,Pierrick Dube,R,WSH,23,0,0,0,0
9,8480267,Sammy Walker,C,MIN,25,0,0,0,0
9,8482747,Brennan Othmann,L,NYR,21,0,0,0,0
9,8479991,Jake Leschyshyn,C,NYR,25,0,0,0,0
9,8478400,Colin White,C,MTL,27,0,0,0,0
9,8479328,Julien Gauthier,R,NYI,27,0,0,0,0
9,8484325,Waltteri Merela,C,TBL,26,0,0,0,0
9,8479066,Ryan Lomberg,L,FLA,30,0,0,0,0
9,8477070,Liam O'Brien,C,ARI,30,0,0,0,0
9,8478146,Matthew Highmore,C,OTT,28,0,0,0,0
9,8478028,Fredrik Olofsson,L,COL,28,0,0,0,0
9,8480880,Jakub Lauko,C,BOS,24,0,0,0,0
9,8479968,Vinni Lettieri,C,MIN,29,0,0,0,0
9,8474709,Matt Martin,L,NYI,35,0,0,0,0
9,8480845,Rasmus Kupari,C,WPG,24,0,0,0,0
9,8481550,Adam Beckman,L,MIN,23,0,0,0,0
9,8481422,Jacob Lucchini,C,MIN,29,0,0,0,0
9,8477401,John Hayden,C,SEA,29,0,0,0,0
9,8478904,Steven Lorentz,C,FLA,28,0,0,0,0
9,8482088,Justin Sourdif,R,FLA,22,0,0,0,0
9,8482751,Ryan Winterton,C,SEA,21,0,0,0,0
9,8482241,Radim Zohorna,L,PIT,28,0,0,0,0
9,8481690,Tyler Angle,C,CBJ,24,0,0,0,0
9,8476952,Dominic Toninato,C,WPG,30,0,0,0,0
9,8476919,Chris Tierney,C,NJD,30,0,0,0,0
9,8480032,Shane Bowers,C,NJD,25,0,0,0,0
9,8484314,Jiri Smejkal,L,OTT,28,0,0,0,0
9,8481239,Samuel Fagemo,L,LAK,24,0,0,0,0
9,8481532,Alex Turcotte,C,LAK,23,0,0,0,0
9,8481019,David Gustafsson,C,WPG,24,0,0,0,0
9,8478477,Mitchell Stephens,C,MTL,27,0,0,0,0
9,8479546,Oskar Steen,C,BOS,26,0,0,0,0
9,8480292,Carson Meyer,R,CBJ,27,0,0,0,0
9,8478446,Glenn Gawdin,C,ANA,27,0,0,0,0
9,8483531,Brian Halonen,L,NJD,25,0,0,0,0
9,8477149,Scott Sabourin,R,SJS,32,0,0,0,0
9,8479972,Mason Shaw,C,MIN,26,0,0,0,0
9,8480890,Jan Jenik,R,ARI,24,0,0,0,0
9,8478051,Max Willman,C,NJD,29,0,0,0,0
9,8480851,Akil Thomas,C,LAK,24,0,0,0,0
9,8482765,Isak Rosen,R,BUF,21,0,0,0,0
9,8478421,A.J. Greer,L,CGY,28,0,0,0,0
9,8478512,Austin Czarnik,C,DET,32,0,0,0,0
9,8479536,Axel Jonsson-Fjallby,L,WPG,26,0,0,0,0
9,8477320,Anton Blidh,L,NYR,29,0,0,0,0
9,8481543,Nikita Alexandrov,C,STL,24,0,0,0,0
9,8475235,Nicolas Deslauriers,L,PHI,33,0,0,0,0
9,8481070,Hugh McGing,L,STL,26,0,0,0,0
9,8480836,Jonathan Gruden,C,PIT,24,0,0,0,0
9,8481591,Sam Poulin,R,PIT,23,0,0,0,0
9,8477962,Brendan Lemieux,L,CAR,28,0,0,0,0
9,8483401,Marc Johnstone,R,PIT,28,0,0,0,0
9,8482250,Callahan Burke,C,CAR,27,0,0,0,0
9,8481726,Adam Edstrom,C,NYR,24,0,0,0,0
9,8471817,Ryan Reaves,R,TOR,37,0,0,0,0
9,8479587,Rhett Gardner,C,PHI,28,0,0,0,0
9,8475766,Austin Watson,L,TBL,32,0,0,0,0
9,8479367,William Lockwood,R,FLA,26,0,0,0,0
9,8478424,Jansen Harkins,C,PIT,27,0,0,0,0
9,8476913,Devin Shore,C,SEA,30,0,0,0,0
9,8482652,Walker Duehr,R,CGY,27,0,0,0,0
9,8477527,Ross Johnston,L,ANA,30,0,0,0,0
9,8481077,John Leonard,L,ARI,26,0,0,0,0
9,8483549,Lucas Condotta,L,MTL,27,0,0,0,0
9,8480468,James Hamblin,L,EDM,25,0,0,0,0
9,8476907,Mackenzie MacEachern,L,STL,30,0,0,0,0
9,8479543,Michael Pezzetta,L,MTL,26,0,0,0,0
9,8480355,Mark Kastelic,C,OTT,25,0,0,0,0
9,8482162,Roby Jarventie,L,OTT,22,0,0,0,0
9,8479772,Zack MacEwen,R,OTT,28,0,0,0,0
9,8483597,Milos Kelemen,L,ARI,25,0,0,0,0
9,8479379,Givani Smith,R,SJS,26,0,0,0,0
9,8481655,Cole Schwindt,R,CGY,23,0,0,0,0
9,8479981,Jonah Gadjovich,L,FLA,26,0,0,0,0
9,8482147,Jean-Luc Foudy,C,COL,22,0,0,0,0
9,8484255,Jason Polin,R,COL,25,0,0,0,0
9,8477993,Justin Kirkland,C,ARI,28,0,0,0,0
9,8479249,Andrew Poturalski,C,SEA,30,0,0,0,0
9,8482197,Adam Raska,R,MIN,23,0,0,0,0
9,8475780,Chris Wagner,R,COL,33,0,0,0,0
9,8479533,Joona Koppanen,L,PIT,26,0,0,0,0
9,8481534,Raphael Lavoie,C,EDM,24,0,0,0,0
9,8484321,Nikolas Matinpalo,D,OTT,26,0,0,0,0
9,8481043,Cole Koepke,L,TBL,26,0,0,0,0
9,8476323,Max McCormick,L,SEA,32,0,0,0,0
9,8483609,Adam Klapka,R,CGY,24,0,0,0,0
9,8483512,Matt Savoie,C,BUF,20,0,0,0,0
9,8484259,Ondrej Pavel,C,COL,31,0,0,0,0
9,8478147,Bokondji Imama,L,OTT,28,0,0,0,0
9,8482460,Matt Rempe,C,NYR,22,0,0,0,0
9,8477073,Kurtis MacDermid,L,NJD,30,0,0,0,0
9,8480274,Philip Kemp,D,EDM,25,0,0,0,0
9,8478956,Samuel Laberge,L,NJD,27,0,0,0,0
9,8483045,Cameron Butler,R,CBJ,31,0,0,0,0
10,8476453,Nikita Kucherov,R,TBL,31,82,44,78,122
10,8479318,Auston Matthews,C,TOR,27,82,67,49,116
10,8477956,David Pastrnak,R,BOS,28,82,55,58,113
10,8478402,Connor McDavid,C,EDM,27,82,42,68,110
10,8476887,Filip Forsberg,L,NSH,30,82,47,62,109
10,8478864,Kirill Kaprizov,L,MIN,27,82,47,56,103
10,8477493,Aleksander Barkov,C,FLA,29,82,34,66,100
10,8478010,Brayden Point,C,TBL,28,82,46,53,99
10,8477939,William Nylander,R,TOR,28,82,36,59,95
10,8474600,Roman Josi,D,NSH,34,82,28,67,95
10,8478420,Mikko Rantanen,R,COL,28,82,44,49,93
10,8481559,Jack Hughes,C,NJD,23,82,36,56,92
10,8477942,Kevin Fiala,L,LAK,28,82,37,52,89
10,8476468,J.T. Miller,C,VAN,31,82,35,53,88
10,8477492,Nathan MacKinnon,C,COL,29,82,29,59,88
10,8478398,Kyle Connor,L,WPG,28,82,38,49,87
10,8476459,Mika Zibanejad,C,NYR,31,82,34,53,87
10,8479314,Matthew Tkachuk,L,FLA,27,82,32,55,87
10,8480803,Evan Bouchard,D,EDM,25,82,17,69,86
10,8474564,Steven Stamkos,C,TBL,34,82,39,46,85
10,8480027,Jason Robertson,L,DAL,25,82,27,58,85
10,8473419,Brad Marchand,L,BOS,36,82,36,48,84
10,8479343,Clayton Keller,R,ARI,26,82,39,44,83
10,8476346,Johnny Gaudreau,L,CBJ,31,82,22,61,83
10,8471675,Sidney Crosby,C,PIT,37,82,33,49,82
10,8471215,Evgeni Malkin,C,PIT,38,82,30,52,82
10,8477934,Leon Draisaitl,C,EDM,29,82,27,55,82
10,8482116,Tim Stützle,C,OTT,22,82,30,50,80
10,8480069,Cale Makar,D,COL,26,82,24,56,80
10,8480800,Quinn Hughes,D,VAN,25,82,8,71,79
10,8477933,Sam Reinhart,C,FLA,29,82,40,38,78
10,8477960,Adrian Kempe,R,LAK,28,82,32,46,78
10,8478439,Travis Konecny,R,PHI,27,82,27,51,78
10,8481528,Dylan Cozens,C,BUF,23,82,32,45,77
10,8474679,Gustav Nyquist,C,NSH,35,82,27,50,77
10,8475172,Nazem Kadri,C,CGY,34,82,25,52,77
10,8481523,Kirby Dach,C,MTL,23,82,11,66,77
10,8470794,Joe Pavelski,C,DAL,40,82,29,47,76
10,8478550,Artemi Panarin,L,NYR,33,82,26,50,76
10,8478042,Viktor Arvidsson,R,LAK,31,82,36,39,75
10,8476460,Mark Scheifele,C,WPG,31,82,33,41,74
10,8476454,Ryan Nugent-Hopkins,C,EDM,31,82,26,48,74
10,8475786,Zach Hyman,L,EDM,32,82,40,33,73
10,8480208,Drake Batherson,R,OTT,26,82,35,38,73
10,8479337,Alex DeBrincat,R,DET,27,82,29,44,73
10,8477940,Nikolaj Ehlers,L,WPG,28,82,27,46,73
10,8479420,Tage Thompson,C,BUF,27,82,36,36,72
10,8480839,Rasmus Dahlin,D,BUF,24,82,17,55,72
10,8475158,Ryan O'Reilly,C,NSH,33,82,34,37,71
10,8480801,Brady Tkachuk,L,OTT,25,82,28,43,71
10,8478047,Michael Bunting,L,PIT,29,82,25,46,71
10,8476539,Jonathan Marchessault,R,VGK,34,82,31,39,70
10,8480023,Robert Thomas,C,STL,25,82,23,47,70
10,8478403,Jack Eichel,C,VGK,28,82,31,38,69
10,8480012,Elias Pettersson,C,VAN,26,82,28,41,69
10,8473994,Jamie Benn,L,DAL,35,82,23,46,69
10,8481540,Cole Caufield,R,MTL,23,82,38,30,68
10,8479385,Jordan Kyrou,C,STL,26,82,37,31,68
10,8475810,Bryan Rust,R,PIT,32,82,35,33,68
10,8480018,Nick Suzuki,C,MTL,25,82,33,35,68
10,8482078,Lucas Raymond,L,DET,22,82,32,36,68
10,8471214,Alex Ovechkin,L,WSH,39,82,31,37,68
10,8475166,John Tavares,C,TOR,34,82,27,41,68
10,8477404,Jake Guentzel,C,CAR,30,82,32,35,67
10,8478440,Dylan Strome,C,WSH,27,82,31,36,67
10,8478444,Brock Boeser,R,VAN,27,82,30,37,67
10,8477402,Pavel Buchnevich,L,STL,29,82,27,40,67
10,8480036,Miro Heiskanen,D,DAL,25,82,13,54,67
10,8475168,Matt Duchene,C,DAL,33,82,35,31,66
10,8477946,Dylan Larkin,C,DET,28,82,31,35,66
10,8479323,Adam Fox,D,NYR,26,82,16,50,66
10,8478493,Joel Eriksson Ek,C,MIN,27,82,28,37,65
10,8477955,Jared McCann,L,SEA,28,82,25,40,65
10,8475726,Tyler Toffoli,C,WPG,32,82,37,27,64
10,8481557,Matt Boldy,L,MIN,23,82,28,36,64
10,8479407,Jesper Bratt,L,NJD,26,82,22,42,64
10,8474578,Erik Karlsson,D,PIT,34,82,13,51,64
10,8476389,Vincent Trocheck,C,NYR,31,82,25,38,63
10,8479999,Casey Mittelstadt,C,COL,26,82,15,48,63
10,8477501,Valeri Nichushkin,R,COL,29,82,37,25,62
10,8477951,Nick Schmaltz,C,ARI,28,82,25,37,62
10,8477496,Elias Lindholm,C,VAN,30,82,25,37,62
10,8478449,Roope Hintz,C,DAL,28,82,27,34,61
10,8475167,Victor Hedman,D,TBL,34,82,14,47,61
10,8476483,Rickard Rakell,R,PIT,31,82,35,25,60
10,8477409,Carter Verhaeghe,C,FLA,29,82,29,31,60
10,8480039,Martin Necas,C,CAR,25,82,24,36,60
10,8477447,Shea Theodore,D,VGK,29,82,15,45,60
10,8475784,Jeff Skinner,C,BUF,32,82,25,34,59
10,8477416,Oliver Bjorkstrand,R,SEA,29,82,25,34,59
10,8477949,Alex Tuch,R,BUF,28,82,22,37,59
10,8480830,Andrei Svechnikov,R,CAR,24,82,21,38,59
10,8473512,Claude Giroux,R,OTT,36,82,18,41,59
10,8478445,Mathew Barzal,C,NYI,27,82,16,43,59
10,8474157,Max Pacioretty,L,WSH,36,82,30,28,58
10,8477476,Artturi Lehkonen,L,COL,29,82,30,28,58
10,8476479,Phillip Danault,C,LAK,31,82,23,35,58
10,8476853,Morgan Rielly,D,TOR,30,82,15,43,58
10,8477504,Josh Morrissey,D,WPG,29,82,12,46,58
10,8474590,John Carlson,D,WSH,34,82,11,47,58
10,8480015,Owen Tippett,R,PHI,25,82,26,31,57
10,8475913,Mark Stone,R,VGK,32,82,24,33,57
10,8479542,Brandon Hagel,L,TBL,26,82,23,34,57
10,8480002,Nico Hischier,C,NJD,25,82,19,38,57
10,8480014,Gabriel Vilardi,C,WPG,25,82,33,23,56
10,8479675,Trevor Moore,L,LAK,29,82,31,25,56
10,8474141,Patrick Kane,R,DET,36,82,27,29,56
10,8475765,Vladimir Tarasenko,R,FLA,33,82,14,42,56
10,8476456,Jonathan Huberdeau,C,CGY,31,82,12,44,56
10,8476905,Chandler Stephenson,C,VGK,30,82,12,44,56
10,8475794,Tyler Seguin,C,DAL,32,82,29,26,55
10,8478427,Sebastian Aho,C,CAR,27,82,28,27,55
10,8475745,Charlie Coyle,C,BOS,32,82,16,39,55
10,8471685,Anze Kopitar,C,LAK,37,82,14,41,55
10,8481699,Aku Raty,R,ARI,23,82,2,53,55
10,8482684,Luke Hughes,D,NJD,21,82,19,35,54
10,8471724,Kris Letang,D,PIT,37,82,8,46,54
10,8482740,Wyatt Johnston,C,DAL,21,82,25,28,53
10,8478233,Andrew Mangiapane,L,CGY,28,82,21,32,53
10,8475170,Brayden Schenn,C,STL,33,82,20,33,53
10,8478438,Tommy Novak,C,NSH,27,82,15,38,53
10,8480865,Noah Dobson,D,NYI,24,82,13,40,53
10,8478460,Zach Werenski,D,CBJ,27,82,10,43,53
10,8475692,Mats Zuccarello,R,MIN,37,82,8,45,53
10,8475184,Chris Kreider,L,NYR,33,82,37,15,52
10,8477500,Bo Horvat,C,NYI,29,82,30,22,52
10,8481068,Yegor Sharangovich,C,CGY,26,82,26,26,52
10,8480188,Fabian Zetterlund,L,SJS,25,82,22,30,52
10,8475798,Mikael Granlund,C,SJS,32,82,14,38,52
10,8478469,Thomas Chabot,D,OTT,27,82,11,41,52
10,8477407,Anthony Duclair,L,TBL,29,82,22,29,51
10,8476329,Travis Boyd,C,ARI,31,82,20,31,51
10,8479339,Patrik Laine,L,CBJ,26,82,19,32,51
10,8479345,Jakob Chychrun,D,OTT,26,82,18,33,51
10,8475754,Brock Nelson,C,NYI,33,82,25,25,50
10,8482093,Seth Jarvis,C,CAR,22,82,19,31,50
10,8479325,Charlie McAvoy,D,BOS,27,82,12,38,50
10,8475169,Evander Kane,L,EDM,33,82,27,22,49
10,8477511,Anthony Mantha,R,VGK,30,82,22,27,49
10,8476880,Tom Wilson,R,WSH,30,82,21,28,49
10,8471698,T.J. Oshie,R,WSH,38,82,19,30,49
10,8482097,Jack Quinn,R,BUF,23,82,18,31,49
10,8475191,Reilly Smith,R,PIT,33,82,18,31,49
10,8474586,Jordan Eberle,R,SEA,34,82,15,34,49
10,8482124,Quinton Byfield,R,LAK,22,82,13,36,49
10,8476875,Mike Matheson,D,MTL,30,82,11,38,49
10,8475722,Jason Zucker,L,NSH,32,82,28,20,48
10,8478414,Timo Meier,R,NJD,28,82,27,21,48
10,8478498,Jake DeBrusk,L,BOS,28,82,25,23,48
10,8477479,Tyler Bertuzzi,L,TOR,29,82,23,25,48
10,8470621,Corey Perry,R,EDM,39,82,22,26,48
10,8482665,Matty Beniers,C,SEA,22,82,14,34,48
10,8479425,Filip Hronek,D,VAN,27,82,12,36,48
10,8477346,MacKenzie Weegar,D,CGY,30,82,7,41,48
10,8473986,Alex Killorn,L,ANA,35,82,22,25,47
10,8482159,Tyson Foerster,R,PHI,22,82,18,29,47
10,8477451,Ryan Hartman,R,MIN,30,82,27,19,46
10,8480797,Joel Farabee,L,PHI,24,82,27,19,46
10,8475799,Nino Niederreiter,R,WPG,32,82,25,21,46
10,8477947,Sonny Milano,L,WSH,28,82,21,25,46
10,8477497,Sean Monahan,C,WPG,30,82,20,26,46
10,8478856,Conor Garland,R,VAN,28,82,18,28,46
10,8474150,Mikael Backlund,C,CGY,35,82,18,28,46
10,8476448,William Karlsson,C,VGK,31,82,18,28,46
10,8476419,Jean-Gabriel Pageau,C,NYI,32,82,18,28,46
10,8480798,Philipp Kurashev,C,CHI,25,82,16,30,46
10,8477494,Jonathan Drouin,L,COL,29,82,11,35,46
10,8476792,Torey Krug,D,STL,33,82,9,37,46
10,8481542,Moritz Seider,D,DET,23,82,8,38,46
10,8475760,Nick Bjugstad,C,ARI,32,82,30,15,45
10,8482055,Drew O'Connor,L,PIT,26,82,28,17,45
10,8482699,Dylan Guenther,R,ARI,21,82,25,20,45
10,8481624,Ilya Mikheyev,R,VAN,30,82,22,23,45
10,8477964,Ivan Barbashev,C,VGK,29,82,21,24,45
10,8481596,Shane Pinto,C,OTT,24,82,20,25,45
10,8475791,Taylor Hall,L,CHI,33,82,19,26,45
10,8484144,Connor Bedard,C,CHI,19,82,18,27,45
10,8476869,Brady Skjei,D,CAR,30,82,17,28,45
10,8476881,Tomas Hertl,C,VGK,31,82,16,29,45
10,8480893,Kirill Marchenko,R,CBJ,24,82,16,29,45
10,8476462,Dougie Hamilton,D,NJD,31,82,10,35,45
10,8483524,Shane Wright,C,SEA,20,82,31,13,44
10,8476432,Boone Jenner,C,CBJ,31,82,26,18,44
10,8475151,Kyle Palmieri,C,NYI,33,82,24,20,44
10,8482109,Alexis Lafrenière,L,NYR,23,82,22,22,44
10,8482079,Marco Rossi,C,MIN,23,82,22,22,44
10,8478873,Troy Terry,R,ANA,27,82,20,24,44
10,8482146,Luke Evangelista,R,NSH,22,82,18,26,44
10,8480009,Eeli Tolvanen,R,SEA,25,82,15,29,44
10,8478519,Anthony Cirelli,C,TBL,27,82,14,30,44
10,8478401,Pavel Zacha,C,BOS,27,82,12,32,44
10,8477503,Max Domi,C,TOR,29,82,10,34,44
10,8478396,Noah Hanifin,D,VGK,27,82,9,35,44
10,8482122,Brock Faber,D,MIN,22,82,6,38,44
10,8476399,Blake Coleman,C,CGY,33,82,27,16,43
10,8478057,Dakota Joshua,C,VAN,28,82,23,20,43
10,8475714,Calle Jarnkrok,C,TOR,33,82,20,23,43
10,8477935,Sam Bennett,C,FLA,28,82,18,25,43
10,8478407,Vince Dunn,D,SEA,28,82,14,29,43
10,8482745,Mason McTavish,C,ANA,21,82,13,30,43
10,8482671,Owen Power,D,BUF,22,82,10,33,43
10,8475197,Tyson Barrie,D,NSH,33,82,6,37,43
10,8475314,Anders Lee,L,NYI,34,82,24,18,42
10,8479525,Ross Colton,C,COL,28,82,14,28,42
10,8476854,Hampus Lindholm,D,BOS,30,82,13,29,42
10,8482105,Jake Sanderson,D,OTT,22,82,12,30,42
10,8477429,Andrew Copp,C,DET,30,82,12,30,42
10,8480459,Pius Suter,C,VAN,28,82,16,25,41
10,8479992,Michael Rasmussen,C,DET,25,82,15,26,41
10,8475744,Evgeny Kuznetsov,C,CAR,32,82,12,29,41
10,8479410,Mikhail Sergachev,D,TBL,26,82,11,30,41
10,8474563,Drew Doughty,D,LAK,35,82,9,32,41
10,8478038,Devon Toews,D,COL,30,82,7,34,41
10,8476906,Shayne Gostisbehere,D,DET,31,82,7,34,41
10,8480145,Neal Pionk,D,WPG,29,82,6,35,41
10,8482101,Danil Gushchin,L,SJS,22,82,27,13,40
10,8478366,Frank Vatrano,R,ANA,30,82,20,20,40
10,8481533,Trevor Zegras,C,ANA,23,82,16,24,40
10,8478458,Jack Roslovic,C,NYR,27,82,13,27,40
10,8477986,Brandon Montour,D,FLA,30,82,12,28,40
10,8474102,David Perron,L,DET,36,82,12,28,40
10,8480064,Josh Norris,C,OTT,25,82,21,18,39
10,8481618,Alex Newhook,C,MTL,23,82,20,19,39
10,8474870,Tyler Johnson,C,CHI,34,82,18,21,39
10,8474189,Lars Eller,C,PIT,35,82,17,22,39
10,8476458,Ryan Strome,C,ANA,31,82,16,23,39
10,8478462,Nicolas Roy,C,VGK,27,82,15,24,39
10,8482175,JJ Peterka,R,BUF,22,82,14,25,39
10,8479987,Morgan Geekie,C,BOS,26,82,11,28,39
10,8475218,Mattias Ekholm,D,EDM,34,82,10,29,39
10,8480031,Maxime Comtois,L,CAR,25,82,7,32,39
10,8477495,Seth Jones,D,CHI,30,82,7,32,39
10,8476873,Mark Jankowski,C,NSH,30,82,29,9,38
10,8474641,Adam Henrique,C,EDM,34,82,18,20,38
10,8480220,Noah Cates,L,PHI,25,82,18,20,38
10,8480028,Morgan Frost,C,PHI,25,82,17,21,38
10,8471218,Blake Wheeler,R,NYR,38,82,17,21,38
10,8483808,Andrei Kuzmenko,L,CGY,28,82,15,23,38
10,8475753,Justin Faulk,D,STL,32,82,14,24,38
10,8479996,Cody Glass,C,NSH,25,82,14,24,38
10,8477456,J.T. Compher,L,DET,29,82,13,25,38
10,8478542,Evan Rodrigues,C,FLA,31,82,12,26,38
10,8475768,Jaden Schwartz,C,SEA,32,82,11,27,38
10,8482705,Cole Sillinger,C,CBJ,21,82,11,27,38
10,8482667,William Eklund,L,SJS,22,82,10,28,38
10,8473422,Nick Foligno,L,CHI,37,82,10,28,38
10,8481581,Thomas Harley,D,DAL,23,82,9,29,38
10,8476958,Jaccob Slavin,D,CAR,30,82,6,32,38
10,8476438,Brandon Saad,L,STL,32,82,21,16,37
10,8484166,Adam Fantilli,C,CBJ,20,82,19,18,37
10,8481535,Nils Hoglander,L,VAN,24,82,17,20,37
10,8477444,Andre Burakovsky,L,SEA,29,82,16,21,37
10,8476882,Teuvo Teravainen,L,CAR,30,82,14,23,37
10,8477021,Alex Kerfoot,C,ARI,30,82,14,23,37
10,8474565,Alex Pietrangelo,D,VGK,34,82,10,27,37
10,8477948,Travis Sanheim,D,PHI,28,82,10,27,37
10,8478500,Ivan Provorov,D,CBJ,27,82,9,28,37
10,8480821,Filip Zadina,R,SJS,25,82,22,14,36
10,8478891,Mason Appleton,C,WPG,28,82,19,17,36
10,8478474,Lawson Crouse,L,ARI,27,82,17,19,36
10,8478466,Daniel Sprong,R,DET,27,82,16,20,36
10,8481704,Juuso Parssinen,C,NSH,23,82,16,20,36
10,8480873,Rasmus Sandin,D,WSH,24,82,5,31,36
10,8481703,Valtteri Puustinen,R,PIT,25,82,5,31,36
10,8479351,Sam Steel,C,DAL,26,82,18,17,35
10,8482133,Thomas Bordeleau,C,SJS,22,82,17,18,35
10,8470604,Jeff Carter,C,PIT,39,82,16,19,35
10,8478109,Victor Olofsson,L,BUF,29,82,16,19,35
10,8482702,Logan Stankoven,C,DAL,21,82,15,20,35
10,8478463,Anthony Beauvillier,L,NSH,27,82,14,21,35
10,8480855,Jack McBain,C,ARI,24,82,14,21,35
10,8477425,Miles Wood,L,COL,29,82,13,22,35
10,8481711,Matias Maccelli,L,ARI,24,82,12,23,35
10,8474037,James van Riemsdyk,L,BOS,35,82,12,23,35
10,8479365,Trent Frederic,C,BOS,26,82,12,23,35
10,8482720,Matthew Knies,L,TOR,22,82,10,25,35
10,8476826,Yanni Gourde,C,SEA,33,82,9,26,35
10,8482142,Jamie Drysdale,D,PHI,22,82,8,27,35
10,8480434,Sean Durzi,D,ARI,26,82,6,29,35
10,8479941,Justin Danforth,R,CBJ,31,82,19,15,34
10,8479423,Alex Nylander,L,CBJ,26,82,18,16,34
10,8482475,Yegor Chinakhov,R,CBJ,23,82,16,18,34
10,8478975,Mason Marchment,L,DAL,29,82,15,19,34
10,8480802,Ryan McLeod,C,EDM,25,82,14,20,34
10,8475793,Ryan Johansen,C,PHI,32,82,14,20,34
10,8476872,Scott Laughton,C,PHI,30,82,10,24,34
10,8476897,Oskar Sundqvist,C,STL,30,82,9,25,34
10,8480336,Sean Walker,D,COL,30,82,9,25,34
10,8474034,Pat Maroon,L,BOS,36,82,9,25,34
10,8477498,Darnell Nurse,D,EDM,29,82,8,26,34
10,8481016,Ruslan Iskhakov,C,NYI,24,82,5,29,34
10,8483397,Marc McLaughlin,C,BOS,25,82,29,4,33
10,8480849,Barrett Hayton,C,ARI,24,82,15,18,33
10,8477998,Warren Foegele,L,EDM,28,82,14,19,33
10,8479400,Pierre-Luc Dubois,L,LAK,26,82,12,21,33
10,8482089,Jake Neighbours,L,STL,22,82,12,21,33
10,8481656,Aliaksei Protas,C,WSH,23,82,8,25,33
10,8478397,Rasmus Andersson,D,CGY,28,82,3,30,33
10,8483471,Brad Lambert,C,WPG,31,82,1,32,33
10,8481604,Pavel Dorofeyev,L,VGK,24,82,19,13,32
10,8477989,Christian Dvorak,C,MTL,28,82,19,13,32
10,8475287,Erik Haula,L,NJD,33,82,16,16,32
10,8482110,Dawson Mercer,C,NJD,23,82,16,16,32
10,8473449,Kyle Okposo,R,FLA,36,82,15,17,32
10,8480185,Eetu Luostarinen,C,FLA,26,82,15,17,32
10,8478055,Gustav Forsling,D,FLA,28,82,12,20,32
10,8483515,Juraj Slafkovsky,L,MTL,20,82,12,20,32
10,8475171,Oliver Ekman-Larsson,D,FLA,33,82,10,22,32
10,8478472,Mathieu Joseph,R,OTT,27,82,10,22,32
10,8477969,Marcus Pettersson,D,PIT,28,82,6,26,32
10,8479591,Michael Eyssimont,C,TBL,28,82,18,13,31
10,8477426,Nicholas Paul,L,TBL,29,82,16,15,31
10,8481481,Blake Lizotte,C,LAK,27,82,16,15,31
10,8481560,Arthur Kaliyev,R,LAK,23,82,13,18,31
10,8476923,Damon Severson,D,CBJ,30,82,9,22,31
10,8476979,Erik Gustafsson,D,NYR,32,82,9,22,31
10,8476292,Ondrej Palat,L,NJD,33,82,8,23,31
10,8476480,Vladislav Namestnikov,C,WPG,32,82,6,25,31
10,8474151,Ryan McDonagh,D,NSH,35,82,4,27,31
10,8483493,Frank Nazar,C,CHI,20,82,23,7,30
10,8478046,Danton Heinen,L,BOS,29,82,17,13,30
10,8477952,Robby Fabbri,C,DET,28,82,17,13,30
10,8476461,Sean Couturier,C,PHI,32,82,15,15,30
10,8476392,Adam Lowry,C,WPG,31,82,12,18,30
10,8481186,Logan O'Connor,R,COL,28,82,12,18,30
10,8480078,Filip Chytil,C,NYR,25,82,9,21,30
10,8479976,Juuso Valimaki,D,ARI,26,82,9,21,30
10,8477953,Kasperi Kapanen,R,STL,28,82,8,22,30
10,8474053,Logan Couture,C,SJS,35,82,8,22,30
10,8475149,Marcus Johansson,L,MIN,34,82,8,22,30
10,8477932,Aaron Ekblad,D,FLA,28,82,7,23,30
10,8481606,Jordan Spence,D,LAK,23,82,6,24,30
10,8475181,Nick Leddy,D,STL,33,82,4,26,30
10,8482733,Logan Mailloux,D,MTL,31,82,1,29,30
10,8481093,Rafael Harvey-Pinard,L,MTL,25,82,20,9,29
10,8478043,Sam Lafferty,C,VAN,29,82,14,15,29
10,8478020,Michael Amadio,C,VGK,28,82,14,15,29
10,8473533,Jordan Staal,C,CAR,36,82,14,15,29
10,8481554,Kaapo Kakko,R,NYR,23,82,13,16,29
10,8482113,Anton Lundell,C,FLA,23,82,12,17,29
10,8482222,Alexander Barabanov,L,SJS,30,82,12,17,29
10,8478430,Oliver Kylington,D,CGY,27,82,12,17,29
10,8476921,Jordan Martinook,L,CAR,32,82,11,18,29
10,8482117,Lukas Reichel,L,CHI,22,82,11,18,29
10,8476925,Colton Sissons,C,NSH,31,82,10,19,29
10,8477839,Conor Sheary,L,TBL,32,82,9,20,29
10,8482062,Cole Smith,L,NSH,29,82,9,20,29
10,8480144,David Kampf,C,TOR,29,82,9,20,29
10,8477506,Ryan Pulock,D,NYI,30,82,8,21,29
10,8475906,John Klingberg,D,TOR,32,82,6,23,29
10,8481546,Cam York,D,PHI,23,82,5,24,29
10,8476931,Jake McCabe,D,TOR,31,82,4,25,29
10,8480035,Henri Jokiharju,D,BUF,25,82,4,25,29
10,8483445,Cutter Gauthier,L,ANA,20,82,1,28,29
10,8470610,Zach Parise,L,COL,40,82,15,13,28
10,8481013,Jonatan Berggren,R,DET,24,82,14,14,28
10,8481580,Connor McMichael,C,WSH,23,82,14,14,28
10,8482624,Daniil Miromanov,D,CGY,27,82,13,15,28
10,8484153,Leo Carlsson,C,ANA,20,82,13,15,28
10,8481477,Nico Sturm,C,SJS,29,82,13,15,28
10,8481553,Bobby Brink,R,PHI,23,82,13,15,28
10,8477919,Frederick Gaudreau,C,MIN,31,82,12,16,28
10,8483431,Logan Cooley,C,ARI,20,82,11,17,28
10,8474884,Mike Hoffman,C,SJS,35,82,10,18,28
10,8480871,Adam Boqvist,D,CBJ,24,82,9,19,28
10,8484145,Zach Benson,L,BUF,19,82,9,19,28
10,8474149,Evgenii Dadonov,R,DAL,35,82,7,21,28
10,8474673,TJ Brodie,D,TOR,34,82,5,23,28
10,8482087,Kaiden Guhle,D,MTL,22,82,4,24,28
10,8473507,Jeff Petry,D,DET,37,82,2,26,28
10,8479293,Brandon Tanev,L,SEA,33,82,17,10,27
10,8477353,Tyler Motte,C,TBL,29,82,13,14,27
10,8480113,Alex Iafallo,L,WPG,31,82,12,15,27
10,8478413,Jordan Greenway,L,BUF,27,82,11,16,27
10,8479661,Tanner Jeannot,L,TBL,27,82,10,17,27
10,8476927,Teddy Blueger,C,VAN,30,82,9,18,27
10,8476892,Colton Parayko,D,STL,31,82,7,20,27
10,8480817,K'Andre Miller,D,NYR,24,82,7,20,27
10,8480043,Timothy Liljegren,D,TOR,25,82,6,21,27
10,8475200,Dmitry Orlov,D,CAR,33,82,6,21,27
10,8482655,J.J. Moser,D,ARI,24,82,5,22,27
10,8476902,Esa Lindell,D,DAL,30,82,4,23,27
10,8479393,Noah Gregor,C,TOR,26,82,17,9,26
10,8482125,Alexander Holtz,R,NJD,22,82,13,13,26
10,8482092,Ridly Greig,C,OTT,22,82,12,14,26
10,8476960,Andreas Athanasiou,C,CHI,30,82,11,15,26
10,8480813,Joe Veleno,C,DET,24,82,11,15,26
10,8478115,Pierre Engvall,L,NYI,28,82,11,15,26
10,8483491,Ivan Miroshnichenko,L,WSH,20,82,11,15,26
10,8477450,Jason Dickinson,C,CHI,29,82,8,18,26
10,8476312,Josh Manson,D,COL,33,82,8,18,26
10,8473563,Nicklas Backstrom,C,WSH,37,82,7,19,26
10,8475763,Kevin Hayes,R,STL,32,82,6,20,26
10,8483457,Lane Hutson,D,MTL,20,82,5,21,26
10,8478133,Jake Evans,C,MTL,28,82,5,21,26
10,8477845,Trevor van Riemsdyk,D,WSH,33,82,5,21,26
10,8479369,Andrew Peeke,D,BOS,26,82,4,22,26
10,8475790,Erik Gudbranson,D,CBJ,32,82,4,22,26
10,8474716,Jared Spurgeon,D,MIN,35,82,3,23,26
10,8476879,Cody Ceci,D,EDM,31,82,3,23,26
10,8475220,Marcus Foligno,L,MIN,33,82,12,13,25
10,8477931,Tomas Nosek,L,NJD,32,82,10,15,25
10,8479415,Michael McLeod,C,NJD,26,82,9,16,25
10,8478882,Vladislav Gavrikov,D,LAK,29,82,7,18,25
10,8475233,David Savard,D,MTL,34,82,5,20,25
10,8483505,Matthew Poitras,C,BOS,20,82,4,21,25
10,8475764,Cam Fowler,D,ANA,33,82,3,22,25
10,8476981,Josh Anderson,R,MTL,30,82,17,7,24
10,8477330,Dominik Kubalik,L,OTT,29,82,16,8,24
10,8477944,Jakub Vrana,L,STL,28,82,15,9,24
10,8481028,Martin Pospisil,C,CGY,25,82,12,12,24
10,8475343,Nic Dowd,C,WSH,34,82,10,14,24
10,8480074,Alexandre Texier,C,CBJ,25,82,9,15,24
10,8476525,Colin Miller,D,WPG,32,82,8,16,24
10,8476442,Matt Nieto,L,PIT,32,82,7,17,24
10,8482712,Oskar Olausson,R,COL,22,82,6,18,24
10,8475179,Dmitry Kulikov,D,FLA,34,82,5,19,24
10,8476463,Jonas Brodin,D,MIN,31,82,2,22,24
10,8476917,Adam Pelech,D,NYI,30,82,1,23,24
10,8479442,Troy Stecher,D,EDM,30,82,11,12,23
10,8477507,Nikita Zadorov,D,VAN,29,82,9,14,23
10,8477015,Connor Brown,R,EDM,30,82,9,14,23
10,8478831,Kevin Stenlund,C,FLA,28,82,8,15,23
10,8478840,Will Borgen,D,SEA,28,82,7,16,23
10,8479390,Taylor Raddysh,R,CHI,26,82,7,16,23
10,8478911,Matt Roy,D,LAK,29,82,6,17,23
10,8476372,Nick Seeler,D,PHI,31,82,6,17,23
10,8476624,Barclay Goodrow,C,NYR,31,82,6,17,23
10,8470613,Brent Burns,D,CAR,39,82,4,19,23
10,8480246,Nick Perbix,D,TBL,26,82,4,19,23
10,8477499,Rasmus Ristolainen,D,PHI,30,82,4,19,23
10,8478178,Darren Raddysh,D,TBL,28,82,3,20,23
10,8479359,Beck Malenstyn,L,WSH,26,82,13,9,22
10,8476878,Zemgus Girgensons,L,BUF,30,82,13,9,22
10,8482259,Bobby McMann,C,TOR,28,82,12,10,22
10,8476278,Colin Blackwell,C,CHI,31,82,11,11,22
10,8482074,Connor Zary,C,CGY,23,82,10,12,22
10,8476967,Brett Kulak,D,EDM,30,82,7,15,22
10,8482803,Olen Zellweger,D,ANA,21,82,7,15,22
10,8479983,Mario Ferraro,D,SJS,26,82,5,17,22
10,8482730,Brandt Clarke,D,LAK,21,82,4,18,22
10,8478507,John Marino,D,NJD,27,82,2,20,22
10,8478416,Erik Cernak,D,TBL,27,82,2,20,22
10,8482809,Jackson Blake,R,CAR,21,82,14,7,21
10,8480281,Alexey Toropchenko,R,STL,25,82,13,8,21
10,8484203,Bradly Nadeau,L,CAR,19,82,12,9,21
10,8479977,Kailer Yamamoto,R,SEA,26,82,12,9,21
10,8482155,Alex Laferriere,R,LAK,23,82,11,10,21
10,8481524,Bowen Byram,D,BUF,23,82,9,12,21
10,8479316,Luke Kunin,C,SJS,27,82,8,13,21
10,8476422,Mike Reilly,D,NYI,31,82,8,13,21
10,8479353,Brett Howden,C,VGK,26,82,6,15,21
10,8480860,Kevin Bahl,D,NJD,24,82,6,15,21
10,8475462,Radko Gudas,D,ANA,34,82,5,16,21
10,8483466,Kevin Korchinski,D,CHI,20,82,5,16,21
10,8481178,Egor Zamula,D,PHI,24,82,3,18,21
10,8477220,Nate Schmidt,D,WPG,33,82,3,18,21
10,8480172,Jan Rutta,D,SJS,34,82,3,18,21
10,8478851,Alexandre Carrier,D,NSH,28,82,1,20,21
10,8482516,Matthew Kessel,D,STL,24,82,0,21,21
10,8481517,Brett Leason,R,ANA,25,82,14,6,20
10,8475848,Brendan Gallagher,R,MTL,32,82,13,7,20
10,8481537,Nikita Okhotiuk,D,CGY,24,82,12,8,20
10,8473504,Cal Clutterbuck,R,NYI,37,82,10,10,20
10,8476469,Joel Armia,R,MTL,31,82,9,11,20
10,8480806,Isac Lundestrom,C,ANA,25,82,9,11,20
10,8481601,Simon Holmstrom,R,NYI,23,82,8,12,20
10,8483499,Liam Ohgren,L,MIN,20,82,8,12,20
10,8478013,Jake Walman,D,DET,28,82,8,12,20
10,8477392,Hudson Fasching,R,NYI,29,82,8,12,20
10,8480980,Connor Dewar,C,TOR,25,82,8,12,20
10,8477435,Ryan Graves,D,PIT,29,82,7,13,20
10,8479398,Samuel Girard,D,COL,26,82,4,16,20
10,8477406,Mattias Janmark,C,EDM,32,82,4,16,20
10,8480058,Pierre-Olivier Joseph,D,PIT,25,82,2,18,20
10,8476331,Dylan DeMelo,D,WPG,31,82,1,19,20
10,8478508,Yakov Trenin,C,COL,27,82,15,4,19
10,8474715,Cam Atkinson,R,PHI,35,82,12,7,19
10,8478569,Noel Acciari,C,PIT,33,82,10,9,19
10,8482111,Justin Barron,D,MTL,23,82,9,10,19
10,8479383,Boris Katchouk,L,OTT,26,82,7,12,19
10,8480068,Ryan Poehling,C,PHI,25,82,7,12,19
10,8479346,Dillon Dube,C,CGY,26,82,7,12,19
10,8476891,Matt Grzelcyk,D,BOS,30,82,3,16,19
10,8474013,Ian Cole,D,VAN,35,82,3,16,19
10,8470600,Ryan Suter,D,DAL,39,82,2,17,19
10,8475324,Nick Jensen,D,WSH,34,82,0,19,19
10,8476374,Sean Kuraly,C,CBJ,31,82,11,7,18
10,8477508,Curtis Lazar,C,NJD,29,82,8,10,18
10,8475231,Casey Cizikas,C,NYI,33,82,6,12,18
10,8478451,Ethan Bear,D,WSH,27,82,5,13,18
10,8479980,Nicolas Hague,D,VGK,26,82,4,14,18
10,8481014,Alexander Romanov,D,NYI,24,82,3,15,18
10,8478443,Brandon Carlo,D,BOS,28,82,3,15,18
10,8476473,Connor Murphy,D,CHI,31,82,2,16,18
10,8482118,Sam Colangelo,R,ANA,23,82,15,2,17
10,8482666,Scott Morrow,D,CAR,22,82,7,10,17
10,8483012,Logan Morrison,C,SEA,22,82,7,10,17
10,8476871,Tanner Pearson,L,MTL,32,82,6,11,17
10,8479514,Rem Pitlick,C,CHI,27,82,6,11,17
10,8481059,Scott Perunovich,D,STL,26,82,6,11,17
10,8474009,Nick Bonino,C,NYR,36,82,6,11,17
10,8482679,Matt Coronato,R,CGY,22,82,5,12,17
10,8480807,Mattias Samuelsson,D,BUF,24,82,4,13,17
10,8475208,Brian Dumoulin,D,SEA,33,82,4,13,17
10,8476457,Adam Larsson,D,SEA,32,82,3,14,17
10,8482245,Artem Zub,D,OTT,29,82,3,14,17
10,8483495,Simon Nemec,D,NJD,20,82,3,14,17
10,8480879,Jacob Bernard-Docker,D,OTT,24,82,3,14,17
10,8479998,Mikey Anderson,D,LAK,25,82,2,15,17
10,8477365,Connor Clifton,D,BUF,29,82,2,15,17
10,8475455,Brenden Dillon,D,WPG,34,82,2,15,17
10,8481568,Alex Vlasic,D,CHI,23,82,6,10,16
10,8481522,Peyton Krebs,C,BUF,23,82,6,10,16
10,8478468,Jeremy Lauzon,D,NSH,27,82,6,10,16
10,8483565,Nick Blankenburg,D,CBJ,26,82,4,12,16
10,8481567,Henry Thrun,D,SJS,23,82,4,12,16
10,8482073,Braden Schneider,D,NYR,23,82,4,12,16
10,8479324,Ryan Lindgren,D,NYR,26,82,3,13,16
10,8474574,Tyler Myers,D,VAN,34,82,3,13,16
10,8481605,Jackson LaCombe,D,ANA,23,82,3,13,16
10,8482858,Ryker Evans,D,SEA,23,82,3,13,16
10,8480073,Erik Brannstrom,D,OTT,25,82,1,15,16
10,8482145,Mavrik Bourque,C,DAL,22,82,12,3,15
10,8473453,Trevor Lewis,C,LAK,37,82,10,5,15
10,8476822,Luke Glendening,C,TBL,35,82,9,6,15
10,8476858,Phillip Di Giuseppe,L,VAN,31,82,8,7,15
10,8482166,Shakir Mukhamadullin,D,SJS,22,82,5,10,15
10,8478859,Niko Mikkola,D,FLA,28,82,4,11,15
10,8475762,Derek Forbort,D,BOS,32,82,4,11,15
10,8484911,Collin Graf,R,SJS,22,82,3,12,15
10,8479371,Dante Fabbro,D,NSH,26,82,3,12,15
10,8471677,Jack Johnson,D,COL,37,82,3,12,15
10,8475177,Calvin de Haan,D,TBL,33,82,0,15,15
10,8482737,Zack Bolduc,C,STL,21,82,11,3,14
10,8482762,Simon Edvinsson,D,DET,21,82,9,5,14
10,8474166,Alec Martinez,D,VGK,37,82,7,7,14
10,8477369,Carson Soucy,D,VAN,30,82,6,8,14
10,8480796,Martin Fehervary,D,WSH,25,82,6,8,14
10,8483482,Tristan Luneau,D,ANA,20,82,5,9,14
10,8480834,Ty Emberson,D,SJS,24,82,4,10,14
10,8477505,Alexander Wennberg,C,NYR,30,82,4,10,14
10,8482807,Ethan Del Mastro,D,CHI,21,82,4,10,14
10,8475164,Jakob Silfverberg,R,ANA,34,82,3,11,14
10,8476885,Jacob Trouba,D,NYR,30,82,1,13,14
10,8475279,Ben Chiarot,D,DET,33,82,1,13,14
10,8475825,Jani Hakanpää,D,DAL,32,82,1,13,14
10,8480448,Parker Kelly,L,OTT,25,82,7,6,13
10,8483468,Jiri Kulich,C,BUF,20,82,5,8,13
10,8475188,Brayden McNabb,D,VGK,33,82,3,10,13
10,8482470,Ilya Solovyov,D,CGY,24,82,3,10,13
10,8470966,Mark Giordano,D,TOR,41,82,1,12,13
10,8476429,Scott Mayfield,D,NYI,32,82,1,12,13
10,8483490,Pavel Mintyukov,D,ANA,21,82,0,13,13
10,8477488,Brett Pesce,D,CAR,30,82,6,6,12
10,8479291,Kevin Rooney,C,CGY,31,82,4,8,12
10,8478136,Jake Middleton,D,MIN,28,82,4,8,12
10,8476467,Jamie Oleksiak,D,SEA,32,82,2,10,12
10,8480990,Declan Chisholm,D,MIN,24,82,2,10,12
10,8475690,Chris Tanev,D,DAL,35,82,1,11,12
10,8481599,Victor Soderstrom,D,ARI,23,82,1,11,12
10,8481578,Graeme Clarke,R,NJD,23,82,6,5,11
10,8477335,Kyle Burroughs,D,SJS,29,82,3,8,11
10,8475842,Sam Carrick,C,EDM,32,82,3,8,11
10,8478399,Jonas Siegenthaler,D,NJD,27,82,4,6,10
10,8481030,Jack St. Ivany,D,PIT,25,82,4,6,10
10,8474567,Zach Bogosian,D,MIN,34,82,1,9,10
10,8484149,Gavin Brindley,C,CBJ,20,82,3,6,9
10,8482177,Marat Khusnutdinov,C,MIN,22,82,2,6,8
10,8483763,Maksymilian Szuber,D,ARI,22,82,2,6,8
10,8477034,Jaycob Megna,D,CHI,32,82,2,6,8
10,8482713,Mackie Samoskevich,R,FLA,22,82,1,7,8
10,8476915,Jujhar Khaira,L,MIN,30,82,4,3,7
10,8478408,Travis Dermott,D,ARI,28,82,2,5,7
10,8482859,Zack Ostapchuk,C,OTT,21,82,1,6,7
10,8483489,Fraser Minten,C,TOR,31,82,0,5,5
10,8482141,Lukas Cormier,D,VGK,22,0,0,0,0
10,8476988,Matt Benning,D,SJS,30,0,0,0,0
10,8480727,Zach Whitecloud,D,VGK,28,0,0,0,0
10,8480887,Jordan Harris,D,MTL,24,0,0,0,0
10,8478450,Parker Wotherspoon,D,BOS,27,0,0,0,0
10,8481812,Nikolai Knyzhov,D,SJS,27,0,0,0,0
10,8480001,Urho Vaakanainen,D,ANA,25,0,0,0,0
10,8482176,Wyatt Kaiser,D,CHI,22,0,0,0,0
10,8481122,Simon Benoit,D,TOR,26,0,0,0,0
10,8476441,Joel Edmundson,D,TOR,31,0,0,0,0
10,8480884,Calen Addison,D,SJS,24,0,0,0,0
10,8482511,Mason Lohrei,D,BOS,23,0,0,0,0
10,8482192,Isaak Phillips,D,CHI,23,0,0,0,0
10,8480950,Ilya Lyubushkin,D,TOR,30,0,0,0,0
10,8474031,Kevin Shattenkirk,D,BOS,35,0,0,0,0
10,8475718,Justin Holl,D,DET,32,0,0,0,0
10,8479402,Jake Bean,D,CBJ,26,0,0,0,0
10,8474602,Justin Schultz,D,SEA,34,0,0,0,0
10,8477950,Tony DeAngelo,D,CAR,29,0,0,0,0
10,8481743,Marc Del Gaizo,D,NSH,25,0,0,0,0
10,8481527,Kaedan Korczak,D,VGK,23,0,0,0,0
10,8480192,Johnathan Kovacevic,D,MTL,27,0,0,0,0
10,8476874,Olli Maatta,D,DET,30,0,0,0,0
10,8482144,Jack Thompson,D,SJS,22,0,0,0,0
10,8480222,Sebastian Aho,D,NYI,28,0,0,0,0
10,8479458,Nikita Zaitsev,D,CHI,33,0,0,0,0
10,8471709,Marc-Edouard Vlasic,D,SJS,37,0,0,0,0
10,8482929,Emil Lilleberg,D,TBL,23,0,0,0,0
10,8477018,Ben Hutton,D,VGK,31,0,0,0,0
10,8481056,Spencer Stastney,D,NSH,24,0,0,0,0
10,8481593,Jayden Struble,D,MTL,23,0,0,0,0
10,8479982,Conor Timmins,D,TOR,26,0,0,0,0
10,8474090,Brendan Smith,D,NJD,35,0,0,0,0
10,8482964,Arber Xhekaj,D,MTL,23,0,0,0,0
10,8480891,Michael Kesselring,D,ARI,24,0,0,0,0
10,8477938,Haydn Fleury,D,TBL,28,0,0,0,0
10,8481806,Louis Crevier,D,CHI,23,0,0,0,0
10,8471274,Alex Goligoski,D,MIN,39,0,0,0,0
10,8481600,Tobias Bjornfot,D,FLA,23,0,0,0,0
10,8475797,Jarred Tinordi,D,CHI,32,0,0,0,0
10,8481521,Ronnie Attard,D,PHI,25,0,0,0,0
10,8474612,Travis Hamonic,D,OTT,34,0,0,0,0
10,8479576,Vincent Desharnais,D,EDM,28,0,0,0,0
10,8480049,Dylan Samberg,D,WPG,25,0,0,0,0
10,8483619,Filip Roos,D,CHI,25,0,0,0,0
10,8474568,Luke Schenn,D,NSH,35,0,0,0,0
10,8480184,Gustav Lindstrom,D,ANA,26,0,0,0,0
10,8480070,Ian Mitchell,D,BOS,25,0,0,0,0
10,8480196,Jacob Bryson,D,BUF,27,0,0,0,0
10,8471686,Marc Staal,D,PHI,37,0,0,0,0
10,8477467,Gustav Olofsson,D,SEA,30,0,0,0,0
10,8478970,Jalen Chatfield,D,CAR,28,0,0,0,0
10,8479348,Kale Clague,D,BUF,26,0,0,0,0
10,8473446,Erik Johnson,D,PHI,36,0,0,0,0
10,8477462,Robert Hagg,D,ANA,29,0,0,0,0
10,8478454,Noah Juulsen,D,VAN,27,0,0,0,0
10,8477384,Josh Brown,D,ARI,30,0,0,0,0
10,8481708,Zac Jones,D,NYR,24,0,0,0,0
10,8481167,Brayden Pachal,D,CGY,25,0,0,0,0
10,8482067,Connor Mackey,D,NYR,28,0,0,0,0
10,8483460,David Jiricek,D,CBJ,21,0,0,0,0
10,8481701,Santeri Hatakka,D,NJD,23,0,0,0,0
10,8478021,William Lagesson,D,ANA,28,0,0,0,0
10,8477851,Jordan Oesterle,D,CGY,32,0,0,0,0
10,8478452,Caleb Jones,D,COL,27,0,0,0,0
10,8479984,Cal Foote,D,NJD,26,0,0,0,0
10,8479639,Dylan Coghlan,D,CAR,26,0,0,0,0
10,8480874,Adam Ginning,D,PHI,24,0,0,0,0
10,8479321,Lucas Johansen,D,WSH,27,0,0,0,0
10,8480878,Nils Lundkvist,D,DAL,24,0,0,0,0
10,8482165,Yan Kuznetsov,D,CGY,22,0,0,0,0
10,8484258,Sam Malinski,D,COL,26,0,0,0,0
10,8480157,Calle Rosen,D,STL,30,0,0,0,0
10,8484304,Uvis Balinskis,D,FLA,28,0,0,0,0
10,8479985,Cale Fleury,D,SEA,26,0,0,0,0
10,8479378,Logan Stanley,D,WPG,26,0,0,0,0
10,8477541,Dakota Mermis,D,MIN,30,0,0,0,0
10,8481609,Vladislav Kolyachonok,D,ARI,23,0,0,0,0
10,8480823,Alexander Alexeyev,D,WSH,25,0,0,0,0
10,8481679,Maxence Guenette,D,OTT,23,0,0,0,0
10,8481564,Ryan Johnson,D,BUF,23,0,0,0,0
10,8479376,Victor Mete,D,PHI,26,0,0,0,0
10,8484254,Akito Hirose,D,VAN,25,0,0,0,0
10,8482660,Kent Johnson,C,CBJ,22,0,0,0,0
10,8482149,Cole Perfetti,C,WPG,22,0,0,0,0
10,8477987,Ryan Donato,C,CHI,28,0,0,0,0
10,8475755,Alexander Petrovic,D,DAL,32,0,0,0,0
10,8477810,Joel Hanley,D,CGY,33,0,0,0,0
10,8474145,Robert Bortuzzo,D,NYI,35,0,0,0,0
10,8481161,Jake Christiansen,D,CBJ,25,0,0,0,0
10,8476884,Derrick Pouliot,D,DAL,30,0,0,0,0
10,8481716,Dmitri Voronkov,L,CBJ,24,0,0,0,0
10,8480084,Nick DeSimone,D,NJD,30,0,0,0,0
10,8475750,Jon Merrill,D,MIN,32,0,0,0,0
10,8479315,Joey Anderson,R,CHI,26,0,0,0,0
10,8478011,Louie Belpedio,D,PHI,28,0,0,0,0
10,8482451,Mikael Pyyhtia,L,CBJ,23,0,0,0,0
10,8481541,Samuel Bolduc,D,NYI,24,0,0,0,0
10,8482126,Emil Andrae,D,PHI,31,0,0,0,0
10,8474618,Marco Scandella,D,STL,34,0,0,0,0
10,8477244,Chad Ruhwedel,D,NYR,34,0,0,0,0
10,8477971,Andreas Englund,D,LAK,28,0,0,0,0
10,8480829,Jesperi Kotkaniemi,C,CAR,24,0,0,0,0
10,8479372,Josh Mahura,D,FLA,26,0,0,0,0
10,8482095,Tyler Kleven,D,OTT,22,0,0,0,0
10,8481719,Maxwell Crozier,D,TBL,24,0,0,0,0
10,8475855,Jesper Fast,R,CAR,33,0,0,0,0
10,8480848,Ty Dellandrea,C,DAL,24,0,0,0,0
10,8475193,Tomas Tatar,L,SEA,34,0,0,0,0
10,8476889,Radek Faksa,C,DAL,30,0,0,0,0
10,8478495,Denis Gurianov,R,PHI,27,0,0,0,0
10,8480216,Jacob Peterson,C,SJS,25,0,0,0,0
10,8480252,Cole Guttman,C,CHI,25,0,0,0,0
10,8479026,Philippe Myers,D,TBL,27,0,0,0,0
10,8481006,Tyler Tucker,D,STL,24,0,0,0,0
10,8481032,Paul Cotter,C,VGK,25,0,0,0,0
10,8481577,Philip Tomasino,C,NSH,23,0,0,0,0
10,8476918,Jimmy Vesey,L,NYR,31,0,0,0,0
10,8479320,Max Lajoie,D,TOR,27,0,0,0,0
10,8478017,Mark Friedman,D,VAN,29,0,0,0,0
10,8481754,Nikita Nesterenko,C,ANA,23,0,0,0,0
10,8483407,Brandon Scanlin,D,NYR,25,0,0,0,0
10,8482659,Josh Doan,R,ARI,22,0,0,0,0
10,8477446,Michael McCarron,R,NSH,29,0,0,0,0
10,8477903,Garnet Hathaway,R,PHI,33,0,0,0,0
10,8482153,Brendan Brisson,C,VGK,23,0,0,0,0
10,8483546,Marshall Rifai,D,TOR,26,0,0,0,0
10,8484287,Cole McWard,D,VAN,23,0,0,0,0
10,8478854,Ryan Shea,D,PIT,27,0,0,0,0
10,8481585,Egor Afanasyev,L,NSH,23,0,0,0,0
10,8483398,Declan Carlile,D,TBL,31,0,0,0,0
10,8478502,Dennis Gilbert,D,CGY,28,0,0,0,0
10,8482749,Joshua Roy,R,MTL,21,0,0,0,0
10,8481598,Philip Broberg,D,EDM,23,0,0,0,0
10,8480835,Jack Drury,C,CAR,24,0,0,0,0
10,8480748,Kiefer Sherwood,L,NSH,29,0,0,0,0
10,8476934,Brock McGinn,L,ANA,30,0,0,0,0
10,8480870,Bo Groulx,C,ANA,24,0,0,0,0
10,8479368,Max Jones,L,ANA,26,0,0,0,0
10,8478099,Kevin Labanc,R,SJS,29,0,0,0,0
10,8478067,Oskar Lindblom,L,SJS,28,0,0,0,0
10,8476393,Nick Cousins,C,FLA,31,0,0,0,0
10,8483395,Arshdeep Bains,L,VAN,23,0,0,0,0
10,8480762,Eric Robinson,L,BUF,29,0,0,0,0
10,8479439,Jacob MacDonald,D,SJS,31,0,0,0,0
10,8476474,Stefan Noesen,R,CAR,31,0,0,0,0
10,8482787,Nikita Chibrikov,R,WPG,31,0,0,0,0
10,8478432,Christian Fischer,R,DET,27,0,0,0,0
10,8477979,Nicolas Aube-Kubel,R,WSH,28,0,0,0,0
10,8481789,Tye Kartye,L,SEA,23,0,0,0,0
10,8479330,Brandon Gignac,C,MTL,27,0,0,0,0
10,8480075,Cameron Crotty,D,ARI,25,0,0,0,0
10,8473473,Milan Lucic,L,BOS,36,0,0,0,0
10,8482094,Daemon Hunt,D,MIN,22,0,0,0,0
10,8481206,John Ludvig,D,PIT,24,0,0,0,0
10,8483630,Pavol Regenda,L,ANA,25,0,0,0,0
10,8481617,Vasily Podkolzin,R,VAN,23,0,0,0,0
10,8480306,Grant Hutton,D,NYI,29,0,0,0,0
10,8480995,Pontus Holmberg,R,TOR,25,0,0,0,0
10,8482148,Hendrix Lapierre,C,WSH,22,0,0,0,0
10,8477478,William Carrier,L,VGK,30,0,0,0,0
10,8480003,Jesper Boqvist,C,BOS,26,0,0,0,0
10,8482172,Landon Slaggert,L,CHI,22,0,0,0,0
10,8480789,Oliver Wahlstrom,R,NYI,24,0,0,0,0
10,8474062,Riley Nash,C,NYR,35,0,0,0,0
10,8480021,Jack Studnicka,C,SJS,25,0,0,0,0
10,8480025,MacKenzie Entwistle,R,CHI,25,0,0,0,0
10,8481582,Nicholas Robertson,L,TOR,23,0,0,0,0
10,8476867,Brendan Gaunce,C,CBJ,30,0,0,0,0
10,8479619,Michael Carcone,L,ARI,28,0,0,0,0
10,8479370,Tyson Jost,C,BUF,26,0,0,0,0
10,8479671,Mathieu Olivier,R,CBJ,27,0,0,0,0
10,8476994,Vinnie Hinostroza,C,PIT,30,0,0,0,0
10,8482070,Mitchell Chaffee,R,TBL,26,0,0,0,0
10,8477473,Justin Bailey,R,SJS,29,0,0,0,0
10,8479344,Jesse Puljujarvi,R,PIT,26,0,0,0,0
10,8480205,Emil Bemstrom,C,PIT,25,0,0,0,0
10,8479718,Alex Barré-Boulet,C,TBL,27,0,0,0,0
10,8482061,Brandon Biro,L,BUF,26,0,0,0,0
10,8479638,Justin Brazeau,R,BOS,26,0,0,0,0
10,8474040,Sam Gagner,C,EDM,35,0,0,0,0
10,8477846,Ryan Carpenter,C,SJS,33,0,0,0,0
10,8482077,Dylan Holloway,L,EDM,23,0,0,0,0
10,8482157,Will Cuylle,L,NYR,22,0,0,0,0
10,8480007,Jonas Rondbjerg,R,VGK,25,0,0,0,0
10,8478874,Adam Gaudette,C,STL,28,0,0,0,0
10,8478434,Keegan Kolesar,R,VGK,27,0,0,0,0
10,8480441,Trey Fix-Wolansky,R,CBJ,25,0,0,0,0
10,8479994,Jaret Anderson-Dolan,C,NSH,25,0,0,0,0
10,8483567,Georgii Merkulov,C,BOS,24,0,0,0,0
10,8477380,Jonny Brodzinski,C,NYR,31,0,0,0,0
10,8482201,Gage Goncalves,C,TBL,23,0,0,0,0
10,8478211,Dryden Hunt,L,CGY,29,0,0,0,0
10,8471699,Andrew Cogliano,C,COL,37,0,0,0,0
10,8479421,Jacob Moverare,D,LAK,26,0,0,0,0
10,8478881,Brett Seney,L,CHI,28,0,0,0,0
10,8477464,Nic Petan,C,MIN,29,0,0,0,0
10,8475958,Michael Sgarbossa,C,WSH,32,0,0,0,0
10,8481147,Reese Johnson,C,CHI,26,0,0,0,0
10,8479336,Carl Grundstrom,R,LAK,27,0,0,0,0
10,8480853,Liam Foudy,C,NSH,24,0,0,0,0
10,8479522,Hardy Haman Aktell,D,WSH,26,0,0,0,0
10,8481462,Mason Morelli,L,VGK,28,0,0,0,0
10,8482102,Vasily Ponomarev,C,CAR,22,0,0,0,0
10,8480844,Grigori Denisenko,L,VGK,24,0,0,0,0
10,8479944,Zach Aston-Reese,C,DET,30,0,0,0,0
10,8482784,Zach Dean,C,STL,21,0,0,0,0
10,8479419,Brett Murray,L,BUF,26,0,0,0,0
10,8479520,Brandon Duhaime,R,COL,27,0,0,0,0
10,8477573,Nathan Walker,L,STL,30,0,0,0,0
10,8478078,Rourke Chartier,C,OTT,28,0,0,0,0
10,8475795,Dylan McIlrath,D,WSH,32,0,0,0,0
10,8482496,Nils Aman,C,VAN,24,0,0,0,0
10,8480289,Morgan Barron,C,WPG,26,0,0,0,0
10,8481751,Lukas Rousek,R,BUF,25,0,0,0,0
10,8480011,Klim Kostin,C,SJS,25,0,0,0,0
10,8481556,John Beecher,C,BOS,23,0,0,0,0
10,8475278,Byron Froese,C,VGK,33,0,0,0,0
10,8475225,Craig Smith,C,DAL,35,0,0,0,0
10,8484326,Patrik Koch,D,ARI,28,0,0,0,0
10,8477930,Pierre-Edouard Bellemare,L,SEA,39,0,0,0,0
10,8478409,Anthony Richard,C,BOS,28,0,0,0,0
10,8481024,Linus Karlsson,C,VAN,25,0,0,0,0
10,8479986,Kole Lind,R,SEA,26,0,0,0,0
10,8479414,Nathan Bastian,R,NJD,27,0,0,0,0
10,8479362,Riley Tufte,L,COL,26,0,0,0,0
10,8481058,Jesse Ylönen,R,MTL,25,0,0,0,0
10,8482476,Emil Heineman,L,MTL,23,0,0,0,0
10,8482861,Vincent Iorio,D,WSH,22,0,0,0,0
10,8483432,Luca Del Bel Belluz,C,CBJ,31,0,0,0,0
10,8482744,James Malatesta,L,CBJ,21,0,0,0,0
10,8477887,Patrick Brown,C,BOS,32,0,0,0,0
10,8478585,Derek Ryan,C,EDM,38,0,0,0,0
10,8481441,Joe Snively,C,WSH,28,0,0,0,0
10,8481592,Jakob Pelletier,L,CGY,23,0,0,0,0
10,8482634,Alex Steeves,C,TOR,25,0,0,0,0
10,8477126,Jayson Megna,C,BOS,34,0,0,0,0
10,8475752,Tyler Pitlick,C,NYR,33,0,0,0,0
10,8480008,Adam Ruzicka,C,ARI,25,0,0,0,0
10,8481065,Angus Crookshank,L,OTT,25,0,0,0,0
10,8479547,Matthew Phillips,R,WSH,26,0,0,0,0
10,8480226,Marián Studenic,R,SEA,26,0,0,0,0
10,8481237,Kyle MacLean,C,NYI,25,0,0,0,0
10,8475413,Justin Dowling,C,NJD,34,0,0,0,0
10,8481641,Joel Kiviranta,L,COL,28,0,0,0,0
10,8478104,Sammy Blais,L,STL,28,0,0,0,0
10,8477454,Adam Erne,L,EDM,29,0,0,0,0
10,8481518,Nolan Foote,L,NJD,24,0,0,0,0
10,8480245,Olle Lycksell,R,PHI,25,0,0,0,0
10,8483570,Ben Meyers,C,ANA,26,0,0,0,0
10,8480776,Sheldon Rempal,R,VGK,29,0,0,0,0
10,8483920,Pierrick Dube,R,WSH,23,0,0,0,0
10,8480267,Sammy Walker,C,MIN,25,0,0,0,0
10,8482747,Brennan Othmann,L,NYR,21,0,0,0,0
10,8479991,Jake Leschyshyn,C,NYR,25,0,0,0,0
10,8478400,Colin White,C,MTL,27,0,0,0,0
10,8479328,Julien Gauthier,R,NYI,27,0,0,0,0
10,8484325,Waltteri Merela,C,TBL,26,0,0,0,0
10,8479066,Ryan Lomberg,L,FLA,30,0,0,0,0
10,8477070,Liam O'Brien,C,ARI,30,0,0,0,0
10,8478146,Matthew Highmore,C,OTT,28,0,0,0,0
10,8478028,Fredrik Olofsson,L,COL,28,0,0,0,0
10,8480880,Jakub Lauko,C,BOS,24,0,0,0,0
10,8479968,Vinni Lettieri,C,MIN,29,0,0,0,0
10,8474709,Matt Martin,L,NYI,35,0,0,0,0
10,8480845,Rasmus Kupari,C,WPG,24,0,0,0,0
10,8481550,Adam Beckman,L,MIN,23,0,0,0,0
10,8481422,Jacob Lucchini,C,MIN,29,0,0,0,0
10,8477401,John Hayden,C,SEA,29,0,0,0,0
10,8478904,Steven Lorentz,C,FLA,28,0,0,0,0
10,8482088,Justin Sourdif,R,FLA,22,0,0,0,0
10,8482751,Ryan Winterton,C,SEA,21,0,0,0,0
10,8482241,Radim Zohorna,L,PIT,28,0,0,0,0
10,8481690,Tyler Angle,C,CBJ,24,0,0,0,0
10,8476952,Dominic Toninato,C,WPG,30,0,0,0,0
10,8476919,Chris Tierney,C,NJD,30,0,0,0,0
10,8480032,Shane Bowers,C,NJD,25,0,0,0,0
10,8484314,Jiri Smejkal,L,OTT,28,0,0,0,0
10,8481239,Samuel Fagemo,L,LAK,24,0,0,0,0
10,8481532,Alex Turcotte,C,LAK,23,0,0,0,0
10,8481019,David Gustafsson,C,WPG,24,0,0,0,0
10,8478477,Mitchell Stephens,C,MTL,27,0,0,0,0
10,8479546,Oskar Steen,C,BOS,26,0,0,0,0
10,8480292,Carson Meyer,R,CBJ,27,0,0,0,0
10,8478446,Glenn Gawdin,C,ANA,27,0,0,0,0
10,8483531,Brian Halonen,L,NJD,25,0,0,0,0
10,8477149,Scott Sabourin,R,SJS,32,0,0,0,0
10,8479972,Mason Shaw,C,MIN,26,0,0,0,0
10,8480890,Jan Jenik,R,ARI,24,0,0,0,0
10,8478051,Max Willman,C,NJD,29,0,0,0,0
10,8480851,Akil Thomas,C,LAK,24,0,0,0,0
10,8482765,Isak Rosen,R,BUF,21,0,0,0,0
10,8478421,A.J. Greer,L,CGY,28,0,0,0,0
10,8478512,Austin Czarnik,C,DET,32,0,0,0,0
10,8479536,Axel Jonsson-Fjallby,L,WPG,26,0,0,0,0
10,8477320,Anton Blidh,L,NYR,29,0,0,0,0
10,8481543,Nikita Alexandrov,C,STL,24,0,0,0,0
10,8475235,Nicolas Deslauriers,L,PHI,33,0,0,0,0
10,8481070,Hugh McGing,L,STL,26,0,0,0,0
10,8480836,Jonathan Gruden,C,PIT,24,0,0,0,0
10,8481591,Sam Poulin,R,PIT,23,0,0,0,0
10,8477962,Brendan Lemieux,L,CAR,28,0,0,0,0
10,8483401,Marc Johnstone,R,PIT,28,0,0,0,0
10,8482250,Callahan Burke,C,CAR,27,0,0,0,0
10,8481726,Adam Edstrom,C,NYR,24,0,0,0,0
10,8471817,Ryan Reaves,R,TOR,37,0,0,0,0
10,8479587,Rhett Gardner,C,PHI,28,0,0,0,0
10,8475766,Austin Watson,L,TBL,32,0,0,0,0
10,8479367,William Lockwood,R,FLA,26,0,0,0,0
10,8478424,Jansen Harkins,C,PIT,27,0,0,0,0
10,8476913,Devin Shore,C,SEA,30,0,0,0,0
10,8482652,Walker Duehr,R,CGY,27,0,0,0,0
10,8477527,Ross Johnston,L,ANA,30,0,0,0,0
10,8481077,John Leonard,L,ARI,26,0,0,0,0
10,8483549,Lucas Condotta,L,MTL,27,0,0,0,0
10,8480468,James Hamblin,L,EDM,25,0,0,0,0
10,8476907,Mackenzie MacEachern,L,STL,30,0,0,0,0
10,8479543,Michael Pezzetta,L,MTL,26,0,0,0,0
10,8480355,Mark Kastelic,C,OTT,25,0,0,0,0
10,8482162,Roby Jarventie,L,OTT,22,0,0,0,0
10,8479772,Zack MacEwen,R,OTT,28,0,0,0,0
10,8483597,Milos Kelemen,L,ARI,25,0,0,0,0
10,8479379,Givani Smith,R,SJS,26,0,0,0,0
10,8481655,Cole Schwindt,R,CGY,23,0,0,0,0
10,8479981,Jonah Gadjovich,L,FLA,26,0,0,0,0
10,8482147,Jean-Luc Foudy,C,COL,22,0,0,0,0
10,8484255,Jason Polin,R,COL,25,0,0,0,0
10,8477993,Justin Kirkland,C,ARI,28,0,0,0,0
10,8479249,Andrew Poturalski,C,SEA,30,0,0,0,0
10,8482197,Adam Raska,R,MIN,23,0,0,0,0
10,8475780,Chris Wagner,R,COL,33,0,0,0,0
10,8479533,Joona Koppanen,L,PIT,26,0,0,0,0
10,8481534,Raphael Lavoie,C,EDM,24,0,0,0,0
10,8484321,Nikolas Matinpalo,D,OTT,26,0,0,0,0
10,8481043,Cole Koepke,L,TBL,26,0,0,0,0
10,8476323,Max McCormick,L,SEA,32,0,0,0,0
10,8483609,Adam Klapka,R,CGY,24,0,0,0,0
10,8483512,Matt Savoie,C,BUF,20,0,0,0,0
10,8484259,Ondrej Pavel,C,COL,31,0,0,0,0
10,8478147,Bokondji Imama,L,OTT,28,0,0,0,0
10,8482460,Matt Rempe,C,NYR,22,0,0,0,0
10,8477073,Kurtis MacDermid,L,NJD,30,0,0,0,0
10,8480274,Philip Kemp,D,EDM,25,0,0,0,0
10,8478956,Samuel Laberge,L,NJD,27,0,0,0,0
10,8483045,Cameron Butler,R,CBJ,31,0,0,0,0
