Simulation,PlayerID,Player,Position,Team,Age,Games Played,Goals,Assists,Points
1,8477492,Nathan MacKinnon,C,COL,29,82,58,86,144
1,8477956,David Pastrnak,R,BOS,28,82,66,71,137
1,8476453,Nikita Kucherov,R,TBL,31,82,37,96,133
1,8478402,Connor McDavid,C,EDM,27,79,35,98,133
1,8478550,Artemi Panarin,L,NYR,33,81,35,87,122
1,8479318,Auston Matthews,C,TOR,27,82,53,68,121
1,8477493,Aleksander Barkov,C,FLA,29,80,35,81,116
1,8481559,Jack Hughes,C,NJD,23,75,42,63,105
1,8477404,Jake Guentzel,C,TBL,30,82,44,58,102
1,8478420,Mikko Rantanen,R,COL,28,82,39,62,101
1,8477934,Leon Draisaitl,C,EDM,29,78,39,61,100
1,8477939,William Nylander,R,TOR,28,80,37,62,99
1,8476468,J.T. Miller,C,VAN,31,76,33,66,99
1,8479314,Matthew Tkachuk,L,FLA,27,76,26,71,97
1,8480027,Jason Robertson,L,DAL,25,81,39,57,96
1,8484144,Connor Bedard,C,CHI,19,74,36,58,94
1,8480069,Cale Makar,D,COL,26,65,22,72,94
1,8478864,Kirill Kaprizov,L,MIN,27,70,43,47,90
1,8471675,Sidney Crosby,C,PIT,37,74,32,58,90
1,8478398,Kyle Connor,L,WPG,28,75,46,43,89
1,8480012,Elias Pettersson,C,VAN,26,73,36,52,88
1,8477933,Sam Reinhart,C,FLA,29,78,36,52,88
1,8480002,Nico Hischier,C,NJD,25,70,30,57,87
1,8474141,Patrick Kane,R,DET,36,80,29,58,87
1,8477946,Dylan Larkin,C,DET,28,80,35,51,86
1,8480800,Quinn Hughes,D,VAN,25,75,12,73,85
1,8480023,Robert Thomas,C,STL,25,75,29,55,84
1,8479385,Jordan Kyrou,C,STL,26,76,38,45,83
1,8477960,Adrian Kempe,R,LAK,28,81,30,52,82
1,8476887,Filip Forsberg,L,NSH,30,68,40,41,81
1,8480801,Brady Tkachuk,L,OTT,25,79,37,44,81
1,8479542,Brandon Hagel,L,TBL,26,82,36,44,80
1,8477942,Kevin Fiala,L,LAK,28,77,30,50,80
1,8482116,Tim Stützle,C,OTT,22,77,30,50,80
1,8475166,John Tavares,C,TOR,34,80,30,50,80
1,8480208,Drake Batherson,R,OTT,26,78,30,50,80
1,8478445,Mathew Barzal,C,NYI,27,78,19,59,78
1,8479325,Charlie McAvoy,D,BOS,27,74,18,59,77
1,8478439,Travis Konecny,R,PHI,27,79,35,41,76
1,8477501,Valeri Nichushkin,R,COL,29,80,42,33,75
1,8480830,Andrei Svechnikov,R,CAR,24,77,30,44,74
1,8477402,Pavel Buchnevich,L,STL,29,68,28,46,74
1,8474564,Steven Stamkos,C,NSH,34,73,23,51,74
1,8474578,Erik Karlsson,D,PIT,34,79,15,59,74
1,8479323,Adam Fox,D,NYR,26,74,14,60,74
1,8477409,Carter Verhaeghe,C,FLA,29,79,36,37,73
1,8477949,Alex Tuch,R,BUF,28,71,28,45,73
1,8473419,Brad Marchand,L,BOS,36,78,26,47,73
1,8479343,Clayton Keller,R,UTA,26,77,25,48,73
1,8480036,Miro Heiskanen,D,DAL,25,81,15,58,73
1,8478010,Brayden Point,C,TBL,28,82,30,42,72
1,8477496,Elias Lindholm,C,BOS,30,81,25,47,72
1,8480018,Nick Suzuki,C,MTL,25,75,24,48,72
1,8478449,Roope Hintz,C,DAL,28,80,25,46,71
1,8478403,Jack Eichel,C,VGK,28,78,34,36,70
1,8476399,Blake Coleman,C,CGY,33,78,31,39,70
1,8481557,Matt Boldy,L,MIN,23,73,29,41,70
1,8478440,Dylan Strome,C,WSH,27,74,21,49,70
1,8479420,Tage Thompson,C,BUF,27,73,31,38,69
1,8475172,Nazem Kadri,C,CGY,34,77,28,41,69
1,8476881,Tomas Hertl,C,VGK,31,77,24,45,69
1,8475184,Chris Kreider,L,NYR,33,74,40,28,68
1,8479337,Alex DeBrincat,R,DET,27,82,30,38,68
1,8478401,Pavel Zacha,C,BOS,27,78,24,44,68
1,8478047,Michael Bunting,L,PIT,29,73,37,30,67
1,8478444,Brock Boeser,R,VAN,27,75,27,40,67
1,8471215,Evgeni Malkin,C,PIT,38,74,26,41,67
1,8479407,Jesper Bratt,L,NJD,26,77,21,46,67
1,8471685,Anze Kopitar,C,LAK,37,82,20,47,67
1,8476853,Morgan Rielly,D,TOR,30,70,11,56,67
1,8481068,Yegor Sharangovich,C,CGY,26,73,33,33,66
1,8477504,Josh Morrissey,D,WPG,29,76,20,46,66
1,8478460,Zach Werenski,D,CBJ,27,81,10,56,66
1,8477940,Nikolaj Ehlers,L,WPG,28,77,25,40,65
1,8476459,Mika Zibanejad,C,NYR,31,77,24,41,65
1,8476882,Teuvo Teravainen,L,CHI,30,74,22,43,65
1,8477935,Sam Bennett,C,FLA,28,77,33,31,64
1,8476389,Vincent Trocheck,C,NYR,31,78,26,38,64
1,8473512,Claude Giroux,R,OTT,36,79,22,42,64
1,8474600,Roman Josi,D,NSH,34,77,16,48,64
1,8475786,Zach Hyman,L,EDM,32,82,34,29,63
1,8471214,Alex Ovechkin,L,WSH,39,72,29,34,63
1,8480839,Rasmus Dahlin,D,BUF,24,72,22,41,63
1,8475167,Victor Hedman,D,TBL,34,80,10,53,63
1,8476460,Mark Scheifele,C,WPG,31,73,26,36,62
1,8475913,Mark Stone,R,VGK,32,76,24,38,62
1,8481540,Cole Caufield,R,MTL,23,73,26,35,61
1,8484153,Leo Carlsson,C,ANA,20,70,25,36,61
1,8475158,Ryan O'Reilly,C,NSH,33,75,19,42,61
1,8476456,Jonathan Huberdeau,C,CGY,31,76,18,43,61
1,8479425,Filip Hronek,D,VAN,27,76,9,52,61
1,8478397,Rasmus Andersson,D,CGY,28,69,9,52,61
1,8476539,Jonathan Marchessault,R,NSH,34,72,33,27,60
1,8480039,Martin Necas,C,CAR,25,71,31,29,60
1,8477500,Bo Horvat,C,NYI,29,80,27,33,60
1,8477494,Jonathan Drouin,L,COL,29,80,21,39,60
1,8480014,Gabriel Vilardi,C,WPG,25,71,32,27,59
1,8475810,Bryan Rust,R,PIT,32,69,30,29,59
1,8478427,Sebastian Aho,C,CAR,27,70,27,32,59
1,8477951,Nick Schmaltz,C,UTA,28,77,27,32,59
1,8482699,Dylan Guenther,R,UTA,21,74,23,36,59
1,8480803,Evan Bouchard,D,EDM,25,72,8,51,59
1,8482124,Quinton Byfield,R,LAK,22,80,25,33,58
1,8475765,Vladimir Tarasenko,R,DET,33,81,24,34,58
1,8473994,Jamie Benn,L,DAL,35,82,22,36,58
1,8476454,Ryan Nugent-Hopkins,C,EDM,31,79,13,45,58
1,8475692,Mats Zuccarello,R,MIN,37,76,12,46,58
1,8482109,Alexis Lafrenière,L,NYR,23,77,29,28,57
1,8475754,Brock Nelson,C,NYI,33,78,28,29,57
1,8479675,Trevor Moore,L,LAK,29,82,27,30,57
1,8478414,Timo Meier,R,NJD,28,71,23,34,57
1,8475745,Charlie Coyle,C,BOS,32,80,21,36,57
1,8482684,Luke Hughes,D,NJD,21,71,7,50,57
1,8478493,Joel Eriksson Ek,C,MIN,27,71,35,21,56
1,8475794,Tyler Seguin,C,DAL,32,81,28,28,56
1,8482740,Wyatt Johnston,C,DAL,21,81,28,28,56
1,8482078,Lucas Raymond,L,DET,22,82,26,30,56
1,8475168,Matt Duchene,C,DAL,33,81,25,31,56
1,8480015,Owen Tippett,R,PHI,25,75,22,34,56
1,8482093,Seth Jarvis,C,CAR,22,67,28,27,55
1,8483431,Logan Cooley,C,UTA,20,73,25,30,55
1,8477416,Oliver Bjorkstrand,R,SEA,29,78,24,31,55
1,8478873,Troy Terry,R,ANA,27,74,21,34,55
1,8474586,Jordan Eberle,R,SEA,34,76,20,35,55
1,8475170,Brayden Schenn,C,STL,33,75,15,40,55
1,8476346,Johnny Gaudreau,L,CBJ,31,65,13,42,55
1,8477447,Shea Theodore,D,VGK,29,64,9,46,55
1,8478519,Anthony Cirelli,C,TBL,27,81,27,27,54
1,8482745,Mason McTavish,C,ANA,21,75,17,37,54
1,8481711,Matias Maccelli,L,UTA,24,73,16,38,54
1,8475798,Mikael Granlund,C,SJS,32,63,12,42,54
1,8470613,Brent Burns,D,CAR,39,69,9,45,54
1,8478469,Thomas Chabot,D,OTT,27,76,9,45,54
1,8477955,Jared McCann,L,SEA,28,78,29,24,53
1,8478438,Tommy Novak,C,NSH,27,70,28,25,53
1,8477407,Anthony Duclair,L,NYI,29,82,21,32,53
1,8483515,Juraj Slafkovsky,L,MTL,20,76,19,34,53
1,8478498,Jake DeBrusk,L,VAN,28,72,25,27,52
1,8478856,Conor Garland,R,VAN,28,73,22,30,52
1,8476448,William Karlsson,C,VGK,31,72,15,37,52
1,8481542,Moritz Seider,D,DET,23,76,11,41,52
1,8480434,Sean Durzi,D,UTA,26,73,14,37,51
1,8476792,Torey Krug,D,STL,33,76,11,40,51
1,8477346,MacKenzie Weegar,D,CGY,30,75,8,43,51
1,8475169,Evander Kane,L,EDM,33,76,31,19,50
1,8478366,Frank Vatrano,R,ANA,30,71,29,21,50
1,8478975,Mason Marchment,L,DAL,29,82,25,25,50
1,8474641,Adam Henrique,C,EDM,34,78,25,25,50
1,8477021,Alex Kerfoot,C,UTA,30,73,20,30,50
1,8476479,Phillip Danault,C,LAK,31,81,18,32,50
1,8474679,Gustav Nyquist,C,NSH,35,71,16,34,50
1,8476462,Dougie Hamilton,D,NJD,31,71,15,35,50
1,8477495,Seth Jones,D,CHI,30,71,15,35,50
1,8478407,Vince Dunn,D,SEA,28,70,12,38,50
1,8480865,Noah Dobson,D,NYI,24,80,7,43,50
1,8477476,Artturi Lehkonen,L,COL,29,82,30,19,49
1,8475314,Anders Lee,L,NYI,34,81,26,23,49
1,8480064,Josh Norris,C,OTT,25,76,25,24,49
1,8479365,Trent Frederic,C,BOS,26,74,24,25,49
1,8482665,Matty Beniers,C,SEA,22,72,20,29,49
1,8480028,Morgan Frost,C,PHI,25,73,16,33,49
1,8479345,Jakob Chychrun,D,WSH,26,68,13,36,49
1,8482105,Jake Sanderson,D,OTT,22,76,13,36,49
1,8476875,Mike Matheson,D,MTL,30,71,12,37,49
1,8477497,Sean Monahan,C,CBJ,30,70,23,25,48
1,8475151,Kyle Palmieri,C,NYI,33,77,23,25,48
1,8482159,Tyson Foerster,R,PHI,22,80,18,30,48
1,8474150,Mikael Backlund,C,CGY,35,71,15,33,48
1,8483808,Andrei Kuzmenko,L,CGY,28,75,26,21,47
1,8479992,Michael Rasmussen,C,DET,25,76,26,21,47
1,8482110,Dawson Mercer,C,NJD,23,69,26,21,47
1,8481560,Arthur Kaliyev,R,LAK,23,76,24,23,47
1,8482720,Matthew Knies,L,TOR,22,76,23,24,47
1,8481528,Dylan Cozens,C,BUF,23,70,22,25,47
1,8475726,Tyler Toffoli,C,SJS,32,73,19,28,47
1,8477964,Ivan Barbashev,C,VGK,29,77,18,29,47
1,8476905,Chandler Stephenson,C,SEA,30,72,12,35,47
1,8481535,Nils Hoglander,L,VAN,24,75,23,23,46
1,8477479,Tyler Bertuzzi,L,CHI,29,76,17,29,46
1,8482667,William Eklund,L,SJS,22,68,15,31,46
1,8477503,Max Domi,C,TOR,29,80,13,33,46
1,8475784,Jeff Skinner,C,EDM,32,77,13,33,46
1,8478396,Noah Hanifin,D,VGK,27,56,11,35,46
1,8480798,Philipp Kurashev,C,CHI,25,69,11,35,46
1,8479999,Casey Mittelstadt,C,COL,26,81,10,36,46
1,8477932,Aaron Ekblad,D,FLA,28,69,10,36,46
1,8480797,Joel Farabee,L,PHI,24,70,23,22,45
1,8477511,Anthony Mantha,R,CGY,30,75,22,23,45
1,8474102,David Perron,L,OTT,36,76,16,29,45
1,8477456,J.T. Compher,L,DET,29,80,17,27,44
1,8471724,Kris Letang,D,PIT,37,79,11,33,44
1,8474563,Drew Doughty,D,LAK,35,73,8,36,44
1,8476432,Boone Jenner,C,CBJ,31,68,30,13,43
1,8479525,Ross Colton,C,COL,28,79,24,19,43
1,8473986,Alex Killorn,L,ANA,35,73,21,22,43
1,8480188,Fabian Zetterlund,L,SJS,25,71,20,23,43
1,8477429,Andrew Copp,C,DET,30,79,19,24,43
1,8477986,Brandon Montour,D,SEA,30,74,12,31,43
1,8478038,Devon Toews,D,COL,30,68,4,39,43
1,8475799,Nino Niederreiter,R,WPG,32,76,23,19,42
1,8482149,Cole Perfetti,C,WPG,22,70,18,24,42
1,8475191,Reilly Smith,R,NYR,33,75,17,25,42
1,8477998,Warren Foegele,L,LAK,28,77,16,26,42
1,8480220,Noah Cates,L,PHI,25,71,16,26,42
1,8474590,John Carlson,D,WSH,34,65,12,30,42
1,8476438,Brandon Saad,L,STL,32,72,20,21,41
1,8478462,Nicolas Roy,C,VGK,27,78,17,24,41
1,8477426,Nicholas Paul,L,TBL,29,82,17,24,41
1,8481618,Alex Newhook,C,MTL,23,71,14,27,41
1,8482671,Owen Power,D,BUF,22,68,8,33,41
1,8481604,Pavel Dorofeyev,L,VGK,24,65,22,18,40
1,8480995,Pontus Holmberg,R,TOR,25,72,21,19,40
1,8484166,Adam Fantilli,C,CBJ,20,67,20,20,40
1,8480829,Jesperi Kotkaniemi,C,CAR,24,68,19,21,40
1,8482097,Jack Quinn,R,BUF,23,63,17,23,40
1,8478233,Andrew Mangiapane,L,WSH,28,71,17,23,40
1,8480802,Ryan McLeod,C,BUF,25,68,17,23,40
1,8476872,Scott Laughton,C,PHI,30,75,16,24,40
1,8478472,Mathieu Joseph,R,STL,27,71,12,28,40
1,8476461,Sean Couturier,C,PHI,32,67,12,28,40
1,8476906,Shayne Gostisbehere,D,CAR,31,75,10,30,40
1,8478042,Viktor Arvidsson,R,EDM,31,73,19,20,39
1,8481582,Nicholas Robertson,L,TOR,23,75,19,20,39
1,8480459,Pius Suter,C,VAN,28,66,18,21,39
1,8483505,Matthew Poitras,C,BOS,20,76,17,22,39
1,8478474,Lawson Crouse,L,UTA,27,74,15,24,39
1,8477444,Andre Burakovsky,L,SEA,29,74,13,26,39
1,8482113,Anton Lundell,C,FLA,23,76,13,26,39
1,8479400,Pierre-Luc Dubois,L,WSH,26,69,13,26,39
1,8478507,John Marino,D,UTA,27,70,7,32,39
1,8481554,Kaapo Kakko,R,NYR,23,73,24,14,38
1,8475287,Erik Haula,L,NJD,33,71,23,15,38
1,8475760,Nick Bjugstad,C,UTA,32,72,23,15,38
1,8477425,Miles Wood,L,COL,29,81,19,19,38
1,8479339,Patrik Laine,L,CBJ,26,67,18,20,38
1,8482475,Yegor Chinakhov,R,CBJ,23,61,17,21,38
1,8481186,Logan O'Connor,R,COL,28,81,17,21,38
1,8478046,Danton Heinen,L,VAN,29,67,16,22,38
1,8481656,Aliaksei Protas,C,WSH,23,57,15,23,38
1,8478458,Jack Roslovic,C,CAR,27,68,14,24,38
1,8482702,Logan Stankoven,C,DAL,21,79,14,24,38
1,8476458,Ryan Strome,C,ANA,31,68,13,25,38
1,8482705,Cole Sillinger,C,CBJ,21,73,12,26,38
1,8481703,Valtteri Puustinen,R,PIT,25,65,7,31,38
1,8479410,Mikhail Sergachev,D,UTA,26,66,6,32,38
1,8475763,Kevin Hayes,R,PIT,32,67,22,15,37
1,8482089,Jake Neighbours,L,STL,22,69,21,16,37
1,8478109,Victor Olofsson,L,VGK,29,71,20,17,37
1,8475218,Mattias Ekholm,D,EDM,34,74,14,23,37
1,8476480,Vladislav Namestnikov,C,WPG,32,70,9,28,37
1,8475764,Cam Fowler,D,ANA,33,72,8,29,37
1,8474715,Cam Atkinson,R,TBL,35,80,20,16,36
1,8475714,Calle Jarnkrok,C,TOR,33,80,19,17,36
1,8478020,Michael Amadio,C,OTT,28,74,19,17,36
1,8476483,Rickard Rakell,R,PIT,31,70,17,19,36
1,8478542,Evan Rodrigues,C,FLA,31,79,16,20,36
1,8476826,Yanni Gourde,C,SEA,33,76,15,21,36
1,8475753,Justin Faulk,D,STL,32,67,11,25,36
1,8476869,Brady Skjei,D,NSH,30,72,11,25,36
1,8477969,Marcus Pettersson,D,PIT,28,79,7,29,36
1,8480043,Timothy Liljegren,D,TOR,25,71,3,33,36
1,8478115,Pierre Engvall,L,NYI,28,79,20,15,35
1,8476880,Tom Wilson,R,WSH,30,68,16,19,35
1,8477451,Ryan Hartman,R,MIN,30,70,15,20,35
1,8481596,Shane Pinto,C,OTT,24,77,11,24,35
1,8478055,Gustav Forsling,D,FLA,28,73,10,25,35
1,8480145,Neal Pionk,D,WPG,29,72,9,26,35
1,8483445,Cutter Gauthier,L,ANA,20,70,9,26,35
1,8483490,Pavel Mintyukov,D,ANA,21,73,8,27,35
1,8481581,Thomas Harley,D,DAL,23,80,8,27,35
1,8475722,Jason Zucker,L,BUF,32,72,21,13,34
1,8471698,T.J. Oshie,R,WSH,38,68,18,16,34
1,8476392,Adam Lowry,C,WPG,31,68,16,18,34
1,8475848,Brendan Gallagher,R,MTL,32,69,16,18,34
1,8482175,JJ Peterka,R,BUF,22,63,16,18,34
1,8480068,Ryan Poehling,C,PHI,25,70,16,18,34
1,8480185,Eetu Luostarinen,C,FLA,26,72,13,21,34
1,8476925,Colton Sissons,C,NSH,31,68,13,21,34
1,8479987,Morgan Geekie,C,BOS,26,74,11,23,34
1,8476292,Ondrej Palat,L,NJD,33,67,10,24,34
1,8484145,Zach Benson,L,BUF,19,70,9,25,34
1,8479591,Michael Eyssimont,C,TBL,28,81,15,18,33
1,8477953,Kasperi Kapanen,R,STL,28,68,15,18,33
1,8480003,Jesper Boqvist,C,FLA,26,68,15,18,33
1,8476474,Stefan Noesen,R,NJD,31,75,13,20,33
1,8477989,Christian Dvorak,C,MTL,28,67,13,20,33
1,8474149,Evgenii Dadonov,R,DAL,35,81,12,21,33
1,8481533,Trevor Zegras,C,ANA,23,68,11,22,33
1,8478891,Mason Appleton,C,WPG,28,56,6,27,33
1,8482092,Ridly Greig,C,OTT,22,77,17,15,32
1,8478466,Daniel Sprong,R,VAN,27,66,16,16,32
1,8478057,Dakota Joshua,C,VAN,28,66,16,16,32
1,8479661,Tanner Jeannot,L,LAK,27,76,15,17,32
1,8475768,Jaden Schwartz,C,SEA,32,75,14,18,32
1,8477450,Jason Dickinson,C,CHI,29,65,14,18,32
1,8475793,Ryan Johansen,C,PHI,32,73,13,19,32
1,8475171,Oliver Ekman-Larsson,D,TOR,33,67,11,21,32
1,8475149,Marcus Johansson,L,MIN,34,63,11,21,32
1,8476419,Jean-Gabriel Pageau,C,NYI,32,73,11,21,32
1,8474053,Logan Couture,C,SJS,35,64,11,21,32
1,8481606,Jordan Spence,D,LAK,23,71,10,22,32
1,8476923,Damon Severson,D,CBJ,30,78,9,23,32
1,8480855,Jack McBain,C,UTA,24,69,17,14,31
1,8480009,Eeli Tolvanen,R,SEA,25,65,16,15,31
1,8473422,Nick Foligno,L,CHI,37,61,15,16,31
1,8482660,Kent Johnson,C,CBJ,22,57,11,20,31
1,8482146,Luke Evangelista,R,NSH,22,70,11,20,31
1,8476958,Jaccob Slavin,D,CAR,30,76,9,22,31
1,8484203,Bradly Nadeau,L,CAR,19,63,9,22,31
1,8476854,Hampus Lindholm,D,BOS,30,68,7,24,31
1,8482122,Brock Faber,D,MIN,22,77,7,24,31
1,8476979,Erik Gustafsson,D,DET,32,76,4,27,31
1,8482117,Lukas Reichel,L,CHI,22,55,12,18,30
1,8476921,Jordan Martinook,L,CAR,32,60,12,18,30
1,8478463,Anthony Beauvillier,L,PIT,27,66,10,20,30
1,8480817,K'Andre Miller,D,NYR,24,75,8,22,30
1,8477488,Brett Pesce,D,NJD,30,67,8,22,30
1,8474565,Alex Pietrangelo,D,VGK,34,61,7,23,30
1,8479402,Jake Bean,D,CGY,26,67,7,23,30
1,8480336,Sean Walker,D,CAR,30,74,7,23,30
1,8478970,Jalen Chatfield,D,CAR,28,69,5,25,30
1,8476422,Mike Reilly,D,NYI,31,76,4,26,30
1,8477948,Travis Sanheim,D,PHI,28,76,3,27,30
1,8476278,Colin Blackwell,C,DAL,31,79,18,11,29
1,8480849,Barrett Hayton,C,UTA,24,70,16,13,29
1,8482074,Connor Zary,C,CGY,23,67,16,13,29
1,8479353,Brett Howden,C,VGK,26,69,14,15,29
1,8480871,Adam Boqvist,D,FLA,24,73,11,18,29
1,8482749,Joshua Roy,R,MTL,21,64,11,18,29
1,8482101,Danil Gushchin,L,SJS,22,60,11,18,29
1,8476885,Jacob Trouba,D,NYR,30,72,10,19,29
1,8476917,Adam Pelech,D,NYI,30,75,8,21,29
1,8476892,Colton Parayko,D,STL,31,70,3,26,29
1,8480281,Alexey Toropchenko,R,STL,25,56,19,9,28
1,8479293,Brandon Tanev,L,SEA,33,70,15,13,28
1,8480893,Kirill Marchenko,R,CBJ,24,59,15,13,28
1,8482125,Alexander Holtz,R,VGK,22,70,13,15,28
1,8477952,Robby Fabbri,C,ANA,28,63,12,16,28
1,8481523,Kirby Dach,C,MTL,23,71,9,19,28
1,8482133,Thomas Bordeleau,C,SJS,22,64,8,20,28
1,8483565,Nick Blankenburg,D,NSH,26,65,8,20,28
1,8475231,Casey Cizikas,C,NYI,33,72,18,9,27
1,8476469,Joel Armia,R,MTL,31,66,15,12,27
1,8479619,Michael Carcone,L,UTA,28,59,14,13,27
1,8481577,Philip Tomasino,C,NSH,23,68,12,15,27
1,8477987,Ryan Donato,C,CHI,28,60,12,15,27
1,8480813,Joe Veleno,C,DET,24,76,11,16,27
1,8479351,Sam Steel,C,DAL,26,78,9,18,27
1,8482111,Justin Barron,D,MTL,23,65,9,18,27
1,8482624,Daniil Miromanov,D,CGY,27,66,8,19,27
1,8477506,Ryan Pulock,D,NYI,30,79,6,21,27
1,8473507,Jeff Petry,D,DET,37,72,5,22,27
1,8478136,Jake Middleton,D,MIN,28,76,4,23,27
1,8479983,Mario Ferraro,D,SJS,26,66,4,23,27
1,8478013,Jake Walman,D,SJS,28,74,16,10,26
1,8482803,Olen Zellweger,D,ANA,21,70,15,11,26
1,8480448,Parker Kelly,L,COL,25,72,14,12,26
1,8476981,Josh Anderson,R,MTL,30,71,14,12,26
1,8480748,Kiefer Sherwood,L,VAN,29,66,13,13,26
1,8481553,Bobby Brink,R,PHI,23,58,13,13,26
1,8478432,Christian Fischer,R,DET,27,75,13,13,26
1,8473563,Nicklas Backstrom,C,WSH,37,50,10,16,26
1,8482142,Jamie Drysdale,D,PHI,22,68,10,16,26
1,8479982,Conor Timmins,D,TOR,26,63,8,18,26
1,8475220,Marcus Foligno,L,MIN,33,57,6,20,26
1,8474574,Tyler Myers,D,VAN,34,67,1,25,26
1,8479336,Carl Grundstrom,R,SJS,27,49,16,9,25
1,8473533,Jordan Staal,C,CAR,36,60,14,11,25
1,8477947,Sonny Milano,L,WSH,28,67,13,12,25
1,8480078,Filip Chytil,C,NYR,25,58,13,12,25
1,8482055,Drew O'Connor,L,PIT,26,64,13,12,25
1,8477507,Nikita Zadorov,D,BOS,29,65,11,14,25
1,8478043,Sam Lafferty,C,BUF,29,67,11,14,25
1,8477353,Tyler Motte,C,DET,29,70,11,14,25
1,8481477,Nico Sturm,C,SJS,29,58,11,14,25
1,8480222,Sebastian Aho,D,PIT,28,73,7,18,25
1,8476429,Scott Mayfield,D,NYI,32,73,7,18,25
1,8476457,Adam Larsson,D,SEA,32,63,6,19,25
1,8479398,Samuel Girard,D,COL,26,64,4,21,25
1,8478500,Ivan Provorov,D,CBJ,27,77,4,21,25
1,8476331,Dylan DeMelo,D,WPG,31,67,4,21,25
1,8479393,Noah Gregor,C,OTT,26,69,15,9,24
1,8470621,Corey Perry,R,EDM,39,72,14,10,24
1,8479414,Nathan Bastian,R,NJD,27,60,14,10,24
1,8479315,Joey Anderson,R,CHI,26,50,13,11,24
1,8478434,Keegan Kolesar,R,VGK,27,69,11,13,24
1,8481624,Ilya Mikheyev,R,CHI,30,61,10,14,24
1,8476988,Matt Benning,D,SJS,30,59,10,14,24
1,8480144,David Kampf,C,TOR,29,75,10,14,24
1,8481580,Connor McMichael,C,WSH,23,61,10,14,24
1,8483468,Jiri Kulich,C,BUF,20,60,7,17,24
1,8475200,Dmitry Orlov,D,CAR,33,73,6,18,24
1,8476902,Esa Lindell,D,DAL,30,81,6,18,24
1,8482712,Oskar Olausson,R,COL,22,76,6,18,24
1,8478882,Vladislav Gavrikov,D,LAK,29,67,5,19,24
1,8478416,Erik Cernak,D,TBL,27,75,4,20,24
1,8479996,Cody Glass,C,NSH,25,58,15,8,23
1,8476878,Zemgus Girgensons,L,TBL,30,80,14,9,23
1,8479316,Luke Kunin,C,SJS,27,59,14,9,23
1,8476927,Teddy Blueger,C,VAN,30,65,12,11,23
1,8479368,Max Jones,L,BOS,26,63,12,11,23
1,8482679,Matt Coronato,R,CGY,22,64,12,11,23
1,8482148,Hendrix Lapierre,C,WSH,22,58,11,12,23
1,8479344,Jesse Puljujarvi,R,PIT,26,58,11,12,23
1,8476918,Jimmy Vesey,L,NYR,31,63,11,12,23
1,8483493,Frank Nazar,C,CHI,20,53,10,13,23
1,8476624,Barclay Goodrow,C,SJS,31,53,8,15,23
1,8479639,Dylan Coghlan,D,WPG,26,60,6,17,23
1,8475324,Nick Jensen,D,OTT,34,64,5,18,23
1,8477220,Nate Schmidt,D,FLA,33,66,4,19,23
1,8478911,Matt Roy,D,WSH,29,67,4,19,23
1,8478443,Brandon Carlo,D,BOS,28,63,4,19,23
1,8479324,Ryan Lindgren,D,NYR,26,62,3,20,23
1,8482807,Ethan Del Mastro,D,CHI,21,52,10,12,22
1,8477498,Darnell Nurse,D,EDM,29,74,7,15,22
1,8480074,Alexandre Texier,C,STL,25,66,7,15,22
1,8477435,Ryan Graves,D,PIT,29,76,6,16,22
1,8482087,Kaiden Guhle,D,MTL,22,65,6,16,22
1,8481546,Cam York,D,PHI,23,65,4,18,22
1,8476463,Jonas Brodin,D,MIN,31,71,4,18,22
1,8478133,Jake Evans,C,MTL,28,64,4,18,22
1,8480873,Rasmus Sandin,D,WSH,24,62,3,19,22
1,8478851,Alexandre Carrier,D,NSH,28,62,3,19,22
1,8482259,Bobby McMann,C,TOR,28,72,14,7,21
1,8482079,Marco Rossi,C,MIN,23,56,12,9,21
1,8478211,Dryden Hunt,L,CGY,29,59,12,9,21
1,8480835,Jack Drury,C,CAR,24,56,10,11,21
1,8477478,William Carrier,L,CAR,30,61,7,14,21
1,8482655,J.J. Moser,D,TBL,24,77,6,15,21
1,8480113,Alex Iafallo,L,WPG,31,63,6,15,21
1,8481481,Blake Lizotte,C,PIT,27,56,6,15,21
1,8478840,Will Borgen,D,SEA,28,63,4,17,21
1,8474716,Jared Spurgeon,D,MIN,35,76,4,17,21
1,8475690,Chris Tanev,D,TOR,35,58,4,17,21
1,8480073,Erik Brannstrom,D,COL,25,59,2,19,21
1,8482073,Braden Schneider,D,NYR,23,60,1,20,21
1,8476897,Oskar Sundqvist,C,STL,30,63,12,8,20
1,8477446,Michael McCarron,R,NSH,29,59,11,9,20
1,8480980,Connor Dewar,C,TOR,25,76,11,9,20
1,8478508,Yakov Trenin,C,MIN,27,59,9,11,20
1,8479370,Tyson Jost,C,CAR,26,49,8,12,20
1,8483457,Lane Hutson,D,MTL,20,71,8,12,20
1,8474189,Lars Eller,C,PIT,35,64,7,13,20
1,8480878,Nils Lundkvist,D,DAL,24,77,6,14,20
1,8475791,Taylor Hall,L,CHI,33,56,6,14,20
1,8475233,David Savard,D,MTL,34,62,6,14,20
1,8481521,Ronnie Attard,D,PHI,25,55,6,14,20
1,8481567,Henry Thrun,D,SJS,23,56,6,14,20
1,8479369,Andrew Peeke,D,BOS,26,60,5,15,20
1,8474151,Ryan McDonagh,D,TBL,35,76,2,18,20
1,8481178,Egor Zamula,D,PHI,24,54,2,18,20
1,8475790,Erik Gudbranson,D,CBJ,32,77,2,18,20
1,8476960,Andreas Athanasiou,C,CHI,30,51,10,9,19
1,8481704,Juuso Parssinen,C,NSH,23,55,10,9,19
1,8477839,Conor Sheary,L,TBL,32,80,8,11,19
1,8479026,Philippe Myers,D,TOR,27,52,8,11,19
1,8481537,Nikita Okhotiuk,D,CGY,24,45,8,11,19
1,8479390,Taylor Raddysh,R,WSH,26,63,8,11,19
1,8479968,Vinni Lettieri,C,BOS,29,50,8,11,19
1,8480205,Emil Bemstrom,C,PIT,25,51,7,12,19
1,8477979,Nicolas Aube-Kubel,R,BUF,28,49,7,12,19
1,8482192,Isaak Phillips,D,CHI,23,47,6,13,19
1,8480891,Michael Kesselring,D,UTA,24,52,6,13,19
1,8477508,Curtis Lazar,C,NJD,29,64,6,13,19
1,8476467,Jamie Oleksiak,D,SEA,32,71,5,14,19
1,8476931,Jake McCabe,D,TOR,31,62,4,15,19
1,8479998,Mikey Anderson,D,LAK,25,67,4,15,19
1,8477392,Hudson Fasching,R,NYI,29,68,4,15,19
1,8481568,Alex Vlasic,D,CHI,23,53,3,16,19
1,8475455,Brenden Dillon,D,NJD,34,59,3,16,19
1,8475462,Radko Gudas,D,ANA,34,65,2,17,19
1,8480049,Dylan Samberg,D,WPG,25,61,1,18,19
1,8474673,TJ Brodie,D,CHI,34,59,1,18,19
1,8482157,Will Cuylle,L,NYR,22,61,12,6,18
1,8482659,Josh Doan,R,UTA,22,59,10,8,18
1,8477406,Mattias Janmark,C,EDM,32,64,9,9,18
1,8476934,Brock McGinn,L,ANA,30,57,9,9,18
1,8482166,Shakir Mukhamadullin,D,SJS,22,61,9,9,18
1,8477931,Tomas Nosek,L,FLA,32,57,8,10,18
1,8478413,Jordan Greenway,L,BUF,27,63,7,11,18
1,8482062,Cole Smith,L,NSH,29,63,6,12,18
1,8482784,Zach Dean,C,STL,21,46,6,12,18
1,8483466,Kevin Korchinski,D,CHI,20,46,5,13,18
1,8476891,Matt Grzelcyk,D,PIT,30,74,2,16,18
1,8481014,Alexander Romanov,D,NYI,24,73,0,18,18
1,8481716,Dmitri Voronkov,L,CBJ,24,57,13,4,17
1,8482737,Zack Bolduc,C,STL,21,56,10,7,17
1,8479359,Beck Malenstyn,L,BUF,26,49,10,7,17
1,8479066,Ryan Lomberg,L,CGY,30,63,10,7,17
1,8483491,Ivan Miroshnichenko,L,WSH,20,54,8,9,17
1,8482666,Scott Morrow,D,CAR,22,56,8,9,17
1,8475343,Nic Dowd,C,WSH,34,57,7,10,17
1,8475855,Jesper Fast,R,CAR,33,58,5,12,17
1,8475179,Dmitry Kulikov,D,FLA,34,59,5,12,17
1,8482634,Alex Steeves,C,TOR,25,67,4,13,17
1,8475718,Justin Holl,D,DET,32,59,3,14,17
1,8480887,Jordan Harris,D,MTL,24,61,3,14,17
1,8479976,Juuso Valimaki,D,UTA,26,61,2,15,17
1,8478178,Darren Raddysh,D,TBL,28,64,2,15,17
1,8480950,Ilya Lyubushkin,D,DAL,30,76,2,15,17
1,8476312,Josh Manson,D,COL,33,62,1,16,17
1,8475188,Brayden McNabb,D,VGK,33,51,1,16,17
1,8475181,Nick Leddy,D,STL,33,64,0,17,17
1,8476889,Radek Faksa,C,STL,30,53,9,7,16
1,8481093,Rafael Harvey-Pinard,L,MTL,25,57,9,7,16
1,8481032,Paul Cotter,C,NJD,25,54,9,7,16
1,8480789,Oliver Wahlstrom,R,NYI,24,66,8,8,16
1,8479941,Justin Danforth,R,CBJ,31,61,8,8,16
1,8477015,Connor Brown,R,EDM,30,61,8,8,16
1,8482859,Zack Ostapchuk,C,OTT,21,64,7,9,16
1,8479718,Alex Barré-Boulet,C,MTL,27,50,7,9,16
1,8482730,Brandt Clarke,D,LAK,21,49,7,9,16
1,8477919,Frederick Gaudreau,C,MIN,31,60,6,10,16
1,8476873,Mark Jankowski,C,NSH,30,45,6,10,16
1,8480289,Morgan Barron,C,WPG,26,55,6,10,16
1,8483524,Shane Wright,C,SEA,20,59,5,11,16
1,8481522,Peyton Krebs,C,BUF,23,56,5,11,16
1,8480001,Urho Vaakanainen,D,ANA,25,57,5,11,16
1,8481013,Jonatan Berggren,R,DET,24,62,5,11,16
1,8483482,Tristan Luneau,D,ANA,20,58,4,12,16
1,8480355,Mark Kastelic,C,BOS,25,54,4,12,16
1,8475279,Ben Chiarot,D,DET,33,64,4,12,16
1,8483495,Simon Nemec,D,NJD,20,59,4,12,16
1,8475177,Calvin de Haan,D,COL,33,54,3,13,16
1,8481524,Bowen Byram,D,BUF,23,50,3,13,16
1,8480172,Jan Rutta,D,SJS,34,58,2,14,16
1,8474013,Ian Cole,D,UTA,35,55,2,14,16
1,8479520,Brandon Duhaime,R,WSH,27,59,10,5,15
1,8477573,Nathan Walker,L,STL,30,52,8,7,15
1,8480762,Eric Robinson,L,CAR,29,54,7,8,15
1,8481517,Brett Leason,R,ANA,25,50,7,8,15
1,8481592,Jakob Pelletier,L,CGY,23,46,7,8,15
1,8475193,Tomas Tatar,L,NJD,34,64,6,9,15
1,8476525,Colin Miller,D,WPG,32,66,6,9,15
1,8479328,Julien Gauthier,R,NYI,27,59,6,9,15
1,8480192,Johnathan Kovacevic,D,NJD,27,53,6,9,15
1,8477018,Ben Hutton,D,VGK,31,50,5,10,15
1,8480727,Zach Whitecloud,D,VGK,28,47,5,10,15
1,8477369,Carson Soucy,D,VAN,30,62,5,10,15
1,8480035,Henri Jokiharju,D,BUF,25,62,2,13,15
1,8477365,Connor Clifton,D,BUF,29,57,2,13,15
1,8476874,Olli Maatta,D,DET,30,61,2,13,15
1,8475208,Brian Dumoulin,D,ANA,33,61,2,13,15
1,8482245,Artem Zub,D,OTT,29,74,1,14,15
1,8480070,Ian Mitchell,D,BOS,25,42,1,14,15
1,8481059,Scott Perunovich,D,STL,26,60,0,15,15
1,8480246,Nick Perbix,D,TBL,26,74,0,15,15
1,8480021,Jack Studnicka,C,LAK,25,58,8,6,14
1,8481601,Simon Holmstrom,R,NYI,23,66,8,6,14
1,8478569,Noel Acciari,C,PIT,33,55,7,7,14
1,8471817,Ryan Reaves,R,TOR,37,62,7,7,14
1,8478831,Kevin Stenlund,C,UTA,28,54,7,7,14
1,8479439,Jacob MacDonald,D,COL,31,48,6,8,14
1,8482176,Wyatt Kaiser,D,CHI,22,58,5,9,14
1,8481161,Jake Christiansen,D,CBJ,25,55,5,9,14
1,8480252,Cole Guttman,C,CHI,25,39,5,9,14
1,8477499,Rasmus Ristolainen,D,PHI,30,62,4,10,14
1,8481028,Martin Pospisil,C,CGY,25,54,4,10,14
1,8478451,Ethan Bear,D,WSH,27,58,3,11,14
1,8480806,Isac Lundestrom,C,ANA,25,46,8,5,13
1,8482762,Simon Edvinsson,D,DET,21,51,8,5,13
1,8481641,Joel Kiviranta,L,COL,28,67,7,6,13
1,8482809,Jackson Blake,R,CAR,21,59,6,7,13
1,8481617,Vasily Podkolzin,R,VAN,23,53,6,7,13
1,8477903,Garnet Hathaway,R,PHI,33,68,6,7,13
1,8471709,Marc-Edouard Vlasic,D,SJS,37,59,5,8,13
1,8480796,Martin Fehervary,D,WSH,25,61,5,8,13
1,8482713,Mackie Samoskevich,R,FLA,22,47,5,8,13
1,8476994,Vinnie Hinostroza,C,NSH,30,53,4,9,13
1,8480011,Klim Kostin,C,SJS,25,56,3,10,13
1,8480058,Pierre-Olivier Joseph,D,STL,25,54,2,11,13
1,8482067,Connor Mackey,D,NYR,28,56,2,11,13
1,8474166,Alec Martinez,D,CHI,37,51,2,11,13
1,8477845,Trevor van Riemsdyk,D,WSH,33,61,0,13,13
1,8477070,Liam O'Brien,C,UTA,30,52,9,3,12
1,8475225,Craig Smith,C,CHI,35,50,7,5,12
1,8474034,Pat Maroon,L,CHI,36,53,5,7,12
1,8478421,A.J. Greer,L,FLA,28,54,5,7,12
1,8477938,Haydn Fleury,D,WPG,28,46,5,7,12
1,8473453,Trevor Lewis,C,LAK,37,71,5,7,12
1,8479372,Josh Mahura,D,SEA,26,57,4,8,12
1,8480025,MacKenzie Entwistle,R,FLA,25,58,4,8,12
1,8474567,Zach Bogosian,D,MIN,34,65,4,8,12
1,8481122,Simon Benoit,D,TOR,26,40,4,8,12
1,8470600,Ryan Suter,D,STL,39,57,3,9,12
1,8481019,David Gustafsson,C,WPG,24,39,2,10,12
1,8483499,Liam Ohgren,L,MIN,20,54,2,10,12
1,8481701,Santeri Hatakka,D,NJD,23,39,2,10,12
1,8480807,Mattias Samuelsson,D,BUF,24,52,2,10,12
1,8476372,Nick Seeler,D,PHI,31,48,2,10,12
1,8478468,Jeremy Lauzon,D,NSH,27,59,2,10,12
1,8479371,Dante Fabbro,D,NSH,26,62,1,11,12
1,8480860,Kevin Bahl,D,CGY,24,56,1,11,12
1,8481056,Spencer Stastney,D,NSH,24,36,6,5,11
1,8480007,Jonas Rondbjerg,R,VGK,25,45,5,6,11
1,8482141,Lukas Cormier,D,VGK,22,36,5,6,11
1,8476858,Phillip Di Giuseppe,L,VAN,31,39,5,6,11
1,8476967,Brett Kulak,D,EDM,30,62,4,7,11
1,8482964,Arber Xhekaj,D,MTL,23,47,4,7,11
1,8482652,Walker Duehr,R,CGY,27,42,3,8,11
1,8481751,Lukas Rousek,R,BUF,25,41,2,9,11
1,8476879,Cody Ceci,D,EDM,31,68,2,9,11
1,8482451,Mikael Pyyhtia,L,CBJ,23,37,2,9,11
1,8478450,Parker Wotherspoon,D,BOS,27,37,2,9,11
1,8481708,Zac Jones,D,NYR,24,52,1,10,11
1,8479442,Troy Stecher,D,EDM,30,56,1,10,11
1,8482145,Mavrik Bourque,C,DAL,22,61,1,10,11
1,8476374,Sean Kuraly,C,CBJ,31,53,6,4,10
1,8476952,Dominic Toninato,C,WPG,30,31,5,5,10
1,8484149,Gavin Brindley,C,CBJ,20,55,5,5,10
1,8482153,Brendan Brisson,C,VGK,23,37,5,5,10
1,8479944,Zach Aston-Reese,C,VGK,30,47,5,5,10
1,8477505,Alexander Wennberg,C,SJS,30,33,5,5,10
1,8477380,Jonny Brodzinski,C,NYR,31,50,4,6,10
1,8479671,Mathieu Olivier,R,CBJ,27,53,4,6,10
1,8481167,Brayden Pachal,D,CGY,25,43,4,6,10
1,8480848,Ty Dellandrea,C,SJS,24,46,4,6,10
1,8478874,Adam Gaudette,C,OTT,28,34,4,6,10
1,8475762,Derek Forbort,D,VAN,32,49,3,7,10
1,8482095,Tyler Kleven,D,OTT,22,48,2,8,10
1,8474090,Brendan Smith,D,DAL,35,78,2,8,10
1,8477962,Brendan Lemieux,L,CAR,28,43,2,8,10
1,8473446,Erik Johnson,D,PHI,36,40,2,8,10
1,8476473,Connor Murphy,D,CHI,31,46,2,8,10
1,8483460,David Jiricek,D,CBJ,21,57,1,9,10
1,8479348,Kale Clague,D,BUF,26,48,1,9,10
1,8480196,Jacob Bryson,D,BUF,27,48,1,9,10
1,8478859,Niko Mikkola,D,FLA,28,55,1,9,10
1,8477034,Jaycob Megna,D,FLA,32,43,1,9,10
1,8482155,Alex Laferriere,R,LAK,23,67,8,1,9
1,8475842,Sam Carrick,C,NYR,32,64,6,3,9
1,8480880,Jakub Lauko,C,MIN,24,40,5,4,9
1,8481789,Tye Kartye,L,SEA,23,39,5,4,9
1,8481441,Joe Snively,C,DET,28,61,4,5,9
1,8480845,Rasmus Kupari,C,WPG,24,37,3,6,9
1,8480990,Declan Chisholm,D,MIN,24,53,3,6,9
1,8480157,Calle Rosen,D,COL,30,44,2,7,9
1,8478452,Caleb Jones,D,LAK,27,55,2,7,9
1,8481599,Victor Soderstrom,D,UTA,23,32,2,7,9
1,8479378,Logan Stanley,D,WPG,26,44,2,7,9
1,8479576,Vincent Desharnais,D,VAN,28,48,2,7,9
1,8481605,Jackson LaCombe,D,ANA,23,36,1,8,9
1,8477851,Jordan Oesterle,D,BOS,32,50,0,9,9
1,8479772,Zack MacEwen,R,OTT,28,55,5,3,8
1,8481754,Nikita Nesterenko,C,ANA,23,34,5,3,8
1,8480441,Trey Fix-Wolansky,R,CBJ,25,38,4,4,8
1,8478399,Jonas Siegenthaler,D,NJD,27,62,4,4,8
1,8482751,Ryan Winterton,C,SEA,21,33,4,4,8
1,8478424,Jansen Harkins,C,ANA,27,47,4,4,8
1,8479291,Kevin Rooney,C,CGY,31,47,4,4,8
1,8476822,Luke Glendening,C,TBL,35,78,4,4,8
1,8476913,Devin Shore,C,MIN,30,37,3,5,8
1,8476442,Matt Nieto,L,PIT,32,50,3,5,8
1,8478454,Noah Juulsen,D,VAN,27,40,2,6,8
1,8471677,Jack Johnson,D,CBJ,37,67,2,6,8
1,8479986,Kole Lind,R,DAL,26,38,2,6,8
1,8481541,Samuel Bolduc,D,NYI,24,29,1,7,8
1,8483763,Maksymilian Szuber,D,UTA,22,41,1,7,8
1,8484911,Collin Graf,R,SJS,22,45,1,7,8
1,8478017,Mark Friedman,D,VAN,29,26,5,2,7
1,8481532,Alex Turcotte,C,LAK,23,45,5,2,7
1,8482077,Dylan Holloway,L,EDM,23,58,4,3,7
1,8482496,Nils Aman,C,VAN,24,35,4,3,7
1,8475958,Michael Sgarbossa,C,WSH,32,30,4,3,7
1,8482765,Isak Rosen,R,BUF,21,29,3,4,7
1,8479981,Jonah Gadjovich,L,FLA,26,41,3,4,7
1,8479980,Nicolas Hague,D,VGK,26,54,2,5,7
1,8480292,Carson Meyer,R,ANA,27,32,2,5,7
1,8477810,Joel Hanley,D,CGY,33,31,2,5,7
1,8482516,Matthew Kessel,D,STL,24,31,2,5,7
1,8477401,John Hayden,C,SEA,29,27,2,5,7
1,8482744,James Malatesta,L,CBJ,21,38,1,6,7
1,8482747,Brennan Othmann,L,NYR,21,35,1,6,7
1,8475750,Jon Merrill,D,MIN,32,49,1,6,7
1,8480879,Jacob Bernard-Docker,D,OTT,24,42,1,6,7
1,8483619,Filip Roos,D,OTT,25,35,1,6,7
1,8476867,Brendan Gaunce,C,MIN,30,39,1,6,7
1,8477887,Patrick Brown,C,BOS,32,44,1,6,7
1,8481609,Vladislav Kolyachonok,D,UTA,23,42,1,6,7
1,8480834,Ty Emberson,D,SJS,24,35,0,7,7
1,8479379,Givani Smith,R,SJS,26,32,5,1,6
1,8481518,Nolan Foote,L,NJD,24,34,5,1,6
1,8479638,Justin Brazeau,R,BOS,26,41,5,1,6
1,8483630,Pavol Regenda,L,ANA,25,29,4,2,6
1,8479994,Jaret Anderson-Dolan,C,WPG,25,39,3,3,6
1,8480267,Sammy Walker,C,MIN,25,18,3,3,6
1,8481598,Philip Broberg,D,EDM,23,43,2,4,6
1,8479543,Michael Pezzetta,L,MTL,26,56,2,4,6
1,8480245,Olle Lycksell,R,PHI,25,29,2,4,6
1,8482177,Marat Khusnutdinov,C,MIN,22,37,2,4,6
1,8480870,Bo Groulx,C,NYR,24,37,2,4,6
1,8479536,Axel Jonsson-Fjallby,L,WPG,26,32,1,5,6
1,8479985,Cale Fleury,D,SEA,26,21,1,5,6
1,8479991,Jake Leschyshyn,C,NYR,25,31,1,5,6
1,8474568,Luke Schenn,D,NSH,35,37,0,6,6
1,8477073,Kurtis MacDermid,L,NJD,30,34,3,2,5
1,8483549,Lucas Condotta,L,MTL,27,29,3,2,5
1,8482201,Gage Goncalves,C,TBL,23,22,3,2,5
1,8480468,James Hamblin,L,EDM,25,18,3,2,5
1,8481550,Adam Beckman,L,NJD,23,48,2,3,5
1,8481600,Tobias Bjornfot,D,FLA,23,45,2,3,5
1,8478146,Matthew Highmore,C,OTT,28,26,2,3,5
1,8478585,Derek Ryan,C,EDM,38,61,2,3,5
1,8481237,Kyle MacLean,C,NYI,25,25,2,3,5
1,8481556,John Beecher,C,BOS,23,41,2,3,5
1,8480032,Shane Bowers,C,NJD,25,17,2,3,5
1,8479249,Andrew Poturalski,C,SJS,30,28,1,4,5
1,8476329,Travis Boyd,C,MIN,31,52,1,4,5
1,8479972,Mason Shaw,C,WPG,26,36,1,4,5
1,8477149,Scott Sabourin,R,SJS,32,23,1,4,5
1,8476441,Joel Edmundson,D,LAK,31,39,1,4,5
1,8482858,Ryker Evans,D,SEA,23,31,1,4,5
1,8482733,Logan Mailloux,D,MTL,31,32,1,4,5
1,8484258,Sam Malinski,D,COL,26,28,0,5,5
1,8481006,Tyler Tucker,D,STL,24,13,0,5,5
1,8477971,Andreas Englund,D,LAK,28,26,0,5,5
1,8482250,Callahan Burke,C,VGK,27,17,0,5,5
1,8481043,Cole Koepke,L,BOS,26,14,4,0,4
1,8478409,Anthony Richard,C,PHI,28,28,3,1,4
1,8475755,Alexander Petrovic,D,DAL,32,19,3,1,4
1,8483012,Logan Morrison,C,SEA,22,31,3,1,4
1,8484254,Akito Hirose,D,VAN,25,27,2,2,4
1,8477527,Ross Johnston,L,ANA,30,33,2,2,4
1,8481147,Reese Johnson,C,MIN,26,35,2,2,4
1,8475235,Nicolas Deslauriers,L,PHI,33,51,2,2,4
1,8479367,William Lockwood,R,FLA,26,23,2,2,4
1,8481578,Graeme Clarke,R,MIN,23,11,2,2,4
1,8482070,Mitchell Chaffee,R,TBL,26,52,2,2,4
1,8478502,Dennis Gilbert,D,BUF,28,19,1,3,4
1,8482511,Mason Lohrei,D,BOS,23,33,1,3,4
1,8477335,Kyle Burroughs,D,LAK,29,32,1,3,4
1,8481543,Nikita Alexandrov,C,STL,24,18,1,3,4
1,8482144,Jack Thompson,D,SJS,22,24,1,3,4
1,8474062,Riley Nash,C,NYR,35,14,1,3,4
1,8483570,Ben Meyers,C,SEA,26,27,1,3,4
1,8474612,Travis Hamonic,D,OTT,34,39,0,4,4
1,8477384,Josh Brown,D,EDM,30,43,0,4,4
1,8483395,Arshdeep Bains,L,VAN,23,7,0,4,4
1,8477473,Justin Bailey,R,SJS,29,20,3,0,3
1,8481679,Maxence Guenette,D,OTT,23,36,3,0,3
1,8483407,Brandon Scanlin,D,NYR,25,8,2,1,3
1,8481422,Jacob Lucchini,C,NSH,29,16,2,1,3
1,8475795,Dylan McIlrath,D,WSH,32,16,1,2,3
1,8481564,Ryan Johnson,D,BUF,23,16,1,2,3
1,8480823,Alexander Alexeyev,D,WSH,25,16,1,2,3
1,8481030,Jack St. Ivany,D,PIT,25,10,1,2,3
1,8480075,Cameron Crotty,D,MIN,25,13,1,2,3
1,8477467,Gustav Olofsson,D,SEA,30,21,1,2,3
1,8483397,Marc McLaughlin,C,BOS,25,37,1,2,3
1,8479362,Riley Tufte,L,BOS,26,12,1,2,3
1,8481585,Egor Afanasyev,L,SJS,23,19,1,2,3
1,8481527,Kaedan Korczak,D,VGK,23,48,0,3,3
1,8479320,Max Lajoie,D,SEA,27,21,0,3,3
1,8484287,Cole McWard,D,VAN,23,22,0,3,3
1,8482172,Landon Slaggert,L,CHI,22,25,0,3,3
1,8479419,Brett Murray,L,BUF,26,20,1,1,2
1,8477244,Chad Ruhwedel,D,NYR,34,33,1,1,2
1,8478477,Mitchell Stephens,C,SEA,27,15,1,1,2
1,8481593,Jayden Struble,D,MTL,23,18,1,1,2
1,8480851,Akil Thomas,C,LAK,24,21,1,1,2
1,8482061,Brandon Biro,L,SEA,26,9,1,1,2
1,8482147,Jean-Luc Foudy,C,COL,22,25,1,1,2
1,8483567,Georgii Merkulov,C,BOS,24,5,1,1,2
1,8478021,William Lagesson,D,DET,28,33,0,2,2
1,8477320,Anton Blidh,L,NYR,29,18,0,2,2
1,8482470,Ilya Solovyov,D,CGY,24,18,0,2,2
1,8481743,Marc Del Gaizo,D,NSH,25,22,0,2,2
1,8481719,Maxwell Crozier,D,TBL,24,20,0,2,2
1,8480890,Jan Jenik,R,OTT,24,25,0,2,2
1,8478011,Louie Belpedio,D,PHI,28,8,0,2,2
1,8477541,Dakota Mermis,D,TOR,30,7,0,2,2
1,8478051,Max Willman,C,NJD,29,15,0,2,2
1,8481699,Aku Raty,R,UTA,23,14,0,2,2
1,8481655,Cole Schwindt,R,CGY,23,8,0,2,2
1,8482118,Sam Colangelo,R,ANA,23,24,0,2,2
1,8483512,Matt Savoie,C,EDM,20,14,1,0,1
1,8479587,Rhett Gardner,C,PHI,28,17,1,0,1
1,8482165,Yan Kuznetsov,D,CGY,22,22,1,0,1
1,8478446,Glenn Gawdin,C,LAK,27,10,1,0,1
1,8483920,Pierrick Dube,R,WSH,23,6,1,0,1
1,8481065,Angus Crookshank,L,OTT,25,18,1,0,1
1,8482476,Emil Heineman,L,MTL,23,13,1,0,1
1,8481024,Linus Karlsson,C,VAN,25,10,1,0,1
1,8482861,Vincent Iorio,D,WSH,22,17,0,1,1
1,8477462,Robert Hagg,D,VGK,29,25,0,1,1
1,8480844,Grigori Denisenko,L,VGK,24,29,0,1,1
1,8475413,Justin Dowling,C,NJD,34,16,0,1,1
1,8479421,Jacob Moverare,D,LAK,26,13,0,1,1
1,8480874,Adam Ginning,D,PHI,24,14,0,1,1
1,8482126,Emil Andrae,D,PHI,31,2,0,1,1
1,8477993,Justin Kirkland,C,CGY,28,8,0,1,1
1,8482102,Vasily Ponomarev,C,PIT,22,20,0,1,1
1,8483597,Milos Kelemen,L,UTA,25,14,0,1,1
1,8482162,Roby Jarventie,L,EDM,22,12,0,1,1
1,8483471,Brad Lambert,C,WPG,31,11,0,1,1
1,8483489,Fraser Minten,C,TOR,31,7,0,1,1
1,8478854,Ryan Shea,D,PIT,27,5,0,1,1
1,8484255,Jason Polin,R,COL,25,3,0,1,1
1,8482088,Justin Sourdif,R,FLA,22,19,0,1,1
1,8479321,Lucas Johansen,D,,27,0,0,0,0
1,8470794,Joe Pavelski,C,,40,0,0,0,0
1,8477950,Tony DeAngelo,D,,29,0,0,0,0
1,8471218,Blake Wheeler,R,,38,0,0,0,0
1,8475197,Tyson Barrie,D,,33,0,0,0,0
1,8475744,Evgeny Kuznetsov,C,,32,0,0,0,0
1,8474037,James van Riemsdyk,L,,35,0,0,0,0
1,8474602,Justin Schultz,D,,34,0,0,0,0
1,8482222,Alexander Barabanov,L,,30,0,0,0,0
1,8474157,Max Pacioretty,L,,36,0,0,0,0
1,8474031,Kevin Shattenkirk,D,,35,0,0,0,0
1,8480884,Calen Addison,D,,24,0,0,0,0
1,8480008,Adam Ruzicka,C,,25,0,0,0,0
1,8475906,John Klingberg,D,,32,0,0,0,0
1,8476884,Derrick Pouliot,D,,30,0,0,0,0
1,8476919,Chris Tierney,C,,30,0,0,0,0
1,8479415,Michael McLeod,C,,26,0,0,0,0
1,8474884,Mike Hoffman,C,,35,0,0,0,0
1,8478104,Sammy Blais,L,,28,0,0,0,0
1,8474870,Tyler Johnson,C,,34,0,0,0,0
1,8481591,Sam Poulin,R,,23,0,0,0,0
1,8479977,Kailer Yamamoto,R,,26,0,0,0,0
1,8476393,Nick Cousins,C,,31,0,0,0,0
1,8479376,Victor Mete,D,,26,0,0,0,0
1,8476871,Tanner Pearson,L,,32,0,0,0,0
1,8471274,Alex Goligoski,D,,39,0,0,0,0
1,8481058,Jesse Ylönen,R,,25,0,0,0,0
1,8477464,Nic Petan,C,,29,0,0,0,0
1,8473449,Kyle Okposo,R,,36,0,0,0,0
1,8480216,Jacob Peterson,C,,25,0,0,0,0
1,8479346,Dillon Dube,C,,26,0,0,0,0
1,8470966,Mark Giordano,D,,41,0,0,0,0
1,8480821,Filip Zadina,R,,25,0,0,0,0
1,8476907,Mackenzie MacEachern,L,,30,0,0,0,0
1,8478430,Oliver Kylington,D,,27,0,0,0,0
1,8479514,Rem Pitlick,C,,27,0,0,0,0
1,8478099,Kevin Labanc,R,,29,0,0,0,0
1,8482241,Radim Zohorna,L,,28,0,0,0,0
1,8474040,Sam Gagner,C,,35,0,0,0,0
1,8475164,Jakob Silfverberg,R,,34,0,0,0,0
1,8475752,Tyler Pitlick,C,,33,0,0,0,0
1,8479984,Cal Foote,D,,26,0,0,0,0
1,8478495,Denis Gurianov,R,,27,0,0,0,0
1,8479533,Joona Koppanen,L,,26,0,0,0,0
1,8479458,Nikita Zaitsev,D,,33,0,0,0,0
1,8471699,Andrew Cogliano,C,,37,0,0,0,0
1,8470604,Jeff Carter,C,,39,0,0,0,0
1,8477330,Dominik Kubalik,L,,29,0,0,0,0
1,8477944,Jakub Vrana,L,,28,0,0,0,0
1,8478904,Steven Lorentz,C,,28,0,0,0,0
1,8471686,Marc Staal,D,,37,0,0,0,0
1,8478512,Austin Czarnik,C,,32,0,0,0,0
1,8470610,Zach Parise,L,,40,0,0,0,0
1,8473504,Cal Clutterbuck,R,,37,0,0,0,0
1,8474009,Nick Bonino,C,,36,0,0,0,0
1,8477454,Adam Erne,L,,29,0,0,0,0
1,8477126,Jayson Megna,C,,34,0,0,0,0
1,8473473,Milan Lucic,L,,36,0,0,0,0
1,8478067,Oskar Lindblom,L,,28,0,0,0,0
1,8475825,Jani Hakanpää,D,,32,0,0,0,0
1,8479383,Boris Katchouk,L,,26,0,0,0,0
1,8478400,Colin White,C,,27,0,0,0,0
1,8477846,Ryan Carpenter,C,,33,0,0,0,0
1,8480084,Nick DeSimone,D,NJD,30,11,0,0,0
1,8477930,Pierre-Edouard Bellemare,L,,39,0,0,0,0
1,8479423,Alex Nylander,L,,26,0,0,0,0
1,8475797,Jarred Tinordi,D,,32,0,0,0,0
1,8481239,Samuel Fagemo,L,,24,0,0,0,0
1,8474618,Marco Scandella,D,,34,0,0,0,0
1,8480853,Liam Foudy,C,,24,0,0,0,0
1,8482094,Daemon Hunt,D,MIN,22,12,0,0,0
1,8478028,Fredrik Olofsson,L,,28,0,0,0,0
1,8474145,Robert Bortuzzo,D,,35,0,0,0,0
1,8474709,Matt Martin,L,,35,0,0,0,0
1,8480226,Marián Studenic,R,,26,0,0,0,0
1,8479522,Hardy Haman Aktell,D,WSH,26,1,0,0,0
1,8481806,Louis Crevier,D,CHI,23,9,0,0,0
1,8482929,Emil Lilleberg,D,TBL,23,22,0,0,0
1,8480274,Philip Kemp,D,EDM,25,0,0,0,0
1,8480184,Gustav Lindstrom,D,,26,0,0,0,0
1,8481077,John Leonard,L,,26,0,0,0,0
1,8479547,Matthew Phillips,R,,26,0,0,0,0
1,8476915,Jujhar Khaira,L,,30,0,0,0,0
1,8476323,Max McCormick,L,SEA,32,8,0,0,0
1,8481070,Hugh McGing,L,,26,0,0,0,0
1,8483546,Marshall Rifai,D,TOR,26,2,0,0,0
1,8478408,Travis Dermott,D,,28,0,0,0,0
1,8484326,Patrik Koch,D,UTA,28,0,0,0,0
1,8481812,Nikolai Knyzhov,D,,27,0,0,0,0
1,8482197,Adam Raska,R,MIN,23,6,0,0,0
1,8484321,Nikolas Matinpalo,D,OTT,26,2,0,0,0
1,8480306,Grant Hutton,D,NYI,29,7,0,0,0
1,8475278,Byron Froese,C,,33,0,0,0,0
1,8475766,Austin Watson,L,,32,0,0,0,0
1,8481206,John Ludvig,D,PIT,24,17,0,0,0
1,8483398,Declan Carlile,D,TBL,31,4,0,0,0
1,8479546,Oskar Steen,C,,26,0,0,0,0
1,8484304,Uvis Balinskis,D,FLA,28,9,0,0,0
1,8480836,Jonathan Gruden,C,,24,0,0,0,0
1,8481690,Tyler Angle,C,,24,0,0,0,0
1,8480031,Maxime Comtois,L,,25,0,0,0,0
1,8482460,Matt Rempe,C,NYR,22,11,0,0,0
1,8484325,Waltteri Merela,C,TBL,26,20,0,0,0
1,8483045,Cameron Butler,R,CBJ,31,1,0,0,0
1,8483432,Luca Del Bel Belluz,C,CBJ,31,4,0,0,0
1,8478078,Rourke Chartier,C,,28,0,0,0,0
1,8482787,Nikita Chibrikov,R,WPG,31,5,0,0,0
1,8481016,Ruslan Iskhakov,C,,24,0,0,0,0
1,8483609,Adam Klapka,R,CGY,24,1,0,0,0
1,8478881,Brett Seney,L,CHI,28,12,0,0,0
1,8481534,Raphael Lavoie,C,EDM,24,2,0,0,0
1,8484314,Jiri Smejkal,L,,28,0,0,0,0
1,8481726,Adam Edstrom,C,NYR,24,7,0,0,0
1,8478956,Samuel Laberge,L,NJD,27,0,0,0,0
1,8481462,Mason Morelli,L,VGK,28,7,0,0,0
1,8483401,Marc Johnstone,R,PIT,28,1,0,0,0
1,8483531,Brian Halonen,L,NJD,25,3,0,0,0
1,8484259,Ondrej Pavel,C,COL,31,1,0,0,0
1,8479330,Brandon Gignac,C,MTL,27,12,0,0,0
1,8480776,Sheldon Rempal,R,,29,0,0,0,0
1,8478147,Bokondji Imama,L,PIT,28,7,0,0,0
1,8475780,Chris Wagner,R,COL,33,12,0,0,0
2,8477492,Nathan MacKinnon,C,COL,29,81,49,87,136
2,8478402,Connor McDavid,C,EDM,27,78,30,103,133
2,8476453,Nikita Kucherov,R,TBL,31,82,32,91,123
2,8477956,David Pastrnak,R,BOS,28,82,61,61,122
2,8480027,Jason Robertson,L,DAL,25,81,36,79,115
2,8477934,Leon Draisaitl,C,EDM,29,78,46,65,111
2,8479314,Matthew Tkachuk,L,FLA,27,79,36,73,109
2,8478550,Artemi Panarin,L,NYR,33,70,28,76,104
2,8476459,Mika Zibanejad,C,NYR,31,79,42,61,103
2,8478864,Kirill Kaprizov,L,MIN,27,78,50,51,101
2,8480036,Miro Heiskanen,D,DAL,25,81,25,76,101
2,8478398,Kyle Connor,L,WPG,28,72,44,56,100
2,8479318,Auston Matthews,C,TOR,27,81,53,46,99
2,8478420,Mikko Rantanen,R,COL,28,82,45,54,99
2,8475172,Nazem Kadri,C,CGY,34,79,40,59,99
2,8481559,Jack Hughes,C,NJD,23,74,36,63,99
2,8480012,Elias Pettersson,C,VAN,26,74,34,65,99
2,8480800,Quinn Hughes,D,VAN,25,78,16,81,97
2,8477409,Carter Verhaeghe,C,FLA,29,82,48,46,94
2,8477939,William Nylander,R,TOR,28,82,36,58,94
2,8484144,Connor Bedard,C,CHI,19,76,35,59,94
2,8471675,Sidney Crosby,C,PIT,37,73,42,49,91
2,8476468,J.T. Miller,C,VAN,31,74,32,59,91
2,8479343,Clayton Keller,R,UTA,26,73,42,48,90
2,8477946,Dylan Larkin,C,DET,28,81,36,54,90
2,8477493,Aleksander Barkov,C,FLA,29,81,27,63,90
2,8478427,Sebastian Aho,C,CAR,27,73,44,45,89
2,8480801,Brady Tkachuk,L,OTT,25,79,40,49,89
2,8477942,Kevin Fiala,L,LAK,28,80,29,60,89
2,8480069,Cale Makar,D,COL,26,67,34,54,88
2,8474141,Patrick Kane,R,DET,36,81,32,56,88
2,8476460,Mark Scheifele,C,WPG,31,79,28,60,88
2,8476389,Vincent Trocheck,C,NYR,31,70,39,48,87
2,8482116,Tim Stützle,C,OTT,22,77,31,56,87
2,8479337,Alex DeBrincat,R,DET,27,82,42,44,86
2,8478449,Roope Hintz,C,DAL,28,81,40,46,86
2,8477404,Jake Guentzel,C,TBL,30,82,48,37,85
2,8480023,Robert Thomas,C,STL,25,75,22,63,85
2,8478873,Troy Terry,R,ANA,27,76,32,52,84
2,8475184,Chris Kreider,L,NYR,33,79,48,34,82
2,8478010,Brayden Point,C,TBL,28,82,44,37,81
2,8477933,Sam Reinhart,C,FLA,29,79,41,40,81
2,8477940,Nikolaj Ehlers,L,WPG,28,73,39,41,80
2,8478439,Travis Konecny,R,PHI,27,81,33,47,80
2,8474600,Roman Josi,D,NSH,34,74,23,57,80
2,8475786,Zach Hyman,L,EDM,32,80,39,40,79
2,8479385,Jordan Kyrou,C,STL,26,77,35,44,79
2,8481557,Matt Boldy,L,MIN,23,72,33,46,79
2,8478403,Jack Eichel,C,VGK,28,77,32,47,79
2,8476887,Filip Forsberg,L,NSH,30,77,33,45,78
2,8475913,Mark Stone,R,VGK,32,79,26,52,78
2,8478444,Brock Boeser,R,VAN,27,77,34,43,77
2,8475765,Vladimir Tarasenko,R,DET,33,81,25,52,77
2,8479323,Adam Fox,D,NYR,26,70,16,61,77
2,8478445,Mathew Barzal,C,NYI,27,79,15,62,77
2,8480002,Nico Hischier,C,NJD,25,77,26,50,76
2,8480208,Drake Batherson,R,OTT,26,76,28,47,75
2,8479407,Jesper Bratt,L,NJD,26,73,20,55,75
2,8474564,Steven Stamkos,C,NSH,34,69,26,47,73
2,8480830,Andrei Svechnikov,R,CAR,24,73,30,42,72
2,8477476,Artturi Lehkonen,L,COL,29,80,28,44,72
2,8480803,Evan Bouchard,D,EDM,25,75,21,51,72
2,8482699,Dylan Guenther,R,UTA,21,79,34,37,71
2,8476454,Ryan Nugent-Hopkins,C,EDM,31,77,25,46,71
2,8479420,Tage Thompson,C,BUF,27,75,39,31,70
2,8482740,Wyatt Johnston,C,DAL,21,80,35,34,69
2,8475168,Matt Duchene,C,DAL,33,81,33,36,69
2,8478460,Zach Werenski,D,CBJ,27,80,19,50,69
2,8481540,Cole Caufield,R,MTL,23,77,40,28,68
2,8473419,Brad Marchand,L,BOS,36,80,30,38,68
2,8473512,Claude Giroux,R,OTT,36,80,19,49,68
2,8475167,Victor Hedman,D,TBL,34,79,18,50,68
2,8477501,Valeri Nichushkin,R,COL,29,79,32,35,67
2,8471685,Anze Kopitar,C,LAK,37,81,24,43,67
2,8475798,Mikael Granlund,C,SJS,32,72,20,47,67
2,8476456,Jonathan Huberdeau,C,CGY,31,73,19,48,67
2,8475794,Tyler Seguin,C,DAL,32,81,36,30,66
2,8477402,Pavel Buchnevich,L,STL,29,74,31,35,66
2,8474578,Erik Karlsson,D,PIT,34,80,18,48,66
2,8478493,Joel Eriksson Ek,C,MIN,27,73,35,30,65
2,8484153,Leo Carlsson,C,ANA,20,77,26,38,64
2,8475166,John Tavares,C,TOR,34,80,23,41,64
2,8480865,Noah Dobson,D,NYI,24,79,14,50,64
2,8480839,Rasmus Dahlin,D,BUF,24,70,21,42,63
2,8475170,Brayden Schenn,C,STL,33,75,21,42,63
2,8478440,Dylan Strome,C,WSH,27,76,20,43,63
2,8476346,Johnny Gaudreau,L,CBJ,31,73,18,45,63
2,8480018,Nick Suzuki,C,MTL,25,75,14,49,63
2,8477504,Josh Morrissey,D,WPG,29,71,14,49,63
2,8477960,Adrian Kempe,R,LAK,28,78,30,32,62
2,8477949,Alex Tuch,R,BUF,28,74,22,40,62
2,8476432,Boone Jenner,C,CBJ,31,68,45,16,61
2,8475158,Ryan O'Reilly,C,NSH,33,72,26,35,61
2,8475191,Reilly Smith,R,NYR,33,78,26,35,61
2,8478414,Timo Meier,R,NJD,28,69,25,36,61
2,8476539,Jonathan Marchessault,R,NSH,34,75,34,26,60
2,8479675,Trevor Moore,L,LAK,29,81,33,27,60
2,8476881,Tomas Hertl,C,VGK,31,77,32,28,60
2,8478856,Conor Garland,R,VAN,28,78,31,29,60
2,8476882,Teuvo Teravainen,L,CHI,30,65,23,37,60
2,8478519,Anthony Cirelli,C,TBL,27,81,22,38,60
2,8479542,Brandon Hagel,L,TBL,26,82,21,39,60
2,8477951,Nick Schmaltz,C,UTA,28,77,17,43,60
2,8476853,Morgan Rielly,D,TOR,30,66,11,49,60
2,8474563,Drew Doughty,D,LAK,35,69,7,53,60
2,8478366,Frank Vatrano,R,ANA,30,74,32,27,59
2,8477500,Bo Horvat,C,NYI,29,78,28,31,59
2,8473994,Jamie Benn,L,DAL,35,81,27,32,59
2,8482078,Lucas Raymond,L,DET,22,80,20,39,59
2,8478401,Pavel Zacha,C,BOS,27,78,18,41,59
2,8482684,Luke Hughes,D,NJD,21,73,10,49,59
2,8475151,Kyle Palmieri,C,NYI,33,77,31,27,58
2,8478498,Jake DeBrusk,L,VAN,28,75,29,29,58
2,8477496,Elias Lindholm,C,BOS,30,78,25,33,58
2,8475692,Mats Zuccarello,R,MIN,37,65,20,38,58
2,8475754,Brock Nelson,C,NYI,33,76,31,26,57
2,8483515,Juraj Slafkovsky,L,MTL,20,78,27,30,57
2,8477935,Sam Bennett,C,FLA,28,77,25,32,57
2,8477494,Jonathan Drouin,L,COL,29,81,22,35,57
2,8478975,Mason Marchment,L,DAL,29,82,22,35,57
2,8477503,Max Domi,C,TOR,29,81,18,39,57
2,8475726,Tyler Toffoli,C,SJS,32,67,28,28,56
2,8476448,William Karlsson,C,VGK,31,81,26,30,56
2,8481711,Matias Maccelli,L,UTA,24,77,17,39,56
2,8479999,Casey Mittelstadt,C,COL,26,81,17,39,56
2,8475287,Erik Haula,L,NJD,33,71,29,26,55
2,8482745,Mason McTavish,C,ANA,21,71,26,29,55
2,8482665,Matty Beniers,C,SEA,22,74,26,29,55
2,8476483,Rickard Rakell,R,PIT,31,78,26,29,55
2,8477416,Oliver Bjorkstrand,R,SEA,29,71,25,30,55
2,8476479,Phillip Danault,C,LAK,31,81,23,32,55
2,8482093,Seth Jarvis,C,CAR,22,69,22,33,55
2,8471215,Evgeni Malkin,C,PIT,38,70,19,36,55
2,8479425,Filip Hronek,D,VAN,27,73,15,40,55
2,8477444,Andre Burakovsky,L,SEA,29,71,14,41,55
2,8480015,Owen Tippett,R,PHI,25,77,28,26,54
2,8477451,Ryan Hartman,R,MIN,30,72,17,37,54
2,8474590,John Carlson,D,WSH,34,69,13,41,54
2,8480014,Gabriel Vilardi,C,WPG,25,69,28,25,53
2,8477955,Jared McCann,L,SEA,28,73,26,27,53
2,8478438,Tommy Novak,C,NSH,27,69,20,33,53
2,8482667,William Eklund,L,SJS,22,64,20,33,53
2,8482109,Alexis Lafrenière,L,NYR,23,72,17,36,53
2,8475784,Jeff Skinner,C,EDM,32,76,25,27,52
2,8480028,Morgan Frost,C,PHI,25,69,23,29,52
2,8474641,Adam Henrique,C,EDM,34,75,22,29,51
2,8481528,Dylan Cozens,C,BUF,23,68,19,32,51
2,8482110,Dawson Mercer,C,NJD,23,74,26,24,50
2,8474586,Jordan Eberle,R,SEA,34,72,25,25,50
2,8478474,Lawson Crouse,L,UTA,27,73,24,26,50
2,8475810,Bryan Rust,R,PIT,32,72,22,28,50
2,8482720,Matthew Knies,L,TOR,22,81,20,30,50
2,8483431,Logan Cooley,C,UTA,20,72,19,31,50
2,8478047,Michael Bunting,L,PIT,29,72,17,33,50
2,8478462,Nicolas Roy,C,VGK,27,75,14,36,50
2,8477456,J.T. Compher,L,DET,29,77,13,37,50
2,8475760,Nick Bjugstad,C,UTA,32,68,26,23,49
2,8471214,Alex Ovechkin,L,WSH,39,74,21,28,49
2,8477964,Ivan Barbashev,C,VGK,29,75,21,28,49
2,8480039,Martin Necas,C,CAR,25,69,18,31,49
2,8476880,Tom Wilson,R,WSH,30,65,18,31,49
2,8477447,Shea Theodore,D,VGK,29,62,8,41,49
2,8481533,Trevor Zegras,C,ANA,23,64,23,25,48
2,8474150,Mikael Backlund,C,CGY,35,76,20,28,48
2,8481542,Moritz Seider,D,DET,23,78,12,36,48
2,8479325,Charlie McAvoy,D,BOS,27,73,11,37,48
2,8476875,Mike Matheson,D,MTL,30,68,10,38,48
2,8478407,Vince Dunn,D,SEA,28,73,7,41,48
2,8475799,Nino Niederreiter,R,WPG,32,72,29,18,47
2,8476399,Blake Coleman,C,CGY,33,76,27,20,47
2,8475314,Anders Lee,L,NYI,34,81,26,21,47
2,8473986,Alex Killorn,L,ANA,35,70,22,25,47
2,8482159,Tyson Foerster,R,PHI,22,74,20,27,47
2,8483808,Andrei Kuzmenko,L,CGY,28,74,20,27,47
2,8477479,Tyler Bertuzzi,L,CHI,29,62,19,28,47
2,8482702,Logan Stankoven,C,DAL,21,79,17,30,47
2,8476792,Torey Krug,D,STL,33,67,13,34,47
2,8478055,Gustav Forsling,D,FLA,28,73,11,36,47
2,8471724,Kris Letang,D,PIT,37,79,9,38,47
2,8475714,Calle Jarnkrok,C,TOR,33,78,24,22,46
2,8482149,Cole Perfetti,C,WPG,22,68,20,26,46
2,8481068,Yegor Sharangovich,C,CGY,26,77,19,27,46
2,8482097,Jack Quinn,R,BUF,23,57,14,32,46
2,8477346,MacKenzie Weegar,D,CGY,30,75,10,36,46
2,8476905,Chandler Stephenson,C,SEA,30,74,9,37,46
2,8478397,Rasmus Andersson,D,CGY,28,75,8,38,46
2,8477998,Warren Foegele,L,LAK,28,78,24,21,45
2,8480185,Eetu Luostarinen,C,FLA,26,75,18,27,45
2,8477497,Sean Monahan,C,CBJ,30,62,13,32,45
2,8480064,Josh Norris,C,OTT,25,72,29,15,44
2,8477407,Anthony Duclair,L,NYI,29,78,21,23,44
2,8479992,Michael Rasmussen,C,DET,25,81,20,24,44
2,8476458,Ryan Strome,C,ANA,31,69,14,30,44
2,8478472,Mathieu Joseph,R,STL,27,70,12,32,44
2,8477021,Alex Kerfoot,C,UTA,30,73,11,33,44
2,8482105,Jake Sanderson,D,OTT,22,76,11,33,44
2,8475745,Charlie Coyle,C,BOS,32,78,9,35,44
2,8481546,Cam York,D,PHI,23,71,9,35,44
2,8481604,Pavel Dorofeyev,L,VGK,24,67,27,16,43
2,8484145,Zach Benson,L,BUF,19,72,20,23,43
2,8482113,Anton Lundell,C,FLA,23,76,19,24,43
2,8481618,Alex Newhook,C,MTL,23,77,17,26,43
2,8482124,Quinton Byfield,R,LAK,22,76,10,33,43
2,8477986,Brandon Montour,D,SEA,30,72,8,35,43
2,8475218,Mattias Ekholm,D,EDM,34,75,6,37,43
2,8471698,T.J. Oshie,R,WSH,38,65,24,18,42
2,8475768,Jaden Schwartz,C,SEA,32,69,22,20,42
2,8480849,Barrett Hayton,C,UTA,24,64,19,23,42
2,8474102,David Perron,L,OTT,36,78,16,26,42
2,8476438,Brandon Saad,L,STL,32,69,26,15,41
2,8482146,Luke Evangelista,R,NSH,22,69,19,22,41
2,8480797,Joel Farabee,L,PHI,24,70,16,25,41
2,8481535,Nils Hoglander,L,VAN,24,63,15,26,41
2,8480336,Sean Walker,D,CAR,30,72,10,31,41
2,8474565,Alex Pietrangelo,D,VGK,34,59,9,32,41
2,8480145,Neal Pionk,D,WPG,29,76,8,33,41
2,8480459,Pius Suter,C,VAN,28,71,20,20,40
2,8480188,Fabian Zetterlund,L,SJS,25,68,17,23,40
2,8476826,Yanni Gourde,C,SEA,33,73,17,23,40
2,8477511,Anthony Mantha,R,CGY,30,76,16,24,40
2,8478233,Andrew Mangiapane,L,WSH,28,66,16,24,40
2,8474679,Gustav Nyquist,C,NSH,35,71,14,26,40
2,8482671,Owen Power,D,BUF,22,69,9,31,40
2,8478469,Thomas Chabot,D,OTT,27,76,8,32,40
2,8475169,Evander Kane,L,EDM,33,74,23,16,39
2,8478046,Danton Heinen,L,VAN,29,69,18,21,39
2,8476292,Ondrej Palat,L,NJD,33,68,17,22,39
2,8480798,Philipp Kurashev,C,CHI,25,67,13,26,39
2,8478500,Ivan Provorov,D,CBJ,27,80,5,34,39
2,8483490,Pavel Mintyukov,D,ANA,21,72,4,35,39
2,8481596,Shane Pinto,C,OTT,24,75,21,17,38
2,8480009,Eeli Tolvanen,R,SEA,25,72,19,19,38
2,8475793,Ryan Johansen,C,PHI,32,71,15,23,38
2,8476897,Oskar Sundqvist,C,STL,30,65,13,25,38
2,8476869,Brady Skjei,D,NSH,30,69,10,28,38
2,8480434,Sean Durzi,D,UTA,26,69,9,29,38
2,8476958,Jaccob Slavin,D,CAR,30,77,5,33,38
2,8477969,Marcus Pettersson,D,PIT,28,78,3,35,38
2,8481554,Kaapo Kakko,R,NYR,23,72,20,17,37
2,8481032,Paul Cotter,C,NJD,25,68,16,21,37
2,8478396,Noah Hanifin,D,VGK,27,65,14,23,37
2,8479525,Ross Colton,C,COL,28,79,14,23,37
2,8481186,Logan O'Connor,R,COL,28,81,14,23,37
2,8479987,Morgan Geekie,C,BOS,26,75,14,23,37
2,8482092,Ridly Greig,C,OTT,22,78,13,24,37
2,8480817,K'Andre Miller,D,NYR,24,75,6,31,37
2,8475722,Jason Zucker,L,BUF,32,69,19,17,36
2,8478891,Mason Appleton,C,WPG,28,67,19,17,36
2,8479591,Michael Eyssimont,C,TBL,28,81,18,18,36
2,8470621,Corey Perry,R,EDM,39,71,16,20,36
2,8484166,Adam Fantilli,C,CBJ,20,67,14,22,36
2,8475753,Justin Faulk,D,STL,32,73,14,22,36
2,8478115,Pierre Engvall,L,NYI,28,78,13,23,36
2,8481523,Kirby Dach,C,MTL,23,64,12,24,36
2,8478133,Jake Evans,C,MTL,28,69,8,28,36
2,8476462,Dougie Hamilton,D,NJD,31,70,7,29,36
2,8478542,Evan Rodrigues,C,FLA,31,77,16,19,35
2,8476419,Jean-Gabriel Pageau,C,NYI,32,76,14,21,35
2,8482660,Kent Johnson,C,CBJ,22,62,12,23,35
2,8479410,Mikhail Sergachev,D,UTA,26,70,8,27,35
2,8477495,Seth Jones,D,CHI,30,68,7,28,35
2,8482055,Drew O'Connor,L,PIT,26,66,22,12,34
2,8481560,Arthur Kaliyev,R,LAK,23,77,18,16,34
2,8482175,JJ Peterka,R,BUF,22,74,18,16,34
2,8482475,Yegor Chinakhov,R,CBJ,23,67,17,17,34
2,8476960,Andreas Athanasiou,C,CHI,30,53,14,20,34
2,8479339,Patrik Laine,L,CBJ,26,64,13,21,34
2,8477498,Darnell Nurse,D,EDM,29,71,13,21,34
2,8473422,Nick Foligno,L,CHI,37,62,10,24,34
2,8481581,Thomas Harley,D,DAL,23,80,9,25,34
2,8480855,Jack McBain,C,UTA,24,66,9,25,34
2,8476854,Hampus Lindholm,D,BOS,30,75,8,26,34
2,8475764,Cam Fowler,D,ANA,33,78,5,29,34
2,8478038,Devon Toews,D,COL,30,68,4,30,34
2,8476474,Stefan Noesen,R,NJD,31,68,18,15,33
2,8482089,Jake Neighbours,L,STL,22,63,14,19,33
2,8476392,Adam Lowry,C,WPG,31,64,13,20,33
2,8480113,Alex Iafallo,L,WPG,31,64,12,21,33
2,8474716,Jared Spurgeon,D,MIN,35,78,12,21,33
2,8481656,Aliaksei Protas,C,WSH,23,68,11,22,33
2,8476278,Colin Blackwell,C,DAL,31,78,11,22,33
2,8478466,Daniel Sprong,R,VAN,27,67,10,23,33
2,8474149,Evgenii Dadonov,R,DAL,35,82,9,24,33
2,8481703,Valtteri Puustinen,R,PIT,25,62,7,26,33
2,8481580,Connor McMichael,C,WSH,23,69,21,11,32
2,8480281,Alexey Toropchenko,R,STL,25,59,19,13,32
2,8477426,Nicholas Paul,L,TBL,29,82,15,17,32
2,8481553,Bobby Brink,R,PHI,23,65,13,19,32
2,8478109,Victor Olofsson,L,VGK,29,68,12,20,32
2,8480068,Ryan Poehling,C,PHI,25,68,11,21,32
2,8478911,Matt Roy,D,WSH,29,68,11,21,32
2,8477932,Aaron Ekblad,D,FLA,28,72,9,23,32
2,8482133,Thomas Bordeleau,C,SJS,22,66,7,25,32
2,8482122,Brock Faber,D,MIN,22,78,3,29,32
2,8474574,Tyler Myers,D,VAN,34,64,3,29,32
2,8482259,Bobby McMann,C,TOR,28,73,23,8,31
2,8480893,Kirill Marchenko,R,CBJ,24,59,19,12,31
2,8477839,Conor Sheary,L,TBL,32,82,16,15,31
2,8482125,Alexander Holtz,R,VGK,22,67,14,17,31
2,8476918,Jimmy Vesey,L,NYR,31,61,14,17,31
2,8482705,Cole Sillinger,C,CBJ,21,63,12,19,31
2,8479400,Pierre-Luc Dubois,L,WSH,26,67,10,21,31
2,8470613,Brent Burns,D,CAR,39,75,9,22,31
2,8479351,Sam Steel,C,DAL,26,81,9,22,31
2,8479345,Jakob Chychrun,D,WSH,26,65,8,23,31
2,8484203,Bradly Nadeau,L,CAR,19,67,8,23,31
2,8480144,David Kampf,C,TOR,29,74,7,24,31
2,8476906,Shayne Gostisbehere,D,CAR,31,73,6,25,31
2,8480802,Ryan McLeod,C,BUF,25,67,14,16,30
2,8476927,Teddy Blueger,C,VAN,30,67,13,17,30
2,8478042,Viktor Arvidsson,R,EDM,31,68,12,18,30
2,8476981,Josh Anderson,R,MTL,30,69,12,18,30
2,8476921,Jordan Martinook,L,CAR,32,66,10,20,30
2,8476923,Damon Severson,D,CBJ,30,81,6,24,30
2,8480871,Adam Boqvist,D,FLA,24,69,5,25,30
2,8476457,Adam Larsson,D,SEA,32,68,4,26,30
2,8482655,J.J. Moser,D,TBL,24,78,3,27,30
2,8478020,Michael Amadio,C,OTT,28,72,19,10,29
2,8477987,Ryan Donato,C,CHI,28,56,19,10,29
2,8474053,Logan Couture,C,SJS,35,57,17,12,29
2,8483524,Shane Wright,C,SEA,20,63,17,12,29
2,8479390,Taylor Raddysh,R,WSH,26,64,16,13,29
2,8478057,Dakota Joshua,C,VAN,28,66,15,14,29
2,8479365,Trent Frederic,C,BOS,26,76,13,16,29
2,8477953,Kasperi Kapanen,R,STL,28,66,13,16,29
2,8480220,Noah Cates,L,PHI,25,68,12,17,29
2,8475149,Marcus Johansson,L,MIN,34,61,11,18,29
2,8477952,Robby Fabbri,C,ANA,28,65,10,19,29
2,8475763,Kevin Hayes,R,PIT,32,68,9,20,29
2,8477948,Travis Sanheim,D,PHI,28,70,9,20,29
2,8477429,Andrew Copp,C,DET,30,77,8,21,29
2,8476885,Jacob Trouba,D,NYR,30,71,7,22,29
2,8476917,Adam Pelech,D,NYI,30,79,6,23,29
2,8480873,Rasmus Sandin,D,WSH,24,64,3,26,29
2,8480078,Filip Chytil,C,NYR,25,66,13,15,28
2,8482117,Lukas Reichel,L,CHI,22,67,11,17,28
2,8483499,Liam Ohgren,L,MIN,20,62,11,17,28
2,8478507,John Marino,D,UTA,27,61,6,22,28
2,8482142,Jamie Drysdale,D,PHI,22,69,6,22,28
2,8481441,Joe Snively,C,DET,28,61,14,13,27
2,8477425,Miles Wood,L,COL,29,77,12,15,27
2,8480835,Jack Drury,C,CAR,24,56,11,16,27
2,8482111,Justin Barron,D,MTL,23,65,10,17,27
2,8482803,Olen Zellweger,D,ANA,21,65,9,18,27
2,8479316,Luke Kunin,C,SJS,27,57,7,20,27
2,8477506,Ryan Pulock,D,NYI,30,80,2,25,27
2,8476463,Jonas Brodin,D,MIN,31,76,1,26,27
2,8480003,Jesper Boqvist,C,FLA,26,68,13,13,26
2,8482074,Connor Zary,C,CGY,23,53,13,13,26
2,8474715,Cam Atkinson,R,TBL,35,82,12,14,26
2,8475343,Nic Dowd,C,WSH,34,63,12,14,26
2,8483491,Ivan Miroshnichenko,L,WSH,20,63,11,15,26
2,8481577,Philip Tomasino,C,NSH,23,62,9,17,26
2,8476872,Scott Laughton,C,PHI,30,73,8,18,26
2,8483505,Matthew Poitras,C,BOS,20,67,8,18,26
2,8475231,Casey Cizikas,C,NYI,33,68,7,19,26
2,8478458,Jack Roslovic,C,CAR,27,57,6,20,26
2,8480043,Timothy Liljegren,D,TOR,25,71,5,21,26
2,8481606,Jordan Spence,D,LAK,23,65,4,22,26
2,8482087,Kaiden Guhle,D,MTL,22,73,2,24,26
2,8475790,Erik Gudbranson,D,CBJ,32,75,1,25,26
2,8481582,Nicholas Robertson,L,TOR,23,76,14,11,25
2,8480813,Joe Veleno,C,DET,24,75,14,11,25
2,8482737,Zack Bolduc,C,STL,21,52,14,11,25
2,8478432,Christian Fischer,R,DET,27,72,13,12,25
2,8475848,Brendan Gallagher,R,MTL,32,64,10,15,25
2,8475791,Taylor Hall,L,CHI,33,63,10,15,25
2,8480289,Morgan Barron,C,WPG,26,57,10,15,25
2,8482679,Matt Coronato,R,CGY,22,70,9,16,25
2,8480074,Alexandre Texier,C,STL,25,61,9,16,25
2,8478413,Jordan Greenway,L,BUF,27,60,8,17,25
2,8476979,Erik Gustafsson,D,DET,32,77,7,18,25
2,8479324,Ryan Lindgren,D,NYR,26,71,5,20,25
2,8480829,Jesperi Kotkaniemi,C,CAR,24,59,15,9,24
2,8482079,Marco Rossi,C,MIN,23,59,12,12,24
2,8479619,Michael Carcone,L,UTA,28,63,11,13,24
2,8476461,Sean Couturier,C,PHI,32,68,9,15,24
2,8483493,Frank Nazar,C,CHI,20,61,9,15,24
2,8476422,Mike Reilly,D,NYI,31,75,8,16,24
2,8475171,Oliver Ekman-Larsson,D,TOR,33,63,7,17,24
2,8482624,Daniil Miromanov,D,CGY,27,64,7,17,24
2,8479398,Samuel Girard,D,COL,26,71,5,19,24
2,8478136,Jake Middleton,D,MIN,28,72,2,22,24
2,8476892,Colton Parayko,D,STL,31,75,1,23,24
2,8478508,Yakov Trenin,C,MIN,27,65,14,9,23
2,8480252,Cole Guttman,C,CHI,25,41,13,10,23
2,8481481,Blake Lizotte,C,PIT,27,61,11,12,23
2,8476925,Colton Sissons,C,NSH,31,63,10,13,23
2,8477450,Jason Dickinson,C,CHI,29,59,10,13,23
2,8483482,Tristan Luneau,D,ANA,20,63,10,13,23
2,8477353,Tyler Motte,C,DET,29,74,9,14,23
2,8477392,Hudson Fasching,R,NYI,29,67,9,14,23
2,8481624,Ilya Mikheyev,R,CHI,30,62,8,15,23
2,8481537,Nikita Okhotiuk,D,CGY,24,49,8,15,23
2,8479543,Michael Pezzetta,L,MTL,26,59,8,15,23
2,8474673,TJ Brodie,D,CHI,34,66,6,17,23
2,8482101,Danil Gushchin,L,SJS,22,61,5,18,23
2,8479996,Cody Glass,C,NSH,25,64,13,9,22
2,8477380,Jonny Brodzinski,C,NYR,31,52,13,9,22
2,8481093,Rafael Harvey-Pinard,L,MTL,25,54,12,10,22
2,8480789,Oliver Wahlstrom,R,NYI,24,69,12,10,22
2,8475193,Tomas Tatar,L,NJD,34,64,12,10,22
2,8476994,Vinnie Hinostroza,C,NSH,30,47,12,10,22
2,8475225,Craig Smith,C,CHI,35,54,10,12,22
2,8478013,Jake Walman,D,SJS,28,73,9,13,22
2,8477947,Sonny Milano,L,WSH,28,61,9,13,22
2,8476480,Vladislav Namestnikov,C,WPG,32,65,8,14,22
2,8480980,Connor Dewar,C,TOR,25,78,8,14,22
2,8482809,Jackson Blake,R,CAR,21,64,8,14,22
2,8477369,Carson Soucy,D,VAN,30,69,7,15,22
2,8475200,Dmitry Orlov,D,CAR,33,77,4,18,22
2,8475455,Brenden Dillon,D,NJD,34,64,3,19,22
2,8476312,Josh Manson,D,COL,33,64,3,19,22
2,8480891,Michael Kesselring,D,UTA,24,56,1,21,22
2,8479414,Nathan Bastian,R,NJD,27,56,14,7,21
2,8480995,Pontus Holmberg,R,TOR,25,72,12,9,21
2,8473533,Jordan Staal,C,CAR,36,63,12,9,21
2,8479718,Alex Barré-Boulet,C,MTL,27,54,10,11,21
2,8478434,Keegan Kolesar,R,VGK,27,69,9,12,21
2,8482148,Hendrix Lapierre,C,WSH,22,51,9,12,21
2,8478463,Anthony Beauvillier,L,PIT,27,63,8,13,21
2,8479393,Noah Gregor,C,OTT,26,75,7,14,21
2,8476467,Jamie Oleksiak,D,SEA,32,71,5,16,21
2,8476902,Esa Lindell,D,DAL,30,82,4,17,21
2,8475690,Chris Tanev,D,TOR,35,61,4,17,21
2,8479976,Juuso Valimaki,D,UTA,26,67,4,17,21
2,8480950,Ilya Lyubushkin,D,DAL,30,80,4,17,21
2,8479371,Dante Fabbro,D,NSH,26,67,4,17,21
2,8480157,Calle Rosen,D,COL,30,57,4,17,21
2,8479402,Jake Bean,D,CGY,26,61,3,18,21
2,8478840,Will Borgen,D,SEA,28,63,2,19,21
2,8474151,Ryan McDonagh,D,TBL,35,76,1,20,21
2,8476967,Brett Kulak,D,EDM,30,61,0,21,21
2,8479336,Carl Grundstrom,R,SJS,27,56,12,8,20
2,8481601,Simon Holmstrom,R,NYI,23,65,12,8,20
2,8480762,Eric Robinson,L,CAR,29,60,9,11,20
2,8479368,Max Jones,L,BOS,26,66,8,12,20
2,8475188,Brayden McNabb,D,VGK,33,58,6,14,20
2,8479353,Brett Howden,C,VGK,26,64,5,15,20
2,8476331,Dylan DeMelo,D,WPG,31,67,5,15,20
2,8480035,Henri Jokiharju,D,BUF,25,69,4,16,20
2,8477845,Trevor van Riemsdyk,D,WSH,33,64,3,17,20
2,8481014,Alexander Romanov,D,NYI,24,75,2,18,20
2,8478178,Darren Raddysh,D,TBL,28,72,2,18,20
2,8478831,Kevin Stenlund,C,UTA,28,59,13,6,19
2,8481617,Vasily Podkolzin,R,VAN,23,50,13,6,19
2,8478043,Sam Lafferty,C,BUF,29,59,11,8,19
2,8479941,Justin Danforth,R,CBJ,31,59,11,8,19
2,8483445,Cutter Gauthier,L,ANA,20,66,9,10,19
2,8481477,Nico Sturm,C,SJS,29,59,9,10,19
2,8483457,Lane Hutson,D,MTL,20,65,9,10,19
2,8476374,Sean Kuraly,C,CBJ,31,59,9,10,19
2,8477508,Curtis Lazar,C,NJD,29,64,8,11,19
2,8477989,Christian Dvorak,C,MTL,28,62,7,12,19
2,8473563,Nicklas Backstrom,C,WSH,37,53,7,12,19
2,8474189,Lars Eller,C,PIT,35,56,7,12,19
2,8480878,Nils Lundkvist,D,DAL,24,80,6,13,19
2,8479980,Nicolas Hague,D,VGK,26,65,6,13,19
2,8478882,Vladislav Gavrikov,D,LAK,29,68,5,14,19
2,8478443,Brandon Carlo,D,BOS,28,55,5,14,19
2,8476891,Matt Grzelcyk,D,PIT,30,77,5,14,19
2,8476525,Colin Miller,D,WPG,32,62,5,14,19
2,8482067,Connor Mackey,D,NYR,28,53,5,14,19
2,8481704,Juuso Parssinen,C,NSH,23,54,4,15,19
2,8482730,Brandt Clarke,D,LAK,21,49,4,15,19
2,8477488,Brett Pesce,D,NJD,30,63,3,16,19
2,8476469,Joel Armia,R,MTL,31,71,11,7,18
2,8479315,Joey Anderson,R,CHI,26,40,10,8,18
2,8476934,Brock McGinn,L,ANA,30,46,10,8,18
2,8479328,Julien Gauthier,R,NYI,27,65,9,9,18
2,8484149,Gavin Brindley,C,CBJ,20,50,9,9,18
2,8476889,Radek Faksa,C,STL,30,59,8,10,18
2,8479661,Tanner Jeannot,L,LAK,27,77,6,12,18
2,8477931,Tomas Nosek,L,FLA,32,58,5,13,18
2,8471709,Marc-Edouard Vlasic,D,SJS,37,51,5,13,18
2,8480025,MacKenzie Entwistle,R,FLA,25,60,5,13,18
2,8476879,Cody Ceci,D,EDM,31,66,5,13,18
2,8479983,Mario Ferraro,D,SJS,26,67,4,14,18
2,8477507,Nikita Zadorov,D,BOS,29,70,4,14,18
2,8480073,Erik Brannstrom,D,COL,25,62,4,14,18
2,8478468,Jeremy Lauzon,D,NSH,27,53,4,14,18
2,8481708,Zac Jones,D,NYR,24,54,4,14,18
2,8479639,Dylan Coghlan,D,WPG,26,61,3,15,18
2,8482712,Oskar Olausson,R,COL,22,76,2,16,18
2,8475181,Nick Leddy,D,STL,33,64,1,17,18
2,8475208,Brian Dumoulin,D,ANA,33,57,1,17,18
2,8476878,Zemgus Girgensons,L,TBL,30,77,11,6,17
2,8482155,Alex Laferriere,R,LAK,23,66,11,6,17
2,8477979,Nicolas Aube-Kubel,R,BUF,28,62,9,8,17
2,8477015,Connor Brown,R,EDM,30,61,9,8,17
2,8482749,Joshua Roy,R,MTL,21,62,8,9,17
2,8483468,Jiri Kulich,C,BUF,20,63,8,9,17
2,8477903,Garnet Hathaway,R,PHI,33,61,8,9,17
2,8480011,Klim Kostin,C,SJS,25,50,8,9,17
2,8473453,Trevor Lewis,C,LAK,37,75,8,9,17
2,8480222,Sebastian Aho,D,PIT,28,71,6,11,17
2,8481527,Kaedan Korczak,D,VGK,23,45,6,11,17
2,8482634,Alex Steeves,C,TOR,25,57,5,12,17
2,8479293,Brandon Tanev,L,SEA,33,64,4,13,17
2,8480172,Jan Rutta,D,SJS,34,62,4,13,17
2,8475233,David Savard,D,MTL,34,64,3,14,17
2,8476931,Jake McCabe,D,TOR,31,65,3,14,17
2,8475324,Nick Jensen,D,OTT,34,63,2,15,17
2,8475462,Radko Gudas,D,ANA,34,61,2,15,17
2,8475718,Justin Holl,D,DET,32,58,2,15,17
2,8475842,Sam Carrick,C,NYR,32,54,12,4,16
2,8481754,Nikita Nesterenko,C,ANA,23,43,10,6,16
2,8475220,Marcus Foligno,L,MIN,33,58,9,7,16
2,8480205,Emil Bemstrom,C,PIT,25,58,9,7,16
2,8481641,Joel Kiviranta,L,COL,28,67,9,7,16
2,8477446,Michael McCarron,R,NSH,29,54,8,8,16
2,8480748,Kiefer Sherwood,L,VAN,29,55,7,9,16
2,8478585,Derek Ryan,C,EDM,38,67,7,9,16
2,8482859,Zack Ostapchuk,C,OTT,21,59,6,10,16
2,8483495,Simon Nemec,D,NJD,20,58,6,10,16
2,8482807,Ethan Del Mastro,D,CHI,21,53,5,11,16
2,8481521,Ronnie Attard,D,PHI,25,50,5,11,16
2,8481013,Jonatan Berggren,R,DET,24,62,5,11,16
2,8478399,Jonas Siegenthaler,D,NJD,27,61,5,11,16
2,8478970,Jalen Chatfield,D,CAR,28,68,4,12,16
2,8477478,William Carrier,L,CAR,30,55,4,12,16
2,8481568,Alex Vlasic,D,CHI,23,52,4,12,16
2,8474034,Pat Maroon,L,CHI,36,47,4,12,16
2,8481599,Victor Soderstrom,D,UTA,23,50,4,12,16
2,8480246,Nick Perbix,D,TBL,26,71,3,13,16
2,8475179,Dmitry Kulikov,D,FLA,34,61,2,14,16
2,8477220,Nate Schmidt,D,FLA,33,66,1,15,16
2,8479982,Conor Timmins,D,TOR,26,59,0,16,16
2,8479066,Ryan Lomberg,L,CGY,30,71,12,3,15
2,8481716,Dmitri Voronkov,L,CBJ,24,55,10,5,15
2,8477573,Nathan Walker,L,STL,30,48,10,5,15
2,8479671,Mathieu Olivier,R,CBJ,27,46,9,6,15
2,8482166,Shakir Mukhamadullin,D,SJS,22,58,8,7,15
2,8479372,Josh Mahura,D,SEA,26,48,8,7,15
2,8482762,Simon Edvinsson,D,DET,21,45,7,8,15
2,8483466,Kevin Korchinski,D,CHI,20,49,6,9,15
2,8474013,Ian Cole,D,UTA,35,51,6,9,15
2,8480796,Martin Fehervary,D,WSH,25,49,6,9,15
2,8475235,Nicolas Deslauriers,L,PHI,33,57,5,10,15
2,8479369,Andrew Peeke,D,BOS,26,55,4,11,15
2,8481751,Lukas Rousek,R,BUF,25,40,4,11,15
2,8482073,Braden Schneider,D,NYR,23,58,3,12,15
2,8477919,Frederick Gaudreau,C,MIN,31,57,3,12,15
2,8475279,Ben Chiarot,D,DET,33,66,3,12,15
2,8473507,Jeff Petry,D,DET,37,75,2,13,15
2,8475762,Derek Forbort,D,VAN,32,54,2,13,15
2,8482245,Artem Zub,D,OTT,29,64,1,14,15
2,8479370,Tyson Jost,C,CAR,26,52,10,4,14
2,8482666,Scott Morrow,D,CAR,22,50,6,8,14
2,8479442,Troy Stecher,D,EDM,30,50,6,8,14
2,8480848,Ty Dellandrea,C,SJS,24,47,6,8,14
2,8482157,Will Cuylle,L,NYR,22,60,5,9,14
2,8478421,A.J. Greer,L,FLA,28,59,5,9,14
2,8477505,Alexander Wennberg,C,SJS,30,41,5,9,14
2,8480058,Pierre-Olivier Joseph,D,STL,25,58,3,11,14
2,8479348,Kale Clague,D,BUF,26,40,3,11,14
2,8477851,Jordan Oesterle,D,BOS,32,37,2,12,14
2,8481517,Brett Leason,R,ANA,25,56,1,13,14
2,8475750,Jon Merrill,D,MIN,32,58,0,14,14
2,8484911,Collin Graf,R,SJS,22,48,8,5,13
2,8480355,Mark Kastelic,C,BOS,25,58,5,8,13
2,8480192,Johnathan Kovacevic,D,NJD,27,50,5,8,13
2,8478451,Ethan Bear,D,WSH,27,52,4,9,13
2,8480007,Jonas Rondbjerg,R,VGK,25,41,4,9,13
2,8480049,Dylan Samberg,D,WPG,25,68,3,10,13
2,8482062,Cole Smith,L,NSH,29,69,3,10,13
2,8477365,Connor Clifton,D,BUF,29,53,3,10,13
2,8478859,Niko Mikkola,D,FLA,28,53,3,10,13
2,8477435,Ryan Graves,D,PIT,29,75,2,11,13
2,8480990,Declan Chisholm,D,MIN,24,52,2,11,13
2,8481059,Scott Perunovich,D,STL,26,56,1,12,13
2,8477938,Haydn Fleury,D,WPG,28,47,1,12,13
2,8480807,Mattias Samuelsson,D,BUF,24,61,0,13,13
2,8474612,Travis Hamonic,D,OTT,34,46,0,13,13
2,8480448,Parker Kelly,L,COL,25,75,7,5,12
2,8479344,Jesse Puljujarvi,R,PIT,26,48,6,6,12
2,8475855,Jesper Fast,R,CAR,33,59,6,6,12
2,8480021,Jack Studnicka,C,LAK,25,52,6,6,12
2,8482077,Dylan Holloway,L,EDM,23,49,5,7,12
2,8478409,Anthony Richard,C,PHI,28,42,5,7,12
2,8480834,Ty Emberson,D,SJS,24,45,4,8,12
2,8476988,Matt Benning,D,SJS,30,63,3,9,12
2,8474567,Zach Bogosian,D,MIN,34,60,3,9,12
2,8482095,Tyler Kleven,D,OTT,22,48,3,9,12
2,8479998,Mikey Anderson,D,LAK,25,64,2,10,12
2,8480887,Jordan Harris,D,MTL,24,57,2,10,12
2,8480727,Zach Whitecloud,D,VGK,28,51,2,10,12
2,8482176,Wyatt Kaiser,D,CHI,22,44,2,10,12
2,8484254,Akito Hirose,D,VAN,25,37,2,10,12
2,8476874,Olli Maatta,D,DET,30,69,1,11,12
2,8478416,Erik Cernak,D,TBL,27,75,0,12,12
2,8480001,Urho Vaakanainen,D,ANA,25,59,0,12,12
2,8476858,Phillip Di Giuseppe,L,VAN,31,44,9,2,11
2,8476624,Barclay Goodrow,C,SJS,31,59,7,4,11
2,8482659,Josh Doan,R,UTA,22,55,6,5,11
2,8480806,Isac Lundestrom,C,ANA,25,51,6,5,11
2,8481518,Nolan Foote,L,NJD,24,43,6,5,11
2,8481161,Jake Christiansen,D,CBJ,25,56,5,6,11
2,8477499,Rasmus Ristolainen,D,PHI,30,49,5,6,11
2,8477070,Liam O'Brien,C,UTA,30,54,5,6,11
2,8476329,Travis Boyd,C,MIN,31,49,5,6,11
2,8476873,Mark Jankowski,C,NSH,30,48,4,7,11
2,8481598,Philip Broberg,D,EDM,23,43,4,7,11
2,8470600,Ryan Suter,D,STL,39,62,3,8,11
2,8482964,Arber Xhekaj,D,MTL,23,49,3,8,11
2,8480880,Jakub Lauko,C,MIN,24,43,3,8,11
2,8479994,Jaret Anderson-Dolan,C,WPG,25,42,3,8,11
2,8482192,Isaak Phillips,D,CHI,23,51,2,9,11
2,8474166,Alec Martinez,D,CHI,37,50,2,9,11
2,8480441,Trey Fix-Wolansky,R,CBJ,25,37,2,9,11
2,8476429,Scott Mayfield,D,NYI,32,73,1,10,11
2,8478851,Alexandre Carrier,D,NSH,28,69,1,10,11
2,8474090,Brendan Smith,D,DAL,35,72,1,10,11
2,8480196,Jacob Bryson,D,BUF,27,47,1,10,11
2,8479378,Logan Stanley,D,WPG,26,40,1,10,11
2,8482784,Zach Dean,C,STL,21,49,7,3,10
2,8481592,Jakob Pelletier,L,CGY,23,45,6,4,10
2,8481028,Martin Pospisil,C,CGY,25,48,6,4,10
2,8477406,Mattias Janmark,C,EDM,32,69,5,5,10
2,8479359,Beck Malenstyn,L,BUF,26,44,5,5,10
2,8482145,Mavrik Bourque,C,DAL,22,54,5,5,10
2,8479638,Justin Brazeau,R,BOS,26,44,5,5,10
2,8483565,Nick Blankenburg,D,NSH,26,63,4,6,10
2,8479944,Zach Aston-Reese,C,VGK,30,49,4,6,10
2,8481532,Alex Turcotte,C,LAK,23,51,4,6,10
2,8479520,Brandon Duhaime,R,WSH,27,48,3,7,10
2,8480070,Ian Mitchell,D,BOS,25,52,3,7,10
2,8479576,Vincent Desharnais,D,VAN,28,34,3,7,10
2,8477335,Kyle Burroughs,D,LAK,29,45,3,7,10
2,8481178,Egor Zamula,D,PHI,24,66,2,8,10
2,8481524,Bowen Byram,D,BUF,23,48,2,8,10
2,8478211,Dryden Hunt,L,CGY,29,50,1,9,10
2,8481567,Henry Thrun,D,SJS,23,50,1,9,10
2,8480860,Kevin Bahl,D,CGY,24,55,1,9,10
2,8482451,Mikael Pyyhtia,L,CBJ,23,40,1,9,10
2,8479985,Cale Fleury,D,SEA,26,36,0,10,10
2,8476822,Luke Glendening,C,TBL,35,73,6,3,9
2,8481550,Adam Beckman,L,NJD,23,37,5,4,9
2,8481019,David Gustafsson,C,WPG,24,42,4,5,9
2,8478424,Jansen Harkins,C,ANA,27,44,4,5,9
2,8479026,Philippe Myers,D,TOR,27,45,3,6,9
2,8482747,Brennan Othmann,L,NYR,21,39,3,6,9
2,8479536,Axel Jonsson-Fjallby,L,WPG,26,38,3,6,9
2,8476473,Connor Murphy,D,CHI,31,45,2,7,9
2,8478452,Caleb Jones,D,LAK,27,53,1,8,9
2,8479249,Andrew Poturalski,C,SJS,30,29,1,8,9
2,8476372,Nick Seeler,D,PHI,31,40,0,9,9
2,8478569,Noel Acciari,C,PIT,33,56,6,2,8
2,8476913,Devin Shore,C,MIN,30,39,5,3,8
2,8476442,Matt Nieto,L,PIT,32,51,4,4,8
2,8481600,Tobias Bjornfot,D,FLA,23,46,4,4,8
2,8482733,Logan Mailloux,D,MTL,31,32,4,4,8
2,8481147,Reese Johnson,C,MIN,26,36,4,4,8
2,8483397,Marc McLaughlin,C,BOS,25,32,3,5,8
2,8481522,Peyton Krebs,C,BUF,23,54,2,6,8
2,8481167,Brayden Pachal,D,CGY,25,42,2,6,8
2,8480292,Carson Meyer,R,ANA,27,34,2,6,8
2,8477384,Josh Brown,D,EDM,30,51,2,6,8
2,8471677,Jack Johnson,D,CBJ,37,58,1,7,8
2,8480870,Bo Groulx,C,NYR,24,31,1,7,8
2,8482861,Vincent Iorio,D,WSH,22,28,1,7,8
2,8474568,Luke Schenn,D,NSH,35,43,0,8,8
2,8471817,Ryan Reaves,R,TOR,37,61,3,4,7
2,8480844,Grigori Denisenko,L,VGK,24,33,3,4,7
2,8477018,Ben Hutton,D,VGK,31,43,2,5,7
2,8479986,Kole Lind,R,DAL,26,43,2,5,7
2,8482144,Jack Thompson,D,SJS,22,23,2,5,7
2,8478450,Parker Wotherspoon,D,BOS,27,41,1,6,7
2,8473446,Erik Johnson,D,PHI,36,48,1,6,7
2,8483460,David Jiricek,D,CBJ,21,62,1,6,7
2,8477034,Jaycob Megna,D,FLA,32,41,1,6,7
2,8477887,Patrick Brown,C,BOS,32,42,5,1,6
2,8479968,Vinni Lettieri,C,BOS,29,40,4,2,6
2,8481789,Tye Kartye,L,SEA,23,37,4,2,6
2,8478017,Mark Friedman,D,VAN,29,26,4,2,6
2,8483012,Logan Morrison,C,SEA,22,41,4,2,6
2,8483570,Ben Meyers,C,SEA,26,28,4,2,6
2,8482652,Walker Duehr,R,CGY,27,46,3,3,6
2,8477962,Brendan Lemieux,L,CAR,28,42,3,3,6
2,8480245,Olle Lycksell,R,PHI,25,27,3,3,6
2,8478146,Matthew Highmore,C,OTT,28,32,3,3,6
2,8482141,Lukas Cormier,D,VGK,22,26,2,4,6
2,8478874,Adam Gaudette,C,OTT,28,35,2,4,6
2,8479772,Zack MacEwen,R,OTT,28,54,2,4,6
2,8482751,Ryan Winterton,C,SEA,21,40,2,4,6
2,8483763,Maksymilian Szuber,D,UTA,22,33,2,4,6
2,8483549,Lucas Condotta,L,MTL,27,25,2,4,6
2,8481556,John Beecher,C,BOS,23,33,2,4,6
2,8480032,Shane Bowers,C,NJD,25,13,2,4,6
2,8476441,Joel Edmundson,D,LAK,31,33,2,4,6
2,8475177,Calvin de Haan,D,COL,33,36,1,5,6
2,8479439,Jacob MacDonald,D,COL,31,45,1,5,6
2,8482858,Ryker Evans,D,SEA,23,30,1,5,6
2,8475795,Dylan McIlrath,D,WSH,32,21,1,5,6
2,8478021,William Lagesson,D,DET,28,24,1,5,6
2,8482102,Vasily Ponomarev,C,PIT,22,25,1,5,6
2,8481701,Santeri Hatakka,D,NJD,23,37,0,6,6
2,8482516,Matthew Kessel,D,STL,24,20,0,6,6
2,8477244,Chad Ruhwedel,D,NYR,34,36,0,6,6
2,8481699,Aku Raty,R,UTA,23,17,0,6,6
2,8481609,Vladislav Kolyachonok,D,UTA,23,35,4,1,5
2,8482713,Mackie Samoskevich,R,FLA,22,39,3,2,5
2,8477527,Ross Johnston,L,ANA,30,32,3,2,5
2,8481679,Maxence Guenette,D,OTT,23,37,3,2,5
2,8477320,Anton Blidh,L,NYR,29,29,3,2,5
2,8482496,Nils Aman,C,VAN,24,35,2,3,5
2,8480879,Jacob Bernard-Docker,D,OTT,24,41,2,3,5
2,8480267,Sammy Walker,C,MIN,25,21,2,3,5
2,8480468,James Hamblin,L,EDM,25,16,2,3,5
2,8481006,Tyler Tucker,D,STL,24,17,2,3,5
2,8482172,Landon Slaggert,L,CHI,22,33,2,3,5
2,8482118,Sam Colangelo,R,ANA,23,14,2,3,5
2,8481605,Jackson LaCombe,D,ANA,23,37,1,4,5
2,8482744,James Malatesta,L,CBJ,21,47,1,4,5
2,8479972,Mason Shaw,C,WPG,26,25,1,4,5
2,8477473,Justin Bailey,R,SJS,29,26,1,4,5
2,8481056,Spencer Stastney,D,NSH,24,30,0,5,5
2,8476952,Dominic Toninato,C,WPG,30,30,0,5,5
2,8475958,Michael Sgarbossa,C,WSH,32,26,0,5,5
2,8482511,Mason Lohrei,D,BOS,23,34,3,1,4
2,8482460,Matt Rempe,C,NYR,22,10,3,1,4
2,8479330,Brandon Gignac,C,MTL,27,11,3,1,4
2,8479291,Kevin Rooney,C,CGY,31,49,2,2,4
2,8482765,Isak Rosen,R,BUF,21,32,2,2,4
2,8476867,Brendan Gaunce,C,MIN,30,31,2,2,4
2,8483630,Pavol Regenda,L,ANA,25,32,2,2,4
2,8484258,Sam Malinski,D,COL,26,22,2,2,4
2,8478011,Louie Belpedio,D,PHI,28,15,2,2,4
2,8482165,Yan Kuznetsov,D,CGY,22,21,2,2,4
2,8482162,Roby Jarventie,L,EDM,22,23,2,2,4
2,8481122,Simon Benoit,D,TOR,26,45,1,3,4
2,8477810,Joel Hanley,D,CGY,33,27,1,3,4
2,8483619,Filip Roos,D,OTT,25,37,1,3,4
2,8475755,Alexander Petrovic,D,DAL,32,17,1,3,4
2,8481030,Jack St. Ivany,D,PIT,25,23,1,3,4
2,8477073,Kurtis MacDermid,L,NJD,30,32,3,0,3
2,8484287,Cole McWard,D,VAN,23,35,3,0,3
2,8481743,Marc Del Gaizo,D,NSH,25,24,3,0,3
2,8482153,Brendan Brisson,C,VGK,23,32,2,1,3
2,8477401,John Hayden,C,SEA,29,30,2,1,3
2,8479379,Givani Smith,R,SJS,26,31,2,1,3
2,8481065,Angus Crookshank,L,OTT,25,18,2,1,3
2,8483597,Milos Kelemen,L,UTA,25,14,2,1,3
2,8482177,Marat Khusnutdinov,C,MIN,22,34,1,2,3
2,8479367,William Lockwood,R,FLA,26,15,1,2,3
2,8481593,Jayden Struble,D,MTL,23,19,1,2,3
2,8483567,Georgii Merkulov,C,BOS,24,12,1,2,3
2,8482470,Ilya Solovyov,D,CGY,24,23,1,2,3
2,8480890,Jan Jenik,R,OTT,24,24,1,2,3
2,8477462,Robert Hagg,D,VGK,29,18,1,2,3
2,8475413,Justin Dowling,C,NJD,34,17,1,2,3
2,8478454,Noah Juulsen,D,VAN,27,22,0,3,3
2,8477149,Scott Sabourin,R,SJS,32,13,0,3,3
2,8477971,Andreas Englund,D,LAK,28,38,0,3,3
2,8482088,Justin Sourdif,R,FLA,22,24,0,3,3
2,8482147,Jean-Luc Foudy,C,COL,22,26,2,0,2
2,8483512,Matt Savoie,C,EDM,20,21,2,0,2
2,8481206,John Ludvig,D,PIT,24,6,2,0,2
2,8478881,Brett Seney,L,CHI,28,16,2,0,2
2,8479991,Jake Leschyshyn,C,NYR,25,27,1,1,2
2,8481043,Cole Koepke,L,BOS,26,17,1,1,2
2,8481564,Ryan Johnson,D,BUF,23,18,1,1,2
2,8480823,Alexander Alexeyev,D,WSH,25,12,1,1,2
2,8480075,Cameron Crotty,D,MIN,25,6,1,1,2
2,8477467,Gustav Olofsson,D,SEA,30,15,1,1,2
2,8478051,Max Willman,C,NJD,29,16,1,1,2
2,8482476,Emil Heineman,L,MTL,23,13,1,1,2
2,8480306,Grant Hutton,D,NYI,29,6,1,1,2
2,8480845,Rasmus Kupari,C,WPG,24,36,0,2,2
2,8481541,Samuel Bolduc,D,NYI,24,25,0,2,2
2,8479981,Jonah Gadjovich,L,FLA,26,35,0,2,2
2,8478502,Dennis Gilbert,D,BUF,28,17,0,2,2
2,8479362,Riley Tufte,L,BOS,26,26,0,2,2
2,8479419,Brett Murray,L,BUF,26,14,0,2,2
2,8482061,Brandon Biro,L,SEA,26,16,0,2,2
2,8479421,Jacob Moverare,D,LAK,26,8,0,2,2
2,8484325,Waltteri Merela,C,TBL,26,27,0,2,2
2,8481578,Graeme Clarke,R,MIN,23,6,1,0,1
2,8474062,Riley Nash,C,NYR,35,26,1,0,1
2,8480851,Akil Thomas,C,LAK,24,18,1,0,1
2,8477541,Dakota Mermis,D,TOR,30,12,1,0,1
2,8483920,Pierrick Dube,R,WSH,23,5,1,0,1
2,8484255,Jason Polin,R,COL,25,6,1,0,1
2,8482929,Emil Lilleberg,D,TBL,23,13,1,0,1
2,8476323,Max McCormick,L,SEA,32,3,1,0,1
2,8484304,Uvis Balinskis,D,FLA,28,11,1,0,1
2,8475780,Chris Wagner,R,COL,33,11,1,0,1
2,8482250,Callahan Burke,C,VGK,27,21,0,1,1
2,8482070,Mitchell Chaffee,R,TBL,26,51,0,1,1
2,8481543,Nikita Alexandrov,C,STL,24,22,0,1,1
2,8483395,Arshdeep Bains,L,VAN,23,9,0,1,1
2,8481422,Jacob Lucchini,C,NSH,29,21,0,1,1
2,8481585,Egor Afanasyev,L,SJS,23,13,0,1,1
2,8479320,Max Lajoie,D,SEA,27,16,0,1,1
2,8481719,Maxwell Crozier,D,TBL,24,20,0,1,1
2,8479587,Rhett Gardner,C,PHI,28,13,0,1,1
2,8478446,Glenn Gawdin,C,LAK,27,13,0,1,1
2,8481024,Linus Karlsson,C,VAN,25,10,0,1,1
2,8483471,Brad Lambert,C,WPG,31,14,0,1,1
2,8480084,Nick DeSimone,D,NJD,30,16,0,1,1
2,8483432,Luca Del Bel Belluz,C,CBJ,31,6,0,1,1
2,8482787,Nikita Chibrikov,R,WPG,31,7,0,1,1
2,8483609,Adam Klapka,R,CGY,24,4,0,1,1
2,8481726,Adam Edstrom,C,NYR,24,9,0,1,1
2,8478147,Bokondji Imama,L,PIT,28,4,0,1,1
2,8482201,Gage Goncalves,C,TBL,23,20,0,0,0
2,8481237,Kyle MacLean,C,NYI,25,27,0,0,0
2,8483407,Brandon Scanlin,D,NYR,25,4,0,0,0
2,8478477,Mitchell Stephens,C,SEA,27,13,0,0,0
2,8481655,Cole Schwindt,R,CGY,23,6,0,0,0
2,8480874,Adam Ginning,D,PHI,24,12,0,0,0
2,8482126,Emil Andrae,D,PHI,31,2,0,0,0
2,8477993,Justin Kirkland,C,CGY,28,11,0,0,0
2,8483489,Fraser Minten,C,TOR,31,10,0,0,0
2,8478854,Ryan Shea,D,PIT,27,3,0,0,0
2,8479321,Lucas Johansen,D,,27,0,0,0,0
2,8470794,Joe Pavelski,C,,40,0,0,0,0
2,8477950,Tony DeAngelo,D,,29,0,0,0,0
2,8471218,Blake Wheeler,R,,38,0,0,0,0
2,8475197,Tyson Barrie,D,,33,0,0,0,0
2,8475744,Evgeny Kuznetsov,C,,32,0,0,0,0
2,8474037,James van Riemsdyk,L,,35,0,0,0,0
2,8474602,Justin Schultz,D,,34,0,0,0,0
2,8482222,Alexander Barabanov,L,,30,0,0,0,0
2,8474157,Max Pacioretty,L,,36,0,0,0,0
2,8474031,Kevin Shattenkirk,D,,35,0,0,0,0
2,8480884,Calen Addison,D,,24,0,0,0,0
2,8480008,Adam Ruzicka,C,,25,0,0,0,0
2,8475906,John Klingberg,D,,32,0,0,0,0
2,8476884,Derrick Pouliot,D,,30,0,0,0,0
2,8476919,Chris Tierney,C,,30,0,0,0,0
2,8479415,Michael McLeod,C,,26,0,0,0,0
2,8474884,Mike Hoffman,C,,35,0,0,0,0
2,8478104,Sammy Blais,L,,28,0,0,0,0
2,8474870,Tyler Johnson,C,,34,0,0,0,0
2,8481591,Sam Poulin,R,,23,0,0,0,0
2,8479977,Kailer Yamamoto,R,,26,0,0,0,0
2,8476393,Nick Cousins,C,,31,0,0,0,0
2,8479376,Victor Mete,D,,26,0,0,0,0
2,8476871,Tanner Pearson,L,,32,0,0,0,0
2,8471274,Alex Goligoski,D,,39,0,0,0,0
2,8481058,Jesse Ylönen,R,,25,0,0,0,0
2,8477464,Nic Petan,C,,29,0,0,0,0
2,8473449,Kyle Okposo,R,,36,0,0,0,0
2,8480216,Jacob Peterson,C,,25,0,0,0,0
2,8479346,Dillon Dube,C,,26,0,0,0,0
2,8470966,Mark Giordano,D,,41,0,0,0,0
2,8480821,Filip Zadina,R,,25,0,0,0,0
2,8476907,Mackenzie MacEachern,L,,30,0,0,0,0
2,8478430,Oliver Kylington,D,,27,0,0,0,0
2,8479514,Rem Pitlick,C,,27,0,0,0,0
2,8478099,Kevin Labanc,R,,29,0,0,0,0
2,8482241,Radim Zohorna,L,,28,0,0,0,0
2,8474040,Sam Gagner,C,,35,0,0,0,0
2,8475164,Jakob Silfverberg,R,,34,0,0,0,0
2,8475752,Tyler Pitlick,C,,33,0,0,0,0
2,8479984,Cal Foote,D,,26,0,0,0,0
2,8478495,Denis Gurianov,R,,27,0,0,0,0
2,8479533,Joona Koppanen,L,,26,0,0,0,0
2,8479458,Nikita Zaitsev,D,,33,0,0,0,0
2,8471699,Andrew Cogliano,C,,37,0,0,0,0
2,8470604,Jeff Carter,C,,39,0,0,0,0
2,8477330,Dominik Kubalik,L,,29,0,0,0,0
2,8477944,Jakub Vrana,L,,28,0,0,0,0
2,8478904,Steven Lorentz,C,,28,0,0,0,0
2,8471686,Marc Staal,D,,37,0,0,0,0
2,8478512,Austin Czarnik,C,,32,0,0,0,0
2,8470610,Zach Parise,L,,40,0,0,0,0
2,8473504,Cal Clutterbuck,R,,37,0,0,0,0
2,8474009,Nick Bonino,C,,36,0,0,0,0
2,8477454,Adam Erne,L,,29,0,0,0,0
2,8477126,Jayson Megna,C,,34,0,0,0,0
2,8473473,Milan Lucic,L,,36,0,0,0,0
2,8478067,Oskar Lindblom,L,,28,0,0,0,0
2,8475825,Jani Hakanpää,D,,32,0,0,0,0
2,8479383,Boris Katchouk,L,,26,0,0,0,0
2,8478400,Colin White,C,,27,0,0,0,0
2,8477846,Ryan Carpenter,C,,33,0,0,0,0
2,8477930,Pierre-Edouard Bellemare,L,,39,0,0,0,0
2,8479423,Alex Nylander,L,,26,0,0,0,0
2,8475797,Jarred Tinordi,D,,32,0,0,0,0
2,8481239,Samuel Fagemo,L,,24,0,0,0,0
2,8474618,Marco Scandella,D,,34,0,0,0,0
2,8480853,Liam Foudy,C,,24,0,0,0,0
2,8482094,Daemon Hunt,D,MIN,22,12,0,0,0
2,8478028,Fredrik Olofsson,L,,28,0,0,0,0
2,8474145,Robert Bortuzzo,D,,35,0,0,0,0
2,8474709,Matt Martin,L,,35,0,0,0,0
2,8480226,Marián Studenic,R,,26,0,0,0,0
2,8479522,Hardy Haman Aktell,D,WSH,26,0,0,0,0
2,8481806,Louis Crevier,D,CHI,23,14,0,0,0
2,8480274,Philip Kemp,D,EDM,25,0,0,0,0
2,8480184,Gustav Lindstrom,D,,26,0,0,0,0
2,8481077,John Leonard,L,,26,0,0,0,0
2,8479547,Matthew Phillips,R,,26,0,0,0,0
2,8476915,Jujhar Khaira,L,,30,0,0,0,0
2,8481070,Hugh McGing,L,,26,0,0,0,0
2,8483546,Marshall Rifai,D,TOR,26,5,0,0,0
2,8478408,Travis Dermott,D,,28,0,0,0,0
2,8484326,Patrik Koch,D,UTA,28,0,0,0,0
2,8481812,Nikolai Knyzhov,D,,27,0,0,0,0
2,8482197,Adam Raska,R,MIN,23,3,0,0,0
2,8484321,Nikolas Matinpalo,D,OTT,26,4,0,0,0
2,8475278,Byron Froese,C,,33,0,0,0,0
2,8475766,Austin Watson,L,,32,0,0,0,0
2,8483398,Declan Carlile,D,TBL,31,8,0,0,0
2,8479546,Oskar Steen,C,,26,0,0,0,0
2,8480836,Jonathan Gruden,C,,24,0,0,0,0
2,8481690,Tyler Angle,C,,24,0,0,0,0
2,8480031,Maxime Comtois,L,,25,0,0,0,0
2,8483045,Cameron Butler,R,CBJ,31,0,0,0,0
2,8478078,Rourke Chartier,C,,28,0,0,0,0
2,8481016,Ruslan Iskhakov,C,,24,0,0,0,0
2,8481534,Raphael Lavoie,C,EDM,24,1,0,0,0
2,8484314,Jiri Smejkal,L,,28,0,0,0,0
2,8478956,Samuel Laberge,L,NJD,27,0,0,0,0
2,8481462,Mason Morelli,L,VGK,28,9,0,0,0
2,8483401,Marc Johnstone,R,PIT,28,1,0,0,0
2,8483531,Brian Halonen,L,NJD,25,0,0,0,0
2,8484259,Ondrej Pavel,C,COL,31,2,0,0,0
2,8480776,Sheldon Rempal,R,,29,0,0,0,0
3,8477492,Nathan MacKinnon,C,COL,29,81,66,93,159
3,8478402,Connor McDavid,C,EDM,27,79,40,96,136
3,8479318,Auston Matthews,C,TOR,27,81,55,73,128
3,8476453,Nikita Kucherov,R,TBL,31,82,30,86,116
3,8478420,Mikko Rantanen,R,COL,28,81,45,62,107
3,8478864,Kirill Kaprizov,L,MIN,27,73,42,62,104
3,8481559,Jack Hughes,C,NJD,23,81,38,66,104
3,8482116,Tim Stützle,C,OTT,22,80,37,66,103
3,8477956,David Pastrnak,R,BOS,28,78,46,56,102
3,8477934,Leon Draisaitl,C,EDM,29,78,42,60,102
3,8478010,Brayden Point,C,TBL,28,80,52,49,101
3,8477939,William Nylander,R,TOR,28,81,50,50,100
3,8477946,Dylan Larkin,C,DET,28,80,52,47,99
3,8479314,Matthew Tkachuk,L,FLA,27,79,30,65,95
3,8475172,Nazem Kadri,C,CGY,34,77,37,57,94
3,8480012,Elias Pettersson,C,VAN,26,70,36,58,94
3,8476887,Filip Forsberg,L,NSH,30,70,35,57,92
3,8480002,Nico Hischier,C,NJD,25,75,34,56,90
3,8480023,Robert Thomas,C,STL,25,78,26,64,90
3,8474600,Roman Josi,D,NSH,34,75,26,64,90
3,8479323,Adam Fox,D,NYR,26,79,18,72,90
3,8475913,Mark Stone,R,VGK,32,76,34,54,88
3,8475166,John Tavares,C,TOR,34,81,40,47,87
3,8477493,Aleksander Barkov,C,FLA,29,77,36,51,87
3,8471675,Sidney Crosby,C,PIT,37,72,44,42,86
3,8478398,Kyle Connor,L,WPG,28,80,43,43,86
3,8478550,Artemi Panarin,L,NYR,33,76,26,60,86
3,8478427,Sebastian Aho,C,CAR,27,73,34,51,85
3,8478445,Mathew Barzal,C,NYI,27,82,20,65,85
3,8473419,Brad Marchand,L,BOS,36,79,32,52,84
3,8476468,J.T. Miller,C,VAN,31,73,28,56,84
3,8478460,Zach Werenski,D,CBJ,27,82,20,64,84
3,8477409,Carter Verhaeghe,C,FLA,29,82,41,42,83
3,8477501,Valeri Nichushkin,R,COL,29,81,38,44,82
3,8479407,Jesper Bratt,L,NJD,26,77,32,50,82
3,8477404,Jake Guentzel,C,TBL,30,82,30,52,82
3,8480027,Jason Robertson,L,DAL,25,79,27,55,82
3,8480830,Andrei Svechnikov,R,CAR,24,75,31,50,81
3,8477942,Kevin Fiala,L,LAK,28,82,40,40,80
3,8477933,Sam Reinhart,C,FLA,29,78,38,42,80
3,8480801,Brady Tkachuk,L,OTT,25,78,31,49,80
3,8480800,Quinn Hughes,D,VAN,25,73,10,70,80
3,8475170,Brayden Schenn,C,STL,33,76,29,49,78
3,8478403,Jack Eichel,C,VGK,28,79,35,42,77
3,8480069,Cale Makar,D,COL,26,74,13,64,77
3,8478444,Brock Boeser,R,VAN,27,77,36,40,76
3,8479385,Jordan Kyrou,C,STL,26,74,35,41,76
3,8476448,William Karlsson,C,VGK,31,77,34,42,76
3,8476881,Tomas Hertl,C,VGK,31,78,28,48,76
3,8475168,Matt Duchene,C,DAL,33,81,22,54,76
3,8479337,Alex DeBrincat,R,DET,27,81,31,44,75
3,8474141,Patrick Kane,R,DET,36,82,26,49,75
3,8478439,Travis Konecny,R,PHI,27,77,32,42,74
3,8474564,Steven Stamkos,C,NSH,34,72,32,42,74
3,8476459,Mika Zibanejad,C,NYR,31,78,25,49,74
3,8475786,Zach Hyman,L,EDM,32,75,38,35,73
3,8476539,Jonathan Marchessault,R,NSH,34,76,31,42,73
3,8482093,Seth Jarvis,C,CAR,22,75,30,43,73
3,8475810,Bryan Rust,R,PIT,32,72,35,37,72
3,8482078,Lucas Raymond,L,DET,22,81,26,46,72
3,8476456,Jonathan Huberdeau,C,CGY,31,78,20,52,72
3,8477402,Pavel Buchnevich,L,STL,29,76,30,41,71
3,8480839,Rasmus Dahlin,D,BUF,24,73,15,56,71
3,8479343,Clayton Keller,R,UTA,26,76,28,42,70
3,8479420,Tage Thompson,C,BUF,27,77,41,28,69
3,8484144,Connor Bedard,C,CHI,19,68,29,40,69
3,8482745,Mason McTavish,C,ANA,21,77,29,40,69
3,8476454,Ryan Nugent-Hopkins,C,EDM,31,76,17,52,69
3,8477504,Josh Morrissey,D,WPG,29,77,16,53,69
3,8480865,Noah Dobson,D,NYI,24,78,13,56,69
3,8478414,Timo Meier,R,NJD,28,72,36,32,68
3,8476389,Vincent Trocheck,C,NYR,31,76,35,33,68
3,8478440,Dylan Strome,C,WSH,27,68,30,38,68
3,8475158,Ryan O'Reilly,C,NSH,33,72,26,42,68
3,8477949,Alex Tuch,R,BUF,28,70,22,46,68
3,8479675,Trevor Moore,L,LAK,29,81,31,36,67
3,8482665,Matty Beniers,C,SEA,22,73,28,39,67
3,8476460,Mark Scheifele,C,WPG,31,70,26,41,67
3,8477955,Jared McCann,L,SEA,28,75,28,38,66
3,8482699,Dylan Guenther,R,UTA,21,75,23,43,66
3,8480208,Drake Batherson,R,OTT,26,80,32,33,65
3,8478449,Roope Hintz,C,DAL,28,81,29,36,65
3,8481557,Matt Boldy,L,MIN,23,72,24,41,65
3,8477500,Bo Horvat,C,NYI,29,79,26,38,64
3,8471215,Evgeni Malkin,C,PIT,38,71,26,38,64
3,8475794,Tyler Seguin,C,DAL,32,80,25,39,64
3,8479542,Brandon Hagel,L,TBL,26,82,23,41,64
3,8476853,Morgan Rielly,D,TOR,30,73,12,52,64
3,8477935,Sam Bennett,C,FLA,28,71,34,29,63
3,8475726,Tyler Toffoli,C,SJS,32,69,33,30,63
3,8475784,Jeff Skinner,C,EDM,32,79,31,32,63
3,8475692,Mats Zuccarello,R,MIN,37,75,17,46,63
3,8474590,John Carlson,D,WSH,34,76,14,49,63
3,8478407,Vince Dunn,D,SEA,28,73,14,49,63
3,8482740,Wyatt Johnston,C,DAL,21,82,37,25,62
3,8475754,Brock Nelson,C,NYI,33,81,36,26,62
3,8475169,Evander Kane,L,EDM,33,74,36,26,62
3,8480039,Martin Necas,C,CAR,25,71,27,35,62
3,8478873,Troy Terry,R,ANA,27,72,26,36,62
3,8473994,Jamie Benn,L,DAL,35,82,22,40,62
3,8475184,Chris Kreider,L,NYR,33,79,31,30,61
3,8477940,Nikolaj Ehlers,L,WPG,28,73,21,40,61
3,8483515,Juraj Slafkovsky,L,MTL,20,77,20,41,61
3,8484153,Leo Carlsson,C,ANA,20,72,25,35,60
3,8477416,Oliver Bjorkstrand,R,SEA,29,69,24,36,60
3,8480036,Miro Heiskanen,D,DAL,25,80,10,49,59
3,8471724,Kris Letang,D,PIT,37,79,10,49,59
3,8481540,Cole Caufield,R,MTL,23,73,36,22,58
3,8477960,Adrian Kempe,R,LAK,28,80,33,25,58
3,8478366,Frank Vatrano,R,ANA,30,71,27,31,58
3,8474102,David Perron,L,OTT,36,79,21,37,58
3,8480018,Nick Suzuki,C,MTL,25,75,15,43,58
3,8476346,Johnny Gaudreau,L,CBJ,31,70,10,48,58
3,8476880,Tom Wilson,R,WSH,30,68,28,29,57
3,8481528,Dylan Cozens,C,BUF,23,73,26,31,57
3,8481711,Matias Maccelli,L,UTA,24,74,22,35,57
3,8475167,Victor Hedman,D,TBL,34,79,20,37,57
3,8474679,Gustav Nyquist,C,NSH,35,72,20,37,57
3,8478469,Thomas Chabot,D,OTT,27,75,20,37,57
3,8473512,Claude Giroux,R,OTT,36,81,17,40,57
3,8474578,Erik Karlsson,D,PIT,34,77,16,41,57
3,8478493,Joel Eriksson Ek,C,MIN,27,72,23,33,56
3,8478975,Mason Marchment,L,DAL,29,82,22,34,56
3,8478047,Michael Bunting,L,PIT,29,74,22,34,56
3,8475151,Kyle Palmieri,C,NYI,33,77,35,20,55
3,8478462,Nicolas Roy,C,VGK,27,77,24,31,55
3,8481068,Yegor Sharangovich,C,CGY,26,79,24,31,55
3,8477951,Nick Schmaltz,C,UTA,28,78,20,35,55
3,8480803,Evan Bouchard,D,EDM,25,77,10,45,55
3,8479999,Casey Mittelstadt,C,COL,26,81,21,33,54
3,8484145,Zach Benson,L,BUF,19,72,21,33,54
3,8477503,Max Domi,C,TOR,29,81,15,39,54
3,8476854,Hampus Lindholm,D,BOS,30,75,9,45,54
3,8471214,Alex Ovechkin,L,WSH,39,73,32,21,53
3,8482124,Quinton Byfield,R,LAK,22,81,23,30,53
3,8477021,Alex Kerfoot,C,UTA,30,78,19,34,53
3,8477497,Sean Monahan,C,CBJ,30,69,18,35,53
3,8476458,Ryan Strome,C,ANA,31,66,27,25,52
3,8482667,William Eklund,L,SJS,22,72,22,30,52
3,8476905,Chandler Stephenson,C,SEA,30,79,17,35,52
3,8479325,Charlie McAvoy,D,BOS,27,72,15,37,52
3,8476875,Mike Matheson,D,MTL,30,74,14,38,52
3,8479987,Morgan Geekie,C,BOS,26,75,24,27,51
3,8482110,Dawson Mercer,C,NJD,23,77,23,28,51
3,8482684,Luke Hughes,D,NJD,21,72,13,38,51
3,8477447,Shea Theodore,D,VGK,29,60,8,43,51
3,8477964,Ivan Barbashev,C,VGK,29,79,29,21,50
3,8480064,Josh Norris,C,OTT,25,74,26,24,50
3,8477476,Artturi Lehkonen,L,COL,29,78,21,29,50
3,8475287,Erik Haula,L,NJD,33,74,20,30,50
3,8477407,Anthony Duclair,L,NYI,29,76,20,30,50
3,8480798,Philipp Kurashev,C,CHI,25,66,17,33,50
3,8475798,Mikael Granlund,C,SJS,32,66,16,34,50
3,8479425,Filip Hronek,D,VAN,27,75,16,34,50
3,8480434,Sean Durzi,D,UTA,26,72,10,40,50
3,8478396,Noah Hanifin,D,VGK,27,64,10,40,50
3,8476958,Jaccob Slavin,D,CAR,30,77,8,42,50
3,8478519,Anthony Cirelli,C,TBL,27,82,24,25,49
3,8473986,Alex Killorn,L,ANA,35,76,24,25,49
3,8483431,Logan Cooley,C,UTA,20,71,21,28,49
3,8474150,Mikael Backlund,C,CGY,35,75,20,29,49
3,8474586,Jordan Eberle,R,SEA,34,73,18,31,49
3,8476792,Torey Krug,D,STL,33,68,16,33,49
3,8477496,Elias Lindholm,C,BOS,30,78,15,34,49
3,8481542,Moritz Seider,D,DET,23,72,10,39,49
3,8483808,Andrei Kuzmenko,L,CGY,28,75,26,22,48
3,8475768,Jaden Schwartz,C,SEA,32,75,25,23,48
3,8479400,Pierre-Luc Dubois,L,WSH,26,69,18,30,48
3,8478401,Pavel Zacha,C,BOS,27,78,17,31,48
3,8477494,Jonathan Drouin,L,COL,29,81,11,37,48
3,8484166,Adam Fantilli,C,CBJ,20,65,26,21,47
3,8478856,Conor Garland,R,VAN,28,74,22,25,47
3,8478042,Viktor Arvidsson,R,EDM,31,77,19,28,47
3,8480797,Joel Farabee,L,PHI,24,77,18,29,47
3,8475765,Vladimir Tarasenko,R,DET,33,78,17,30,47
3,8481596,Shane Pinto,C,OTT,24,75,17,30,47
3,8481581,Thomas Harley,D,DAL,23,81,13,34,47
3,8475799,Nino Niederreiter,R,WPG,32,65,32,14,46
3,8476432,Boone Jenner,C,CBJ,31,72,29,17,46
3,8482109,Alexis Lafrenière,L,NYR,23,72,27,19,46
3,8471685,Anze Kopitar,C,LAK,37,80,18,28,46
3,8476399,Blake Coleman,C,CGY,33,71,17,29,46
3,8477986,Brandon Montour,D,SEA,30,70,13,33,46
3,8476462,Dougie Hamilton,D,NJD,31,69,13,33,46
3,8475745,Charlie Coyle,C,BOS,32,76,21,24,45
3,8480188,Fabian Zetterlund,L,SJS,25,68,20,25,45
3,8478057,Dakota Joshua,C,VAN,28,68,20,25,45
3,8482702,Logan Stankoven,C,DAL,21,79,24,20,44
3,8477451,Ryan Hartman,R,MIN,30,72,23,21,44
3,8479365,Trent Frederic,C,BOS,26,74,22,22,44
3,8479992,Michael Rasmussen,C,DET,25,80,16,28,44
3,8481533,Trevor Zegras,C,ANA,23,68,12,32,44
3,8483505,Matthew Poitras,C,BOS,20,79,12,32,44
3,8482105,Jake Sanderson,D,OTT,22,76,11,33,44
3,8480015,Owen Tippett,R,PHI,25,75,26,17,43
3,8477511,Anthony Mantha,R,CGY,30,77,21,22,43
3,8477346,MacKenzie Weegar,D,CGY,30,75,16,27,43
3,8477456,J.T. Compher,L,DET,29,81,15,28,43
3,8474565,Alex Pietrangelo,D,VGK,34,69,11,32,43
3,8478233,Andrew Mangiapane,L,WSH,28,73,18,24,42
3,8482149,Cole Perfetti,C,WPG,22,74,17,25,42
3,8478474,Lawson Crouse,L,UTA,27,73,16,26,42
3,8478458,Jack Roslovic,C,CAR,27,66,15,27,42
3,8475218,Mattias Ekholm,D,EDM,34,73,13,29,42
3,8476479,Phillip Danault,C,LAK,31,77,9,33,42
3,8470613,Brent Burns,D,CAR,39,76,9,33,42
3,8475314,Anders Lee,L,NYI,34,78,22,19,41
3,8482097,Jack Quinn,R,BUF,23,60,19,22,41
3,8481604,Pavel Dorofeyev,L,VGK,24,66,17,24,41
3,8476483,Rickard Rakell,R,PIT,31,61,15,26,41
3,8479525,Ross Colton,C,COL,28,76,14,27,41
3,8477948,Travis Sanheim,D,PHI,28,67,10,31,41
3,8478038,Devon Toews,D,COL,30,70,6,35,41
3,8477426,Nicholas Paul,L,TBL,29,82,23,17,40
3,8482175,JJ Peterka,R,BUF,22,68,20,20,40
3,8478438,Tommy Novak,C,NSH,27,68,14,26,40
3,8482720,Matthew Knies,L,TOR,22,79,13,27,40
3,8480145,Neal Pionk,D,WPG,29,73,7,33,40
3,8479410,Mikhail Sergachev,D,UTA,26,69,6,34,40
3,8478397,Rasmus Andersson,D,CGY,28,66,5,35,40
3,8478115,Pierre Engvall,L,NYI,28,75,22,17,39
3,8475714,Calle Jarnkrok,C,TOR,33,80,21,18,39
3,8478046,Danton Heinen,L,VAN,29,68,19,20,39
3,8470621,Corey Perry,R,EDM,39,73,17,22,39
3,8477444,Andre Burakovsky,L,SEA,29,68,16,23,39
3,8475763,Kevin Hayes,R,PIT,32,69,16,23,39
3,8477932,Aaron Ekblad,D,FLA,28,74,8,31,39
3,8480893,Kirill Marchenko,R,CBJ,24,69,25,13,38
3,8482159,Tyson Foerster,R,PHI,22,77,20,18,38
3,8476392,Adam Lowry,C,WPG,31,59,16,22,38
3,8480113,Alex Iafallo,L,WPG,31,71,16,22,38
3,8474149,Evgenii Dadonov,R,DAL,35,79,16,22,38
3,8484203,Bradly Nadeau,L,CAR,19,57,10,28,38
3,8478055,Gustav Forsling,D,FLA,28,74,9,29,38
3,8476906,Shayne Gostisbehere,D,CAR,31,76,8,30,38
3,8478498,Jake DeBrusk,L,VAN,28,69,22,15,37
3,8477953,Kasperi Kapanen,R,STL,28,62,16,21,37
3,8475793,Ryan Johansen,C,PHI,32,71,15,22,37
3,8477479,Tyler Bertuzzi,L,CHI,29,65,13,24,37
3,8476826,Yanni Gourde,C,SEA,33,69,13,24,37
3,8482660,Kent Johnson,C,CBJ,22,60,12,25,37
3,8475200,Dmitry Orlov,D,CAR,33,74,12,25,37
3,8478472,Mathieu Joseph,R,STL,27,67,9,28,37
3,8482122,Brock Faber,D,MIN,22,79,6,31,37
3,8475764,Cam Fowler,D,ANA,33,72,2,35,37
3,8482089,Jake Neighbours,L,STL,22,66,25,11,36
3,8475760,Nick Bjugstad,C,UTA,32,72,24,12,36
3,8480849,Barrett Hayton,C,UTA,24,71,18,18,36
3,8476438,Brandon Saad,L,STL,32,69,17,19,36
3,8482055,Drew O'Connor,L,PIT,26,66,16,20,36
3,8480028,Morgan Frost,C,PHI,25,79,14,22,36
3,8476869,Brady Skjei,D,NSH,30,69,13,23,36
3,8477429,Andrew Copp,C,DET,30,80,12,24,36
3,8476480,Vladislav Namestnikov,C,WPG,32,65,12,24,36
3,8476461,Sean Couturier,C,PHI,32,69,11,25,36
3,8474563,Drew Doughty,D,LAK,35,64,8,28,36
3,8475191,Reilly Smith,R,NYR,33,75,15,20,35
3,8481582,Nicholas Robertson,L,TOR,23,76,15,20,35
3,8475722,Jason Zucker,L,BUF,32,66,14,21,35
3,8474189,Lars Eller,C,PIT,35,67,14,21,35
3,8482113,Anton Lundell,C,FLA,23,78,13,22,35
3,8476292,Ondrej Palat,L,NJD,33,68,12,23,35
3,8476923,Damon Severson,D,CBJ,30,78,12,23,35
3,8474716,Jared Spurgeon,D,MIN,35,78,11,24,35
3,8476927,Teddy Blueger,C,VAN,30,68,11,24,35
3,8478911,Matt Roy,D,WSH,29,67,10,25,35
3,8475171,Oliver Ekman-Larsson,D,TOR,33,68,10,25,35
3,8481703,Valtteri Puustinen,R,PIT,25,64,7,28,35
3,8477506,Ryan Pulock,D,NYI,30,77,1,34,35
3,8480459,Pius Suter,C,VAN,28,71,22,12,34
3,8478020,Michael Amadio,C,OTT,28,76,17,17,34
3,8482092,Ridly Greig,C,OTT,22,78,12,22,34
3,8481560,Arthur Kaliyev,R,LAK,23,80,12,22,34
3,8475193,Tomas Tatar,L,NJD,34,69,12,22,34
3,8478466,Daniel Sprong,R,VAN,27,70,9,25,34
3,8478178,Darren Raddysh,D,TBL,28,72,5,29,34
3,8476469,Joel Armia,R,MTL,31,74,18,15,33
3,8476882,Teuvo Teravainen,L,CHI,30,75,10,23,33
3,8474641,Adam Henrique,C,EDM,34,72,10,23,33
3,8476463,Jonas Brodin,D,MIN,31,74,9,24,33
3,8479393,Noah Gregor,C,OTT,26,75,19,13,32
3,8477987,Ryan Donato,C,CHI,28,63,18,14,32
3,8480835,Jack Drury,C,CAR,24,62,17,15,32
3,8477446,Michael McCarron,R,NSH,29,62,17,15,32
3,8477947,Sonny Milano,L,WSH,28,67,15,17,32
3,8482705,Cole Sillinger,C,CBJ,21,63,14,18,32
3,8478413,Jordan Greenway,L,BUF,27,61,12,20,32
3,8476925,Colton Sissons,C,NSH,31,70,12,20,32
3,8481523,Kirby Dach,C,MTL,23,63,11,21,32
3,8480817,K'Andre Miller,D,NYR,24,73,9,23,32
3,8479345,Jakob Chychrun,D,WSH,26,63,9,23,32
3,8478542,Evan Rodrigues,C,FLA,31,77,8,24,32
3,8482133,Thomas Bordeleau,C,SJS,22,65,8,24,32
3,8480336,Sean Walker,D,CAR,30,73,6,26,32
3,8476897,Oskar Sundqvist,C,STL,30,68,6,26,32
3,8483490,Pavel Mintyukov,D,ANA,21,75,4,28,32
3,8476892,Colton Parayko,D,STL,31,72,2,30,32
3,8481186,Logan O'Connor,R,COL,28,78,19,12,31
3,8473533,Jordan Staal,C,CAR,36,60,18,13,31
3,8480806,Isac Lundestrom,C,ANA,25,65,17,14,31
3,8476872,Scott Laughton,C,PHI,30,73,16,15,31
3,8482475,Yegor Chinakhov,R,CBJ,23,62,15,16,31
3,8479339,Patrik Laine,L,CBJ,26,63,15,16,31
3,8476921,Jordan Martinook,L,CAR,32,58,14,17,31
3,8480185,Eetu Luostarinen,C,FLA,26,73,13,18,31
3,8479591,Michael Eyssimont,C,TBL,28,80,13,18,31
3,8478109,Victor Olofsson,L,VGK,29,67,13,18,31
3,8473422,Nick Foligno,L,CHI,37,54,12,19,31
3,8480871,Adam Boqvist,D,FLA,24,66,12,19,31
3,8476979,Erik Gustafsson,D,DET,32,77,12,19,31
3,8476312,Josh Manson,D,COL,33,59,12,19,31
3,8481546,Cam York,D,PHI,23,69,9,22,31
3,8479996,Cody Glass,C,NSH,25,61,19,11,30
3,8480855,Jack McBain,C,UTA,24,67,12,18,30
3,8480220,Noah Cates,L,PHI,25,78,9,21,30
3,8477495,Seth Jones,D,CHI,30,64,7,23,30
3,8476885,Jacob Trouba,D,NYR,30,68,7,23,30
3,8475753,Justin Faulk,D,STL,32,75,6,24,30
3,8483445,Cutter Gauthier,L,ANA,20,58,6,24,30
3,8480829,Jesperi Kotkaniemi,C,CAR,24,60,18,11,29
3,8481535,Nils Hoglander,L,VAN,24,70,14,15,29
3,8474715,Cam Atkinson,R,TBL,35,81,14,15,29
3,8471698,T.J. Oshie,R,WSH,38,63,13,16,29
3,8482679,Matt Coronato,R,CGY,22,69,12,17,29
3,8481618,Alex Newhook,C,MTL,23,67,11,18,29
3,8478133,Jake Evans,C,MTL,28,73,10,19,29
3,8482245,Artem Zub,D,OTT,29,73,7,22,29
3,8480873,Rasmus Sandin,D,WSH,24,63,2,27,29
3,8481580,Connor McMichael,C,WSH,23,63,16,12,28
3,8477919,Frederick Gaudreau,C,MIN,31,65,16,12,28
3,8474053,Logan Couture,C,SJS,35,60,15,13,28
3,8477998,Warren Foegele,L,LAK,28,78,13,15,28
3,8481624,Ilya Mikheyev,R,CHI,30,69,12,16,28
3,8481577,Philip Tomasino,C,NSH,23,54,11,17,28
3,8478463,Anthony Beauvillier,L,PIT,27,65,11,17,28
3,8477839,Conor Sheary,L,TBL,32,79,9,19,28
3,8477488,Brett Pesce,D,NJD,30,65,9,19,28
3,8475220,Marcus Foligno,L,MIN,33,63,9,19,28
3,8479390,Taylor Raddysh,R,WSH,26,62,8,20,28
3,8481606,Jordan Spence,D,LAK,23,64,8,20,28
3,8481704,Juuso Parssinen,C,NSH,23,63,8,20,28
3,8479976,Juuso Valimaki,D,UTA,26,68,7,21,28
3,8475225,Craig Smith,C,CHI,35,58,16,11,27
3,8480068,Ryan Poehling,C,PHI,25,76,15,12,27
3,8477450,Jason Dickinson,C,CHI,29,56,14,13,27
3,8481553,Bobby Brink,R,PHI,23,68,13,14,27
3,8482146,Luke Evangelista,R,NSH,22,64,11,16,27
3,8476419,Jean-Gabriel Pageau,C,NYI,32,76,9,18,27
3,8477498,Darnell Nurse,D,EDM,29,73,9,18,27
3,8479353,Brett Howden,C,VGK,26,69,8,19,27
3,8480878,Nils Lundkvist,D,DAL,24,81,6,21,27
3,8475790,Erik Gudbranson,D,CBJ,32,75,3,24,27
3,8476931,Jake McCabe,D,TOR,31,64,2,25,27
3,8478882,Vladislav Gavrikov,D,LAK,29,68,0,27,27
3,8477952,Robby Fabbri,C,ANA,28,68,18,8,26
3,8481554,Kaapo Kakko,R,NYR,23,72,12,14,26
3,8483468,Jiri Kulich,C,BUF,20,59,12,14,26
3,8477425,Miles Wood,L,COL,29,76,11,15,26
3,8482671,Owen Power,D,BUF,22,72,6,20,26
3,8483482,Tristan Luneau,D,ANA,20,62,6,20,26
3,8473563,Nicklas Backstrom,C,WSH,37,54,6,20,26
3,8476429,Scott Mayfield,D,NYI,32,69,5,21,26
3,8474151,Ryan McDonagh,D,TBL,35,77,1,25,26
3,8479619,Michael Carcone,L,UTA,28,63,16,9,25
3,8480980,Connor Dewar,C,TOR,25,72,13,12,25
3,8482079,Marco Rossi,C,MIN,23,55,12,13,25
3,8480009,Eeli Tolvanen,R,SEA,25,69,11,14,25
3,8482062,Cole Smith,L,NSH,29,60,11,14,25
3,8475855,Jesper Fast,R,CAR,33,63,11,14,25
3,8483565,Nick Blankenburg,D,NSH,26,65,8,17,25
3,8476902,Esa Lindell,D,DAL,30,79,6,19,25
3,8478851,Alexandre Carrier,D,NSH,28,64,6,19,25
3,8476918,Jimmy Vesey,L,NYR,31,67,5,20,25
3,8476891,Matt Grzelcyk,D,PIT,30,76,4,21,25
3,8479398,Samuel Girard,D,COL,26,67,3,22,25
3,8479661,Tanner Jeannot,L,LAK,27,78,13,11,24
3,8477392,Hudson Fasching,R,NYI,29,71,12,12,24
3,8480078,Filip Chytil,C,NYR,25,65,10,14,24
3,8483524,Shane Wright,C,SEA,20,63,9,15,24
3,8482117,Lukas Reichel,L,CHI,22,58,7,17,24
3,8482809,Jackson Blake,R,CAR,21,62,7,17,24
3,8475462,Radko Gudas,D,ANA,34,66,6,18,24
3,8476917,Adam Pelech,D,NYI,30,75,4,20,24
3,8478507,John Marino,D,UTA,27,70,4,20,24
3,8475181,Nick Leddy,D,STL,33,70,4,20,24
3,8482142,Jamie Drysdale,D,PHI,22,66,2,22,24
3,8480073,Erik Brannstrom,D,COL,25,62,2,22,24
3,8480205,Emil Bemstrom,C,PIT,25,58,14,9,23
3,8476889,Radek Faksa,C,STL,30,62,12,11,23
3,8475848,Brendan Gallagher,R,MTL,32,66,11,12,23
3,8481093,Rafael Harvey-Pinard,L,MTL,25,60,11,12,23
3,8480762,Eric Robinson,L,CAR,29,55,11,12,23
3,8482749,Joshua Roy,R,MTL,21,62,11,12,23
3,8475231,Casey Cizikas,C,NYI,33,72,10,13,23
3,8476873,Mark Jankowski,C,NSH,30,54,9,14,23
3,8475149,Marcus Johansson,L,MIN,34,64,8,15,23
3,8482712,Oskar Olausson,R,COL,22,75,8,15,23
3,8478970,Jalen Chatfield,D,CAR,28,70,8,15,23
3,8482803,Olen Zellweger,D,ANA,21,66,6,17,23
3,8479371,Dante Fabbro,D,NSH,26,63,6,17,23
3,8482655,J.J. Moser,D,TBL,24,74,5,18,23
3,8478443,Brandon Carlo,D,BOS,28,57,5,18,23
3,8479402,Jake Bean,D,CGY,26,67,4,19,23
3,8480043,Timothy Liljegren,D,TOR,25,65,1,22,23
3,8478500,Ivan Provorov,D,CBJ,27,79,0,23,23
3,8482087,Kaiden Guhle,D,MTL,22,68,0,23,23
3,8477015,Connor Brown,R,EDM,30,62,16,6,22
3,8478043,Sam Lafferty,C,BUF,29,57,12,10,22
3,8476878,Zemgus Girgensons,L,TBL,30,79,12,10,22
3,8480813,Joe Veleno,C,DET,24,77,11,11,22
3,8477353,Tyler Motte,C,DET,29,74,11,11,22
3,8479351,Sam Steel,C,DAL,26,81,10,12,22
3,8478432,Christian Fischer,R,DET,27,76,10,12,22
3,8478508,Yakov Trenin,C,MIN,27,63,10,12,22
3,8482259,Bobby McMann,C,TOR,28,73,8,14,22
3,8482101,Danil Gushchin,L,SJS,22,67,8,14,22
3,8482073,Braden Schneider,D,NYR,23,60,7,15,22
3,8478891,Mason Appleton,C,WPG,28,65,6,16,22
3,8477507,Nikita Zadorov,D,BOS,29,70,6,16,22
3,8475233,David Savard,D,MTL,34,57,5,17,22
3,8475455,Brenden Dillon,D,NJD,34,62,4,18,22
3,8480049,Dylan Samberg,D,WPG,25,72,4,18,22
3,8474673,TJ Brodie,D,CHI,34,60,2,20,22
3,8481059,Scott Perunovich,D,STL,26,54,2,20,22
3,8482125,Alexander Holtz,R,VGK,22,63,13,8,21
3,8480802,Ryan McLeod,C,BUF,25,61,12,9,21
3,8482074,Connor Zary,C,CGY,23,65,11,10,21
3,8479718,Alex Barré-Boulet,C,MTL,27,57,11,10,21
3,8476960,Andreas Athanasiou,C,CHI,30,52,10,11,21
3,8480789,Oliver Wahlstrom,R,NYI,24,75,10,11,21
3,8474034,Pat Maroon,L,CHI,36,49,9,12,21
3,8478421,A.J. Greer,L,FLA,28,63,8,13,21
3,8481522,Peyton Krebs,C,BUF,23,63,7,14,21
3,8483457,Lane Hutson,D,MTL,20,63,6,15,21
3,8480891,Michael Kesselring,D,UTA,24,57,5,16,21
3,8473507,Jeff Petry,D,DET,37,73,3,18,21
3,8480001,Urho Vaakanainen,D,ANA,25,63,1,20,21
3,8477478,William Carrier,L,CAR,30,55,10,10,20
3,8480014,Gabriel Vilardi,C,WPG,25,62,9,11,20
3,8476994,Vinnie Hinostroza,C,NSH,30,40,9,11,20
3,8479293,Brandon Tanev,L,SEA,33,67,9,11,20
3,8477070,Liam O'Brien,C,UTA,30,56,9,11,20
3,8477406,Mattias Janmark,C,EDM,32,64,8,12,20
3,8481441,Joe Snively,C,DET,28,59,7,13,20
3,8480025,MacKenzie Entwistle,R,FLA,25,66,7,13,20
3,8476988,Matt Benning,D,SJS,30,63,6,14,20
3,8481656,Aliaksei Protas,C,WSH,23,61,5,15,20
3,8479372,Josh Mahura,D,SEA,26,50,5,15,20
3,8480035,Henri Jokiharju,D,BUF,25,66,4,16,20
3,8479639,Dylan Coghlan,D,WPG,26,58,3,17,20
3,8477435,Ryan Graves,D,PIT,29,73,3,17,20
3,8477969,Marcus Pettersson,D,PIT,28,79,2,18,20
3,8474574,Tyler Myers,D,VAN,34,60,2,18,20
3,8476874,Olli Maatta,D,DET,30,59,2,18,20
3,8482737,Zack Bolduc,C,STL,21,55,13,6,19
3,8479520,Brandon Duhaime,R,WSH,27,56,10,9,19
3,8475343,Nic Dowd,C,WSH,34,64,9,10,19
3,8480995,Pontus Holmberg,R,TOR,25,71,8,11,19
3,8482157,Will Cuylle,L,NYR,22,61,8,11,19
3,8481032,Paul Cotter,C,NJD,25,61,7,12,19
3,8478013,Jake Walman,D,SJS,28,65,7,12,19
3,8477989,Christian Dvorak,C,MTL,28,73,7,12,19
3,8477903,Garnet Hathaway,R,PHI,33,62,7,12,19
3,8481521,Ronnie Attard,D,PHI,25,57,4,15,19
3,8478136,Jake Middleton,D,MIN,28,73,3,16,19
3,8481567,Henry Thrun,D,SJS,23,52,3,16,19
3,8476879,Cody Ceci,D,EDM,31,68,2,17,19
3,8480222,Sebastian Aho,D,PIT,28,71,2,17,19
3,8481014,Alexander Romanov,D,NYI,24,74,0,19,19
3,8480144,David Kampf,C,TOR,29,74,11,7,18
3,8476278,Colin Blackwell,C,DAL,31,72,10,8,18
3,8478585,Derek Ryan,C,EDM,38,68,10,8,18
3,8481716,Dmitri Voronkov,L,CBJ,24,46,10,8,18
3,8479414,Nathan Bastian,R,NJD,27,62,9,9,18
3,8476934,Brock McGinn,L,ANA,30,61,9,9,18
3,8476474,Stefan Noesen,R,NJD,31,63,8,10,18
3,8476422,Mike Reilly,D,NYI,31,78,8,10,18
3,8481481,Blake Lizotte,C,PIT,27,57,8,10,18
3,8482166,Shakir Mukhamadullin,D,SJS,22,66,8,10,18
3,8478424,Jansen Harkins,C,ANA,27,39,8,10,18
3,8480748,Kiefer Sherwood,L,VAN,29,58,7,11,18
3,8476981,Josh Anderson,R,MTL,30,70,6,12,18
3,8475279,Ben Chiarot,D,DET,33,65,6,12,18
3,8476331,Dylan DeMelo,D,WPG,31,68,5,13,18
3,8477508,Curtis Lazar,C,NJD,29,54,5,13,18
3,8478434,Keegan Kolesar,R,VGK,27,66,4,14,18
3,8475188,Brayden McNabb,D,VGK,33,53,3,15,18
3,8481178,Egor Zamula,D,PHI,24,60,2,16,18
3,8479998,Mikey Anderson,D,LAK,25,65,1,17,18
3,8479941,Justin Danforth,R,CBJ,31,56,11,6,17
3,8476329,Travis Boyd,C,MIN,31,49,9,8,17
3,8481028,Martin Pospisil,C,CGY,25,63,9,8,17
3,8478569,Noel Acciari,C,PIT,33,54,9,8,17
3,8482111,Justin Barron,D,MTL,23,58,8,9,17
3,8483491,Ivan Miroshnichenko,L,WSH,20,57,7,10,17
3,8476858,Phillip Di Giuseppe,L,VAN,31,46,7,10,17
3,8478211,Dryden Hunt,L,CGY,29,57,6,11,17
3,8476525,Colin Miller,D,WPG,32,64,4,13,17
3,8482634,Alex Steeves,C,TOR,25,59,4,13,17
3,8484149,Gavin Brindley,C,CBJ,20,58,3,14,17
3,8479982,Conor Timmins,D,TOR,26,54,3,14,17
3,8480796,Martin Fehervary,D,WSH,25,63,3,14,17
3,8477365,Connor Clifton,D,BUF,29,55,3,14,17
3,8476457,Adam Larsson,D,SEA,32,73,2,15,17
3,8477499,Rasmus Ristolainen,D,PHI,30,55,2,15,17
3,8478399,Jonas Siegenthaler,D,NJD,27,54,1,16,17
3,8475179,Dmitry Kulikov,D,FLA,34,65,1,16,17
3,8480860,Kevin Bahl,D,CGY,24,61,1,16,17
3,8479983,Mario Ferraro,D,SJS,26,68,0,17,17
3,8480003,Jesper Boqvist,C,FLA,26,62,9,7,16
3,8480172,Jan Rutta,D,SJS,34,59,9,7,16
3,8475791,Taylor Hall,L,CHI,33,60,8,8,16
3,8479336,Carl Grundstrom,R,SJS,27,56,8,8,16
3,8482155,Alex Laferriere,R,LAK,23,68,8,8,16
3,8475842,Sam Carrick,C,NYR,32,62,8,8,16
3,8483495,Simon Nemec,D,NJD,20,63,8,8,16
3,8481517,Brett Leason,R,ANA,25,54,8,8,16
3,8480289,Morgan Barron,C,WPG,26,51,7,9,16
3,8480355,Mark Kastelic,C,BOS,25,59,6,10,16
3,8480727,Zach Whitecloud,D,VGK,28,45,5,11,16
3,8479291,Kevin Rooney,C,CGY,31,46,5,11,16
3,8476467,Jamie Oleksiak,D,SEA,32,67,4,12,16
3,8481708,Zac Jones,D,NYR,24,55,4,12,16
3,8480848,Ty Dellandrea,C,SJS,24,45,4,12,16
3,8479344,Jesse Puljujarvi,R,PIT,26,53,3,13,16
3,8474013,Ian Cole,D,UTA,35,47,2,14,16
3,8477220,Nate Schmidt,D,FLA,33,63,1,15,16
3,8482762,Simon Edvinsson,D,DET,21,52,10,5,15
3,8482624,Daniil Miromanov,D,CGY,27,66,9,6,15
3,8481641,Joel Kiviranta,L,COL,28,75,9,6,15
3,8482067,Connor Mackey,D,NYR,28,58,8,7,15
3,8480074,Alexandre Texier,C,STL,25,52,7,8,15
3,8483499,Liam Ohgren,L,MIN,20,56,6,9,15
3,8481477,Nico Sturm,C,SJS,29,51,6,9,15
3,8477979,Nicolas Aube-Kubel,R,BUF,28,61,6,9,15
3,8480021,Jack Studnicka,C,LAK,25,54,6,9,15
3,8480441,Trey Fix-Wolansky,R,CBJ,25,38,6,9,15
3,8480990,Declan Chisholm,D,MIN,24,56,5,10,15
3,8481537,Nikita Okhotiuk,D,CGY,24,52,4,11,15
3,8482148,Hendrix Lapierre,C,WSH,22,54,4,11,15
3,8479980,Nicolas Hague,D,VGK,26,54,4,11,15
3,8479316,Luke Kunin,C,SJS,27,55,3,12,15
3,8479026,Philippe Myers,D,TOR,27,53,3,12,15
3,8481527,Kaedan Korczak,D,VGK,23,53,2,13,15
3,8479369,Andrew Peeke,D,BOS,26,60,2,13,15
3,8480058,Pierre-Olivier Joseph,D,STL,25,53,2,13,15
3,8478859,Niko Mikkola,D,FLA,28,57,2,13,15
3,8479638,Justin Brazeau,R,BOS,26,38,10,4,14
3,8476822,Luke Glendening,C,TBL,35,80,9,5,14
3,8482807,Ethan Del Mastro,D,CHI,21,51,8,6,14
3,8480448,Parker Kelly,L,COL,25,69,6,8,14
3,8480252,Cole Guttman,C,CHI,25,47,5,9,14
3,8479368,Max Jones,L,BOS,26,68,5,9,14
3,8480007,Jonas Rondbjerg,R,VGK,25,44,5,9,14
3,8470600,Ryan Suter,D,STL,39,55,5,9,14
3,8479671,Mathieu Olivier,R,CBJ,27,48,4,10,14
3,8483466,Kevin Korchinski,D,CHI,20,57,4,10,14
3,8480887,Jordan Harris,D,MTL,24,59,4,10,14
3,8482666,Scott Morrow,D,CAR,22,46,3,11,14
3,8482451,Mikael Pyyhtia,L,CBJ,23,44,3,11,14
3,8475177,Calvin de Haan,D,COL,33,56,3,11,14
3,8479324,Ryan Lindgren,D,NYR,26,59,2,12,14
3,8477845,Trevor van Riemsdyk,D,WSH,33,64,2,12,14
3,8478416,Erik Cernak,D,TBL,27,69,2,12,14
3,8480950,Ilya Lyubushkin,D,DAL,30,73,1,13,14
3,8480807,Mattias Samuelsson,D,BUF,24,61,1,13,14
3,8478831,Kevin Stenlund,C,UTA,28,55,9,4,13
3,8479439,Jacob MacDonald,D,COL,31,42,9,4,13
3,8481617,Vasily Podkolzin,R,VAN,23,45,8,5,13
3,8482077,Dylan Holloway,L,EDM,23,44,8,5,13
3,8482859,Zack Ostapchuk,C,OTT,21,49,7,6,13
3,8479066,Ryan Lomberg,L,CGY,30,51,7,6,13
3,8479315,Joey Anderson,R,CHI,26,50,6,7,13
3,8479543,Michael Pezzetta,L,MTL,26,49,5,8,13
3,8476374,Sean Kuraly,C,CBJ,31,54,5,8,13
3,8477931,Tomas Nosek,L,FLA,32,65,5,8,13
3,8483493,Frank Nazar,C,CHI,20,54,4,9,13
3,8482784,Zach Dean,C,STL,21,52,3,10,13
3,8481019,David Gustafsson,C,WPG,24,50,3,10,13
3,8480834,Ty Emberson,D,SJS,24,45,2,11,13
3,8481592,Jakob Pelletier,L,CGY,23,37,2,11,13
3,8478452,Caleb Jones,D,LAK,27,57,2,11,13
3,8478840,Will Borgen,D,SEA,28,65,1,12,13
3,8478451,Ethan Bear,D,WSH,27,47,1,12,13
3,8476967,Brett Kulak,D,EDM,30,65,0,13,13
3,8480070,Ian Mitchell,D,BOS,25,46,5,7,12
3,8480246,Nick Perbix,D,TBL,26,75,4,8,12
3,8480192,Johnathan Kovacevic,D,NJD,27,46,4,8,12
3,8481161,Jake Christiansen,D,CBJ,25,51,4,8,12
3,8474568,Luke Schenn,D,NSH,35,45,4,8,12
3,8479370,Tyson Jost,C,CAR,26,53,3,9,12
3,8476624,Barclay Goodrow,C,SJS,31,48,3,9,12
3,8482192,Isaak Phillips,D,CHI,23,50,3,9,12
3,8477887,Patrick Brown,C,BOS,32,50,3,9,12
3,8480157,Calle Rosen,D,COL,30,39,1,11,12
3,8479348,Kale Clague,D,BUF,26,41,1,11,12
3,8474567,Zach Bogosian,D,MIN,34,58,1,11,12
3,8475324,Nick Jensen,D,OTT,34,63,0,12,12
3,8482095,Tyler Kleven,D,OTT,22,47,0,12,12
3,8479994,Jaret Anderson-Dolan,C,WPG,25,43,8,3,11
3,8477380,Jonny Brodzinski,C,NYR,31,43,7,4,11
3,8483570,Ben Meyers,C,SEA,26,35,7,4,11
3,8481601,Simon Holmstrom,R,NYI,23,65,6,5,11
3,8482730,Brandt Clarke,D,LAK,21,41,6,5,11
3,8479328,Julien Gauthier,R,NYI,27,54,6,5,11
3,8480011,Klim Kostin,C,SJS,25,49,6,5,11
3,8481013,Jonatan Berggren,R,DET,24,55,6,5,11
3,8479359,Beck Malenstyn,L,BUF,26,47,6,5,11
3,8481532,Alex Turcotte,C,LAK,23,41,5,6,11
3,8481789,Tye Kartye,L,SEA,23,36,4,7,11
3,8482153,Brendan Brisson,C,VGK,23,35,3,8,11
3,8479442,Troy Stecher,D,EDM,30,58,2,9,11
3,8478468,Jeremy Lauzon,D,NSH,27,54,1,10,11
3,8475208,Brian Dumoulin,D,ANA,33,59,1,10,11
3,8481568,Alex Vlasic,D,CHI,23,55,1,10,11
3,8480281,Alexey Toropchenko,R,STL,25,52,6,4,10
3,8482659,Josh Doan,R,UTA,22,50,6,4,10
3,8481543,Nikita Alexandrov,C,STL,24,27,6,4,10
3,8483619,Filip Roos,D,OTT,25,28,5,5,10
3,8476442,Matt Nieto,L,PIT,32,50,4,6,10
3,8484287,Cole McWard,D,VAN,23,28,4,6,10
3,8475690,Chris Tanev,D,TOR,35,57,3,7,10
3,8475762,Derek Forbort,D,VAN,32,48,3,7,10
3,8481599,Victor Soderstrom,D,UTA,23,43,2,8,10
3,8482176,Wyatt Kaiser,D,CHI,22,53,2,8,10
3,8481518,Nolan Foote,L,NJD,24,41,2,8,10
3,8476913,Devin Shore,C,MIN,30,39,2,8,10
3,8480196,Jacob Bryson,D,BUF,27,42,1,9,10
3,8481751,Lukas Rousek,R,BUF,25,32,5,4,9
3,8478409,Anthony Richard,C,PHI,28,25,5,4,9
3,8482141,Lukas Cormier,D,VGK,22,27,5,4,9
3,8473453,Trevor Lewis,C,LAK,37,74,4,5,9
3,8482145,Mavrik Bourque,C,DAL,22,63,4,5,9
3,8477573,Nathan Walker,L,STL,30,48,3,6,9
3,8482652,Walker Duehr,R,CGY,27,49,3,6,9
3,8482744,James Malatesta,L,CBJ,21,42,3,6,9
3,8476952,Dominic Toninato,C,WPG,30,44,3,6,9
3,8471709,Marc-Edouard Vlasic,D,SJS,37,46,2,7,9
3,8481167,Brayden Pachal,D,CGY,25,36,2,7,9
3,8482751,Ryan Winterton,C,SEA,21,35,2,7,9
3,8477810,Joel Hanley,D,CGY,33,30,2,7,9
3,8474166,Alec Martinez,D,CHI,37,46,1,8,9
3,8479576,Vincent Desharnais,D,VAN,28,43,1,8,9
3,8477335,Kyle Burroughs,D,LAK,29,39,1,8,9
3,8476473,Connor Murphy,D,CHI,31,41,1,8,9
3,8476372,Nick Seeler,D,PHI,31,52,1,8,9
3,8478454,Noah Juulsen,D,VAN,27,41,1,8,9
3,8477971,Andreas Englund,D,LAK,28,31,1,8,9
3,8476867,Brendan Gaunce,C,MIN,30,42,6,2,8
3,8481122,Simon Benoit,D,TOR,26,44,5,3,8
3,8482070,Mitchell Chaffee,R,TBL,26,54,5,3,8
3,8481550,Adam Beckman,L,NJD,23,33,4,4,8
3,8481147,Reese Johnson,C,MIN,26,32,4,4,8
3,8482496,Nils Aman,C,VAN,24,33,4,4,8
3,8477505,Alexander Wennberg,C,SJS,30,45,3,5,8
3,8471817,Ryan Reaves,R,TOR,37,67,3,5,8
3,8479968,Vinni Lettieri,C,BOS,29,50,3,5,8
3,8477962,Brendan Lemieux,L,CAR,28,39,3,5,8
3,8482858,Ryker Evans,D,SEA,23,28,3,5,8
3,8478021,William Lagesson,D,DET,28,34,3,5,8
3,8481754,Nikita Nesterenko,C,ANA,23,37,2,6,8
3,8474090,Brendan Smith,D,DAL,35,73,2,6,8
3,8483763,Maksymilian Szuber,D,UTA,22,36,2,6,8
3,8475750,Jon Merrill,D,MIN,32,52,1,7,8
3,8482964,Arber Xhekaj,D,MTL,23,53,1,7,8
3,8479378,Logan Stanley,D,WPG,26,36,1,7,8
3,8477018,Ben Hutton,D,VGK,31,45,1,7,8
3,8475718,Justin Holl,D,DET,32,60,0,8,8
3,8484911,Collin Graf,R,SJS,22,38,5,2,7
3,8483012,Logan Morrison,C,SEA,22,37,5,2,7
3,8482733,Logan Mailloux,D,MTL,31,37,4,3,7
3,8482765,Isak Rosen,R,BUF,21,27,4,3,7
3,8481422,Jacob Lucchini,C,NSH,29,26,4,3,7
3,8481524,Bowen Byram,D,BUF,23,42,3,4,7
3,8481600,Tobias Bjornfot,D,FLA,23,36,3,4,7
3,8475958,Michael Sgarbossa,C,WSH,32,25,3,4,7
3,8479249,Andrew Poturalski,C,SJS,30,38,2,5,7
3,8484258,Sam Malinski,D,COL,26,23,2,5,7
3,8479991,Jake Leschyshyn,C,NYR,25,29,2,5,7
3,8484254,Akito Hirose,D,VAN,25,21,1,6,7
3,8481598,Philip Broberg,D,EDM,23,36,1,6,7
3,8480292,Carson Meyer,R,ANA,27,34,1,6,7
3,8471677,Jack Johnson,D,CBJ,37,63,1,6,7
3,8480879,Jacob Bernard-Docker,D,OTT,24,53,1,6,7
3,8477369,Carson Soucy,D,VAN,30,67,0,7,7
3,8473446,Erik Johnson,D,PHI,36,43,0,7,7
3,8479362,Riley Tufte,L,BOS,26,16,5,1,6
3,8480245,Olle Lycksell,R,PHI,25,20,4,2,6
3,8480880,Jakub Lauko,C,MIN,24,31,3,3,6
3,8482747,Brennan Othmann,L,NYR,21,40,3,3,6
3,8480844,Grigori Denisenko,L,VGK,24,34,3,3,6
3,8477401,John Hayden,C,SEA,29,23,3,3,6
3,8474612,Travis Hamonic,D,OTT,34,47,2,4,6
3,8479944,Zach Aston-Reese,C,VGK,30,38,2,4,6
3,8483460,David Jiricek,D,CBJ,21,64,2,4,6
3,8477034,Jaycob Megna,D,FLA,32,48,2,4,6
3,8478874,Adam Gaudette,C,OTT,28,35,2,4,6
3,8481605,Jackson LaCombe,D,ANA,23,29,2,4,6
3,8474062,Riley Nash,C,NYR,35,24,2,4,6
3,8477938,Haydn Fleury,D,WPG,28,44,1,5,6
3,8482144,Jack Thompson,D,SJS,22,28,1,5,6
3,8478017,Mark Friedman,D,VAN,29,36,1,5,6
3,8479772,Zack MacEwen,R,OTT,28,56,1,5,6
3,8476441,Joel Edmundson,D,LAK,31,42,1,5,6
3,8475235,Nicolas Deslauriers,L,PHI,33,44,4,1,5
3,8478146,Matthew Highmore,C,OTT,28,30,4,1,5
3,8481679,Maxence Guenette,D,OTT,23,28,4,1,5
3,8482147,Jean-Luc Foudy,C,COL,22,30,3,2,5
3,8477851,Jordan Oesterle,D,BOS,32,39,2,3,5
3,8483549,Lucas Condotta,L,MTL,27,25,2,3,5
3,8482713,Mackie Samoskevich,R,FLA,22,39,2,3,5
3,8483512,Matt Savoie,C,EDM,20,20,2,3,5
3,8483471,Brad Lambert,C,WPG,31,16,2,3,5
3,8479986,Kole Lind,R,DAL,26,43,1,4,5
3,8478450,Parker Wotherspoon,D,BOS,27,42,1,4,5
3,8481701,Santeri Hatakka,D,NJD,23,45,1,4,5
3,8482511,Mason Lohrei,D,BOS,23,31,1,4,5
3,8481743,Marc Del Gaizo,D,NSH,25,22,1,4,5
3,8480845,Rasmus Kupari,C,WPG,24,35,1,4,5
3,8479981,Jonah Gadjovich,L,FLA,26,41,1,4,5
3,8477320,Anton Blidh,L,NYR,29,23,0,5,5
3,8481564,Ryan Johnson,D,BUF,23,18,0,5,5
3,8478502,Dennis Gilbert,D,BUF,28,22,0,5,5
3,8482177,Marat Khusnutdinov,C,MIN,22,24,3,1,4
3,8479536,Axel Jonsson-Fjallby,L,WPG,26,33,2,2,4
3,8481556,John Beecher,C,BOS,23,30,2,2,4
3,8480032,Shane Bowers,C,NJD,25,13,2,2,4
3,8482102,Vasily Ponomarev,C,PIT,22,23,2,2,4
3,8481699,Aku Raty,R,UTA,23,14,2,2,4
3,8479379,Givani Smith,R,SJS,26,32,2,2,4
3,8482470,Ilya Solovyov,D,CGY,24,18,2,2,4
3,8482201,Gage Goncalves,C,TBL,23,20,2,2,4
3,8483397,Marc McLaughlin,C,BOS,25,36,1,3,4
3,8480468,James Hamblin,L,EDM,25,17,1,3,4
3,8477473,Justin Bailey,R,SJS,29,27,1,3,4
3,8481056,Spencer Stastney,D,NSH,24,35,1,3,4
3,8475755,Alexander Petrovic,D,DAL,32,25,1,3,4
3,8481541,Samuel Bolduc,D,NYI,24,33,1,3,4
3,8479419,Brett Murray,L,BUF,26,30,1,3,4
3,8478477,Mitchell Stephens,C,SEA,27,20,1,3,4
3,8480870,Bo Groulx,C,NYR,24,23,0,4,4
3,8475795,Dylan McIlrath,D,WSH,32,14,0,4,4
3,8481609,Vladislav Kolyachonok,D,UTA,23,28,0,4,4
3,8478147,Bokondji Imama,L,PIT,28,7,3,0,3
3,8482197,Adam Raska,R,MIN,23,9,3,0,3
3,8482516,Matthew Kessel,D,STL,24,20,2,1,3
3,8479972,Mason Shaw,C,WPG,26,20,2,1,3
3,8477073,Kurtis MacDermid,L,NJD,30,29,2,1,3
3,8477149,Scott Sabourin,R,SJS,32,15,2,1,3
3,8480874,Adam Ginning,D,PHI,24,8,2,1,3
3,8481462,Mason Morelli,L,VGK,28,12,2,1,3
3,8477384,Josh Brown,D,EDM,30,41,1,2,3
3,8477527,Ross Johnston,L,ANA,30,29,1,2,3
3,8481006,Tyler Tucker,D,STL,24,25,1,2,3
3,8483630,Pavol Regenda,L,ANA,25,23,1,2,3
3,8479367,William Lockwood,R,FLA,26,18,1,2,3
3,8482061,Brandon Biro,L,SEA,26,16,1,2,3
3,8482929,Emil Lilleberg,D,TBL,23,22,1,2,3
3,8480084,Nick DeSimone,D,NJD,30,16,1,2,3
3,8481593,Jayden Struble,D,MTL,23,23,0,3,3
3,8479587,Rhett Gardner,C,PHI,28,13,0,3,3
3,8481237,Kyle MacLean,C,NYI,25,23,0,3,3
3,8479985,Cale Fleury,D,SEA,26,29,1,1,2
3,8482861,Vincent Iorio,D,WSH,22,21,1,1,2
3,8477244,Chad Ruhwedel,D,NYR,34,35,1,1,2
3,8482118,Sam Colangelo,R,ANA,23,14,1,1,2
3,8479330,Brandon Gignac,C,MTL,27,13,1,1,2
3,8482162,Roby Jarventie,L,EDM,22,24,1,1,2
3,8481206,John Ludvig,D,PIT,24,7,1,1,2
3,8478881,Brett Seney,L,CHI,28,16,1,1,2
3,8481043,Cole Koepke,L,BOS,26,15,1,1,2
3,8480823,Alexander Alexeyev,D,WSH,25,13,1,1,2
3,8482250,Callahan Burke,C,VGK,27,24,1,1,2
3,8482787,Nikita Chibrikov,R,WPG,31,8,1,1,2
3,8482094,Daemon Hunt,D,MIN,22,14,1,1,2
3,8478051,Max Willman,C,NJD,29,17,0,2,2
3,8480306,Grant Hutton,D,NYI,29,8,0,2,2
3,8484255,Jason Polin,R,COL,25,9,0,2,2
3,8479320,Max Lajoie,D,SEA,27,18,0,2,2
3,8478011,Louie Belpedio,D,PHI,28,10,1,0,1
3,8481065,Angus Crookshank,L,OTT,25,16,1,0,1
3,8483567,Georgii Merkulov,C,BOS,24,5,1,0,1
3,8482088,Justin Sourdif,R,FLA,22,15,1,0,1
3,8480075,Cameron Crotty,D,MIN,25,8,1,0,1
3,8477467,Gustav Olofsson,D,SEA,30,19,1,0,1
3,8481578,Graeme Clarke,R,MIN,23,7,1,0,1
3,8475780,Chris Wagner,R,COL,33,9,1,0,1
3,8481585,Egor Afanasyev,L,SJS,23,18,1,0,1
3,8478446,Glenn Gawdin,C,LAK,27,10,1,0,1
3,8481024,Linus Karlsson,C,VAN,25,13,1,0,1
3,8483407,Brandon Scanlin,D,NYR,25,5,1,0,1
3,8483546,Marshall Rifai,D,TOR,26,5,1,0,1
3,8484259,Ondrej Pavel,C,COL,31,4,1,0,1
3,8480267,Sammy Walker,C,MIN,25,21,0,1,1
3,8482460,Matt Rempe,C,NYR,22,15,0,1,1
3,8482165,Yan Kuznetsov,D,CGY,22,21,0,1,1
3,8481030,Jack St. Ivany,D,PIT,25,19,0,1,1
3,8480890,Jan Jenik,R,OTT,24,22,0,1,1
3,8477462,Robert Hagg,D,VGK,29,22,0,1,1
3,8479421,Jacob Moverare,D,LAK,26,21,0,1,1
3,8477541,Dakota Mermis,D,TOR,30,9,0,1,1
3,8484304,Uvis Balinskis,D,FLA,28,9,0,1,1
3,8481719,Maxwell Crozier,D,TBL,24,21,0,1,1
3,8481655,Cole Schwindt,R,CGY,23,4,0,1,1
3,8482126,Emil Andrae,D,PHI,31,5,0,1,1
3,8477993,Justin Kirkland,C,CGY,28,5,0,1,1
3,8478854,Ryan Shea,D,PIT,27,11,0,1,1
3,8481806,Louis Crevier,D,CHI,23,15,0,1,1
3,8482172,Landon Slaggert,L,CHI,22,24,0,0,0
3,8483597,Milos Kelemen,L,UTA,25,11,0,0,0
3,8475413,Justin Dowling,C,NJD,34,13,0,0,0
3,8482476,Emil Heineman,L,MTL,23,7,0,0,0
3,8484325,Waltteri Merela,C,TBL,26,21,0,0,0
3,8480851,Akil Thomas,C,LAK,24,20,0,0,0
3,8483920,Pierrick Dube,R,WSH,23,7,0,0,0
3,8476323,Max McCormick,L,SEA,32,2,0,0,0
3,8483395,Arshdeep Bains,L,VAN,23,11,0,0,0
3,8483432,Luca Del Bel Belluz,C,CBJ,31,4,0,0,0
3,8483609,Adam Klapka,R,CGY,24,6,0,0,0
3,8481726,Adam Edstrom,C,NYR,24,4,0,0,0
3,8483489,Fraser Minten,C,TOR,31,9,0,0,0
3,8479321,Lucas Johansen,D,,27,0,0,0,0
3,8470794,Joe Pavelski,C,,40,0,0,0,0
3,8477950,Tony DeAngelo,D,,29,0,0,0,0
3,8471218,Blake Wheeler,R,,38,0,0,0,0
3,8475197,Tyson Barrie,D,,33,0,0,0,0
3,8475744,Evgeny Kuznetsov,C,,32,0,0,0,0
3,8474037,James van Riemsdyk,L,,35,0,0,0,0
3,8474602,Justin Schultz,D,,34,0,0,0,0
3,8482222,Alexander Barabanov,L,,30,0,0,0,0
3,8474157,Max Pacioretty,L,,36,0,0,0,0
3,8474031,Kevin Shattenkirk,D,,35,0,0,0,0
3,8480884,Calen Addison,D,,24,0,0,0,0
3,8480008,Adam Ruzicka,C,,25,0,0,0,0
3,8475906,John Klingberg,D,,32,0,0,0,0
3,8476884,Derrick Pouliot,D,,30,0,0,0,0
3,8476919,Chris Tierney,C,,30,0,0,0,0
3,8479415,Michael McLeod,C,,26,0,0,0,0
3,8474884,Mike Hoffman,C,,35,0,0,0,0
3,8478104,Sammy Blais,L,,28,0,0,0,0
3,8474870,Tyler Johnson,C,,34,0,0,0,0
3,8481591,Sam Poulin,R,,23,0,0,0,0
3,8479977,Kailer Yamamoto,R,,26,0,0,0,0
3,8476393,Nick Cousins,C,,31,0,0,0,0
3,8479376,Victor Mete,D,,26,0,0,0,0
3,8476871,Tanner Pearson,L,,32,0,0,0,0
3,8471274,Alex Goligoski,D,,39,0,0,0,0
3,8481058,Jesse Ylönen,R,,25,0,0,0,0
3,8477464,Nic Petan,C,,29,0,0,0,0
3,8473449,Kyle Okposo,R,,36,0,0,0,0
3,8480216,Jacob Peterson,C,,25,0,0,0,0
3,8479346,Dillon Dube,C,,26,0,0,0,0
3,8470966,Mark Giordano,D,,41,0,0,0,0
3,8480821,Filip Zadina,R,,25,0,0,0,0
3,8476907,Mackenzie MacEachern,L,,30,0,0,0,0
3,8478430,Oliver Kylington,D,,27,0,0,0,0
3,8479514,Rem Pitlick,C,,27,0,0,0,0
3,8478099,Kevin Labanc,R,,29,0,0,0,0
3,8482241,Radim Zohorna,L,,28,0,0,0,0
3,8474040,Sam Gagner,C,,35,0,0,0,0
3,8475164,Jakob Silfverberg,R,,34,0,0,0,0
3,8475752,Tyler Pitlick,C,,33,0,0,0,0
3,8479984,Cal Foote,D,,26,0,0,0,0
3,8478495,Denis Gurianov,R,,27,0,0,0,0
3,8479533,Joona Koppanen,L,,26,0,0,0,0
3,8479458,Nikita Zaitsev,D,,33,0,0,0,0
3,8471699,Andrew Cogliano,C,,37,0,0,0,0
3,8470604,Jeff Carter,C,,39,0,0,0,0
3,8477330,Dominik Kubalik,L,,29,0,0,0,0
3,8477944,Jakub Vrana,L,,28,0,0,0,0
3,8478904,Steven Lorentz,C,,28,0,0,0,0
3,8471686,Marc Staal,D,,37,0,0,0,0
3,8478512,Austin Czarnik,C,,32,0,0,0,0
3,8470610,Zach Parise,L,,40,0,0,0,0
3,8473504,Cal Clutterbuck,R,,37,0,0,0,0
3,8474009,Nick Bonino,C,,36,0,0,0,0
3,8477454,Adam Erne,L,,29,0,0,0,0
3,8477126,Jayson Megna,C,,34,0,0,0,0
3,8473473,Milan Lucic,L,,36,0,0,0,0
3,8478067,Oskar Lindblom,L,,28,0,0,0,0
3,8475825,Jani Hakanpää,D,,32,0,0,0,0
3,8479383,Boris Katchouk,L,,26,0,0,0,0
3,8478400,Colin White,C,,27,0,0,0,0
3,8477846,Ryan Carpenter,C,,33,0,0,0,0
3,8477930,Pierre-Edouard Bellemare,L,,39,0,0,0,0
3,8479423,Alex Nylander,L,,26,0,0,0,0
3,8475797,Jarred Tinordi,D,,32,0,0,0,0
3,8481239,Samuel Fagemo,L,,24,0,0,0,0
3,8474618,Marco Scandella,D,,34,0,0,0,0
3,8480853,Liam Foudy,C,,24,0,0,0,0
3,8478028,Fredrik Olofsson,L,,28,0,0,0,0
3,8474145,Robert Bortuzzo,D,,35,0,0,0,0
3,8474709,Matt Martin,L,,35,0,0,0,0
3,8480226,Marián Studenic,R,,26,0,0,0,0
3,8479522,Hardy Haman Aktell,D,WSH,26,1,0,0,0
3,8480274,Philip Kemp,D,EDM,25,1,0,0,0
3,8480184,Gustav Lindstrom,D,,26,0,0,0,0
3,8481077,John Leonard,L,,26,0,0,0,0
3,8479547,Matthew Phillips,R,,26,0,0,0,0
3,8476915,Jujhar Khaira,L,,30,0,0,0,0
3,8481070,Hugh McGing,L,,26,0,0,0,0
3,8478408,Travis Dermott,D,,28,0,0,0,0
3,8484326,Patrik Koch,D,UTA,28,2,0,0,0
3,8481812,Nikolai Knyzhov,D,,27,0,0,0,0
3,8484321,Nikolas Matinpalo,D,OTT,26,2,0,0,0
3,8475278,Byron Froese,C,,33,0,0,0,0
3,8475766,Austin Watson,L,,32,0,0,0,0
3,8483398,Declan Carlile,D,TBL,31,3,0,0,0
3,8479546,Oskar Steen,C,,26,0,0,0,0
3,8480836,Jonathan Gruden,C,,24,0,0,0,0
3,8481690,Tyler Angle,C,,24,0,0,0,0
3,8480031,Maxime Comtois,L,,25,0,0,0,0
3,8483045,Cameron Butler,R,CBJ,31,1,0,0,0
3,8478078,Rourke Chartier,C,,28,0,0,0,0
3,8481016,Ruslan Iskhakov,C,,24,0,0,0,0
3,8481534,Raphael Lavoie,C,EDM,24,2,0,0,0
3,8484314,Jiri Smejkal,L,,28,0,0,0,0
3,8478956,Samuel Laberge,L,NJD,27,1,0,0,0
3,8483401,Marc Johnstone,R,PIT,28,1,0,0,0
3,8483531,Brian Halonen,L,NJD,25,4,0,0,0
3,8480776,Sheldon Rempal,R,,29,0,0,0,0
4,8481559,Jack Hughes,C,NJD,23,73,49,77,126
4,8478402,Connor McDavid,C,EDM,27,77,37,88,125
4,8477492,Nathan MacKinnon,C,COL,29,82,47,76,123
4,8476453,Nikita Kucherov,R,TBL,31,82,49,71,120
4,8477934,Leon Draisaitl,C,EDM,29,80,50,67,117
4,8479318,Auston Matthews,C,TOR,27,82,54,58,112
4,8479314,Matthew Tkachuk,L,FLA,27,76,30,75,105
4,8477404,Jake Guentzel,C,TBL,30,82,43,57,100
4,8480002,Nico Hischier,C,NJD,25,77,37,63,100
4,8480027,Jason Robertson,L,DAL,25,81,40,59,99
4,8477956,David Pastrnak,R,BOS,28,80,54,44,98
4,8476887,Filip Forsberg,L,NSH,30,76,46,52,98
4,8476468,J.T. Miller,C,VAN,31,77,32,65,97
4,8477933,Sam Reinhart,C,FLA,29,78,49,46,95
4,8477946,Dylan Larkin,C,DET,28,81,47,47,94
4,8477939,William Nylander,R,TOR,28,80,46,48,94
4,8478420,Mikko Rantanen,R,COL,28,79,38,56,94
4,8484144,Connor Bedard,C,CHI,19,73,36,58,94
4,8482116,Tim Stützle,C,OTT,22,81,33,61,94
4,8478445,Mathew Barzal,C,NYI,27,78,26,67,93
4,8477501,Valeri Nichushkin,R,COL,29,81,49,43,92
4,8480801,Brady Tkachuk,L,OTT,25,81,39,53,92
4,8475172,Nazem Kadri,C,CGY,34,79,33,59,92
4,8480800,Quinn Hughes,D,VAN,25,78,14,78,92
4,8477493,Aleksander Barkov,C,FLA,29,78,28,62,90
4,8476459,Mika Zibanejad,C,NYR,31,76,33,56,89
4,8480012,Elias Pettersson,C,VAN,26,72,38,50,88
4,8480069,Cale Makar,D,COL,26,71,26,62,88
4,8477942,Kevin Fiala,L,LAK,28,81,28,58,86
4,8480036,Miro Heiskanen,D,DAL,25,82,18,68,86
4,8481540,Cole Caufield,R,MTL,23,77,48,36,84
4,8477940,Nikolaj Ehlers,L,WPG,28,76,33,51,84
4,8480023,Robert Thomas,C,STL,25,76,27,57,84
4,8478550,Artemi Panarin,L,NYR,33,80,24,60,84
4,8474141,Patrick Kane,R,DET,36,77,29,53,82
4,8480830,Andrei Svechnikov,R,CAR,24,74,28,53,81
4,8474578,Erik Karlsson,D,PIT,34,81,17,64,81
4,8478864,Kirill Kaprizov,L,MIN,27,76,30,50,80
4,8478010,Brayden Point,C,TBL,28,82,47,32,79
4,8478427,Sebastian Aho,C,CAR,27,78,39,40,79
4,8478439,Travis Konecny,R,PHI,27,78,35,44,79
4,8479323,Adam Fox,D,NYR,26,73,11,68,79
4,8477409,Carter Verhaeghe,C,FLA,29,79,40,38,78
4,8471675,Sidney Crosby,C,PIT,37,73,37,41,78
4,8476460,Mark Scheifele,C,WPG,31,73,31,47,78
4,8480865,Noah Dobson,D,NYI,24,78,16,62,78
4,8478398,Kyle Connor,L,WPG,28,74,32,45,77
4,8475167,Victor Hedman,D,TBL,34,76,11,66,77
4,8479337,Alex DeBrincat,R,DET,27,81,30,46,76
4,8479343,Clayton Keller,R,UTA,26,79,29,47,76
4,8478403,Jack Eichel,C,VGK,28,78,44,31,75
4,8482078,Lucas Raymond,L,DET,22,80,31,44,75
4,8478449,Roope Hintz,C,DAL,28,81,34,40,74
4,8475726,Tyler Toffoli,C,SJS,32,74,42,31,73
4,8475168,Matt Duchene,C,DAL,33,80,30,43,73
4,8477504,Josh Morrissey,D,WPG,29,75,26,47,73
4,8475184,Chris Kreider,L,NYR,33,78,41,31,72
4,8480208,Drake Batherson,R,OTT,26,81,33,39,72
4,8473419,Brad Marchand,L,BOS,36,78,31,41,72
4,8475754,Brock Nelson,C,NYI,33,75,34,37,71
4,8476454,Ryan Nugent-Hopkins,C,EDM,31,79,19,52,71
4,8479420,Tage Thompson,C,BUF,27,73,40,30,70
4,8482699,Dylan Guenther,R,UTA,21,76,26,44,70
4,8478414,Timo Meier,R,NJD,28,73,25,45,70
4,8475166,John Tavares,C,TOR,34,81,34,35,69
4,8471215,Evgeni Malkin,C,PIT,38,69,25,44,69
4,8482109,Alexis Lafrenière,L,NYR,23,77,37,31,68
4,8478444,Brock Boeser,R,VAN,27,78,33,35,68
4,8480803,Evan Bouchard,D,EDM,25,74,14,54,68
4,8475794,Tyler Seguin,C,DAL,32,82,32,35,67
4,8477402,Pavel Buchnevich,L,STL,29,75,30,37,67
4,8477949,Alex Tuch,R,BUF,28,69,28,39,67
4,8479675,Trevor Moore,L,LAK,29,79,28,39,67
4,8478975,Mason Marchment,L,DAL,29,80,25,42,67
4,8474564,Steven Stamkos,C,NSH,34,74,24,43,67
4,8476881,Tomas Hertl,C,VGK,31,74,32,34,66
4,8482740,Wyatt Johnston,C,DAL,21,81,32,34,66
4,8477960,Adrian Kempe,R,LAK,28,82,31,35,66
4,8475913,Mark Stone,R,VGK,32,76,24,42,66
4,8479407,Jesper Bratt,L,NJD,26,76,22,44,66
4,8476346,Johnny Gaudreau,L,CBJ,31,72,18,48,66
4,8477951,Nick Schmaltz,C,UTA,28,79,23,42,65
4,8475765,Vladimir Tarasenko,R,DET,33,78,23,42,65
4,8476539,Jonathan Marchessault,R,NSH,34,73,32,32,64
4,8482745,Mason McTavish,C,ANA,21,76,30,34,64
4,8474679,Gustav Nyquist,C,NSH,35,73,29,35,64
4,8476389,Vincent Trocheck,C,NYR,31,76,27,36,63
4,8478440,Dylan Strome,C,WSH,27,78,26,37,63
4,8479385,Jordan Kyrou,C,STL,26,77,24,39,63
4,8475798,Mikael Granlund,C,SJS,32,75,14,49,63
4,8474600,Roman Josi,D,NSH,34,71,11,52,63
4,8473994,Jamie Benn,L,DAL,35,82,29,33,62
4,8475786,Zach Hyman,L,EDM,32,75,35,26,61
4,8473512,Claude Giroux,R,OTT,36,77,25,36,61
4,8471685,Anze Kopitar,C,LAK,37,81,17,44,61
4,8480018,Nick Suzuki,C,MTL,25,76,23,37,60
4,8480839,Rasmus Dahlin,D,BUF,24,75,16,44,60
4,8481711,Matias Maccelli,L,UTA,24,78,15,45,60
4,8478460,Zach Werenski,D,CBJ,27,75,14,46,60
4,8478519,Anthony Cirelli,C,TBL,27,82,21,38,59
4,8479400,Pierre-Luc Dubois,L,WSH,26,74,31,27,58
4,8481557,Matt Boldy,L,MIN,23,68,28,30,58
4,8479542,Brandon Hagel,L,TBL,26,82,23,35,58
4,8478466,Daniel Sprong,R,VAN,27,70,23,35,58
4,8477494,Jonathan Drouin,L,COL,29,79,21,37,58
4,8479999,Casey Mittelstadt,C,COL,26,81,20,38,58
4,8471724,Kris Letang,D,PIT,37,81,17,41,58
4,8477955,Jared McCann,L,SEA,28,75,25,32,57
4,8474102,David Perron,L,OTT,36,78,19,38,57
4,8476432,Boone Jenner,C,CBJ,31,73,36,20,56
4,8477496,Elias Lindholm,C,BOS,30,77,27,29,56
4,8478498,Jake DeBrusk,L,VAN,28,73,26,30,56
4,8475170,Brayden Schenn,C,STL,33,76,23,33,56
4,8483515,Juraj Slafkovsky,L,MTL,20,78,21,35,56
4,8476479,Phillip Danault,C,LAK,31,82,21,35,56
4,8475692,Mats Zuccarello,R,MIN,37,69,12,44,56
4,8482665,Matty Beniers,C,SEA,22,74,22,33,55
4,8477935,Sam Bennett,C,FLA,28,74,22,33,55
4,8478462,Nicolas Roy,C,VGK,27,81,21,34,55
4,8482110,Dawson Mercer,C,NJD,23,70,21,34,55
4,8482667,William Eklund,L,SJS,22,68,17,38,55
4,8476906,Shayne Gostisbehere,D,CAR,31,78,12,43,55
4,8475810,Bryan Rust,R,PIT,32,72,25,29,54
4,8478493,Joel Eriksson Ek,C,MIN,27,73,25,29,54
4,8474641,Adam Henrique,C,EDM,34,77,24,30,54
4,8481596,Shane Pinto,C,OTT,24,78,18,36,54
4,8476882,Teuvo Teravainen,L,CHI,30,70,16,38,54
4,8476875,Mike Matheson,D,MTL,30,69,14,40,54
4,8474590,John Carlson,D,WSH,34,67,12,42,54
4,8480014,Gabriel Vilardi,C,WPG,25,70,30,23,53
4,8480039,Martin Necas,C,CAR,25,72,27,26,53
4,8481528,Dylan Cozens,C,BUF,23,67,27,26,53
4,8477451,Ryan Hartman,R,MIN,30,69,25,28,53
4,8478856,Conor Garland,R,VAN,28,78,23,30,53
4,8480064,Josh Norris,C,OTT,25,75,22,31,53
4,8478047,Michael Bunting,L,PIT,29,71,20,33,53
4,8476853,Morgan Rielly,D,TOR,30,69,8,45,53
4,8480185,Eetu Luostarinen,C,FLA,26,76,23,29,52
4,8476456,Jonathan Huberdeau,C,CGY,31,80,15,37,52
4,8477932,Aaron Ekblad,D,FLA,28,71,12,40,52
4,8481068,Yegor Sharangovich,C,CGY,26,80,25,26,51
4,8483431,Logan Cooley,C,UTA,20,74,22,29,51
4,8476905,Chandler Stephenson,C,SEA,30,74,16,35,51
4,8478397,Rasmus Andersson,D,CGY,28,75,8,43,51
4,8477500,Bo Horvat,C,NYI,29,79,37,13,50
4,8475191,Reilly Smith,R,NYR,33,69,28,22,50
4,8478366,Frank Vatrano,R,ANA,30,74,25,25,50
4,8475768,Jaden Schwartz,C,SEA,32,65,23,27,50
4,8482097,Jack Quinn,R,BUF,23,66,23,27,50
4,8478401,Pavel Zacha,C,BOS,27,77,17,33,50
4,8477346,MacKenzie Weegar,D,CGY,30,74,17,33,50
4,8478438,Tommy Novak,C,NSH,27,72,10,40,50
4,8479325,Charlie McAvoy,D,BOS,27,75,8,42,50
4,8477476,Artturi Lehkonen,L,COL,29,80,25,24,49
4,8471214,Alex Ovechkin,L,WSH,39,68,21,28,49
4,8475158,Ryan O'Reilly,C,NSH,33,71,17,32,49
4,8478873,Troy Terry,R,ANA,27,73,17,32,49
4,8477456,J.T. Compher,L,DET,29,80,20,28,48
4,8481618,Alex Newhook,C,MTL,23,78,20,28,48
4,8477986,Brandon Montour,D,SEA,30,76,19,29,48
4,8482149,Cole Perfetti,C,WPG,22,69,17,31,48
4,8474565,Alex Pietrangelo,D,VGK,34,71,9,39,48
4,8481542,Moritz Seider,D,DET,23,73,8,40,48
4,8477407,Anthony Duclair,L,NYI,29,78,23,24,47
4,8482113,Anton Lundell,C,FLA,23,78,23,24,47
4,8477503,Max Domi,C,TOR,29,80,18,29,47
4,8480797,Joel Farabee,L,PHI,24,74,18,29,47
4,8484153,Leo Carlsson,C,ANA,20,73,15,32,47
4,8478038,Devon Toews,D,COL,30,69,11,36,47
4,8476448,William Karlsson,C,VGK,31,75,25,21,46
4,8475784,Jeff Skinner,C,EDM,32,74,23,23,46
4,8484166,Adam Fantilli,C,CBJ,20,75,22,24,46
4,8476399,Blake Coleman,C,CGY,33,75,21,25,46
4,8475745,Charlie Coyle,C,BOS,32,79,21,25,46
4,8476981,Josh Anderson,R,MTL,30,70,20,26,46
4,8482093,Seth Jarvis,C,CAR,22,67,19,27,46
4,8473986,Alex Killorn,L,ANA,35,70,19,27,46
4,8475760,Nick Bjugstad,C,UTA,32,74,24,21,45
4,8476792,Torey Krug,D,STL,33,77,21,24,45
4,8482705,Cole Sillinger,C,CBJ,21,66,19,26,45
4,8477964,Ivan Barbashev,C,VGK,29,80,17,28,45
4,8478042,Viktor Arvidsson,R,EDM,31,75,16,29,45
4,8481581,Thomas Harley,D,DAL,23,81,15,30,45
4,8478458,Jack Roslovic,C,CAR,27,68,15,30,45
4,8476826,Yanni Gourde,C,SEA,33,69,15,30,45
4,8482702,Logan Stankoven,C,DAL,21,81,21,23,44
4,8477021,Alex Kerfoot,C,UTA,30,71,19,25,44
4,8477429,Andrew Copp,C,DET,30,78,16,28,44
4,8475753,Justin Faulk,D,STL,32,72,9,35,44
4,8480188,Fabian Zetterlund,L,SJS,25,69,21,22,43
4,8483808,Andrei Kuzmenko,L,CGY,28,78,20,23,43
4,8477416,Oliver Bjorkstrand,R,SEA,29,72,15,28,43
4,8481533,Trevor Zegras,C,ANA,23,69,14,29,43
4,8477447,Shea Theodore,D,VGK,29,59,13,30,43
4,8474150,Mikael Backlund,C,CGY,35,76,13,30,43
4,8483505,Matthew Poitras,C,BOS,20,72,12,31,43
4,8474563,Drew Doughty,D,LAK,35,73,11,32,43
4,8480145,Neal Pionk,D,WPG,29,70,8,35,43
4,8476869,Brady Skjei,D,NSH,30,75,8,35,43
4,8479410,Mikhail Sergachev,D,UTA,26,70,7,36,43
4,8481560,Arthur Kaliyev,R,LAK,23,76,21,21,42
4,8477998,Warren Foegele,L,LAK,28,81,18,24,42
4,8477497,Sean Monahan,C,CBJ,30,69,15,27,42
4,8478469,Thomas Chabot,D,OTT,27,73,11,31,42
4,8480434,Sean Durzi,D,UTA,26,71,7,35,42
4,8482684,Luke Hughes,D,NJD,21,69,6,36,42
4,8476854,Hampus Lindholm,D,BOS,30,71,5,37,42
4,8474586,Jordan Eberle,R,SEA,34,74,18,23,41
4,8482124,Quinton Byfield,R,LAK,22,76,14,27,41
4,8482671,Owen Power,D,BUF,22,72,7,34,41
4,8476458,Ryan Strome,C,ANA,31,71,17,23,40
4,8480798,Philipp Kurashev,C,CHI,25,67,16,24,40
4,8478055,Gustav Forsling,D,FLA,28,72,15,25,40
4,8478115,Pierre Engvall,L,NYI,28,77,14,26,40
4,8474149,Evgenii Dadonov,R,DAL,35,78,12,28,40
4,8479425,Filip Hronek,D,VAN,27,76,5,35,40
4,8481604,Pavel Dorofeyev,L,VGK,24,68,22,17,39
4,8475287,Erik Haula,L,NJD,33,73,19,20,39
4,8480802,Ryan McLeod,C,BUF,25,69,18,21,39
4,8476872,Scott Laughton,C,PHI,30,79,17,22,39
4,8481656,Aliaksei Protas,C,WSH,23,63,16,23,39
4,8479525,Ross Colton,C,COL,28,77,15,24,39
4,8484145,Zach Benson,L,BUF,19,72,14,25,39
4,8478396,Noah Hanifin,D,VGK,27,62,3,36,39
4,8477426,Nicholas Paul,L,TBL,29,82,20,18,38
4,8481535,Nils Hoglander,L,VAN,24,64,20,18,38
4,8482092,Ridly Greig,C,OTT,22,76,19,19,38
4,8482159,Tyson Foerster,R,PHI,22,75,16,22,38
4,8476480,Vladislav Namestnikov,C,WPG,32,67,15,23,38
4,8478233,Andrew Mangiapane,L,WSH,28,69,10,28,38
4,8479365,Trent Frederic,C,BOS,26,76,19,18,37
4,8482475,Yegor Chinakhov,R,CBJ,23,64,19,18,37
4,8478474,Lawson Crouse,L,UTA,27,72,17,20,37
4,8480009,Eeli Tolvanen,R,SEA,25,67,17,20,37
4,8480015,Owen Tippett,R,PHI,25,79,16,21,37
4,8476461,Sean Couturier,C,PHI,32,65,14,23,37
4,8477987,Ryan Donato,C,CHI,28,66,14,23,37
4,8479345,Jakob Chychrun,D,WSH,26,68,13,24,37
4,8477511,Anthony Mantha,R,CGY,30,72,12,25,37
4,8476885,Jacob Trouba,D,NYR,30,72,9,28,37
4,8478407,Vince Dunn,D,SEA,28,68,5,32,37
4,8482175,JJ Peterka,R,BUF,22,67,20,16,36
4,8477952,Robby Fabbri,C,ANA,28,64,20,16,36
4,8476483,Rickard Rakell,R,PIT,31,70,19,17,36
4,8475151,Kyle Palmieri,C,NYI,33,79,18,18,36
4,8475714,Calle Jarnkrok,C,TOR,33,81,17,19,36
4,8477947,Sonny Milano,L,WSH,28,64,17,19,36
4,8474715,Cam Atkinson,R,TBL,35,81,17,19,36
4,8478542,Evan Rodrigues,C,FLA,31,74,15,21,36
4,8480068,Ryan Poehling,C,PHI,25,72,15,21,36
4,8477479,Tyler Bertuzzi,L,CHI,29,60,14,22,36
4,8481577,Philip Tomasino,C,NSH,23,66,14,22,36
4,8481703,Valtteri Puustinen,R,PIT,25,61,9,27,36
4,8479591,Michael Eyssimont,C,TBL,28,79,8,28,36
4,8478500,Ivan Provorov,D,CBJ,27,81,5,31,36
4,8476438,Brandon Saad,L,STL,32,75,23,12,35
4,8480893,Kirill Marchenko,R,CBJ,24,61,17,18,35
4,8477444,Andre Burakovsky,L,SEA,29,75,13,22,35
4,8478057,Dakota Joshua,C,VAN,28,68,12,23,35
4,8480028,Morgan Frost,C,PHI,25,72,12,23,35
4,8477435,Ryan Graves,D,PIT,29,81,5,30,35
4,8476880,Tom Wilson,R,WSH,30,64,17,17,34
4,8475169,Evander Kane,L,EDM,33,73,16,18,34
4,8482660,Kent Johnson,C,CBJ,22,61,16,18,34
4,8474053,Logan Couture,C,SJS,35,60,14,20,34
4,8476462,Dougie Hamilton,D,NJD,31,70,9,25,34
4,8475764,Cam Fowler,D,ANA,33,75,3,31,34
4,8482146,Luke Evangelista,R,NSH,22,66,18,15,33
4,8481186,Logan O'Connor,R,COL,28,78,13,20,33
4,8479987,Morgan Geekie,C,BOS,26,77,11,22,33
4,8479992,Michael Rasmussen,C,DET,25,78,11,22,33
4,8482720,Matthew Knies,L,TOR,22,81,10,23,33
4,8476958,Jaccob Slavin,D,CAR,30,78,8,25,33
4,8474716,Jared Spurgeon,D,MIN,35,78,7,26,33
4,8478046,Danton Heinen,L,VAN,29,74,19,13,32
4,8479339,Patrik Laine,L,CBJ,26,60,16,16,32
4,8477839,Conor Sheary,L,TBL,32,81,15,17,32
4,8477425,Miles Wood,L,COL,29,79,15,17,32
4,8475218,Mattias Ekholm,D,EDM,34,70,14,18,32
4,8480829,Jesperi Kotkaniemi,C,CAR,24,63,14,18,32
4,8480113,Alex Iafallo,L,WPG,31,63,13,19,32
4,8475793,Ryan Johansen,C,PHI,32,73,13,19,32
4,8475193,Tomas Tatar,L,NJD,34,73,12,20,32
4,8482749,Joshua Roy,R,MTL,21,67,12,20,32
4,8477495,Seth Jones,D,CHI,30,66,11,21,32
4,8481606,Jordan Spence,D,LAK,23,65,10,22,32
4,8477948,Travis Sanheim,D,PHI,28,69,4,28,32
4,8483490,Pavel Mintyukov,D,ANA,21,72,4,28,32
4,8482125,Alexander Holtz,R,VGK,22,67,18,13,31
4,8483524,Shane Wright,C,SEA,20,65,17,14,31
4,8482089,Jake Neighbours,L,STL,22,65,16,15,31
4,8482117,Lukas Reichel,L,CHI,22,58,14,17,31
4,8482133,Thomas Bordeleau,C,SJS,22,59,12,19,31
4,8481624,Ilya Mikheyev,R,CHI,30,60,12,19,31
4,8477498,Darnell Nurse,D,EDM,29,76,12,19,31
4,8478463,Anthony Beauvillier,L,PIT,27,64,11,20,31
4,8479351,Sam Steel,C,DAL,26,81,10,21,31
4,8475200,Dmitry Orlov,D,CAR,33,74,9,22,31
4,8477488,Brett Pesce,D,NJD,30,66,9,22,31
4,8480817,K'Andre Miller,D,NYR,24,69,8,23,31
4,8478472,Mathieu Joseph,R,STL,27,65,7,24,31
4,8476429,Scott Mayfield,D,NYI,32,76,7,24,31
4,8482111,Justin Barron,D,MTL,23,69,7,24,31
4,8480459,Pius Suter,C,VAN,28,64,16,14,30
4,8478020,Michael Amadio,C,OTT,28,78,15,15,30
4,8480078,Filip Chytil,C,NYR,25,65,14,16,30
4,8481580,Connor McMichael,C,WSH,23,67,13,17,30
4,8481582,Nicholas Robertson,L,TOR,23,76,11,19,30
4,8478970,Jalen Chatfield,D,CAR,28,72,8,22,30
4,8476979,Erik Gustafsson,D,DET,32,67,7,23,30
4,8476902,Esa Lindell,D,DAL,30,81,5,25,30
4,8482105,Jake Sanderson,D,OTT,22,78,4,26,30
4,8476923,Damon Severson,D,CBJ,30,81,4,26,30
4,8474151,Ryan McDonagh,D,TBL,35,75,3,27,30
4,8477446,Michael McCarron,R,NSH,29,59,18,11,29
4,8475314,Anders Lee,L,NYI,34,79,17,12,29
4,8481481,Blake Lizotte,C,PIT,27,55,17,12,29
4,8475791,Taylor Hall,L,CHI,33,58,16,13,29
4,8480813,Joe Veleno,C,DET,24,78,12,17,29
4,8484203,Bradly Nadeau,L,CAR,19,60,9,20,29
4,8476927,Teddy Blueger,C,VAN,30,64,5,24,29
4,8477989,Christian Dvorak,C,MTL,28,73,4,25,29
4,8482055,Drew O'Connor,L,PIT,26,63,20,8,28
4,8478109,Victor Olofsson,L,VGK,29,65,17,11,28
4,8480762,Eric Robinson,L,CAR,29,67,14,14,28
4,8479661,Tanner Jeannot,L,LAK,27,78,13,15,28
4,8476392,Adam Lowry,C,WPG,31,66,12,16,28
4,8481553,Bobby Brink,R,PHI,23,61,12,16,28
4,8480336,Sean Walker,D,CAR,30,68,11,17,28
4,8481477,Nico Sturm,C,SJS,29,57,11,17,28
4,8478891,Mason Appleton,C,WPG,28,66,10,18,28
4,8481523,Kirby Dach,C,MTL,23,71,8,20,28
4,8480220,Noah Cates,L,PHI,25,72,8,20,28
4,8476917,Adam Pelech,D,NYI,30,79,6,22,28
4,8470613,Brent Burns,D,CAR,39,76,4,24,28
4,8476931,Jake McCabe,D,TOR,31,68,4,24,28
4,8475790,Erik Gudbranson,D,CBJ,32,75,2,26,28
4,8482079,Marco Rossi,C,MIN,23,63,17,10,27
4,8479996,Cody Glass,C,NSH,25,54,14,13,27
4,8475763,Kevin Hayes,R,PIT,32,70,12,15,27
4,8471698,T.J. Oshie,R,WSH,38,60,11,16,27
4,8477499,Rasmus Ristolainen,D,PHI,30,59,10,17,27
4,8477953,Kasperi Kapanen,R,STL,28,66,9,18,27
4,8478413,Jordan Greenway,L,BUF,27,68,9,18,27
4,8482624,Daniil Miromanov,D,CGY,27,65,9,18,27
4,8479353,Brett Howden,C,VGK,26,70,8,19,27
4,8475171,Oliver Ekman-Larsson,D,TOR,33,67,7,20,27
4,8482122,Brock Faber,D,MIN,22,76,6,21,27
4,8477507,Nikita Zadorov,D,BOS,29,71,6,21,27
4,8475690,Chris Tanev,D,TOR,35,64,5,22,27
4,8481059,Scott Perunovich,D,STL,26,51,3,24,27
4,8481032,Paul Cotter,C,NJD,25,68,20,6,26
4,8479336,Carl Grundstrom,R,SJS,27,52,15,11,26
4,8480748,Kiefer Sherwood,L,VAN,29,61,14,12,26
4,8475220,Marcus Foligno,L,MIN,33,64,13,13,26
4,8477478,William Carrier,L,CAR,30,56,13,13,26
4,8482155,Alex Laferriere,R,LAK,23,68,13,13,26
4,8479414,Nathan Bastian,R,NJD,27,67,11,15,26
4,8475722,Jason Zucker,L,BUF,32,67,10,16,26
4,8473533,Jordan Staal,C,CAR,36,61,9,17,26
4,8480871,Adam Boqvist,D,FLA,24,68,9,17,26
4,8480878,Nils Lundkvist,D,DAL,24,80,7,19,26
4,8473507,Jeff Petry,D,DET,37,74,6,20,26
4,8478178,Darren Raddysh,D,TBL,28,67,5,21,26
4,8475149,Marcus Johansson,L,MIN,34,66,5,21,26
4,8479402,Jake Bean,D,CGY,26,64,5,21,26
4,8480873,Rasmus Sandin,D,WSH,24,68,3,23,26
4,8477969,Marcus Pettersson,D,PIT,28,72,3,23,26
4,8479619,Michael Carcone,L,UTA,28,59,16,9,25
4,8475799,Nino Niederreiter,R,WPG,32,65,14,11,25
4,8479393,Noah Gregor,C,OTT,26,70,14,11,25
4,8476469,Joel Armia,R,MTL,31,63,13,12,25
4,8473422,Nick Foligno,L,CHI,37,63,13,12,25
4,8477392,Hudson Fasching,R,NYI,29,63,13,12,25
4,8483457,Lane Hutson,D,MTL,20,67,9,16,25
4,8483482,Tristan Luneau,D,ANA,20,61,8,17,25
4,8479983,Mario Ferraro,D,SJS,26,71,7,18,25
4,8480043,Timothy Liljegren,D,TOR,25,65,6,19,25
4,8474673,TJ Brodie,D,CHI,34,60,6,19,25
4,8478507,John Marino,D,UTA,27,63,3,22,25
4,8476331,Dylan DeMelo,D,WPG,31,72,3,22,25
4,8479324,Ryan Lindgren,D,NYR,26,64,3,22,25
4,8476892,Colton Parayko,D,STL,31,70,2,23,25
4,8479398,Samuel Girard,D,COL,26,66,2,23,25
4,8478508,Yakov Trenin,C,MIN,27,56,14,10,24
4,8477353,Tyler Motte,C,DET,29,76,13,11,24
4,8476292,Ondrej Palat,L,NJD,33,66,11,13,24
4,8482679,Matt Coronato,R,CGY,22,63,11,13,24
4,8480855,Jack McBain,C,UTA,24,66,10,14,24
4,8477450,Jason Dickinson,C,CHI,29,58,10,14,24
4,8476463,Jonas Brodin,D,MIN,31,80,9,15,24
4,8482101,Danil Gushchin,L,SJS,22,57,9,15,24
4,8476312,Josh Manson,D,COL,33,65,8,16,24
4,8476467,Jamie Oleksiak,D,SEA,32,69,7,17,24
4,8477506,Ryan Pulock,D,NYI,30,76,3,21,24
4,8481014,Alexander Romanov,D,NYI,24,72,1,23,24
4,8477220,Nate Schmidt,D,FLA,33,68,0,24,24
4,8479390,Taylor Raddysh,R,WSH,26,65,13,10,23
4,8482737,Zack Bolduc,C,STL,21,56,13,10,23
4,8482062,Cole Smith,L,NSH,29,64,12,11,23
4,8476419,Jean-Gabriel Pageau,C,NYI,32,76,11,12,23
4,8481441,Joe Snively,C,DET,28,61,11,12,23
4,8482807,Ethan Del Mastro,D,CHI,21,57,11,12,23
4,8481554,Kaapo Kakko,R,NYR,23,64,10,13,23
4,8480025,MacKenzie Entwistle,R,FLA,25,55,10,13,23
4,8483445,Cutter Gauthier,L,ANA,20,56,8,15,23
4,8478133,Jake Evans,C,MTL,28,63,7,16,23
4,8475181,Nick Leddy,D,STL,33,68,5,18,23
4,8478911,Matt Roy,D,WSH,29,64,4,19,23
4,8482655,J.J. Moser,D,TBL,24,82,3,20,23
4,8478136,Jake Middleton,D,MIN,28,77,3,20,23
4,8479982,Conor Timmins,D,TOR,26,56,2,21,23
4,8482192,Isaak Phillips,D,CHI,23,62,2,21,23
4,8482259,Bobby McMann,C,TOR,28,72,13,9,22
4,8480849,Barrett Hayton,C,UTA,24,70,12,10,22
4,8479315,Joey Anderson,R,CHI,26,49,12,10,22
4,8482142,Jamie Drysdale,D,PHI,22,65,10,12,22
4,8479316,Luke Kunin,C,SJS,27,51,10,12,22
4,8483493,Frank Nazar,C,CHI,20,60,10,12,22
4,8476921,Jordan Martinook,L,CAR,32,53,8,14,22
4,8476278,Colin Blackwell,C,DAL,31,77,7,15,22
4,8480074,Alexandre Texier,C,STL,25,54,7,15,22
4,8478013,Jake Walman,D,SJS,28,68,5,17,22
4,8480073,Erik Brannstrom,D,COL,25,65,4,18,22
4,8479980,Nicolas Hague,D,VGK,26,49,4,18,22
4,8480035,Henri Jokiharju,D,BUF,25,62,3,19,22
4,8480049,Dylan Samberg,D,WPG,25,67,1,21,22
4,8477903,Garnet Hathaway,R,PHI,33,57,14,7,21
4,8475848,Brendan Gallagher,R,MTL,32,59,10,11,21
4,8478434,Keegan Kolesar,R,VGK,27,64,9,12,21
4,8483499,Liam Ohgren,L,MIN,20,51,9,12,21
4,8481013,Jonatan Berggren,R,DET,24,60,8,13,21
4,8476374,Sean Kuraly,C,CBJ,31,59,7,14,21
4,8476624,Barclay Goodrow,C,SJS,31,59,7,14,21
4,8482073,Braden Schneider,D,NYR,23,66,6,15,21
4,8475343,Nic Dowd,C,WSH,34,63,6,15,21
4,8483468,Jiri Kulich,C,BUF,20,58,5,16,21
4,8481708,Zac Jones,D,NYR,24,50,5,16,21
4,8481568,Alex Vlasic,D,CHI,23,56,4,17,21
4,8476925,Colton Sissons,C,NSH,31,65,3,18,21
4,8475455,Brenden Dillon,D,NJD,34,64,3,18,21
4,8476879,Cody Ceci,D,EDM,31,66,3,18,21
4,8481527,Kaedan Korczak,D,VGK,23,48,3,18,21
4,8481093,Rafael Harvey-Pinard,L,MTL,25,60,13,7,20
4,8474189,Lars Eller,C,PIT,35,68,12,8,20
4,8475855,Jesper Fast,R,CAR,33,59,11,9,20
4,8478585,Derek Ryan,C,EDM,38,60,11,9,20
4,8476474,Stefan Noesen,R,NJD,31,59,11,9,20
4,8481601,Simon Holmstrom,R,NYI,23,75,11,9,20
4,8480144,David Kampf,C,TOR,29,73,9,11,20
4,8479359,Beck Malenstyn,L,BUF,26,52,9,11,20
4,8480835,Jack Drury,C,CAR,24,63,8,12,20
4,8476918,Jimmy Vesey,L,NYR,31,70,8,12,20
4,8480252,Cole Guttman,C,CHI,25,44,8,12,20
4,8470600,Ryan Suter,D,STL,39,64,7,13,20
4,8482744,James Malatesta,L,CBJ,21,49,7,13,20
4,8475231,Casey Cizikas,C,NYI,33,73,6,14,20
4,8478043,Sam Lafferty,C,BUF,29,58,6,14,20
4,8476988,Matt Benning,D,SJS,30,66,5,15,20
4,8481178,Egor Zamula,D,PHI,24,57,5,15,20
4,8482712,Oskar Olausson,R,COL,22,75,4,16,20
4,8478416,Erik Cernak,D,TBL,27,72,4,16,20
4,8481546,Cam York,D,PHI,23,72,3,17,20
4,8478840,Will Borgen,D,SEA,28,63,3,17,20
4,8478399,Jonas Siegenthaler,D,NJD,27,59,2,18,20
4,8477380,Jonny Brodzinski,C,NYR,31,53,12,7,19
4,8479066,Ryan Lomberg,L,CGY,30,62,11,8,19
4,8473453,Trevor Lewis,C,LAK,37,73,11,8,19
4,8477406,Mattias Janmark,C,EDM,32,65,10,9,19
4,8478432,Christian Fischer,R,DET,27,76,8,11,19
4,8479293,Brandon Tanev,L,SEA,33,57,8,11,19
4,8482148,Hendrix Lapierre,C,WSH,22,51,8,11,19
4,8480789,Oliver Wahlstrom,R,NYI,24,70,7,12,19
4,8479639,Dylan Coghlan,D,WPG,26,64,7,12,19
4,8479976,Juuso Valimaki,D,UTA,26,60,6,13,19
4,8476422,Mike Reilly,D,NYI,31,74,6,13,19
4,8477015,Connor Brown,R,EDM,30,62,5,14,19
4,8480003,Jesper Boqvist,C,FLA,26,63,5,14,19
4,8476891,Matt Grzelcyk,D,PIT,30,75,4,15,19
4,8476994,Vinnie Hinostroza,C,NSH,30,54,4,15,19
4,8482245,Artem Zub,D,OTT,29,71,2,17,19
4,8478882,Vladislav Gavrikov,D,LAK,29,68,2,17,19
4,8475188,Brayden McNabb,D,VGK,33,55,2,17,19
4,8477365,Connor Clifton,D,BUF,29,61,2,17,19
4,8480727,Zach Whitecloud,D,VGK,28,54,2,17,19
4,8476934,Brock McGinn,L,ANA,30,53,13,5,18
4,8483491,Ivan Miroshnichenko,L,WSH,20,58,11,7,18
4,8477931,Tomas Nosek,L,FLA,32,67,7,11,18
4,8484149,Gavin Brindley,C,CBJ,20,53,6,12,18
4,8475179,Dmitry Kulikov,D,FLA,34,62,4,14,18
4,8479543,Michael Pezzetta,L,MTL,26,56,4,14,18
4,8474574,Tyler Myers,D,VAN,34,73,3,15,18
4,8480011,Klim Kostin,C,SJS,25,55,3,15,18
4,8481567,Henry Thrun,D,SJS,23,56,2,16,18
4,8480222,Sebastian Aho,D,PIT,28,67,2,16,18
4,8476457,Adam Larsson,D,SEA,32,70,2,16,18
4,8480860,Kevin Bahl,D,CGY,24,54,2,16,18
4,8476874,Olli Maatta,D,DET,30,60,1,17,18
4,8481716,Dmitri Voronkov,L,CBJ,24,44,11,6,17
4,8475225,Craig Smith,C,CHI,35,63,10,7,17
4,8481028,Martin Pospisil,C,CGY,25,53,10,7,17
4,8479368,Max Jones,L,BOS,26,65,9,8,17
4,8482074,Connor Zary,C,CGY,23,56,8,9,17
4,8482809,Jackson Blake,R,CAR,21,56,6,11,17
4,8479371,Dante Fabbro,D,NSH,26,65,6,11,17
4,8475233,David Savard,D,MTL,34,62,6,11,17
4,8479344,Jesse Puljujarvi,R,PIT,26,50,6,11,17
4,8482859,Zack Ostapchuk,C,OTT,21,56,5,12,17
4,8480157,Calle Rosen,D,COL,30,41,5,12,17
4,8477369,Carson Soucy,D,VAN,30,63,5,12,17
4,8480887,Jordan Harris,D,MTL,24,54,4,13,17
4,8482087,Kaiden Guhle,D,MTL,22,70,3,14,17
4,8480796,Martin Fehervary,D,WSH,25,60,2,15,17
4,8474090,Brendan Smith,D,DAL,35,69,2,15,17
4,8476878,Zemgus Girgensons,L,TBL,30,80,10,6,16
4,8480355,Mark Kastelic,C,BOS,25,64,10,6,16
4,8482659,Josh Doan,R,UTA,22,48,9,7,16
4,8480205,Emil Bemstrom,C,PIT,25,67,7,9,16
4,8482157,Will Cuylle,L,NYR,22,64,7,9,16
4,8477979,Nicolas Aube-Kubel,R,BUF,28,59,7,9,16
4,8482067,Connor Mackey,D,NYR,28,62,6,10,16
4,8476889,Radek Faksa,C,STL,30,53,5,11,16
4,8482803,Olen Zellweger,D,ANA,21,59,4,12,16
4,8482634,Alex Steeves,C,TOR,25,64,3,13,16
4,8479998,Mikey Anderson,D,LAK,25,63,2,14,16
4,8480246,Nick Perbix,D,TBL,26,70,2,14,16
4,8480289,Morgan Barron,C,WPG,26,58,11,4,15
4,8478569,Noel Acciari,C,PIT,33,60,10,5,15
4,8481704,Juuso Parssinen,C,NSH,23,53,9,6,15
4,8479370,Tyson Jost,C,CAR,26,48,9,6,15
4,8476822,Luke Glendening,C,TBL,35,77,8,7,15
4,8481754,Nikita Nesterenko,C,ANA,23,38,7,8,15
4,8480980,Connor Dewar,C,TOR,25,76,5,10,15
4,8476329,Travis Boyd,C,MIN,31,55,5,10,15
4,8476525,Colin Miller,D,WPG,32,62,5,10,15
4,8481599,Victor Soderstrom,D,UTA,23,51,5,10,15
4,8479718,Alex Barré-Boulet,C,MTL,27,47,4,11,15
4,8474034,Pat Maroon,L,CHI,36,46,4,11,15
4,8477938,Haydn Fleury,D,WPG,28,46,2,13,15
4,8476967,Brett Kulak,D,EDM,30,59,0,15,15
4,8479941,Justin Danforth,R,CBJ,31,54,8,6,14
4,8475842,Sam Carrick,C,NYR,32,57,8,6,14
4,8478831,Kevin Stenlund,C,UTA,28,58,8,6,14
4,8480806,Isac Lundestrom,C,ANA,25,57,7,7,14
4,8479520,Brandon Duhaime,R,WSH,27,56,7,7,14
4,8480281,Alexey Toropchenko,R,STL,25,67,7,7,14
4,8476960,Andreas Athanasiou,C,CHI,30,48,6,8,14
4,8481617,Vasily Podkolzin,R,VAN,23,49,6,8,14
4,8480995,Pontus Holmberg,R,TOR,25,69,5,9,14
4,8479439,Jacob MacDonald,D,COL,31,52,5,9,14
4,8479944,Zach Aston-Reese,C,VGK,30,45,5,9,14
4,8479328,Julien Gauthier,R,NYI,27,57,4,10,14
4,8474013,Ian Cole,D,UTA,35,52,3,11,14
4,8480950,Ilya Lyubushkin,D,DAL,30,81,3,11,14
4,8478451,Ethan Bear,D,WSH,27,46,3,11,14
4,8480172,Jan Rutta,D,SJS,34,54,2,12,14
4,8480058,Pierre-Olivier Joseph,D,STL,25,49,2,12,14
4,8475324,Nick Jensen,D,OTT,34,66,2,12,14
4,8478468,Jeremy Lauzon,D,NSH,27,57,1,13,14
4,8482176,Wyatt Kaiser,D,CHI,22,52,1,13,14
4,8475718,Justin Holl,D,DET,32,61,1,13,14
4,8480848,Ty Dellandrea,C,SJS,24,37,7,6,13
4,8481751,Lukas Rousek,R,BUF,25,37,4,9,13
4,8471709,Marc-Edouard Vlasic,D,SJS,37,57,4,9,13
4,8477505,Alexander Wennberg,C,SJS,30,41,4,9,13
4,8481521,Ronnie Attard,D,PHI,25,64,3,10,13
4,8480990,Declan Chisholm,D,MIN,24,45,2,11,13
4,8481524,Bowen Byram,D,BUF,23,53,2,11,13
4,8473563,Nicklas Backstrom,C,WSH,37,52,0,13,13
4,8478851,Alexandre Carrier,D,NSH,28,66,0,13,13
4,8480891,Michael Kesselring,D,UTA,24,59,0,13,13
4,8482762,Simon Edvinsson,D,DET,21,55,8,4,12
4,8483763,Maksymilian Szuber,D,UTA,22,33,7,5,12
4,8477573,Nathan Walker,L,STL,30,56,6,6,12
4,8475462,Radko Gudas,D,ANA,34,64,5,7,12
4,8481522,Peyton Krebs,C,BUF,23,52,5,7,12
4,8478211,Dryden Hunt,L,CGY,29,55,5,7,12
4,8481641,Joel Kiviranta,L,COL,28,68,5,7,12
4,8482964,Arber Xhekaj,D,MTL,23,50,5,7,12
4,8476897,Oskar Sundqvist,C,STL,30,62,4,8,12
4,8477919,Frederick Gaudreau,C,MIN,31,60,4,8,12
4,8479372,Josh Mahura,D,SEA,26,57,4,8,12
4,8474568,Luke Schenn,D,NSH,35,48,4,8,12
4,8481532,Alex Turcotte,C,LAK,23,43,4,8,12
4,8476442,Matt Nieto,L,PIT,32,50,4,8,12
4,8483460,David Jiricek,D,CBJ,21,60,4,8,12
4,8483466,Kevin Korchinski,D,CHI,20,44,3,9,12
4,8483495,Simon Nemec,D,NJD,20,54,2,10,12
4,8476372,Nick Seeler,D,PHI,31,43,2,10,12
4,8476441,Joel Edmundson,D,LAK,31,41,2,10,12
4,8483565,Nick Blankenburg,D,NSH,26,63,1,11,12
4,8480196,Jacob Bryson,D,BUF,27,45,1,11,12
4,8477335,Kyle Burroughs,D,LAK,29,51,1,11,12
4,8471677,Jack Johnson,D,CBJ,37,63,1,11,12
4,8470621,Corey Perry,R,EDM,39,70,7,4,11
4,8478452,Caleb Jones,D,LAK,27,46,7,4,11
4,8482077,Dylan Holloway,L,EDM,23,51,6,5,11
4,8481592,Jakob Pelletier,L,CGY,23,46,6,5,11
4,8480021,Jack Studnicka,C,LAK,25,61,5,6,11
4,8479026,Philippe Myers,D,TOR,27,49,3,8,11
4,8475762,Derek Forbort,D,VAN,32,52,3,8,11
4,8481122,Simon Benoit,D,TOR,26,38,3,8,11
4,8481019,David Gustafsson,C,WPG,24,38,2,9,11
4,8475208,Brian Dumoulin,D,ANA,33,56,2,9,11
4,8480879,Jacob Bernard-Docker,D,OTT,24,46,2,9,11
4,8478443,Brandon Carlo,D,BOS,28,60,1,10,11
4,8477845,Trevor van Riemsdyk,D,WSH,33,60,1,10,11
4,8480807,Mattias Samuelsson,D,BUF,24,51,1,10,11
4,8478859,Niko Mikkola,D,FLA,28,57,0,11,11
4,8479671,Mathieu Olivier,R,CBJ,27,44,7,3,10
4,8479291,Kevin Rooney,C,CGY,31,46,6,4,10
4,8478421,A.J. Greer,L,FLA,28,57,4,6,10
4,8480192,Johnathan Kovacevic,D,NJD,27,52,4,6,10
4,8480292,Carson Meyer,R,ANA,27,30,4,6,10
4,8478017,Mark Friedman,D,VAN,29,35,3,7,10
4,8480845,Rasmus Kupari,C,WPG,24,49,3,7,10
4,8475279,Ben Chiarot,D,DET,33,67,2,8,10
4,8476913,Devin Shore,C,MIN,30,34,2,8,10
4,8481167,Brayden Pachal,D,CGY,25,45,2,8,10
4,8482858,Ryker Evans,D,SEA,23,31,2,8,10
4,8482666,Scott Morrow,D,CAR,22,46,1,9,10
4,8479442,Troy Stecher,D,EDM,30,54,1,9,10
4,8482451,Mikael Pyyhtia,L,CBJ,23,39,0,10,10
4,8483570,Ben Meyers,C,SEA,26,37,7,2,9
4,8482652,Walker Duehr,R,CGY,27,44,5,4,9
4,8481550,Adam Beckman,L,NJD,23,40,5,4,9
4,8477962,Brendan Lemieux,L,CAR,28,39,5,4,9
4,8477070,Liam O'Brien,C,UTA,30,54,4,5,9
4,8482166,Shakir Mukhamadullin,D,SJS,22,52,4,5,9
4,8481537,Nikita Okhotiuk,D,CGY,24,49,4,5,9
4,8480448,Parker Kelly,L,COL,25,74,4,5,9
4,8480834,Ty Emberson,D,SJS,24,42,4,5,9
4,8471817,Ryan Reaves,R,TOR,37,60,4,5,9
4,8481161,Jake Christiansen,D,CBJ,25,57,3,6,9
4,8482070,Mitchell Chaffee,R,TBL,26,52,3,6,9
4,8484911,Collin Graf,R,SJS,22,46,3,6,9
4,8474612,Travis Hamonic,D,OTT,34,45,2,7,9
4,8478874,Adam Gaudette,C,OTT,28,44,2,7,9
4,8475750,Jon Merrill,D,MIN,32,54,1,8,9
4,8477034,Jaycob Megna,D,FLA,32,47,1,8,9
4,8482511,Mason Lohrei,D,BOS,23,38,1,8,9
4,8482784,Zach Dean,C,STL,21,39,7,1,8
4,8481789,Tye Kartye,L,SEA,23,43,7,1,8
4,8477508,Curtis Lazar,C,NJD,29,56,6,2,8
4,8481517,Brett Leason,R,ANA,25,59,5,3,8
4,8477887,Patrick Brown,C,BOS,32,44,5,3,8
4,8478424,Jansen Harkins,C,ANA,27,38,4,4,8
4,8481600,Tobias Bjornfot,D,FLA,23,35,4,4,8
4,8475235,Nicolas Deslauriers,L,PHI,33,51,4,4,8
4,8479986,Kole Lind,R,DAL,26,43,4,4,8
4,8476873,Mark Jankowski,C,NSH,30,48,3,5,8
4,8482730,Brandt Clarke,D,LAK,21,46,3,5,8
4,8483549,Lucas Condotta,L,MTL,27,29,2,6,8
4,8477320,Anton Blidh,L,NYR,29,25,2,6,8
4,8477473,Justin Bailey,R,SJS,29,29,2,6,8
4,8480001,Urho Vaakanainen,D,ANA,25,56,1,7,8
4,8479576,Vincent Desharnais,D,VAN,28,36,1,7,8
4,8478146,Matthew Highmore,C,OTT,28,27,1,7,8
4,8481056,Spencer Stastney,D,NSH,24,32,1,7,8
4,8480070,Ian Mitchell,D,BOS,25,41,0,8,8
4,8474166,Alec Martinez,D,CHI,37,47,0,8,8
4,8477851,Jordan Oesterle,D,BOS,32,47,0,8,8
4,8476858,Phillip Di Giuseppe,L,VAN,31,42,6,1,7
4,8481543,Nikita Alexandrov,C,STL,24,22,5,2,7
4,8476867,Brendan Gaunce,C,MIN,30,41,5,2,7
4,8481147,Reese Johnson,C,MIN,26,46,5,2,7
4,8480441,Trey Fix-Wolansky,R,CBJ,25,38,4,3,7
4,8479994,Jaret Anderson-Dolan,C,WPG,25,30,4,3,7
4,8482765,Isak Rosen,R,BUF,21,25,4,3,7
4,8481679,Maxence Guenette,D,OTT,23,34,4,3,7
4,8475177,Calvin de Haan,D,COL,33,46,3,4,7
4,8479991,Jake Leschyshyn,C,NYR,25,28,3,4,7
4,8481598,Philip Broberg,D,EDM,23,43,2,5,7
4,8482144,Jack Thompson,D,SJS,22,26,2,5,7
4,8479536,Axel Jonsson-Fjallby,L,WPG,26,42,2,5,7
4,8477527,Ross Johnston,L,ANA,30,39,2,5,7
4,8479369,Andrew Peeke,D,BOS,26,57,1,6,7
4,8480007,Jonas Rondbjerg,R,VGK,25,48,1,6,7
4,8474567,Zach Bogosian,D,MIN,34,63,1,6,7
4,8478409,Anthony Richard,C,PHI,28,25,1,6,7
4,8482751,Ryan Winterton,C,SEA,21,41,1,6,7
4,8473446,Erik Johnson,D,PHI,36,48,1,6,7
4,8477384,Josh Brown,D,EDM,30,48,1,6,7
4,8482496,Nils Aman,C,VAN,24,33,4,2,6
4,8479968,Vinni Lettieri,C,BOS,29,39,3,3,6
4,8477401,John Hayden,C,SEA,29,31,3,3,6
4,8479772,Zack MacEwen,R,OTT,28,49,3,3,6
4,8479379,Givani Smith,R,SJS,26,27,3,3,6
4,8481237,Kyle MacLean,C,NYI,25,25,3,3,6
4,8481556,John Beecher,C,BOS,23,33,2,4,6
4,8482095,Tyler Kleven,D,OTT,22,42,1,5,6
4,8482141,Lukas Cormier,D,VGK,22,27,1,5,6
4,8477018,Ben Hutton,D,VGK,31,49,1,5,6
4,8483012,Logan Morrison,C,SEA,22,30,1,5,6
4,8475958,Michael Sgarbossa,C,WSH,32,26,1,5,6
4,8478450,Parker Wotherspoon,D,BOS,27,32,1,5,6
4,8484254,Akito Hirose,D,VAN,25,24,0,6,6
4,8481701,Santeri Hatakka,D,NJD,23,35,0,6,6
4,8481609,Vladislav Kolyachonok,D,UTA,23,32,0,6,6
4,8483397,Marc McLaughlin,C,BOS,25,34,4,1,5
4,8480844,Grigori Denisenko,L,VGK,24,33,3,2,5
4,8477149,Scott Sabourin,R,SJS,32,22,3,2,5
4,8483567,Georgii Merkulov,C,BOS,24,16,3,2,5
4,8476952,Dominic Toninato,C,WPG,30,33,2,3,5
4,8480870,Bo Groulx,C,NYR,24,31,2,3,5
4,8482861,Vincent Iorio,D,WSH,22,24,2,3,5
4,8479348,Kale Clague,D,BUF,26,41,1,4,5
4,8482153,Brendan Brisson,C,VGK,23,31,1,4,5
4,8479972,Mason Shaw,C,WPG,26,24,1,4,5
4,8481006,Tyler Tucker,D,STL,24,20,1,4,5
4,8481593,Jayden Struble,D,MTL,23,23,1,4,5
4,8477462,Robert Hagg,D,VGK,29,18,1,4,5
4,8481719,Maxwell Crozier,D,TBL,24,31,1,4,5
4,8482172,Landon Slaggert,L,CHI,22,28,1,4,5
4,8480851,Akil Thomas,C,LAK,24,16,1,4,5
4,8478454,Noah Juulsen,D,VAN,27,27,0,5,5
4,8477244,Chad Ruhwedel,D,NYR,34,32,0,5,5
4,8481518,Nolan Foote,L,NJD,24,33,4,0,4
4,8482145,Mavrik Bourque,C,DAL,22,57,4,0,4
4,8480468,James Hamblin,L,EDM,25,25,3,1,4
4,8480267,Sammy Walker,C,MIN,25,21,3,1,4
4,8483619,Filip Roos,D,OTT,25,36,2,2,4
4,8477810,Joel Hanley,D,CGY,33,27,2,2,4
4,8480880,Jakub Lauko,C,MIN,24,30,2,2,4
4,8482713,Mackie Samoskevich,R,FLA,22,46,2,2,4
4,8482177,Marat Khusnutdinov,C,MIN,22,24,2,2,4
4,8482470,Ilya Solovyov,D,CGY,24,18,2,2,4
4,8481065,Angus Crookshank,L,OTT,25,16,2,2,4
4,8479638,Justin Brazeau,R,BOS,26,36,1,3,4
4,8479362,Riley Tufte,L,BOS,26,22,1,3,4
4,8483630,Pavol Regenda,L,ANA,25,23,1,3,4
4,8479587,Rhett Gardner,C,PHI,28,15,1,3,4
4,8476473,Connor Murphy,D,CHI,31,38,0,4,4
4,8479378,Logan Stanley,D,WPG,26,36,0,4,4
4,8481605,Jackson LaCombe,D,ANA,23,49,0,4,4
4,8481541,Samuel Bolduc,D,NYI,24,28,0,4,4
4,8482516,Matthew Kessel,D,STL,24,21,0,4,4
4,8484287,Cole McWard,D,VAN,23,28,2,1,3
4,8482147,Jean-Luc Foudy,C,COL,22,26,2,1,3
4,8480084,Nick DeSimone,D,NJD,30,23,2,1,3
4,8481585,Egor Afanasyev,L,SJS,23,17,2,1,3
4,8478021,William Lagesson,D,DET,28,35,1,2,3
4,8482733,Logan Mailloux,D,MTL,31,28,1,2,3
4,8484258,Sam Malinski,D,COL,26,17,1,2,3
4,8479981,Jonah Gadjovich,L,FLA,26,46,1,2,3
4,8478477,Mitchell Stephens,C,SEA,27,17,1,2,3
4,8480823,Alexander Alexeyev,D,WSH,25,16,1,2,3
4,8479320,Max Lajoie,D,SEA,27,14,1,2,3
4,8482088,Justin Sourdif,R,FLA,22,22,1,2,3
4,8483489,Fraser Minten,C,TOR,31,9,1,2,3
4,8479522,Hardy Haman Aktell,D,WSH,26,5,1,2,3
4,8477971,Andreas Englund,D,LAK,28,30,0,3,3
4,8477073,Kurtis MacDermid,L,NJD,30,31,0,3,3
4,8477467,Gustav Olofsson,D,SEA,30,17,0,3,3
4,8481030,Jack St. Ivany,D,PIT,25,17,0,3,3
4,8480890,Jan Jenik,R,OTT,24,17,0,3,3
4,8479367,William Lockwood,R,FLA,26,15,2,0,2
4,8484325,Waltteri Merela,C,TBL,26,22,2,0,2
4,8482747,Brennan Othmann,L,NYR,21,37,1,1,2
4,8481699,Aku Raty,R,UTA,23,16,1,1,2
4,8479419,Brett Murray,L,BUF,26,25,1,1,2
4,8482197,Adam Raska,R,MIN,23,8,1,1,2
4,8482118,Sam Colangelo,R,ANA,23,21,1,1,2
4,8482162,Roby Jarventie,L,EDM,22,13,1,1,2
4,8481024,Linus Karlsson,C,VAN,25,8,1,1,2
4,8482165,Yan Kuznetsov,D,CGY,22,21,1,1,2
4,8480245,Olle Lycksell,R,PHI,25,36,0,2,2
4,8475795,Dylan McIlrath,D,WSH,32,14,0,2,2
4,8481206,John Ludvig,D,PIT,24,14,0,2,2
4,8478881,Brett Seney,L,CHI,28,13,0,2,2
4,8482250,Callahan Burke,C,VGK,27,15,0,2,2
4,8483546,Marshall Rifai,D,TOR,26,5,0,2,2
4,8481422,Jacob Lucchini,C,NSH,29,16,1,0,1
4,8481564,Ryan Johnson,D,BUF,23,19,1,0,1
4,8478502,Dennis Gilbert,D,BUF,28,13,1,0,1
4,8482102,Vasily Ponomarev,C,PIT,22,17,1,0,1
4,8482201,Gage Goncalves,C,TBL,23,20,1,0,1
4,8475755,Alexander Petrovic,D,DAL,32,18,1,0,1
4,8482061,Brandon Biro,L,SEA,26,14,1,0,1
4,8478051,Max Willman,C,NJD,29,16,1,0,1
4,8483920,Pierrick Dube,R,WSH,23,6,1,0,1
4,8484326,Patrik Koch,D,UTA,28,1,1,0,1
4,8481534,Raphael Lavoie,C,EDM,24,6,1,0,1
4,8479249,Andrew Poturalski,C,SJS,30,29,0,1,1
4,8474062,Riley Nash,C,NYR,35,16,0,1,1
4,8483512,Matt Savoie,C,EDM,20,22,0,1,1
4,8483471,Brad Lambert,C,WPG,31,15,0,1,1
4,8478147,Bokondji Imama,L,PIT,28,4,0,1,1
4,8482929,Emil Lilleberg,D,TBL,23,16,0,1,1
4,8479330,Brandon Gignac,C,MTL,27,10,0,1,1
4,8482787,Nikita Chibrikov,R,WPG,31,6,0,1,1
4,8480075,Cameron Crotty,D,MIN,25,5,0,1,1
4,8484259,Ondrej Pavel,C,COL,31,4,0,1,1
4,8482460,Matt Rempe,C,NYR,22,9,0,1,1
4,8484304,Uvis Balinskis,D,FLA,28,12,0,1,1
4,8482126,Emil Andrae,D,PHI,31,2,0,1,1
4,8482476,Emil Heineman,L,MTL,23,7,0,1,1
4,8481743,Marc Del Gaizo,D,NSH,25,15,0,0,0
4,8480032,Shane Bowers,C,NJD,25,18,0,0,0
4,8480874,Adam Ginning,D,PHI,24,6,0,0,0
4,8481462,Mason Morelli,L,VGK,28,14,0,0,0
4,8479985,Cale Fleury,D,SEA,26,27,0,0,0
4,8481043,Cole Koepke,L,BOS,26,15,0,0,0
4,8482094,Daemon Hunt,D,MIN,22,14,0,0,0
4,8480306,Grant Hutton,D,NYI,29,9,0,0,0
4,8484255,Jason Polin,R,COL,25,8,0,0,0
4,8478011,Louie Belpedio,D,PHI,28,7,0,0,0
4,8481578,Graeme Clarke,R,MIN,23,10,0,0,0
4,8475780,Chris Wagner,R,COL,33,13,0,0,0
4,8478446,Glenn Gawdin,C,LAK,27,7,0,0,0
4,8483407,Brandon Scanlin,D,NYR,25,4,0,0,0
4,8479421,Jacob Moverare,D,LAK,26,9,0,0,0
4,8477541,Dakota Mermis,D,TOR,30,11,0,0,0
4,8481655,Cole Schwindt,R,CGY,23,8,0,0,0
4,8477993,Justin Kirkland,C,CGY,28,6,0,0,0
4,8478854,Ryan Shea,D,PIT,27,4,0,0,0
4,8481806,Louis Crevier,D,CHI,23,10,0,0,0
4,8483597,Milos Kelemen,L,UTA,25,10,0,0,0
4,8475413,Justin Dowling,C,NJD,34,11,0,0,0
4,8476323,Max McCormick,L,SEA,32,4,0,0,0
4,8483395,Arshdeep Bains,L,VAN,23,9,0,0,0
4,8483432,Luca Del Bel Belluz,C,CBJ,31,3,0,0,0
4,8483609,Adam Klapka,R,CGY,24,5,0,0,0
4,8481726,Adam Edstrom,C,NYR,24,9,0,0,0
4,8479321,Lucas Johansen,D,,27,0,0,0,0
4,8470794,Joe Pavelski,C,,40,0,0,0,0
4,8477950,Tony DeAngelo,D,,29,0,0,0,0
4,8471218,Blake Wheeler,R,,38,0,0,0,0
4,8475197,Tyson Barrie,D,,33,0,0,0,0
4,8475744,Evgeny Kuznetsov,C,,32,0,0,0,0
4,8474037,James van Riemsdyk,L,,35,0,0,0,0
4,8474602,Justin Schultz,D,,34,0,0,0,0
4,8482222,Alexander Barabanov,L,,30,0,0,0,0
4,8474157,Max Pacioretty,L,,36,0,0,0,0
4,8474031,Kevin Shattenkirk,D,,35,0,0,0,0
4,8480884,Calen Addison,D,,24,0,0,0,0
4,8480008,Adam Ruzicka,C,,25,0,0,0,0
4,8475906,John Klingberg,D,,32,0,0,0,0
4,8476884,Derrick Pouliot,D,,30,0,0,0,0
4,8476919,Chris Tierney,C,,30,0,0,0,0
4,8479415,Michael McLeod,C,,26,0,0,0,0
4,8474884,Mike Hoffman,C,,35,0,0,0,0
4,8478104,Sammy Blais,L,,28,0,0,0,0
4,8474870,Tyler Johnson,C,,34,0,0,0,0
4,8481591,Sam Poulin,R,,23,0,0,0,0
4,8479977,Kailer Yamamoto,R,,26,0,0,0,0
4,8476393,Nick Cousins,C,,31,0,0,0,0
4,8479376,Victor Mete,D,,26,0,0,0,0
4,8476871,Tanner Pearson,L,,32,0,0,0,0
4,8471274,Alex Goligoski,D,,39,0,0,0,0
4,8481058,Jesse Ylönen,R,,25,0,0,0,0
4,8477464,Nic Petan,C,,29,0,0,0,0
4,8473449,Kyle Okposo,R,,36,0,0,0,0
4,8480216,Jacob Peterson,C,,25,0,0,0,0
4,8479346,Dillon Dube,C,,26,0,0,0,0
4,8470966,Mark Giordano,D,,41,0,0,0,0
4,8480821,Filip Zadina,R,,25,0,0,0,0
4,8476907,Mackenzie MacEachern,L,,30,0,0,0,0
4,8478430,Oliver Kylington,D,,27,0,0,0,0
4,8479514,Rem Pitlick,C,,27,0,0,0,0
4,8478099,Kevin Labanc,R,,29,0,0,0,0
4,8482241,Radim Zohorna,L,,28,0,0,0,0
4,8474040,Sam Gagner,C,,35,0,0,0,0
4,8475164,Jakob Silfverberg,R,,34,0,0,0,0
4,8475752,Tyler Pitlick,C,,33,0,0,0,0
4,8479984,Cal Foote,D,,26,0,0,0,0
4,8478495,Denis Gurianov,R,,27,0,0,0,0
4,8479533,Joona Koppanen,L,,26,0,0,0,0
4,8479458,Nikita Zaitsev,D,,33,0,0,0,0
4,8471699,Andrew Cogliano,C,,37,0,0,0,0
4,8470604,Jeff Carter,C,,39,0,0,0,0
4,8477330,Dominik Kubalik,L,,29,0,0,0,0
4,8477944,Jakub Vrana,L,,28,0,0,0,0
4,8478904,Steven Lorentz,C,,28,0,0,0,0
4,8471686,Marc Staal,D,,37,0,0,0,0
4,8478512,Austin Czarnik,C,,32,0,0,0,0
4,8470610,Zach Parise,L,,40,0,0,0,0
4,8473504,Cal Clutterbuck,R,,37,0,0,0,0
4,8474009,Nick Bonino,C,,36,0,0,0,0
4,8477454,Adam Erne,L,,29,0,0,0,0
4,8477126,Jayson Megna,C,,34,0,0,0,0
4,8473473,Milan Lucic,L,,36,0,0,0,0
4,8478067,Oskar Lindblom,L,,28,0,0,0,0
4,8475825,Jani Hakanpää,D,,32,0,0,0,0
4,8479383,Boris Katchouk,L,,26,0,0,0,0
4,8478400,Colin White,C,,27,0,0,0,0
4,8477846,Ryan Carpenter,C,,33,0,0,0,0
4,8477930,Pierre-Edouard Bellemare,L,,39,0,0,0,0
4,8479423,Alex Nylander,L,,26,0,0,0,0
4,8475797,Jarred Tinordi,D,,32,0,0,0,0
4,8481239,Samuel Fagemo,L,,24,0,0,0,0
4,8474618,Marco Scandella,D,,34,0,0,0,0
4,8480853,Liam Foudy,C,,24,0,0,0,0
4,8478028,Fredrik Olofsson,L,,28,0,0,0,0
4,8474145,Robert Bortuzzo,D,,35,0,0,0,0
4,8474709,Matt Martin,L,,35,0,0,0,0
4,8480226,Marián Studenic,R,,26,0,0,0,0
4,8480274,Philip Kemp,D,EDM,25,2,0,0,0
4,8480184,Gustav Lindstrom,D,,26,0,0,0,0
4,8481077,John Leonard,L,,26,0,0,0,0
4,8479547,Matthew Phillips,R,,26,0,0,0,0
4,8476915,Jujhar Khaira,L,,30,0,0,0,0
4,8481070,Hugh McGing,L,,26,0,0,0,0
4,8478408,Travis Dermott,D,,28,0,0,0,0
4,8481812,Nikolai Knyzhov,D,,27,0,0,0,0
4,8484321,Nikolas Matinpalo,D,OTT,26,1,0,0,0
4,8475278,Byron Froese,C,,33,0,0,0,0
4,8475766,Austin Watson,L,,32,0,0,0,0
4,8483398,Declan Carlile,D,TBL,31,3,0,0,0
4,8479546,Oskar Steen,C,,26,0,0,0,0
4,8480836,Jonathan Gruden,C,,24,0,0,0,0
4,8481690,Tyler Angle,C,,24,0,0,0,0
4,8480031,Maxime Comtois,L,,25,0,0,0,0
4,8483045,Cameron Butler,R,CBJ,31,0,0,0,0
4,8478078,Rourke Chartier,C,,28,0,0,0,0
4,8481016,Ruslan Iskhakov,C,,24,0,0,0,0
4,8484314,Jiri Smejkal,L,,28,0,0,0,0
4,8478956,Samuel Laberge,L,NJD,27,1,0,0,0
4,8483401,Marc Johnstone,R,PIT,28,0,0,0,0
4,8483531,Brian Halonen,L,NJD,25,3,0,0,0
4,8480776,Sheldon Rempal,R,,29,0,0,0,0
5,8478402,Connor McDavid,C,EDM,27,79,55,96,151
5,8476453,Nikita Kucherov,R,TBL,31,82,35,101,136
5,8477492,Nathan MacKinnon,C,COL,29,81,61,71,132
5,8479318,Auston Matthews,C,TOR,27,80,69,60,129
5,8481559,Jack Hughes,C,NJD,23,75,53,72,125
5,8478550,Artemi Panarin,L,NYR,33,79,35,75,110
5,8478864,Kirill Kaprizov,L,MIN,27,76,50,58,108
5,8477934,Leon Draisaitl,C,EDM,29,79,43,65,108
5,8477493,Aleksander Barkov,C,FLA,29,78,33,71,104
5,8478420,Mikko Rantanen,R,COL,28,81,41,60,101
5,8476468,J.T. Miller,C,VAN,31,73,34,67,101
5,8480069,Cale Makar,D,COL,26,68,23,74,97
5,8477939,William Nylander,R,TOR,28,82,41,55,96
5,8477956,David Pastrnak,R,BOS,28,79,50,45,95
5,8480002,Nico Hischier,C,NJD,25,75,34,60,94
5,8471675,Sidney Crosby,C,PIT,37,72,32,62,94
5,8479314,Matthew Tkachuk,L,FLA,27,78,23,71,94
5,8474600,Roman Josi,D,NSH,34,75,22,71,93
5,8477404,Jake Guentzel,C,TBL,30,82,45,47,92
5,8475166,John Tavares,C,TOR,34,80,39,52,91
5,8477946,Dylan Larkin,C,DET,28,81,48,42,90
5,8479323,Adam Fox,D,NYR,26,76,13,77,90
5,8477501,Valeri Nichushkin,R,COL,29,81,41,48,89
5,8478403,Jack Eichel,C,VGK,28,75,39,50,89
5,8480012,Elias Pettersson,C,VAN,26,77,29,59,88
5,8480027,Jason Robertson,L,DAL,25,82,31,54,85
5,8476887,Filip Forsberg,L,NSH,30,75,41,43,84
5,8471214,Alex Ovechkin,L,WSH,39,72,41,40,81
5,8479407,Jesper Bratt,L,NJD,26,74,31,50,81
5,8476460,Mark Scheifele,C,WPG,31,69,29,52,81
5,8476456,Jonathan Huberdeau,C,CGY,31,77,23,58,81
5,8479385,Jordan Kyrou,C,STL,26,72,39,41,80
5,8481557,Matt Boldy,L,MIN,23,75,33,47,80
5,8480801,Brady Tkachuk,L,OTT,25,78,32,48,80
5,8474564,Steven Stamkos,C,NSH,34,76,29,51,80
5,8482078,Lucas Raymond,L,DET,22,82,35,44,79
5,8478414,Timo Meier,R,NJD,28,74,40,38,78
5,8473419,Brad Marchand,L,BOS,36,81,33,45,78
5,8477951,Nick Schmaltz,C,UTA,28,76,31,47,78
5,8478398,Kyle Connor,L,WPG,28,71,43,34,77
5,8478445,Mathew Barzal,C,NYI,27,79,26,51,77
5,8478873,Troy Terry,R,ANA,27,70,33,43,76
5,8478439,Travis Konecny,R,PHI,27,78,29,47,76
5,8475913,Mark Stone,R,VGK,32,76,28,48,76
5,8477933,Sam Reinhart,C,FLA,29,76,38,37,75
5,8478010,Brayden Point,C,TBL,28,81,36,39,75
5,8478493,Joel Eriksson Ek,C,MIN,27,69,32,43,75
5,8484144,Connor Bedard,C,CHI,19,67,27,48,75
5,8480036,Miro Heiskanen,D,DAL,25,81,18,57,75
5,8477409,Carter Verhaeghe,C,FLA,29,75,39,35,74
5,8480023,Robert Thomas,C,STL,25,74,25,49,74
5,8476454,Ryan Nugent-Hopkins,C,EDM,31,80,22,52,74
5,8478427,Sebastian Aho,C,CAR,27,68,32,41,73
5,8471685,Anze Kopitar,C,LAK,37,81,24,49,73
5,8476459,Mika Zibanejad,C,NYR,31,73,23,50,73
5,8477942,Kevin Fiala,L,LAK,28,80,27,45,72
5,8480208,Drake Batherson,R,OTT,26,78,36,35,71
5,8477960,Adrian Kempe,R,LAK,28,82,29,42,71
5,8477504,Josh Morrissey,D,WPG,29,76,15,56,71
5,8479343,Clayton Keller,R,UTA,26,80,36,34,70
5,8475168,Matt Duchene,C,DAL,33,78,32,38,70
5,8476389,Vincent Trocheck,C,NYR,31,76,32,38,70
5,8482745,Mason McTavish,C,ANA,21,74,29,41,70
5,8474578,Erik Karlsson,D,PIT,34,80,13,57,70
5,8475692,Mats Zuccarello,R,MIN,37,67,13,57,70
5,8475784,Jeff Skinner,C,EDM,32,72,40,29,69
5,8475172,Nazem Kadri,C,CGY,34,74,28,41,69
5,8475786,Zach Hyman,L,EDM,32,75,42,25,67
5,8482699,Dylan Guenther,R,UTA,21,77,31,36,67
5,8479675,Trevor Moore,L,LAK,29,80,29,38,67
5,8482740,Wyatt Johnston,C,DAL,21,79,32,34,66
5,8477476,Artturi Lehkonen,L,COL,29,79,29,37,66
5,8479337,Alex DeBrincat,R,DET,27,79,26,40,66
5,8480830,Andrei Svechnikov,R,CAR,24,64,28,37,65
5,8477940,Nikolaj Ehlers,L,WPG,28,73,27,38,65
5,8477949,Alex Tuch,R,BUF,28,68,25,40,65
5,8480803,Evan Bouchard,D,EDM,25,80,16,49,65
5,8476346,Johnny Gaudreau,L,CBJ,31,75,14,50,64
5,8475184,Chris Kreider,L,NYR,33,78,39,24,63
5,8481068,Yegor Sharangovich,C,CGY,26,77,39,24,63
5,8477496,Elias Lindholm,C,BOS,30,78,30,33,63
5,8478449,Roope Hintz,C,DAL,28,82,27,36,63
5,8484153,Leo Carlsson,C,ANA,20,73,25,38,63
5,8482116,Tim Stützle,C,OTT,22,82,20,43,63
5,8475167,Victor Hedman,D,TBL,34,75,16,47,63
5,8478460,Zach Werenski,D,CBJ,27,82,9,54,63
5,8476853,Morgan Rielly,D,TOR,30,70,8,55,63
5,8480800,Quinn Hughes,D,VAN,25,74,1,62,63
5,8478047,Michael Bunting,L,PIT,29,71,27,35,62
5,8477402,Pavel Buchnevich,L,STL,29,74,25,37,62
5,8477494,Jonathan Drouin,L,COL,29,81,18,44,62
5,8481540,Cole Caufield,R,MTL,23,74,35,26,61
5,8478444,Brock Boeser,R,VAN,27,75,27,34,61
5,8479420,Tage Thompson,C,BUF,27,70,28,32,60
5,8474141,Patrick Kane,R,DET,36,79,21,39,60
5,8475798,Mikael Granlund,C,SJS,32,69,16,44,60
5,8477935,Sam Bennett,C,FLA,28,81,31,28,59
5,8475810,Bryan Rust,R,PIT,32,68,31,28,59
5,8480039,Martin Necas,C,CAR,25,66,28,31,59
5,8479542,Brandon Hagel,L,TBL,26,82,26,33,59
5,8474641,Adam Henrique,C,EDM,34,80,25,34,59
5,8477500,Bo Horvat,C,NYI,29,80,23,36,59
5,8482667,William Eklund,L,SJS,22,72,22,37,59
5,8479999,Casey Mittelstadt,C,COL,26,82,18,41,59
5,8476539,Jonathan Marchessault,R,NSH,34,75,35,23,58
5,8478975,Mason Marchment,L,DAL,29,81,26,32,58
5,8477416,Oliver Bjorkstrand,R,SEA,29,73,21,37,58
5,8471724,Kris Letang,D,PIT,37,78,18,40,58
5,8482093,Seth Jarvis,C,CAR,22,72,30,27,57
5,8475158,Ryan O'Reilly,C,NSH,33,74,29,28,57
5,8476881,Tomas Hertl,C,VGK,31,72,26,31,57
5,8481618,Alex Newhook,C,MTL,23,72,18,39,57
5,8478498,Jake DeBrusk,L,VAN,28,72,35,21,56
5,8475794,Tyler Seguin,C,DAL,32,82,29,27,56
5,8475754,Brock Nelson,C,NYI,33,77,25,31,56
5,8483808,Andrei Kuzmenko,L,CGY,28,81,24,31,55
5,8471215,Evgeni Malkin,C,PIT,38,75,22,33,55
5,8473994,Jamie Benn,L,DAL,35,80,21,34,55
5,8479425,Filip Hronek,D,VAN,27,71,11,44,55
5,8476448,William Karlsson,C,VGK,31,78,28,26,54
5,8475765,Vladimir Tarasenko,R,DET,33,79,22,32,54
5,8481711,Matias Maccelli,L,UTA,24,76,20,34,54
5,8482110,Dawson Mercer,C,NJD,23,69,19,35,54
5,8480839,Rasmus Dahlin,D,BUF,24,67,14,40,54
5,8475169,Evander Kane,L,EDM,33,74,30,23,53
5,8476479,Phillip Danault,C,LAK,31,80,20,33,53
5,8474150,Mikael Backlund,C,CGY,35,78,20,33,53
5,8477964,Ivan Barbashev,C,VGK,29,72,19,34,53
5,8476432,Boone Jenner,C,CBJ,31,68,31,21,52
5,8477955,Jared McCann,L,SEA,28,71,28,24,52
5,8478519,Anthony Cirelli,C,TBL,27,82,22,30,52
5,8477021,Alex Kerfoot,C,UTA,30,77,15,37,52
5,8478407,Vince Dunn,D,SEA,28,72,9,43,52
5,8477479,Tyler Bertuzzi,L,CHI,29,72,27,24,51
5,8473986,Alex Killorn,L,ANA,35,71,26,25,51
5,8476880,Tom Wilson,R,WSH,30,76,24,27,51
5,8477497,Sean Monahan,C,CBJ,30,65,23,28,51
5,8482665,Matty Beniers,C,SEA,22,71,22,29,51
5,8480018,Nick Suzuki,C,MTL,25,77,20,31,51
5,8474102,David Perron,L,OTT,36,78,19,32,51
5,8482113,Anton Lundell,C,FLA,23,75,18,33,51
5,8477953,Kasperi Kapanen,R,STL,28,72,17,34,51
5,8479400,Pierre-Luc Dubois,L,WSH,26,72,31,19,50
5,8476438,Brandon Saad,L,STL,32,70,30,20,50
5,8479525,Ross Colton,C,COL,28,78,27,23,50
5,8480014,Gabriel Vilardi,C,WPG,25,73,24,26,50
5,8480188,Fabian Zetterlund,L,SJS,25,67,23,27,50
5,8484145,Zach Benson,L,BUF,19,69,22,28,50
5,8474149,Evgenii Dadonov,R,DAL,35,79,18,32,50
5,8475170,Brayden Schenn,C,STL,33,74,17,33,50
5,8478462,Nicolas Roy,C,VGK,27,80,16,34,50
5,8482124,Quinton Byfield,R,LAK,22,79,26,23,49
5,8476399,Blake Coleman,C,CGY,33,75,24,25,49
5,8474586,Jordan Eberle,R,SEA,34,70,24,25,49
5,8483431,Logan Cooley,C,UTA,20,74,22,27,49
5,8482109,Alexis Lafrenière,L,NYR,23,77,19,30,49
5,8481528,Dylan Cozens,C,BUF,23,72,19,30,49
5,8478856,Conor Garland,R,VAN,28,75,19,30,49
5,8480015,Owen Tippett,R,PHI,25,75,19,30,49
5,8477447,Shea Theodore,D,VGK,29,56,7,42,49
5,8482159,Tyson Foerster,R,PHI,22,73,27,21,48
5,8482097,Jack Quinn,R,BUF,23,66,25,23,48
5,8479325,Charlie McAvoy,D,BOS,27,77,14,34,48
5,8478038,Devon Toews,D,COL,30,71,9,39,48
5,8482684,Luke Hughes,D,NJD,21,67,7,41,48
5,8480064,Josh Norris,C,OTT,25,75,30,17,47
5,8476483,Rickard Rakell,R,PIT,31,73,25,22,47
5,8482146,Luke Evangelista,R,NSH,22,67,23,24,47
5,8478458,Jack Roslovic,C,CAR,27,66,21,26,47
5,8477451,Ryan Hartman,R,MIN,30,66,19,28,47
5,8481533,Trevor Zegras,C,ANA,23,74,19,28,47
5,8478396,Noah Hanifin,D,VGK,27,63,19,28,47
5,8476458,Ryan Strome,C,ANA,31,74,18,29,47
5,8473512,Claude Giroux,R,OTT,36,78,16,31,47
5,8474679,Gustav Nyquist,C,NSH,35,72,14,33,47
5,8482671,Owen Power,D,BUF,22,69,12,35,47
5,8474590,John Carlson,D,WSH,34,69,11,36,47
5,8475151,Kyle Palmieri,C,NYI,33,75,28,18,46
5,8482702,Logan Stankoven,C,DAL,21,81,23,23,46
5,8477986,Brandon Montour,D,SEA,30,70,16,30,46
5,8478233,Andrew Mangiapane,L,WSH,28,68,16,30,46
5,8476905,Chandler Stephenson,C,SEA,30,77,14,32,46
5,8476462,Dougie Hamilton,D,NJD,31,67,8,38,46
5,8476875,Mike Matheson,D,MTL,30,74,6,40,46
5,8478366,Frank Vatrano,R,ANA,30,65,22,23,45
5,8475191,Reilly Smith,R,NYR,33,72,18,27,45
5,8478401,Pavel Zacha,C,BOS,27,80,15,30,45
5,8478397,Rasmus Andersson,D,CGY,28,69,9,36,45
5,8477425,Miles Wood,L,COL,29,82,24,20,44
5,8477998,Warren Foegele,L,LAK,28,79,18,26,44
5,8478463,Anthony Beauvillier,L,PIT,27,66,16,28,44
5,8477932,Aaron Ekblad,D,FLA,28,71,14,30,44
5,8481186,Logan O'Connor,R,COL,28,79,13,31,44
5,8475218,Mattias Ekholm,D,EDM,34,69,13,31,44
5,8478438,Tommy Novak,C,NSH,27,68,12,32,44
5,8478042,Viktor Arvidsson,R,EDM,31,70,11,33,44
5,8479410,Mikhail Sergachev,D,UTA,26,70,5,39,44
5,8475764,Cam Fowler,D,ANA,33,76,4,40,44
5,8475714,Calle Jarnkrok,C,TOR,33,78,20,23,43
5,8477456,J.T. Compher,L,DET,29,79,16,27,43
5,8477498,Darnell Nurse,D,EDM,29,69,7,36,43
5,8477495,Seth Jones,D,CHI,30,68,6,37,43
5,8477426,Nicholas Paul,L,TBL,29,81,23,19,42
5,8481582,Nicholas Robertson,L,TOR,23,75,23,19,42
5,8480849,Barrett Hayton,C,UTA,24,70,20,22,42
5,8482149,Cole Perfetti,C,WPG,22,67,17,25,42
5,8480009,Eeli Tolvanen,R,SEA,25,73,17,25,42
5,8478472,Mathieu Joseph,R,STL,27,74,17,25,42
5,8475745,Charlie Coyle,C,BOS,32,78,13,29,42
5,8476792,Torey Krug,D,STL,33,68,12,30,42
5,8476923,Damon Severson,D,CBJ,30,81,10,32,42
5,8480434,Sean Durzi,D,UTA,26,68,9,33,42
5,8482055,Drew O'Connor,L,PIT,26,68,22,19,41
5,8478440,Dylan Strome,C,WSH,27,63,18,23,41
5,8476419,Jean-Gabriel Pageau,C,NYI,32,76,18,23,41
5,8481596,Shane Pinto,C,OTT,24,78,16,25,41
5,8480817,K'Andre Miller,D,NYR,24,70,8,33,41
5,8477346,MacKenzie Weegar,D,CGY,30,66,7,34,41
5,8480865,Noah Dobson,D,NYI,24,75,5,36,41
5,8481577,Philip Tomasino,C,NSH,23,62,17,23,40
5,8475726,Tyler Toffoli,C,SJS,32,71,15,25,40
5,8477503,Max Domi,C,TOR,29,78,11,29,40
5,8475753,Justin Faulk,D,STL,32,67,11,29,40
5,8481581,Thomas Harley,D,DAL,23,81,8,32,40
5,8471698,T.J. Oshie,R,WSH,38,63,22,17,39
5,8475799,Nino Niederreiter,R,WPG,32,73,21,18,39
5,8477407,Anthony Duclair,L,NYI,29,79,20,19,39
5,8483515,Juraj Slafkovsky,L,MTL,20,78,15,24,39
5,8480798,Philipp Kurashev,C,CHI,25,67,15,24,39
5,8479987,Morgan Geekie,C,BOS,26,76,14,25,39
5,8477429,Andrew Copp,C,DET,30,79,12,27,39
5,8476906,Shayne Gostisbehere,D,CAR,31,79,10,29,39
5,8474565,Alex Pietrangelo,D,VGK,34,60,10,29,39
5,8478466,Daniel Sprong,R,VAN,27,71,17,21,38
5,8482092,Ridly Greig,C,OTT,22,78,17,21,38
5,8478542,Evan Rodrigues,C,FLA,31,74,17,21,38
5,8475287,Erik Haula,L,NJD,33,66,16,22,38
5,8476927,Teddy Blueger,C,VAN,30,67,14,24,38
5,8476826,Yanni Gourde,C,SEA,33,71,13,25,38
5,8483505,Matthew Poitras,C,BOS,20,74,11,27,38
5,8475200,Dmitry Orlov,D,CAR,33,74,10,28,38
5,8476463,Jonas Brodin,D,MIN,31,78,10,28,38
5,8478474,Lawson Crouse,L,UTA,27,74,21,16,37
5,8482089,Jake Neighbours,L,STL,22,70,20,17,37
5,8483524,Shane Wright,C,SEA,20,62,19,18,37
5,8480459,Pius Suter,C,VAN,28,77,17,20,37
5,8482720,Matthew Knies,L,TOR,22,80,14,23,37
5,8473422,Nick Foligno,L,CHI,37,64,14,23,37
5,8481560,Arthur Kaliyev,R,LAK,23,77,12,25,37
5,8474563,Drew Doughty,D,LAK,35,69,11,26,37
5,8481703,Valtteri Puustinen,R,PIT,25,63,9,28,37
5,8480185,Eetu Luostarinen,C,FLA,26,77,19,17,36
5,8475763,Kevin Hayes,R,PIT,32,59,17,19,36
5,8476872,Scott Laughton,C,PHI,30,77,15,21,36
5,8476897,Oskar Sundqvist,C,STL,30,73,15,21,36
5,8475760,Nick Bjugstad,C,UTA,32,76,13,23,36
5,8477948,Travis Sanheim,D,PHI,28,66,8,28,36
5,8481546,Cam York,D,PHI,23,65,6,30,36
5,8477506,Ryan Pulock,D,NYI,30,77,4,32,36
5,8480893,Kirill Marchenko,R,CBJ,24,61,24,11,35
5,8482125,Alexander Holtz,R,VGK,22,68,20,15,35
5,8477511,Anthony Mantha,R,CGY,30,76,18,17,35
5,8475314,Anders Lee,L,NYI,34,74,18,17,35
5,8478057,Dakota Joshua,C,VAN,28,71,17,18,35
5,8475791,Taylor Hall,L,CHI,33,70,17,18,35
5,8480078,Filip Chytil,C,NYR,25,65,13,22,35
5,8480068,Ryan Poehling,C,PHI,25,72,10,25,35
5,8481542,Moritz Seider,D,DET,23,79,6,29,35
5,8478055,Gustav Forsling,D,FLA,28,73,6,29,35
5,8482175,JJ Peterka,R,BUF,22,66,25,9,34
5,8482079,Marco Rossi,C,MIN,23,60,18,16,34
5,8484166,Adam Fantilli,C,CBJ,20,72,17,17,34
5,8481601,Simon Holmstrom,R,NYI,23,72,17,17,34
5,8477444,Andre Burakovsky,L,SEA,29,74,15,19,34
5,8480028,Morgan Frost,C,PHI,25,72,15,19,34
5,8476474,Stefan Noesen,R,NJD,31,69,15,19,34
5,8476882,Teuvo Teravainen,L,CHI,30,69,14,20,34
5,8479365,Trent Frederic,C,BOS,26,76,14,20,34
5,8481656,Aliaksei Protas,C,WSH,23,71,9,25,34
5,8470613,Brent Burns,D,CAR,39,72,8,26,34
5,8482122,Brock Faber,D,MIN,22,76,8,26,34
5,8475848,Brendan Gallagher,R,MTL,32,71,17,16,33
5,8478115,Pierre Engvall,L,NYI,28,76,15,18,33
5,8474053,Logan Couture,C,SJS,35,62,15,18,33
5,8480797,Joel Farabee,L,PHI,24,70,11,22,33
5,8475193,Tomas Tatar,L,NJD,34,73,11,22,33
5,8476869,Brady Skjei,D,NSH,30,71,8,25,33
5,8479345,Jakob Chychrun,D,WSH,26,70,8,25,33
5,8483490,Pavel Mintyukov,D,ANA,21,74,7,26,33
5,8477952,Robby Fabbri,C,ANA,28,63,19,13,32
5,8479339,Patrik Laine,L,CBJ,26,63,16,16,32
5,8479351,Sam Steel,C,DAL,26,80,14,18,32
5,8476921,Jordan Martinook,L,CAR,32,66,14,18,32
5,8470621,Corey Perry,R,EDM,39,71,14,18,32
5,8476278,Colin Blackwell,C,DAL,31,78,11,21,32
5,8484203,Bradly Nadeau,L,CAR,19,62,9,23,32
5,8478416,Erik Cernak,D,TBL,27,74,9,23,32
5,8476885,Jacob Trouba,D,NYR,30,74,7,25,32
5,8475768,Jaden Schwartz,C,SEA,32,70,6,26,32
5,8474151,Ryan McDonagh,D,TBL,35,75,3,29,32
5,8479661,Tanner Jeannot,L,LAK,27,73,17,14,31
5,8478046,Danton Heinen,L,VAN,29,71,16,15,31
5,8481032,Paul Cotter,C,NJD,25,68,16,15,31
5,8480802,Ryan McLeod,C,BUF,25,67,13,18,31
5,8479992,Michael Rasmussen,C,DET,25,78,13,18,31
5,8475793,Ryan Johansen,C,PHI,32,74,13,18,31
5,8480220,Noah Cates,L,PHI,25,65,13,18,31
5,8482809,Jackson Blake,R,CAR,21,65,12,19,31
5,8482705,Cole Sillinger,C,CBJ,21,76,11,20,31
5,8480748,Kiefer Sherwood,L,VAN,29,68,11,20,31
5,8482111,Justin Barron,D,MTL,23,75,10,21,31
5,8479353,Brett Howden,C,VGK,26,71,10,21,31
5,8476854,Hampus Lindholm,D,BOS,30,69,7,24,31
5,8477488,Brett Pesce,D,NJD,30,61,7,24,31
5,8482624,Daniil Miromanov,D,CGY,27,65,6,25,31
5,8480871,Adam Boqvist,D,FLA,24,74,5,26,31
5,8480873,Rasmus Sandin,D,WSH,24,60,2,29,31
5,8480043,Timothy Liljegren,D,TOR,25,68,1,30,31
5,8476469,Joel Armia,R,MTL,31,70,16,14,30
5,8479941,Justin Danforth,R,CBJ,31,64,15,15,30
5,8476480,Vladislav Namestnikov,C,WPG,32,66,14,16,30
5,8473533,Jordan Staal,C,CAR,36,67,14,16,30
5,8474716,Jared Spurgeon,D,MIN,35,74,11,19,30
5,8478413,Jordan Greenway,L,BUF,27,69,11,19,30
5,8475149,Marcus Johansson,L,MIN,34,65,11,19,30
5,8481523,Kirby Dach,C,MTL,23,66,8,22,30
5,8482133,Thomas Bordeleau,C,SJS,22,61,6,24,30
5,8473507,Jeff Petry,D,DET,37,74,4,26,30
5,8478500,Ivan Provorov,D,CBJ,27,80,3,27,30
5,8478882,Vladislav Gavrikov,D,LAK,29,68,2,28,30
5,8477508,Curtis Lazar,C,NJD,29,58,17,12,29
5,8476292,Ondrej Palat,L,NJD,33,68,13,16,29
5,8478432,Christian Fischer,R,DET,27,72,12,17,29
5,8476422,Mike Reilly,D,NYI,31,78,11,18,29
5,8480336,Sean Walker,D,CAR,30,71,7,22,29
5,8480995,Pontus Holmberg,R,TOR,25,68,7,22,29
5,8477969,Marcus Pettersson,D,PIT,28,77,6,23,29
5,8476979,Erik Gustafsson,D,DET,32,77,5,24,29
5,8480222,Sebastian Aho,D,PIT,28,73,4,25,29
5,8480073,Erik Brannstrom,D,COL,25,66,2,27,29
5,8476918,Jimmy Vesey,L,NYR,31,72,14,14,28
5,8481624,Ilya Mikheyev,R,CHI,30,58,12,16,28
5,8477987,Ryan Donato,C,CHI,28,61,11,17,28
5,8477989,Christian Dvorak,C,MTL,28,72,11,17,28
5,8483499,Liam Ohgren,L,MIN,20,66,11,17,28
5,8475171,Oliver Ekman-Larsson,D,TOR,33,72,10,18,28
5,8482660,Kent Johnson,C,CBJ,22,61,8,20,28
5,8480835,Jack Drury,C,CAR,24,64,7,21,28
5,8476917,Adam Pelech,D,NYI,30,81,6,22,28
5,8478469,Thomas Chabot,D,OTT,27,73,3,25,28
5,8476958,Jaccob Slavin,D,CAR,30,74,2,26,28
5,8476981,Josh Anderson,R,MTL,30,66,19,8,27
5,8482074,Connor Zary,C,CGY,23,69,12,15,27
5,8476392,Adam Lowry,C,WPG,31,70,10,17,27
5,8480855,Jack McBain,C,UTA,24,63,10,17,27
5,8474189,Lars Eller,C,PIT,35,69,10,17,27
5,8480145,Neal Pionk,D,WPG,29,77,9,18,27
5,8475343,Nic Dowd,C,WSH,34,56,6,21,27
5,8482245,Artem Zub,D,OTT,29,73,6,21,27
5,8475181,Nick Leddy,D,STL,33,71,1,26,27
5,8475722,Jason Zucker,L,BUF,32,64,14,12,26
5,8479390,Taylor Raddysh,R,WSH,26,67,13,13,26
5,8477947,Sonny Milano,L,WSH,28,61,12,14,26
5,8477450,Jason Dickinson,C,CHI,29,55,12,14,26
5,8480205,Emil Bemstrom,C,PIT,25,64,12,14,26
5,8476925,Colton Sissons,C,NSH,31,69,10,16,26
5,8482105,Jake Sanderson,D,OTT,22,70,9,17,26
5,8480829,Jesperi Kotkaniemi,C,CAR,24,63,8,18,26
5,8478911,Matt Roy,D,WSH,29,68,8,18,26
5,8476467,Jamie Oleksiak,D,SEA,32,69,7,19,26
5,8478891,Mason Appleton,C,WPG,28,61,6,20,26
5,8483445,Cutter Gauthier,L,ANA,20,61,6,20,26
5,8480113,Alex Iafallo,L,WPG,31,64,4,22,26
5,8478136,Jake Middleton,D,MIN,28,70,4,22,26
5,8482712,Oskar Olausson,R,COL,22,76,3,23,26
5,8479976,Juuso Valimaki,D,UTA,26,57,2,24,26
5,8478020,Michael Amadio,C,OTT,28,70,16,9,25
5,8475855,Jesper Fast,R,CAR,33,59,13,12,25
5,8481553,Bobby Brink,R,PHI,23,65,12,13,25
5,8482101,Danil Gushchin,L,SJS,22,55,12,13,25
5,8476312,Josh Manson,D,COL,33,71,10,15,25
5,8479315,Joey Anderson,R,CHI,26,50,10,15,25
5,8476525,Colin Miller,D,WPG,32,60,9,16,25
5,8483565,Nick Blankenburg,D,NSH,26,64,8,17,25
5,8481580,Connor McMichael,C,WSH,23,62,6,19,25
5,8481606,Jordan Spence,D,LAK,23,68,5,20,25
5,8476902,Esa Lindell,D,DAL,30,77,5,20,25
5,8480878,Nils Lundkvist,D,DAL,24,82,4,21,25
5,8481014,Alexander Romanov,D,NYI,24,79,2,23,25
5,8478507,John Marino,D,UTA,27,70,1,24,25
5,8479393,Noah Gregor,C,OTT,26,74,18,6,24
5,8481604,Pavel Dorofeyev,L,VGK,24,65,15,9,24
5,8474715,Cam Atkinson,R,TBL,35,81,14,10,24
5,8482749,Joshua Roy,R,MTL,21,66,14,10,24
5,8480074,Alexandre Texier,C,STL,25,60,9,15,24
5,8481527,Kaedan Korczak,D,VGK,23,46,9,15,24
5,8483491,Ivan Miroshnichenko,L,WSH,20,62,9,15,24
5,8479983,Mario Ferraro,D,SJS,26,68,7,17,24
5,8474574,Tyler Myers,D,VAN,34,70,6,18,24
5,8482655,J.J. Moser,D,TBL,24,78,5,19,24
5,8479982,Conor Timmins,D,TOR,26,64,4,20,24
5,8476879,Cody Ceci,D,EDM,31,67,3,21,24
5,8478851,Alexandre Carrier,D,NSH,28,65,2,22,24
5,8481477,Nico Sturm,C,SJS,29,60,12,11,23
5,8480789,Oliver Wahlstrom,R,NYI,24,68,10,13,23
5,8477499,Rasmus Ristolainen,D,PHI,30,58,8,15,23
5,8479359,Beck Malenstyn,L,BUF,26,54,8,15,23
5,8480144,David Kampf,C,TOR,29,76,7,16,23
5,8482117,Lukas Reichel,L,CHI,22,58,6,17,23
5,8478178,Darren Raddysh,D,TBL,28,70,5,18,23
5,8482259,Bobby McMann,C,TOR,28,72,12,10,22
5,8479368,Max Jones,L,BOS,26,60,12,10,22
5,8481554,Kaapo Kakko,R,NYR,23,68,9,13,22
5,8475231,Casey Cizikas,C,NYI,33,76,8,14,22
5,8484149,Gavin Brindley,C,CBJ,20,54,8,14,22
5,8479996,Cody Glass,C,NSH,25,60,7,15,22
5,8479591,Michael Eyssimont,C,TBL,28,81,5,17,22
5,8478133,Jake Evans,C,MTL,28,67,5,17,22
5,8473563,Nicklas Backstrom,C,WSH,37,54,5,17,22
5,8475324,Nick Jensen,D,OTT,34,71,1,21,22
5,8478508,Yakov Trenin,C,MIN,27,60,15,6,21
5,8476374,Sean Kuraly,C,CBJ,31,59,11,10,21
5,8476878,Zemgus Girgensons,L,TBL,30,80,11,10,21
5,8480813,Joe Veleno,C,DET,24,79,10,11,21
5,8480848,Ty Dellandrea,C,SJS,24,44,10,11,21
5,8481481,Blake Lizotte,C,PIT,27,61,9,12,21
5,8475220,Marcus Foligno,L,MIN,33,51,9,12,21
5,8476988,Matt Benning,D,SJS,30,51,5,16,21
5,8478840,Will Borgen,D,SEA,28,62,5,16,21
5,8479402,Jake Bean,D,CGY,26,71,4,17,21
5,8476331,Dylan DeMelo,D,WPG,31,71,4,17,21
5,8477919,Frederick Gaudreau,C,MIN,31,61,12,8,20
5,8476889,Radek Faksa,C,STL,30,57,10,10,20
5,8482475,Yegor Chinakhov,R,CBJ,23,57,8,12,20
5,8479316,Luke Kunin,C,SJS,27,62,8,12,20
5,8483468,Jiri Kulich,C,BUF,20,58,8,12,20
5,8483457,Lane Hutson,D,MTL,20,61,7,13,20
5,8477015,Connor Brown,R,EDM,30,64,7,13,20
5,8481521,Ronnie Attard,D,PHI,25,61,7,13,20
5,8477406,Mattias Janmark,C,EDM,32,59,6,14,20
5,8480762,Eric Robinson,L,CAR,29,56,5,15,20
5,8476892,Colton Parayko,D,STL,31,64,4,16,20
5,8475188,Brayden McNabb,D,VGK,33,62,3,17,20
5,8474612,Travis Hamonic,D,OTT,34,53,3,17,20
5,8481059,Scott Perunovich,D,STL,26,67,2,18,20
5,8481535,Nils Hoglander,L,VAN,24,59,13,6,19
5,8481716,Dmitri Voronkov,L,CBJ,24,44,10,9,19
5,8482807,Ethan Del Mastro,D,CHI,21,57,9,10,19
5,8480003,Jesper Boqvist,C,FLA,26,64,8,11,19
5,8482803,Olen Zellweger,D,ANA,21,69,7,12,19
5,8476960,Andreas Athanasiou,C,CHI,30,54,7,12,19
5,8481441,Joe Snively,C,DET,28,69,6,13,19
5,8477435,Ryan Graves,D,PIT,29,79,4,15,19
5,8479414,Nathan Bastian,R,NJD,27,52,10,8,18
5,8481704,Juuso Parssinen,C,NSH,23,54,9,9,18
5,8482679,Matt Coronato,R,CGY,22,63,8,10,18
5,8476624,Barclay Goodrow,C,SJS,31,53,8,10,18
5,8473453,Trevor Lewis,C,LAK,37,70,8,10,18
5,8479543,Michael Pezzetta,L,MTL,26,56,8,10,18
5,8478569,Noel Acciari,C,PIT,33,50,8,10,18
5,8478109,Victor Olofsson,L,VGK,29,68,7,11,18
5,8478013,Jake Walman,D,SJS,28,71,7,11,18
5,8479293,Brandon Tanev,L,SEA,33,68,7,11,18
5,8480192,Johnathan Kovacevic,D,NJD,27,61,7,11,18
5,8479370,Tyson Jost,C,CAR,26,60,6,12,18
5,8478970,Jalen Chatfield,D,CAR,28,70,5,13,18
5,8477220,Nate Schmidt,D,FLA,33,63,5,13,18
5,8481093,Rafael Harvey-Pinard,L,MTL,25,57,5,13,18
5,8481568,Alex Vlasic,D,CHI,23,52,4,14,18
5,8476457,Adam Larsson,D,SEA,32,73,4,14,18
5,8480950,Ilya Lyubushkin,D,DAL,30,76,4,14,18
5,8479398,Samuel Girard,D,COL,26,64,2,16,18
5,8482087,Kaiden Guhle,D,MTL,22,63,2,16,18
5,8479998,Mikey Anderson,D,LAK,25,61,0,18,18
5,8479619,Michael Carcone,L,UTA,28,56,14,3,17
5,8480021,Jack Studnicka,C,LAK,25,53,10,7,17
5,8477979,Nicolas Aube-Kubel,R,BUF,28,55,8,9,17
5,8482067,Connor Mackey,D,NYR,28,54,8,9,17
5,8481517,Brett Leason,R,ANA,25,61,8,9,17
5,8477392,Hudson Fasching,R,NYI,29,58,7,10,17
5,8481013,Jonatan Berggren,R,DET,24,53,7,10,17
5,8482062,Cole Smith,L,NSH,29,56,6,11,17
5,8480025,MacKenzie Entwistle,R,FLA,25,68,6,11,17
5,8480727,Zach Whitecloud,D,VGK,28,60,5,12,17
5,8482148,Hendrix Lapierre,C,WSH,22,51,4,13,17
5,8481567,Henry Thrun,D,SJS,23,56,4,13,17
5,8480990,Declan Chisholm,D,MIN,24,56,4,13,17
5,8476931,Jake McCabe,D,TOR,31,68,3,14,17
5,8482737,Zack Bolduc,C,STL,21,54,3,14,17
5,8481178,Egor Zamula,D,PHI,24,58,3,14,17
5,8480891,Michael Kesselring,D,UTA,24,52,3,14,17
5,8476891,Matt Grzelcyk,D,PIT,30,74,1,16,17
5,8476967,Brett Kulak,D,EDM,30,64,1,16,17
5,8475690,Chris Tanev,D,TOR,35,57,0,17,17
5,8479336,Carl Grundstrom,R,SJS,27,54,12,4,16
5,8480281,Alexey Toropchenko,R,STL,25,62,11,5,16
5,8477353,Tyler Motte,C,DET,29,75,10,6,16
5,8478434,Keegan Kolesar,R,VGK,27,64,9,7,16
5,8479066,Ryan Lomberg,L,CGY,30,58,9,7,16
5,8479639,Dylan Coghlan,D,WPG,26,55,7,9,16
5,8480980,Connor Dewar,C,TOR,25,72,7,9,16
5,8483495,Simon Nemec,D,NJD,20,63,7,9,16
5,8480448,Parker Kelly,L,COL,25,78,7,9,16
5,8478043,Sam Lafferty,C,BUF,29,60,6,10,16
5,8482142,Jamie Drysdale,D,PHI,22,68,5,11,16
5,8475225,Craig Smith,C,CHI,35,55,5,11,16
5,8476329,Travis Boyd,C,MIN,31,57,5,11,16
5,8482176,Wyatt Kaiser,D,CHI,22,58,5,11,16
5,8481524,Bowen Byram,D,BUF,23,46,5,11,16
5,8476461,Sean Couturier,C,PHI,32,66,4,12,16
5,8482634,Alex Steeves,C,TOR,25,55,4,12,16
5,8479369,Andrew Peeke,D,BOS,26,60,4,12,16
5,8479324,Ryan Lindgren,D,NYR,26,71,3,13,16
5,8474090,Brendan Smith,D,DAL,35,70,3,13,16
5,8475462,Radko Gudas,D,ANA,34,60,3,13,16
5,8480807,Mattias Samuelsson,D,BUF,24,57,3,13,16
5,8480035,Henri Jokiharju,D,BUF,25,69,1,15,16
5,8480049,Dylan Samberg,D,WPG,25,66,0,16,16
5,8478443,Brandon Carlo,D,BOS,28,65,0,16,16
5,8477839,Conor Sheary,L,TBL,32,80,11,4,15
5,8475842,Sam Carrick,C,NYR,32,54,9,6,15
5,8477505,Alexander Wennberg,C,SJS,30,45,9,6,15
5,8477478,William Carrier,L,CAR,30,53,8,7,15
5,8482155,Alex Laferriere,R,LAK,23,63,8,7,15
5,8476873,Mark Jankowski,C,NSH,30,51,7,8,15
5,8477507,Nikita Zadorov,D,BOS,29,65,6,9,15
5,8479520,Brandon Duhaime,R,WSH,27,50,6,9,15
5,8471709,Marc-Edouard Vlasic,D,SJS,37,57,6,9,15
5,8479372,Josh Mahura,D,SEA,26,47,5,10,15
5,8475279,Ben Chiarot,D,DET,33,63,5,10,15
5,8478421,A.J. Greer,L,FLA,28,61,4,11,15
5,8477018,Ben Hutton,D,VGK,31,52,4,11,15
5,8482073,Braden Schneider,D,NYR,23,61,3,12,15
5,8478859,Niko Mikkola,D,FLA,28,55,3,12,15
5,8475455,Brenden Dillon,D,NJD,34,60,2,13,15
5,8480172,Jan Rutta,D,SJS,34,61,2,13,15
5,8480796,Martin Fehervary,D,WSH,25,54,1,14,15
5,8480001,Urho Vaakanainen,D,ANA,25,54,1,14,15
5,8474034,Pat Maroon,L,CHI,36,49,12,2,14
5,8477380,Jonny Brodzinski,C,NYR,31,44,8,6,14
5,8478831,Kevin Stenlund,C,UTA,28,58,8,6,14
5,8479291,Kevin Rooney,C,CGY,31,41,7,7,14
5,8477573,Nathan Walker,L,STL,30,48,6,8,14
5,8481522,Peyton Krebs,C,BUF,23,54,5,9,14
5,8479442,Troy Stecher,D,EDM,30,56,5,9,14
5,8482166,Shakir Mukhamadullin,D,SJS,22,60,5,9,14
5,8483493,Frank Nazar,C,CHI,20,48,4,10,14
5,8474013,Ian Cole,D,UTA,35,52,3,11,14
5,8475718,Justin Holl,D,DET,32,58,3,11,14
5,8481019,David Gustafsson,C,WPG,24,41,3,11,14
5,8480246,Nick Perbix,D,TBL,26,72,2,12,14
5,8481751,Lukas Rousek,R,BUF,25,44,2,12,14
5,8480070,Ian Mitchell,D,BOS,25,47,2,12,14
5,8477365,Connor Clifton,D,BUF,29,58,1,13,14
5,8480887,Jordan Harris,D,MTL,24,48,1,13,14
5,8474673,TJ Brodie,D,CHI,34,64,0,14,14
5,8478399,Jonas Siegenthaler,D,NJD,27,50,0,14,14
5,8476822,Luke Glendening,C,TBL,35,75,9,4,13
5,8479718,Alex Barré-Boulet,C,MTL,27,54,8,5,13
5,8475235,Nicolas Deslauriers,L,PHI,33,61,8,5,13
5,8480252,Cole Guttman,C,CHI,25,42,7,6,13
5,8479344,Jesse Puljujarvi,R,PIT,26,49,7,6,13
5,8479439,Jacob MacDonald,D,COL,31,46,7,6,13
5,8482157,Will Cuylle,L,NYR,22,61,6,7,13
5,8480806,Isac Lundestrom,C,ANA,25,56,6,7,13
5,8479328,Julien Gauthier,R,NYI,27,56,6,7,13
5,8483466,Kevin Korchinski,D,CHI,20,46,5,8,13
5,8476429,Scott Mayfield,D,NYI,32,72,4,9,13
5,8483482,Tristan Luneau,D,ANA,20,67,4,9,13
5,8478585,Derek Ryan,C,EDM,38,59,3,10,13
5,8478468,Jeremy Lauzon,D,NSH,27,48,3,10,13
5,8471677,Jack Johnson,D,CBJ,37,65,3,10,13
5,8475762,Derek Forbort,D,VAN,32,51,3,10,13
5,8475790,Erik Gudbranson,D,CBJ,32,78,2,11,13
5,8475750,Jon Merrill,D,MIN,32,60,2,11,13
5,8480058,Pierre-Olivier Joseph,D,STL,25,56,1,12,13
5,8475233,David Savard,D,MTL,34,72,0,13,13
5,8477446,Michael McCarron,R,NSH,29,54,7,5,12
5,8482077,Dylan Holloway,L,EDM,23,51,7,5,12
5,8479968,Vinni Lettieri,C,BOS,29,41,7,5,12
5,8481518,Nolan Foote,L,NJD,24,40,7,5,12
5,8481028,Martin Pospisil,C,CGY,25,52,6,6,12
5,8481641,Joel Kiviranta,L,COL,28,70,6,6,12
5,8481532,Alex Turcotte,C,LAK,23,47,6,6,12
5,8479026,Philippe Myers,D,TOR,27,46,6,6,12
5,8482451,Mikael Pyyhtia,L,CBJ,23,38,6,6,12
5,8477931,Tomas Nosek,L,FLA,32,64,5,7,12
5,8480007,Jonas Rondbjerg,R,VGK,25,42,5,7,12
5,8481617,Vasily Podkolzin,R,VAN,23,50,4,8,12
5,8474567,Zach Bogosian,D,MIN,34,59,4,8,12
5,8482744,James Malatesta,L,CBJ,21,39,2,10,12
5,8476874,Olli Maatta,D,DET,30,63,2,10,12
5,8476372,Nick Seeler,D,PHI,31,45,2,10,12
5,8478452,Caleb Jones,D,LAK,27,55,2,10,12
5,8479986,Kole Lind,R,DAL,26,48,2,10,12
5,8478450,Parker Wotherspoon,D,BOS,27,38,2,10,12
5,8470600,Ryan Suter,D,STL,39,65,1,11,12
5,8480879,Jacob Bernard-Docker,D,OTT,24,44,1,11,12
5,8480860,Kevin Bahl,D,CGY,24,54,0,12,12
5,8480196,Jacob Bryson,D,BUF,27,53,0,12,12
5,8480880,Jakub Lauko,C,MIN,24,39,8,3,11
5,8477903,Garnet Hathaway,R,PHI,33,61,7,4,11
5,8476934,Brock McGinn,L,ANA,30,56,7,4,11
5,8482070,Mitchell Chaffee,R,TBL,26,56,7,4,11
5,8476858,Phillip Di Giuseppe,L,VAN,31,31,7,4,11
5,8482747,Brennan Othmann,L,NYR,21,48,7,4,11
5,8476442,Matt Nieto,L,PIT,32,50,6,5,11
5,8477335,Kyle Burroughs,D,LAK,29,42,6,5,11
5,8481161,Jake Christiansen,D,CBJ,25,53,6,5,11
5,8480011,Klim Kostin,C,SJS,25,41,5,6,11
5,8482659,Josh Doan,R,UTA,22,54,5,6,11
5,8478451,Ethan Bear,D,WSH,27,46,5,6,11
5,8480292,Carson Meyer,R,ANA,27,32,5,6,11
5,8484911,Collin Graf,R,SJS,22,45,5,6,11
5,8479980,Nicolas Hague,D,VGK,26,42,4,7,11
5,8480355,Mark Kastelic,C,BOS,25,56,4,7,11
5,8483763,Maksymilian Szuber,D,UTA,22,38,4,7,11
5,8480845,Rasmus Kupari,C,WPG,24,46,4,7,11
5,8481598,Philip Broberg,D,EDM,23,36,4,7,11
5,8476994,Vinnie Hinostroza,C,NSH,30,51,3,8,11
5,8482859,Zack Ostapchuk,C,OTT,21,59,3,8,11
5,8477384,Josh Brown,D,EDM,30,49,3,8,11
5,8475958,Michael Sgarbossa,C,WSH,32,30,3,8,11
5,8482192,Isaak Phillips,D,CHI,23,49,2,9,11
5,8475179,Dmitry Kulikov,D,FLA,34,58,2,9,11
5,8477369,Carson Soucy,D,VAN,30,71,2,9,11
5,8481122,Simon Benoit,D,TOR,26,36,2,9,11
5,8481537,Nikita Okhotiuk,D,CGY,24,55,2,9,11
5,8477034,Jaycob Megna,D,FLA,32,45,2,9,11
5,8479638,Justin Brazeau,R,BOS,26,40,7,3,10
5,8479944,Zach Aston-Reese,C,VGK,30,49,6,4,10
5,8478211,Dryden Hunt,L,CGY,29,58,4,6,10
5,8481592,Jakob Pelletier,L,CGY,23,45,4,6,10
5,8479536,Axel Jonsson-Fjallby,L,WPG,26,46,4,6,10
5,8481237,Kyle MacLean,C,NYI,25,38,4,6,10
5,8481754,Nikita Nesterenko,C,ANA,23,44,3,7,10
5,8477938,Haydn Fleury,D,WPG,28,50,3,7,10
5,8477887,Patrick Brown,C,BOS,32,48,3,7,10
5,8474568,Luke Schenn,D,NSH,35,49,2,8,10
5,8475208,Brian Dumoulin,D,ANA,33,57,2,8,10
5,8482652,Walker Duehr,R,CGY,27,40,2,8,10
5,8476867,Brendan Gaunce,C,MIN,30,42,2,8,10
5,8482733,Logan Mailloux,D,MTL,31,39,2,8,10
5,8478874,Adam Gaudette,C,OTT,28,43,1,9,10
5,8481701,Santeri Hatakka,D,NJD,23,45,1,9,10
5,8479249,Andrew Poturalski,C,SJS,30,37,1,9,10
5,8483460,David Jiricek,D,CBJ,21,53,0,10,10
5,8477845,Trevor van Riemsdyk,D,WSH,33,64,0,10,10
5,8480441,Trey Fix-Wolansky,R,CBJ,25,40,7,2,9
5,8479671,Mathieu Olivier,R,CBJ,27,45,5,4,9
5,8471817,Ryan Reaves,R,TOR,37,67,5,4,9
5,8482762,Simon Edvinsson,D,DET,21,51,4,5,9
5,8481550,Adam Beckman,L,NJD,23,41,4,5,9
5,8479371,Dante Fabbro,D,NSH,26,65,3,6,9
5,8482666,Scott Morrow,D,CAR,22,52,3,6,9
5,8478424,Jansen Harkins,C,ANA,27,41,3,6,9
5,8482177,Marat Khusnutdinov,C,MIN,22,37,3,6,9
5,8481599,Victor Soderstrom,D,UTA,23,42,2,7,9
5,8482964,Arber Xhekaj,D,MTL,23,47,2,7,9
5,8483619,Filip Roos,D,OTT,25,31,1,8,9
5,8474166,Alec Martinez,D,CHI,37,52,0,9,9
5,8477851,Jordan Oesterle,D,BOS,32,38,0,9,9
5,8482172,Landon Slaggert,L,CHI,22,33,4,4,8
5,8480245,Olle Lycksell,R,PHI,25,33,4,4,8
5,8480289,Morgan Barron,C,WPG,26,51,3,5,8
5,8481609,Vladislav Kolyachonok,D,UTA,23,40,3,5,8
5,8476441,Joel Edmundson,D,LAK,31,35,2,6,8
5,8482511,Mason Lohrei,D,BOS,23,33,2,6,8
5,8482784,Zach Dean,C,STL,21,33,2,6,8
5,8479972,Mason Shaw,C,WPG,26,33,2,6,8
5,8480834,Ty Emberson,D,SJS,24,41,1,7,8
5,8482095,Tyler Kleven,D,OTT,22,49,1,7,8
5,8478409,Anthony Richard,C,PHI,28,26,6,1,7
5,8481708,Zac Jones,D,NYR,24,48,4,3,7
5,8482713,Mackie Samoskevich,R,FLA,22,40,4,3,7
5,8484258,Sam Malinski,D,COL,26,19,4,3,7
5,8476913,Devin Shore,C,MIN,30,38,3,4,7
5,8482730,Brandt Clarke,D,LAK,21,50,3,4,7
5,8481147,Reese Johnson,C,MIN,26,26,3,4,7
5,8479379,Givani Smith,R,SJS,26,24,3,4,7
5,8481167,Brayden Pachal,D,CGY,25,41,2,5,7
5,8484254,Akito Hirose,D,VAN,25,33,2,5,7
5,8480870,Bo Groulx,C,NYR,24,29,2,5,7
5,8482861,Vincent Iorio,D,WSH,22,26,2,5,7
5,8482141,Lukas Cormier,D,VGK,22,28,1,6,7
5,8481605,Jackson LaCombe,D,ANA,23,35,1,6,7
5,8479985,Cale Fleury,D,SEA,26,26,1,6,7
5,8479348,Kale Clague,D,BUF,26,40,0,7,7
5,8476473,Connor Murphy,D,CHI,31,37,0,7,7
5,8478017,Mark Friedman,D,VAN,29,31,3,3,6
5,8481679,Maxence Guenette,D,OTT,23,26,3,3,6
5,8477962,Brendan Lemieux,L,CAR,28,33,2,4,6
5,8481600,Tobias Bjornfot,D,FLA,23,38,2,4,6
5,8479378,Logan Stanley,D,WPG,26,37,2,4,6
5,8479419,Brett Murray,L,BUF,26,22,2,4,6
5,8482144,Jack Thompson,D,SJS,22,27,1,5,6
5,8477810,Joel Hanley,D,CGY,33,28,1,5,6
5,8478021,William Lagesson,D,DET,28,27,1,5,6
5,8478477,Mitchell Stephens,C,SEA,27,16,1,5,6
5,8478454,Noah Juulsen,D,VAN,27,25,0,6,6
5,8482496,Nils Aman,C,VAN,24,30,4,1,5
5,8482460,Matt Rempe,C,NYR,22,17,4,1,5
5,8483570,Ben Meyers,C,SEA,26,40,3,2,5
5,8483512,Matt Savoie,C,EDM,20,27,3,2,5
5,8477070,Liam O'Brien,C,UTA,30,44,2,3,5
5,8482102,Vasily Ponomarev,C,PIT,22,19,2,3,5
5,8481462,Mason Morelli,L,VGK,28,15,2,3,5
5,8481056,Spencer Stastney,D,NSH,24,37,1,4,5
5,8473446,Erik Johnson,D,PHI,36,47,1,4,5
5,8481585,Egor Afanasyev,L,SJS,23,14,1,4,5
5,8483489,Fraser Minten,C,TOR,31,21,1,4,5
5,8481422,Jacob Lucchini,C,NSH,29,20,1,4,5
5,8482765,Isak Rosen,R,BUF,21,26,0,5,5
5,8477971,Andreas Englund,D,LAK,28,31,0,5,5
5,8483549,Lucas Condotta,L,MTL,27,24,4,0,4
5,8477473,Justin Bailey,R,SJS,29,31,4,0,4
5,8483395,Arshdeep Bains,L,VAN,23,12,4,0,4
5,8481789,Tye Kartye,L,SEA,23,40,3,1,4
5,8479994,Jaret Anderson-Dolan,C,WPG,25,29,3,1,4
5,8483397,Marc McLaughlin,C,BOS,25,42,3,1,4
5,8484287,Cole McWard,D,VAN,23,29,3,1,4
5,8477401,John Hayden,C,SEA,29,27,2,2,4
5,8481556,John Beecher,C,BOS,23,34,2,2,4
5,8480851,Akil Thomas,C,LAK,24,25,2,2,4
5,8479362,Riley Tufte,L,BOS,26,22,2,2,4
5,8483630,Pavol Regenda,L,ANA,25,31,2,2,4
5,8477467,Gustav Olofsson,D,SEA,30,21,2,2,4
5,8475795,Dylan McIlrath,D,WSH,32,16,2,2,4
5,8482858,Ryker Evans,D,SEA,23,32,1,3,4
5,8476952,Dominic Toninato,C,WPG,30,33,1,3,4
5,8482145,Mavrik Bourque,C,DAL,22,54,1,3,4
5,8481065,Angus Crookshank,L,OTT,25,19,1,3,4
5,8475755,Alexander Petrovic,D,DAL,32,25,1,3,4
5,8482787,Nikita Chibrikov,R,WPG,31,7,1,3,4
5,8481743,Marc Del Gaizo,D,NSH,25,18,1,3,4
5,8475177,Calvin de Haan,D,COL,33,41,0,4,4
5,8477527,Ross Johnston,L,ANA,30,24,0,4,4
5,8477462,Robert Hagg,D,VGK,29,23,0,4,4
5,8482094,Daemon Hunt,D,MIN,22,11,0,4,4
5,8479991,Jake Leschyshyn,C,NYR,25,31,2,1,3
5,8480468,James Hamblin,L,EDM,25,24,2,1,3
5,8479981,Jonah Gadjovich,L,FLA,26,33,2,1,3
5,8477073,Kurtis MacDermid,L,NJD,30,28,2,1,3
5,8484325,Waltteri Merela,C,TBL,26,19,2,1,3
5,8478502,Dennis Gilbert,D,BUF,28,18,2,1,3
5,8478146,Matthew Highmore,C,OTT,28,25,1,2,3
5,8482751,Ryan Winterton,C,SEA,21,37,1,2,3
5,8480844,Grigori Denisenko,L,VGK,24,29,1,2,3
5,8482153,Brendan Brisson,C,VGK,23,32,1,2,3
5,8481006,Tyler Tucker,D,STL,24,15,1,2,3
5,8477244,Chad Ruhwedel,D,NYR,34,34,1,2,3
5,8482516,Matthew Kessel,D,STL,24,19,1,2,3
5,8479320,Max Lajoie,D,SEA,27,20,1,2,3
5,8480890,Jan Jenik,R,OTT,24,24,1,2,3
5,8482250,Callahan Burke,C,VGK,27,28,1,2,3
5,8483546,Marshall Rifai,D,TOR,26,3,1,2,3
5,8478051,Max Willman,C,NJD,29,18,1,2,3
5,8480032,Shane Bowers,C,NJD,25,12,1,2,3
5,8477320,Anton Blidh,L,NYR,29,16,0,3,3
5,8479576,Vincent Desharnais,D,VAN,28,37,0,3,3
5,8481541,Samuel Bolduc,D,NYI,24,27,0,3,3
5,8480823,Alexander Alexeyev,D,WSH,25,15,0,3,3
5,8481543,Nikita Alexandrov,C,STL,24,17,2,0,2
5,8479367,William Lockwood,R,FLA,26,25,2,0,2
5,8482061,Brandon Biro,L,SEA,26,10,2,0,2
5,8478446,Glenn Gawdin,C,LAK,27,15,2,0,2
5,8480157,Calle Rosen,D,COL,30,46,1,1,2
5,8483567,Georgii Merkulov,C,BOS,24,7,1,1,2
5,8481564,Ryan Johnson,D,BUF,23,15,1,1,2
5,8474062,Riley Nash,C,NYR,35,18,1,1,2
5,8475413,Justin Dowling,C,NJD,34,19,1,1,2
5,8479772,Zack MacEwen,R,OTT,28,45,0,2,2
5,8483012,Logan Morrison,C,SEA,22,32,0,2,2
5,8481593,Jayden Struble,D,MTL,23,13,0,2,2
5,8480267,Sammy Walker,C,MIN,25,16,0,2,2
5,8482470,Ilya Solovyov,D,CGY,24,23,0,2,2
5,8480084,Nick DeSimone,D,NJD,30,18,0,2,2
5,8483920,Pierrick Dube,R,WSH,23,6,0,2,2
5,8483471,Brad Lambert,C,WPG,31,11,0,2,2
5,8482929,Emil Lilleberg,D,TBL,23,16,0,2,2
5,8481806,Louis Crevier,D,CHI,23,9,0,2,2
5,8482147,Jean-Luc Foudy,C,COL,22,21,1,0,1
5,8479522,Hardy Haman Aktell,D,WSH,26,4,1,0,1
5,8481699,Aku Raty,R,UTA,23,21,1,0,1
5,8482197,Adam Raska,R,MIN,23,5,1,0,1
5,8482162,Roby Jarventie,L,EDM,22,18,1,0,1
5,8484326,Patrik Koch,D,UTA,28,3,1,0,1
5,8478147,Bokondji Imama,L,PIT,28,6,1,0,1
5,8480874,Adam Ginning,D,PHI,24,11,1,0,1
5,8484255,Jason Polin,R,COL,25,8,1,0,1
5,8481655,Cole Schwindt,R,CGY,23,7,1,0,1
5,8477149,Scott Sabourin,R,SJS,32,17,0,1,1
5,8481719,Maxwell Crozier,D,TBL,24,27,0,1,1
5,8482088,Justin Sourdif,R,FLA,22,15,0,1,1
5,8482118,Sam Colangelo,R,ANA,23,14,0,1,1
5,8481024,Linus Karlsson,C,VAN,25,5,0,1,1
5,8482165,Yan Kuznetsov,D,CGY,22,20,0,1,1
5,8482201,Gage Goncalves,C,TBL,23,22,0,1,1
5,8481534,Raphael Lavoie,C,EDM,24,2,0,1,1
5,8480306,Grant Hutton,D,NYI,29,3,0,1,1
5,8478011,Louie Belpedio,D,PHI,28,9,0,1,1
5,8479421,Jacob Moverare,D,LAK,26,13,0,1,1
5,8477541,Dakota Mermis,D,TOR,30,8,0,1,1
5,8477993,Justin Kirkland,C,CGY,28,8,0,1,1
5,8483597,Milos Kelemen,L,UTA,25,8,0,1,1
5,8479587,Rhett Gardner,C,PHI,28,16,0,0,0
5,8481030,Jack St. Ivany,D,PIT,25,18,0,0,0
5,8481206,John Ludvig,D,PIT,24,9,0,0,0
5,8478881,Brett Seney,L,CHI,28,12,0,0,0
5,8479330,Brandon Gignac,C,MTL,27,11,0,0,0
5,8480075,Cameron Crotty,D,MIN,25,8,0,0,0
5,8484259,Ondrej Pavel,C,COL,31,4,0,0,0
5,8484304,Uvis Balinskis,D,FLA,28,15,0,0,0
5,8482126,Emil Andrae,D,PHI,31,4,0,0,0
5,8482476,Emil Heineman,L,MTL,23,3,0,0,0
5,8481043,Cole Koepke,L,BOS,26,12,0,0,0
5,8481578,Graeme Clarke,R,MIN,23,8,0,0,0
5,8475780,Chris Wagner,R,COL,33,3,0,0,0
5,8483407,Brandon Scanlin,D,NYR,25,4,0,0,0
5,8478854,Ryan Shea,D,PIT,27,4,0,0,0
5,8476323,Max McCormick,L,SEA,32,2,0,0,0
5,8483432,Luca Del Bel Belluz,C,CBJ,31,2,0,0,0
5,8483609,Adam Klapka,R,CGY,24,5,0,0,0
5,8481726,Adam Edstrom,C,NYR,24,6,0,0,0
5,8479321,Lucas Johansen,D,,27,0,0,0,0
5,8470794,Joe Pavelski,C,,40,0,0,0,0
5,8477950,Tony DeAngelo,D,,29,0,0,0,0
5,8471218,Blake Wheeler,R,,38,0,0,0,0
5,8475197,Tyson Barrie,D,,33,0,0,0,0
5,8475744,Evgeny Kuznetsov,C,,32,0,0,0,0
5,8474037,James van Riemsdyk,L,,35,0,0,0,0
5,8474602,Justin Schultz,D,,34,0,0,0,0
5,8482222,Alexander Barabanov,L,,30,0,0,0,0
5,8474157,Max Pacioretty,L,,36,0,0,0,0
5,8474031,Kevin Shattenkirk,D,,35,0,0,0,0
5,8480884,Calen Addison,D,,24,0,0,0,0
5,8480008,Adam Ruzicka,C,,25,0,0,0,0
5,8475906,John Klingberg,D,,32,0,0,0,0
5,8476884,Derrick Pouliot,D,,30,0,0,0,0
5,8476919,Chris Tierney,C,,30,0,0,0,0
5,8479415,Michael McLeod,C,,26,0,0,0,0
5,8474884,Mike Hoffman,C,,35,0,0,0,0
5,8478104,Sammy Blais,L,,28,0,0,0,0
5,8474870,Tyler Johnson,C,,34,0,0,0,0
5,8481591,Sam Poulin,R,,23,0,0,0,0
5,8479977,Kailer Yamamoto,R,,26,0,0,0,0
5,8476393,Nick Cousins,C,,31,0,0,0,0
5,8479376,Victor Mete,D,,26,0,0,0,0
5,8476871,Tanner Pearson,L,,32,0,0,0,0
5,8471274,Alex Goligoski,D,,39,0,0,0,0
5,8481058,Jesse Ylönen,R,,25,0,0,0,0
5,8477464,Nic Petan,C,,29,0,0,0,0
5,8473449,Kyle Okposo,R,,36,0,0,0,0
5,8480216,Jacob Peterson,C,,25,0,0,0,0
5,8479346,Dillon Dube,C,,26,0,0,0,0
5,8470966,Mark Giordano,D,,41,0,0,0,0
5,8480821,Filip Zadina,R,,25,0,0,0,0
5,8476907,Mackenzie MacEachern,L,,30,0,0,0,0
5,8478430,Oliver Kylington,D,,27,0,0,0,0
5,8479514,Rem Pitlick,C,,27,0,0,0,0
5,8478099,Kevin Labanc,R,,29,0,0,0,0
5,8482241,Radim Zohorna,L,,28,0,0,0,0
5,8474040,Sam Gagner,C,,35,0,0,0,0
5,8475164,Jakob Silfverberg,R,,34,0,0,0,0
5,8475752,Tyler Pitlick,C,,33,0,0,0,0
5,8479984,Cal Foote,D,,26,0,0,0,0
5,8478495,Denis Gurianov,R,,27,0,0,0,0
5,8479533,Joona Koppanen,L,,26,0,0,0,0
5,8479458,Nikita Zaitsev,D,,33,0,0,0,0
5,8471699,Andrew Cogliano,C,,37,0,0,0,0
5,8470604,Jeff Carter,C,,39,0,0,0,0
5,8477330,Dominik Kubalik,L,,29,0,0,0,0
5,8477944,Jakub Vrana,L,,28,0,0,0,0
5,8478904,Steven Lorentz,C,,28,0,0,0,0
5,8471686,Marc Staal,D,,37,0,0,0,0
5,8478512,Austin Czarnik,C,,32,0,0,0,0
5,8470610,Zach Parise,L,,40,0,0,0,0
5,8473504,Cal Clutterbuck,R,,37,0,0,0,0
5,8474009,Nick Bonino,C,,36,0,0,0,0
5,8477454,Adam Erne,L,,29,0,0,0,0
5,8477126,Jayson Megna,C,,34,0,0,0,0
5,8473473,Milan Lucic,L,,36,0,0,0,0
5,8478067,Oskar Lindblom,L,,28,0,0,0,0
5,8475825,Jani Hakanpää,D,,32,0,0,0,0
5,8479383,Boris Katchouk,L,,26,0,0,0,0
5,8478400,Colin White,C,,27,0,0,0,0
5,8477846,Ryan Carpenter,C,,33,0,0,0,0
5,8477930,Pierre-Edouard Bellemare,L,,39,0,0,0,0
5,8479423,Alex Nylander,L,,26,0,0,0,0
5,8475797,Jarred Tinordi,D,,32,0,0,0,0
5,8481239,Samuel Fagemo,L,,24,0,0,0,0
5,8474618,Marco Scandella,D,,34,0,0,0,0
5,8480853,Liam Foudy,C,,24,0,0,0,0
5,8478028,Fredrik Olofsson,L,,28,0,0,0,0
5,8474145,Robert Bortuzzo,D,,35,0,0,0,0
5,8474709,Matt Martin,L,,35,0,0,0,0
5,8480226,Marián Studenic,R,,26,0,0,0,0
5,8480274,Philip Kemp,D,EDM,25,2,0,0,0
5,8480184,Gustav Lindstrom,D,,26,0,0,0,0
5,8481077,John Leonard,L,,26,0,0,0,0
5,8479547,Matthew Phillips,R,,26,0,0,0,0
5,8476915,Jujhar Khaira,L,,30,0,0,0,0
5,8481070,Hugh McGing,L,,26,0,0,0,0
5,8478408,Travis Dermott,D,,28,0,0,0,0
5,8481812,Nikolai Knyzhov,D,,27,0,0,0,0
5,8484321,Nikolas Matinpalo,D,OTT,26,2,0,0,0
5,8475278,Byron Froese,C,,33,0,0,0,0
5,8475766,Austin Watson,L,,32,0,0,0,0
5,8483398,Declan Carlile,D,TBL,31,5,0,0,0
5,8479546,Oskar Steen,C,,26,0,0,0,0
5,8480836,Jonathan Gruden,C,,24,0,0,0,0
5,8481690,Tyler Angle,C,,24,0,0,0,0
5,8480031,Maxime Comtois,L,,25,0,0,0,0
5,8483045,Cameron Butler,R,CBJ,31,1,0,0,0
5,8478078,Rourke Chartier,C,,28,0,0,0,0
5,8481016,Ruslan Iskhakov,C,,24,0,0,0,0
5,8484314,Jiri Smejkal,L,,28,0,0,0,0
5,8478956,Samuel Laberge,L,NJD,27,2,0,0,0
5,8483401,Marc Johnstone,R,PIT,28,1,0,0,0
5,8483531,Brian Halonen,L,NJD,25,3,0,0,0
5,8480776,Sheldon Rempal,R,,29,0,0,0,0
6,8476453,Nikita Kucherov,R,TBL,31,82,40,102,142
6,8478402,Connor McDavid,C,EDM,27,74,38,96,134
6,8479318,Auston Matthews,C,TOR,27,82,62,55,117
6,8478550,Artemi Panarin,L,NYR,33,79,37,74,111
6,8477939,William Nylander,R,TOR,28,81,47,62,109
6,8481559,Jack Hughes,C,NJD,23,76,44,64,108
6,8477492,Nathan MacKinnon,C,COL,29,81,35,71,106
6,8477956,David Pastrnak,R,BOS,28,79,50,54,104
6,8478420,Mikko Rantanen,R,COL,28,81,49,55,104
6,8480002,Nico Hischier,C,NJD,25,75,35,64,99
6,8478010,Brayden Point,C,TBL,28,82,54,42,96
6,8478403,Jack Eichel,C,VGK,28,77,46,50,96
6,8480012,Elias Pettersson,C,VAN,26,80,41,55,96
6,8477946,Dylan Larkin,C,DET,28,82,47,48,95
6,8477934,Leon Draisaitl,C,EDM,29,78,41,53,94
6,8482116,Tim Stützle,C,OTT,22,80,37,57,94
6,8478864,Kirill Kaprizov,L,MIN,27,77,49,44,93
6,8475810,Bryan Rust,R,PIT,32,73,37,55,92
6,8480027,Jason Robertson,L,DAL,25,81,44,47,91
6,8476468,J.T. Miller,C,VAN,31,77,38,52,90
6,8479420,Tage Thompson,C,BUF,27,72,40,49,89
6,8474600,Roman Josi,D,NSH,34,71,22,67,89
6,8480023,Robert Thomas,C,STL,25,73,20,66,86
6,8480800,Quinn Hughes,D,VAN,25,74,13,72,85
6,8478414,Timo Meier,R,NJD,28,76,41,43,84
6,8475166,John Tavares,C,TOR,34,81,39,45,84
6,8477942,Kevin Fiala,L,LAK,28,82,30,54,84
6,8478445,Mathew Barzal,C,NYI,27,82,22,62,84
6,8474578,Erik Karlsson,D,PIT,34,79,17,67,84
6,8477501,Valeri Nichushkin,R,COL,29,78,44,38,82
6,8479314,Matthew Tkachuk,L,FLA,27,77,28,54,82
6,8477493,Aleksander Barkov,C,FLA,29,79,27,55,82
6,8477409,Carter Verhaeghe,C,FLA,29,79,38,43,81
6,8479407,Jesper Bratt,L,NJD,26,78,25,56,81
6,8475167,Victor Hedman,D,TBL,34,80,11,70,81
6,8477404,Jake Guentzel,C,TBL,30,82,36,44,80
6,8474564,Steven Stamkos,C,NSH,34,74,32,48,80
6,8478439,Travis Konecny,R,PHI,27,76,30,50,80
6,8476887,Filip Forsberg,L,NSH,30,71,34,45,79
6,8475913,Mark Stone,R,VGK,32,75,29,50,79
6,8477402,Pavel Buchnevich,L,STL,29,78,38,40,78
6,8478444,Brock Boeser,R,VAN,27,72,37,41,78
6,8476399,Blake Coleman,C,CGY,33,80,43,34,77
6,8477951,Nick Schmaltz,C,UTA,28,76,31,46,77
6,8480830,Andrei Svechnikov,R,CAR,24,77,36,40,76
6,8471215,Evgeni Malkin,C,PIT,38,74,26,50,76
6,8477955,Jared McCann,L,SEA,28,75,40,35,75
6,8480069,Cale Makar,D,COL,26,64,22,53,75
6,8484144,Connor Bedard,C,CHI,19,62,31,43,74
6,8476881,Tomas Hertl,C,VGK,31,78,25,49,74
6,8478460,Zach Werenski,D,CBJ,27,77,18,56,74
6,8479385,Jordan Kyrou,C,STL,26,76,34,39,73
6,8476905,Chandler Stephenson,C,SEA,30,75,31,42,73
6,8480208,Drake Batherson,R,OTT,26,74,30,43,73
6,8475168,Matt Duchene,C,DAL,33,81,24,49,73
6,8476448,William Karlsson,C,VGK,31,76,32,40,72
6,8476454,Ryan Nugent-Hopkins,C,EDM,31,76,25,47,72
6,8477949,Alex Tuch,R,BUF,28,72,25,47,72
6,8473512,Claude Giroux,R,OTT,36,78,22,50,72
6,8479323,Adam Fox,D,NYR,26,75,15,57,72
6,8480801,Brady Tkachuk,L,OTT,25,80,36,35,71
6,8481557,Matt Boldy,L,MIN,23,73,35,36,71
6,8479343,Clayton Keller,R,UTA,26,76,33,38,71
6,8480865,Noah Dobson,D,NYI,24,81,13,58,71
6,8478449,Roope Hintz,C,DAL,28,80,33,37,70
6,8475784,Jeff Skinner,C,EDM,32,78,30,40,70
6,8476456,Jonathan Huberdeau,C,CGY,31,74,23,47,70
6,8477500,Bo Horvat,C,NYI,29,82,37,32,69
6,8481068,Yegor Sharangovich,C,CGY,26,80,29,40,69
6,8471685,Anze Kopitar,C,LAK,37,82,22,47,69
6,8479325,Charlie McAvoy,D,BOS,27,75,18,51,69
6,8477447,Shea Theodore,D,VGK,29,66,11,58,69
6,8475158,Ryan O'Reilly,C,NSH,33,72,26,42,68
6,8480036,Miro Heiskanen,D,DAL,25,82,11,57,68
6,8478407,Vince Dunn,D,SEA,28,76,11,57,68
6,8474590,John Carlson,D,WSH,34,73,21,46,67
6,8482740,Wyatt Johnston,C,DAL,21,80,38,28,66
6,8477933,Sam Reinhart,C,FLA,29,78,32,34,66
6,8475754,Brock Nelson,C,NYI,33,78,31,35,66
6,8474141,Patrick Kane,R,DET,36,79,20,46,66
6,8475172,Nazem Kadri,C,CGY,34,80,28,37,65
6,8473419,Brad Marchand,L,BOS,36,77,24,41,65
6,8475794,Tyler Seguin,C,DAL,32,82,29,35,64
6,8477496,Elias Lindholm,C,BOS,30,79,22,42,64
6,8480803,Evan Bouchard,D,EDM,25,74,11,53,64
6,8482699,Dylan Guenther,R,UTA,21,78,22,41,63
6,8477986,Brandon Montour,D,SEA,30,76,17,46,63
6,8477960,Adrian Kempe,R,LAK,28,81,33,29,62
6,8478427,Sebastian Aho,C,CAR,27,68,29,33,62
6,8476459,Mika Zibanejad,C,NYR,31,76,26,36,62
6,8478047,Michael Bunting,L,PIT,29,72,25,37,62
6,8478873,Troy Terry,R,ANA,27,79,22,40,62
6,8480018,Nick Suzuki,C,MTL,25,77,22,40,62
6,8476346,Johnny Gaudreau,L,CBJ,31,77,13,49,62
6,8479675,Trevor Moore,L,LAK,29,82,33,28,61
6,8471214,Alex Ovechkin,L,WSH,39,72,31,30,61
6,8471675,Sidney Crosby,C,PIT,37,71,27,34,61
6,8477503,Max Domi,C,TOR,29,81,18,43,61
6,8479425,Filip Hronek,D,VAN,27,77,15,46,61
6,8477504,Josh Morrissey,D,WPG,29,68,13,48,61
6,8475786,Zach Hyman,L,EDM,32,77,31,29,60
6,8473994,Jamie Benn,L,DAL,35,81,26,34,60
6,8477935,Sam Bennett,C,FLA,28,79,24,36,60
6,8477494,Jonathan Drouin,L,COL,29,80,20,40,60
6,8482124,Quinton Byfield,R,LAK,22,80,20,40,60
6,8475765,Vladimir Tarasenko,R,DET,33,80,15,45,60
6,8478398,Kyle Connor,L,WPG,28,77,31,28,59
6,8477940,Nikolaj Ehlers,L,WPG,28,71,23,36,59
6,8482097,Jack Quinn,R,BUF,23,74,22,37,59
6,8475692,Mats Zuccarello,R,MIN,37,67,20,39,59
6,8474679,Gustav Nyquist,C,NSH,35,74,17,42,59
6,8476483,Rickard Rakell,R,PIT,31,73,35,23,58
6,8476479,Phillip Danault,C,LAK,31,80,26,32,58
6,8476389,Vincent Trocheck,C,NYR,31,77,23,35,58
6,8478975,Mason Marchment,L,DAL,29,82,20,38,58
6,8478469,Thomas Chabot,D,OTT,27,75,10,48,58
6,8475184,Chris Kreider,L,NYR,33,78,31,26,57
6,8477964,Ivan Barbashev,C,VGK,29,78,29,28,57
6,8475314,Anders Lee,L,NYI,34,80,29,28,57
6,8476539,Jonathan Marchessault,R,NSH,34,71,28,29,57
6,8484153,Leo Carlsson,C,ANA,20,75,26,31,57
6,8480797,Joel Farabee,L,PHI,24,74,26,31,57
6,8478493,Joel Eriksson Ek,C,MIN,27,71,22,35,57
6,8478396,Noah Hanifin,D,VGK,27,66,22,35,57
6,8475798,Mikael Granlund,C,SJS,32,68,16,41,57
6,8475151,Kyle Palmieri,C,NYI,33,79,30,26,56
6,8482078,Lucas Raymond,L,DET,22,79,25,31,56
6,8476460,Mark Scheifele,C,WPG,31,70,24,32,56
6,8477476,Artturi Lehkonen,L,COL,29,81,23,33,56
6,8482665,Matty Beniers,C,SEA,22,74,23,33,56
6,8478440,Dylan Strome,C,WSH,27,72,21,35,56
6,8480015,Owen Tippett,R,PHI,25,76,20,36,56
6,8479337,Alex DeBrincat,R,DET,27,82,33,22,55
6,8478401,Pavel Zacha,C,BOS,27,80,30,25,55
6,8477407,Anthony Duclair,L,NYI,29,77,24,31,55
6,8476462,Dougie Hamilton,D,NJD,31,69,14,41,55
6,8474565,Alex Pietrangelo,D,VGK,34,64,10,45,55
6,8483431,Logan Cooley,C,UTA,20,74,22,32,54
6,8475726,Tyler Toffoli,C,SJS,32,70,22,32,54
6,8482745,Mason McTavish,C,ANA,21,67,19,35,54
6,8474150,Mikael Backlund,C,CGY,35,78,18,36,54
6,8474563,Drew Doughty,D,LAK,35,72,10,44,54
6,8481540,Cole Caufield,R,MTL,23,75,31,22,53
6,8482667,William Eklund,L,SJS,22,67,23,30,53
6,8478856,Conor Garland,R,VAN,28,74,21,32,53
6,8480839,Rasmus Dahlin,D,BUF,24,71,19,34,53
6,8480064,Josh Norris,C,OTT,25,77,26,26,52
6,8481533,Trevor Zegras,C,ANA,23,68,16,36,52
6,8476958,Jaccob Slavin,D,CAR,30,71,5,47,52
6,8475169,Evander Kane,L,EDM,33,74,30,21,51
6,8483808,Andrei Kuzmenko,L,CGY,28,75,25,26,51
6,8482684,Luke Hughes,D,NJD,21,70,6,45,51
6,8476853,Morgan Rielly,D,TOR,30,70,4,47,51
6,8475170,Brayden Schenn,C,STL,33,70,21,29,50
6,8477497,Sean Monahan,C,CBJ,30,71,20,30,50
6,8477451,Ryan Hartman,R,MIN,30,70,18,32,50
6,8479542,Brandon Hagel,L,TBL,26,82,16,34,50
6,8477416,Oliver Bjorkstrand,R,SEA,29,75,15,35,50
6,8478038,Devon Toews,D,COL,30,72,12,38,50
6,8480039,Martin Necas,C,CAR,25,70,25,24,49
6,8481596,Shane Pinto,C,OTT,24,81,20,29,49
6,8475745,Charlie Coyle,C,BOS,32,75,19,30,49
6,8482149,Cole Perfetti,C,WPG,22,74,18,31,49
6,8484145,Zach Benson,L,BUF,19,69,20,28,48
6,8477456,J.T. Compher,L,DET,29,82,19,29,48
6,8481711,Matias Maccelli,L,UTA,24,68,18,30,48
6,8480014,Gabriel Vilardi,C,WPG,25,67,24,23,47
6,8477998,Warren Foegele,L,LAK,28,78,23,24,47
6,8478466,Daniel Sprong,R,VAN,27,69,23,24,47
6,8476292,Ondrej Palat,L,NJD,33,65,15,32,47
6,8476875,Mike Matheson,D,MTL,30,71,12,35,47
6,8476438,Brandon Saad,L,STL,32,68,23,23,46
6,8476826,Yanni Gourde,C,SEA,33,71,18,28,46
6,8483515,Juraj Slafkovsky,L,MTL,20,77,17,29,46
6,8481528,Dylan Cozens,C,BUF,23,73,12,34,46
6,8477346,MacKenzie Weegar,D,CGY,30,72,11,35,46
6,8479525,Ross Colton,C,COL,28,82,23,22,45
6,8478519,Anthony Cirelli,C,TBL,27,82,21,24,45
6,8480829,Jesperi Kotkaniemi,C,CAR,24,64,19,26,45
6,8474641,Adam Henrique,C,EDM,34,72,26,18,44
6,8475191,Reilly Smith,R,NYR,33,74,25,19,44
6,8473986,Alex Killorn,L,ANA,35,70,23,21,44
6,8474586,Jordan Eberle,R,SEA,34,71,16,28,44
6,8482109,Alexis Lafrenière,L,NYR,23,74,16,28,44
6,8476927,Teddy Blueger,C,VAN,30,68,14,30,44
6,8480798,Philipp Kurashev,C,CHI,25,71,13,31,44
6,8476906,Shayne Gostisbehere,D,CAR,31,78,13,31,44
6,8478055,Gustav Forsling,D,FLA,28,73,4,40,44
6,8474149,Evgenii Dadonov,R,DAL,35,82,24,19,43
6,8479400,Pierre-Luc Dubois,L,WSH,26,68,19,24,43
6,8482113,Anton Lundell,C,FLA,23,80,18,25,43
6,8476869,Brady Skjei,D,NSH,30,73,15,28,43
6,8470613,Brent Burns,D,CAR,39,69,13,30,43
6,8480145,Neal Pionk,D,WPG,29,75,12,31,43
6,8479410,Mikhail Sergachev,D,UTA,26,70,8,35,43
6,8480817,K'Andre Miller,D,NYR,24,70,6,37,43
6,8478474,Lawson Crouse,L,UTA,27,75,24,18,42
6,8475760,Nick Bjugstad,C,UTA,32,68,22,20,42
6,8475768,Jaden Schwartz,C,SEA,32,68,21,21,42
6,8481560,Arthur Kaliyev,R,LAK,23,79,19,23,42
6,8482093,Seth Jarvis,C,CAR,22,69,18,24,42
6,8480028,Morgan Frost,C,PHI,25,71,16,26,42
6,8478042,Viktor Arvidsson,R,EDM,31,74,19,22,41
6,8481624,Ilya Mikheyev,R,CHI,30,69,18,23,41
6,8474102,David Perron,L,OTT,36,80,17,24,41
6,8482159,Tyson Foerster,R,PHI,22,72,17,24,41
6,8482702,Logan Stankoven,C,DAL,21,79,17,24,41
6,8477511,Anthony Mantha,R,CGY,30,74,17,24,41
6,8480188,Fabian Zetterlund,L,SJS,25,66,14,27,41
6,8475793,Ryan Johansen,C,PHI,32,75,14,27,41
6,8477495,Seth Jones,D,CHI,30,65,9,32,41
6,8478397,Rasmus Andersson,D,CGY,28,72,7,34,41
6,8478366,Frank Vatrano,R,ANA,30,73,23,17,40
6,8476432,Boone Jenner,C,CBJ,31,68,22,18,40
6,8475799,Nino Niederreiter,R,WPG,32,70,22,18,40
6,8478057,Dakota Joshua,C,VAN,28,66,20,20,40
6,8480078,Filip Chytil,C,NYR,25,64,20,20,40
6,8481604,Pavel Dorofeyev,L,VGK,24,68,14,26,40
6,8479999,Casey Mittelstadt,C,COL,26,82,9,31,40
6,8476854,Hampus Lindholm,D,BOS,30,74,8,32,40
6,8475287,Erik Haula,L,NJD,33,74,21,18,39
6,8482089,Jake Neighbours,L,STL,22,67,19,20,39
6,8479339,Patrik Laine,L,CBJ,26,63,19,20,39
6,8478462,Nicolas Roy,C,VGK,27,76,18,21,39
6,8478046,Danton Heinen,L,VAN,29,71,17,22,39
6,8475714,Calle Jarnkrok,C,TOR,33,78,15,24,39
6,8476882,Teuvo Teravainen,L,CHI,30,65,15,24,39
6,8482133,Thomas Bordeleau,C,SJS,22,68,14,25,39
6,8476872,Scott Laughton,C,PHI,30,74,13,26,39
6,8480220,Noah Cates,L,PHI,25,75,12,27,39
6,8479345,Jakob Chychrun,D,WSH,26,66,9,30,39
6,8471724,Kris Letang,D,PIT,37,79,8,31,39
6,8481581,Thomas Harley,D,DAL,23,79,8,31,39
6,8482671,Owen Power,D,BUF,22,65,7,32,39
6,8482122,Brock Faber,D,MIN,22,77,5,34,39
6,8475764,Cam Fowler,D,ANA,33,77,1,38,39
6,8478463,Anthony Beauvillier,L,PIT,27,68,21,17,38
6,8482110,Dawson Mercer,C,NJD,23,67,20,18,38
6,8475722,Jason Zucker,L,BUF,32,70,19,19,38
6,8475763,Kevin Hayes,R,PIT,32,66,16,22,38
6,8478115,Pierre Engvall,L,NYI,28,81,15,23,38
6,8482720,Matthew Knies,L,TOR,22,81,14,24,38
6,8483505,Matthew Poitras,C,BOS,20,72,12,26,38
6,8476461,Sean Couturier,C,PHI,32,74,11,27,38
6,8478458,Jack Roslovic,C,CAR,27,63,10,28,38
6,8478472,Mathieu Joseph,R,STL,27,64,8,30,38
6,8484166,Adam Fantilli,C,CBJ,20,65,20,17,37
6,8476474,Stefan Noesen,R,NJD,31,66,20,17,37
6,8482475,Yegor Chinakhov,R,CBJ,23,64,18,19,37
6,8478498,Jake DeBrusk,L,VAN,28,71,16,21,37
6,8481618,Alex Newhook,C,MTL,23,74,15,22,37
6,8477021,Alex Kerfoot,C,UTA,30,75,12,25,37
6,8482105,Jake Sanderson,D,OTT,22,74,11,26,37
6,8475200,Dmitry Orlov,D,CAR,33,78,10,27,37
6,8477506,Ryan Pulock,D,NYI,30,79,5,32,37
6,8481577,Philip Tomasino,C,NSH,23,66,15,21,36
6,8479351,Sam Steel,C,DAL,26,80,15,21,36
6,8473422,Nick Foligno,L,CHI,37,64,14,22,36
6,8481546,Cam York,D,PHI,23,72,12,24,36
6,8478438,Tommy Novak,C,NSH,27,72,11,25,36
6,8475753,Justin Faulk,D,STL,32,66,10,26,36
6,8482175,JJ Peterka,R,BUF,22,70,19,16,35
6,8471698,T.J. Oshie,R,WSH,38,71,18,17,35
6,8475848,Brendan Gallagher,R,MTL,32,70,17,18,35
6,8476392,Adam Lowry,C,WPG,31,58,15,20,35
6,8478109,Victor Olofsson,L,VGK,29,74,15,20,35
6,8477429,Andrew Copp,C,DET,30,75,14,21,35
6,8476792,Torey Krug,D,STL,33,68,6,29,35
6,8481703,Valtteri Puustinen,R,PIT,25,63,6,29,35
6,8475218,Mattias Ekholm,D,EDM,34,71,5,30,35
6,8480873,Rasmus Sandin,D,WSH,24,71,2,33,35
6,8482125,Alexander Holtz,R,VGK,22,68,23,11,34
6,8480893,Kirill Marchenko,R,CBJ,24,60,18,16,34
6,8476925,Colton Sissons,C,NSH,31,70,15,19,34
6,8480144,David Kampf,C,TOR,29,79,15,19,34
6,8478542,Evan Rodrigues,C,FLA,31,78,12,22,34
6,8475791,Taylor Hall,L,CHI,33,55,12,22,34
6,8482809,Jackson Blake,R,CAR,21,60,12,22,34
6,8476458,Ryan Strome,C,ANA,31,72,10,24,34
6,8477444,Andre Burakovsky,L,SEA,29,69,10,24,34
6,8475171,Oliver Ekman-Larsson,D,TOR,33,62,9,25,34
6,8480434,Sean Durzi,D,UTA,26,69,7,27,34
6,8476923,Damon Severson,D,CBJ,30,78,5,29,34
6,8477426,Nicholas Paul,L,TBL,29,81,20,13,33
6,8481032,Paul Cotter,C,NJD,25,59,18,15,33
6,8479996,Cody Glass,C,NSH,25,60,18,15,33
6,8479365,Trent Frederic,C,BOS,26,69,16,17,33
6,8476880,Tom Wilson,R,WSH,30,70,12,21,33
6,8478013,Jake Walman,D,SJS,28,73,12,21,33
6,8474716,Jared Spurgeon,D,MIN,35,74,11,22,33
6,8480459,Pius Suter,C,VAN,28,69,10,23,33
6,8477498,Darnell Nurse,D,EDM,29,74,9,24,33
6,8484203,Bradly Nadeau,L,CAR,19,67,9,24,33
6,8481542,Moritz Seider,D,DET,23,78,8,25,33
6,8483490,Pavel Mintyukov,D,ANA,21,75,8,25,33
6,8482624,Daniil Miromanov,D,CGY,27,65,6,27,33
6,8476917,Adam Pelech,D,NYI,30,75,4,29,33
6,8477479,Tyler Bertuzzi,L,CHI,29,58,17,15,32
6,8480980,Connor Dewar,C,TOR,25,69,13,19,32
6,8478233,Andrew Mangiapane,L,WSH,28,69,12,20,32
6,8476419,Jean-Gabriel Pageau,C,NYI,32,73,9,23,32
6,8476885,Jacob Trouba,D,NYR,30,69,9,23,32
6,8476892,Colton Parayko,D,STL,31,72,6,26,32
6,8478416,Erik Cernak,D,TBL,27,75,4,28,32
6,8476878,Zemgus Girgensons,L,TBL,30,82,21,10,31
6,8479992,Michael Rasmussen,C,DET,25,77,18,13,31
6,8481582,Nicholas Robertson,L,TOR,23,75,15,16,31
6,8479414,Nathan Bastian,R,NJD,27,60,13,18,31
6,8480009,Eeli Tolvanen,R,SEA,25,74,10,21,31
6,8475149,Marcus Johansson,L,MIN,34,64,10,21,31
6,8481704,Juuso Parssinen,C,NSH,23,61,10,21,31
6,8482259,Bobby McMann,C,TOR,28,68,19,11,30
6,8477839,Conor Sheary,L,TBL,32,81,17,13,30
6,8480185,Eetu Luostarinen,C,FLA,26,72,16,14,30
6,8481535,Nils Hoglander,L,VAN,24,65,15,15,30
6,8474715,Cam Atkinson,R,TBL,35,79,14,16,30
6,8483491,Ivan Miroshnichenko,L,WSH,20,59,14,16,30
6,8477932,Aaron Ekblad,D,FLA,28,67,10,20,30
6,8480748,Kiefer Sherwood,L,VAN,29,62,9,21,30
6,8476463,Jonas Brodin,D,MIN,31,81,8,22,30
6,8474151,Ryan McDonagh,D,TBL,35,77,5,25,30
6,8482679,Matt Coronato,R,CGY,22,63,17,12,29
6,8481553,Bobby Brink,R,PHI,23,61,16,13,29
6,8480802,Ryan McLeod,C,BUF,25,60,13,16,29
6,8478891,Mason Appleton,C,WPG,28,70,13,16,29
6,8476918,Jimmy Vesey,L,NYR,31,68,12,17,29
6,8480835,Jack Drury,C,CAR,24,55,11,18,29
6,8479353,Brett Howden,C,VGK,26,67,9,20,29
6,8483445,Cutter Gauthier,L,ANA,20,63,8,21,29
6,8477948,Travis Sanheim,D,PHI,28,66,7,22,29
6,8473507,Jeff Petry,D,DET,37,76,3,26,29
6,8477969,Marcus Pettersson,D,PIT,28,78,3,26,29
6,8478020,Michael Amadio,C,OTT,28,69,16,12,28
6,8474053,Logan Couture,C,SJS,35,62,15,13,28
6,8482660,Kent Johnson,C,CBJ,22,66,13,15,28
6,8481580,Connor McMichael,C,WSH,23,62,13,15,28
6,8474189,Lars Eller,C,PIT,35,72,12,16,28
6,8477947,Sonny Milano,L,WSH,28,58,12,16,28
6,8481656,Aliaksei Protas,C,WSH,23,68,10,18,28
6,8482117,Lukas Reichel,L,CHI,22,60,10,18,28
6,8479591,Michael Eyssimont,C,TBL,28,81,10,18,28
6,8480336,Sean Walker,D,CAR,30,75,9,19,28
6,8482101,Danil Gushchin,L,SJS,22,57,9,19,28
6,8481606,Jordan Spence,D,LAK,23,63,4,24,28
6,8476902,Esa Lindell,D,DAL,30,82,2,26,28
6,8478413,Jordan Greenway,L,BUF,27,65,15,12,27
6,8477425,Miles Wood,L,COL,29,77,14,13,27
6,8475220,Marcus Foligno,L,MIN,33,53,13,14,27
6,8481186,Logan O'Connor,R,COL,28,79,12,15,27
6,8476981,Josh Anderson,R,MTL,30,70,11,16,27
6,8482146,Luke Evangelista,R,NSH,22,67,10,17,27
6,8482111,Justin Barron,D,MTL,23,63,10,17,27
6,8482176,Wyatt Kaiser,D,CHI,22,54,9,18,27
6,8478970,Jalen Chatfield,D,CAR,28,70,8,19,27
6,8476979,Erik Gustafsson,D,DET,32,76,5,22,27
6,8480043,Timothy Liljegren,D,TOR,25,67,4,23,27
6,8479998,Mikey Anderson,D,LAK,25,70,3,24,27
6,8475690,Chris Tanev,D,TOR,35,69,3,24,27
6,8483457,Lane Hutson,D,MTL,20,74,14,12,26
6,8477953,Kasperi Kapanen,R,STL,28,68,13,13,26
6,8479293,Brandon Tanev,L,SEA,33,61,12,14,26
6,8482092,Ridly Greig,C,OTT,22,76,9,17,26
6,8480871,Adam Boqvist,D,FLA,24,64,9,17,26
6,8481523,Kirby Dach,C,MTL,23,63,6,20,26
6,8476469,Joel Armia,R,MTL,31,65,14,11,25
6,8483524,Shane Wright,C,SEA,20,59,13,12,25
6,8482079,Marco Rossi,C,MIN,23,60,13,12,25
6,8475343,Nic Dowd,C,WSH,34,64,13,12,25
6,8475231,Casey Cizikas,C,NYI,33,69,13,12,25
6,8477478,William Carrier,L,CAR,30,57,13,12,25
6,8477573,Nathan Walker,L,STL,30,49,13,12,25
6,8482055,Drew O'Connor,L,PIT,26,60,12,13,25
6,8476278,Colin Blackwell,C,DAL,31,78,12,13,25
6,8480074,Alexandre Texier,C,STL,25,56,11,14,25
6,8479987,Morgan Geekie,C,BOS,26,71,10,15,25
6,8473533,Jordan Staal,C,CAR,36,61,10,15,25
6,8477450,Jason Dickinson,C,CHI,29,65,10,15,25
6,8481554,Kaapo Kakko,R,NYR,23,76,9,16,25
6,8475193,Tomas Tatar,L,NJD,34,70,8,17,25
6,8479390,Taylor Raddysh,R,WSH,26,60,8,17,25
6,8476480,Vladislav Namestnikov,C,WPG,32,69,6,19,25
6,8482142,Jamie Drysdale,D,PHI,22,64,6,19,25
6,8481014,Alexander Romanov,D,NYI,24,76,3,22,25
6,8476931,Jake McCabe,D,TOR,31,64,2,23,25
6,8479982,Conor Timmins,D,TOR,26,55,0,25,25
6,8480281,Alexey Toropchenko,R,STL,25,58,15,9,24
6,8482157,Will Cuylle,L,NYR,22,61,14,10,24
6,8482705,Cole Sillinger,C,CBJ,21,66,13,11,24
6,8481517,Brett Leason,R,ANA,25,60,12,12,24
6,8480113,Alex Iafallo,L,WPG,31,58,11,13,24
6,8478133,Jake Evans,C,MTL,28,73,3,21,24
6,8477952,Robby Fabbri,C,ANA,28,68,16,7,23
6,8482062,Cole Smith,L,NSH,29,57,14,9,23
6,8470621,Corey Perry,R,EDM,39,72,12,11,23
6,8476921,Jordan Martinook,L,CAR,32,62,10,13,23
6,8480789,Oliver Wahlstrom,R,NYI,24,69,10,13,23
6,8481481,Blake Lizotte,C,PIT,27,55,9,14,23
6,8480068,Ryan Poehling,C,PHI,25,68,8,15,23
6,8479661,Tanner Jeannot,L,LAK,27,74,8,15,23
6,8477220,Nate Schmidt,D,FLA,33,72,8,15,23
6,8476457,Adam Larsson,D,SEA,32,68,6,17,23
6,8478507,John Marino,D,UTA,27,67,5,18,23
6,8482655,J.J. Moser,D,TBL,24,76,5,18,23
6,8482245,Artem Zub,D,OTT,29,64,3,20,23
6,8480878,Nils Lundkvist,D,DAL,24,79,2,21,23
6,8480049,Dylan Samberg,D,WPG,25,69,2,21,23
6,8477989,Christian Dvorak,C,MTL,28,65,11,11,22
6,8480205,Emil Bemstrom,C,PIT,25,59,11,11,22
6,8483565,Nick Blankenburg,D,NSH,26,53,11,11,22
6,8477987,Ryan Donato,C,CHI,28,63,10,12,22
6,8478508,Yakov Trenin,C,MIN,27,59,10,12,22
6,8476897,Oskar Sundqvist,C,STL,30,65,9,13,22
6,8476422,Mike Reilly,D,NYI,31,74,9,13,22
6,8482749,Joshua Roy,R,MTL,21,65,9,13,22
6,8477488,Brett Pesce,D,NJD,30,70,7,15,22
6,8482074,Connor Zary,C,CGY,23,63,7,15,22
6,8478432,Christian Fischer,R,DET,27,75,6,16,22
6,8483499,Liam Ohgren,L,MIN,20,60,6,16,22
6,8477507,Nikita Zadorov,D,BOS,29,72,6,16,22
6,8483466,Kevin Korchinski,D,CHI,20,62,6,16,22
6,8476624,Barclay Goodrow,C,SJS,31,52,5,17,22
6,8479398,Samuel Girard,D,COL,26,73,4,18,22
6,8474673,TJ Brodie,D,CHI,34,64,4,18,22
6,8479983,Mario Ferraro,D,SJS,26,71,3,19,22
6,8476331,Dylan DeMelo,D,WPG,31,67,3,19,22
6,8480001,Urho Vaakanainen,D,ANA,25,54,1,21,22
6,8475225,Craig Smith,C,CHI,35,58,14,7,21
6,8479393,Noah Gregor,C,OTT,26,72,11,10,21
6,8479619,Michael Carcone,L,UTA,28,67,11,10,21
6,8480849,Barrett Hayton,C,UTA,24,67,10,11,21
6,8479370,Tyson Jost,C,CAR,26,57,9,12,21
6,8473563,Nicklas Backstrom,C,WSH,37,59,8,13,21
6,8483468,Jiri Kulich,C,BUF,20,52,8,13,21
6,8480003,Jesper Boqvist,C,FLA,26,65,7,14,21
6,8480855,Jack McBain,C,UTA,24,66,5,16,21
6,8478452,Caleb Jones,D,LAK,27,62,5,16,21
6,8478500,Ivan Provorov,D,CBJ,27,79,4,17,21
6,8474574,Tyler Myers,D,VAN,34,75,4,17,21
6,8475233,David Savard,D,MTL,34,60,4,17,21
6,8480796,Martin Fehervary,D,WSH,25,59,3,18,21
6,8475181,Nick Leddy,D,STL,33,68,2,19,21
6,8481568,Alex Vlasic,D,CHI,23,55,1,20,21
6,8476891,Matt Grzelcyk,D,PIT,30,66,1,20,21
6,8481601,Simon Holmstrom,R,NYI,23,71,13,7,20
6,8476822,Luke Glendening,C,TBL,35,79,11,9,20
6,8476873,Mark Jankowski,C,NSH,30,51,10,10,20
6,8481521,Ronnie Attard,D,PHI,25,59,9,11,20
6,8480762,Eric Robinson,L,CAR,29,59,8,12,20
6,8481028,Martin Pospisil,C,CGY,25,58,7,13,20
6,8480727,Zach Whitecloud,D,VGK,28,47,6,14,20
6,8477508,Curtis Lazar,C,NJD,29,59,5,15,20
6,8476467,Jamie Oleksiak,D,SEA,32,68,5,15,20
6,8483493,Frank Nazar,C,CHI,20,55,5,15,20
6,8482073,Braden Schneider,D,NYR,23,60,4,16,20
6,8479976,Juuso Valimaki,D,UTA,26,59,1,19,20
6,8482077,Dylan Holloway,L,EDM,23,59,11,8,19
6,8480995,Pontus Holmberg,R,TOR,25,68,9,10,19
6,8477353,Tyler Motte,C,DET,29,76,9,10,19
6,8476312,Josh Manson,D,COL,33,65,8,11,19
6,8482803,Olen Zellweger,D,ANA,21,64,8,11,19
6,8481522,Peyton Krebs,C,BUF,23,57,8,11,19
6,8481161,Jake Christiansen,D,CBJ,25,58,6,13,19
6,8483495,Simon Nemec,D,NJD,20,59,5,14,19
6,8478882,Vladislav Gavrikov,D,LAK,29,69,3,16,19
6,8478136,Jake Middleton,D,MIN,28,69,3,16,19
6,8476879,Cody Ceci,D,EDM,31,66,3,16,19
6,8475790,Erik Gudbranson,D,CBJ,32,77,1,18,19
6,8482737,Zack Bolduc,C,STL,21,62,11,7,18
6,8479520,Brandon Duhaime,R,WSH,27,61,11,7,18
6,8480011,Klim Kostin,C,SJS,25,55,10,8,18
6,8479941,Justin Danforth,R,CBJ,31,53,9,9,18
6,8480813,Joe Veleno,C,DET,24,73,9,9,18
6,8477979,Nicolas Aube-Kubel,R,BUF,28,49,9,9,18
6,8479344,Jesse Puljujarvi,R,PIT,26,50,9,9,18
6,8476988,Matt Benning,D,SJS,30,66,8,10,18
6,8482807,Ethan Del Mastro,D,CHI,21,53,8,10,18
6,8481093,Rafael Harvey-Pinard,L,MTL,25,57,8,10,18
6,8480806,Isac Lundestrom,C,ANA,25,54,8,10,18
6,8479026,Philippe Myers,D,TOR,27,51,6,12,18
6,8482744,James Malatesta,L,CBJ,21,47,6,12,18
6,8479324,Ryan Lindgren,D,NYR,26,62,5,13,18
6,8475279,Ben Chiarot,D,DET,33,62,3,15,18
6,8478468,Jeremy Lauzon,D,NSH,27,62,3,15,18
6,8476429,Scott Mayfield,D,NYI,32,68,1,17,18
6,8479371,Dante Fabbro,D,NSH,26,59,1,17,18
6,8482762,Simon Edvinsson,D,DET,21,53,9,8,17
6,8476374,Sean Kuraly,C,CBJ,31,52,8,9,17
6,8478211,Dryden Hunt,L,CGY,29,58,8,9,17
6,8479718,Alex Barré-Boulet,C,MTL,27,54,7,10,17
6,8477499,Rasmus Ristolainen,D,PHI,30,59,6,11,17
6,8476889,Radek Faksa,C,STL,30,64,5,12,17
6,8477406,Mattias Janmark,C,EDM,32,66,5,12,17
6,8482730,Brandt Clarke,D,LAK,21,46,5,12,17
6,8470600,Ryan Suter,D,STL,39,61,4,13,17
6,8480950,Ilya Lyubushkin,D,DAL,30,79,3,14,17
6,8480035,Henri Jokiharju,D,BUF,25,61,3,14,17
6,8480887,Jordan Harris,D,MTL,24,56,3,14,17
6,8478851,Alexandre Carrier,D,NSH,28,72,0,17,17
6,8478840,Will Borgen,D,SEA,28,64,0,17,17
6,8481477,Nico Sturm,C,SJS,29,55,11,5,16
6,8481716,Dmitri Voronkov,L,CBJ,24,52,10,6,16
6,8479316,Luke Kunin,C,SJS,27,52,9,7,16
6,8483482,Tristan Luneau,D,ANA,20,68,6,10,16
6,8478043,Sam Lafferty,C,BUF,29,66,5,11,16
6,8480172,Jan Rutta,D,SJS,34,59,5,11,16
6,8476994,Vinnie Hinostroza,C,NSH,30,48,5,11,16
6,8477369,Carson Soucy,D,VAN,30,59,5,11,16
6,8476525,Colin Miller,D,WPG,32,64,4,12,16
6,8484149,Gavin Brindley,C,CBJ,20,56,4,12,16
6,8482859,Zack Ostapchuk,C,OTT,21,58,4,12,16
6,8480157,Calle Rosen,D,COL,30,49,4,12,16
6,8480058,Pierre-Olivier Joseph,D,STL,25,54,3,13,16
6,8479378,Logan Stanley,D,WPG,26,51,2,14,16
6,8475455,Brenden Dillon,D,NJD,34,61,1,15,16
6,8478178,Darren Raddysh,D,TBL,28,69,0,16,16
6,8477903,Garnet Hathaway,R,PHI,33,63,10,5,15
6,8478585,Derek Ryan,C,EDM,38,64,9,6,15
6,8482659,Josh Doan,R,UTA,22,55,9,6,15
6,8479315,Joey Anderson,R,CHI,26,50,8,7,15
6,8481441,Joe Snively,C,DET,28,63,8,7,15
6,8473453,Trevor Lewis,C,LAK,37,75,7,8,15
6,8481524,Bowen Byram,D,BUF,23,54,7,8,15
6,8480448,Parker Kelly,L,COL,25,77,6,9,15
6,8480289,Morgan Barron,C,WPG,26,58,6,9,15
6,8478911,Matt Roy,D,WSH,29,66,5,10,15
6,8481592,Jakob Pelletier,L,CGY,23,38,5,10,15
6,8477365,Connor Clifton,D,BUF,29,63,4,11,15
6,8478399,Jonas Siegenthaler,D,NJD,27,61,4,11,15
6,8481641,Joel Kiviranta,L,COL,28,72,4,11,15
6,8481059,Scott Perunovich,D,STL,26,58,3,12,15
6,8480990,Declan Chisholm,D,MIN,24,57,3,12,15
6,8475462,Radko Gudas,D,ANA,34,61,2,13,15
6,8481537,Nikita Okhotiuk,D,CGY,24,46,2,13,15
6,8477845,Trevor van Riemsdyk,D,WSH,33,60,2,13,15
6,8477435,Ryan Graves,D,PIT,29,75,1,14,15
6,8482087,Kaiden Guhle,D,MTL,22,65,1,14,15
6,8480891,Michael Kesselring,D,UTA,24,56,1,14,15
6,8477380,Jonny Brodzinski,C,NYR,31,44,10,4,14
6,8478434,Keegan Kolesar,R,VGK,27,62,8,6,14
6,8471817,Ryan Reaves,R,TOR,37,68,8,6,14
6,8477392,Hudson Fasching,R,NYI,29,61,7,7,14
6,8477446,Michael McCarron,R,NSH,29,51,7,7,14
6,8477015,Connor Brown,R,EDM,30,58,6,8,14
6,8476329,Travis Boyd,C,MIN,31,54,6,8,14
6,8475235,Nicolas Deslauriers,L,PHI,33,53,6,8,14
6,8477034,Jaycob Megna,D,FLA,32,59,6,8,14
6,8476960,Andreas Athanasiou,C,CHI,30,53,5,9,14
6,8475179,Dmitry Kulikov,D,FLA,34,52,5,9,14
6,8482148,Hendrix Lapierre,C,WSH,22,42,4,10,14
6,8482192,Isaak Phillips,D,CHI,23,52,4,10,14
6,8481527,Kaedan Korczak,D,VGK,23,43,3,11,14
6,8478451,Ethan Bear,D,WSH,27,53,3,11,14
6,8482634,Alex Steeves,C,TOR,25,61,2,12,14
6,8475750,Jon Merrill,D,MIN,32,54,2,12,14
6,8478831,Kevin Stenlund,C,UTA,28,54,9,4,13
6,8478569,Noel Acciari,C,PIT,33,53,8,5,13
6,8480252,Cole Guttman,C,CHI,25,50,8,5,13
6,8479336,Carl Grundstrom,R,SJS,27,55,7,6,13
6,8481019,David Gustafsson,C,WPG,24,49,6,7,13
6,8481518,Nolan Foote,L,NJD,24,40,6,7,13
6,8476934,Brock McGinn,L,ANA,30,55,6,7,13
6,8480222,Sebastian Aho,D,PIT,28,71,5,8,13
6,8475855,Jesper Fast,R,CAR,33,52,5,8,13
6,8479639,Dylan Coghlan,D,WPG,26,58,4,9,13
6,8479328,Julien Gauthier,R,NYI,27,60,4,9,13
6,8481617,Vasily Podkolzin,R,VAN,23,44,4,9,13
6,8482666,Scott Morrow,D,CAR,22,51,4,9,13
6,8477919,Frederick Gaudreau,C,MIN,31,61,3,10,13
6,8480807,Mattias Samuelsson,D,BUF,24,58,3,10,13
6,8481708,Zac Jones,D,NYR,24,54,3,10,13
6,8479402,Jake Bean,D,CGY,26,64,2,11,13
6,8482166,Shakir Mukhamadullin,D,SJS,22,56,2,11,13
6,8480246,Nick Perbix,D,TBL,26,71,2,11,13
6,8474567,Zach Bogosian,D,MIN,34,56,1,12,13
6,8479980,Nicolas Hague,D,VGK,26,58,1,12,13
6,8482070,Mitchell Chaffee,R,TBL,26,57,7,5,12
6,8481147,Reese Johnson,C,MIN,26,38,7,5,12
6,8482067,Connor Mackey,D,NYR,28,67,6,6,12
6,8475842,Sam Carrick,C,NYR,32,57,6,6,12
6,8477851,Jordan Oesterle,D,BOS,32,40,5,7,12
6,8479368,Max Jones,L,BOS,26,66,4,8,12
6,8477931,Tomas Nosek,L,FLA,32,63,4,8,12
6,8479944,Zach Aston-Reese,C,VGK,30,45,4,8,12
6,8480355,Mark Kastelic,C,BOS,25,61,3,9,12
6,8481567,Henry Thrun,D,SJS,23,48,2,10,12
6,8481178,Egor Zamula,D,PHI,24,57,2,10,12
6,8471709,Marc-Edouard Vlasic,D,SJS,37,57,2,10,12
6,8478859,Niko Mikkola,D,FLA,28,57,2,10,12
6,8475718,Justin Holl,D,DET,32,53,2,10,12
6,8475324,Nick Jensen,D,OTT,34,69,0,12,12
6,8479536,Axel Jonsson-Fjallby,L,WPG,26,38,8,3,11
6,8476867,Brendan Gaunce,C,MIN,30,34,8,3,11
6,8477070,Liam O'Brien,C,UTA,30,55,7,4,11
6,8479671,Mathieu Olivier,R,CBJ,27,50,6,5,11
6,8478424,Jansen Harkins,C,ANA,27,44,6,5,11
6,8479066,Ryan Lomberg,L,CGY,30,52,5,6,11
6,8477018,Ben Hutton,D,VGK,31,47,5,6,11
6,8476858,Phillip Di Giuseppe,L,VAN,31,38,5,6,11
6,8482652,Walker Duehr,R,CGY,27,42,5,6,11
6,8480021,Jack Studnicka,C,LAK,25,62,4,7,11
6,8478421,A.J. Greer,L,FLA,28,55,4,7,11
6,8474034,Pat Maroon,L,CHI,36,43,4,7,11
6,8475762,Derek Forbort,D,VAN,32,49,3,8,11
6,8479968,Vinni Lettieri,C,BOS,29,47,3,8,11
6,8480860,Kevin Bahl,D,CGY,24,51,3,8,11
6,8477335,Kyle Burroughs,D,LAK,29,34,3,8,11
6,8476952,Dominic Toninato,C,WPG,30,38,3,8,11
6,8475188,Brayden McNabb,D,VGK,33,53,2,9,11
6,8479439,Jacob MacDonald,D,COL,31,40,2,9,11
6,8483460,David Jiricek,D,CBJ,21,64,2,9,11
6,8480879,Jacob Bernard-Docker,D,OTT,24,48,1,10,11
6,8479348,Kale Clague,D,BUF,26,40,1,10,11
6,8480848,Ty Dellandrea,C,SJS,24,45,7,3,10
6,8480025,MacKenzie Entwistle,R,FLA,25,57,5,5,10
6,8482733,Logan Mailloux,D,MTL,31,32,4,6,10
6,8482095,Tyler Kleven,D,OTT,22,50,4,6,10
6,8479369,Andrew Peeke,D,BOS,26,57,3,7,10
6,8483619,Filip Roos,D,OTT,25,33,3,7,10
6,8477473,Justin Bailey,R,SJS,29,32,3,7,10
6,8478443,Brandon Carlo,D,BOS,28,59,2,8,10
6,8474013,Ian Cole,D,UTA,35,48,1,9,10
6,8476874,Olli Maatta,D,DET,30,64,1,9,10
6,8474166,Alec Martinez,D,CHI,37,41,1,9,10
6,8480834,Ty Emberson,D,SJS,24,36,1,9,10
6,8482712,Oskar Olausson,R,COL,22,78,0,10,10
6,8476967,Brett Kulak,D,EDM,30,59,0,10,10
6,8475208,Brian Dumoulin,D,ANA,33,59,0,10,10
6,8477938,Haydn Fleury,D,WPG,28,40,5,4,9
6,8477505,Alexander Wennberg,C,SJS,30,36,4,5,9
6,8481751,Lukas Rousek,R,BUF,25,43,4,5,9
6,8481609,Vladislav Kolyachonok,D,UTA,23,44,4,5,9
6,8482451,Mikael Pyyhtia,L,CBJ,23,41,3,6,9
6,8481167,Brayden Pachal,D,CGY,25,51,3,6,9
6,8476473,Connor Murphy,D,CHI,31,36,3,6,9
6,8479543,Michael Pezzetta,L,MTL,26,49,2,7,9
6,8479442,Troy Stecher,D,EDM,30,67,2,7,9
6,8471677,Jack Johnson,D,CBJ,37,59,2,7,9
6,8482747,Brennan Othmann,L,NYR,21,44,2,7,9
6,8480845,Rasmus Kupari,C,WPG,24,37,2,7,9
6,8477887,Patrick Brown,C,BOS,32,47,2,7,9
6,8479249,Andrew Poturalski,C,SJS,30,40,2,7,9
6,8480070,Ian Mitchell,D,BOS,25,36,1,8,9
6,8481599,Victor Soderstrom,D,UTA,23,46,1,8,9
6,8481056,Spencer Stastney,D,NSH,24,42,1,8,9
6,8482155,Alex Laferriere,R,LAK,23,61,6,2,8
6,8484911,Collin Graf,R,SJS,22,45,5,3,8
6,8482784,Zach Dean,C,STL,21,39,5,3,8
6,8479638,Justin Brazeau,R,BOS,26,43,4,4,8
6,8481532,Alex Turcotte,C,LAK,23,51,3,5,8
6,8480007,Jonas Rondbjerg,R,VGK,25,43,3,5,8
6,8474568,Luke Schenn,D,NSH,35,44,3,5,8
6,8479985,Cale Fleury,D,SEA,26,31,3,5,8
6,8477073,Kurtis MacDermid,L,NJD,30,25,3,5,8
6,8479359,Beck Malenstyn,L,BUF,26,44,2,6,8
6,8481013,Jonatan Berggren,R,DET,24,61,2,6,8
6,8479291,Kevin Rooney,C,CGY,31,52,2,6,8
6,8481550,Adam Beckman,L,NJD,23,39,2,6,8
6,8481600,Tobias Bjornfot,D,FLA,23,39,2,6,8
6,8473446,Erik Johnson,D,PHI,36,49,2,6,8
6,8483397,Marc McLaughlin,C,BOS,25,38,2,6,8
6,8474090,Brendan Smith,D,DAL,35,79,1,7,8
6,8479372,Josh Mahura,D,SEA,26,45,1,7,8
6,8482964,Arber Xhekaj,D,MTL,23,47,1,7,8
6,8484254,Akito Hirose,D,VAN,25,28,1,7,8
6,8477384,Josh Brown,D,EDM,30,40,0,8,8
6,8481605,Jackson LaCombe,D,ANA,23,34,0,8,8
6,8477462,Robert Hagg,D,VGK,29,20,0,8,8
6,8480245,Olle Lycksell,R,PHI,25,30,6,1,7
6,8479994,Jaret Anderson-Dolan,C,WPG,25,37,6,1,7
6,8483763,Maksymilian Szuber,D,UTA,22,31,5,2,7
6,8481754,Nikita Nesterenko,C,ANA,23,37,5,2,7
6,8480292,Carson Meyer,R,ANA,27,32,4,3,7
6,8482496,Nils Aman,C,VAN,24,39,4,3,7
6,8477401,John Hayden,C,SEA,29,28,4,3,7
6,8482145,Mavrik Bourque,C,DAL,22,56,4,3,7
6,8480032,Shane Bowers,C,NJD,25,17,4,3,7
6,8482165,Yan Kuznetsov,D,CGY,22,24,4,3,7
6,8478477,Mitchell Stephens,C,SEA,27,20,3,4,7
6,8483512,Matt Savoie,C,EDM,20,27,3,4,7
6,8482751,Ryan Winterton,C,SEA,21,40,3,4,7
6,8479772,Zack MacEwen,R,OTT,28,45,3,4,7
6,8480196,Jacob Bryson,D,BUF,27,38,2,5,7
6,8476442,Matt Nieto,L,PIT,32,48,2,5,7
6,8481122,Simon Benoit,D,TOR,26,46,2,5,7
6,8481701,Santeri Hatakka,D,NJD,23,37,2,5,7
6,8480441,Trey Fix-Wolansky,R,CBJ,25,26,2,5,7
6,8482144,Jack Thompson,D,SJS,22,26,2,5,7
6,8478450,Parker Wotherspoon,D,BOS,27,39,1,6,7
6,8480880,Jakub Lauko,C,MIN,24,33,1,6,7
6,8480870,Bo Groulx,C,NYR,24,36,1,6,7
6,8475177,Calvin de Haan,D,COL,33,44,1,6,7
6,8481541,Samuel Bolduc,D,NYI,24,28,1,6,7
6,8480192,Johnathan Kovacevic,D,NJD,27,49,0,7,7
6,8479986,Kole Lind,R,DAL,26,42,0,7,7
6,8481789,Tye Kartye,L,SEA,23,38,4,2,6
6,8483012,Logan Morrison,C,SEA,22,37,4,2,6
6,8481598,Philip Broberg,D,EDM,23,39,3,3,6
6,8478874,Adam Gaudette,C,OTT,28,44,3,3,6
6,8482172,Landon Slaggert,L,CHI,22,29,3,3,6
6,8482141,Lukas Cormier,D,VGK,22,28,3,3,6
6,8483549,Lucas Condotta,L,MTL,27,34,3,3,6
6,8478409,Anthony Richard,C,PHI,28,32,2,4,6
6,8478017,Mark Friedman,D,VAN,29,32,2,4,6
6,8480844,Grigori Denisenko,L,VGK,24,31,2,4,6
6,8478051,Max Willman,C,NJD,29,13,2,4,6
6,8475958,Michael Sgarbossa,C,WSH,32,23,1,5,6
6,8484258,Sam Malinski,D,COL,26,22,1,5,6
6,8479576,Vincent Desharnais,D,VAN,28,33,1,5,6
6,8482153,Brendan Brisson,C,VGK,23,29,0,6,6
6,8482250,Callahan Burke,C,VGK,27,26,0,6,6
6,8483570,Ben Meyers,C,SEA,26,31,5,0,5
6,8482511,Mason Lohrei,D,BOS,23,40,4,1,5
6,8482713,Mackie Samoskevich,R,FLA,22,36,4,1,5
6,8484287,Cole McWard,D,VAN,23,28,3,2,5
6,8480073,Erik Brannstrom,D,COL,25,63,2,3,5
6,8479972,Mason Shaw,C,WPG,26,27,2,3,5
6,8477962,Brendan Lemieux,L,CAR,28,43,2,3,5
6,8482102,Vasily Ponomarev,C,PIT,22,21,2,3,5
6,8475795,Dylan McIlrath,D,WSH,32,10,2,3,5
6,8477527,Ross Johnston,L,ANA,30,30,2,3,5
6,8481543,Nikita Alexandrov,C,STL,24,27,2,3,5
6,8476913,Devin Shore,C,MIN,30,38,1,4,5
6,8478454,Noah Juulsen,D,VAN,27,37,1,4,5
6,8479320,Max Lajoie,D,SEA,27,22,1,4,5
6,8480823,Alexander Alexeyev,D,WSH,25,15,1,4,5
6,8475413,Justin Dowling,C,NJD,34,20,1,4,5
6,8481593,Jayden Struble,D,MTL,23,24,1,4,5
6,8476372,Nick Seeler,D,PHI,31,41,0,5,5
6,8477810,Joel Hanley,D,CGY,33,23,0,5,5
6,8482765,Isak Rosen,R,BUF,21,31,0,5,5
6,8482858,Ryker Evans,D,SEA,23,26,0,5,5
6,8481237,Kyle MacLean,C,NYI,25,22,2,2,4
6,8481679,Maxence Guenette,D,OTT,23,28,2,2,4
6,8482088,Justin Sourdif,R,FLA,22,18,2,2,4
6,8478021,William Lagesson,D,DET,28,30,0,4,4
6,8482147,Jean-Luc Foudy,C,COL,22,22,0,4,4
6,8482061,Brandon Biro,L,SEA,26,16,3,0,3
6,8479587,Rhett Gardner,C,PHI,28,10,3,0,3
6,8481422,Jacob Lucchini,C,NSH,29,19,2,1,3
6,8481556,John Beecher,C,BOS,23,33,2,1,3
6,8480851,Akil Thomas,C,LAK,24,14,2,1,3
6,8479981,Jonah Gadjovich,L,FLA,26,37,2,1,3
6,8481043,Cole Koepke,L,BOS,26,18,2,1,3
6,8474612,Travis Hamonic,D,OTT,34,50,1,2,3
6,8476441,Joel Edmundson,D,LAK,31,36,1,2,3
6,8479419,Brett Murray,L,BUF,26,17,1,2,3
6,8479367,William Lockwood,R,FLA,26,31,1,2,3
6,8477149,Scott Sabourin,R,SJS,32,23,1,2,3
6,8479379,Givani Smith,R,SJS,26,24,0,3,3
6,8477971,Andreas Englund,D,LAK,28,23,0,3,3
6,8481006,Tyler Tucker,D,STL,24,19,0,3,3
6,8481564,Ryan Johnson,D,BUF,23,18,0,3,3
6,8481578,Graeme Clarke,R,MIN,23,11,0,3,3
6,8483630,Pavol Regenda,L,ANA,25,21,2,0,2
6,8477467,Gustav Olofsson,D,SEA,30,16,2,0,2
6,8481065,Angus Crookshank,L,OTT,25,17,2,0,2
6,8480874,Adam Ginning,D,PHI,24,8,2,0,2
6,8477541,Dakota Mermis,D,TOR,30,6,2,0,2
6,8482476,Emil Heineman,L,MTL,23,12,2,0,2
6,8480468,James Hamblin,L,EDM,25,21,1,1,2
6,8478146,Matthew Highmore,C,OTT,28,32,1,1,2
6,8474062,Riley Nash,C,NYR,35,14,1,1,2
6,8481699,Aku Raty,R,UTA,23,20,1,1,2
6,8482118,Sam Colangelo,R,ANA,23,16,1,1,2
6,8481030,Jack St. Ivany,D,PIT,25,21,1,1,2
6,8479362,Riley Tufte,L,BOS,26,17,0,2,2
6,8479991,Jake Leschyshyn,C,NYR,25,25,0,2,2
6,8484325,Waltteri Merela,C,TBL,26,16,0,2,2
6,8482516,Matthew Kessel,D,STL,24,26,0,2,2
6,8480890,Jan Jenik,R,OTT,24,21,0,2,2
6,8482470,Ilya Solovyov,D,CGY,24,24,0,2,2
6,8478011,Louie Belpedio,D,PHI,28,13,0,2,2
6,8482177,Marat Khusnutdinov,C,MIN,22,36,1,0,1
6,8482861,Vincent Iorio,D,WSH,22,16,1,0,1
6,8481585,Egor Afanasyev,L,SJS,23,12,1,0,1
6,8482162,Roby Jarventie,L,EDM,22,13,1,0,1
6,8484255,Jason Polin,R,COL,25,4,1,0,1
6,8479421,Jacob Moverare,D,LAK,26,17,1,0,1
6,8478881,Brett Seney,L,CHI,28,14,1,0,1
6,8483398,Declan Carlile,D,TBL,31,6,1,0,1
6,8483531,Brian Halonen,L,NJD,25,4,1,0,1
6,8475755,Alexander Petrovic,D,DAL,32,12,0,1,1
6,8482094,Daemon Hunt,D,MIN,22,17,0,1,1
6,8478502,Dennis Gilbert,D,BUF,28,24,0,1,1
6,8477244,Chad Ruhwedel,D,NYR,34,31,0,1,1
6,8477320,Anton Blidh,L,NYR,29,23,0,1,1
6,8480084,Nick DeSimone,D,NJD,30,16,0,1,1
6,8483920,Pierrick Dube,R,WSH,23,6,0,1,1
6,8483471,Brad Lambert,C,WPG,31,7,0,1,1
6,8482929,Emil Lilleberg,D,TBL,23,18,0,1,1
6,8482197,Adam Raska,R,MIN,23,12,0,1,1
6,8481719,Maxwell Crozier,D,TBL,24,20,0,1,1
6,8481024,Linus Karlsson,C,VAN,25,12,0,1,1
6,8482201,Gage Goncalves,C,TBL,23,18,0,1,1
6,8483597,Milos Kelemen,L,UTA,25,10,0,1,1
6,8481206,John Ludvig,D,PIT,24,15,0,1,1
6,8484304,Uvis Balinskis,D,FLA,28,9,0,1,1
6,8483432,Luca Del Bel Belluz,C,CBJ,31,6,0,1,1
6,8483609,Adam Klapka,R,CGY,24,2,0,1,1
6,8482460,Matt Rempe,C,NYR,22,9,0,0,0
6,8481462,Mason Morelli,L,VGK,28,11,0,0,0
6,8483489,Fraser Minten,C,TOR,31,12,0,0,0
6,8483395,Arshdeep Bains,L,VAN,23,7,0,0,0
6,8482787,Nikita Chibrikov,R,WPG,31,9,0,0,0
6,8481743,Marc Del Gaizo,D,NSH,25,16,0,0,0
6,8483546,Marshall Rifai,D,TOR,26,2,0,0,0
6,8478446,Glenn Gawdin,C,LAK,27,3,0,0,0
6,8483567,Georgii Merkulov,C,BOS,24,12,0,0,0
6,8480267,Sammy Walker,C,MIN,25,13,0,0,0
6,8481806,Louis Crevier,D,CHI,23,10,0,0,0
6,8479522,Hardy Haman Aktell,D,WSH,26,3,0,0,0
6,8484326,Patrik Koch,D,UTA,28,2,0,0,0
6,8478147,Bokondji Imama,L,PIT,28,6,0,0,0
6,8481655,Cole Schwindt,R,CGY,23,6,0,0,0
6,8481534,Raphael Lavoie,C,EDM,24,1,0,0,0
6,8480306,Grant Hutton,D,NYI,29,11,0,0,0
6,8477993,Justin Kirkland,C,CGY,28,9,0,0,0
6,8479330,Brandon Gignac,C,MTL,27,4,0,0,0
6,8480075,Cameron Crotty,D,MIN,25,7,0,0,0
6,8484259,Ondrej Pavel,C,COL,31,2,0,0,0
6,8482126,Emil Andrae,D,PHI,31,4,0,0,0
6,8475780,Chris Wagner,R,COL,33,8,0,0,0
6,8483407,Brandon Scanlin,D,NYR,25,4,0,0,0
6,8478854,Ryan Shea,D,PIT,27,8,0,0,0
6,8476323,Max McCormick,L,SEA,32,2,0,0,0
6,8481726,Adam Edstrom,C,NYR,24,5,0,0,0
6,8479321,Lucas Johansen,D,,27,0,0,0,0
6,8470794,Joe Pavelski,C,,40,0,0,0,0
6,8477950,Tony DeAngelo,D,,29,0,0,0,0
6,8471218,Blake Wheeler,R,,38,0,0,0,0
6,8475197,Tyson Barrie,D,,33,0,0,0,0
6,8475744,Evgeny Kuznetsov,C,,32,0,0,0,0
6,8474037,James van Riemsdyk,L,,35,0,0,0,0
6,8474602,Justin Schultz,D,,34,0,0,0,0
6,8482222,Alexander Barabanov,L,,30,0,0,0,0
6,8474157,Max Pacioretty,L,,36,0,0,0,0
6,8474031,Kevin Shattenkirk,D,,35,0,0,0,0
6,8480884,Calen Addison,D,,24,0,0,0,0
6,8480008,Adam Ruzicka,C,,25,0,0,0,0
6,8475906,John Klingberg,D,,32,0,0,0,0
6,8476884,Derrick Pouliot,D,,30,0,0,0,0
6,8476919,Chris Tierney,C,,30,0,0,0,0
6,8479415,Michael McLeod,C,,26,0,0,0,0
6,8474884,Mike Hoffman,C,,35,0,0,0,0
6,8478104,Sammy Blais,L,,28,0,0,0,0
6,8474870,Tyler Johnson,C,,34,0,0,0,0
6,8481591,Sam Poulin,R,,23,0,0,0,0
6,8479977,Kailer Yamamoto,R,,26,0,0,0,0
6,8476393,Nick Cousins,C,,31,0,0,0,0
6,8479376,Victor Mete,D,,26,0,0,0,0
6,8476871,Tanner Pearson,L,,32,0,0,0,0
6,8471274,Alex Goligoski,D,,39,0,0,0,0
6,8481058,Jesse Ylönen,R,,25,0,0,0,0
6,8477464,Nic Petan,C,,29,0,0,0,0
6,8473449,Kyle Okposo,R,,36,0,0,0,0
6,8480216,Jacob Peterson,C,,25,0,0,0,0
6,8479346,Dillon Dube,C,,26,0,0,0,0
6,8470966,Mark Giordano,D,,41,0,0,0,0
6,8480821,Filip Zadina,R,,25,0,0,0,0
6,8476907,Mackenzie MacEachern,L,,30,0,0,0,0
6,8478430,Oliver Kylington,D,,27,0,0,0,0
6,8479514,Rem Pitlick,C,,27,0,0,0,0
6,8478099,Kevin Labanc,R,,29,0,0,0,0
6,8482241,Radim Zohorna,L,,28,0,0,0,0
6,8474040,Sam Gagner,C,,35,0,0,0,0
6,8475164,Jakob Silfverberg,R,,34,0,0,0,0
6,8475752,Tyler Pitlick,C,,33,0,0,0,0
6,8479984,Cal Foote,D,,26,0,0,0,0
6,8478495,Denis Gurianov,R,,27,0,0,0,0
6,8479533,Joona Koppanen,L,,26,0,0,0,0
6,8479458,Nikita Zaitsev,D,,33,0,0,0,0
6,8471699,Andrew Cogliano,C,,37,0,0,0,0
6,8470604,Jeff Carter,C,,39,0,0,0,0
6,8477330,Dominik Kubalik,L,,29,0,0,0,0
6,8477944,Jakub Vrana,L,,28,0,0,0,0
6,8478904,Steven Lorentz,C,,28,0,0,0,0
6,8471686,Marc Staal,D,,37,0,0,0,0
6,8478512,Austin Czarnik,C,,32,0,0,0,0
6,8470610,Zach Parise,L,,40,0,0,0,0
6,8473504,Cal Clutterbuck,R,,37,0,0,0,0
6,8474009,Nick Bonino,C,,36,0,0,0,0
6,8477454,Adam Erne,L,,29,0,0,0,0
6,8477126,Jayson Megna,C,,34,0,0,0,0
6,8473473,Milan Lucic,L,,36,0,0,0,0
6,8478067,Oskar Lindblom,L,,28,0,0,0,0
6,8475825,Jani Hakanpää,D,,32,0,0,0,0
6,8479383,Boris Katchouk,L,,26,0,0,0,0
6,8478400,Colin White,C,,27,0,0,0,0
6,8477846,Ryan Carpenter,C,,33,0,0,0,0
6,8477930,Pierre-Edouard Bellemare,L,,39,0,0,0,0
6,8479423,Alex Nylander,L,,26,0,0,0,0
6,8475797,Jarred Tinordi,D,,32,0,0,0,0
6,8481239,Samuel Fagemo,L,,24,0,0,0,0
6,8474618,Marco Scandella,D,,34,0,0,0,0
6,8480853,Liam Foudy,C,,24,0,0,0,0
6,8478028,Fredrik Olofsson,L,,28,0,0,0,0
6,8474145,Robert Bortuzzo,D,,35,0,0,0,0
6,8474709,Matt Martin,L,,35,0,0,0,0
6,8480226,Marián Studenic,R,,26,0,0,0,0
6,8480274,Philip Kemp,D,EDM,25,2,0,0,0
6,8480184,Gustav Lindstrom,D,,26,0,0,0,0
6,8481077,John Leonard,L,,26,0,0,0,0
6,8479547,Matthew Phillips,R,,26,0,0,0,0
6,8476915,Jujhar Khaira,L,,30,0,0,0,0
6,8481070,Hugh McGing,L,,26,0,0,0,0
6,8478408,Travis Dermott,D,,28,0,0,0,0
6,8481812,Nikolai Knyzhov,D,,27,0,0,0,0
6,8484321,Nikolas Matinpalo,D,OTT,26,1,0,0,0
6,8475278,Byron Froese,C,,33,0,0,0,0
6,8475766,Austin Watson,L,,32,0,0,0,0
6,8479546,Oskar Steen,C,,26,0,0,0,0
6,8480836,Jonathan Gruden,C,,24,0,0,0,0
6,8481690,Tyler Angle,C,,24,0,0,0,0
6,8480031,Maxime Comtois,L,,25,0,0,0,0
6,8483045,Cameron Butler,R,CBJ,31,1,0,0,0
6,8478078,Rourke Chartier,C,,28,0,0,0,0
6,8481016,Ruslan Iskhakov,C,,24,0,0,0,0
6,8484314,Jiri Smejkal,L,,28,0,0,0,0
6,8478956,Samuel Laberge,L,NJD,27,1,0,0,0
6,8483401,Marc Johnstone,R,PIT,28,0,0,0,0
6,8480776,Sheldon Rempal,R,,29,0,0,0,0
7,8477492,Nathan MacKinnon,C,COL,29,81,60,80,140
7,8476453,Nikita Kucherov,R,TBL,31,82,40,98,138
7,8478420,Mikko Rantanen,R,COL,28,81,66,63,129
7,8478402,Connor McDavid,C,EDM,27,77,45,80,125
7,8481559,Jack Hughes,C,NJD,23,77,55,67,122
7,8477939,William Nylander,R,TOR,28,82,40,76,116
7,8477946,Dylan Larkin,C,DET,28,81,50,63,113
7,8477934,Leon Draisaitl,C,EDM,29,80,38,75,113
7,8476887,Filip Forsberg,L,NSH,30,74,45,60,105
7,8478550,Artemi Panarin,L,NYR,33,80,34,71,105
7,8478864,Kirill Kaprizov,L,MIN,27,72,45,58,103
7,8479314,Matthew Tkachuk,L,FLA,27,77,32,71,103
7,8479318,Auston Matthews,C,TOR,27,81,54,46,100
7,8477404,Jake Guentzel,C,TBL,30,82,41,59,100
7,8477942,Kevin Fiala,L,LAK,28,82,38,61,99
7,8477956,David Pastrnak,R,BOS,28,77,50,47,97
7,8478403,Jack Eichel,C,VGK,28,77,49,47,96
7,8477933,Sam Reinhart,C,FLA,29,79,48,46,94
7,8480023,Robert Thomas,C,STL,25,79,24,70,94
7,8480012,Elias Pettersson,C,VAN,26,75,37,56,93
7,8484144,Connor Bedard,C,CHI,19,75,32,60,92
7,8480002,Nico Hischier,C,NJD,25,75,34,55,89
7,8474141,Patrick Kane,R,DET,36,81,28,59,87
7,8474600,Roman Josi,D,NSH,34,73,21,66,87
7,8475172,Nazem Kadri,C,CGY,34,82,42,44,86
7,8478414,Timo Meier,R,NJD,28,80,40,46,86
7,8477501,Valeri Nichushkin,R,COL,29,81,35,50,85
7,8478445,Mathew Barzal,C,NYI,27,80,15,70,85
7,8477493,Aleksander Barkov,C,FLA,29,77,26,58,84
7,8475184,Chris Kreider,L,NYR,33,75,50,32,82
7,8471675,Sidney Crosby,C,PIT,37,68,39,42,81
7,8480069,Cale Makar,D,COL,26,65,14,67,81
7,8480800,Quinn Hughes,D,VAN,25,76,11,70,81
7,8481557,Matt Boldy,L,MIN,23,70,41,39,80
7,8479337,Alex DeBrincat,R,DET,27,80,37,43,80
7,8476468,J.T. Miller,C,VAN,31,79,31,49,80
7,8476459,Mika Zibanejad,C,NYR,31,76,31,48,79
7,8482078,Lucas Raymond,L,DET,22,82,30,49,79
7,8480803,Evan Bouchard,D,EDM,25,77,21,58,79
7,8479420,Tage Thompson,C,BUF,27,72,45,33,78
7,8478398,Kyle Connor,L,WPG,28,78,36,42,78
7,8482116,Tim Stützle,C,OTT,22,80,25,53,78
7,8477402,Pavel Buchnevich,L,STL,29,76,32,44,76
7,8480027,Jason Robertson,L,DAL,25,82,23,53,76
7,8475166,John Tavares,C,TOR,34,81,37,38,75
7,8474564,Steven Stamkos,C,NSH,34,78,36,39,75
7,8478427,Sebastian Aho,C,CAR,27,72,31,44,75
7,8480018,Nick Suzuki,C,MTL,25,77,27,48,75
7,8478493,Joel Eriksson Ek,C,MIN,27,70,35,39,74
7,8480801,Brady Tkachuk,L,OTT,25,81,35,38,73
7,8479407,Jesper Bratt,L,NJD,26,77,28,45,73
7,8480865,Noah Dobson,D,NYI,24,77,7,66,73
7,8477500,Bo Horvat,C,NYI,29,80,37,35,72
7,8482124,Quinton Byfield,R,LAK,22,81,18,54,72
7,8475754,Brock Nelson,C,NYI,33,81,47,24,71
7,8479675,Trevor Moore,L,LAK,29,80,25,46,71
7,8476454,Ryan Nugent-Hopkins,C,EDM,31,80,19,52,71
7,8476460,Mark Scheifele,C,WPG,31,76,32,38,70
7,8475170,Brayden Schenn,C,STL,33,76,30,40,70
7,8478439,Travis Konecny,R,PHI,27,78,24,46,70
7,8477949,Alex Tuch,R,BUF,28,69,24,46,70
7,8475765,Vladimir Tarasenko,R,DET,33,82,34,35,69
7,8480830,Andrei Svechnikov,R,CAR,24,77,29,40,69
7,8476539,Jonathan Marchessault,R,NSH,34,72,35,33,68
7,8477960,Adrian Kempe,R,LAK,28,81,31,37,68
7,8478010,Brayden Point,C,TBL,28,82,30,38,68
7,8473512,Claude Giroux,R,OTT,36,78,27,41,68
7,8475692,Mats Zuccarello,R,MIN,37,68,11,57,68
7,8478449,Roope Hintz,C,DAL,28,82,35,32,67
7,8479542,Brandon Hagel,L,TBL,26,82,27,40,67
7,8476448,William Karlsson,C,VGK,31,77,26,41,67
7,8476346,Johnny Gaudreau,L,CBJ,31,71,18,49,67
7,8476456,Jonathan Huberdeau,C,CGY,31,78,11,56,67
7,8471214,Alex Ovechkin,L,WSH,39,75,37,29,66
7,8481540,Cole Caufield,R,MTL,23,76,36,30,66
7,8471215,Evgeni Malkin,C,PIT,38,71,29,37,66
7,8479343,Clayton Keller,R,UTA,26,76,28,38,66
7,8477409,Carter Verhaeghe,C,FLA,29,78,36,29,65
7,8476881,Tomas Hertl,C,VGK,31,76,29,36,65
7,8478440,Dylan Strome,C,WSH,27,73,29,36,65
7,8480208,Drake Batherson,R,OTT,26,82,20,45,65
7,8471685,Anze Kopitar,C,LAK,37,80,20,45,65
7,8480036,Miro Heiskanen,D,DAL,25,82,15,50,65
7,8473419,Brad Marchand,L,BOS,36,80,30,34,64
7,8481068,Yegor Sharangovich,C,CGY,26,78,25,39,64
7,8475158,Ryan O'Reilly,C,NSH,33,68,24,40,64
7,8479385,Jordan Kyrou,C,STL,26,73,23,41,64
7,8475913,Mark Stone,R,VGK,32,76,20,44,64
7,8480839,Rasmus Dahlin,D,BUF,24,69,14,50,64
7,8476389,Vincent Trocheck,C,NYR,31,77,27,36,63
7,8479999,Casey Mittelstadt,C,COL,26,81,22,41,63
7,8477504,Josh Morrissey,D,WPG,29,78,20,43,63
7,8477940,Nikolaj Ehlers,L,WPG,28,72,19,43,62
7,8474578,Erik Karlsson,D,PIT,34,77,15,47,62
7,8482699,Dylan Guenther,R,UTA,21,76,23,38,61
7,8477951,Nick Schmaltz,C,UTA,28,74,19,42,61
7,8476905,Chandler Stephenson,C,SEA,30,75,19,42,61
7,8478397,Rasmus Andersson,D,CGY,28,72,12,49,61
7,8475810,Bryan Rust,R,PIT,32,73,32,28,60
7,8479323,Adam Fox,D,NYR,26,76,13,47,60
7,8481528,Dylan Cozens,C,BUF,23,74,25,34,59
7,8477496,Elias Lindholm,C,BOS,30,77,21,38,59
7,8481711,Matias Maccelli,L,UTA,24,74,17,42,59
7,8476853,Morgan Rielly,D,TOR,30,72,7,52,59
7,8475786,Zach Hyman,L,EDM,32,77,32,26,58
7,8470613,Brent Burns,D,CAR,39,75,22,36,58
7,8478401,Pavel Zacha,C,BOS,27,78,20,38,58
7,8482113,Anton Lundell,C,FLA,23,77,26,31,57
7,8478975,Mason Marchment,L,DAL,29,78,21,36,57
7,8475169,Evander Kane,L,EDM,33,74,26,30,56
7,8480028,Morgan Frost,C,PHI,25,75,18,38,56
7,8479325,Charlie McAvoy,D,BOS,27,74,11,45,56
7,8475726,Tyler Toffoli,C,SJS,32,68,28,27,55
7,8483431,Logan Cooley,C,UTA,20,77,25,30,55
7,8476479,Phillip Danault,C,LAK,31,80,24,31,55
7,8476882,Teuvo Teravainen,L,CHI,30,68,22,33,55
7,8481577,Philip Tomasino,C,NSH,23,69,22,33,55
7,8482093,Seth Jarvis,C,CAR,22,71,21,34,55
7,8478873,Troy Terry,R,ANA,27,72,17,38,55
7,8477503,Max Domi,C,TOR,29,80,15,40,55
7,8478460,Zach Werenski,D,CBJ,27,81,12,43,55
7,8475794,Tyler Seguin,C,DAL,32,81,23,31,54
7,8476826,Yanni Gourde,C,SEA,33,72,20,34,54
7,8475753,Justin Faulk,D,STL,32,77,12,42,54
7,8482159,Tyson Foerster,R,PHI,22,75,27,26,53
7,8480039,Martin Necas,C,CAR,25,76,20,33,53
7,8474679,Gustav Nyquist,C,NSH,35,67,19,34,53
7,8481533,Trevor Zegras,C,ANA,23,76,19,34,53
7,8475798,Mikael Granlund,C,SJS,32,70,11,42,53
7,8483808,Andrei Kuzmenko,L,CGY,28,75,34,18,52
7,8478047,Michael Bunting,L,PIT,29,69,26,26,52
7,8484153,Leo Carlsson,C,ANA,20,69,26,26,52
7,8477476,Artturi Lehkonen,L,COL,29,80,25,27,52
7,8478519,Anthony Cirelli,C,TBL,27,82,25,27,52
7,8477935,Sam Bennett,C,FLA,28,79,19,33,52
7,8484166,Adam Fantilli,C,CBJ,20,69,19,33,52
7,8478396,Noah Hanifin,D,VGK,27,64,14,38,52
7,8478055,Gustav Forsling,D,FLA,28,74,14,38,52
7,8482667,William Eklund,L,SJS,22,66,22,29,51
7,8477986,Brandon Montour,D,SEA,30,75,21,30,51
7,8478856,Conor Garland,R,VAN,28,74,20,31,51
7,8479992,Michael Rasmussen,C,DET,25,80,20,31,51
7,8480798,Philipp Kurashev,C,CHI,25,70,17,34,51
7,8477429,Andrew Copp,C,DET,30,81,17,34,51
7,8478444,Brock Boeser,R,VAN,27,76,28,22,50
7,8477511,Anthony Mantha,R,CGY,30,75,25,25,50
7,8479400,Pierre-Luc Dubois,L,WSH,26,66,21,29,50
7,8482109,Alexis Lafrenière,L,NYR,23,69,20,30,50
7,8475287,Erik Haula,L,NJD,33,65,18,32,50
7,8478407,Vince Dunn,D,SEA,28,77,12,38,50
7,8475191,Reilly Smith,R,NYR,33,67,25,24,49
7,8480188,Fabian Zetterlund,L,SJS,25,60,23,26,49
7,8476399,Blake Coleman,C,CGY,33,78,22,27,49
7,8477407,Anthony Duclair,L,NYI,29,77,22,27,49
7,8479525,Ross Colton,C,COL,28,81,21,28,49
7,8477451,Ryan Hartman,R,MIN,30,70,18,31,49
7,8482720,Matthew Knies,L,TOR,22,79,18,31,49
7,8475745,Charlie Coyle,C,BOS,32,80,16,33,49
7,8476869,Brady Skjei,D,NSH,30,71,15,34,49
7,8479425,Filip Hronek,D,VAN,27,74,11,38,49
7,8476875,Mike Matheson,D,MTL,30,76,9,40,49
7,8479410,Mikhail Sergachev,D,UTA,26,75,8,41,49
7,8477495,Seth Jones,D,CHI,30,72,8,41,49
7,8475784,Jeff Skinner,C,EDM,32,77,24,24,48
7,8477998,Warren Foegele,L,LAK,28,78,23,25,48
7,8477456,J.T. Compher,L,DET,29,80,20,28,48
7,8480015,Owen Tippett,R,PHI,25,75,30,17,47
7,8482740,Wyatt Johnston,C,DAL,21,82,24,23,47
7,8480064,Josh Norris,C,OTT,25,77,24,23,47
7,8475714,Calle Jarnkrok,C,TOR,33,79,24,23,47
7,8475151,Kyle Palmieri,C,NYI,33,78,22,25,47
7,8482665,Matty Beniers,C,SEA,22,80,22,25,47
7,8475768,Jaden Schwartz,C,SEA,32,74,22,25,47
7,8481560,Arthur Kaliyev,R,LAK,23,78,22,25,47
7,8477498,Darnell Nurse,D,EDM,29,75,14,33,47
7,8475167,Victor Hedman,D,TBL,34,78,12,35,47
7,8482684,Luke Hughes,D,NJD,21,68,6,41,47
7,8475799,Nino Niederreiter,R,WPG,32,75,26,20,46
7,8478474,Lawson Crouse,L,UTA,27,75,24,22,46
7,8480802,Ryan McLeod,C,BUF,25,69,21,25,46
7,8475168,Matt Duchene,C,DAL,33,82,19,27,46
7,8477479,Tyler Bertuzzi,L,CHI,29,73,19,27,46
7,8477494,Jonathan Drouin,L,COL,29,82,8,38,46
7,8475314,Anders Lee,L,NYI,34,74,24,21,45
7,8477955,Jared McCann,L,SEA,28,70,23,22,45
7,8478462,Nicolas Roy,C,VGK,27,73,22,23,45
7,8477426,Nicholas Paul,L,TBL,29,81,21,24,45
7,8478466,Daniel Sprong,R,VAN,27,71,18,27,45
7,8476792,Torey Krug,D,STL,33,71,13,32,45
7,8482671,Owen Power,D,BUF,22,70,9,36,45
7,8478498,Jake DeBrusk,L,VAN,28,68,25,19,44
7,8482702,Logan Stankoven,C,DAL,21,80,22,22,44
7,8476292,Ondrej Palat,L,NJD,33,72,19,25,44
7,8481624,Ilya Mikheyev,R,CHI,30,62,17,27,44
7,8477964,Ivan Barbashev,C,VGK,29,77,12,32,44
7,8475763,Kevin Hayes,R,PIT,32,74,12,32,44
7,8477346,MacKenzie Weegar,D,CGY,30,73,7,37,44
7,8480849,Barrett Hayton,C,UTA,24,71,22,21,43
7,8482097,Jack Quinn,R,BUF,23,61,20,23,43
7,8482110,Dawson Mercer,C,NJD,23,73,18,25,43
7,8480459,Pius Suter,C,VAN,28,67,18,25,43
7,8473994,Jamie Benn,L,DAL,35,82,17,26,43
7,8484145,Zach Benson,L,BUF,19,67,14,29,43
7,8474563,Drew Doughty,D,LAK,35,73,13,30,43
7,8474586,Jordan Eberle,R,SEA,34,77,13,30,43
7,8476419,Jean-Gabriel Pageau,C,NYI,32,74,9,34,43
7,8477447,Shea Theodore,D,VGK,29,67,6,37,43
7,8481542,Moritz Seider,D,DET,23,74,6,37,43
7,8478366,Frank Vatrano,R,ANA,30,71,25,17,42
7,8477497,Sean Monahan,C,CBJ,30,73,19,23,42
7,8477416,Oliver Bjorkstrand,R,SEA,29,72,19,23,42
7,8481596,Shane Pinto,C,OTT,24,74,17,25,42
7,8474102,David Perron,L,OTT,36,73,16,26,42
7,8476880,Tom Wilson,R,WSH,30,71,16,26,42
7,8479345,Jakob Chychrun,D,WSH,26,70,13,29,42
7,8471724,Kris Letang,D,PIT,37,78,10,32,42
7,8481604,Pavel Dorofeyev,L,VGK,24,71,19,22,41
7,8483515,Juraj Slafkovsky,L,MTL,20,72,12,29,41
7,8478542,Evan Rodrigues,C,FLA,31,77,12,29,41
7,8476958,Jaccob Slavin,D,CAR,30,72,6,35,41
7,8476906,Shayne Gostisbehere,D,CAR,31,78,5,36,41
7,8474641,Adam Henrique,C,EDM,34,70,18,22,40
7,8482745,Mason McTavish,C,ANA,21,66,17,23,40
7,8474150,Mikael Backlund,C,CGY,35,72,13,27,40
7,8477932,Aaron Ekblad,D,FLA,28,70,13,27,40
7,8476979,Erik Gustafsson,D,DET,32,74,9,31,40
7,8480434,Sean Durzi,D,UTA,26,70,8,32,40
7,8480009,Eeli Tolvanen,R,SEA,25,74,21,18,39
7,8482146,Luke Evangelista,R,NSH,22,66,19,20,39
7,8477444,Andre Burakovsky,L,SEA,29,74,16,23,39
7,8482092,Ridly Greig,C,OTT,22,79,16,23,39
7,8476458,Ryan Strome,C,ANA,31,69,15,24,39
7,8478233,Andrew Mangiapane,L,WSH,28,74,13,26,39
7,8478469,Thomas Chabot,D,OTT,27,74,9,30,39
7,8481546,Cam York,D,PHI,23,70,9,30,39
7,8474590,John Carlson,D,WSH,34,68,3,36,39
7,8473986,Alex Killorn,L,ANA,35,68,25,13,38
7,8476438,Brandon Saad,L,STL,32,61,20,18,38
7,8480014,Gabriel Vilardi,C,WPG,25,63,18,20,38
7,8475793,Ryan Johansen,C,PHI,32,69,18,20,38
7,8478042,Viktor Arvidsson,R,EDM,31,74,16,22,38
7,8478438,Tommy Novak,C,NSH,27,68,14,24,38
7,8480220,Noah Cates,L,PHI,25,77,13,25,38
7,8481581,Thomas Harley,D,DAL,23,80,13,25,38
7,8478458,Jack Roslovic,C,CAR,27,70,10,28,38
7,8475218,Mattias Ekholm,D,EDM,34,72,9,29,38
7,8475764,Cam Fowler,D,ANA,33,68,5,33,38
7,8479619,Michael Carcone,L,UTA,28,67,22,15,37
7,8476483,Rickard Rakell,R,PIT,31,73,20,17,37
7,8479365,Trent Frederic,C,BOS,26,74,17,20,37
7,8482705,Cole Sillinger,C,CBJ,21,66,16,21,37
7,8481582,Nicholas Robertson,L,TOR,23,76,15,22,37
7,8476897,Oskar Sundqvist,C,STL,30,64,13,24,37
7,8476462,Dougie Hamilton,D,NJD,31,68,12,25,37
7,8474565,Alex Pietrangelo,D,VGK,34,65,9,28,37
7,8481703,Valtteri Puustinen,R,PIT,25,60,8,29,37
7,8483490,Pavel Mintyukov,D,ANA,21,72,5,32,37
7,8481186,Logan O'Connor,R,COL,28,80,21,15,36
7,8482055,Drew O'Connor,L,PIT,26,72,20,16,36
7,8480113,Alex Iafallo,L,WPG,31,68,15,21,36
7,8476461,Sean Couturier,C,PHI,32,76,14,22,36
7,8478038,Devon Toews,D,COL,30,69,9,27,36
7,8480185,Eetu Luostarinen,C,FLA,26,74,15,20,35
7,8474149,Evgenii Dadonov,R,DAL,35,79,14,21,35
7,8481523,Kirby Dach,C,MTL,23,64,14,21,35
7,8475193,Tomas Tatar,L,NJD,34,69,13,22,35
7,8482660,Kent Johnson,C,CBJ,22,66,12,23,35
7,8476931,Jake McCabe,D,TOR,31,70,4,31,35
7,8476892,Colton Parayko,D,STL,31,67,3,32,35
7,8476432,Boone Jenner,C,CBJ,31,67,19,15,34
7,8482175,JJ Peterka,R,BUF,22,60,16,18,34
7,8471698,T.J. Oshie,R,WSH,38,66,16,18,34
7,8478472,Mathieu Joseph,R,STL,27,67,15,19,34
7,8481535,Nils Hoglander,L,VAN,24,65,15,19,34
7,8479987,Morgan Geekie,C,BOS,26,80,15,19,34
7,8480797,Joel Farabee,L,PHI,24,75,14,20,34
7,8477021,Alex Kerfoot,C,UTA,30,75,13,21,34
7,8481554,Kaapo Kakko,R,NYR,23,72,13,21,34
7,8481618,Alex Newhook,C,MTL,23,75,12,22,34
7,8474716,Jared Spurgeon,D,MIN,35,79,11,23,34
7,8481606,Jordan Spence,D,LAK,23,61,11,23,34
7,8480078,Filip Chytil,C,NYR,25,67,10,24,34
7,8478046,Danton Heinen,L,VAN,29,69,10,24,34
7,8476917,Adam Pelech,D,NYI,30,77,4,30,34
7,8475722,Jason Zucker,L,BUF,32,64,22,11,33
7,8476981,Josh Anderson,R,MTL,30,73,21,12,33
7,8470621,Corey Perry,R,EDM,39,70,13,20,33
7,8475181,Nick Leddy,D,STL,33,70,10,23,33
7,8476923,Damon Severson,D,CBJ,30,79,9,24,33
7,8478463,Anthony Beauvillier,L,PIT,27,65,7,26,33
7,8482133,Thomas Bordeleau,C,SJS,22,65,5,28,33
7,8482089,Jake Neighbours,L,STL,22,70,23,9,32
7,8474053,Logan Couture,C,SJS,35,64,16,16,32
7,8480829,Jesperi Kotkaniemi,C,CAR,24,66,14,18,32
7,8479591,Michael Eyssimont,C,TBL,28,80,14,18,32
7,8476392,Adam Lowry,C,WPG,31,65,13,19,32
7,8479996,Cody Glass,C,NSH,25,57,10,22,32
7,8482122,Brock Faber,D,MIN,22,74,9,23,32
7,8482259,Bobby McMann,C,TOR,28,75,21,10,31
7,8482117,Lukas Reichel,L,CHI,22,65,18,13,31
7,8481580,Connor McMichael,C,WSH,23,60,17,14,31
7,8476474,Stefan Noesen,R,NJD,31,59,13,18,31
7,8476885,Jacob Trouba,D,NYR,30,74,12,19,31
7,8479353,Brett Howden,C,VGK,26,67,10,21,31
7,8483565,Nick Blankenburg,D,NSH,26,71,9,22,31
7,8483482,Tristan Luneau,D,ANA,20,64,8,23,31
7,8477948,Travis Sanheim,D,PHI,28,64,7,24,31
7,8476854,Hampus Lindholm,D,BOS,30,72,4,27,31
7,8480873,Rasmus Sandin,D,WSH,24,60,2,29,31
7,8480893,Kirill Marchenko,R,CBJ,24,67,18,12,30
7,8475848,Brendan Gallagher,R,MTL,32,71,17,13,30
7,8478413,Jordan Greenway,L,BUF,27,61,17,13,30
7,8475760,Nick Bjugstad,C,UTA,32,71,16,14,30
7,8481553,Bobby Brink,R,PHI,23,66,16,14,30
7,8477987,Ryan Donato,C,CHI,28,60,14,16,30
7,8482149,Cole Perfetti,C,WPG,22,69,11,19,30
7,8481656,Aliaksei Protas,C,WSH,23,64,9,21,30
7,8477488,Brett Pesce,D,NJD,30,66,7,23,30
7,8475200,Dmitry Orlov,D,CAR,33,76,6,24,30
7,8477969,Marcus Pettersson,D,PIT,28,78,2,28,30
7,8482655,J.J. Moser,D,TBL,24,75,2,28,30
7,8473422,Nick Foligno,L,CHI,37,56,16,13,29
7,8477508,Curtis Lazar,C,NJD,29,63,16,13,29
7,8476480,Vladislav Namestnikov,C,WPG,32,65,13,16,29
7,8477919,Frederick Gaudreau,C,MIN,31,55,13,16,29
7,8480748,Kiefer Sherwood,L,VAN,29,65,10,19,29
7,8479293,Brandon Tanev,L,SEA,33,62,10,19,29
7,8476872,Scott Laughton,C,PHI,30,74,9,20,29
7,8482101,Danil Gushchin,L,SJS,22,52,8,21,29
7,8477406,Mattias Janmark,C,EDM,32,63,16,12,28
7,8482475,Yegor Chinakhov,R,CBJ,23,66,14,14,28
7,8478115,Pierre Engvall,L,NYI,28,71,13,15,28
7,8476921,Jordan Martinook,L,CAR,32,60,11,17,28
7,8482624,Daniil Miromanov,D,CGY,27,67,10,18,28
7,8483524,Shane Wright,C,SEA,20,64,10,18,28
7,8478432,Christian Fischer,R,DET,27,76,9,19,28
7,8476422,Mike Reilly,D,NYI,31,74,8,20,28
7,8476463,Jonas Brodin,D,MIN,31,79,7,21,28
7,8476902,Esa Lindell,D,DAL,30,81,6,22,28
7,8479398,Samuel Girard,D,COL,26,64,4,24,28
7,8478500,Ivan Provorov,D,CBJ,27,76,3,25,28
7,8477353,Tyler Motte,C,DET,29,70,18,9,27
7,8480789,Oliver Wahlstrom,R,NYI,24,72,15,12,27
7,8477947,Sonny Milano,L,WSH,28,61,13,14,27
7,8473533,Jordan Staal,C,CAR,36,62,13,14,27
7,8478057,Dakota Joshua,C,VAN,28,66,12,15,27
7,8484203,Bradly Nadeau,L,CAR,19,62,12,15,27
7,8477953,Kasperi Kapanen,R,STL,28,66,12,15,27
7,8483445,Cutter Gauthier,L,ANA,20,62,9,18,27
7,8478891,Mason Appleton,C,WPG,28,67,7,20,27
7,8480145,Neal Pionk,D,WPG,29,74,4,23,27
7,8479976,Juuso Valimaki,D,UTA,26,65,3,24,27
7,8478020,Michael Amadio,C,OTT,28,73,16,10,26
7,8477425,Miles Wood,L,COL,29,76,14,12,26
7,8477952,Robby Fabbri,C,ANA,28,67,14,12,26
7,8479661,Tanner Jeannot,L,LAK,27,71,14,12,26
7,8481093,Rafael Harvey-Pinard,L,MTL,25,54,13,13,26
7,8480835,Jack Drury,C,CAR,24,62,12,14,26
7,8475225,Craig Smith,C,CHI,35,57,12,14,26
7,8483505,Matthew Poitras,C,BOS,20,72,11,15,26
7,8483457,Lane Hutson,D,MTL,20,64,11,15,26
7,8482062,Cole Smith,L,NSH,29,56,11,15,26
7,8479941,Justin Danforth,R,CBJ,31,62,11,15,26
7,8480068,Ryan Poehling,C,PHI,25,72,10,16,26
7,8479315,Joey Anderson,R,CHI,26,50,10,16,26
7,8477839,Conor Sheary,L,TBL,32,82,6,20,26
7,8476331,Dylan DeMelo,D,WPG,31,68,4,22,26
7,8473507,Jeff Petry,D,DET,37,69,3,23,26
7,8475233,David Savard,D,MTL,34,72,3,23,26
7,8481481,Blake Lizotte,C,PIT,27,60,17,8,25
7,8478109,Victor Olofsson,L,VGK,29,66,12,13,25
7,8475791,Taylor Hall,L,CHI,33,63,11,14,25
7,8479339,Patrik Laine,L,CBJ,26,63,10,15,25
7,8479390,Taylor Raddysh,R,WSH,26,61,10,15,25
7,8480855,Jack McBain,C,UTA,24,60,10,15,25
7,8482105,Jake Sanderson,D,OTT,22,77,9,16,25
7,8480003,Jesper Boqvist,C,FLA,26,64,9,16,25
7,8482803,Olen Zellweger,D,ANA,21,71,9,16,25
7,8476927,Teddy Blueger,C,VAN,30,67,8,17,25
7,8476925,Colton Sissons,C,NSH,31,67,8,17,25
7,8480871,Adam Boqvist,D,FLA,24,65,8,17,25
7,8480336,Sean Walker,D,CAR,30,69,4,21,25
7,8479983,Mario Ferraro,D,SJS,26,66,4,21,25
7,8480043,Timothy Liljegren,D,TOR,25,72,2,23,25
7,8482125,Alexander Holtz,R,VGK,22,71,12,12,24
7,8482679,Matt Coronato,R,CGY,22,64,10,14,24
7,8477015,Connor Brown,R,EDM,30,63,10,14,24
7,8478421,A.J. Greer,L,FLA,28,61,10,14,24
7,8482074,Connor Zary,C,CGY,23,58,9,15,24
7,8482784,Zach Dean,C,STL,21,46,9,15,24
7,8483468,Jiri Kulich,C,BUF,20,58,8,16,24
7,8481521,Ronnie Attard,D,PHI,25,60,7,17,24
7,8482712,Oskar Olausson,R,COL,22,73,6,18,24
7,8480222,Sebastian Aho,D,PIT,28,79,5,19,24
7,8476312,Josh Manson,D,COL,33,61,1,23,24
7,8479316,Luke Kunin,C,SJS,27,56,13,10,23
7,8479393,Noah Gregor,C,OTT,26,73,10,13,23
7,8479368,Max Jones,L,BOS,26,60,10,13,23
7,8481704,Juuso Parssinen,C,NSH,23,60,9,14,23
7,8476918,Jimmy Vesey,L,NYR,31,68,9,14,23
7,8476889,Radek Faksa,C,STL,30,60,9,14,23
7,8482749,Joshua Roy,R,MTL,21,66,8,15,23
7,8478133,Jake Evans,C,MTL,28,68,7,16,23
7,8480848,Ty Dellandrea,C,SJS,24,51,7,16,23
7,8482079,Marco Rossi,C,MIN,23,59,6,17,23
7,8476457,Adam Larsson,D,SEA,32,72,6,17,23
7,8476467,Jamie Oleksiak,D,SEA,32,70,6,17,23
7,8474189,Lars Eller,C,PIT,35,67,5,18,23
7,8477220,Nate Schmidt,D,FLA,33,68,5,18,23
7,8481014,Alexander Romanov,D,NYI,24,77,4,19,23
7,8477979,Nicolas Aube-Kubel,R,BUF,28,61,4,19,23
7,8480878,Nils Lundkvist,D,DAL,24,80,1,22,23
7,8476878,Zemgus Girgensons,L,TBL,30,79,17,5,22
7,8481601,Simon Holmstrom,R,NYI,23,69,14,8,22
7,8476278,Colin Blackwell,C,DAL,31,76,12,10,22
7,8479328,Julien Gauthier,R,NYI,27,62,12,10,22
7,8479066,Ryan Lomberg,L,CGY,30,62,12,10,22
7,8475231,Casey Cizikas,C,NYI,33,71,11,11,22
7,8481028,Martin Pospisil,C,CGY,25,61,11,11,22
7,8478434,Keegan Kolesar,R,VGK,27,59,10,12,22
7,8479402,Jake Bean,D,CGY,26,69,10,12,22
7,8475149,Marcus Johansson,L,MIN,34,60,7,15,22
7,8480205,Emil Bemstrom,C,PIT,25,59,7,15,22
7,8475855,Jesper Fast,R,CAR,33,55,7,15,22
7,8480817,K'Andre Miller,D,NYR,24,72,6,16,22
7,8482809,Jackson Blake,R,CAR,21,64,6,16,22
7,8476469,Joel Armia,R,MTL,31,67,6,16,22
7,8477435,Ryan Graves,D,PIT,29,73,6,16,22
7,8483495,Simon Nemec,D,NJD,20,56,4,18,22
7,8480049,Dylan Samberg,D,WPG,25,64,3,19,22
7,8475462,Radko Gudas,D,ANA,34,63,2,20,22
7,8482087,Kaiden Guhle,D,MTL,22,69,1,21,22
7,8478508,Yakov Trenin,C,MIN,27,61,15,6,21
7,8477478,William Carrier,L,CAR,30,51,12,9,21
7,8480289,Morgan Barron,C,WPG,26,55,12,9,21
7,8480813,Joe Veleno,C,DET,24,79,11,10,21
7,8478211,Dryden Hunt,L,CGY,29,58,10,11,21
7,8479414,Nathan Bastian,R,NJD,27,56,9,12,21
7,8476525,Colin Miller,D,WPG,32,71,7,14,21
7,8481522,Peyton Krebs,C,BUF,23,66,6,15,21
7,8482245,Artem Zub,D,OTT,29,77,5,16,21
7,8477506,Ryan Pulock,D,NYI,30,73,3,18,21
7,8477507,Nikita Zadorov,D,BOS,29,66,3,18,21
7,8480035,Henri Jokiharju,D,BUF,25,63,3,18,21
7,8480073,Erik Brannstrom,D,COL,25,68,3,18,21
7,8480807,Mattias Samuelsson,D,BUF,24,58,1,20,21
7,8476822,Luke Glendening,C,TBL,35,76,14,6,20
7,8478569,Noel Acciari,C,PIT,33,59,12,8,20
7,8480144,David Kampf,C,TOR,29,78,11,9,20
7,8475220,Marcus Foligno,L,MIN,33,59,10,10,20
7,8479439,Jacob MacDonald,D,COL,31,49,9,11,20
7,8479351,Sam Steel,C,DAL,26,80,8,12,20
7,8477450,Jason Dickinson,C,CHI,29,63,8,12,20
7,8477989,Christian Dvorak,C,MTL,28,65,7,13,20
7,8482142,Jamie Drysdale,D,PHI,22,60,6,14,20
7,8483499,Liam Ohgren,L,MIN,20,59,6,14,20
7,8475171,Oliver Ekman-Larsson,D,TOR,33,66,5,15,20
7,8479982,Conor Timmins,D,TOR,26,64,5,15,20
7,8482073,Braden Schneider,D,NYR,23,59,3,17,20
7,8480025,MacKenzie Entwistle,R,FLA,25,64,13,6,19
7,8480995,Pontus Holmberg,R,TOR,25,69,10,9,19
7,8481716,Dmitri Voronkov,L,CBJ,24,53,10,9,19
7,8476960,Andreas Athanasiou,C,CHI,30,49,6,13,19
7,8477392,Hudson Fasching,R,NYI,29,69,5,14,19
7,8478882,Vladislav Gavrikov,D,LAK,29,65,4,15,19
7,8479371,Dante Fabbro,D,NSH,26,68,4,15,19
7,8475324,Nick Jensen,D,OTT,34,69,4,15,19
7,8475188,Brayden McNabb,D,VGK,33,51,4,15,19
7,8479998,Mikey Anderson,D,LAK,25,60,3,16,19
7,8478851,Alexandre Carrier,D,NSH,28,71,2,17,19
7,8479639,Dylan Coghlan,D,WPG,26,58,2,17,19
7,8480281,Alexey Toropchenko,R,STL,25,65,12,6,18
7,8474715,Cam Atkinson,R,TBL,35,81,11,7,18
7,8482077,Dylan Holloway,L,EDM,23,55,10,8,18
7,8479718,Alex Barré-Boulet,C,MTL,27,54,10,8,18
7,8481477,Nico Sturm,C,SJS,29,56,10,8,18
7,8481032,Paul Cotter,C,NJD,25,61,9,9,18
7,8478013,Jake Walman,D,SJS,28,66,9,9,18
7,8482737,Zack Bolduc,C,STL,21,59,7,11,18
7,8477369,Carson Soucy,D,VAN,30,68,7,11,18
7,8477903,Garnet Hathaway,R,PHI,33,62,7,11,18
7,8478585,Derek Ryan,C,EDM,38,65,6,12,18
7,8479442,Troy Stecher,D,EDM,30,55,6,12,18
7,8482176,Wyatt Kaiser,D,CHI,22,60,5,13,18
7,8481441,Joe Snively,C,DET,28,57,5,13,18
7,8474151,Ryan McDonagh,D,TBL,35,77,4,14,18
7,8478911,Matt Roy,D,WSH,29,64,3,15,18
7,8481019,David Gustafsson,C,WPG,24,46,3,15,18
7,8476429,Scott Mayfield,D,NYI,32,68,1,17,18
7,8480246,Nick Perbix,D,TBL,26,73,1,17,18
7,8476967,Brett Kulak,D,EDM,30,65,0,18,18
7,8475842,Sam Carrick,C,NYR,32,61,11,6,17
7,8473453,Trevor Lewis,C,LAK,37,74,10,7,17
7,8479336,Carl Grundstrom,R,SJS,27,50,10,7,17
7,8476873,Mark Jankowski,C,NSH,30,53,8,9,17
7,8482166,Shakir Mukhamadullin,D,SJS,22,56,7,10,17
7,8481013,Jonatan Berggren,R,DET,24,55,7,10,17
7,8483491,Ivan Miroshnichenko,L,WSH,20,59,6,11,17
7,8480074,Alexandre Texier,C,STL,25,56,6,11,17
7,8476329,Travis Boyd,C,MIN,31,62,6,11,17
7,8479026,Philippe Myers,D,TOR,27,44,5,12,17
7,8470600,Ryan Suter,D,STL,39,54,5,12,17
7,8477380,Jonny Brodzinski,C,NYR,31,55,5,12,17
7,8476879,Cody Ceci,D,EDM,31,68,4,13,17
7,8476891,Matt Grzelcyk,D,PIT,30,74,2,15,17
7,8479324,Ryan Lindgren,D,NYR,26,61,2,15,17
7,8478970,Jalen Chatfield,D,CAR,28,72,9,7,16
7,8478043,Sam Lafferty,C,BUF,29,60,8,8,16
7,8477446,Michael McCarron,R,NSH,29,57,8,8,16
7,8480021,Jack Studnicka,C,LAK,25,59,8,8,16
7,8480796,Martin Fehervary,D,WSH,25,56,7,9,16
7,8479359,Beck Malenstyn,L,BUF,26,49,7,9,16
7,8474567,Zach Bogosian,D,MIN,34,61,5,11,16
7,8478443,Brandon Carlo,D,BOS,28,62,5,11,16
7,8473563,Nicklas Backstrom,C,WSH,37,54,4,12,16
7,8481518,Nolan Foote,L,NJD,24,39,3,13,16
7,8481708,Zac Jones,D,NYR,24,47,3,13,16
7,8478507,John Marino,D,UTA,27,66,2,14,16
7,8481059,Scott Perunovich,D,STL,26,60,2,14,16
7,8480860,Kevin Bahl,D,CGY,24,59,2,14,16
7,8478399,Jonas Siegenthaler,D,NJD,27,59,1,15,16
7,8477365,Connor Clifton,D,BUF,29,54,0,16,16
7,8480762,Eric Robinson,L,CAR,29,53,10,5,15
7,8476374,Sean Kuraly,C,CBJ,31,56,9,6,15
7,8480252,Cole Guttman,C,CHI,25,43,9,6,15
7,8482157,Will Cuylle,L,NYR,22,59,8,7,15
7,8475343,Nic Dowd,C,WSH,34,66,7,8,15
7,8477499,Rasmus Ristolainen,D,PHI,30,59,7,8,15
7,8482111,Justin Barron,D,MTL,23,58,6,9,15
7,8479370,Tyson Jost,C,CAR,26,52,6,9,15
7,8476867,Brendan Gaunce,C,MIN,30,44,6,9,15
7,8481751,Lukas Rousek,R,BUF,25,37,6,9,15
7,8481568,Alex Vlasic,D,CHI,23,52,5,10,15
7,8480806,Isac Lundestrom,C,ANA,25,71,5,10,15
7,8480157,Calle Rosen,D,COL,30,52,5,10,15
7,8475208,Brian Dumoulin,D,ANA,33,61,5,10,15
7,8480070,Ian Mitchell,D,BOS,25,50,5,10,15
7,8483763,Maksymilian Szuber,D,UTA,22,36,5,10,15
7,8483466,Kevin Korchinski,D,CHI,20,50,4,11,15
7,8478840,Will Borgen,D,SEA,28,63,2,13,15
7,8475179,Dmitry Kulikov,D,FLA,34,64,2,13,15
7,8479980,Nicolas Hague,D,VGK,26,54,2,13,15
7,8476874,Olli Maatta,D,DET,30,65,2,13,15
7,8479372,Josh Mahura,D,SEA,26,54,2,13,15
7,8482964,Arber Xhekaj,D,MTL,23,46,2,13,15
7,8474673,TJ Brodie,D,CHI,34,61,1,14,15
7,8476624,Barclay Goodrow,C,SJS,31,56,8,6,14
7,8479520,Brandon Duhaime,R,WSH,27,55,8,6,14
7,8481517,Brett Leason,R,ANA,25,58,7,7,14
7,8471817,Ryan Reaves,R,TOR,37,57,7,7,14
7,8477018,Ben Hutton,D,VGK,31,49,6,8,14
7,8476994,Vinnie Hinostroza,C,NSH,30,49,5,9,14
7,8480011,Klim Kostin,C,SJS,25,53,4,10,14
7,8475279,Ben Chiarot,D,DET,33,70,4,10,14
7,8481641,Joel Kiviranta,L,COL,28,71,4,10,14
7,8482634,Alex Steeves,C,TOR,25,62,3,11,14
7,8481617,Vasily Podkolzin,R,VAN,23,44,3,11,14
7,8478136,Jake Middleton,D,MIN,28,74,2,12,14
7,8482192,Isaak Phillips,D,CHI,23,49,2,12,14
7,8471677,Jack Johnson,D,CBJ,37,68,2,12,14
7,8475718,Justin Holl,D,DET,32,59,1,13,14
7,8478416,Erik Cernak,D,TBL,27,75,0,14,14
7,8482762,Simon Edvinsson,D,DET,21,55,8,5,13
7,8479944,Zach Aston-Reese,C,VGK,30,57,8,5,13
7,8474034,Pat Maroon,L,CHI,36,50,8,5,13
7,8481524,Bowen Byram,D,BUF,23,52,7,6,13
7,8480448,Parker Kelly,L,COL,25,74,5,8,13
7,8482451,Mikael Pyyhtia,L,CBJ,23,35,5,8,13
7,8480891,Michael Kesselring,D,UTA,24,47,4,9,13
7,8474013,Ian Cole,D,UTA,35,56,4,9,13
7,8475177,Calvin de Haan,D,COL,33,39,4,9,13
7,8481567,Henry Thrun,D,SJS,23,46,2,11,13
7,8471709,Marc-Edouard Vlasic,D,SJS,37,66,1,12,13
7,8483460,David Jiricek,D,CBJ,21,64,0,13,13
7,8482155,Alex Laferriere,R,LAK,23,66,9,3,12
7,8483493,Frank Nazar,C,CHI,20,52,8,4,12
7,8478831,Kevin Stenlund,C,UTA,28,55,7,5,12
7,8476442,Matt Nieto,L,PIT,32,55,7,5,12
7,8474574,Tyler Myers,D,VAN,34,66,6,6,12
7,8482148,Hendrix Lapierre,C,WSH,22,49,5,7,12
7,8475790,Erik Gudbranson,D,CBJ,32,76,4,8,12
7,8480727,Zach Whitecloud,D,VGK,28,48,3,9,12
7,8482807,Ethan Del Mastro,D,CHI,21,52,3,9,12
7,8480058,Pierre-Olivier Joseph,D,STL,25,52,3,9,12
7,8481537,Nikita Okhotiuk,D,CGY,24,56,3,9,12
7,8476441,Joel Edmundson,D,LAK,31,46,3,9,12
7,8478451,Ethan Bear,D,WSH,27,53,2,10,12
7,8479369,Andrew Peeke,D,BOS,26,63,2,10,12
7,8475690,Chris Tanev,D,TOR,35,54,1,11,12
7,8474166,Alec Martinez,D,CHI,37,47,1,11,12
7,8478178,Darren Raddysh,D,TBL,28,67,0,12,12
7,8479344,Jesse Puljujarvi,R,PIT,26,40,6,5,11
7,8476934,Brock McGinn,L,ANA,30,44,6,5,11
7,8480845,Rasmus Kupari,C,WPG,24,45,6,5,11
7,8480980,Connor Dewar,C,TOR,25,75,5,6,11
7,8480192,Johnathan Kovacevic,D,NJD,27,55,5,6,11
7,8482141,Lukas Cormier,D,VGK,22,30,5,6,11
7,8481161,Jake Christiansen,D,CBJ,25,48,4,7,11
7,8482067,Connor Mackey,D,NYR,28,66,4,7,11
7,8482652,Walker Duehr,R,CGY,27,40,4,7,11
7,8479968,Vinni Lettieri,C,BOS,29,45,4,7,11
7,8479543,Michael Pezzetta,L,MTL,26,55,4,7,11
7,8478452,Caleb Jones,D,LAK,27,55,3,8,11
7,8481701,Santeri Hatakka,D,NJD,23,47,3,8,11
7,8478468,Jeremy Lauzon,D,NSH,27,51,2,9,11
7,8475455,Brenden Dillon,D,NJD,34,52,2,9,11
7,8480834,Ty Emberson,D,SJS,24,41,2,9,11
7,8482095,Tyler Kleven,D,OTT,22,45,1,10,11
7,8481598,Philip Broberg,D,EDM,23,44,1,10,11
7,8479348,Kale Clague,D,BUF,26,45,0,11,11
7,8477573,Nathan Walker,L,STL,30,46,7,3,10
7,8476988,Matt Benning,D,SJS,30,61,5,5,10
7,8477938,Haydn Fleury,D,WPG,28,40,5,5,10
7,8481532,Alex Turcotte,C,LAK,23,46,5,5,10
7,8481550,Adam Beckman,L,NJD,23,35,5,5,10
7,8482496,Nils Aman,C,VAN,24,34,5,5,10
7,8477505,Alexander Wennberg,C,SJS,30,41,4,6,10
7,8479291,Kevin Rooney,C,CGY,31,51,4,6,10
7,8481527,Kaedan Korczak,D,VGK,23,38,3,7,10
7,8483619,Filip Roos,D,OTT,25,35,3,7,10
7,8474090,Brendan Smith,D,DAL,35,79,3,7,10
7,8482744,James Malatesta,L,CBJ,21,41,2,8,10
7,8477335,Kyle Burroughs,D,LAK,29,42,2,8,10
7,8481600,Tobias Bjornfot,D,FLA,23,40,2,8,10
7,8479986,Kole Lind,R,DAL,26,47,2,8,10
7,8482730,Brandt Clarke,D,LAK,21,40,1,9,10
7,8477845,Trevor van Riemsdyk,D,WSH,33,57,1,9,10
7,8477034,Jaycob Megna,D,FLA,32,47,1,9,10
7,8477462,Robert Hagg,D,VGK,29,26,0,10,10
7,8476858,Phillip Di Giuseppe,L,VAN,31,44,7,2,9
7,8479362,Riley Tufte,L,BOS,26,28,7,2,9
7,8480355,Mark Kastelic,C,BOS,25,54,4,5,9
7,8482659,Josh Doan,R,UTA,22,49,3,6,9
7,8477070,Liam O'Brien,C,UTA,30,59,3,6,9
7,8477962,Brendan Lemieux,L,CAR,28,31,3,6,9
7,8480001,Urho Vaakanainen,D,ANA,25,58,2,7,9
7,8480990,Declan Chisholm,D,MIN,24,46,2,7,9
7,8474568,Luke Schenn,D,NSH,35,36,2,7,9
7,8479985,Cale Fleury,D,SEA,26,26,2,7,9
7,8479994,Jaret Anderson-Dolan,C,WPG,25,35,2,7,9
7,8480292,Carson Meyer,R,ANA,27,35,2,7,9
7,8481541,Samuel Bolduc,D,NYI,24,39,2,7,9
7,8476913,Devin Shore,C,MIN,30,36,2,7,9
7,8483630,Pavol Regenda,L,ANA,25,26,2,7,9
7,8481178,Egor Zamula,D,PHI,24,56,1,8,9
7,8474612,Travis Hamonic,D,OTT,34,44,1,8,9
7,8479671,Mathieu Olivier,R,CBJ,27,47,7,1,8
7,8482859,Zack Ostapchuk,C,OTT,21,54,5,3,8
7,8479379,Givani Smith,R,SJS,26,30,5,3,8
7,8481147,Reese Johnson,C,MIN,26,40,4,4,8
7,8475958,Michael Sgarbossa,C,WSH,32,26,4,4,8
7,8484149,Gavin Brindley,C,CBJ,20,41,3,5,8
7,8475235,Nicolas Deslauriers,L,PHI,33,55,3,5,8
7,8481599,Victor Soderstrom,D,UTA,23,35,3,5,8
7,8473446,Erik Johnson,D,PHI,36,46,3,5,8
7,8480441,Trey Fix-Wolansky,R,CBJ,25,35,3,5,8
7,8480950,Ilya Lyubushkin,D,DAL,30,79,2,6,8
7,8479378,Logan Stanley,D,WPG,26,39,2,6,8
7,8475762,Derek Forbort,D,VAN,32,52,2,6,8
7,8478017,Mark Friedman,D,VAN,29,30,2,6,8
7,8480172,Jan Rutta,D,SJS,34,61,1,7,8
7,8477931,Tomas Nosek,L,FLA,32,66,1,7,8
7,8478859,Niko Mikkola,D,FLA,28,49,1,7,8
7,8482747,Brennan Othmann,L,NYR,21,35,1,7,8
7,8481056,Spencer Stastney,D,NSH,24,33,1,7,8
7,8484254,Akito Hirose,D,VAN,25,30,1,7,8
7,8481592,Jakob Pelletier,L,CGY,23,42,0,8,8
7,8481754,Nikita Nesterenko,C,ANA,23,36,6,1,7
7,8482147,Jean-Luc Foudy,C,COL,22,26,6,1,7
7,8482070,Mitchell Chaffee,R,TBL,26,49,5,2,7
7,8482145,Mavrik Bourque,C,DAL,22,53,4,3,7
7,8482153,Brendan Brisson,C,VGK,23,34,3,4,7
7,8481122,Simon Benoit,D,TOR,26,32,2,5,7
7,8480880,Jakub Lauko,C,MIN,24,29,2,5,7
7,8480870,Bo Groulx,C,NYR,24,33,2,5,7
7,8482511,Mason Lohrei,D,BOS,23,25,2,5,7
7,8479991,Jake Leschyshyn,C,NYR,25,25,2,5,7
7,8476952,Dominic Toninato,C,WPG,30,26,1,6,7
7,8480007,Jonas Rondbjerg,R,VGK,25,42,1,6,7
7,8480196,Jacob Bryson,D,BUF,27,41,1,6,7
7,8484258,Sam Malinski,D,COL,26,25,1,6,7
7,8478454,Noah Juulsen,D,VAN,27,34,1,6,7
7,8477971,Andreas Englund,D,LAK,28,30,1,6,7
7,8482861,Vincent Iorio,D,WSH,22,34,1,6,7
7,8481167,Brayden Pachal,D,CGY,25,28,0,7,7
7,8477473,Justin Bailey,R,SJS,29,25,4,2,6
7,8481789,Tye Kartye,L,SEA,23,40,4,2,6
7,8480887,Jordan Harris,D,MTL,24,50,3,3,6
7,8484911,Collin Graf,R,SJS,22,54,3,3,6
7,8477384,Josh Brown,D,EDM,30,35,3,3,6
7,8481605,Jackson LaCombe,D,ANA,23,35,3,3,6
7,8480245,Olle Lycksell,R,PHI,25,26,3,3,6
7,8482713,Mackie Samoskevich,R,FLA,22,37,3,3,6
7,8481743,Marc Del Gaizo,D,NSH,25,18,3,3,6
7,8479536,Axel Jonsson-Fjallby,L,WPG,26,30,2,4,6
7,8482733,Logan Mailloux,D,MTL,31,43,2,4,6
7,8478477,Mitchell Stephens,C,SEA,27,13,2,4,6
7,8483549,Lucas Condotta,L,MTL,27,24,2,4,6
7,8481609,Vladislav Kolyachonok,D,UTA,23,41,1,5,6
7,8479249,Andrew Poturalski,C,SJS,30,34,1,5,6
7,8479981,Jonah Gadjovich,L,FLA,26,36,1,5,6
7,8475750,Jon Merrill,D,MIN,32,54,0,6,6
7,8477527,Ross Johnston,L,ANA,30,30,0,6,6
7,8482666,Scott Morrow,D,CAR,22,50,4,1,5
7,8483012,Logan Morrison,C,SEA,22,31,4,1,5
7,8481065,Angus Crookshank,L,OTT,25,16,4,1,5
7,8479772,Zack MacEwen,R,OTT,28,49,2,3,5
7,8481679,Maxence Guenette,D,OTT,23,24,2,3,5
7,8484304,Uvis Balinskis,D,FLA,28,15,2,3,5
7,8482751,Ryan Winterton,C,SEA,21,36,1,4,5
7,8481556,John Beecher,C,BOS,23,42,1,4,5
7,8481006,Tyler Tucker,D,STL,24,26,1,4,5
7,8482118,Sam Colangelo,R,ANA,23,20,1,4,5
7,8482929,Emil Lilleberg,D,TBL,23,17,1,4,5
7,8480879,Jacob Bernard-Docker,D,OTT,24,46,0,5,5
7,8480844,Grigori Denisenko,L,VGK,24,33,0,5,5
7,8477810,Joel Hanley,D,CGY,33,28,0,5,5
7,8483397,Marc McLaughlin,C,BOS,25,30,4,0,4
7,8481237,Kyle MacLean,C,NYI,25,26,3,1,4
7,8480084,Nick DeSimone,D,NJD,30,21,3,1,4
7,8477887,Patrick Brown,C,BOS,32,44,2,2,4
7,8479576,Vincent Desharnais,D,VAN,28,35,2,2,4
7,8484325,Waltteri Merela,C,TBL,26,25,2,2,4
7,8479421,Jacob Moverare,D,LAK,26,20,2,2,4
7,8475755,Alexander Petrovic,D,DAL,32,11,2,2,4
7,8478424,Jansen Harkins,C,ANA,27,44,1,3,4
7,8481043,Cole Koepke,L,BOS,26,18,1,3,4
7,8477851,Jordan Oesterle,D,BOS,32,41,0,4,4
7,8476473,Connor Murphy,D,CHI,31,38,0,4,4
7,8478450,Parker Wotherspoon,D,BOS,27,39,0,4,4
7,8476372,Nick Seeler,D,PHI,31,50,0,4,4
7,8482177,Marat Khusnutdinov,C,MIN,22,35,0,4,4
7,8477401,John Hayden,C,SEA,29,26,3,0,3
7,8477467,Gustav Olofsson,D,SEA,30,14,3,0,3
7,8482144,Jack Thompson,D,SJS,22,29,1,2,3
7,8481543,Nikita Alexandrov,C,STL,24,20,1,2,3
7,8479320,Max Lajoie,D,SEA,27,15,1,2,3
7,8482765,Isak Rosen,R,BUF,21,33,1,2,3
7,8481422,Jacob Lucchini,C,NSH,29,23,1,2,3
7,8478146,Matthew Highmore,C,OTT,28,42,1,2,3
7,8480890,Jan Jenik,R,OTT,24,21,1,2,3
7,8482470,Ilya Solovyov,D,CGY,24,24,1,2,3
7,8478502,Dennis Gilbert,D,BUF,28,21,1,2,3
7,8477320,Anton Blidh,L,NYR,29,25,1,2,3
7,8478874,Adam Gaudette,C,OTT,28,32,0,3,3
7,8482172,Landon Slaggert,L,CHI,22,22,0,3,3
7,8475795,Dylan McIlrath,D,WSH,32,15,0,3,3
7,8481030,Jack St. Ivany,D,PIT,25,14,0,3,3
7,8482201,Gage Goncalves,C,TBL,23,21,0,3,3
7,8482165,Yan Kuznetsov,D,CGY,22,16,2,0,2
7,8480851,Akil Thomas,C,LAK,24,24,2,0,2
7,8483398,Declan Carlile,D,TBL,31,7,2,0,2
7,8479638,Justin Brazeau,R,BOS,26,34,1,1,2
7,8480032,Shane Bowers,C,NJD,25,15,1,1,2
7,8479972,Mason Shaw,C,WPG,26,28,1,1,2
7,8481593,Jayden Struble,D,MTL,23,14,1,1,2
7,8477149,Scott Sabourin,R,SJS,32,17,1,1,2
7,8480468,James Hamblin,L,EDM,25,23,1,1,2
7,8478011,Louie Belpedio,D,PHI,28,17,1,1,2
7,8481719,Maxwell Crozier,D,TBL,24,23,1,1,2
7,8483597,Milos Kelemen,L,UTA,25,7,1,1,2
7,8480267,Sammy Walker,C,MIN,25,19,1,1,2
7,8478051,Max Willman,C,NJD,29,14,0,2,2
7,8482250,Callahan Burke,C,VGK,27,20,0,2,2
7,8475413,Justin Dowling,C,NJD,34,22,0,2,2
7,8482088,Justin Sourdif,R,FLA,22,13,0,2,2
7,8478021,William Lagesson,D,DET,28,26,0,2,2
7,8482061,Brandon Biro,L,SEA,26,8,0,2,2
7,8479419,Brett Murray,L,BUF,26,23,0,2,2
7,8481564,Ryan Johnson,D,BUF,23,19,0,2,2
7,8474062,Riley Nash,C,NYR,35,21,0,2,2
7,8482094,Daemon Hunt,D,MIN,22,15,0,2,2
7,8483471,Brad Lambert,C,WPG,31,15,0,2,2
7,8482197,Adam Raska,R,MIN,23,8,0,2,2
7,8481024,Linus Karlsson,C,VAN,25,6,0,2,2
7,8483570,Ben Meyers,C,SEA,26,34,1,0,1
7,8484287,Cole McWard,D,VAN,23,27,1,0,1
7,8480823,Alexander Alexeyev,D,WSH,25,14,1,0,1
7,8481699,Aku Raty,R,UTA,23,18,1,0,1
7,8482516,Matthew Kessel,D,STL,24,15,1,0,1
7,8481585,Egor Afanasyev,L,SJS,23,16,1,0,1
7,8483395,Arshdeep Bains,L,VAN,23,14,1,0,1
7,8478446,Glenn Gawdin,C,LAK,27,4,1,0,1
7,8480306,Grant Hutton,D,NYI,29,7,1,0,1
7,8480075,Cameron Crotty,D,MIN,25,10,1,0,1
7,8478409,Anthony Richard,C,PHI,28,20,0,1,1
7,8482102,Vasily Ponomarev,C,PIT,22,17,0,1,1
7,8482858,Ryker Evans,D,SEA,23,26,0,1,1
7,8479367,William Lockwood,R,FLA,26,25,0,1,1
7,8480874,Adam Ginning,D,PHI,24,9,0,1,1
7,8482162,Roby Jarventie,L,EDM,22,13,0,1,1
7,8484255,Jason Polin,R,COL,25,7,0,1,1
7,8478881,Brett Seney,L,CHI,28,6,0,1,1
7,8477244,Chad Ruhwedel,D,NYR,34,33,0,1,1
7,8483489,Fraser Minten,C,TOR,31,10,0,1,1
7,8482787,Nikita Chibrikov,R,WPG,31,6,0,1,1
7,8483567,Georgii Merkulov,C,BOS,24,11,0,1,1
7,8477993,Justin Kirkland,C,CGY,28,5,0,1,1
7,8479330,Brandon Gignac,C,MTL,27,16,0,1,1
7,8477073,Kurtis MacDermid,L,NJD,30,27,0,0,0
7,8483512,Matt Savoie,C,EDM,20,20,0,0,0
7,8479587,Rhett Gardner,C,PHI,28,9,0,0,0
7,8481578,Graeme Clarke,R,MIN,23,8,0,0,0
7,8477541,Dakota Mermis,D,TOR,30,14,0,0,0
7,8482476,Emil Heineman,L,MTL,23,7,0,0,0
7,8483531,Brian Halonen,L,NJD,25,4,0,0,0
7,8483920,Pierrick Dube,R,WSH,23,4,0,0,0
7,8481206,John Ludvig,D,PIT,24,6,0,0,0
7,8483432,Luca Del Bel Belluz,C,CBJ,31,5,0,0,0
7,8483609,Adam Klapka,R,CGY,24,1,0,0,0
7,8482460,Matt Rempe,C,NYR,22,15,0,0,0
7,8481462,Mason Morelli,L,VGK,28,8,0,0,0
7,8483546,Marshall Rifai,D,TOR,26,4,0,0,0
7,8481806,Louis Crevier,D,CHI,23,11,0,0,0
7,8479522,Hardy Haman Aktell,D,WSH,26,1,0,0,0
7,8484326,Patrik Koch,D,UTA,28,1,0,0,0
7,8478147,Bokondji Imama,L,PIT,28,2,0,0,0
7,8481655,Cole Schwindt,R,CGY,23,4,0,0,0
7,8481534,Raphael Lavoie,C,EDM,24,3,0,0,0
7,8484259,Ondrej Pavel,C,COL,31,1,0,0,0
7,8482126,Emil Andrae,D,PHI,31,1,0,0,0
7,8475780,Chris Wagner,R,COL,33,9,0,0,0
7,8483407,Brandon Scanlin,D,NYR,25,4,0,0,0
7,8478854,Ryan Shea,D,PIT,27,13,0,0,0
7,8476323,Max McCormick,L,SEA,32,2,0,0,0
7,8481726,Adam Edstrom,C,NYR,24,4,0,0,0
7,8479321,Lucas Johansen,D,,27,0,0,0,0
7,8470794,Joe Pavelski,C,,40,0,0,0,0
7,8477950,Tony DeAngelo,D,,29,0,0,0,0
7,8471218,Blake Wheeler,R,,38,0,0,0,0
7,8475197,Tyson Barrie,D,,33,0,0,0,0
7,8475744,Evgeny Kuznetsov,C,,32,0,0,0,0
7,8474037,James van Riemsdyk,L,,35,0,0,0,0
7,8474602,Justin Schultz,D,,34,0,0,0,0
7,8482222,Alexander Barabanov,L,,30,0,0,0,0
7,8474157,Max Pacioretty,L,,36,0,0,0,0
7,8474031,Kevin Shattenkirk,D,,35,0,0,0,0
7,8480884,Calen Addison,D,,24,0,0,0,0
7,8480008,Adam Ruzicka,C,,25,0,0,0,0
7,8475906,John Klingberg,D,,32,0,0,0,0
7,8476884,Derrick Pouliot,D,,30,0,0,0,0
7,8476919,Chris Tierney,C,,30,0,0,0,0
7,8479415,Michael McLeod,C,,26,0,0,0,0
7,8474884,Mike Hoffman,C,,35,0,0,0,0
7,8478104,Sammy Blais,L,,28,0,0,0,0
7,8474870,Tyler Johnson,C,,34,0,0,0,0
7,8481591,Sam Poulin,R,,23,0,0,0,0
7,8479977,Kailer Yamamoto,R,,26,0,0,0,0
7,8476393,Nick Cousins,C,,31,0,0,0,0
7,8479376,Victor Mete,D,,26,0,0,0,0
7,8476871,Tanner Pearson,L,,32,0,0,0,0
7,8471274,Alex Goligoski,D,,39,0,0,0,0
7,8481058,Jesse Ylönen,R,,25,0,0,0,0
7,8477464,Nic Petan,C,,29,0,0,0,0
7,8473449,Kyle Okposo,R,,36,0,0,0,0
7,8480216,Jacob Peterson,C,,25,0,0,0,0
7,8479346,Dillon Dube,C,,26,0,0,0,0
7,8470966,Mark Giordano,D,,41,0,0,0,0
7,8480821,Filip Zadina,R,,25,0,0,0,0
7,8476907,Mackenzie MacEachern,L,,30,0,0,0,0
7,8478430,Oliver Kylington,D,,27,0,0,0,0
7,8479514,Rem Pitlick,C,,27,0,0,0,0
7,8478099,Kevin Labanc,R,,29,0,0,0,0
7,8482241,Radim Zohorna,L,,28,0,0,0,0
7,8474040,Sam Gagner,C,,35,0,0,0,0
7,8475164,Jakob Silfverberg,R,,34,0,0,0,0
7,8475752,Tyler Pitlick,C,,33,0,0,0,0
7,8479984,Cal Foote,D,,26,0,0,0,0
7,8478495,Denis Gurianov,R,,27,0,0,0,0
7,8479533,Joona Koppanen,L,,26,0,0,0,0
7,8479458,Nikita Zaitsev,D,,33,0,0,0,0
7,8471699,Andrew Cogliano,C,,37,0,0,0,0
7,8470604,Jeff Carter,C,,39,0,0,0,0
7,8477330,Dominik Kubalik,L,,29,0,0,0,0
7,8477944,Jakub Vrana,L,,28,0,0,0,0
7,8478904,Steven Lorentz,C,,28,0,0,0,0
7,8471686,Marc Staal,D,,37,0,0,0,0
7,8478512,Austin Czarnik,C,,32,0,0,0,0
7,8470610,Zach Parise,L,,40,0,0,0,0
7,8473504,Cal Clutterbuck,R,,37,0,0,0,0
7,8474009,Nick Bonino,C,,36,0,0,0,0
7,8477454,Adam Erne,L,,29,0,0,0,0
7,8477126,Jayson Megna,C,,34,0,0,0,0
7,8473473,Milan Lucic,L,,36,0,0,0,0
7,8478067,Oskar Lindblom,L,,28,0,0,0,0
7,8475825,Jani Hakanpää,D,,32,0,0,0,0
7,8479383,Boris Katchouk,L,,26,0,0,0,0
7,8478400,Colin White,C,,27,0,0,0,0
7,8477846,Ryan Carpenter,C,,33,0,0,0,0
7,8477930,Pierre-Edouard Bellemare,L,,39,0,0,0,0
7,8479423,Alex Nylander,L,,26,0,0,0,0
7,8475797,Jarred Tinordi,D,,32,0,0,0,0
7,8481239,Samuel Fagemo,L,,24,0,0,0,0
7,8474618,Marco Scandella,D,,34,0,0,0,0
7,8480853,Liam Foudy,C,,24,0,0,0,0
7,8478028,Fredrik Olofsson,L,,28,0,0,0,0
7,8474145,Robert Bortuzzo,D,,35,0,0,0,0
7,8474709,Matt Martin,L,,35,0,0,0,0
7,8480226,Marián Studenic,R,,26,0,0,0,0
7,8480274,Philip Kemp,D,EDM,25,1,0,0,0
7,8480184,Gustav Lindstrom,D,,26,0,0,0,0
7,8481077,John Leonard,L,,26,0,0,0,0
7,8479547,Matthew Phillips,R,,26,0,0,0,0
7,8476915,Jujhar Khaira,L,,30,0,0,0,0
7,8481070,Hugh McGing,L,,26,0,0,0,0
7,8478408,Travis Dermott,D,,28,0,0,0,0
7,8481812,Nikolai Knyzhov,D,,27,0,0,0,0
7,8484321,Nikolas Matinpalo,D,OTT,26,1,0,0,0
7,8475278,Byron Froese,C,,33,0,0,0,0
7,8475766,Austin Watson,L,,32,0,0,0,0
7,8479546,Oskar Steen,C,,26,0,0,0,0
7,8480836,Jonathan Gruden,C,,24,0,0,0,0
7,8481690,Tyler Angle,C,,24,0,0,0,0
7,8480031,Maxime Comtois,L,,25,0,0,0,0
7,8483045,Cameron Butler,R,CBJ,31,1,0,0,0
7,8478078,Rourke Chartier,C,,28,0,0,0,0
7,8481016,Ruslan Iskhakov,C,,24,0,0,0,0
7,8484314,Jiri Smejkal,L,,28,0,0,0,0
7,8478956,Samuel Laberge,L,NJD,27,1,0,0,0
7,8483401,Marc Johnstone,R,PIT,28,0,0,0,0
7,8480776,Sheldon Rempal,R,,29,0,0,0,0
8,8477492,Nathan MacKinnon,C,COL,29,81,47,77,124
8,8479318,Auston Matthews,C,TOR,27,81,66,57,123
8,8477939,William Nylander,R,TOR,28,82,52,70,122
8,8476453,Nikita Kucherov,R,TBL,31,81,43,76,119
8,8478402,Connor McDavid,C,EDM,27,79,38,75,113
8,8477956,David Pastrnak,R,BOS,28,78,64,48,112
8,8481559,Jack Hughes,C,NJD,23,78,52,60,112
8,8477934,Leon Draisaitl,C,EDM,29,78,37,74,111
8,8478403,Jack Eichel,C,VGK,28,77,55,51,106
8,8475172,Nazem Kadri,C,CGY,34,78,38,64,102
8,8478550,Artemi Panarin,L,NYR,33,75,25,75,100
8,8478864,Kirill Kaprizov,L,MIN,27,75,43,56,99
8,8478445,Mathew Barzal,C,NYI,27,82,25,73,98
8,8479343,Clayton Keller,R,UTA,26,75,48,49,97
8,8480027,Jason Robertson,L,DAL,25,82,40,57,97
8,8477942,Kevin Fiala,L,LAK,28,81,38,59,97
8,8479314,Matthew Tkachuk,L,FLA,27,78,32,65,97
8,8477493,Aleksander Barkov,C,FLA,29,79,29,67,96
8,8476887,Filip Forsberg,L,NSH,30,74,58,36,94
8,8480801,Brady Tkachuk,L,OTT,25,81,47,47,94
8,8477933,Sam Reinhart,C,FLA,29,80,43,48,91
8,8477946,Dylan Larkin,C,DET,28,82,38,53,91
8,8476468,J.T. Miller,C,VAN,31,72,30,61,91
8,8484144,Connor Bedard,C,CHI,19,75,32,58,90
8,8477409,Carter Verhaeghe,C,FLA,29,79,42,43,85
8,8475913,Mark Stone,R,VGK,32,77,30,55,85
8,8477504,Josh Morrissey,D,WPG,29,77,19,66,85
8,8479407,Jesper Bratt,L,NJD,26,73,28,55,83
8,8479323,Adam Fox,D,NYR,26,74,19,64,83
8,8478420,Mikko Rantanen,R,COL,28,82,35,47,82
8,8476459,Mika Zibanejad,C,NYR,31,78,33,48,81
8,8480023,Robert Thomas,C,STL,25,77,21,60,81
8,8478398,Kyle Connor,L,WPG,28,73,43,37,80
8,8479420,Tage Thompson,C,BUF,27,70,45,34,79
8,8481540,Cole Caufield,R,MTL,23,75,32,47,79
8,8479675,Trevor Moore,L,LAK,29,81,39,38,77
8,8474564,Steven Stamkos,C,NSH,34,71,36,41,77
8,8478439,Travis Konecny,R,PHI,27,76,34,43,77
8,8480208,Drake Batherson,R,OTT,26,78,25,52,77
8,8482740,Wyatt Johnston,C,DAL,21,82,40,36,76
8,8477402,Pavel Buchnevich,L,STL,29,73,32,44,76
8,8476881,Tomas Hertl,C,VGK,31,80,32,44,76
8,8480069,Cale Makar,D,COL,26,71,22,54,76
8,8479385,Jordan Kyrou,C,STL,26,79,38,37,75
8,8475166,John Tavares,C,TOR,34,82,30,45,75
8,8480800,Quinn Hughes,D,VAN,25,79,6,69,75
8,8479542,Brandon Hagel,L,TBL,26,82,36,37,73
8,8477500,Bo Horvat,C,NYI,29,81,35,38,73
8,8482078,Lucas Raymond,L,DET,22,81,36,36,72
8,8477404,Jake Guentzel,C,TBL,30,82,35,37,72
8,8475765,Vladimir Tarasenko,R,DET,33,81,29,42,71
8,8474150,Mikael Backlund,C,CGY,35,73,25,46,71
8,8478460,Zach Werenski,D,CBJ,27,81,20,51,71
8,8475754,Brock Nelson,C,NYI,33,78,40,30,70
8,8476539,Jonathan Marchessault,R,NSH,34,76,33,37,70
8,8478449,Roope Hintz,C,DAL,28,81,31,39,70
8,8475167,Victor Hedman,D,TBL,34,78,18,52,70
8,8476346,Johnny Gaudreau,L,CBJ,31,73,14,56,70
8,8478010,Brayden Point,C,TBL,28,81,29,40,69
8,8477949,Alex Tuch,R,BUF,28,74,25,44,69
8,8480839,Rasmus Dahlin,D,BUF,24,76,18,51,69
8,8482116,Tim Stützle,C,OTT,22,79,27,41,68
8,8478427,Sebastian Aho,C,CAR,27,70,27,41,68
8,8476454,Ryan Nugent-Hopkins,C,EDM,31,76,24,44,68
8,8477496,Elias Lindholm,C,BOS,30,81,21,47,68
8,8475784,Jeff Skinner,C,EDM,32,76,32,35,67
8,8480012,Elias Pettersson,C,VAN,26,76,24,43,67
8,8480036,Miro Heiskanen,D,DAL,25,81,17,50,67
8,8481068,Yegor Sharangovich,C,CGY,26,78,35,31,66
8,8480018,Nick Suzuki,C,MTL,25,82,26,40,66
8,8476389,Vincent Trocheck,C,NYR,31,76,26,40,66
8,8480002,Nico Hischier,C,NJD,25,78,22,44,66
8,8473512,Claude Giroux,R,OTT,36,77,19,47,66
8,8476853,Morgan Rielly,D,TOR,30,70,9,57,66
8,8475184,Chris Kreider,L,NYR,33,72,42,23,65
8,8481528,Dylan Cozens,C,BUF,23,72,20,45,65
8,8476456,Jonathan Huberdeau,C,CGY,31,79,18,47,65
8,8480830,Andrei Svechnikov,R,CAR,24,64,34,30,64
8,8478975,Mason Marchment,L,DAL,29,79,23,41,64
8,8471675,Sidney Crosby,C,PIT,37,67,18,46,64
8,8474600,Roman Josi,D,NSH,34,70,13,51,64
8,8477501,Valeri Nichushkin,R,COL,29,82,35,28,63
8,8474141,Patrick Kane,R,DET,36,81,24,39,63
8,8476875,Mike Matheson,D,MTL,30,77,13,50,63
8,8478414,Timo Meier,R,NJD,28,76,31,31,62
8,8477960,Adrian Kempe,R,LAK,28,82,26,36,62
8,8475158,Ryan O'Reilly,C,NSH,33,73,24,38,62
8,8477951,Nick Schmaltz,C,UTA,28,75,22,40,62
8,8475170,Brayden Schenn,C,STL,33,77,21,41,62
8,8475726,Tyler Toffoli,C,SJS,32,73,31,30,61
8,8476460,Mark Scheifele,C,WPG,31,73,24,37,61
8,8476448,William Karlsson,C,VGK,31,80,22,39,61
8,8473994,Jamie Benn,L,DAL,35,80,22,39,61
8,8473419,Brad Marchand,L,BOS,36,77,19,42,61
8,8474578,Erik Karlsson,D,PIT,34,81,12,49,61
8,8482149,Cole Perfetti,C,WPG,22,71,26,34,60
8,8482699,Dylan Guenther,R,UTA,21,75,25,35,60
8,8476905,Chandler Stephenson,C,SEA,30,73,17,43,60
8,8477447,Shea Theodore,D,VGK,29,62,17,43,60
8,8483431,Logan Cooley,C,UTA,20,79,30,29,59
8,8474679,Gustav Nyquist,C,NSH,35,77,22,37,59
8,8475745,Charlie Coyle,C,BOS,32,80,22,37,59
8,8479325,Charlie McAvoy,D,BOS,27,76,8,51,59
8,8471215,Evgeni Malkin,C,PIT,38,74,28,30,58
8,8478440,Dylan Strome,C,WSH,27,73,26,32,58
8,8479337,Alex DeBrincat,R,DET,27,81,22,36,58
8,8475798,Mikael Granlund,C,SJS,32,68,20,38,58
8,8478407,Vince Dunn,D,SEA,28,71,15,43,58
8,8480014,Gabriel Vilardi,C,WPG,25,68,33,24,57
8,8476432,Boone Jenner,C,CBJ,31,72,28,29,57
8,8474586,Jordan Eberle,R,SEA,34,76,26,31,57
8,8483808,Andrei Kuzmenko,L,CGY,28,78,24,33,57
8,8478856,Conor Garland,R,VAN,28,73,23,34,57
8,8479999,Casey Mittelstadt,C,COL,26,81,16,41,57
8,8480803,Evan Bouchard,D,EDM,25,73,14,43,57
8,8475786,Zach Hyman,L,EDM,32,80,28,28,56
8,8471214,Alex Ovechkin,L,WSH,39,67,27,29,56
8,8475810,Bryan Rust,R,PIT,32,70,27,29,56
8,8478493,Joel Eriksson Ek,C,MIN,27,67,22,34,56
8,8477940,Nikolaj Ehlers,L,WPG,28,69,22,34,56
8,8477986,Brandon Montour,D,SEA,30,74,17,39,56
8,8477935,Sam Bennett,C,FLA,28,76,24,31,55
8,8475168,Matt Duchene,C,DAL,33,78,24,31,55
8,8482124,Quinton Byfield,R,LAK,22,81,19,36,55
8,8475692,Mats Zuccarello,R,MIN,37,71,18,37,55
8,8476479,Phillip Danault,C,LAK,31,79,19,35,54
8,8482702,Logan Stankoven,C,DAL,21,80,19,35,54
8,8477479,Tyler Bertuzzi,L,CHI,29,72,17,37,54
8,8474590,John Carlson,D,WSH,34,71,11,43,54
8,8478519,Anthony Cirelli,C,TBL,27,81,26,27,53
8,8471685,Anze Kopitar,C,LAK,37,81,20,33,53
8,8481711,Matias Maccelli,L,UTA,24,76,20,33,53
8,8480865,Noah Dobson,D,NYI,24,78,9,44,53
8,8482665,Matty Beniers,C,SEA,22,70,27,25,52
8,8475794,Tyler Seguin,C,DAL,32,81,23,29,52
8,8471698,T.J. Oshie,R,WSH,38,73,23,29,52
8,8484153,Leo Carlsson,C,ANA,20,73,17,35,52
8,8477964,Ivan Barbashev,C,VGK,29,72,17,35,52
8,8478444,Brock Boeser,R,VAN,27,77,29,22,51
8,8478401,Pavel Zacha,C,BOS,27,73,19,32,51
8,8479400,Pierre-Luc Dubois,L,WSH,26,72,19,32,51
8,8477444,Andre Burakovsky,L,SEA,29,69,18,33,51
8,8478397,Rasmus Andersson,D,CGY,28,77,11,40,51
8,8478233,Andrew Mangiapane,L,WSH,28,71,23,27,50
8,8478873,Troy Terry,R,ANA,27,74,19,31,50
8,8478542,Evan Rodrigues,C,FLA,31,78,19,31,50
8,8477955,Jared McCann,L,SEA,28,69,17,33,50
8,8477503,Max Domi,C,TOR,29,78,16,34,50
8,8482684,Luke Hughes,D,NJD,21,71,8,42,50
8,8484166,Adam Fantilli,C,CBJ,20,63,30,19,49
8,8477416,Oliver Bjorkstrand,R,SEA,29,72,23,26,49
8,8480039,Martin Necas,C,CAR,25,71,18,31,49
8,8482745,Mason McTavish,C,ANA,21,71,24,24,48
8,8482097,Jack Quinn,R,BUF,23,64,21,27,48
8,8477932,Aaron Ekblad,D,FLA,28,71,15,33,48
8,8478469,Thomas Chabot,D,OTT,27,70,9,39,48
8,8476399,Blake Coleman,C,CGY,33,76,27,20,47
8,8479992,Michael Rasmussen,C,DET,25,79,23,24,47
8,8480797,Joel Farabee,L,PHI,24,72,22,25,47
8,8475793,Ryan Johansen,C,PHI,32,74,19,28,47
8,8477407,Anthony Duclair,L,NYI,29,74,18,29,47
8,8478462,Nicolas Roy,C,VGK,27,73,14,33,47
8,8476462,Dougie Hamilton,D,NJD,31,73,13,34,47
8,8474563,Drew Doughty,D,LAK,35,66,11,36,47
8,8478047,Michael Bunting,L,PIT,29,74,25,21,46
8,8477476,Artturi Lehkonen,L,COL,29,81,25,21,46
8,8475151,Kyle Palmieri,C,NYI,33,77,24,22,46
8,8473986,Alex Killorn,L,ANA,35,69,23,23,46
8,8484145,Zach Benson,L,BUF,19,65,22,24,46
8,8482093,Seth Jarvis,C,CAR,22,75,21,25,46
8,8475714,Calle Jarnkrok,C,TOR,33,77,20,26,46
8,8480798,Philipp Kurashev,C,CHI,25,69,19,27,46
8,8483515,Juraj Slafkovsky,L,MTL,20,75,17,29,46
8,8481618,Alex Newhook,C,MTL,23,68,17,29,46
8,8478438,Tommy Novak,C,NSH,27,68,15,31,46
8,8478038,Devon Toews,D,COL,30,69,11,35,46
8,8478366,Frank Vatrano,R,ANA,30,71,24,21,45
8,8477497,Sean Monahan,C,CBJ,30,74,22,23,45
8,8478474,Lawson Crouse,L,UTA,27,70,20,25,45
8,8475314,Anders Lee,L,NYI,34,79,20,25,45
8,8475760,Nick Bjugstad,C,UTA,32,74,19,26,45
8,8481557,Matt Boldy,L,MIN,23,72,18,27,45
8,8478466,Daniel Sprong,R,VAN,27,70,18,27,45
8,8478055,Gustav Forsling,D,FLA,28,67,12,33,45
8,8477346,MacKenzie Weegar,D,CGY,30,77,7,38,45
8,8478498,Jake DeBrusk,L,VAN,28,71,25,19,44
8,8475169,Evander Kane,L,EDM,33,73,22,22,44
8,8478115,Pierre Engvall,L,NYI,28,74,20,24,44
8,8480188,Fabian Zetterlund,L,SJS,25,62,19,25,44
8,8482720,Matthew Knies,L,TOR,22,79,19,25,44
8,8475191,Reilly Smith,R,NYR,33,75,18,26,44
8,8476906,Shayne Gostisbehere,D,CAR,31,77,11,33,44
8,8482105,Jake Sanderson,D,OTT,22,78,11,33,44
8,8477021,Alex Kerfoot,C,UTA,30,72,7,37,44
8,8477989,Christian Dvorak,C,MTL,28,66,14,29,43
8,8476882,Teuvo Teravainen,L,CHI,30,68,13,30,43
8,8478042,Viktor Arvidsson,R,EDM,31,76,13,30,43
8,8476826,Yanni Gourde,C,SEA,33,73,12,31,43
8,8481581,Thomas Harley,D,DAL,23,81,8,35,43
8,8482113,Anton Lundell,C,FLA,23,78,22,20,42
8,8477998,Warren Foegele,L,LAK,28,82,22,20,42
8,8480028,Morgan Frost,C,PHI,25,74,21,21,42
8,8475768,Jaden Schwartz,C,SEA,32,77,19,23,42
8,8475287,Erik Haula,L,NJD,33,76,16,26,42
8,8470613,Brent Burns,D,CAR,39,76,14,28,42
8,8471724,Kris Letang,D,PIT,37,75,13,29,42
8,8482146,Luke Evangelista,R,NSH,22,71,13,29,42
8,8474565,Alex Pietrangelo,D,VGK,34,59,11,31,42
8,8474641,Adam Henrique,C,EDM,34,76,22,19,41
8,8480009,Eeli Tolvanen,R,SEA,25,75,19,22,41
8,8477456,J.T. Compher,L,DET,29,75,18,23,41
8,8481186,Logan O'Connor,R,COL,28,76,18,23,41
8,8477451,Ryan Hartman,R,MIN,30,71,17,24,41
8,8481604,Pavel Dorofeyev,L,VGK,24,69,17,24,41
8,8476872,Scott Laughton,C,PHI,30,72,14,27,41
8,8481542,Moritz Seider,D,DET,23,72,9,32,41
8,8477494,Jonathan Drouin,L,COL,29,79,8,33,41
8,8480434,Sean Durzi,D,UTA,26,68,7,34,41
8,8482159,Tyson Foerster,R,PHI,22,77,18,22,40
8,8480015,Owen Tippett,R,PHI,25,77,18,22,40
8,8475799,Nino Niederreiter,R,WPG,32,67,17,23,40
8,8478057,Dakota Joshua,C,VAN,28,67,17,23,40
8,8477511,Anthony Mantha,R,CGY,30,72,15,25,40
8,8481596,Shane Pinto,C,OTT,24,78,13,27,40
8,8475171,Oliver Ekman-Larsson,D,TOR,33,67,12,28,40
8,8479425,Filip Hronek,D,VAN,27,71,7,33,40
8,8482109,Alexis Lafrenière,L,NYR,23,74,24,15,39
8,8476483,Rickard Rakell,R,PIT,31,65,19,20,39
8,8482092,Ridly Greig,C,OTT,22,82,17,22,39
8,8476458,Ryan Strome,C,ANA,31,68,16,23,39
8,8481533,Trevor Zegras,C,ANA,23,67,13,26,39
8,8480064,Josh Norris,C,OTT,25,73,13,26,39
8,8479339,Patrik Laine,L,CBJ,26,65,13,26,39
8,8482089,Jake Neighbours,L,STL,22,66,22,16,38
8,8474102,David Perron,L,OTT,36,80,19,19,38
8,8479525,Ross Colton,C,COL,28,80,18,20,38
8,8477426,Nicholas Paul,L,TBL,29,81,17,21,38
8,8478046,Danton Heinen,L,VAN,29,68,17,21,38
8,8474715,Cam Atkinson,R,TBL,35,80,17,21,38
8,8479987,Morgan Geekie,C,BOS,26,77,15,23,38
8,8479345,Jakob Chychrun,D,WSH,26,58,14,24,38
8,8476958,Jaccob Slavin,D,CAR,30,68,7,31,38
8,8482110,Dawson Mercer,C,NJD,23,79,23,14,37
8,8476438,Brandon Saad,L,STL,32,68,19,18,37
8,8476897,Oskar Sundqvist,C,STL,30,63,16,21,37
8,8482667,William Eklund,L,SJS,22,67,15,22,37
8,8475149,Marcus Johansson,L,MIN,34,66,14,23,37
8,8483505,Matthew Poitras,C,BOS,20,73,8,29,37
8,8475764,Cam Fowler,D,ANA,33,68,6,31,37
8,8481624,Ilya Mikheyev,R,CHI,30,60,19,17,36
8,8477839,Conor Sheary,L,TBL,32,81,13,23,36
8,8476869,Brady Skjei,D,NSH,30,73,10,26,36
8,8482475,Yegor Chinakhov,R,CBJ,23,67,16,19,35
8,8476892,Colton Parayko,D,STL,31,76,5,30,35
8,8477952,Robby Fabbri,C,ANA,28,68,20,14,34
8,8476981,Josh Anderson,R,MTL,30,75,16,18,34
8,8475848,Brendan Gallagher,R,MTL,32,68,16,18,34
8,8482055,Drew O'Connor,L,PIT,26,67,15,19,34
8,8477429,Andrew Copp,C,DET,30,78,13,21,34
8,8475763,Kevin Hayes,R,PIT,32,67,13,21,34
8,8477498,Darnell Nurse,D,EDM,29,72,10,24,34
8,8478133,Jake Evans,C,MTL,28,74,10,24,34
8,8477948,Travis Sanheim,D,PHI,28,72,9,25,34
8,8475218,Mattias Ekholm,D,EDM,34,74,7,27,34
8,8476902,Esa Lindell,D,DAL,30,80,6,28,34
8,8476331,Dylan DeMelo,D,WPG,31,68,4,30,34
8,8478463,Anthony Beauvillier,L,PIT,27,62,21,12,33
8,8481656,Aliaksei Protas,C,WSH,23,65,16,17,33
8,8480893,Kirill Marchenko,R,CBJ,24,60,15,18,33
8,8480789,Oliver Wahlstrom,R,NYI,24,72,14,19,33
8,8480068,Ryan Poehling,C,PHI,25,67,14,19,33
8,8475220,Marcus Foligno,L,MIN,33,62,14,19,33
8,8477495,Seth Jones,D,CHI,30,64,12,21,33
8,8481577,Philip Tomasino,C,NSH,23,61,10,23,33
8,8476927,Teddy Blueger,C,VAN,30,68,10,23,33
8,8476463,Jonas Brodin,D,MIN,31,79,8,25,33
8,8482122,Brock Faber,D,MIN,22,77,7,26,33
8,8480145,Neal Pionk,D,WPG,29,75,7,26,33
8,8474716,Jared Spurgeon,D,MIN,35,79,6,27,33
8,8476469,Joel Armia,R,MTL,31,62,21,11,32
8,8476880,Tom Wilson,R,WSH,30,66,20,12,32
8,8479365,Trent Frederic,C,BOS,26,75,19,13,32
8,8478472,Mathieu Joseph,R,STL,27,67,18,14,32
8,8482074,Connor Zary,C,CGY,23,65,17,15,32
8,8482175,JJ Peterka,R,BUF,22,67,16,16,32
8,8479293,Brandon Tanev,L,SEA,33,65,16,16,32
8,8481554,Kaapo Kakko,R,NYR,23,65,15,17,32
8,8479353,Brett Howden,C,VGK,26,67,12,20,32
8,8476278,Colin Blackwell,C,DAL,31,76,12,20,32
8,8475753,Justin Faulk,D,STL,32,69,9,23,32
8,8482133,Thomas Bordeleau,C,SJS,22,58,9,23,32
8,8478396,Noah Hanifin,D,VGK,27,62,7,25,32
8,8479410,Mikhail Sergachev,D,UTA,26,74,5,27,32
8,8476854,Hampus Lindholm,D,BOS,30,75,4,28,32
8,8478020,Michael Amadio,C,OTT,28,72,18,13,31
8,8482125,Alexander Holtz,R,VGK,22,71,18,13,31
8,8476392,Adam Lowry,C,WPG,31,64,16,15,31
8,8477425,Miles Wood,L,COL,29,79,15,16,31
8,8482705,Cole Sillinger,C,CBJ,21,70,14,17,31
8,8480871,Adam Boqvist,D,FLA,24,68,11,20,31
8,8476792,Torey Krug,D,STL,33,72,7,24,31
8,8474149,Evgenii Dadonov,R,DAL,35,77,16,14,30
8,8481560,Arthur Kaliyev,R,LAK,23,72,13,17,30
8,8476885,Jacob Trouba,D,NYR,30,69,13,17,30
8,8480813,Joe Veleno,C,DET,24,78,13,17,30
8,8476419,Jean-Gabriel Pageau,C,NYI,32,78,11,19,30
8,8480878,Nils Lundkvist,D,DAL,24,80,10,20,30
8,8480113,Alex Iafallo,L,WPG,31,64,9,21,30
8,8482660,Kent Johnson,C,CBJ,22,60,8,22,30
8,8476923,Damon Severson,D,CBJ,30,81,6,24,30
8,8479976,Juuso Valimaki,D,UTA,26,61,6,24,30
8,8478507,John Marino,D,UTA,27,65,2,28,30
8,8481477,Nico Sturm,C,SJS,29,58,17,12,29
8,8481601,Simon Holmstrom,R,NYI,23,65,16,13,29
8,8476474,Stefan Noesen,R,NJD,31,65,15,14,29
8,8475791,Taylor Hall,L,CHI,33,59,15,14,29
8,8480748,Kiefer Sherwood,L,VAN,29,65,14,15,29
8,8482803,Olen Zellweger,D,ANA,21,71,12,17,29
8,8483445,Cutter Gauthier,L,ANA,20,68,8,21,29
8,8474189,Lars Eller,C,PIT,35,65,8,21,29
8,8482671,Owen Power,D,BUF,22,73,6,23,29
8,8474151,Ryan McDonagh,D,TBL,35,77,5,24,29
8,8478500,Ivan Provorov,D,CBJ,27,78,3,26,29
8,8477450,Jason Dickinson,C,CHI,29,65,16,12,28
8,8481553,Bobby Brink,R,PHI,23,63,14,14,28
8,8475231,Casey Cizikas,C,NYI,33,68,14,14,28
8,8478013,Jake Walman,D,SJS,28,69,12,16,28
8,8482679,Matt Coronato,R,CGY,22,70,11,17,28
8,8479591,Michael Eyssimont,C,TBL,28,79,10,18,28
8,8478109,Victor Olofsson,L,VGK,29,69,10,18,28
8,8480185,Eetu Luostarinen,C,FLA,26,73,9,19,28
8,8482111,Justin Barron,D,MTL,23,63,8,20,28
8,8478458,Jack Roslovic,C,CAR,27,72,7,21,28
8,8483490,Pavel Mintyukov,D,ANA,21,67,6,22,28
8,8480336,Sean Walker,D,CAR,30,70,6,22,28
8,8480817,K'Andre Miller,D,NYR,24,74,5,23,28
8,8477488,Brett Pesce,D,NJD,30,65,2,26,28
8,8481535,Nils Hoglander,L,VAN,24,61,18,9,27
8,8479393,Noah Gregor,C,OTT,26,71,15,12,27
8,8480205,Emil Bemstrom,C,PIT,25,59,15,12,27
8,8482117,Lukas Reichel,L,CHI,22,61,13,14,27
8,8480459,Pius Suter,C,VAN,28,68,12,15,27
8,8480074,Alexandre Texier,C,STL,25,59,12,15,27
8,8480806,Isac Lundestrom,C,ANA,25,61,12,15,27
8,8480078,Filip Chytil,C,NYR,25,68,11,16,27
8,8480835,Jack Drury,C,CAR,24,65,11,16,27
8,8483524,Shane Wright,C,SEA,20,60,10,17,27
8,8480448,Parker Kelly,L,COL,25,74,9,18,27
8,8480220,Noah Cates,L,PHI,25,68,8,19,27
8,8480980,Connor Dewar,C,TOR,25,77,8,19,27
8,8476429,Scott Mayfield,D,NYI,32,77,6,21,27
8,8480246,Nick Perbix,D,TBL,26,72,6,21,27
8,8480049,Dylan Samberg,D,WPG,25,66,5,22,27
8,8476422,Mike Reilly,D,NYI,31,69,4,23,27
8,8476979,Erik Gustafsson,D,DET,32,76,3,24,27
8,8480873,Rasmus Sandin,D,WSH,24,67,2,25,27
8,8480043,Timothy Liljegren,D,TOR,25,68,2,25,27
8,8482192,Isaak Phillips,D,CHI,23,56,1,26,27
8,8482749,Joshua Roy,R,MTL,21,64,16,10,26
8,8479336,Carl Grundstrom,R,SJS,27,55,16,10,26
8,8479996,Cody Glass,C,NSH,25,55,14,12,26
8,8476918,Jimmy Vesey,L,NYR,31,67,13,13,26
8,8481580,Connor McMichael,C,WSH,23,56,12,14,26
8,8479351,Sam Steel,C,DAL,26,80,12,14,26
8,8481523,Kirby Dach,C,MTL,23,70,10,16,26
8,8478413,Jordan Greenway,L,BUF,27,59,10,16,26
8,8478970,Jalen Chatfield,D,CAR,28,73,10,16,26
8,8476292,Ondrej Palat,L,NJD,33,66,9,17,26
8,8480849,Barrett Hayton,C,UTA,24,70,8,18,26
8,8480035,Henri Jokiharju,D,BUF,25,59,8,18,26
8,8473563,Nicklas Backstrom,C,WSH,37,54,8,18,26
8,8483565,Nick Blankenburg,D,NSH,26,62,5,21,26
8,8479983,Mario Ferraro,D,SJS,26,67,4,22,26
8,8483468,Jiri Kulich,C,BUF,20,61,4,22,26
8,8481546,Cam York,D,PHI,23,70,3,23,26
8,8478508,Yakov Trenin,C,MIN,27,59,14,11,25
8,8478891,Mason Appleton,C,WPG,28,70,12,13,25
8,8475193,Tomas Tatar,L,NJD,34,53,8,17,25
8,8476457,Adam Larsson,D,SEA,32,77,6,19,25
8,8477220,Nate Schmidt,D,FLA,33,73,3,22,25
8,8474574,Tyler Myers,D,VAN,34,71,3,22,25
8,8478851,Alexandre Carrier,D,NSH,28,64,1,24,25
8,8482259,Bobby McMann,C,TOR,28,72,14,10,24
8,8482744,James Malatesta,L,CBJ,21,42,12,12,24
8,8480829,Jesperi Kotkaniemi,C,CAR,24,68,11,13,24
8,8484203,Bradly Nadeau,L,CAR,19,65,11,13,24
8,8482809,Jackson Blake,R,CAR,21,61,11,13,24
8,8481704,Juuso Parssinen,C,NSH,23,57,10,14,24
8,8484149,Gavin Brindley,C,CBJ,20,52,10,14,24
8,8482624,Daniil Miromanov,D,CGY,27,64,8,16,24
8,8477953,Kasperi Kapanen,R,STL,28,67,8,16,24
8,8481703,Valtteri Puustinen,R,PIT,25,66,7,17,24
8,8481481,Blake Lizotte,C,PIT,27,61,7,17,24
8,8479316,Luke Kunin,C,SJS,27,60,7,17,24
8,8476988,Matt Benning,D,SJS,30,65,7,17,24
8,8479402,Jake Bean,D,CGY,26,61,5,19,24
8,8477507,Nikita Zadorov,D,BOS,29,67,4,20,24
8,8475790,Erik Gudbranson,D,CBJ,32,76,4,20,24
8,8481606,Jordan Spence,D,LAK,23,61,3,21,24
8,8476525,Colin Miller,D,WPG,32,69,3,21,24
8,8478416,Erik Cernak,D,TBL,27,70,3,21,24
8,8479324,Ryan Lindgren,D,NYR,26,63,2,22,24
8,8478831,Kevin Stenlund,C,UTA,28,57,14,9,23
8,8481517,Brett Leason,R,ANA,25,56,12,11,23
8,8479718,Alex Barré-Boulet,C,MTL,27,59,11,12,23
8,8477446,Michael McCarron,R,NSH,29,64,11,12,23
8,8476921,Jordan Martinook,L,CAR,32,60,10,13,23
8,8477979,Nicolas Aube-Kubel,R,BUF,28,64,10,13,23
8,8479661,Tanner Jeannot,L,LAK,27,75,9,14,23
8,8477987,Ryan Donato,C,CHI,28,59,8,15,23
8,8480073,Erik Brannstrom,D,COL,25,64,7,16,23
8,8478178,Darren Raddysh,D,TBL,28,70,6,17,23
8,8479371,Dante Fabbro,D,NSH,26,65,5,18,23
8,8479639,Dylan Coghlan,D,WPG,26,59,5,18,23
8,8476917,Adam Pelech,D,NYI,30,80,4,19,23
8,8483482,Tristan Luneau,D,ANA,20,71,4,19,23
8,8479398,Samuel Girard,D,COL,26,67,3,20,23
8,8479414,Nathan Bastian,R,NJD,27,59,15,7,22
8,8477353,Tyler Motte,C,DET,29,67,14,8,22
8,8480289,Morgan Barron,C,WPG,26,52,12,10,22
8,8474053,Logan Couture,C,SJS,35,60,9,13,22
8,8476329,Travis Boyd,C,MIN,31,51,9,13,22
8,8473422,Nick Foligno,L,CHI,37,60,8,14,22
8,8480144,David Kampf,C,TOR,29,77,8,14,22
8,8470600,Ryan Suter,D,STL,39,59,7,15,22
8,8477369,Carson Soucy,D,VAN,30,68,6,16,22
8,8480802,Ryan McLeod,C,BUF,25,66,5,17,22
8,8481527,Kaedan Korczak,D,VGK,23,54,5,17,22
8,8479982,Conor Timmins,D,TOR,26,62,3,19,22
8,8474567,Zach Bogosian,D,MIN,34,64,3,19,22
8,8480855,Jack McBain,C,UTA,24,60,11,10,21
8,8480021,Jack Studnicka,C,LAK,25,64,11,10,21
8,8478211,Dryden Hunt,L,CGY,29,59,10,11,21
8,8481582,Nicholas Robertson,L,TOR,23,75,9,12,21
8,8476461,Sean Couturier,C,PHI,32,71,8,13,21
8,8476467,Jamie Oleksiak,D,SEA,32,67,8,13,21
8,8478434,Keegan Kolesar,R,VGK,27,61,8,13,21
8,8482737,Zack Bolduc,C,STL,21,60,8,13,21
8,8481522,Peyton Krebs,C,BUF,23,67,7,14,21
8,8479998,Mikey Anderson,D,LAK,25,60,5,16,21
8,8475200,Dmitry Orlov,D,CAR,33,73,4,17,21
8,8482087,Kaiden Guhle,D,MTL,22,67,4,17,21
8,8478882,Vladislav Gavrikov,D,LAK,29,65,3,18,21
8,8473507,Jeff Petry,D,DET,37,73,2,19,21
8,8481014,Alexander Romanov,D,NYI,24,76,2,19,21
8,8475181,Nick Leddy,D,STL,33,66,1,20,21
8,8475722,Jason Zucker,L,BUF,32,61,15,5,20
8,8470621,Corey Perry,R,EDM,39,68,15,5,20
8,8479619,Michael Carcone,L,UTA,28,62,13,7,20
8,8479941,Justin Danforth,R,CBJ,31,60,13,7,20
8,8477947,Sonny Milano,L,WSH,28,67,8,12,20
8,8481093,Rafael Harvey-Pinard,L,MTL,25,59,7,13,20
8,8482101,Danil Gushchin,L,SJS,22,59,5,15,20
8,8477435,Ryan Graves,D,PIT,29,71,5,15,20
8,8482712,Oskar Olausson,R,COL,22,76,4,16,20
8,8478840,Will Borgen,D,SEA,28,64,3,17,20
8,8474673,TJ Brodie,D,CHI,34,55,3,17,20
8,8477969,Marcus Pettersson,D,PIT,28,76,2,18,20
8,8475462,Radko Gudas,D,ANA,34,65,1,19,20
8,8480860,Kevin Bahl,D,CGY,24,59,1,19,20
8,8476878,Zemgus Girgensons,L,TBL,30,79,12,7,19
8,8482157,Will Cuylle,L,NYR,22,61,11,8,19
8,8473533,Jordan Staal,C,CAR,36,60,10,9,19
8,8483493,Frank Nazar,C,CHI,20,59,10,9,19
8,8482062,Cole Smith,L,NSH,29,50,9,10,19
8,8479368,Max Jones,L,BOS,26,63,9,10,19
8,8480003,Jesper Boqvist,C,FLA,26,75,8,11,19
8,8476480,Vladislav Namestnikov,C,WPG,32,60,6,13,19
8,8480025,MacKenzie Entwistle,R,FLA,25,65,6,13,19
8,8473453,Trevor Lewis,C,LAK,37,74,6,13,19
8,8481441,Joe Snively,C,DET,28,65,5,14,19
8,8482142,Jamie Drysdale,D,PHI,22,65,4,15,19
8,8477392,Hudson Fasching,R,NYI,29,65,4,15,19
8,8476925,Colton Sissons,C,NSH,31,63,3,16,19
8,8482073,Braden Schneider,D,NYR,23,60,2,17,19
8,8475188,Brayden McNabb,D,VGK,33,55,2,17,19
8,8480796,Martin Fehervary,D,WSH,25,63,2,17,19
8,8475233,David Savard,D,MTL,34,66,1,18,19
8,8477506,Ryan Pulock,D,NYI,30,77,0,19,19
8,8480995,Pontus Holmberg,R,TOR,25,71,13,5,18
8,8482859,Zack Ostapchuk,C,OTT,21,57,13,5,18
8,8483457,Lane Hutson,D,MTL,20,69,10,8,18
8,8480281,Alexey Toropchenko,R,STL,25,63,10,8,18
8,8477015,Connor Brown,R,EDM,30,63,8,10,18
8,8482148,Hendrix Lapierre,C,WSH,22,54,8,10,18
8,8479390,Taylor Raddysh,R,WSH,26,58,7,11,18
8,8479372,Josh Mahura,D,SEA,26,46,7,11,18
8,8477406,Mattias Janmark,C,EDM,32,62,6,12,18
8,8478452,Caleb Jones,D,LAK,27,59,6,12,18
8,8478136,Jake Middleton,D,MIN,28,69,4,14,18
8,8480950,Ilya Lyubushkin,D,DAL,30,76,4,14,18
8,8481708,Zac Jones,D,NYR,24,51,3,15,18
8,8482655,J.J. Moser,D,TBL,24,79,2,16,18
8,8475279,Ben Chiarot,D,DET,33,67,2,16,18
8,8481032,Paul Cotter,C,NJD,25,56,8,9,17
8,8482067,Connor Mackey,D,NYR,28,60,8,9,17
8,8478432,Christian Fischer,R,DET,27,75,7,10,17
8,8476374,Sean Kuraly,C,CBJ,31,52,7,10,17
8,8480252,Cole Guttman,C,CHI,25,45,7,10,17
8,8476624,Barclay Goodrow,C,SJS,31,59,7,10,17
8,8482155,Alex Laferriere,R,LAK,23,54,7,10,17
8,8479638,Justin Brazeau,R,BOS,26,39,7,10,17
8,8482964,Arber Xhekaj,D,MTL,23,41,6,11,17
8,8477845,Trevor van Riemsdyk,D,WSH,33,64,1,16,17
8,8480058,Pierre-Olivier Joseph,D,STL,25,56,0,17,17
8,8482807,Ethan Del Mastro,D,CHI,21,53,9,7,16
8,8475855,Jesper Fast,R,CAR,33,61,7,9,16
8,8477903,Garnet Hathaway,R,PHI,33,69,7,9,16
8,8478451,Ethan Bear,D,WSH,27,59,7,9,16
8,8481537,Nikita Okhotiuk,D,CGY,24,60,6,10,16
8,8481521,Ronnie Attard,D,PHI,25,60,5,11,16
8,8476312,Josh Manson,D,COL,33,55,5,11,16
8,8481028,Martin Pospisil,C,CGY,25,50,5,11,16
8,8479543,Michael Pezzetta,L,MTL,26,53,5,11,16
8,8480172,Jan Rutta,D,SJS,34,59,5,11,16
8,8480848,Ty Dellandrea,C,SJS,24,51,4,12,16
8,8482176,Wyatt Kaiser,D,CHI,22,56,4,12,16
8,8478911,Matt Roy,D,WSH,29,54,4,12,16
8,8475179,Dmitry Kulikov,D,FLA,34,61,4,12,16
8,8481550,Adam Beckman,L,NJD,23,35,4,12,16
8,8476931,Jake McCabe,D,TOR,31,64,2,14,16
8,8476879,Cody Ceci,D,EDM,31,67,2,14,16
8,8481178,Egor Zamula,D,PHI,24,62,2,14,16
8,8481567,Henry Thrun,D,SJS,23,53,1,15,16
8,8476960,Andreas Athanasiou,C,CHI,30,52,10,5,15
8,8479520,Brandon Duhaime,R,WSH,27,58,10,5,15
8,8476858,Phillip Di Giuseppe,L,VAN,31,45,8,7,15
8,8482079,Marco Rossi,C,MIN,23,66,7,8,15
8,8477478,William Carrier,L,CAR,30,50,7,8,15
8,8475842,Sam Carrick,C,NYR,32,61,7,8,15
8,8478421,A.J. Greer,L,FLA,28,54,6,9,15
8,8480727,Zach Whitecloud,D,VGK,28,50,5,10,15
8,8480845,Rasmus Kupari,C,WPG,24,40,5,10,15
8,8480192,Johnathan Kovacevic,D,NJD,27,63,5,10,15
8,8477508,Curtis Lazar,C,NJD,29,67,3,12,15
8,8481059,Scott Perunovich,D,STL,26,61,3,12,15
8,8475718,Justin Holl,D,DET,32,61,2,13,15
8,8480441,Trey Fix-Wolansky,R,CBJ,25,36,2,13,15
8,8481789,Tye Kartye,L,SEA,23,48,11,3,14
8,8479066,Ryan Lomberg,L,CGY,30,62,8,6,14
8,8479328,Julien Gauthier,R,NYI,27,58,7,7,14
8,8480762,Eric Robinson,L,CAR,29,56,7,7,14
8,8481641,Joel Kiviranta,L,COL,28,72,7,7,14
8,8478043,Sam Lafferty,C,BUF,29,55,6,8,14
8,8477919,Frederick Gaudreau,C,MIN,31,58,5,9,14
8,8480011,Klim Kostin,C,SJS,25,46,5,9,14
8,8476874,Olli Maatta,D,DET,30,60,4,10,14
8,8484911,Collin Graf,R,SJS,22,42,4,10,14
8,8482634,Alex Steeves,C,TOR,25,59,3,11,14
8,8471709,Marc-Edouard Vlasic,D,SJS,37,56,3,11,14
8,8475324,Nick Jensen,D,OTT,34,67,2,12,14
8,8483460,David Jiricek,D,CBJ,21,58,2,12,14
8,8481599,Victor Soderstrom,D,UTA,23,46,1,13,14
8,8475225,Craig Smith,C,CHI,35,60,8,5,13
8,8481716,Dmitri Voronkov,L,CBJ,24,44,8,5,13
8,8482141,Lukas Cormier,D,VGK,22,33,8,5,13
8,8480355,Mark Kastelic,C,BOS,25,56,8,5,13
8,8476822,Luke Glendening,C,TBL,35,82,6,7,13
8,8483491,Ivan Miroshnichenko,L,WSH,20,61,6,7,13
8,8481751,Lukas Rousek,R,BUF,25,44,6,7,13
8,8478443,Brandon Carlo,D,BOS,28,61,5,8,13
8,8475343,Nic Dowd,C,WSH,34,62,4,9,13
8,8481617,Vasily Podkolzin,R,VAN,23,44,3,10,13
8,8474034,Pat Maroon,L,CHI,36,46,3,10,13
8,8479348,Kale Clague,D,BUF,26,42,3,10,13
8,8480001,Urho Vaakanainen,D,ANA,25,58,3,10,13
8,8482245,Artem Zub,D,OTT,29,68,2,11,13
8,8480807,Mattias Samuelsson,D,BUF,24,54,2,11,13
8,8481568,Alex Vlasic,D,CHI,23,54,1,12,13
8,8481605,Jackson LaCombe,D,ANA,23,33,1,12,13
8,8476372,Nick Seeler,D,PHI,31,52,1,12,13
8,8483397,Marc McLaughlin,C,BOS,25,39,9,3,12
8,8482659,Josh Doan,R,UTA,22,50,8,4,12
8,8477887,Patrick Brown,C,BOS,32,46,8,4,12
8,8478569,Noel Acciari,C,PIT,33,55,7,5,12
8,8479315,Joey Anderson,R,CHI,26,42,6,6,12
8,8476889,Radek Faksa,C,STL,30,52,6,6,12
8,8479968,Vinni Lettieri,C,BOS,29,51,6,6,12
8,8483499,Liam Ohgren,L,MIN,20,58,5,7,12
8,8476873,Mark Jankowski,C,NSH,30,55,5,7,12
8,8479026,Philippe Myers,D,TOR,27,49,5,7,12
8,8482652,Walker Duehr,R,CGY,27,50,5,7,12
8,8478468,Jeremy Lauzon,D,NSH,27,53,5,7,12
8,8481592,Jakob Pelletier,L,CGY,23,41,5,7,12
8,8483495,Simon Nemec,D,NJD,20,58,4,8,12
8,8481013,Jonatan Berggren,R,DET,24,61,4,8,12
8,8481524,Bowen Byram,D,BUF,23,54,4,8,12
8,8479359,Beck Malenstyn,L,BUF,26,51,3,9,12
8,8475208,Brian Dumoulin,D,ANA,33,59,3,9,12
8,8476994,Vinnie Hinostroza,C,NSH,30,42,3,9,12
8,8476967,Brett Kulak,D,EDM,30,65,2,10,12
8,8480891,Michael Kesselring,D,UTA,24,48,2,10,12
8,8475455,Brenden Dillon,D,NJD,34,55,2,10,12
8,8474568,Luke Schenn,D,NSH,35,51,2,10,12
8,8479378,Logan Stanley,D,WPG,26,37,2,10,12
8,8477365,Connor Clifton,D,BUF,29,57,1,11,12
8,8479369,Andrew Peeke,D,BOS,26,52,1,11,12
8,8475690,Chris Tanev,D,TOR,35,52,0,12,12
8,8482077,Dylan Holloway,L,EDM,23,51,7,4,11
8,8481556,John Beecher,C,BOS,23,34,7,4,11
8,8479994,Jaret Anderson-Dolan,C,WPG,25,37,6,5,11
8,8479671,Mathieu Olivier,R,CBJ,27,49,6,5,11
8,8479344,Jesse Puljujarvi,R,PIT,26,49,5,6,11
8,8479972,Mason Shaw,C,WPG,26,36,5,6,11
8,8480222,Sebastian Aho,D,PIT,28,70,4,7,11
8,8479442,Troy Stecher,D,EDM,30,58,4,7,11
8,8480990,Declan Chisholm,D,MIN,24,49,4,7,11
8,8480007,Jonas Rondbjerg,R,VGK,25,41,4,7,11
8,8482451,Mikael Pyyhtia,L,CBJ,23,44,3,8,11
8,8480879,Jacob Bernard-Docker,D,OTT,24,51,3,8,11
8,8477499,Rasmus Ristolainen,D,PHI,30,56,2,9,11
8,8481019,David Gustafsson,C,WPG,24,40,1,10,11
8,8478399,Jonas Siegenthaler,D,NJD,27,58,1,10,11
8,8474013,Ian Cole,D,UTA,35,55,1,10,11
8,8482095,Tyler Kleven,D,OTT,22,38,1,10,11
8,8478859,Niko Mikkola,D,FLA,28,58,1,10,11
8,8483012,Logan Morrison,C,SEA,22,37,1,10,11
8,8476934,Brock McGinn,L,ANA,30,50,8,2,10
8,8477380,Jonny Brodzinski,C,NYR,31,50,6,4,10
8,8477070,Liam O'Brien,C,UTA,30,56,6,4,10
8,8479439,Jacob MacDonald,D,COL,31,53,5,5,10
8,8476867,Brendan Gaunce,C,MIN,30,32,5,5,10
8,8481167,Brayden Pachal,D,CGY,25,31,5,5,10
8,8479772,Zack MacEwen,R,OTT,28,56,5,5,10
8,8471817,Ryan Reaves,R,TOR,37,60,4,6,10
8,8475958,Michael Sgarbossa,C,WSH,32,24,3,7,10
8,8478874,Adam Gaudette,C,OTT,28,35,3,7,10
8,8483763,Maksymilian Szuber,D,UTA,22,35,2,8,10
8,8483466,Kevin Korchinski,D,CHI,20,49,2,8,10
8,8477018,Ben Hutton,D,VGK,31,43,2,8,10
8,8474612,Travis Hamonic,D,OTT,34,56,2,8,10
8,8475177,Calvin de Haan,D,COL,33,47,1,9,10
8,8477335,Kyle Burroughs,D,LAK,29,46,1,9,10
8,8479249,Andrew Poturalski,C,SJS,30,35,1,9,10
8,8476891,Matt Grzelcyk,D,PIT,30,76,0,10,10
8,8474090,Brendan Smith,D,DAL,35,71,0,10,10
8,8482762,Simon Edvinsson,D,DET,21,52,6,3,9
8,8481518,Nolan Foote,L,NJD,24,36,5,4,9
8,8475235,Nicolas Deslauriers,L,PHI,33,55,5,4,9
8,8478585,Derek Ryan,C,EDM,38,66,4,5,9
8,8481598,Philip Broberg,D,EDM,23,45,4,5,9
8,8482070,Mitchell Chaffee,R,TBL,26,47,4,5,9
8,8482713,Mackie Samoskevich,R,FLA,22,38,4,5,9
8,8476442,Matt Nieto,L,PIT,32,49,3,6,9
8,8481161,Jake Christiansen,D,CBJ,25,57,3,6,9
8,8476952,Dominic Toninato,C,WPG,30,35,3,6,9
8,8475750,Jon Merrill,D,MIN,32,55,3,6,9
8,8474166,Alec Martinez,D,CHI,37,49,2,7,9
8,8480834,Ty Emberson,D,SJS,24,45,1,8,9
8,8476473,Connor Murphy,D,CHI,31,50,1,8,9
8,8475762,Derek Forbort,D,VAN,32,42,0,9,9
8,8479944,Zach Aston-Reese,C,VGK,30,46,7,1,8
8,8482144,Jack Thompson,D,SJS,22,30,4,4,8
8,8477573,Nathan Walker,L,STL,30,53,3,5,8
8,8477962,Brendan Lemieux,L,CAR,28,37,3,5,8
8,8482511,Mason Lohrei,D,BOS,23,36,3,5,8
8,8477851,Jordan Oesterle,D,BOS,32,39,3,5,8
8,8481600,Tobias Bjornfot,D,FLA,23,43,2,6,8
8,8477931,Tomas Nosek,L,FLA,32,58,2,6,8
8,8478409,Anthony Richard,C,PHI,28,37,2,6,8
8,8482784,Zach Dean,C,STL,21,39,1,7,8
8,8480157,Calle Rosen,D,COL,30,49,1,7,8
8,8479986,Kole Lind,R,DAL,26,51,1,7,8
8,8482730,Brandt Clarke,D,LAK,21,55,1,7,8
8,8482861,Vincent Iorio,D,WSH,22,24,1,7,8
8,8482858,Ryker Evans,D,SEA,23,33,1,7,8
8,8479980,Nicolas Hague,D,VGK,26,51,0,8,8
8,8479536,Axel Jonsson-Fjallby,L,WPG,26,47,4,3,7
8,8471677,Jack Johnson,D,CBJ,37,61,3,4,7
8,8479291,Kevin Rooney,C,CGY,31,35,3,4,7
8,8480870,Bo Groulx,C,NYR,24,39,3,4,7
8,8482666,Scott Morrow,D,CAR,22,55,3,4,7
8,8478424,Jansen Harkins,C,ANA,27,40,3,4,7
8,8481122,Simon Benoit,D,TOR,26,46,2,5,7
8,8481237,Kyle MacLean,C,NYI,25,33,2,5,7
8,8477034,Jaycob Megna,D,FLA,32,43,1,6,7
8,8480292,Carson Meyer,R,ANA,27,34,1,6,7
8,8477384,Josh Brown,D,EDM,30,38,1,6,7
8,8475795,Dylan McIlrath,D,WSH,32,19,1,6,7
8,8479370,Tyson Jost,C,CAR,26,49,0,7,7
8,8480887,Jordan Harris,D,MTL,24,56,0,7,7
8,8484254,Akito Hirose,D,VAN,25,36,4,2,6
8,8482153,Brendan Brisson,C,VGK,23,35,4,2,6
8,8480880,Jakub Lauko,C,MIN,24,34,4,2,6
8,8481609,Vladislav Kolyachonok,D,UTA,23,36,4,2,6
8,8476913,Devin Shore,C,MIN,30,27,3,3,6
8,8481754,Nikita Nesterenko,C,ANA,23,38,3,3,6
8,8479981,Jonah Gadjovich,L,FLA,26,34,3,3,6
8,8482166,Shakir Mukhamadullin,D,SJS,22,48,2,4,6
8,8476441,Joel Edmundson,D,LAK,31,38,2,4,6
8,8481701,Santeri Hatakka,D,NJD,23,29,2,4,6
8,8481532,Alex Turcotte,C,LAK,23,41,2,4,6
8,8480245,Olle Lycksell,R,PHI,25,21,2,4,6
8,8482470,Ilya Solovyov,D,CGY,24,20,2,4,6
8,8478021,William Lagesson,D,DET,28,31,1,5,6
8,8480196,Jacob Bryson,D,BUF,27,39,0,6,6
8,8477971,Andreas Englund,D,LAK,28,26,0,6,6
8,8477505,Alexander Wennberg,C,SJS,30,46,3,2,5
8,8481743,Marc Del Gaizo,D,NSH,25,19,3,2,5
8,8482733,Logan Mailloux,D,MTL,31,35,3,2,5
8,8480851,Akil Thomas,C,LAK,24,19,3,2,5
8,8479379,Givani Smith,R,SJS,26,34,2,3,5
8,8477938,Haydn Fleury,D,WPG,28,41,1,4,5
8,8482747,Brennan Othmann,L,NYR,21,34,1,4,5
8,8478454,Noah Juulsen,D,VAN,27,40,1,4,5
8,8478502,Dennis Gilbert,D,BUF,28,21,1,4,5
8,8481719,Maxwell Crozier,D,TBL,24,25,1,4,5
8,8473446,Erik Johnson,D,PHI,36,34,0,5,5
8,8478450,Parker Wotherspoon,D,BOS,27,41,0,5,5
8,8481679,Maxence Guenette,D,OTT,23,28,4,0,4
8,8482496,Nils Aman,C,VAN,24,35,3,1,4
8,8479985,Cale Fleury,D,SEA,26,32,3,1,4
8,8478017,Mark Friedman,D,VAN,29,28,3,1,4
8,8475755,Alexander Petrovic,D,DAL,32,23,3,1,4
8,8483570,Ben Meyers,C,SEA,26,30,3,1,4
8,8482145,Mavrik Bourque,C,DAL,22,57,2,2,4
8,8482177,Marat Khusnutdinov,C,MIN,22,35,2,2,4
8,8481422,Jacob Lucchini,C,NSH,29,27,2,2,4
8,8480032,Shane Bowers,C,NJD,25,14,2,2,4
8,8480468,James Hamblin,L,EDM,25,21,2,2,4
8,8483489,Fraser Minten,C,TOR,31,14,2,2,4
8,8477462,Robert Hagg,D,VGK,29,23,1,3,4
8,8477473,Justin Bailey,R,SJS,29,21,1,3,4
8,8482929,Emil Lilleberg,D,TBL,23,17,1,3,4
8,8480844,Grigori Denisenko,L,VGK,24,36,1,3,4
8,8482765,Isak Rosen,R,BUF,21,27,1,3,4
8,8480070,Ian Mitchell,D,BOS,25,45,0,4,4
8,8483619,Filip Roos,D,OTT,25,36,0,4,4
8,8477810,Joel Hanley,D,CGY,33,24,0,4,4
8,8482201,Gage Goncalves,C,TBL,23,26,0,4,4
8,8482165,Yan Kuznetsov,D,CGY,22,19,0,4,4
8,8479320,Max Lajoie,D,SEA,27,15,2,1,3
8,8479419,Brett Murray,L,BUF,26,17,2,1,3
8,8484287,Cole McWard,D,VAN,23,21,2,1,3
8,8479367,William Lockwood,R,FLA,26,19,2,1,3
8,8481056,Spencer Stastney,D,NSH,24,35,1,2,3
8,8479991,Jake Leschyshyn,C,NYR,25,24,1,2,3
8,8477401,John Hayden,C,SEA,29,30,1,2,3
8,8481543,Nikita Alexandrov,C,STL,24,21,1,2,3
8,8482172,Landon Slaggert,L,CHI,22,24,1,2,3
8,8481593,Jayden Struble,D,MTL,23,18,1,2,3
8,8482250,Callahan Burke,C,VGK,27,20,1,2,3
8,8481699,Aku Raty,R,UTA,23,24,1,2,3
8,8477244,Chad Ruhwedel,D,NYR,34,38,0,3,3
8,8477073,Kurtis MacDermid,L,NJD,30,35,0,3,3
8,8479587,Rhett Gardner,C,PHI,28,11,0,3,3
8,8483630,Pavol Regenda,L,ANA,25,30,2,0,2
8,8482751,Ryan Winterton,C,SEA,21,35,2,0,2
8,8481206,John Ludvig,D,PIT,24,21,2,0,2
8,8481541,Samuel Bolduc,D,NYI,24,26,1,1,2
8,8484304,Uvis Balinskis,D,FLA,28,8,1,1,2
8,8481006,Tyler Tucker,D,STL,24,20,1,1,2
8,8478146,Matthew Highmore,C,OTT,28,20,1,1,2
8,8480890,Jan Jenik,R,OTT,24,28,1,1,2
8,8478011,Louie Belpedio,D,PHI,28,9,1,1,2
8,8482061,Brandon Biro,L,SEA,26,12,1,1,2
8,8474062,Riley Nash,C,NYR,35,22,1,1,2
8,8483471,Brad Lambert,C,WPG,31,10,1,1,2
8,8481585,Egor Afanasyev,L,SJS,23,14,1,1,2
8,8480306,Grant Hutton,D,NYI,29,9,1,1,2
8,8482102,Vasily Ponomarev,C,PIT,22,25,1,1,2
8,8479330,Brandon Gignac,C,MTL,27,12,1,1,2
8,8481147,Reese Johnson,C,MIN,26,39,0,2,2
8,8480084,Nick DeSimone,D,NJD,30,20,0,2,2
8,8477149,Scott Sabourin,R,SJS,32,16,0,2,2
8,8480267,Sammy Walker,C,MIN,25,25,0,2,2
8,8478051,Max Willman,C,NJD,29,17,0,2,2
8,8475413,Justin Dowling,C,NJD,34,16,0,2,2
8,8481564,Ryan Johnson,D,BUF,23,17,0,2,2
8,8482094,Daemon Hunt,D,MIN,22,15,0,2,2
8,8480823,Alexander Alexeyev,D,WSH,25,11,0,2,2
8,8481578,Graeme Clarke,R,MIN,23,12,0,2,2
8,8475780,Chris Wagner,R,COL,33,9,0,2,2
8,8484258,Sam Malinski,D,COL,26,17,1,0,1
8,8478446,Glenn Gawdin,C,LAK,27,18,1,0,1
8,8478881,Brett Seney,L,CHI,28,8,1,0,1
8,8477993,Justin Kirkland,C,CGY,28,9,1,0,1
8,8477541,Dakota Mermis,D,TOR,30,11,1,0,1
8,8483531,Brian Halonen,L,NJD,25,5,1,0,1
8,8481462,Mason Morelli,L,VGK,28,10,1,0,1
8,8483546,Marshall Rifai,D,TOR,26,3,1,0,1
8,8481726,Adam Edstrom,C,NYR,24,9,1,0,1
8,8482147,Jean-Luc Foudy,C,COL,22,26,0,1,1
8,8483549,Lucas Condotta,L,MTL,27,16,0,1,1
8,8481065,Angus Crookshank,L,OTT,25,17,0,1,1
8,8482118,Sam Colangelo,R,ANA,23,23,0,1,1
8,8484325,Waltteri Merela,C,TBL,26,22,0,1,1
8,8479421,Jacob Moverare,D,LAK,26,16,0,1,1
8,8481030,Jack St. Ivany,D,PIT,25,18,0,1,1
8,8483398,Declan Carlile,D,TBL,31,4,0,1,1
8,8482088,Justin Sourdif,R,FLA,22,20,0,1,1
8,8480874,Adam Ginning,D,PHI,24,8,0,1,1
8,8484255,Jason Polin,R,COL,25,6,0,1,1
8,8482787,Nikita Chibrikov,R,WPG,31,8,0,1,1
8,8483512,Matt Savoie,C,EDM,20,19,0,1,1
8,8482476,Emil Heineman,L,MTL,23,6,0,1,1
8,8484326,Patrik Koch,D,UTA,28,4,0,1,1
8,8482126,Emil Andrae,D,PHI,31,4,0,1,1
8,8479362,Riley Tufte,L,BOS,26,22,0,0,0
8,8478477,Mitchell Stephens,C,SEA,27,11,0,0,0
8,8477527,Ross Johnston,L,ANA,30,23,0,0,0
8,8479576,Vincent Desharnais,D,VAN,28,36,0,0,0
8,8481043,Cole Koepke,L,BOS,26,14,0,0,0
8,8477467,Gustav Olofsson,D,SEA,30,13,0,0,0
8,8477320,Anton Blidh,L,NYR,29,20,0,0,0
8,8483597,Milos Kelemen,L,UTA,25,9,0,0,0
8,8482197,Adam Raska,R,MIN,23,4,0,0,0
8,8481024,Linus Karlsson,C,VAN,25,16,0,0,0
8,8482516,Matthew Kessel,D,STL,24,13,0,0,0
8,8483395,Arshdeep Bains,L,VAN,23,8,0,0,0
8,8480075,Cameron Crotty,D,MIN,25,5,0,0,0
8,8482162,Roby Jarventie,L,EDM,22,18,0,0,0
8,8483567,Georgii Merkulov,C,BOS,24,6,0,0,0
8,8483920,Pierrick Dube,R,WSH,23,3,0,0,0
8,8483432,Luca Del Bel Belluz,C,CBJ,31,1,0,0,0
8,8483609,Adam Klapka,R,CGY,24,4,0,0,0
8,8482460,Matt Rempe,C,NYR,22,14,0,0,0
8,8481806,Louis Crevier,D,CHI,23,6,0,0,0
8,8479522,Hardy Haman Aktell,D,WSH,26,2,0,0,0
8,8478147,Bokondji Imama,L,PIT,28,7,0,0,0
8,8481655,Cole Schwindt,R,CGY,23,5,0,0,0
8,8481534,Raphael Lavoie,C,EDM,24,2,0,0,0
8,8484259,Ondrej Pavel,C,COL,31,0,0,0,0
8,8483407,Brandon Scanlin,D,NYR,25,3,0,0,0
8,8478854,Ryan Shea,D,PIT,27,4,0,0,0
8,8476323,Max McCormick,L,SEA,32,2,0,0,0
8,8479321,Lucas Johansen,D,,27,0,0,0,0
8,8470794,Joe Pavelski,C,,40,0,0,0,0
8,8477950,Tony DeAngelo,D,,29,0,0,0,0
8,8471218,Blake Wheeler,R,,38,0,0,0,0
8,8475197,Tyson Barrie,D,,33,0,0,0,0
8,8475744,Evgeny Kuznetsov,C,,32,0,0,0,0
8,8474037,James van Riemsdyk,L,,35,0,0,0,0
8,8474602,Justin Schultz,D,,34,0,0,0,0
8,8482222,Alexander Barabanov,L,,30,0,0,0,0
8,8474157,Max Pacioretty,L,,36,0,0,0,0
8,8474031,Kevin Shattenkirk,D,,35,0,0,0,0
8,8480884,Calen Addison,D,,24,0,0,0,0
8,8480008,Adam Ruzicka,C,,25,0,0,0,0
8,8475906,John Klingberg,D,,32,0,0,0,0
8,8476884,Derrick Pouliot,D,,30,0,0,0,0
8,8476919,Chris Tierney,C,,30,0,0,0,0
8,8479415,Michael McLeod,C,,26,0,0,0,0
8,8474884,Mike Hoffman,C,,35,0,0,0,0
8,8478104,Sammy Blais,L,,28,0,0,0,0
8,8474870,Tyler Johnson,C,,34,0,0,0,0
8,8481591,Sam Poulin,R,,23,0,0,0,0
8,8479977,Kailer Yamamoto,R,,26,0,0,0,0
8,8476393,Nick Cousins,C,,31,0,0,0,0
8,8479376,Victor Mete,D,,26,0,0,0,0
8,8476871,Tanner Pearson,L,,32,0,0,0,0
8,8471274,Alex Goligoski,D,,39,0,0,0,0
8,8481058,Jesse Ylönen,R,,25,0,0,0,0
8,8477464,Nic Petan,C,,29,0,0,0,0
8,8473449,Kyle Okposo,R,,36,0,0,0,0
8,8480216,Jacob Peterson,C,,25,0,0,0,0
8,8479346,Dillon Dube,C,,26,0,0,0,0
8,8470966,Mark Giordano,D,,41,0,0,0,0
8,8480821,Filip Zadina,R,,25,0,0,0,0
8,8476907,Mackenzie MacEachern,L,,30,0,0,0,0
8,8478430,Oliver Kylington,D,,27,0,0,0,0
8,8479514,Rem Pitlick,C,,27,0,0,0,0
8,8478099,Kevin Labanc,R,,29,0,0,0,0
8,8482241,Radim Zohorna,L,,28,0,0,0,0
8,8474040,Sam Gagner,C,,35,0,0,0,0
8,8475164,Jakob Silfverberg,R,,34,0,0,0,0
8,8475752,Tyler Pitlick,C,,33,0,0,0,0
8,8479984,Cal Foote,D,,26,0,0,0,0
8,8478495,Denis Gurianov,R,,27,0,0,0,0
8,8479533,Joona Koppanen,L,,26,0,0,0,0
8,8479458,Nikita Zaitsev,D,,33,0,0,0,0
8,8471699,Andrew Cogliano,C,,37,0,0,0,0
8,8470604,Jeff Carter,C,,39,0,0,0,0
8,8477330,Dominik Kubalik,L,,29,0,0,0,0
8,8477944,Jakub Vrana,L,,28,0,0,0,0
8,8478904,Steven Lorentz,C,,28,0,0,0,0
8,8471686,Marc Staal,D,,37,0,0,0,0
8,8478512,Austin Czarnik,C,,32,0,0,0,0
8,8470610,Zach Parise,L,,40,0,0,0,0
8,8473504,Cal Clutterbuck,R,,37,0,0,0,0
8,8474009,Nick Bonino,C,,36,0,0,0,0
8,8477454,Adam Erne,L,,29,0,0,0,0
8,8477126,Jayson Megna,C,,34,0,0,0,0
8,8473473,Milan Lucic,L,,36,0,0,0,0
8,8478067,Oskar Lindblom,L,,28,0,0,0,0
8,8475825,Jani Hakanpää,D,,32,0,0,0,0
8,8479383,Boris Katchouk,L,,26,0,0,0,0
8,8478400,Colin White,C,,27,0,0,0,0
8,8477846,Ryan Carpenter,C,,33,0,0,0,0
8,8477930,Pierre-Edouard Bellemare,L,,39,0,0,0,0
8,8479423,Alex Nylander,L,,26,0,0,0,0
8,8475797,Jarred Tinordi,D,,32,0,0,0,0
8,8481239,Samuel Fagemo,L,,24,0,0,0,0
8,8474618,Marco Scandella,D,,34,0,0,0,0
8,8480853,Liam Foudy,C,,24,0,0,0,0
8,8478028,Fredrik Olofsson,L,,28,0,0,0,0
8,8474145,Robert Bortuzzo,D,,35,0,0,0,0
8,8474709,Matt Martin,L,,35,0,0,0,0
8,8480226,Marián Studenic,R,,26,0,0,0,0
8,8480274,Philip Kemp,D,EDM,25,0,0,0,0
8,8480184,Gustav Lindstrom,D,,26,0,0,0,0
8,8481077,John Leonard,L,,26,0,0,0,0
8,8479547,Matthew Phillips,R,,26,0,0,0,0
8,8476915,Jujhar Khaira,L,,30,0,0,0,0
8,8481070,Hugh McGing,L,,26,0,0,0,0
8,8478408,Travis Dermott,D,,28,0,0,0,0
8,8481812,Nikolai Knyzhov,D,,27,0,0,0,0
8,8484321,Nikolas Matinpalo,D,OTT,26,0,0,0,0
8,8475278,Byron Froese,C,,33,0,0,0,0
8,8475766,Austin Watson,L,,32,0,0,0,0
8,8479546,Oskar Steen,C,,26,0,0,0,0
8,8480836,Jonathan Gruden,C,,24,0,0,0,0
8,8481690,Tyler Angle,C,,24,0,0,0,0
8,8480031,Maxime Comtois,L,,25,0,0,0,0
8,8483045,Cameron Butler,R,CBJ,31,0,0,0,0
8,8478078,Rourke Chartier,C,,28,0,0,0,0
8,8481016,Ruslan Iskhakov,C,,24,0,0,0,0
8,8484314,Jiri Smejkal,L,,28,0,0,0,0
8,8478956,Samuel Laberge,L,NJD,27,0,0,0,0
8,8483401,Marc Johnstone,R,PIT,28,2,0,0,0
8,8480776,Sheldon Rempal,R,,29,0,0,0,0
9,8478402,Connor McDavid,C,EDM,27,80,56,95,151
9,8476453,Nikita Kucherov,R,TBL,31,82,45,97,142
9,8477492,Nathan MacKinnon,C,COL,29,81,53,87,140
9,8477956,David Pastrnak,R,BOS,28,81,64,61,125
9,8479314,Matthew Tkachuk,L,FLA,27,79,31,90,121
9,8479318,Auston Matthews,C,TOR,27,82,62,54,116
9,8478864,Kirill Kaprizov,L,MIN,27,73,53,57,110
9,8477939,William Nylander,R,TOR,28,82,41,65,106
9,8477933,Sam Reinhart,C,FLA,29,78,47,52,99
9,8471675,Sidney Crosby,C,PIT,37,74,37,60,97
9,8480027,Jason Robertson,L,DAL,25,81,42,52,94
9,8478420,Mikko Rantanen,R,COL,28,81,42,52,94
9,8477934,Leon Draisaitl,C,EDM,29,78,40,54,94
9,8477409,Carter Verhaeghe,C,FLA,29,80,45,45,90
9,8477942,Kevin Fiala,L,LAK,28,80,32,58,90
9,8477946,Dylan Larkin,C,DET,28,81,38,49,87
9,8478403,Jack Eichel,C,VGK,28,77,38,48,86
9,8476460,Mark Scheifele,C,WPG,31,77,31,55,86
9,8480208,Drake Batherson,R,OTT,26,78,28,58,86
9,8480800,Quinn Hughes,D,VAN,25,74,14,72,86
9,8476468,J.T. Miller,C,VAN,31,74,30,55,85
9,8477493,Aleksander Barkov,C,FLA,29,77,23,62,85
9,8479407,Jesper Bratt,L,NJD,26,81,41,43,84
9,8478010,Brayden Point,C,TBL,28,82,40,43,83
9,8476887,Filip Forsberg,L,NSH,30,75,37,46,83
9,8479337,Alex DeBrincat,R,DET,27,82,37,46,83
9,8471685,Anze Kopitar,C,LAK,37,80,25,58,83
9,8480002,Nico Hischier,C,NJD,25,72,34,48,82
9,8480012,Elias Pettersson,C,VAN,26,77,26,56,82
9,8475172,Nazem Kadri,C,CGY,34,78,38,43,81
9,8482116,Tim Stützle,C,OTT,22,80,28,53,81
9,8477504,Josh Morrissey,D,WPG,29,74,19,62,81
9,8478550,Artemi Panarin,L,NYR,33,77,29,51,80
9,8473419,Brad Marchand,L,BOS,36,82,27,53,80
9,8477404,Jake Guentzel,C,TBL,30,82,38,41,79
9,8477496,Elias Lindholm,C,BOS,30,78,34,45,79
9,8480036,Miro Heiskanen,D,DAL,25,81,15,64,79
9,8481559,Jack Hughes,C,NJD,23,76,28,50,78
9,8475167,Victor Hedman,D,TBL,34,78,16,62,78
9,8478449,Roope Hintz,C,DAL,28,82,42,35,77
9,8480801,Brady Tkachuk,L,OTT,25,78,29,48,77
9,8477951,Nick Schmaltz,C,UTA,28,79,21,56,77
9,8478398,Kyle Connor,L,WPG,28,73,42,34,76
9,8477501,Valeri Nichushkin,R,COL,29,81,39,37,76
9,8479420,Tage Thompson,C,BUF,27,76,35,41,76
9,8479542,Brandon Hagel,L,TBL,26,82,33,43,76
9,8480830,Andrei Svechnikov,R,CAR,24,70,33,43,76
9,8479343,Clayton Keller,R,UTA,26,76,30,46,76
9,8475913,Mark Stone,R,VGK,32,78,21,55,76
9,8478493,Joel Eriksson Ek,C,MIN,27,74,39,36,75
9,8475166,John Tavares,C,TOR,34,81,28,47,75
9,8475786,Zach Hyman,L,EDM,32,76,36,38,74
9,8478427,Sebastian Aho,C,CAR,27,76,31,42,73
9,8481557,Matt Boldy,L,MIN,23,73,28,45,73
9,8484144,Connor Bedard,C,CHI,19,67,27,46,73
9,8476456,Jonathan Huberdeau,C,CGY,31,79,19,54,73
9,8477940,Nikolaj Ehlers,L,WPG,28,69,25,47,72
9,8473512,Claude Giroux,R,OTT,36,79,24,48,72
9,8482078,Lucas Raymond,L,DET,22,82,28,43,71
9,8474564,Steven Stamkos,C,NSH,34,78,27,43,70
9,8475168,Matt Duchene,C,DAL,33,82,20,49,69
9,8475784,Jeff Skinner,C,EDM,32,79,38,30,68
9,8478975,Mason Marchment,L,DAL,29,82,31,37,68
9,8478414,Timo Meier,R,NJD,28,77,29,39,68
9,8482113,Anton Lundell,C,FLA,23,78,28,40,68
9,8480069,Cale Makar,D,COL,26,69,21,47,68
9,8482699,Dylan Guenther,R,UTA,21,76,33,34,67
9,8478445,Mathew Barzal,C,NYI,27,78,14,53,67
9,8471214,Alex Ovechkin,L,WSH,39,72,34,32,66
9,8480018,Nick Suzuki,C,MTL,25,79,25,41,66
9,8476346,Johnny Gaudreau,L,CBJ,31,68,17,49,66
9,8475765,Vladimir Tarasenko,R,DET,33,81,31,34,65
9,8477402,Pavel Buchnevich,L,STL,29,74,30,35,65
9,8479675,Trevor Moore,L,LAK,29,79,29,36,65
9,8476459,Mika Zibanejad,C,NYR,31,79,28,37,65
9,8478444,Brock Boeser,R,VAN,27,71,36,28,64
9,8477949,Alex Tuch,R,BUF,28,71,23,41,64
9,8473994,Jamie Benn,L,DAL,35,80,19,45,64
9,8476454,Ryan Nugent-Hopkins,C,EDM,31,79,17,47,64
9,8478439,Travis Konecny,R,PHI,27,76,32,31,63
9,8476399,Blake Coleman,C,CGY,33,77,31,32,63
9,8480039,Martin Necas,C,CAR,25,71,29,34,63
9,8474141,Patrick Kane,R,DET,36,78,28,35,63
9,8477935,Sam Bennett,C,FLA,28,78,28,35,63
9,8480839,Rasmus Dahlin,D,BUF,24,71,22,41,63
9,8476853,Morgan Rielly,D,TOR,30,75,8,55,63
9,8475810,Bryan Rust,R,PIT,32,74,35,27,62
9,8482740,Wyatt Johnston,C,DAL,21,79,34,28,62
9,8477960,Adrian Kempe,R,LAK,28,80,29,33,62
9,8482665,Matty Beniers,C,SEA,22,78,25,37,62
9,8480023,Robert Thomas,C,STL,25,75,17,45,62
9,8475754,Brock Nelson,C,NYI,33,80,31,30,61
9,8479999,Casey Mittelstadt,C,COL,26,82,21,40,61
9,8478401,Pavel Zacha,C,BOS,27,78,20,41,61
9,8480865,Noah Dobson,D,NYI,24,77,15,46,61
9,8479325,Charlie McAvoy,D,BOS,27,76,7,54,61
9,8480798,Philipp Kurashev,C,CHI,25,73,26,34,60
9,8475158,Ryan O'Reilly,C,NSH,33,71,25,35,60
9,8476389,Vincent Trocheck,C,NYR,31,76,20,40,60
9,8478460,Zach Werenski,D,CBJ,27,78,12,48,60
9,8477447,Shea Theodore,D,VGK,29,59,9,51,60
9,8475184,Chris Kreider,L,NYR,33,77,37,22,59
9,8477416,Oliver Bjorkstrand,R,SEA,29,73,25,34,59
9,8475692,Mats Zuccarello,R,MIN,37,68,15,44,59
9,8480803,Evan Bouchard,D,EDM,25,74,11,48,59
9,8476432,Boone Jenner,C,CBJ,31,72,35,23,58
9,8475794,Tyler Seguin,C,DAL,32,79,31,27,58
9,8477456,J.T. Compher,L,DET,29,79,24,34,58
9,8476906,Shayne Gostisbehere,D,CAR,31,76,14,44,58
9,8479323,Adam Fox,D,NYR,26,73,12,46,58
9,8476539,Jonathan Marchessault,R,NSH,34,73,33,24,57
9,8471215,Evgeni Malkin,C,PIT,38,67,26,31,57
9,8479385,Jordan Kyrou,C,STL,26,71,25,32,57
9,8477494,Jonathan Drouin,L,COL,29,79,20,37,57
9,8475798,Mikael Granlund,C,SJS,32,71,12,45,57
9,8480064,Josh Norris,C,OTT,25,77,32,24,56
9,8481528,Dylan Cozens,C,BUF,23,73,25,31,56
9,8482159,Tyson Foerster,R,PHI,22,78,25,31,56
9,8477503,Max Domi,C,TOR,29,81,15,41,56
9,8477495,Seth Jones,D,CHI,30,75,13,43,56
9,8474600,Roman Josi,D,NSH,34,70,10,46,56
9,8478474,Lawson Crouse,L,UTA,27,76,36,19,55
9,8476881,Tomas Hertl,C,VGK,31,75,27,28,55
9,8474150,Mikael Backlund,C,CGY,35,75,26,29,55
9,8478466,Daniel Sprong,R,VAN,27,71,26,28,54
9,8475170,Brayden Schenn,C,STL,33,78,22,32,54
9,8474578,Erik Karlsson,D,PIT,34,79,14,40,54
9,8482093,Seth Jarvis,C,CAR,22,69,27,26,53
9,8481540,Cole Caufield,R,MTL,23,76,25,28,53
9,8476448,William Karlsson,C,VGK,31,76,22,31,53
9,8476882,Teuvo Teravainen,L,CHI,30,63,19,34,53
9,8475745,Charlie Coyle,C,BOS,32,76,17,36,53
9,8482684,Luke Hughes,D,NJD,21,74,10,43,53
9,8480015,Owen Tippett,R,PHI,25,77,29,23,52
9,8482720,Matthew Knies,L,TOR,22,78,22,30,52
9,8474679,Gustav Nyquist,C,NSH,35,69,13,39,52
9,8477500,Bo Horvat,C,NYI,29,80,34,17,51
9,8475726,Tyler Toffoli,C,SJS,32,70,28,23,51
9,8478440,Dylan Strome,C,WSH,27,71,22,29,51
9,8478047,Michael Bunting,L,PIT,29,71,22,29,51
9,8480797,Joel Farabee,L,PHI,24,77,19,32,51
9,8471724,Kris Letang,D,PIT,37,82,9,42,51
9,8475799,Nino Niederreiter,R,WPG,32,69,29,21,50
9,8478856,Conor Garland,R,VAN,28,72,20,30,50
9,8479425,Filip Hronek,D,VAN,27,75,15,35,50
9,8478397,Rasmus Andersson,D,CGY,28,72,8,42,50
9,8482109,Alexis Lafrenière,L,NYR,23,77,23,26,49
9,8480113,Alex Iafallo,L,WPG,31,67,23,26,49
9,8483431,Logan Cooley,C,UTA,20,76,20,29,49
9,8478873,Troy Terry,R,ANA,27,72,20,29,49
9,8482097,Jack Quinn,R,BUF,23,66,18,31,49
9,8477021,Alex Kerfoot,C,UTA,30,78,17,32,49
9,8484166,Adam Fantilli,C,CBJ,20,69,16,33,49
9,8474641,Adam Henrique,C,EDM,34,77,16,33,49
9,8474590,John Carlson,D,WSH,34,71,11,38,49
9,8476880,Tom Wilson,R,WSH,30,70,27,21,48
9,8477955,Jared McCann,L,SEA,28,78,26,22,48
9,8481604,Pavel Dorofeyev,L,VGK,24,74,20,28,48
9,8478042,Viktor Arvidsson,R,EDM,31,71,19,29,48
9,8481533,Trevor Zegras,C,ANA,23,73,18,30,48
9,8476905,Chandler Stephenson,C,SEA,30,72,15,33,48
9,8476792,Torey Krug,D,STL,33,76,15,33,48
9,8481711,Matias Maccelli,L,UTA,24,77,24,23,47
9,8475169,Evander Kane,L,EDM,33,77,24,23,47
9,8476483,Rickard Rakell,R,PIT,31,70,23,24,47
9,8478519,Anthony Cirelli,C,TBL,27,82,22,25,47
9,8480188,Fabian Zetterlund,L,SJS,25,68,20,27,47
9,8482110,Dawson Mercer,C,NJD,23,71,20,27,47
9,8480220,Noah Cates,L,PHI,25,75,16,31,47
9,8477429,Andrew Copp,C,DET,30,78,15,32,47
9,8478469,Thomas Chabot,D,OTT,27,77,11,36,47
9,8477476,Artturi Lehkonen,L,COL,29,81,23,23,46
9,8478498,Jake DeBrusk,L,VAN,28,70,23,23,46
9,8484153,Leo Carlsson,C,ANA,20,71,22,24,46
9,8477479,Tyler Bertuzzi,L,CHI,29,73,18,28,46
9,8481618,Alex Newhook,C,MTL,23,73,17,29,46
9,8476872,Scott Laughton,C,PHI,30,76,17,29,46
9,8478038,Devon Toews,D,COL,30,73,11,35,46
9,8480434,Sean Durzi,D,UTA,26,64,11,35,46
9,8474102,David Perron,L,OTT,36,78,22,23,45
9,8482745,Mason McTavish,C,ANA,21,69,20,25,45
9,8481596,Shane Pinto,C,OTT,24,75,19,26,45
9,8477407,Anthony Duclair,L,NYI,29,80,17,28,45
9,8476292,Ondrej Palat,L,NJD,33,70,17,28,45
9,8478542,Evan Rodrigues,C,FLA,31,78,15,30,45
9,8482124,Quinton Byfield,R,LAK,22,78,13,32,45
9,8476958,Jaccob Slavin,D,CAR,30,75,6,39,45
9,8480014,Gabriel Vilardi,C,WPG,25,71,29,15,44
9,8481186,Logan O'Connor,R,COL,28,80,19,25,44
9,8483505,Matthew Poitras,C,BOS,20,80,19,25,44
9,8484145,Zach Benson,L,BUF,19,70,18,26,44
9,8483515,Juraj Slafkovsky,L,MTL,20,78,18,26,44
9,8477451,Ryan Hartman,R,MIN,30,69,14,30,44
9,8481581,Thomas Harley,D,DAL,23,82,10,34,44
9,8478366,Frank Vatrano,R,ANA,30,72,27,16,43
9,8479525,Ross Colton,C,COL,28,76,23,20,43
9,8477964,Ivan Barbashev,C,VGK,29,71,20,23,43
9,8474586,Jordan Eberle,R,SEA,34,75,16,27,43
9,8470613,Brent Burns,D,CAR,39,73,15,28,43
9,8475218,Mattias Ekholm,D,EDM,34,75,13,30,43
9,8476875,Mike Matheson,D,MTL,30,72,12,31,43
9,8481546,Cam York,D,PHI,23,66,7,36,43
9,8477511,Anthony Mantha,R,CGY,30,76,27,15,42
9,8475191,Reilly Smith,R,NYR,33,76,22,20,42
9,8481560,Arthur Kaliyev,R,LAK,23,81,22,20,42
9,8474716,Jared Spurgeon,D,MIN,35,79,18,24,42
9,8480802,Ryan McLeod,C,BUF,25,64,18,24,42
9,8477497,Sean Monahan,C,CBJ,30,67,16,26,42
9,8479987,Morgan Geekie,C,BOS,26,76,16,26,42
9,8482667,William Eklund,L,SJS,22,65,15,27,42
9,8482092,Ridly Greig,C,OTT,22,79,14,28,42
9,8480336,Sean Walker,D,CAR,30,74,11,31,42
9,8475722,Jason Zucker,L,BUF,32,63,19,22,41
9,8475768,Jaden Schwartz,C,SEA,32,72,17,24,41
9,8479339,Patrik Laine,L,CBJ,26,60,17,24,41
9,8480185,Eetu Luostarinen,C,FLA,26,65,17,24,41
9,8476462,Dougie Hamilton,D,NJD,31,72,13,28,41
9,8477498,Darnell Nurse,D,EDM,29,69,11,30,41
9,8482105,Jake Sanderson,D,OTT,22,77,10,31,41
9,8479345,Jakob Chychrun,D,WSH,26,66,10,31,41
9,8474563,Drew Doughty,D,LAK,35,77,4,37,41
9,8475151,Kyle Palmieri,C,NYI,33,79,23,17,40
9,8477444,Andre Burakovsky,L,SEA,29,71,18,22,40
9,8475793,Ryan Johansen,C,PHI,32,74,16,24,40
9,8477998,Warren Foegele,L,LAK,28,78,13,27,40
9,8480028,Morgan Frost,C,PHI,25,70,13,27,40
9,8475763,Kevin Hayes,R,PIT,32,68,13,27,40
9,8478046,Danton Heinen,L,VAN,29,72,12,28,40
9,8476869,Brady Skjei,D,NSH,30,73,12,28,40
9,8478055,Gustav Forsling,D,FLA,28,72,8,32,40
9,8476979,Erik Gustafsson,D,DET,32,79,8,32,40
9,8479410,Mikhail Sergachev,D,UTA,26,68,5,35,40
9,8482117,Lukas Reichel,L,CHI,22,58,20,19,39
9,8478462,Nicolas Roy,C,VGK,27,78,19,20,39
9,8481068,Yegor Sharangovich,C,CGY,26,76,14,25,39
9,8477948,Travis Sanheim,D,PHI,28,66,14,25,39
9,8473986,Alex Killorn,L,ANA,35,70,13,26,39
9,8477932,Aaron Ekblad,D,FLA,28,74,12,27,39
9,8478057,Dakota Joshua,C,VAN,28,68,20,18,38
9,8475791,Taylor Hall,L,CHI,33,59,18,20,38
9,8480459,Pius Suter,C,VAN,28,64,17,21,38
9,8482146,Luke Evangelista,R,NSH,22,70,16,22,38
9,8480849,Barrett Hayton,C,UTA,24,72,16,22,38
9,8483808,Andrei Kuzmenko,L,CGY,28,76,15,23,38
9,8476461,Sean Couturier,C,PHI,32,74,13,25,38
9,8474149,Evgenii Dadonov,R,DAL,35,82,11,27,38
9,8477346,MacKenzie Weegar,D,CGY,30,71,8,30,38
9,8481542,Moritz Seider,D,DET,23,75,7,31,38
9,8481703,Valtteri Puustinen,R,PIT,25,64,6,32,38
9,8477986,Brandon Montour,D,SEA,30,76,4,34,38
9,8480893,Kirill Marchenko,R,CBJ,24,62,23,14,37
9,8475314,Anders Lee,L,NYI,34,78,19,18,37
9,8482702,Logan Stankoven,C,DAL,21,82,15,22,37
9,8479365,Trent Frederic,C,BOS,26,77,14,23,37
9,8476463,Jonas Brodin,D,MIN,31,77,9,28,37
9,8480145,Neal Pionk,D,WPG,29,73,4,33,37
9,8482259,Bobby McMann,C,TOR,28,74,24,12,36
9,8477426,Nicholas Paul,L,TBL,29,81,20,16,36
9,8480813,Joe Veleno,C,DET,24,78,18,18,36
9,8476479,Phillip Danault,C,LAK,31,81,17,19,36
9,8476826,Yanni Gourde,C,SEA,33,72,17,19,36
9,8479992,Michael Rasmussen,C,DET,25,81,16,20,36
9,8482149,Cole Perfetti,C,WPG,22,72,15,21,36
9,8481577,Philip Tomasino,C,NSH,23,70,14,22,36
9,8478458,Jack Roslovic,C,CAR,27,63,13,23,36
9,8481624,Ilya Mikheyev,R,CHI,30,63,10,26,36
9,8476458,Ryan Strome,C,ANA,31,69,9,27,36
9,8478396,Noah Hanifin,D,VGK,27,62,9,27,36
9,8481523,Kirby Dach,C,MTL,23,69,9,27,36
9,8476923,Damon Severson,D,CBJ,30,80,7,29,36
9,8481582,Nicholas Robertson,L,TOR,23,72,21,14,35
9,8482705,Cole Sillinger,C,CBJ,21,66,19,16,35
9,8475848,Brendan Gallagher,R,MTL,32,68,15,20,35
9,8474053,Logan Couture,C,SJS,35,61,13,22,35
9,8474565,Alex Pietrangelo,D,VGK,34,61,9,26,35
9,8478013,Jake Walman,D,SJS,28,67,16,18,34
9,8482175,JJ Peterka,R,BUF,22,70,14,20,34
9,8476392,Adam Lowry,C,WPG,31,68,11,23,34
9,8482245,Artem Zub,D,OTT,29,68,8,26,34
9,8480871,Adam Boqvist,D,FLA,24,66,7,27,34
9,8475753,Justin Faulk,D,STL,32,69,6,28,34
9,8483490,Pavel Mintyukov,D,ANA,21,71,3,31,34
9,8479316,Luke Kunin,C,SJS,27,58,19,14,33
9,8474715,Cam Atkinson,R,TBL,35,81,18,15,33
9,8480078,Filip Chytil,C,NYR,25,67,16,17,33
9,8479661,Tanner Jeannot,L,LAK,27,75,15,18,33
9,8480748,Kiefer Sherwood,L,VAN,29,63,12,21,33
9,8480829,Jesperi Kotkaniemi,C,CAR,24,64,11,22,33
9,8477488,Brett Pesce,D,NJD,30,66,6,27,33
9,8478020,Michael Amadio,C,OTT,28,77,19,13,32
9,8478233,Andrew Mangiapane,L,WSH,28,62,18,14,32
9,8471698,T.J. Oshie,R,WSH,38,69,17,15,32
9,8482125,Alexander Holtz,R,VGK,22,71,17,15,32
9,8478438,Tommy Novak,C,NSH,27,68,12,20,32
9,8480068,Ryan Poehling,C,PHI,25,68,11,21,32
9,8475200,Dmitry Orlov,D,CAR,33,71,9,23,32
9,8480817,K'Andre Miller,D,NYR,24,73,8,24,32
9,8476927,Teddy Blueger,C,VAN,30,62,14,17,31
9,8478891,Mason Appleton,C,WPG,28,65,14,17,31
9,8478115,Pierre Engvall,L,NYI,28,78,13,18,31
9,8475220,Marcus Foligno,L,MIN,33,64,13,18,31
9,8477953,Kasperi Kapanen,R,STL,28,68,13,18,31
9,8478109,Victor Olofsson,L,VGK,29,70,12,19,31
9,8477947,Sonny Milano,L,WSH,28,70,9,22,31
9,8476885,Jacob Trouba,D,NYR,30,70,7,24,31
9,8478407,Vince Dunn,D,SEA,28,68,3,28,31
9,8482055,Drew O'Connor,L,PIT,26,59,18,12,30
9,8481535,Nils Hoglander,L,VAN,24,67,16,14,30
9,8479941,Justin Danforth,R,CBJ,31,51,16,14,30
9,8475714,Calle Jarnkrok,C,TOR,33,81,14,16,30
9,8475760,Nick Bjugstad,C,UTA,32,71,14,16,30
9,8478413,Jordan Greenway,L,BUF,27,63,13,17,30
9,8475193,Tomas Tatar,L,NJD,34,67,12,18,30
9,8482475,Yegor Chinakhov,R,CBJ,23,63,10,20,30
9,8476917,Adam Pelech,D,NYI,30,78,3,27,30
9,8476892,Colton Parayko,D,STL,31,69,2,28,30
9,8477952,Robby Fabbri,C,ANA,28,64,15,14,29
9,8476419,Jean-Gabriel Pageau,C,NYI,32,76,14,15,29
9,8480009,Eeli Tolvanen,R,SEA,25,68,13,16,29
9,8477369,Carson Soucy,D,VAN,30,64,12,17,29
9,8476480,Vladislav Namestnikov,C,WPG,32,73,11,18,29
9,8482192,Isaak Phillips,D,CHI,23,53,10,19,29
9,8478133,Jake Evans,C,MTL,28,71,6,23,29
9,8484203,Bradly Nadeau,L,CAR,19,68,6,23,29
9,8476438,Brandon Saad,L,STL,32,71,15,13,28
9,8477425,Miles Wood,L,COL,29,74,12,16,28
9,8481481,Blake Lizotte,C,PIT,27,61,12,16,28
9,8479315,Joey Anderson,R,CHI,26,51,12,16,28
9,8476278,Colin Blackwell,C,DAL,31,80,11,17,28
9,8479400,Pierre-Luc Dubois,L,WSH,26,69,8,20,28
9,8475149,Marcus Johansson,L,MIN,34,62,7,21,28
9,8479324,Ryan Lindgren,D,NYR,26,67,3,25,28
9,8477969,Marcus Pettersson,D,PIT,28,76,3,25,28
9,8477989,Christian Dvorak,C,MTL,28,65,12,15,27
9,8475231,Casey Cizikas,C,NYI,33,76,12,15,27
9,8483499,Liam Ohgren,L,MIN,20,59,6,21,27
9,8482660,Kent Johnson,C,CBJ,22,67,5,22,27
9,8477435,Ryan Graves,D,PIT,29,78,5,22,27
9,8475171,Oliver Ekman-Larsson,D,TOR,33,69,3,24,27
9,8479976,Juuso Valimaki,D,UTA,26,68,3,24,27
9,8474189,Lars Eller,C,PIT,35,65,17,9,26
9,8476925,Colton Sissons,C,NSH,31,66,14,12,26
9,8478463,Anthony Beauvillier,L,PIT,27,68,13,13,26
9,8473422,Nick Foligno,L,CHI,37,60,13,13,26
9,8477987,Ryan Donato,C,CHI,28,64,11,15,26
9,8483524,Shane Wright,C,SEA,20,61,10,16,26
9,8481553,Bobby Brink,R,PHI,23,62,7,19,26
9,8483493,Frank Nazar,C,CHI,20,47,5,21,26
9,8473507,Jeff Petry,D,DET,37,76,3,23,26
9,8479398,Samuel Girard,D,COL,26,61,2,24,26
9,8479368,Max Jones,L,BOS,26,65,15,10,25
9,8473453,Trevor Lewis,C,LAK,37,73,14,11,25
9,8476474,Stefan Noesen,R,NJD,31,67,12,13,25
9,8477353,Tyler Motte,C,DET,29,76,12,13,25
9,8475287,Erik Haula,L,NJD,33,65,11,14,25
9,8476981,Josh Anderson,R,MTL,30,71,11,14,25
9,8482074,Connor Zary,C,CGY,23,62,11,14,25
9,8481554,Kaapo Kakko,R,NYR,23,70,10,15,25
9,8477015,Connor Brown,R,EDM,30,63,10,15,25
9,8483445,Cutter Gauthier,L,ANA,20,63,9,16,25
9,8480835,Jack Drury,C,CAR,24,61,7,18,25
9,8482712,Oskar Olausson,R,COL,22,77,6,19,25
9,8480073,Erik Brannstrom,D,COL,25,70,3,22,25
9,8479402,Jake Bean,D,CGY,26,70,2,23,25
9,8482089,Jake Neighbours,L,STL,22,59,15,9,24
9,8477450,Jason Dickinson,C,CHI,29,56,14,10,24
9,8476469,Joel Armia,R,MTL,31,67,13,11,24
9,8476878,Zemgus Girgensons,L,TBL,30,80,12,12,24
9,8482803,Olen Zellweger,D,ANA,21,70,10,14,24
9,8481656,Aliaksei Protas,C,WSH,23,68,8,16,24
9,8476902,Esa Lindell,D,DAL,30,80,6,18,24
9,8482671,Owen Power,D,BUF,22,65,4,20,24
9,8482624,Daniil Miromanov,D,CGY,27,61,4,20,24
9,8482655,J.J. Moser,D,TBL,24,79,4,20,24
9,8475764,Cam Fowler,D,ANA,33,68,3,21,24
9,8476931,Jake McCabe,D,TOR,31,69,3,21,24
9,8478507,John Marino,D,UTA,27,63,2,22,24
9,8482679,Matt Coronato,R,CGY,22,71,13,10,23
9,8478508,Yakov Trenin,C,MIN,27,63,12,11,23
9,8477839,Conor Sheary,L,TBL,32,80,10,13,23
9,8475343,Nic Dowd,C,WSH,34,53,10,13,23
9,8483482,Tristan Luneau,D,ANA,20,59,9,14,23
9,8482079,Marco Rossi,C,MIN,23,56,9,14,23
9,8478136,Jake Middleton,D,MIN,28,72,6,17,23
9,8477919,Frederick Gaudreau,C,MIN,31,57,6,17,23
9,8476525,Colin Miller,D,WPG,32,59,5,18,23
9,8478851,Alexandre Carrier,D,NSH,28,61,4,19,23
9,8480873,Rasmus Sandin,D,WSH,24,65,3,20,23
9,8482142,Jamie Drysdale,D,PHI,22,66,3,20,23
9,8476967,Brett Kulak,D,EDM,30,62,3,20,23
9,8470621,Corey Perry,R,EDM,39,73,13,9,22
9,8481032,Paul Cotter,C,NJD,25,61,13,9,22
9,8480281,Alexey Toropchenko,R,STL,25,61,12,10,22
9,8476374,Sean Kuraly,C,CBJ,31,65,11,11,22
9,8482749,Joshua Roy,R,MTL,21,68,9,13,22
9,8477220,Nate Schmidt,D,FLA,33,69,7,15,22
9,8481606,Jordan Spence,D,LAK,23,66,7,15,22
9,8479414,Nathan Bastian,R,NJD,27,63,7,15,22
9,8475225,Craig Smith,C,CHI,35,54,7,15,22
9,8478840,Will Borgen,D,SEA,28,70,6,16,22
9,8481522,Peyton Krebs,C,BUF,23,58,5,17,22
9,8476854,Hampus Lindholm,D,BOS,30,73,3,19,22
9,8478500,Ivan Provorov,D,CBJ,27,78,3,19,22
9,8476988,Matt Benning,D,SJS,30,64,3,19,22
9,8480049,Dylan Samberg,D,WPG,25,70,2,20,22
9,8479983,Mario Ferraro,D,SJS,26,65,2,20,22
9,8475181,Nick Leddy,D,STL,33,72,2,20,22
9,8474151,Ryan McDonagh,D,TBL,35,75,0,22,22
9,8483457,Lane Hutson,D,MTL,20,71,12,9,21
9,8481580,Connor McMichael,C,WSH,23,59,11,10,21
9,8476921,Jordan Martinook,L,CAR,32,65,10,11,21
9,8480855,Jack McBain,C,UTA,24,60,10,11,21
9,8478434,Keegan Kolesar,R,VGK,27,67,10,11,21
9,8473533,Jordan Staal,C,CAR,36,56,10,11,21
9,8479591,Michael Eyssimont,C,TBL,28,80,8,13,21
9,8478970,Jalen Chatfield,D,CAR,28,73,8,13,21
9,8480144,David Kampf,C,TOR,29,75,7,14,21
9,8476889,Radek Faksa,C,STL,30,65,7,14,21
9,8475462,Radko Gudas,D,ANA,34,67,6,15,21
9,8482634,Alex Steeves,C,TOR,25,54,6,15,21
9,8479982,Conor Timmins,D,TOR,26,60,4,17,21
9,8479442,Troy Stecher,D,EDM,30,58,4,17,21
9,8480043,Timothy Liljegren,D,TOR,25,62,3,18,21
9,8474574,Tyler Myers,D,VAN,34,70,2,19,21
9,8478421,A.J. Greer,L,FLA,28,59,13,7,20
9,8479619,Michael Carcone,L,UTA,28,67,12,8,20
9,8478043,Sam Lafferty,C,BUF,29,63,12,8,20
9,8479393,Noah Gregor,C,OTT,26,70,10,10,20
9,8479351,Sam Steel,C,DAL,26,79,10,10,20
9,8476960,Andreas Athanasiou,C,CHI,30,55,10,10,20
9,8482737,Zack Bolduc,C,STL,21,58,9,11,20
9,8481093,Rafael Harvey-Pinard,L,MTL,25,65,9,11,20
9,8476918,Jimmy Vesey,L,NYR,31,65,8,12,20
9,8480355,Mark Kastelic,C,BOS,25,63,8,12,20
9,8482809,Jackson Blake,R,CAR,21,54,6,14,20
9,8477507,Nikita Zadorov,D,BOS,29,63,5,15,20
9,8482176,Wyatt Kaiser,D,CHI,22,53,5,15,20
9,8474673,TJ Brodie,D,CHI,34,59,3,17,20
9,8475718,Justin Holl,D,DET,32,58,2,18,20
9,8482157,Will Cuylle,L,NYR,22,67,10,9,19
9,8479066,Ryan Lomberg,L,CGY,30,65,10,9,19
9,8480003,Jesper Boqvist,C,FLA,26,65,9,10,19
9,8479370,Tyson Jost,C,CAR,26,50,9,10,19
9,8480995,Pontus Holmberg,R,TOR,25,72,8,11,19
9,8477903,Garnet Hathaway,R,PHI,33,58,8,11,19
9,8479996,Cody Glass,C,NSH,25,68,6,13,19
9,8478882,Vladislav Gavrikov,D,LAK,29,67,6,13,19
9,8478468,Jeremy Lauzon,D,NSH,27,55,6,13,19
9,8483763,Maksymilian Szuber,D,UTA,22,41,6,13,19
9,8482133,Thomas Bordeleau,C,SJS,22,67,5,14,19
9,8476331,Dylan DeMelo,D,WPG,31,73,4,15,19
9,8473563,Nicklas Backstrom,C,WSH,37,58,4,15,19
9,8481014,Alexander Romanov,D,NYI,24,76,4,15,19
9,8475279,Ben Chiarot,D,DET,33,69,3,16,19
9,8475324,Nick Jensen,D,OTT,34,71,3,16,19
9,8481568,Alex Vlasic,D,CHI,23,56,3,16,19
9,8482807,Ethan Del Mastro,D,CHI,21,47,12,6,18
9,8481517,Brett Leason,R,ANA,25,56,11,7,18
9,8480025,MacKenzie Entwistle,R,FLA,25,64,11,7,18
9,8481477,Nico Sturm,C,SJS,29,58,10,8,18
9,8480074,Alexandre Texier,C,STL,25,54,9,9,18
9,8479336,Carl Grundstrom,R,SJS,27,46,9,9,18
9,8483565,Nick Blankenburg,D,NSH,26,65,9,9,18
9,8476467,Jamie Oleksiak,D,SEA,32,66,9,9,18
9,8480205,Emil Bemstrom,C,PIT,25,56,8,10,18
9,8480806,Isac Lundestrom,C,ANA,25,69,8,10,18
9,8480289,Morgan Barron,C,WPG,26,52,8,10,18
9,8484149,Gavin Brindley,C,CBJ,20,52,7,11,18
9,8478472,Mathieu Joseph,R,STL,27,63,6,12,18
9,8478432,Christian Fischer,R,DET,27,74,6,12,18
9,8481028,Martin Pospisil,C,CGY,25,52,6,12,18
9,8482101,Danil Gushchin,L,SJS,22,58,5,13,18
9,8476312,Josh Manson,D,COL,33,58,5,13,18
9,8479344,Jesse Puljujarvi,R,PIT,26,53,5,13,18
9,8481059,Scott Perunovich,D,STL,26,56,4,14,18
9,8479371,Dante Fabbro,D,NSH,26,57,3,15,18
9,8475233,David Savard,D,MTL,34,65,1,17,18
9,8477506,Ryan Pulock,D,NYI,30,74,1,17,18
9,8477478,William Carrier,L,CAR,30,61,11,6,17
9,8480980,Connor Dewar,C,TOR,25,70,8,9,17
9,8481704,Juuso Parssinen,C,NSH,23,55,8,9,17
9,8476624,Barclay Goodrow,C,SJS,31,49,8,9,17
9,8480848,Ty Dellandrea,C,SJS,24,51,8,9,17
9,8476897,Oskar Sundqvist,C,STL,30,67,7,10,17
9,8476873,Mark Jankowski,C,NSH,30,47,7,10,17
9,8478585,Derek Ryan,C,EDM,38,60,7,10,17
9,8476422,Mike Reilly,D,NYI,31,75,6,11,17
9,8479390,Taylor Raddysh,R,WSH,26,62,6,11,17
9,8478911,Matt Roy,D,WSH,29,61,6,11,17
9,8479972,Mason Shaw,C,WPG,26,35,5,12,17
9,8476457,Adam Larsson,D,SEA,32,66,4,13,17
9,8478443,Brandon Carlo,D,BOS,28,59,4,13,17
9,8483495,Simon Nemec,D,NJD,20,60,4,13,17
9,8482122,Brock Faber,D,MIN,22,78,3,14,17
9,8480246,Nick Perbix,D,TBL,26,71,3,14,17
9,8479348,Kale Clague,D,BUF,26,52,2,15,17
9,8480950,Ilya Lyubushkin,D,DAL,30,76,1,16,17
9,8482155,Alex Laferriere,R,LAK,23,63,11,5,16
9,8476442,Matt Nieto,L,PIT,32,46,9,7,16
9,8477505,Alexander Wennberg,C,SJS,30,44,9,7,16
9,8479353,Brett Howden,C,VGK,26,64,8,8,16
9,8479293,Brandon Tanev,L,SEA,33,63,7,9,16
9,8475855,Jesper Fast,R,CAR,33,61,7,9,16
9,8479543,Michael Pezzetta,L,MTL,26,53,7,9,16
9,8476329,Travis Boyd,C,MIN,31,61,5,11,16
9,8481521,Ronnie Attard,D,PHI,25,63,5,11,16
9,8475455,Brenden Dillon,D,NJD,34,64,5,11,16
9,8480990,Declan Chisholm,D,MIN,24,52,5,11,16
9,8479944,Zach Aston-Reese,C,VGK,30,54,4,12,16
9,8477851,Jordan Oesterle,D,BOS,32,43,4,12,16
9,8482087,Kaiden Guhle,D,MTL,22,64,3,13,16
9,8482067,Connor Mackey,D,NYR,28,56,3,13,16
9,8483491,Ivan Miroshnichenko,L,WSH,20,57,3,13,16
9,8479998,Mikey Anderson,D,LAK,25,60,2,14,16
9,8480860,Kevin Bahl,D,CGY,24,58,2,14,16
9,8475188,Brayden McNabb,D,VGK,33,59,2,14,16
9,8476879,Cody Ceci,D,EDM,31,70,2,14,16
9,8474090,Brendan Smith,D,DAL,35,78,2,14,16
9,8478416,Erik Cernak,D,TBL,27,73,1,15,16
9,8480807,Mattias Samuelsson,D,BUF,24,54,1,15,16
9,8480789,Oliver Wahlstrom,R,NYI,24,66,9,6,15
9,8479638,Justin Brazeau,R,BOS,26,36,8,7,15
9,8480448,Parker Kelly,L,COL,25,77,6,9,15
9,8479520,Brandon Duhaime,R,WSH,27,54,6,9,15
9,8480762,Eric Robinson,L,CAR,29,54,6,9,15
9,8482073,Braden Schneider,D,NYR,23,57,5,10,15
9,8478451,Ethan Bear,D,WSH,27,56,5,10,15
9,8477018,Ben Hutton,D,VGK,31,47,5,10,15
9,8480245,Olle Lycksell,R,PHI,25,30,5,10,15
9,8482111,Justin Barron,D,MTL,23,65,4,11,15
9,8477365,Connor Clifton,D,BUF,29,53,4,11,15
9,8480035,Henri Jokiharju,D,BUF,25,66,3,12,15
9,8480891,Michael Kesselring,D,UTA,24,56,3,12,15
9,8480834,Ty Emberson,D,SJS,24,38,2,13,15
9,8476429,Scott Mayfield,D,NYI,32,74,1,14,15
9,8475690,Chris Tanev,D,TOR,35,59,1,14,15
9,8480021,Jack Studnicka,C,LAK,25,56,8,6,14
9,8482762,Simon Edvinsson,D,DET,21,47,7,7,14
9,8481601,Simon Holmstrom,R,NYI,23,70,6,8,14
9,8482148,Hendrix Lapierre,C,WSH,22,55,6,8,14
9,8480172,Jan Rutta,D,SJS,34,51,6,8,14
9,8479968,Vinni Lettieri,C,BOS,29,46,6,8,14
9,8482166,Shakir Mukhamadullin,D,SJS,22,60,6,8,14
9,8482744,James Malatesta,L,CBJ,21,48,5,9,14
9,8481147,Reese Johnson,C,MIN,26,34,5,9,14
9,8479718,Alex Barré-Boulet,C,MTL,27,47,4,10,14
9,8481527,Kaedan Korczak,D,VGK,23,50,4,10,14
9,8477392,Hudson Fasching,R,NYI,29,60,4,10,14
9,8475750,Jon Merrill,D,MIN,32,55,4,10,14
9,8479639,Dylan Coghlan,D,WPG,26,50,2,12,14
9,8480222,Sebastian Aho,D,PIT,28,65,2,12,14
9,8475762,Derek Forbort,D,VAN,32,50,2,12,14
9,8478452,Caleb Jones,D,LAK,27,54,1,13,14
9,8481056,Spencer Stastney,D,NSH,24,45,1,13,14
9,8483468,Jiri Kulich,C,BUF,20,62,8,5,13
9,8477446,Michael McCarron,R,NSH,29,55,8,5,13
9,8480011,Klim Kostin,C,SJS,25,51,5,8,13
9,8479671,Mathieu Olivier,R,CBJ,27,47,5,8,13
9,8477979,Nicolas Aube-Kubel,R,BUF,28,57,4,9,13
9,8481708,Zac Jones,D,NYR,24,47,4,9,13
9,8474034,Pat Maroon,L,CHI,36,52,4,9,13
9,8479359,Beck Malenstyn,L,BUF,26,45,4,9,13
9,8477499,Rasmus Ristolainen,D,PHI,30,68,4,9,13
9,8471817,Ryan Reaves,R,TOR,37,66,4,9,13
9,8477335,Kyle Burroughs,D,LAK,29,38,4,9,13
9,8480196,Jacob Bryson,D,BUF,27,49,4,9,13
9,8482496,Nils Aman,C,VAN,24,45,3,10,13
9,8478178,Darren Raddysh,D,TBL,28,68,2,11,13
9,8473446,Erik Johnson,D,PHI,36,48,2,11,13
9,8475790,Erik Gudbranson,D,CBJ,32,74,1,12,13
9,8476858,Phillip Di Giuseppe,L,VAN,31,42,7,5,12
9,8482859,Zack Ostapchuk,C,OTT,21,52,6,6,12
9,8481617,Vasily Podkolzin,R,VAN,23,47,6,6,12
9,8478569,Noel Acciari,C,PIT,33,58,6,6,12
9,8481013,Jonatan Berggren,R,DET,24,61,6,6,12
9,8477380,Jonny Brodzinski,C,NYR,31,46,6,6,12
9,8477508,Curtis Lazar,C,NJD,29,61,5,7,12
9,8480441,Trey Fix-Wolansky,R,CBJ,25,47,5,7,12
9,8482659,Josh Doan,R,UTA,22,53,5,7,12
9,8479772,Zack MacEwen,R,OTT,28,50,5,7,12
9,8479291,Kevin Rooney,C,CGY,31,51,5,7,12
9,8477931,Tomas Nosek,L,FLA,32,59,4,8,12
9,8470600,Ryan Suter,D,STL,39,57,3,9,12
9,8480796,Martin Fehervary,D,WSH,25,60,3,9,12
9,8482964,Arber Xhekaj,D,MTL,23,41,3,9,12
9,8476994,Vinnie Hinostroza,C,NSH,30,41,3,9,12
9,8479986,Kole Lind,R,DAL,26,43,3,9,12
9,8476441,Joel Edmundson,D,LAK,31,39,3,9,12
9,8480878,Nils Lundkvist,D,DAL,24,81,2,10,12
9,8476891,Matt Grzelcyk,D,PIT,30,75,2,10,12
9,8481600,Tobias Bjornfot,D,FLA,23,43,2,10,12
9,8480070,Ian Mitchell,D,BOS,25,44,2,10,12
9,8480001,Urho Vaakanainen,D,ANA,25,57,1,11,12
9,8477573,Nathan Walker,L,STL,30,51,7,4,11
9,8477406,Mattias Janmark,C,EDM,32,65,5,6,11
9,8482730,Brandt Clarke,D,LAK,21,48,5,6,11
9,8481550,Adam Beckman,L,NJD,23,34,4,7,11
9,8481641,Joel Kiviranta,L,COL,28,73,4,7,11
9,8481592,Jakob Pelletier,L,CGY,23,40,3,8,11
9,8481167,Brayden Pachal,D,CGY,25,44,3,8,11
9,8480157,Calle Rosen,D,COL,30,49,3,8,11
9,8478424,Jansen Harkins,C,ANA,27,45,3,8,11
9,8482747,Brennan Othmann,L,NYR,21,39,3,8,11
9,8480845,Rasmus Kupari,C,WPG,24,42,2,9,11
9,8479980,Nicolas Hague,D,VGK,26,55,2,9,11
9,8477845,Trevor van Riemsdyk,D,WSH,33,60,1,10,11
9,8481537,Nikita Okhotiuk,D,CGY,24,52,1,10,11
9,8481178,Egor Zamula,D,PHI,24,53,1,10,11
9,8478454,Noah Juulsen,D,VAN,27,36,1,10,11
9,8478450,Parker Wotherspoon,D,BOS,27,31,1,10,11
9,8475179,Dmitry Kulikov,D,FLA,34,52,0,11,11
9,8476822,Luke Glendening,C,TBL,35,78,8,2,10
9,8480252,Cole Guttman,C,CHI,25,48,6,4,10
9,8482652,Walker Duehr,R,CGY,27,38,6,4,10
9,8481716,Dmitri Voronkov,L,CBJ,24,38,5,5,10
9,8479379,Givani Smith,R,SJS,26,33,5,5,10
9,8482062,Cole Smith,L,NSH,29,54,4,6,10
9,8476867,Brendan Gaunce,C,MIN,30,32,4,6,10
9,8479369,Andrew Peeke,D,BOS,26,65,3,7,10
9,8479994,Jaret Anderson-Dolan,C,WPG,25,33,3,7,10
9,8481609,Vladislav Kolyachonok,D,UTA,23,39,3,7,10
9,8474567,Zach Bogosian,D,MIN,34,50,2,8,10
9,8480058,Pierre-Olivier Joseph,D,STL,25,54,2,8,10
9,8481524,Bowen Byram,D,BUF,23,50,2,8,10
9,8482095,Tyler Kleven,D,OTT,22,49,2,8,10
9,8480192,Johnathan Kovacevic,D,NJD,27,41,1,9,10
9,8471709,Marc-Edouard Vlasic,D,SJS,37,61,1,9,10
9,8478399,Jonas Siegenthaler,D,NJD,27,66,1,9,10
9,8475177,Calvin de Haan,D,COL,33,49,1,9,10
9,8481567,Henry Thrun,D,SJS,23,52,0,10,10
9,8479249,Andrew Poturalski,C,SJS,30,31,0,10,10
9,8484911,Collin Graf,R,SJS,22,45,5,4,9
9,8482077,Dylan Holloway,L,EDM,23,47,5,4,9
9,8482784,Zach Dean,C,STL,21,50,5,4,9
9,8482666,Scott Morrow,D,CAR,22,50,5,4,9
9,8479328,Julien Gauthier,R,NYI,27,57,4,5,9
9,8476952,Dominic Toninato,C,WPG,30,34,4,5,9
9,8479981,Jonah Gadjovich,L,FLA,26,52,4,5,9
9,8478211,Dryden Hunt,L,CGY,29,50,3,6,9
9,8478859,Niko Mikkola,D,FLA,28,57,3,6,9
9,8481441,Joe Snively,C,DET,28,53,2,7,9
9,8481599,Victor Soderstrom,D,UTA,23,35,2,7,9
9,8476372,Nick Seeler,D,PHI,31,35,2,7,9
9,8477034,Jaycob Megna,D,FLA,32,49,2,7,9
9,8481701,Santeri Hatakka,D,NJD,23,33,2,7,9
9,8477473,Justin Bailey,R,SJS,29,26,2,7,9
9,8479421,Jacob Moverare,D,LAK,26,22,2,7,9
9,8479026,Philippe Myers,D,TOR,27,46,1,8,9
9,8475208,Brian Dumoulin,D,ANA,33,63,1,8,9
9,8481019,David Gustafsson,C,WPG,24,35,1,8,9
9,8481598,Philip Broberg,D,EDM,23,42,1,8,9
9,8474166,Alec Martinez,D,CHI,37,42,1,8,9
9,8476473,Connor Murphy,D,CHI,31,36,1,8,9
9,8471677,Jack Johnson,D,CBJ,37,67,1,8,9
9,8477070,Liam O'Brien,C,UTA,30,42,0,9,9
9,8484254,Akito Hirose,D,VAN,25,31,0,9,9
9,8479439,Jacob MacDonald,D,COL,31,49,5,3,8
9,8480292,Carson Meyer,R,ANA,27,35,5,3,8
9,8478831,Kevin Stenlund,C,UTA,28,53,4,4,8
9,8475842,Sam Carrick,C,NYR,32,55,4,4,8
9,8481518,Nolan Foote,L,NJD,24,45,4,4,8
9,8483570,Ben Meyers,C,SEA,26,29,4,4,8
9,8482451,Mikael Pyyhtia,L,CBJ,23,40,3,5,8
9,8479372,Josh Mahura,D,SEA,26,56,2,6,8
9,8480887,Jordan Harris,D,MTL,24,55,2,6,8
9,8480727,Zach Whitecloud,D,VGK,28,51,1,7,8
9,8483460,David Jiricek,D,CBJ,21,60,1,7,8
9,8474568,Luke Schenn,D,NSH,35,47,1,7,8
9,8474013,Ian Cole,D,UTA,35,55,1,7,8
9,8477938,Haydn Fleury,D,WPG,28,44,1,7,8
9,8478146,Matthew Highmore,C,OTT,28,37,1,7,8
9,8477962,Brendan Lemieux,L,CAR,28,41,0,8,8
9,8481743,Marc Del Gaizo,D,NSH,25,19,5,2,7
9,8478502,Dennis Gilbert,D,BUF,28,19,5,2,7
9,8481161,Jake Christiansen,D,CBJ,25,55,4,3,7
9,8478409,Anthony Richard,C,PHI,28,28,4,3,7
9,8481585,Egor Afanasyev,L,SJS,23,21,4,3,7
9,8474612,Travis Hamonic,D,OTT,34,45,3,4,7
9,8479378,Logan Stanley,D,WPG,26,49,2,5,7
9,8480870,Bo Groulx,C,NYR,24,24,2,5,7
9,8481605,Jackson LaCombe,D,ANA,23,37,1,6,7
9,8480879,Jacob Bernard-Docker,D,OTT,24,49,1,6,7
9,8477810,Joel Hanley,D,CGY,33,27,1,6,7
9,8476874,Olli Maatta,D,DET,30,64,0,7,7
9,8482858,Ryker Evans,D,SEA,23,31,0,7,7
9,8477887,Patrick Brown,C,BOS,32,47,5,1,6
9,8482162,Roby Jarventie,L,EDM,22,21,5,1,6
9,8480844,Grigori Denisenko,L,VGK,24,33,4,2,6
9,8482765,Isak Rosen,R,BUF,21,34,4,2,6
9,8481754,Nikita Nesterenko,C,ANA,23,33,3,3,6
9,8479991,Jake Leschyshyn,C,NYR,25,27,3,3,6
9,8479576,Vincent Desharnais,D,VAN,28,39,3,3,6
9,8475235,Nicolas Deslauriers,L,PHI,33,48,2,4,6
9,8482733,Logan Mailloux,D,MTL,31,32,2,4,6
9,8482145,Mavrik Bourque,C,DAL,22,53,2,4,6
9,8484287,Cole McWard,D,VAN,23,24,2,4,6
9,8475958,Michael Sgarbossa,C,WSH,32,29,1,5,6
9,8477384,Josh Brown,D,EDM,30,42,1,5,6
9,8476913,Devin Shore,C,MIN,30,31,1,5,6
9,8483471,Brad Lambert,C,WPG,31,15,1,5,6
9,8483512,Matt Savoie,C,EDM,20,21,1,5,6
9,8480007,Jonas Rondbjerg,R,VGK,25,36,0,6,6
9,8479985,Cale Fleury,D,SEA,26,24,4,1,5
9,8482713,Mackie Samoskevich,R,FLA,22,39,3,2,5
9,8478017,Mark Friedman,D,VAN,29,29,3,2,5
9,8477467,Gustav Olofsson,D,SEA,30,19,3,2,5
9,8476934,Brock McGinn,L,ANA,30,40,2,3,5
9,8478874,Adam Gaudette,C,OTT,28,36,2,3,5
9,8483466,Kevin Korchinski,D,CHI,20,52,2,3,5
9,8482511,Mason Lohrei,D,BOS,23,38,2,3,5
9,8481532,Alex Turcotte,C,LAK,23,43,2,3,5
9,8483630,Pavol Regenda,L,ANA,25,29,2,3,5
9,8481751,Lukas Rousek,R,BUF,25,40,1,4,5
9,8481122,Simon Benoit,D,TOR,26,42,1,4,5
9,8481237,Kyle MacLean,C,NYI,25,26,1,4,5
9,8480880,Jakub Lauko,C,MIN,24,34,1,4,5
9,8483619,Filip Roos,D,OTT,25,26,1,4,5
9,8483397,Marc McLaughlin,C,BOS,25,29,0,5,5
9,8482070,Mitchell Chaffee,R,TBL,26,57,0,5,5
9,8477401,John Hayden,C,SEA,29,28,3,1,4
9,8481789,Tye Kartye,L,SEA,23,39,2,2,4
9,8482201,Gage Goncalves,C,TBL,23,21,2,2,4
9,8481543,Nikita Alexandrov,C,STL,24,19,2,2,4
9,8482141,Lukas Cormier,D,VGK,22,31,1,3,4
9,8482153,Brendan Brisson,C,VGK,23,32,1,3,4
9,8478021,William Lagesson,D,DET,28,24,1,3,4
9,8481719,Maxwell Crozier,D,TBL,24,23,1,3,4
9,8480468,James Hamblin,L,EDM,25,14,1,3,4
9,8478011,Louie Belpedio,D,PHI,28,13,1,3,4
9,8483012,Logan Morrison,C,SEA,22,40,0,4,4
9,8482861,Vincent Iorio,D,WSH,22,22,0,4,4
9,8481679,Maxence Guenette,D,OTT,23,27,3,0,3
9,8481065,Angus Crookshank,L,OTT,25,14,3,0,3
9,8482165,Yan Kuznetsov,D,CGY,22,20,2,1,3
9,8482172,Landon Slaggert,L,CHI,22,30,2,1,3
9,8480084,Nick DeSimone,D,NJD,30,16,2,1,3
9,8477993,Justin Kirkland,C,CGY,28,10,2,1,3
9,8481556,John Beecher,C,BOS,23,30,1,2,3
9,8479536,Axel Jonsson-Fjallby,L,WPG,26,29,1,2,3
9,8477971,Andreas Englund,D,LAK,28,21,1,2,3
9,8481593,Jayden Struble,D,MTL,23,27,1,2,3
9,8479587,Rhett Gardner,C,PHI,28,13,1,2,3
9,8482751,Ryan Winterton,C,SEA,21,33,1,2,3
9,8482061,Brandon Biro,L,SEA,26,15,1,2,3
9,8477320,Anton Blidh,L,NYR,29,22,1,2,3
9,8482470,Ilya Solovyov,D,CGY,24,17,0,3,3
9,8478881,Brett Seney,L,CHI,28,11,0,3,3
9,8483549,Lucas Condotta,L,MTL,27,19,0,3,3
9,8477527,Ross Johnston,L,ANA,30,30,0,3,3
9,8481699,Aku Raty,R,UTA,23,19,2,0,2
9,8482787,Nikita Chibrikov,R,WPG,31,5,2,0,2
9,8482476,Emil Heineman,L,MTL,23,3,2,0,2
9,8480075,Cameron Crotty,D,MIN,25,16,2,0,2
9,8482144,Jack Thompson,D,SJS,22,34,1,1,2
9,8475755,Alexander Petrovic,D,DAL,32,14,1,1,2
9,8479419,Brett Murray,L,BUF,26,9,1,1,2
9,8477244,Chad Ruhwedel,D,NYR,34,42,1,1,2
9,8481541,Samuel Bolduc,D,NYI,24,30,1,1,2
9,8481006,Tyler Tucker,D,STL,24,20,1,1,2
9,8480267,Sammy Walker,C,MIN,25,17,1,1,2
9,8480823,Alexander Alexeyev,D,WSH,25,13,1,1,2
9,8482147,Jean-Luc Foudy,C,COL,22,29,1,1,2
9,8481030,Jack St. Ivany,D,PIT,25,20,1,1,2
9,8478477,Mitchell Stephens,C,SEA,27,15,1,1,2
9,8480851,Akil Thomas,C,LAK,24,20,0,2,2
9,8482929,Emil Lilleberg,D,TBL,23,24,0,2,2
9,8479320,Max Lajoie,D,SEA,27,16,0,2,2
9,8475413,Justin Dowling,C,NJD,34,15,0,2,2
9,8484258,Sam Malinski,D,COL,26,14,0,2,2
9,8482118,Sam Colangelo,R,ANA,23,24,0,2,2
9,8482516,Matthew Kessel,D,STL,24,19,0,2,2
9,8480032,Shane Bowers,C,NJD,25,13,1,0,1
9,8480890,Jan Jenik,R,OTT,24,24,1,0,1
9,8477149,Scott Sabourin,R,SJS,32,11,1,0,1
9,8478446,Glenn Gawdin,C,LAK,27,17,1,0,1
9,8481462,Mason Morelli,L,VGK,28,8,1,0,1
9,8481726,Adam Edstrom,C,NYR,24,7,1,0,1
9,8484325,Waltteri Merela,C,TBL,26,16,1,0,1
9,8479362,Riley Tufte,L,BOS,26,16,1,0,1
9,8483597,Milos Kelemen,L,UTA,25,9,1,0,1
9,8483395,Arshdeep Bains,L,VAN,23,7,1,0,1
9,8483567,Georgii Merkulov,C,BOS,24,11,1,0,1
9,8483432,Luca Del Bel Belluz,C,CBJ,31,2,1,0,1
9,8481655,Cole Schwindt,R,CGY,23,7,1,0,1
9,8483407,Brandon Scanlin,D,NYR,25,7,1,0,1
9,8482177,Marat Khusnutdinov,C,MIN,22,34,0,1,1
9,8483489,Fraser Minten,C,TOR,31,16,0,1,1
9,8477462,Robert Hagg,D,VGK,29,17,0,1,1
9,8482250,Callahan Burke,C,VGK,27,20,0,1,1
9,8477073,Kurtis MacDermid,L,NJD,30,21,0,1,1
9,8481206,John Ludvig,D,PIT,24,12,0,1,1
9,8484304,Uvis Balinskis,D,FLA,28,10,0,1,1
9,8474062,Riley Nash,C,NYR,35,21,0,1,1
9,8478051,Max Willman,C,NJD,29,21,0,1,1
9,8481564,Ryan Johnson,D,BUF,23,13,0,1,1
9,8482094,Daemon Hunt,D,MIN,22,13,0,1,1
9,8481578,Graeme Clarke,R,MIN,23,15,0,1,1
9,8475780,Chris Wagner,R,COL,33,10,0,1,1
9,8482088,Justin Sourdif,R,FLA,22,11,0,1,1
9,8481043,Cole Koepke,L,BOS,26,13,0,1,1
9,8481024,Linus Karlsson,C,VAN,25,12,0,1,1
9,8483920,Pierrick Dube,R,WSH,23,6,0,1,1
9,8482460,Matt Rempe,C,NYR,22,12,0,1,1
9,8479522,Hardy Haman Aktell,D,WSH,26,2,0,1,1
9,8483401,Marc Johnstone,R,PIT,28,2,0,1,1
9,8475795,Dylan McIlrath,D,WSH,32,16,0,0,0
9,8481422,Jacob Lucchini,C,NSH,29,24,0,0,0
9,8479367,William Lockwood,R,FLA,26,22,0,0,0
9,8480306,Grant Hutton,D,NYI,29,8,0,0,0
9,8482102,Vasily Ponomarev,C,PIT,22,18,0,0,0
9,8479330,Brandon Gignac,C,MTL,27,12,0,0,0
9,8477541,Dakota Mermis,D,TOR,30,8,0,0,0
9,8483531,Brian Halonen,L,NJD,25,3,0,0,0
9,8483546,Marshall Rifai,D,TOR,26,2,0,0,0
9,8483398,Declan Carlile,D,TBL,31,1,0,0,0
9,8480874,Adam Ginning,D,PHI,24,10,0,0,0
9,8484255,Jason Polin,R,COL,25,3,0,0,0
9,8484326,Patrik Koch,D,UTA,28,3,0,0,0
9,8482126,Emil Andrae,D,PHI,31,4,0,0,0
9,8482197,Adam Raska,R,MIN,23,8,0,0,0
9,8483609,Adam Klapka,R,CGY,24,1,0,0,0
9,8481806,Louis Crevier,D,CHI,23,19,0,0,0
9,8478147,Bokondji Imama,L,PIT,28,10,0,0,0
9,8481534,Raphael Lavoie,C,EDM,24,3,0,0,0
9,8484259,Ondrej Pavel,C,COL,31,0,0,0,0
9,8478854,Ryan Shea,D,PIT,27,5,0,0,0
9,8476323,Max McCormick,L,SEA,32,2,0,0,0
9,8479321,Lucas Johansen,D,,27,0,0,0,0
9,8470794,Joe Pavelski,C,,40,0,0,0,0
9,8477950,Tony DeAngelo,D,,29,0,0,0,0
9,8471218,Blake Wheeler,R,,38,0,0,0,0
9,8475197,Tyson Barrie,D,,33,0,0,0,0
9,8475744,Evgeny Kuznetsov,C,,32,0,0,0,0
9,8474037,James van Riemsdyk,L,,35,0,0,0,0
9,8474602,Justin Schultz,D,,34,0,0,0,0
9,8482222,Alexander Barabanov,L,,30,0,0,0,0
9,8474157,Max Pacioretty,L,,36,0,0,0,0
9,8474031,Kevin Shattenkirk,D,,35,0,0,0,0
9,8480884,Calen Addison,D,,24,0,0,0,0
9,8480008,Adam Ruzicka,C,,25,0,0,0,0
9,8475906,John Klingberg,D,,32,0,0,0,0
9,8476884,Derrick Pouliot,D,,30,0,0,0,0
9,8476919,Chris Tierney,C,,30,0,0,0,0
9,8479415,Michael McLeod,C,,26,0,0,0,0
9,8474884,Mike Hoffman,C,,35,0,0,0,0
9,8478104,Sammy Blais,L,,28,0,0,0,0
9,8474870,Tyler Johnson,C,,34,0,0,0,0
9,8481591,Sam Poulin,R,,23,0,0,0,0
9,8479977,Kailer Yamamoto,R,,26,0,0,0,0
9,8476393,Nick Cousins,C,,31,0,0,0,0
9,8479376,Victor Mete,D,,26,0,0,0,0
9,8476871,Tanner Pearson,L,,32,0,0,0,0
9,8471274,Alex Goligoski,D,,39,0,0,0,0
9,8481058,Jesse Ylönen,R,,25,0,0,0,0
9,8477464,Nic Petan,C,,29,0,0,0,0
9,8473449,Kyle Okposo,R,,36,0,0,0,0
9,8480216,Jacob Peterson,C,,25,0,0,0,0
9,8479346,Dillon Dube,C,,26,0,0,0,0
9,8470966,Mark Giordano,D,,41,0,0,0,0
9,8480821,Filip Zadina,R,,25,0,0,0,0
9,8476907,Mackenzie MacEachern,L,,30,0,0,0,0
9,8478430,Oliver Kylington,D,,27,0,0,0,0
9,8479514,Rem Pitlick,C,,27,0,0,0,0
9,8478099,Kevin Labanc,R,,29,0,0,0,0
9,8482241,Radim Zohorna,L,,28,0,0,0,0
9,8474040,Sam Gagner,C,,35,0,0,0,0
9,8475164,Jakob Silfverberg,R,,34,0,0,0,0
9,8475752,Tyler Pitlick,C,,33,0,0,0,0
9,8479984,Cal Foote,D,,26,0,0,0,0
9,8478495,Denis Gurianov,R,,27,0,0,0,0
9,8479533,Joona Koppanen,L,,26,0,0,0,0
9,8479458,Nikita Zaitsev,D,,33,0,0,0,0
9,8471699,Andrew Cogliano,C,,37,0,0,0,0
9,8470604,Jeff Carter,C,,39,0,0,0,0
9,8477330,Dominik Kubalik,L,,29,0,0,0,0
9,8477944,Jakub Vrana,L,,28,0,0,0,0
9,8478904,Steven Lorentz,C,,28,0,0,0,0
9,8471686,Marc Staal,D,,37,0,0,0,0
9,8478512,Austin Czarnik,C,,32,0,0,0,0
9,8470610,Zach Parise,L,,40,0,0,0,0
9,8473504,Cal Clutterbuck,R,,37,0,0,0,0
9,8474009,Nick Bonino,C,,36,0,0,0,0
9,8477454,Adam Erne,L,,29,0,0,0,0
9,8477126,Jayson Megna,C,,34,0,0,0,0
9,8473473,Milan Lucic,L,,36,0,0,0,0
9,8478067,Oskar Lindblom,L,,28,0,0,0,0
9,8475825,Jani Hakanpää,D,,32,0,0,0,0
9,8479383,Boris Katchouk,L,,26,0,0,0,0
9,8478400,Colin White,C,,27,0,0,0,0
9,8477846,Ryan Carpenter,C,,33,0,0,0,0
9,8477930,Pierre-Edouard Bellemare,L,,39,0,0,0,0
9,8479423,Alex Nylander,L,,26,0,0,0,0
9,8475797,Jarred Tinordi,D,,32,0,0,0,0
9,8481239,Samuel Fagemo,L,,24,0,0,0,0
9,8474618,Marco Scandella,D,,34,0,0,0,0
9,8480853,Liam Foudy,C,,24,0,0,0,0
9,8478028,Fredrik Olofsson,L,,28,0,0,0,0
9,8474145,Robert Bortuzzo,D,,35,0,0,0,0
9,8474709,Matt Martin,L,,35,0,0,0,0
9,8480226,Marián Studenic,R,,26,0,0,0,0
9,8480274,Philip Kemp,D,EDM,25,0,0,0,0
9,8480184,Gustav Lindstrom,D,,26,0,0,0,0
9,8481077,John Leonard,L,,26,0,0,0,0
9,8479547,Matthew Phillips,R,,26,0,0,0,0
9,8476915,Jujhar Khaira,L,,30,0,0,0,0
9,8481070,Hugh McGing,L,,26,0,0,0,0
9,8478408,Travis Dermott,D,,28,0,0,0,0
9,8481812,Nikolai Knyzhov,D,,27,0,0,0,0
9,8484321,Nikolas Matinpalo,D,OTT,26,3,0,0,0
9,8475278,Byron Froese,C,,33,0,0,0,0
9,8475766,Austin Watson,L,,32,0,0,0,0
9,8479546,Oskar Steen,C,,26,0,0,0,0
9,8480836,Jonathan Gruden,C,,24,0,0,0,0
9,8481690,Tyler Angle,C,,24,0,0,0,0
9,8480031,Maxime Comtois,L,,25,0,0,0,0
9,8483045,Cameron Butler,R,CBJ,31,0,0,0,0
9,8478078,Rourke Chartier,C,,28,0,0,0,0
9,8481016,Ruslan Iskhakov,C,,24,0,0,0,0
9,8484314,Jiri Smejkal,L,,28,0,0,0,0
9,8478956,Samuel Laberge,L,NJD,27,1,0,0,0
9,8480776,Sheldon Rempal,R,,29,0,0,0,0
10,8477492,Nathan MacKinnon,C,COL,29,82,58,95,153
10,8476453,Nikita Kucherov,R,TBL,31,82,40,99,139
10,8478402,Connor McDavid,C,EDM,27,78,39,98,137
10,8477956,David Pastrnak,R,BOS,28,81,56,73,129
10,8481559,Jack Hughes,C,NJD,23,74,46,71,117
10,8477934,Leon Draisaitl,C,EDM,29,75,40,73,113
10,8479318,Auston Matthews,C,TOR,27,81,61,50,111
10,8479314,Matthew Tkachuk,L,FLA,27,79,31,72,103
10,8480027,Jason Robertson,L,DAL,25,82,38,64,102
10,8478550,Artemi Panarin,L,NYR,33,77,37,65,102
10,8478420,Mikko Rantanen,R,COL,28,82,47,53,100
10,8479407,Jesper Bratt,L,NJD,26,77,32,68,100
10,8482116,Tim Stützle,C,OTT,22,81,29,68,97
10,8478445,Mathew Barzal,C,NYI,27,80,21,76,97
10,8477939,William Nylander,R,TOR,28,80,40,56,96
10,8475166,John Tavares,C,TOR,34,82,40,55,95
10,8477933,Sam Reinhart,C,FLA,29,80,45,48,93
10,8478403,Jack Eichel,C,VGK,28,74,41,51,92
10,8475786,Zach Hyman,L,EDM,32,79,53,38,91
10,8477946,Dylan Larkin,C,DET,28,81,46,45,91
10,8476468,J.T. Miller,C,VAN,31,75,27,63,90
10,8477942,Kevin Fiala,L,LAK,28,82,35,54,89
10,8477493,Aleksander Barkov,C,FLA,29,75,24,64,88
10,8480069,Cale Makar,D,COL,26,70,25,61,86
10,8479420,Tage Thompson,C,BUF,27,73,38,47,85
10,8479542,Brandon Hagel,L,TBL,26,82,38,46,84
10,8480002,Nico Hischier,C,NJD,25,77,36,48,84
10,8480801,Brady Tkachuk,L,OTT,25,77,34,49,83
10,8480023,Robert Thomas,C,STL,25,68,23,60,83
10,8480800,Quinn Hughes,D,VAN,25,76,14,69,83
10,8478439,Travis Konecny,R,PHI,27,76,36,45,81
10,8482078,Lucas Raymond,L,DET,22,79,33,48,81
10,8484144,Connor Bedard,C,CHI,19,69,31,49,80
10,8476460,Mark Scheifele,C,WPG,31,76,34,45,79
10,8478427,Sebastian Aho,C,CAR,27,74,31,47,78
10,8477409,Carter Verhaeghe,C,FLA,29,79,41,36,77
10,8477501,Valeri Nichushkin,R,COL,29,79,37,40,77
10,8477404,Jake Guentzel,C,TBL,30,82,36,41,77
10,8480012,Elias Pettersson,C,VAN,26,79,34,43,77
10,8475913,Mark Stone,R,VGK,32,75,25,52,77
10,8478864,Kirill Kaprizov,L,MIN,27,72,33,43,76
10,8477402,Pavel Buchnevich,L,STL,29,74,28,48,76
10,8475168,Matt Duchene,C,DAL,33,82,26,50,76
10,8477500,Bo Horvat,C,NYI,29,81,43,32,75
10,8474600,Roman Josi,D,NSH,34,70,19,56,75
10,8476539,Jonathan Marchessault,R,NSH,34,71,45,29,74
10,8471215,Evgeni Malkin,C,PIT,38,73,30,44,74
10,8473512,Claude Giroux,R,OTT,36,79,27,47,74
10,8480208,Drake Batherson,R,OTT,26,78,19,55,74
10,8480865,Noah Dobson,D,NYI,24,78,13,61,74
10,8473994,Jamie Benn,L,DAL,35,82,32,41,73
10,8474564,Steven Stamkos,C,NSH,34,76,30,43,73
10,8473419,Brad Marchand,L,BOS,36,81,28,45,73
10,8476389,Vincent Trocheck,C,NYR,31,77,27,46,73
10,8480036,Miro Heiskanen,D,DAL,25,82,14,59,73
10,8478449,Roope Hintz,C,DAL,28,81,41,31,72
10,8481540,Cole Caufield,R,MTL,23,76,32,40,72
10,8475167,Victor Hedman,D,TBL,34,82,15,57,72
10,8478414,Timo Meier,R,NJD,28,75,28,43,71
10,8480018,Nick Suzuki,C,MTL,25,77,24,47,71
10,8479385,Jordan Kyrou,C,STL,26,74,30,40,70
10,8476456,Jonathan Huberdeau,C,CGY,31,76,21,49,70
10,8476887,Filip Forsberg,L,NSH,30,70,34,35,69
10,8478444,Brock Boeser,R,VAN,27,73,34,35,69
10,8478398,Kyle Connor,L,WPG,28,72,32,37,69
10,8475784,Jeff Skinner,C,EDM,32,78,28,41,69
10,8482665,Matty Beniers,C,SEA,22,80,26,43,69
10,8477951,Nick Schmaltz,C,UTA,28,74,20,49,69
10,8479323,Adam Fox,D,NYR,26,74,11,58,69
10,8475172,Nazem Kadri,C,CGY,34,78,29,39,68
10,8474578,Erik Karlsson,D,PIT,34,80,23,45,68
10,8478010,Brayden Point,C,TBL,28,82,40,27,67
10,8479343,Clayton Keller,R,UTA,26,79,27,40,67
10,8476448,William Karlsson,C,VGK,31,75,26,41,67
10,8478460,Zach Werenski,D,CBJ,27,79,17,50,67
10,8477496,Elias Lindholm,C,BOS,30,79,26,40,66
10,8475170,Brayden Schenn,C,STL,33,70,27,38,65
10,8475692,Mats Zuccarello,R,MIN,37,73,23,42,65
10,8478042,Viktor Arvidsson,R,EDM,31,74,22,43,65
10,8476346,Johnny Gaudreau,L,CBJ,31,71,20,45,65
10,8471685,Anze Kopitar,C,LAK,37,81,16,49,65
10,8475745,Charlie Coyle,C,BOS,32,76,24,40,64
10,8476881,Tomas Hertl,C,VGK,31,77,31,32,63
10,8475714,Calle Jarnkrok,C,TOR,33,77,31,32,63
10,8476459,Mika Zibanejad,C,NYR,31,78,23,40,63
10,8471214,Alex Ovechkin,L,WSH,39,78,33,29,62
10,8471675,Sidney Crosby,C,PIT,37,66,22,40,62
10,8477447,Shea Theodore,D,VGK,29,60,11,51,62
10,8477940,Nikolaj Ehlers,L,WPG,28,65,28,33,61
10,8475754,Brock Nelson,C,NYI,33,82,28,33,61
10,8482699,Dylan Guenther,R,UTA,21,75,28,32,60
10,8477949,Alex Tuch,R,BUF,28,72,25,35,60
10,8476454,Ryan Nugent-Hopkins,C,EDM,31,76,22,38,60
10,8482740,Wyatt Johnston,C,DAL,21,81,31,28,59
10,8477960,Adrian Kempe,R,LAK,28,81,28,31,59
10,8482093,Seth Jarvis,C,CAR,22,75,25,34,59
10,8479337,Alex DeBrincat,R,DET,27,80,23,36,59
10,8474141,Patrick Kane,R,DET,36,81,19,40,59
10,8480839,Rasmus Dahlin,D,BUF,24,72,12,47,59
10,8477451,Ryan Hartman,R,MIN,30,76,28,30,58
10,8475191,Reilly Smith,R,NYR,33,72,26,31,57
10,8478493,Joel Eriksson Ek,C,MIN,27,71,24,33,57
10,8481711,Matias Maccelli,L,UTA,24,75,23,34,57
10,8477504,Josh Morrissey,D,WPG,29,72,6,51,57
10,8475184,Chris Kreider,L,NYR,33,75,36,20,56
10,8478366,Frank Vatrano,R,ANA,30,77,27,29,56
10,8477955,Jared McCann,L,SEA,28,70,21,35,56
10,8475158,Ryan O'Reilly,C,NSH,33,74,20,36,56
10,8480028,Morgan Frost,C,PHI,25,76,20,36,56
10,8475765,Vladimir Tarasenko,R,DET,33,79,19,37,56
10,8478038,Devon Toews,D,COL,30,77,12,44,56
10,8475810,Bryan Rust,R,PIT,32,67,33,22,55
10,8480064,Josh Norris,C,OTT,25,75,29,26,55
10,8482684,Luke Hughes,D,NJD,21,71,9,46,55
10,8477935,Sam Bennett,C,FLA,28,77,27,27,54
10,8479675,Trevor Moore,L,LAK,29,81,26,28,54
10,8483431,Logan Cooley,C,UTA,20,74,26,28,54
10,8478856,Conor Garland,R,VAN,28,79,25,29,54
10,8474102,David Perron,L,OTT,36,76,21,33,54
10,8482745,Mason McTavish,C,ANA,21,71,18,36,54
10,8482113,Anton Lundell,C,FLA,23,80,28,25,53
10,8481557,Matt Boldy,L,MIN,23,69,20,33,53
10,8480830,Andrei Svechnikov,R,CAR,24,72,19,34,53
10,8480015,Owen Tippett,R,PHI,25,75,27,25,52
10,8482110,Dawson Mercer,C,NJD,23,71,25,27,52
10,8481528,Dylan Cozens,C,BUF,23,74,23,29,52
10,8478401,Pavel Zacha,C,BOS,27,77,22,30,52
10,8474679,Gustav Nyquist,C,NSH,35,71,16,36,52
10,8477503,Max Domi,C,TOR,29,79,15,37,52
10,8476462,Dougie Hamilton,D,NJD,31,61,12,40,52
10,8479525,Ross Colton,C,COL,28,80,27,24,51
10,8475726,Tyler Toffoli,C,SJS,32,71,23,28,51
10,8480039,Martin Necas,C,CAR,25,69,22,29,51
10,8480434,Sean Durzi,D,UTA,26,67,12,39,51
10,8474590,John Carlson,D,WSH,34,73,10,41,51
10,8477407,Anthony Duclair,L,NYI,29,75,23,27,50
10,8482109,Alexis Lafrenière,L,NYR,23,74,22,28,50
10,8475798,Mikael Granlund,C,SJS,32,70,19,31,50
10,8483515,Juraj Slafkovsky,L,MTL,20,75,19,31,50
10,8481068,Yegor Sharangovich,C,CGY,26,77,17,33,50
10,8477498,Darnell Nurse,D,EDM,29,76,14,36,50
10,8476853,Morgan Rielly,D,TOR,30,71,8,42,50
10,8481596,Shane Pinto,C,OTT,24,74,23,26,49
10,8474586,Jordan Eberle,R,SEA,34,73,23,26,49
10,8473986,Alex Killorn,L,ANA,35,76,21,28,49
10,8481618,Alex Newhook,C,MTL,23,71,20,29,49
10,8479999,Casey Mittelstadt,C,COL,26,80,19,30,49
10,8474150,Mikael Backlund,C,CGY,35,78,19,30,49
10,8477456,J.T. Compher,L,DET,29,80,18,31,49
10,8476906,Shayne Gostisbehere,D,CAR,31,75,10,39,49
10,8476432,Boone Jenner,C,CBJ,31,72,30,18,48
10,8481604,Pavel Dorofeyev,L,VGK,24,70,30,18,48
10,8475169,Evander Kane,L,EDM,33,75,28,20,48
10,8475287,Erik Haula,L,NJD,33,72,22,26,48
10,8478498,Jake DeBrusk,L,VAN,28,66,19,29,48
10,8478873,Troy Terry,R,ANA,27,69,17,31,48
10,8478396,Noah Hanifin,D,VGK,27,61,12,36,48
10,8479410,Mikhail Sergachev,D,UTA,26,70,10,38,48
10,8478407,Vince Dunn,D,SEA,28,70,10,38,48
10,8478440,Dylan Strome,C,WSH,27,69,26,21,47
10,8484153,Leo Carlsson,C,ANA,20,69,19,28,47
10,8478519,Anthony Cirelli,C,TBL,27,81,18,29,47
10,8481533,Trevor Zegras,C,ANA,23,70,17,30,47
10,8470613,Brent Burns,D,CAR,39,71,17,30,47
10,8477416,Oliver Bjorkstrand,R,SEA,29,77,16,31,47
10,8477476,Artturi Lehkonen,L,COL,29,82,16,31,47
10,8478397,Rasmus Andersson,D,CGY,28,75,9,38,47
10,8480014,Gabriel Vilardi,C,WPG,25,67,24,22,46
10,8474641,Adam Henrique,C,EDM,34,77,23,23,46
10,8479400,Pierre-Luc Dubois,L,WSH,26,66,22,24,46
10,8476905,Chandler Stephenson,C,SEA,30,70,21,25,46
10,8477964,Ivan Barbashev,C,VGK,29,76,21,25,46
10,8475794,Tyler Seguin,C,DAL,32,81,20,26,46
10,8479987,Morgan Geekie,C,BOS,26,74,16,30,46
10,8478975,Mason Marchment,L,DAL,29,80,15,31,46
10,8477494,Jonathan Drouin,L,COL,29,81,15,31,46
10,8475753,Justin Faulk,D,STL,32,66,10,36,46
10,8480803,Evan Bouchard,D,EDM,25,77,8,38,46
10,8483808,Andrei Kuzmenko,L,CGY,28,76,21,24,45
10,8482055,Drew O'Connor,L,PIT,26,65,20,25,45
10,8478047,Michael Bunting,L,PIT,29,67,19,26,45
10,8474149,Evgenii Dadonov,R,DAL,35,80,18,27,45
10,8483505,Matthew Poitras,C,BOS,20,75,11,34,45
10,8471724,Kris Letang,D,PIT,37,80,10,35,45
10,8476958,Jaccob Slavin,D,CAR,30,76,6,39,45
10,8479425,Filip Hronek,D,VAN,27,73,3,42,45
10,8475151,Kyle Palmieri,C,NYI,33,75,19,25,44
10,8477986,Brandon Montour,D,SEA,30,71,12,32,44
10,8478438,Tommy Novak,C,NSH,27,65,8,36,44
10,8475314,Anders Lee,L,NYI,34,80,23,20,43
10,8482702,Logan Stankoven,C,DAL,21,81,17,26,43
10,8476458,Ryan Strome,C,ANA,31,70,16,27,43
10,8480009,Eeli Tolvanen,R,SEA,25,72,14,29,43
10,8476875,Mike Matheson,D,MTL,30,66,7,36,43
10,8481542,Moritz Seider,D,DET,23,78,5,38,43
10,8480798,Philipp Kurashev,C,CHI,25,69,13,29,42
10,8475763,Kevin Hayes,R,PIT,32,66,11,31,42
10,8478055,Gustav Forsling,D,FLA,28,72,7,35,42
10,8482089,Jake Neighbours,L,STL,22,71,24,17,41
10,8476882,Teuvo Teravainen,L,CHI,30,67,21,20,41
10,8478057,Dakota Joshua,C,VAN,28,67,20,21,41
10,8475793,Ryan Johansen,C,PHI,32,67,18,23,41
10,8482720,Matthew Knies,L,TOR,22,79,13,28,41
10,8476463,Jonas Brodin,D,MIN,31,75,9,32,41
10,8478474,Lawson Crouse,L,UTA,27,72,26,14,40
10,8476399,Blake Coleman,C,CGY,33,78,23,17,40
10,8478466,Daniel Sprong,R,VAN,27,75,23,17,40
10,8477998,Warren Foegele,L,LAK,28,78,17,23,40
10,8478115,Pierre Engvall,L,NYI,28,77,17,23,40
10,8476419,Jean-Gabriel Pageau,C,NYI,32,77,16,24,40
10,8475218,Mattias Ekholm,D,EDM,34,73,12,28,40
10,8479325,Charlie McAvoy,D,BOS,27,75,9,31,40
10,8476869,Brady Skjei,D,NSH,30,70,8,32,40
10,8480817,K'Andre Miller,D,NYR,24,68,7,33,40
10,8476438,Brandon Saad,L,STL,32,72,21,18,39
10,8484166,Adam Fantilli,C,CBJ,20,63,20,19,39
10,8476483,Rickard Rakell,R,PIT,31,71,20,19,39
10,8481560,Arthur Kaliyev,R,LAK,23,77,20,19,39
10,8479365,Trent Frederic,C,BOS,26,76,20,19,39
10,8481554,Kaapo Kakko,R,NYR,23,68,20,19,39
10,8477429,Andrew Copp,C,DET,30,79,17,22,39
10,8478233,Andrew Mangiapane,L,WSH,28,72,17,22,39
10,8480188,Fabian Zetterlund,L,SJS,25,67,16,23,39
10,8481703,Valtteri Puustinen,R,PIT,25,61,12,27,39
10,8476826,Yanni Gourde,C,SEA,33,70,12,27,39
10,8474563,Drew Doughty,D,LAK,35,71,11,28,39
10,8476872,Scott Laughton,C,PHI,30,70,10,29,39
10,8476854,Hampus Lindholm,D,BOS,30,75,10,29,39
10,8480113,Alex Iafallo,L,WPG,31,69,19,19,38
10,8476880,Tom Wilson,R,WSH,30,69,17,21,38
10,8478046,Danton Heinen,L,VAN,29,69,17,21,38
10,8480849,Barrett Hayton,C,UTA,24,77,17,21,38
10,8474716,Jared Spurgeon,D,MIN,35,76,15,23,38
10,8476479,Phillip Danault,C,LAK,31,77,15,23,38
10,8478458,Jack Roslovic,C,CAR,27,58,14,24,38
10,8480829,Jesperi Kotkaniemi,C,CAR,24,68,13,25,38
10,8481580,Connor McMichael,C,WSH,23,65,12,26,38
10,8476885,Jacob Trouba,D,NYR,30,73,11,27,38
10,8475799,Nino Niederreiter,R,WPG,32,65,25,12,37
10,8476981,Josh Anderson,R,MTL,30,69,23,14,37
10,8482092,Ridly Greig,C,OTT,22,78,18,19,37
10,8480459,Pius Suter,C,VAN,28,68,18,19,37
10,8477426,Nicholas Paul,L,TBL,29,82,18,19,37
10,8475768,Jaden Schwartz,C,SEA,32,70,17,20,37
10,8477444,Andre Burakovsky,L,SEA,29,70,17,20,37
10,8477497,Sean Monahan,C,CBJ,30,70,14,23,37
10,8481481,Blake Lizotte,C,PIT,27,69,14,23,37
10,8477948,Travis Sanheim,D,PHI,28,70,12,25,37
10,8483490,Pavel Mintyukov,D,ANA,21,69,11,26,37
10,8477932,Aaron Ekblad,D,FLA,28,73,10,27,37
10,8480185,Eetu Luostarinen,C,FLA,26,71,19,17,36
10,8482705,Cole Sillinger,C,CBJ,21,68,19,17,36
10,8482149,Cole Perfetti,C,WPG,22,66,17,19,36
10,8475193,Tomas Tatar,L,NJD,34,68,17,19,36
10,8482475,Yegor Chinakhov,R,CBJ,23,63,16,20,36
10,8480797,Joel Farabee,L,PHI,24,74,15,21,36
10,8482124,Quinton Byfield,R,LAK,22,77,12,24,36
10,8474565,Alex Pietrangelo,D,VGK,34,61,12,24,36
10,8477346,MacKenzie Weegar,D,CGY,30,72,11,25,36
10,8478469,Thomas Chabot,D,OTT,27,76,9,27,36
10,8480145,Neal Pionk,D,WPG,29,74,6,30,36
10,8481546,Cam York,D,PHI,23,74,5,31,36
10,8481535,Nils Hoglander,L,VAN,24,70,18,17,35
10,8481186,Logan O'Connor,R,COL,28,80,17,18,35
10,8474715,Cam Atkinson,R,TBL,35,81,17,18,35
10,8482133,Thomas Bordeleau,C,SJS,22,66,16,19,35
10,8479992,Michael Rasmussen,C,DET,25,80,12,23,35
10,8471698,T.J. Oshie,R,WSH,38,63,11,24,35
10,8477021,Alex Kerfoot,C,UTA,30,72,9,26,35
10,8480873,Rasmus Sandin,D,WSH,24,70,3,32,35
10,8477511,Anthony Mantha,R,CGY,30,77,17,17,34
10,8478462,Nicolas Roy,C,VGK,27,69,16,18,34
10,8478109,Victor Olofsson,L,VGK,29,76,16,18,34
10,8477987,Ryan Donato,C,CHI,28,71,14,20,34
10,8476292,Ondrej Palat,L,NJD,33,70,13,21,34
10,8476461,Sean Couturier,C,PHI,32,70,12,22,34
10,8477839,Conor Sheary,L,TBL,32,79,10,24,34
10,8476927,Teddy Blueger,C,VAN,30,58,8,26,34
10,8482117,Lukas Reichel,L,CHI,22,64,22,11,33
10,8480813,Joe Veleno,C,DET,24,76,16,17,33
10,8480871,Adam Boqvist,D,FLA,24,73,15,18,33
10,8480802,Ryan McLeod,C,BUF,25,66,14,19,33
10,8482105,Jake Sanderson,D,OTT,22,77,13,20,33
10,8479345,Jakob Chychrun,D,WSH,26,67,13,20,33
10,8475149,Marcus Johansson,L,MIN,34,61,13,20,33
10,8476792,Torey Krug,D,STL,33,72,11,22,33
10,8474053,Logan Couture,C,SJS,35,59,11,22,33
10,8479339,Patrik Laine,L,CBJ,26,67,10,23,33
10,8476392,Adam Lowry,C,WPG,31,65,10,23,33
10,8475760,Nick Bjugstad,C,UTA,32,70,19,13,32
10,8482159,Tyson Foerster,R,PHI,22,73,16,16,32
10,8473533,Jordan Staal,C,CAR,36,68,15,17,32
10,8479591,Michael Eyssimont,C,TBL,28,80,12,20,32
10,8477406,Mattias Janmark,C,EDM,32,67,11,21,32
10,8475181,Nick Leddy,D,STL,33,65,4,28,32
10,8480043,Timothy Liljegren,D,TOR,25,72,1,31,32
10,8479393,Noah Gregor,C,OTT,26,78,18,13,31
10,8480980,Connor Dewar,C,TOR,25,72,17,14,31
10,8477953,Kasperi Kapanen,R,STL,28,74,15,16,31
10,8476474,Stefan Noesen,R,NJD,31,71,13,18,31
10,8483457,Lane Hutson,D,MTL,20,74,13,18,31
10,8480855,Jack McBain,C,UTA,24,69,13,18,31
10,8484145,Zach Benson,L,BUF,19,72,12,19,31
10,8477425,Miles Wood,L,COL,29,78,10,21,31
10,8478472,Mathieu Joseph,R,STL,27,72,8,23,31
10,8476923,Damon Severson,D,CBJ,30,82,7,24,31
10,8482122,Brock Faber,D,MIN,22,71,7,24,31
10,8478020,Michael Amadio,C,OTT,28,72,17,13,30
10,8480893,Kirill Marchenko,R,CBJ,24,64,16,14,30
10,8476469,Joel Armia,R,MTL,31,74,15,15,30
10,8475722,Jason Zucker,L,BUF,32,65,14,16,30
10,8478463,Anthony Beauvillier,L,PIT,27,63,12,18,30
10,8477495,Seth Jones,D,CHI,30,62,7,23,30
10,8478500,Ivan Provorov,D,CBJ,27,78,6,24,30
10,8479398,Samuel Girard,D,COL,26,64,3,27,30
10,8475764,Cam Fowler,D,ANA,33,68,1,29,30
10,8480078,Filip Chytil,C,NYR,25,65,16,13,29
10,8482146,Luke Evangelista,R,NSH,22,74,14,15,29
10,8470621,Corey Perry,R,EDM,39,68,14,15,29
10,8477919,Frederick Gaudreau,C,MIN,31,63,13,16,29
10,8478013,Jake Walman,D,SJS,28,70,11,18,29
10,8477479,Tyler Bertuzzi,L,CHI,29,63,10,19,29
10,8482660,Kent Johnson,C,CBJ,22,59,10,19,29
10,8475200,Dmitry Orlov,D,CAR,33,82,8,21,29
10,8476892,Colton Parayko,D,STL,31,67,2,27,29
10,8481624,Ilya Mikheyev,R,CHI,30,64,14,14,28
10,8477947,Sonny Milano,L,WSH,28,61,14,14,28
10,8478542,Evan Rodrigues,C,FLA,31,75,12,16,28
10,8477435,Ryan Graves,D,PIT,29,80,12,16,28
10,8475848,Brendan Gallagher,R,MTL,32,71,11,17,28
10,8483499,Liam Ohgren,L,MIN,20,50,8,20,28
10,8482671,Owen Power,D,BUF,22,69,8,20,28
10,8477488,Brett Pesce,D,NJD,30,70,6,22,28
10,8484203,Bradly Nadeau,L,CAR,19,70,6,22,28
10,8482655,J.J. Moser,D,TBL,24,76,5,23,28
10,8474574,Tyler Myers,D,VAN,34,74,5,23,28
10,8476979,Erik Gustafsson,D,DET,32,71,4,24,28
10,8481581,Thomas Harley,D,DAL,23,79,3,25,28
10,8477969,Marcus Pettersson,D,PIT,28,81,2,26,28
10,8477506,Ryan Pulock,D,NYI,30,77,2,26,28
10,8480068,Ryan Poehling,C,PHI,25,71,14,13,27
10,8479328,Julien Gauthier,R,NYI,27,71,13,14,27
10,8479996,Cody Glass,C,NSH,25,58,11,16,27
10,8482667,William Eklund,L,SJS,22,66,10,17,27
10,8480336,Sean Walker,D,CAR,30,70,9,18,27
10,8477015,Connor Brown,R,EDM,30,63,9,18,27
10,8479351,Sam Steel,C,DAL,26,78,9,18,27
10,8479976,Juuso Valimaki,D,UTA,26,62,7,20,27
10,8479941,Justin Danforth,R,CBJ,31,61,17,9,26
10,8477353,Tyler Motte,C,DET,29,77,17,9,26
10,8478434,Keegan Kolesar,R,VGK,27,65,15,11,26
10,8482175,JJ Peterka,R,BUF,22,66,14,12,26
10,8479368,Max Jones,L,BOS,26,62,14,12,26
10,8481477,Nico Sturm,C,SJS,29,57,13,13,26
10,8479414,Nathan Bastian,R,NJD,27,52,11,15,26
10,8479353,Brett Howden,C,VGK,26,73,11,15,26
10,8481577,Philip Tomasino,C,NSH,23,60,10,16,26
10,8476878,Zemgus Girgensons,L,TBL,30,81,10,16,26
10,8477979,Nicolas Aube-Kubel,R,BUF,28,62,10,16,26
10,8480995,Pontus Holmberg,R,TOR,25,68,9,17,26
10,8476931,Jake McCabe,D,TOR,31,64,6,20,26
10,8478133,Jake Evans,C,MTL,28,71,5,21,26
10,8481032,Paul Cotter,C,NJD,25,62,17,8,25
10,8480748,Kiefer Sherwood,L,VAN,29,60,15,10,25
10,8482097,Jack Quinn,R,BUF,23,60,14,11,25
10,8479619,Michael Carcone,L,UTA,28,61,14,11,25
10,8482259,Bobby McMann,C,TOR,28,75,12,13,25
10,8481553,Bobby Brink,R,PHI,23,72,11,14,25
10,8482125,Alexander Holtz,R,VGK,22,71,9,16,25
10,8476480,Vladislav Namestnikov,C,WPG,32,67,9,16,25
10,8476902,Esa Lindell,D,DAL,30,82,9,16,25
10,8476873,Mark Jankowski,C,NSH,30,59,9,16,25
10,8478413,Jordan Greenway,L,BUF,27,59,8,17,25
10,8479661,Tanner Jeannot,L,LAK,27,75,7,18,25
10,8478911,Matt Roy,D,WSH,29,63,6,19,25
10,8481656,Aliaksei Protas,C,WSH,23,63,5,20,25
10,8479982,Conor Timmins,D,TOR,26,63,2,23,25
10,8476331,Dylan DeMelo,D,WPG,31,73,2,23,25
10,8479293,Brandon Tanev,L,SEA,33,64,14,10,24
10,8477952,Robby Fabbri,C,ANA,28,64,12,12,24
10,8478432,Christian Fischer,R,DET,27,80,12,12,24
10,8479390,Taylor Raddysh,R,WSH,26,64,12,12,24
10,8483468,Jiri Kulich,C,BUF,20,61,10,14,24
10,8478891,Mason Appleton,C,WPG,28,62,9,15,24
10,8480073,Erik Brannstrom,D,COL,25,63,6,18,24
10,8482062,Cole Smith,L,NSH,29,55,6,18,24
10,8475279,Ben Chiarot,D,DET,33,73,4,20,24
10,8479324,Ryan Lindgren,D,NYR,26,66,3,21,24
10,8482157,Will Cuylle,L,NYR,22,60,14,9,23
10,8476897,Oskar Sundqvist,C,STL,30,65,14,9,23
10,8476278,Colin Blackwell,C,DAL,31,78,13,10,23
10,8478508,Yakov Trenin,C,MIN,27,61,13,10,23
10,8477478,William Carrier,L,CAR,30,54,13,10,23
10,8481582,Nicholas Robertson,L,TOR,23,71,12,11,23
10,8481517,Brett Leason,R,ANA,25,54,11,12,23
10,8477450,Jason Dickinson,C,CHI,29,68,9,14,23
10,8476925,Colton Sissons,C,NSH,31,67,8,15,23
10,8481523,Kirby Dach,C,MTL,23,68,7,16,23
10,8482101,Danil Gushchin,L,SJS,22,54,7,16,23
10,8483491,Ivan Miroshnichenko,L,WSH,20,54,7,16,23
10,8476917,Adam Pelech,D,NYI,30,75,6,17,23
10,8482624,Daniil Miromanov,D,CGY,27,71,6,17,23
10,8480144,David Kampf,C,TOR,29,72,5,18,23
10,8476312,Josh Manson,D,COL,33,64,5,18,23
10,8477931,Tomas Nosek,L,FLA,32,64,5,18,23
10,8480049,Dylan Samberg,D,WPG,25,71,4,19,23
10,8476429,Scott Mayfield,D,NYI,32,74,4,19,23
10,8478507,John Marino,D,UTA,27,69,2,21,23
10,8481568,Alex Vlasic,D,CHI,23,64,2,21,23
10,8480806,Isac Lundestrom,C,ANA,25,58,17,5,22
10,8473422,Nick Foligno,L,CHI,37,61,13,9,22
10,8479336,Carl Grundstrom,R,SJS,27,55,13,9,22
10,8480448,Parker Kelly,L,COL,25,73,12,10,22
10,8480220,Noah Cates,L,PHI,25,68,11,11,22
10,8475231,Casey Cizikas,C,NYI,33,64,11,11,22
10,8482074,Connor Zary,C,CGY,23,63,11,11,22
10,8473563,Nicklas Backstrom,C,WSH,37,58,10,12,22
10,8480074,Alexandre Texier,C,STL,25,62,9,13,22
10,8482111,Justin Barron,D,MTL,23,66,9,13,22
10,8479718,Alex Barré-Boulet,C,MTL,27,50,9,13,22
10,8477989,Christian Dvorak,C,MTL,28,64,7,15,22
10,8480246,Nick Perbix,D,TBL,26,66,6,16,22
10,8475171,Oliver Ekman-Larsson,D,TOR,33,67,5,17,22
10,8479983,Mario Ferraro,D,SJS,26,71,5,17,22
10,8478882,Vladislav Gavrikov,D,LAK,29,69,3,19,22
10,8482079,Marco Rossi,C,MIN,23,61,13,8,21
10,8479536,Axel Jonsson-Fjallby,L,WPG,26,48,13,8,21
10,8476918,Jimmy Vesey,L,NYR,31,67,9,12,21
10,8482809,Jackson Blake,R,CAR,21,55,9,12,21
10,8476467,Jamie Oleksiak,D,SEA,32,71,6,15,21
10,8476457,Adam Larsson,D,SEA,32,66,6,15,21
10,8475455,Brenden Dillon,D,NJD,34,59,4,17,21
10,8480727,Zach Whitecloud,D,VGK,28,54,4,17,21
10,8475188,Brayden McNabb,D,VGK,33,58,1,20,21
10,8478136,Jake Middleton,D,MIN,28,75,0,21,21
10,8477446,Michael McCarron,R,NSH,29,55,13,7,20
10,8482737,Zack Bolduc,C,STL,21,62,10,10,20
10,8480789,Oliver Wahlstrom,R,NYI,24,69,10,10,20
10,8475855,Jesper Fast,R,CAR,33,52,8,12,20
10,8478416,Erik Cernak,D,TBL,27,72,7,13,20
10,8477499,Rasmus Ristolainen,D,PHI,30,57,7,13,20
10,8478211,Dryden Hunt,L,CGY,29,61,7,13,20
10,8483482,Tristan Luneau,D,ANA,20,65,6,14,20
10,8476374,Sean Kuraly,C,CBJ,31,59,6,14,20
10,8482712,Oskar Olausson,R,COL,22,73,5,15,20
10,8480891,Michael Kesselring,D,UTA,24,60,3,17,20
10,8480157,Calle Rosen,D,COL,30,44,3,17,20
10,8477369,Carson Soucy,D,VAN,30,62,2,18,20
10,8476891,Matt Grzelcyk,D,PIT,30,68,2,18,20
10,8475343,Nic Dowd,C,WSH,34,64,12,7,19
10,8478585,Derek Ryan,C,EDM,38,68,10,9,19
10,8474189,Lars Eller,C,PIT,35,65,9,10,19
10,8476921,Jordan Martinook,L,CAR,32,62,9,10,19
10,8483493,Frank Nazar,C,CHI,20,55,7,12,19
10,8478970,Jalen Chatfield,D,CAR,28,68,7,12,19
10,8480003,Jesper Boqvist,C,FLA,26,69,7,12,19
10,8476994,Vinnie Hinostroza,C,NSH,30,51,7,12,19
10,8479639,Dylan Coghlan,D,WPG,26,66,6,13,19
10,8481606,Jordan Spence,D,LAK,23,70,5,14,19
10,8478468,Jeremy Lauzon,D,NSH,27,62,4,15,19
10,8479371,Dante Fabbro,D,NSH,26,66,3,16,19
10,8476967,Brett Kulak,D,EDM,30,58,1,18,19
10,8480835,Jack Drury,C,CAR,24,58,11,7,18
10,8481704,Juuso Parssinen,C,NSH,23,52,11,7,18
10,8478569,Noel Acciari,C,PIT,33,53,11,7,18
10,8473453,Trevor Lewis,C,LAK,37,72,10,8,18
10,8481601,Simon Holmstrom,R,NYI,23,68,9,9,18
10,8477392,Hudson Fasching,R,NYI,29,67,8,10,18
10,8482679,Matt Coronato,R,CGY,22,59,7,11,18
10,8483565,Nick Blankenburg,D,NSH,26,66,6,12,18
10,8480192,Johnathan Kovacevic,D,NJD,27,55,5,13,18
10,8473507,Jeff Petry,D,DET,37,71,4,14,18
10,8475462,Radko Gudas,D,ANA,34,69,4,14,18
10,8476879,Cody Ceci,D,EDM,31,66,4,14,18
10,8482730,Brandt Clarke,D,LAK,21,47,4,14,18
10,8477507,Nikita Zadorov,D,BOS,29,68,3,15,18
10,8475324,Nick Jensen,D,OTT,34,60,3,15,18
10,8477220,Nate Schmidt,D,FLA,33,58,2,16,18
10,8481178,Egor Zamula,D,PHI,24,54,2,16,18
10,8480058,Pierre-Olivier Joseph,D,STL,25,52,2,16,18
10,8480281,Alexey Toropchenko,R,STL,25,49,15,2,17
10,8480252,Cole Guttman,C,CHI,25,45,11,6,17
10,8483524,Shane Wright,C,SEA,20,59,10,7,17
10,8482749,Joshua Roy,R,MTL,21,60,8,9,17
10,8480205,Emil Bemstrom,C,PIT,25,63,8,9,17
10,8482148,Hendrix Lapierre,C,WSH,22,55,8,9,17
10,8475220,Marcus Foligno,L,MIN,33,51,7,10,17
10,8479315,Joey Anderson,R,CHI,26,49,7,10,17
10,8477508,Curtis Lazar,C,NJD,29,61,7,10,17
10,8475791,Taylor Hall,L,CHI,33,52,6,11,17
10,8476329,Travis Boyd,C,MIN,31,51,5,12,17
10,8478452,Caleb Jones,D,LAK,27,60,4,13,17
10,8475233,David Savard,D,MTL,34,65,3,14,17
10,8476422,Mike Reilly,D,NYI,31,74,3,14,17
10,8481527,Kaedan Korczak,D,VGK,23,44,3,14,17
10,8479980,Nicolas Hague,D,VGK,26,54,3,14,17
10,8476988,Matt Benning,D,SJS,30,56,2,15,17
10,8474151,Ryan McDonagh,D,TBL,35,77,2,15,17
10,8471677,Jack Johnson,D,CBJ,37,66,2,15,17
10,8480796,Martin Fehervary,D,WSH,25,55,1,16,17
10,8474166,Alec Martinez,D,CHI,37,47,1,16,17
10,8476473,Connor Murphy,D,CHI,31,37,0,17,17
10,8476960,Andreas Athanasiou,C,CHI,30,52,10,6,16
10,8481789,Tye Kartye,L,SEA,23,41,10,6,16
10,8479316,Luke Kunin,C,SJS,27,57,8,8,16
10,8479520,Brandon Duhaime,R,WSH,27,55,8,8,16
10,8478831,Kevin Stenlund,C,UTA,28,51,8,8,16
10,8483445,Cutter Gauthier,L,ANA,20,62,7,9,16
10,8477573,Nathan Walker,L,STL,30,52,7,9,16
10,8475225,Craig Smith,C,CHI,35,47,6,10,16
10,8479442,Troy Stecher,D,EDM,30,49,6,10,16
10,8481019,David Gustafsson,C,WPG,24,48,6,10,16
10,8482634,Alex Steeves,C,TOR,25,64,4,12,16
10,8480860,Kevin Bahl,D,CGY,24,48,4,12,16
10,8480035,Henri Jokiharju,D,BUF,25,60,4,12,16
10,8475690,Chris Tanev,D,TOR,35,56,4,12,16
10,8476372,Nick Seeler,D,PHI,31,46,4,12,16
10,8475718,Justin Holl,D,DET,32,59,2,14,16
10,8477845,Trevor van Riemsdyk,D,WSH,33,60,2,14,16
10,8482245,Artem Zub,D,OTT,29,69,1,15,16
10,8478840,Will Borgen,D,SEA,28,71,1,15,16
10,8481014,Alexander Romanov,D,NYI,24,74,1,15,16
10,8479372,Josh Mahura,D,SEA,26,57,1,15,16
10,8476874,Olli Maatta,D,DET,30,64,1,15,16
10,8477903,Garnet Hathaway,R,PHI,33,59,8,7,15
10,8480762,Eric Robinson,L,CAR,29,59,8,7,15
10,8476889,Radek Faksa,C,STL,30,60,7,8,15
10,8477887,Patrick Brown,C,BOS,32,48,7,8,15
10,8475842,Sam Carrick,C,NYR,32,60,6,9,15
10,8478421,A.J. Greer,L,FLA,28,67,5,10,15
10,8483495,Simon Nemec,D,NJD,20,59,5,10,15
10,8482077,Dylan Holloway,L,EDM,23,48,5,10,15
10,8478043,Sam Lafferty,C,BUF,29,55,4,11,15
10,8478443,Brandon Carlo,D,BOS,28,62,4,11,15
10,8481521,Ronnie Attard,D,PHI,25,57,4,11,15
10,8477018,Ben Hutton,D,VGK,31,47,4,11,15
10,8482451,Mikael Pyyhtia,L,CBJ,23,44,4,11,15
10,8474673,TJ Brodie,D,CHI,34,61,3,12,15
10,8478178,Darren Raddysh,D,TBL,28,65,3,12,15
10,8470600,Ryan Suter,D,STL,39,63,3,12,15
10,8474612,Travis Hamonic,D,OTT,34,56,2,13,15
10,8482142,Jamie Drysdale,D,PHI,22,62,1,14,15
10,8482166,Shakir Mukhamadullin,D,SJS,22,58,9,5,14
10,8479066,Ryan Lomberg,L,CGY,30,60,8,6,14
10,8481522,Peyton Krebs,C,BUF,23,58,7,7,14
10,8479370,Tyson Jost,C,CAR,26,54,5,9,14
10,8480222,Sebastian Aho,D,PIT,28,69,5,9,14
10,8480025,MacKenzie Entwistle,R,FLA,25,56,4,10,14
10,8482073,Braden Schneider,D,NYR,23,59,4,10,14
10,8482803,Olen Zellweger,D,ANA,21,62,3,11,14
10,8480950,Ilya Lyubushkin,D,DAL,30,76,3,11,14
10,8482067,Connor Mackey,D,NYR,28,55,3,11,14
10,8479402,Jake Bean,D,CGY,26,66,2,12,14
10,8482087,Kaiden Guhle,D,MTL,22,69,2,12,14
10,8474090,Brendan Smith,D,DAL,35,79,1,13,14
10,8478399,Jonas Siegenthaler,D,NJD,27,60,1,13,14
10,8474013,Ian Cole,D,UTA,35,57,1,13,14
10,8473446,Erik Johnson,D,PHI,36,48,0,14,14
10,8479369,Andrew Peeke,D,BOS,26,57,0,14,14
10,8482762,Simon Edvinsson,D,DET,21,52,10,3,13
10,8479439,Jacob MacDonald,D,COL,31,46,9,4,13
10,8482155,Alex Laferriere,R,LAK,23,64,8,5,13
10,8481059,Scott Perunovich,D,STL,26,60,6,7,13
10,8481592,Jakob Pelletier,L,CGY,23,47,6,7,13
10,8476934,Brock McGinn,L,ANA,30,43,6,7,13
10,8479344,Jesse Puljujarvi,R,PIT,26,51,5,8,13
10,8476442,Matt Nieto,L,PIT,32,51,5,8,13
10,8484149,Gavin Brindley,C,CBJ,20,57,4,9,13
10,8477365,Connor Clifton,D,BUF,29,62,4,9,13
10,8481537,Nikita Okhotiuk,D,CGY,24,54,4,9,13
10,8482666,Scott Morrow,D,CAR,22,50,4,9,13
10,8479026,Philippe Myers,D,TOR,27,48,4,9,13
10,8482765,Isak Rosen,R,BUF,21,34,4,9,13
10,8478851,Alexandre Carrier,D,NSH,28,60,3,10,13
10,8481600,Tobias Bjornfot,D,FLA,23,50,3,10,13
10,8480007,Jonas Rondbjerg,R,VGK,25,45,3,10,13
10,8483466,Kevin Korchinski,D,CHI,20,55,2,11,13
10,8475790,Erik Gudbranson,D,CBJ,32,78,1,12,13
10,8478859,Niko Mikkola,D,FLA,28,56,1,12,13
10,8480807,Mattias Samuelsson,D,BUF,24,47,0,13,13
10,8481093,Rafael Harvey-Pinard,L,MTL,25,61,9,3,12
10,8482744,James Malatesta,L,CBJ,21,44,8,4,12
10,8477380,Jonny Brodzinski,C,NYR,31,48,7,5,12
10,8480289,Morgan Barron,C,WPG,26,52,6,6,12
10,8482652,Walker Duehr,R,CGY,27,38,6,6,12
10,8481716,Dmitri Voronkov,L,CBJ,24,42,6,6,12
10,8481441,Joe Snively,C,DET,28,50,6,6,12
10,8482141,Lukas Cormier,D,VGK,22,29,5,7,12
10,8481013,Jonatan Berggren,R,DET,24,62,4,8,12
10,8480880,Jakub Lauko,C,MIN,24,40,4,8,12
10,8482192,Isaak Phillips,D,CHI,23,47,3,9,12
10,8476525,Colin Miller,D,WPG,32,63,3,9,12
10,8482095,Tyler Kleven,D,OTT,22,45,3,9,12
10,8475208,Brian Dumoulin,D,ANA,33,60,3,9,12
10,8483460,David Jiricek,D,CBJ,21,55,3,9,12
10,8482176,Wyatt Kaiser,D,CHI,22,55,2,10,12
10,8479998,Mikey Anderson,D,LAK,25,56,2,10,12
10,8480878,Nils Lundkvist,D,DAL,24,82,2,10,12
10,8471709,Marc-Edouard Vlasic,D,SJS,37,54,2,10,12
10,8480172,Jan Rutta,D,SJS,34,61,1,11,12
10,8479671,Mathieu Olivier,R,CBJ,27,44,6,5,11
10,8481641,Joel Kiviranta,L,COL,28,72,6,5,11
10,8477070,Liam O'Brien,C,UTA,30,59,6,5,11
10,8479994,Jaret Anderson-Dolan,C,WPG,25,35,5,6,11
10,8481708,Zac Jones,D,NYR,24,55,4,7,11
10,8480196,Jacob Bryson,D,BUF,27,45,4,7,11
10,8482859,Zack Ostapchuk,C,OTT,21,55,4,7,11
10,8480021,Jack Studnicka,C,LAK,25,64,3,8,11
10,8479359,Beck Malenstyn,L,BUF,26,51,3,8,11
10,8481567,Henry Thrun,D,SJS,23,53,1,10,11
10,8476952,Dominic Toninato,C,WPG,30,38,1,10,11
10,8479638,Justin Brazeau,R,BOS,26,39,7,3,10
10,8479968,Vinni Lettieri,C,BOS,29,45,6,4,10
10,8481518,Nolan Foote,L,NJD,24,40,6,4,10
10,8480011,Klim Kostin,C,SJS,25,43,5,5,10
10,8476822,Luke Glendening,C,TBL,35,80,5,5,10
10,8482145,Mavrik Bourque,C,DAL,22,54,5,5,10
10,8478874,Adam Gaudette,C,OTT,28,38,4,6,10
10,8481532,Alex Turcotte,C,LAK,23,49,4,6,10
10,8482751,Ryan Winterton,C,SEA,21,36,4,6,10
10,8482807,Ethan Del Mastro,D,CHI,21,55,3,7,10
10,8477473,Justin Bailey,R,SJS,29,36,3,7,10
10,8483397,Marc McLaughlin,C,BOS,25,30,3,7,10
10,8476624,Barclay Goodrow,C,SJS,31,54,1,9,10
10,8480845,Rasmus Kupari,C,WPG,24,46,1,9,10
10,8474567,Zach Bogosian,D,MIN,34,59,1,9,10
10,8480887,Jordan Harris,D,MTL,24,56,1,9,10
10,8481161,Jake Christiansen,D,CBJ,25,54,1,9,10
10,8475750,Jon Merrill,D,MIN,32,58,0,10,10
10,8481617,Vasily Podkolzin,R,VAN,23,42,7,2,9
10,8482070,Mitchell Chaffee,R,TBL,26,51,7,2,9
10,8482733,Logan Mailloux,D,MTL,31,32,6,3,9
10,8482177,Marat Khusnutdinov,C,MIN,22,37,6,3,9
10,8481028,Martin Pospisil,C,CGY,25,53,5,4,9
10,8480990,Declan Chisholm,D,MIN,24,51,4,5,9
10,8479772,Zack MacEwen,R,OTT,28,50,4,5,9
10,8479348,Kale Clague,D,BUF,26,49,3,6,9
10,8482659,Josh Doan,R,UTA,22,50,3,6,9
10,8482747,Brennan Othmann,L,NYR,21,41,3,6,9
10,8481524,Bowen Byram,D,BUF,23,49,3,6,9
10,8474568,Luke Schenn,D,NSH,35,52,3,6,9
10,8477962,Brendan Lemieux,L,CAR,28,36,3,6,9
10,8480355,Mark Kastelic,C,BOS,25,58,2,7,9
10,8480848,Ty Dellandrea,C,SJS,24,46,2,7,9
10,8475179,Dmitry Kulikov,D,FLA,34,55,2,7,9
10,8483619,Filip Roos,D,OTT,25,32,2,7,9
10,8482153,Brendan Brisson,C,VGK,23,34,2,7,9
10,8481122,Simon Benoit,D,TOR,26,35,1,8,9
10,8475235,Nicolas Deslauriers,L,PHI,33,46,7,1,8
10,8479981,Jonah Gadjovich,L,FLA,26,39,6,2,8
10,8476858,Phillip Di Giuseppe,L,VAN,31,44,5,3,8
10,8483570,Ben Meyers,C,SEA,26,33,5,3,8
10,8483012,Logan Morrison,C,SEA,22,32,5,3,8
10,8477851,Jordan Oesterle,D,BOS,32,43,3,5,8
10,8474034,Pat Maroon,L,CHI,36,47,3,5,8
10,8478424,Jansen Harkins,C,ANA,27,43,3,5,8
10,8481609,Vladislav Kolyachonok,D,UTA,23,33,3,5,8
10,8471817,Ryan Reaves,R,TOR,37,69,2,6,8
10,8480070,Ian Mitchell,D,BOS,25,39,2,6,8
10,8477938,Haydn Fleury,D,WPG,28,36,2,6,8
10,8481754,Nikita Nesterenko,C,ANA,23,42,2,6,8
10,8481147,Reese Johnson,C,MIN,26,42,1,7,8
10,8478450,Parker Wotherspoon,D,BOS,27,42,1,7,8
10,8477034,Jaycob Megna,D,FLA,32,48,1,7,8
10,8481701,Santeri Hatakka,D,NJD,23,40,1,7,8
10,8481006,Tyler Tucker,D,STL,24,21,1,7,8
10,8478454,Noah Juulsen,D,VAN,27,41,4,3,7
10,8480032,Shane Bowers,C,NJD,25,19,4,3,7
10,8481550,Adam Beckman,L,NJD,23,37,3,4,7
10,8477401,John Hayden,C,SEA,29,33,3,4,7
10,8477462,Robert Hagg,D,VGK,29,24,3,4,7
10,8480834,Ty Emberson,D,SJS,24,41,2,5,7
10,8482964,Arber Xhekaj,D,MTL,23,48,2,5,7
10,8484911,Collin Graf,R,SJS,22,41,2,5,7
10,8481599,Victor Soderstrom,D,UTA,23,39,2,5,7
10,8477384,Josh Brown,D,EDM,30,47,2,5,7
10,8476913,Devin Shore,C,MIN,30,36,2,5,7
10,8478017,Mark Friedman,D,VAN,29,29,2,5,7
10,8481751,Lukas Rousek,R,BUF,25,38,2,5,7
10,8480001,Urho Vaakanainen,D,ANA,25,58,1,6,7
10,8479249,Andrew Poturalski,C,SJS,30,32,1,6,7
10,8484254,Akito Hirose,D,VAN,25,25,0,7,7
10,8477810,Joel Hanley,D,CGY,33,23,0,7,7
10,8482511,Mason Lohrei,D,BOS,23,31,0,7,7
10,8479543,Michael Pezzetta,L,MTL,26,49,4,2,6
10,8479944,Zach Aston-Reese,C,VGK,30,42,4,2,6
10,8476867,Brendan Gaunce,C,MIN,30,39,4,2,6
10,8481556,John Beecher,C,BOS,23,41,4,2,6
10,8482496,Nils Aman,C,VAN,24,39,3,3,6
10,8479378,Logan Stanley,D,WPG,26,37,3,3,6
10,8484287,Cole McWard,D,VAN,23,31,3,3,6
10,8482172,Landon Slaggert,L,CHI,22,31,3,3,6
10,8483549,Lucas Condotta,L,MTL,27,24,3,3,6
10,8481462,Mason Morelli,L,VGK,28,15,3,3,6
10,8479972,Mason Shaw,C,WPG,26,26,2,4,6
10,8477505,Alexander Wennberg,C,SJS,30,39,2,4,6
10,8478451,Ethan Bear,D,WSH,27,48,2,4,6
10,8479986,Kole Lind,R,DAL,26,44,2,4,6
10,8481167,Brayden Pachal,D,CGY,25,43,2,4,6
10,8482784,Zach Dean,C,STL,21,38,2,4,6
10,8478146,Matthew Highmore,C,OTT,28,36,2,4,6
10,8480844,Grigori Denisenko,L,VGK,24,29,2,4,6
10,8481541,Samuel Bolduc,D,NYI,24,32,2,4,6
10,8482516,Matthew Kessel,D,STL,24,26,2,4,6
10,8480441,Trey Fix-Wolansky,R,CBJ,25,34,1,5,6
10,8475177,Calvin de Haan,D,COL,33,40,1,5,6
10,8480292,Carson Meyer,R,ANA,27,27,1,5,6
10,8481605,Jackson LaCombe,D,ANA,23,41,1,5,6
10,8480879,Jacob Bernard-Docker,D,OTT,24,44,1,5,6
10,8482470,Ilya Solovyov,D,CGY,24,22,0,6,6
10,8479320,Max Lajoie,D,SEA,27,18,0,6,6
10,8477335,Kyle Burroughs,D,LAK,29,50,2,3,5
10,8479291,Kevin Rooney,C,CGY,31,50,2,3,5
10,8482861,Vincent Iorio,D,WSH,22,21,2,3,5
10,8481598,Philip Broberg,D,EDM,23,44,1,4,5
10,8478021,William Lagesson,D,DET,28,24,1,4,5
10,8482094,Daemon Hunt,D,MIN,22,21,1,4,5
10,8481585,Egor Afanasyev,L,SJS,23,19,3,1,4
10,8475958,Michael Sgarbossa,C,WSH,32,25,3,1,4
10,8482147,Jean-Luc Foudy,C,COL,22,25,3,1,4
10,8478051,Max Willman,C,NJD,29,14,3,1,4
10,8479379,Givani Smith,R,SJS,26,34,2,2,4
10,8483512,Matt Savoie,C,EDM,20,15,2,2,4
10,8481543,Nikita Alexandrov,C,STL,24,21,2,2,4
10,8481679,Maxence Guenette,D,OTT,23,30,2,2,4
10,8484325,Waltteri Merela,C,TBL,26,22,2,2,4
10,8475795,Dylan McIlrath,D,WSH,32,21,2,2,4
10,8475762,Derek Forbort,D,VAN,32,47,1,3,4
10,8480468,James Hamblin,L,EDM,25,25,1,3,4
10,8477244,Chad Ruhwedel,D,NYR,34,36,1,3,4
10,8477073,Kurtis MacDermid,L,NJD,30,24,1,3,4
10,8478409,Anthony Richard,C,PHI,28,38,0,4,4
10,8480870,Bo Groulx,C,NYR,24,38,0,4,4
10,8482144,Jack Thompson,D,SJS,22,28,2,1,3
10,8480267,Sammy Walker,C,MIN,25,18,2,1,3
10,8483567,Georgii Merkulov,C,BOS,24,8,2,1,3
10,8482858,Ryker Evans,D,SEA,23,31,1,2,3
10,8479991,Jake Leschyshyn,C,NYR,25,28,1,2,3
10,8483630,Pavol Regenda,L,ANA,25,35,1,2,3
10,8478477,Mitchell Stephens,C,SEA,27,19,1,2,3
10,8484258,Sam Malinski,D,COL,26,24,1,2,3
10,8480890,Jan Jenik,R,OTT,24,23,1,2,3
10,8481422,Jacob Lucchini,C,NSH,29,26,1,2,3
10,8479367,William Lockwood,R,FLA,26,18,1,2,3
10,8483546,Marshall Rifai,D,TOR,26,5,1,2,3
10,8481056,Spencer Stastney,D,NSH,24,29,0,3,3
10,8482713,Mackie Samoskevich,R,FLA,22,34,0,3,3
10,8481719,Maxwell Crozier,D,TBL,24,18,0,3,3
10,8479587,Rhett Gardner,C,PHI,28,12,0,3,3
10,8479330,Brandon Gignac,C,MTL,27,15,0,3,3
10,8482162,Roby Jarventie,L,EDM,22,17,2,0,2
10,8478446,Glenn Gawdin,C,LAK,27,10,2,0,2
10,8480245,Olle Lycksell,R,PHI,25,37,1,1,2
10,8481743,Marc Del Gaizo,D,NSH,25,17,1,1,2
10,8481237,Kyle MacLean,C,NYI,25,18,1,1,2
10,8482201,Gage Goncalves,C,TBL,23,19,1,1,2
10,8481065,Angus Crookshank,L,OTT,25,14,1,1,2
10,8477527,Ross Johnston,L,ANA,30,36,1,1,2
10,8481699,Aku Raty,R,UTA,23,17,1,1,2
10,8484304,Uvis Balinskis,D,FLA,28,7,1,1,2
10,8481578,Graeme Clarke,R,MIN,23,10,1,1,2
10,8482102,Vasily Ponomarev,C,PIT,22,26,1,1,2
10,8483398,Declan Carlile,D,TBL,31,14,1,1,2
10,8483763,Maksymilian Szuber,D,UTA,22,35,0,2,2
10,8479421,Jacob Moverare,D,LAK,26,13,0,2,2
10,8478502,Dennis Gilbert,D,BUF,28,15,0,2,2
10,8479576,Vincent Desharnais,D,VAN,28,34,0,2,2
10,8479985,Cale Fleury,D,SEA,26,17,0,2,2
10,8478011,Louie Belpedio,D,PHI,28,12,0,2,2
10,8482165,Yan Kuznetsov,D,CGY,22,18,0,2,2
10,8478881,Brett Seney,L,CHI,28,10,0,2,2
10,8479419,Brett Murray,L,BUF,26,18,0,2,2
10,8481030,Jack St. Ivany,D,PIT,25,20,0,2,2
10,8482929,Emil Lilleberg,D,TBL,23,22,0,2,2
10,8475413,Justin Dowling,C,NJD,34,17,0,2,2
10,8477149,Scott Sabourin,R,SJS,32,18,0,2,2
10,8483395,Arshdeep Bains,L,VAN,23,14,0,2,2
10,8482250,Callahan Burke,C,VGK,27,18,0,2,2
10,8474062,Riley Nash,C,NYR,35,18,0,2,2
10,8481564,Ryan Johnson,D,BUF,23,24,0,2,2
10,8477541,Dakota Mermis,D,TOR,30,11,0,2,2
10,8483471,Brad Lambert,C,WPG,31,12,1,0,1
10,8477467,Gustav Olofsson,D,SEA,30,20,1,0,1
10,8477971,Andreas Englund,D,LAK,28,31,1,0,1
10,8482476,Emil Heineman,L,MTL,23,9,1,0,1
10,8482118,Sam Colangelo,R,ANA,23,18,1,0,1
10,8483597,Milos Kelemen,L,UTA,25,9,1,0,1
10,8483489,Fraser Minten,C,TOR,31,15,1,0,1
10,8483609,Adam Klapka,R,CGY,24,1,1,0,1
10,8481806,Louis Crevier,D,CHI,23,9,1,0,1
10,8476441,Joel Edmundson,D,LAK,31,25,0,1,1
10,8480084,Nick DeSimone,D,NJD,30,17,0,1,1
10,8481593,Jayden Struble,D,MTL,23,16,0,1,1
10,8482061,Brandon Biro,L,SEA,26,14,0,1,1
10,8477320,Anton Blidh,L,NYR,29,22,0,1,1
10,8480823,Alexander Alexeyev,D,WSH,25,12,0,1,1
10,8480851,Akil Thomas,C,LAK,24,16,0,1,1
10,8479362,Riley Tufte,L,BOS,26,25,0,1,1
10,8483407,Brandon Scanlin,D,NYR,25,6,0,1,1
10,8475780,Chris Wagner,R,COL,33,9,0,1,1
10,8482088,Justin Sourdif,R,FLA,22,21,0,1,1
10,8481043,Cole Koepke,L,BOS,26,9,0,1,1
10,8482460,Matt Rempe,C,NYR,22,12,0,1,1
10,8483401,Marc Johnstone,R,PIT,28,1,0,1,1
10,8480306,Grant Hutton,D,NYI,29,8,0,1,1
10,8480874,Adam Ginning,D,PHI,24,8,0,1,1
10,8478147,Bokondji Imama,L,PIT,28,6,0,1,1
10,8477993,Justin Kirkland,C,CGY,28,6,0,0,0
10,8482787,Nikita Chibrikov,R,WPG,31,5,0,0,0
10,8480075,Cameron Crotty,D,MIN,25,6,0,0,0
10,8475755,Alexander Petrovic,D,DAL,32,12,0,0,0
10,8481726,Adam Edstrom,C,NYR,24,4,0,0,0
10,8483432,Luca Del Bel Belluz,C,CBJ,31,2,0,0,0
10,8481655,Cole Schwindt,R,CGY,23,6,0,0,0
10,8481206,John Ludvig,D,PIT,24,9,0,0,0
10,8481024,Linus Karlsson,C,VAN,25,6,0,0,0
10,8483920,Pierrick Dube,R,WSH,23,3,0,0,0
10,8479522,Hardy Haman Aktell,D,WSH,26,2,0,0,0
10,8483531,Brian Halonen,L,NJD,25,2,0,0,0
10,8484255,Jason Polin,R,COL,25,6,0,0,0
10,8484326,Patrik Koch,D,UTA,28,0,0,0,0
10,8482126,Emil Andrae,D,PHI,31,4,0,0,0
10,8482197,Adam Raska,R,MIN,23,3,0,0,0
10,8481534,Raphael Lavoie,C,EDM,24,1,0,0,0
10,8484259,Ondrej Pavel,C,COL,31,2,0,0,0
10,8478854,Ryan Shea,D,PIT,27,5,0,0,0
10,8476323,Max McCormick,L,SEA,32,1,0,0,0
10,8479321,Lucas Johansen,D,,27,0,0,0,0
10,8470794,Joe Pavelski,C,,40,0,0,0,0
10,8477950,Tony DeAngelo,D,,29,0,0,0,0
10,8471218,Blake Wheeler,R,,38,0,0,0,0
10,8475197,Tyson Barrie,D,,33,0,0,0,0
10,8475744,Evgeny Kuznetsov,C,,32,0,0,0,0
10,8474037,James van Riemsdyk,L,,35,0,0,0,0
10,8474602,Justin Schultz,D,,34,0,0,0,0
10,8482222,Alexander Barabanov,L,,30,0,0,0,0
10,8474157,Max Pacioretty,L,,36,0,0,0,0
10,8474031,Kevin Shattenkirk,D,,35,0,0,0,0
10,8480884,Calen Addison,D,,24,0,0,0,0
10,8480008,Adam Ruzicka,C,,25,0,0,0,0
10,8475906,John Klingberg,D,,32,0,0,0,0
10,8476884,Derrick Pouliot,D,,30,0,0,0,0
10,8476919,Chris Tierney,C,,30,0,0,0,0
10,8479415,Michael McLeod,C,,26,0,0,0,0
10,8474884,Mike Hoffman,C,,35,0,0,0,0
10,8478104,Sammy Blais,L,,28,0,0,0,0
10,8474870,Tyler Johnson,C,,34,0,0,0,0
10,8481591,Sam Poulin,R,,23,0,0,0,0
10,8479977,Kailer Yamamoto,R,,26,0,0,0,0
10,8476393,Nick Cousins,C,,31,0,0,0,0
10,8479376,Victor Mete,D,,26,0,0,0,0
10,8476871,Tanner Pearson,L,,32,0,0,0,0
10,8471274,Alex Goligoski,D,,39,0,0,0,0
10,8481058,Jesse Ylönen,R,,25,0,0,0,0
10,8477464,Nic Petan,C,,29,0,0,0,0
10,8473449,Kyle Okposo,R,,36,0,0,0,0
10,8480216,Jacob Peterson,C,,25,0,0,0,0
10,8479346,Dillon Dube,C,,26,0,0,0,0
10,8470966,Mark Giordano,D,,41,0,0,0,0
10,8480821,Filip Zadina,R,,25,0,0,0,0
10,8476907,Mackenzie MacEachern,L,,30,0,0,0,0
10,8478430,Oliver Kylington,D,,27,0,0,0,0
10,8479514,Rem Pitlick,C,,27,0,0,0,0
10,8478099,Kevin Labanc,R,,29,0,0,0,0
10,8482241,Radim Zohorna,L,,28,0,0,0,0
10,8474040,Sam Gagner,C,,35,0,0,0,0
10,8475164,Jakob Silfverberg,R,,34,0,0,0,0
10,8475752,Tyler Pitlick,C,,33,0,0,0,0
10,8479984,Cal Foote,D,,26,0,0,0,0
10,8478495,Denis Gurianov,R,,27,0,0,0,0
10,8479533,Joona Koppanen,L,,26,0,0,0,0
10,8479458,Nikita Zaitsev,D,,33,0,0,0,0
10,8471699,Andrew Cogliano,C,,37,0,0,0,0
10,8470604,Jeff Carter,C,,39,0,0,0,0
10,8477330,Dominik Kubalik,L,,29,0,0,0,0
10,8477944,Jakub Vrana,L,,28,0,0,0,0
10,8478904,Steven Lorentz,C,,28,0,0,0,0
10,8471686,Marc Staal,D,,37,0,0,0,0
10,8478512,Austin Czarnik,C,,32,0,0,0,0
10,8470610,Zach Parise,L,,40,0,0,0,0
10,8473504,Cal Clutterbuck,R,,37,0,0,0,0
10,8474009,Nick Bonino,C,,36,0,0,0,0
10,8477454,Adam Erne,L,,29,0,0,0,0
10,8477126,Jayson Megna,C,,34,0,0,0,0
10,8473473,Milan Lucic,L,,36,0,0,0,0
10,8478067,Oskar Lindblom,L,,28,0,0,0,0
10,8475825,Jani Hakanpää,D,,32,0,0,0,0
10,8479383,Boris Katchouk,L,,26,0,0,0,0
10,8478400,Colin White,C,,27,0,0,0,0
10,8477846,Ryan Carpenter,C,,33,0,0,0,0
10,8477930,Pierre-Edouard Bellemare,L,,39,0,0,0,0
10,8479423,Alex Nylander,L,,26,0,0,0,0
10,8475797,Jarred Tinordi,D,,32,0,0,0,0
10,8481239,Samuel Fagemo,L,,24,0,0,0,0
10,8474618,Marco Scandella,D,,34,0,0,0,0
10,8480853,Liam Foudy,C,,24,0,0,0,0
10,8478028,Fredrik Olofsson,L,,28,0,0,0,0
10,8474145,Robert Bortuzzo,D,,35,0,0,0,0
10,8474709,Matt Martin,L,,35,0,0,0,0
10,8480226,Marián Studenic,R,,26,0,0,0,0
10,8480274,Philip Kemp,D,EDM,25,2,0,0,0
10,8480184,Gustav Lindstrom,D,,26,0,0,0,0
10,8481077,John Leonard,L,,26,0,0,0,0
10,8479547,Matthew Phillips,R,,26,0,0,0,0
10,8476915,Jujhar Khaira,L,,30,0,0,0,0
10,8481070,Hugh McGing,L,,26,0,0,0,0
10,8478408,Travis Dermott,D,,28,0,0,0,0
10,8481812,Nikolai Knyzhov,D,,27,0,0,0,0
10,8484321,Nikolas Matinpalo,D,OTT,26,3,0,0,0
10,8475278,Byron Froese,C,,33,0,0,0,0
10,8475766,Austin Watson,L,,32,0,0,0,0
10,8479546,Oskar Steen,C,,26,0,0,0,0
10,8480836,Jonathan Gruden,C,,24,0,0,0,0
10,8481690,Tyler Angle,C,,24,0,0,0,0
10,8480031,Maxime Comtois,L,,25,0,0,0,0
10,8483045,Cameron Butler,R,CBJ,31,0,0,0,0
10,8478078,Rourke Chartier,C,,28,0,0,0,0
10,8481016,Ruslan Iskhakov,C,,24,0,0,0,0
10,8484314,Jiri Smejkal,L,,28,0,0,0,0
10,8478956,Samuel Laberge,L,NJD,27,1,0,0,0
10,8480776,Sheldon Rempal,R,,29,0,0,0,0
