Simulation,PlayerID,Player,Position,Team,Age,Games Played,Goals,Assists,Points
1,8476453.0,Nikita Kucherov,R,TBL,30,81,44,100,144
1,8477492.0,Nathan MacKinnon,C,COL,28,82,51,89,140
1,8478402.0,Connor McDavid,C,EDM,26,76,32,100,132
1,8478550.0,Artemi Panarin,L,NYR,32,82,49,71,120
1,8477956.0,David Pastrnak,R,BOS,27,82,47,63,110
1,8479318.0,Auston Matthews,C,TOR,26,81,69,38,107
1,8477934.0,Leon Draisaitl,C,EDM,28,81,41,65,106
1,8478420.0,Mikko Rantanen,R,COL,27,80,42,62,104
1,8476468.0,J.T. Miller,C,VAN,30,81,37,66,103
1,8477939.0,William Nylander,R,TOR,27,82,40,58,98
1,8478864.0,Kirill Kaprizov,L,MIN,26,75,46,50,96
1,8477933.0,Sam Reinhart,C,FLA,28,82,57,37,94
1,8476887.0,Filip Forsberg,L,NSH,29,82,48,46,94
1,8471675.0,Sidney Crosby,C,PIT,36,82,42,52,94
1,8480800.0,Quinn Hughes,D,VAN,24,82,17,75,92
1,8478010.0,Brayden Point,C,TBL,27,81,46,44,90
1,8480069.0,Cale Makar,D,COL,25,77,21,69,90
1,8478427.0,Sebastian Aho,C,CAR,26,78,36,53,89
1,8480012.0,Elias Pettersson,C,VAN,25,82,34,55,89
1,8479314.0,Matthew Tkachuk,L,FLA,26,80,26,62,88
1,8480023.0,Robert Thomas,C,STL,24,82,26,60,86
1,8474600.0,Roman Josi,D,NSH,33,82,23,62,85
1,8479407.0,Jesper Bratt,L,NJD,25,82,27,56,83
1,8480803.0,Evan Bouchard,D,EDM,24,81,18,64,82
1,8474564.0,Steven Stamkos,C,TBL,33,79,40,41,81
1,8480027.0,Jason Robertson,L,DAL,24,82,29,51,80
1,8478445.0,Mathew Barzal,C,NYI,26,80,23,57,80
1,8477493.0,Aleksander Barkov,C,FLA,28,73,23,57,80
1,8475786.0,Zach Hyman,L,EDM,31,80,54,23,77
1,8480018.0,Nick Suzuki,C,MTL,24,82,33,44,77
1,8477404.0,Jake Guentzel,L,PIT,29,67,30,47,77
1,8476389.0,Vincent Trocheck,C,NYR,30,82,25,52,77
1,8479343.0,Clayton Keller,R,ARI,25,78,33,43,76
1,8475167.0,Victor Hedman,D,TBL,33,78,13,63,76
1,8475184.0,Chris Kreider,L,NYR,32,82,39,36,75
1,8475172.0,Nazem Kadri,C,CGY,33,82,29,46,75
1,8477960.0,Adrian Kempe,R,LAK,27,77,28,47,75
1,8479542.0,Brandon Hagel,L,TBL,25,82,26,49,75
1,8474679.0,Gustav Nyquist,C,NSH,34,81,23,52,75
1,8480801.0,Brady Tkachuk,L,OTT,24,81,37,37,74
1,8481559.0,Jack Hughes,C,NJD,22,62,27,47,74
1,8478444.0,Brock Boeser,R,VAN,26,81,40,33,73
1,8477942.0,Kevin Fiala,L,LAK,27,82,29,44,73
1,8479323.0,Adam Fox,D,NYR,25,72,17,56,73
1,8477409.0,Carter Verhaeghe,C,FLA,28,76,34,38,72
1,8482078.0,Lucas Raymond,L,DET,21,82,31,41,72
1,8476459.0,Mika Zibanejad,C,NYR,30,81,26,46,72
1,8476460.0,Mark Scheifele,C,WPG,30,74,25,47,72
1,8471685.0,Anze Kopitar,C,LAK,36,81,26,44,70
1,8482116.0,Tim Stützle,C,OTT,21,75,18,52,70
1,8480865.0,Noah Dobson,D,NYI,23,79,10,60,70
1,8476539.0,Jonathan Marchessault,R,VGK,33,82,42,27,69
1,8475754.0,Brock Nelson,C,NYI,32,82,34,35,69
1,8477946.0,Dylan Larkin,C,DET,27,68,33,36,69
1,8475158.0,Ryan O'Reilly,C,NSH,32,82,26,43,69
1,8477504.0,Josh Morrissey,D,WPG,28,81,10,59,69
1,8478439.0,Travis Konecny,R,PHI,26,76,33,35,68
1,8477500.0,Bo Horvat,C,NYI,28,81,33,35,68
1,8478403.0,Jack Eichel,C,VGK,27,63,31,37,68
1,8481557.0,Matt Boldy,L,MIN,22,75,29,39,68
1,8482093.0,Seth Jarvis,C,CAR,21,81,33,34,67
1,8479385.0,Jordan Kyrou,C,STL,25,82,31,36,67
1,8473419.0,Brad Marchand,L,BOS,35,82,29,38,67
1,8480002.0,Nico Hischier,C,NJD,24,71,27,40,67
1,8471215.0,Evgeni Malkin,C,PIT,37,82,27,40,67
1,8478440.0,Dylan Strome,C,WSH,26,82,27,40,67
1,8479337.0,Alex DeBrincat,R,DET,26,82,27,40,67
1,8470794.0,Joe Pavelski,C,DAL,39,82,27,40,67
1,8476454.0,Ryan Nugent-Hopkins,C,EDM,30,80,18,49,67
1,8480208.0,Drake Batherson,R,OTT,25,82,28,38,66
1,8482740.0,Wyatt Johnston,C,DAL,20,82,32,33,65
1,8471214.0,Alex Ovechkin,L,WSH,38,79,31,34,65
1,8478449.0,Roope Hintz,C,DAL,27,80,30,35,65
1,8475166.0,John Tavares,C,TOR,33,80,29,36,65
1,8481540.0,Cole Caufield,R,MTL,22,82,28,37,65
1,8475168.0,Matt Duchene,C,DAL,32,80,25,40,65
1,8478493.0,Joel Eriksson Ek,C,MIN,26,77,30,34,64
1,8473512.0,Claude Giroux,R,OTT,35,82,21,43,64
1,8477402.0,Pavel Buchnevich,L,STL,28,80,27,36,63
1,8475692.0,Mats Zuccarello,R,MIN,36,69,12,51,63
1,8477955.0,Jared McCann,L,SEA,27,80,29,33,62
1,8476875.0,Mike Matheson,D,MTL,29,82,11,51,62
1,8478398.0,Kyle Connor,L,WPG,27,65,34,27,61
1,8477940.0,Nikolaj Ehlers,L,WPG,27,82,25,36,61
1,8477951.0,Nick Schmaltz,C,ARI,27,79,22,39,61
1,8478366.0,Frank Vatrano,R,ANA,29,82,37,23,60
1,8476448.0,William Karlsson,C,VGK,30,70,30,30,60
1,8475745.0,Charlie Coyle,C,BOS,31,82,25,35,60
1,8473994.0,Jamie Benn,L,DAL,34,82,21,39,60
1,8475798.0,Mikael Granlund,C,SJS,31,69,12,48,60
1,8476346.0,Johnny Gaudreau,L,CBJ,30,81,12,48,60
1,8481068.0,Yegor Sharangovich,C,CGY,25,82,31,28,59
1,8477497.0,Sean Monahan,C,WPG,29,83,26,33,59
1,8477949.0,Alex Tuch,R,BUF,27,75,22,37,59
1,8478401.0,Pavel Zacha,C,BOS,26,78,21,38,59
1,8480839.0,Rasmus Dahlin,D,BUF,23,81,20,39,59
1,8477416.0,Oliver Bjorkstrand,R,SEA,28,82,20,39,59
1,8476853.0,Morgan Rielly,D,TOR,29,72,7,51,58
1,8479675.0,Trevor Moore,L,LAK,28,82,31,26,57
1,8482109.0,Alexis Lafrenière,L,NYR,22,82,28,29,57
1,8479999.0,Casey Mittelstadt,C,BUF,25,80,18,39,57
1,8481711.0,Matias Maccelli,L,ARI,23,82,17,40,57
1,8478460.0,Zach Werenski,D,CBJ,26,70,11,46,57
1,8479420.0,Tage Thompson,C,BUF,26,71,29,27,56
1,8475810.0,Bryan Rust,R,PIT,31,62,28,28,56
1,8477494.0,Jonathan Drouin,L,COL,28,79,19,37,56
1,8474578.0,Erik Karlsson,D,PIT,33,82,11,45,56
1,8476906.0,Shayne Gostisbehere,D,DET,30,81,10,46,56
1,8475726.0,Tyler Toffoli,R,NJD,31,79,33,22,55
1,8475765.0,Vladimir Tarasenko,R,OTT,32,76,23,32,55
1,8482124.0,Quinton Byfield,R,LAK,21,80,20,35,55
1,8478047.0,Michael Bunting,L,CAR,28,81,19,36,55
1,8475151.0,Kyle Palmieri,C,NYI,32,82,30,24,54
1,8476399.0,Blake Coleman,C,CGY,32,78,30,24,54
1,8478873.0,Troy Terry,R,ANA,26,76,20,34,54
1,8480798.0,Philipp Kurashev,C,CHI,24,75,18,36,54
1,8480036.0,Miro Heiskanen,D,DAL,24,71,9,45,54
1,8477501.0,Valeri Nichushkin,R,COL,28,54,28,25,53
1,8480015.0,Owen Tippett,R,PHI,24,78,28,25,53
1,8476882.0,Teuvo Teravainen,L,CAR,29,76,25,28,53
1,8480039.0,Martin Necas,C,CAR,24,77,24,29,53
1,8478975.0,Mason Marchment,L,DAL,28,81,22,31,53
1,8475913.0,Mark Stone,R,VGK,31,56,16,37,53
1,8478414.0,Timo Meier,R,NJD,27,69,28,24,52
1,8475794.0,Tyler Seguin,C,DAL,31,68,25,27,52
1,8477346.0,MacKenzie Weegar,D,CGY,29,82,20,32,52
1,8480830.0,Andrei Svechnikov,R,CAR,23,59,19,33,52
1,8476456.0,Jonathan Huberdeau,C,CGY,30,81,12,40,52
1,8474590.0,John Carlson,D,WSH,33,82,10,42,52
1,8474641.0,Adam Henrique,C,ANA,33,82,24,27,51
1,8476905.0,Chandler Stephenson,C,VGK,29,75,16,35,51
1,8471724.0,Kris Letang,D,PIT,36,82,10,41,51
1,8482175.0,JJ Peterka,R,BUF,21,82,28,22,50
1,8480797.0,Joel Farabee,L,PHI,23,82,22,28,50
1,8483515.0,Juraj Slafkovsky,L,MTL,19,82,20,30,50
1,8474563.0,Drew Doughty,D,LAK,34,82,15,35,50
1,8478038.0,Devon Toews,D,COL,29,82,12,38,50
1,8477456.0,J.T. Compher,L,DET,28,77,19,29,48
1,8479425.0,Filip Hronek,D,VAN,26,81,5,43,48
1,8474141.0,Patrick Kane,R,DET,35,50,20,27,47
1,8478856.0,Conor Garland,R,VAN,27,82,20,27,47
1,8481528.0,Dylan Cozens,C,BUF,22,79,18,29,47
1,8476479.0,Phillip Danault,C,LAK,30,78,17,30,47
1,8474102.0,David Perron,L,DET,35,76,17,30,47
1,8481581.0,Thomas Harley,D,DAL,22,79,15,32,47
1,8478396.0,Noah Hanifin,D,CGY,26,80,13,34,47
1,8476869.0,Brady Skjei,D,CAR,29,80,13,34,47
1,8479325.0,Charlie McAvoy,D,BOS,26,74,12,35,47
1,8482684.0,Luke Hughes,D,NJD,20,82,9,38,47
1,8477503.0,Max Domi,C,TOR,28,80,9,38,47
1,8482122.0,Brock Faber,D,MIN,21,82,8,39,47
1,8477426.0,Nicholas Paul,L,TBL,28,82,24,22,46
1,8475784.0,Jeff Skinner,L,BUF,31,74,24,22,46
1,8483808.0,Andrei Kuzmenko,L,CGY,27,72,22,24,46
1,8475170.0,Brayden Schenn,C,STL,32,82,20,26,46
1,8478407.0,Vince Dunn,D,SEA,27,59,11,35,46
1,8475760.0,Nick Bjugstad,C,ARI,31,76,22,23,45
1,8477451.0,Ryan Hartman,R,MIN,29,74,21,24,45
1,8478519.0,Anthony Cirelli,C,TBL,26,79,20,25,45
1,8477964.0,Ivan Barbashev,C,VGK,28,82,19,26,45
1,8478438.0,Tommy Novak,C,NSH,26,71,18,27,45
1,8482667.0,William Eklund,L,SJS,21,80,16,29,45
1,8477021.0,Alex Kerfoot,C,ARI,29,82,13,32,45
1,8475218.0,Mattias Ekholm,D,EDM,33,79,11,34,45
1,8480188.0,Fabian Zetterlund,L,SJS,24,82,24,20,44
1,8475169.0,Evander Kane,L,EDM,32,77,24,20,44
1,8477511.0,Anthony Mantha,R,WSH,29,74,23,21,44
1,8474586.0,Jordan Eberle,R,SEA,33,78,17,27,44
1,8477496.0,Elias Lindholm,C,VAN,29,75,15,29,44
1,8477948.0,Travis Sanheim,D,PHI,27,81,10,34,44
1,8477479.0,Tyler Bertuzzi,L,TOR,28,80,21,22,43
1,8478466.0,Daniel Sprong,R,DET,26,76,18,25,43
1,8470613.0,Brent Burns,D,CAR,38,82,10,33,43
1,8476438.0,Brandon Saad,L,STL,31,82,26,16,42
1,8477407.0,Anthony Duclair,L,SJS,28,73,24,18,42
1,8478474.0,Lawson Crouse,L,ARI,26,81,23,19,42
1,8480893.0,Kirill Marchenko,R,CBJ,23,78,23,19,42
1,8482745.0,Mason McTavish,C,ANA,20,64,19,23,42
1,8481542.0,Moritz Seider,D,DET,22,82,9,33,42
1,8477447.0,Shea Theodore,D,VGK,28,47,5,37,42
1,8477935.0,Sam Bennett,C,FLA,27,69,20,21,41
1,8477998.0,Warren Foegele,L,EDM,27,82,20,21,41
1,8480009.0,Eeli Tolvanen,R,SEA,24,81,16,25,41
1,8479345.0,Jakob Chychrun,D,OTT,25,82,14,27,41
1,8480028.0,Morgan Frost,C,PHI,24,71,13,28,41
1,8478462.0,Nicolas Roy,C,VGK,26,70,13,28,41
1,8476458.0,Ryan Strome,C,ANA,30,79,11,30,41
1,8480434.0,Sean Durzi,D,ARI,25,76,9,32,41
1,8482079.0,Marco Rossi,C,MIN,22,82,21,19,40
1,8478498.0,Jake DeBrusk,L,BOS,27,80,19,21,40
1,8479365.0,Trent Frederic,C,BOS,25,82,18,22,40
1,8479525.0,Ross Colton,C,COL,27,80,17,23,40
1,8479400.0,Pierre-Luc Dubois,C,LAK,25,82,16,24,40
1,8478233.0,Andrew Mangiapane,L,CGY,27,75,14,26,40
1,8475191.0,Reilly Smith,R,PIT,32,76,13,27,40
1,8479987.0,Morgan Geekie,C,BOS,25,76,17,22,39
1,8482146.0,Luke Evangelista,R,NSH,21,80,16,23,39
1,8474150.0,Mikael Backlund,C,CGY,34,82,15,24,39
1,8476872.0,Scott Laughton,C,PHI,29,82,13,26,39
1,8478542.0,Evan Rodrigues,C,FLA,30,80,12,27,39
1,8478055.0,Gustav Forsling,D,FLA,27,79,10,29,39
1,8478397.0,Rasmus Andersson,D,CGY,27,78,9,30,39
1,8475764.0,Cam Fowler,D,ANA,32,81,5,34,39
1,8476792.0,Torey Krug,D,STL,32,77,4,35,39
1,8482089.0,Jake Neighbours,L,STL,21,77,27,11,38
1,8482149.0,Cole Perfetti,C,WPG,21,71,19,19,38
1,8476881.0,Tomas Hertl,C,SJS,30,54,17,21,38
1,8474037.0,James van Riemsdyk,L,BOS,34,71,11,27,38
1,8482105.0,Jake Sanderson,D,OTT,21,79,10,28,38
1,8475314.0,Anders Lee,L,NYI,33,81,20,17,37
1,8473422.0,Nick Foligno,L,CHI,36,74,17,20,37
1,8482665.0,Matty Beniers,C,SEA,21,77,15,22,37
1,8476483.0,Rickard Rakell,R,PIT,30,70,15,22,37
1,8476474.0,Stefan Noesen,R,CAR,30,81,14,23,37
1,8476480.0,Vladislav Namestnikov,C,WPG,31,78,11,26,37
1,8476958.0,Jaccob Slavin,D,CAR,29,81,6,31,37
1,8481535.0,Nils Hoglander,L,VAN,23,80,24,12,36
1,8480014.0,Gabriel Vilardi,C,WPG,24,47,22,14,36
1,8473986.0,Alex Killorn,L,ANA,34,63,18,18,36
1,8478046.0,Danton Heinen,L,BOS,28,74,17,19,36
1,8478891.0,Mason Appleton,C,WPG,27,82,14,22,36
1,8476432.0,Boone Jenner,C,CBJ,30,58,22,13,35
1,8477450.0,Jason Dickinson,C,CHI,28,82,22,13,35
1,8476880.0,Tom Wilson,R,WSH,29,74,18,17,35
1,8482699.0,Dylan Guenther,R,ARI,20,45,18,17,35
1,8475287.0,Erik Haula,L,NJD,32,76,16,19,35
1,8476925.0,Colton Sissons,C,NSH,30,81,15,20,35
1,8482720.0,Matthew Knies,L,TOR,21,80,15,20,35
1,8482113.0,Anton Lundell,C,FLA,22,78,13,22,35
1,8476392.0,Adam Lowry,C,WPG,30,81,12,23,35
1,8478472.0,Mathieu Joseph,R,OTT,26,72,11,24,35
1,8475799.0,Nino Niederreiter,R,WPG,31,77,18,16,34
1,8477476.0,Artturi Lehkonen,L,COL,28,45,16,18,34
1,8481618.0,Alex Newhook,C,MTL,22,55,15,19,34
1,8482159.0,Tyson Foerster,R,PHI,21,77,20,13,33
1,8482110.0,Dawson Mercer,C,NJD,22,82,20,13,33
1,8481580.0,Connor McMichael,C,WSH,22,80,18,15,33
1,8482055.0,Drew O'Connor,L,PIT,25,79,16,17,33
1,8477429.0,Andrew Copp,C,DET,29,79,13,20,33
1,8479992.0,Michael Rasmussen,C,DET,24,75,13,20,33
1,8476826.0,Yanni Gourde,C,SEA,32,80,11,22,33
1,8476419.0,Jean-Gabriel Pageau,C,NYI,31,82,11,22,33
1,8477986.0,Brandon Montour,D,FLA,29,66,8,25,33
1,8482671.0,Owen Power,D,BUF,21,76,6,27,33
1,8478178.0,Darren Raddysh,D,TBL,27,82,6,27,33
1,8480145.0,Neal Pionk,D,WPG,28,82,5,28,33
1,8474565.0,Alex Pietrangelo,D,VGK,33,64,4,29,33
1,8478057.0,Dakota Joshua,C,VAN,27,63,18,14,32
1,8477952.0,Robby Fabbri,C,DET,27,68,18,14,32
1,8476921.0,Jordan Martinook,L,CAR,31,82,14,18,32
1,8475722.0,Jason Zucker,L,ARI,31,69,14,18,32
1,8482705.0,Cole Sillinger,C,CBJ,20,77,13,19,32
1,8477498.0,Darnell Nurse,D,EDM,28,81,10,22,32
1,8475171.0,Oliver Ekman-Larsson,D,FLA,32,80,9,23,32
1,8478500.0,Ivan Provorov,D,CBJ,26,82,5,27,32
1,8474151.0,Ryan McDonagh,D,NSH,34,74,3,29,32
1,8474870.0,Tyler Johnson,C,CHI,33,67,17,14,31
1,8475848.0,Brendan Gallagher,R,MTL,31,77,16,15,31
1,8474189.0,Lars Eller,C,PIT,34,82,15,16,31
1,8476292.0,Ondrej Palat,L,NJD,32,71,11,20,31
1,8481624.0,Ilya Mikheyev,R,VAN,29,78,11,20,31
1,8478458.0,Jack Roslovic,C,CBJ,26,59,9,22,31
1,8477495.0,Seth Jones,D,CHI,29,67,8,23,31
1,8476979.0,Erik Gustafsson,D,NYR,31,76,6,25,31
1,8476331.0,Dylan DeMelo,D,WPG,30,82,3,28,31
1,8480064.0,Josh Norris,C,OTT,24,50,16,14,30
1,8475768.0,Jaden Schwartz,C,SEA,31,62,13,17,30
1,8480802.0,Ryan McLeod,C,EDM,24,81,12,18,30
1,8477987.0,Ryan Donato,C,CHI,27,78,12,18,30
1,8475149.0,Marcus Johansson,L,MIN,33,78,11,19,30
1,8481546.0,Cam York,D,PHI,22,82,10,20,30
1,8477505.0,Alex Wennberg,C,SEA,29,79,10,20,30
1,8473533.0,Jordan Staal,C,CAR,35,80,10,20,30
1,8478469.0,Thomas Chabot,D,OTT,26,51,9,21,30
1,8480817.0,K'Andre Miller,D,NYR,23,80,8,22,30
1,8477969.0,Marcus Pettersson,D,PIT,27,82,4,26,30
1,8475753.0,Justin Faulk,D,STL,31,60,2,28,30
1,8479619.0,Michael Carcone,L,ARI,27,74,21,8,29
1,8482475.0,Yegor Chinakhov,R,CBJ,22,53,16,13,29
1,8480459.0,Pius Suter,C,VAN,27,67,14,15,29
1,8475763.0,Kevin Hayes,R,STL,31,79,13,16,29
1,8481524.0,Bowen  Byram,D,COL,22,73,11,18,29
1,8480336.0,Sean Walker,D,PHI,29,81,10,19,29
1,8481656.0,Aliaksei Protas,C,WSH,22,78,6,23,29
1,8474574.0,Tyler Myers,D,VAN,33,77,5,24,29
1,8482125.0,Alexander Holtz,R,NJD,21,82,16,12,28
1,8480813.0,Joe Veleno,C,DET,23,80,12,16,28
1,8480068.0,Ryan Poehling,C,PHI,24,77,11,17,28
1,8478413.0,Jordan Greenway,L,BUF,26,67,10,18,28
1,8478115.0,Pierre Engvall,L,NYI,27,74,10,18,28
1,8476923.0,Damon Severson,D,CBJ,29,67,9,19,28
1,8476931.0,Jake McCabe,D,TOR,30,73,8,20,28
1,8478133.0,Jake Evans,C,MTL,27,82,7,21,28
1,8476927.0,Teddy Blueger,C,VAN,29,68,6,22,28
1,8475181.0,Nick Leddy,D,STL,32,82,3,25,28
1,8478020.0,Michael Amadio,R,VGK,27,73,14,13,27
1,8481582.0,Nicholas Robertson,L,TOR,22,56,14,13,27
1,8480185.0,Eetu Luostarinen,C,FLA,25,82,12,15,27
1,8480829.0,Jesperi Kotkaniemi,C,CAR,23,79,12,15,27
1,8480113.0,Alex Iafallo,L,WPG,30,82,11,16,27
1,8480748.0,Kiefer Sherwood,L,NSH,28,68,10,17,27
1,8481596.0,Shane Pinto,C,OTT,23,41,9,18,27
1,8480835.0,Jack Drury,C,CAR,23,74,8,19,27
1,8476463.0,Jonas Brodin,D,MIN,30,62,7,20,27
1,8482092.0,Ridly Greig,C,OTT,21,72,13,13,26
1,8476918.0,Jimmy Vesey,L,NYR,30,80,13,13,26
1,8476892.0,Colton Parayko,D,STL,30,82,10,16,26
1,8479941.0,Justin Danforth,R,CBJ,30,71,10,16,26
1,8477425.0,Miles Wood,L,COL,28,74,9,17,26
1,8480855.0,Jack McBain,C,ARI,23,67,8,18,26
1,8474602.0,Justin Schultz,D,SEA,33,70,7,19,26
1,8475790.0,Erik Gudbranson,D,CBJ,31,78,6,20,26
1,8475200.0,Dmitry Orlov,D,CAR,32,82,6,20,26
1,8482655.0,J.J. Moser,D,ARI,23,80,5,21,26
1,8476902.0,Esa Lindell,D,DAL,29,82,5,21,26
1,8475188.0,Brayden McNabb,D,VGK,32,82,4,22,26
1,8476854.0,Hampus Lindholm,D,BOS,29,73,3,23,26
1,8474673.0,TJ Brodie,D,TOR,33,78,1,25,26
1,8476469.0,Joel Armia,R,MTL,30,66,17,8,25
1,8481601.0,Simon Holmstrom,R,NYI,22,75,15,10,25
1,8481186.0,Logan O'Connor,R,COL,27,57,13,12,25
1,8471698.0,T.J. Oshie,R,WSH,37,52,12,13,25
1,8479591.0,Michael Eyssimont,C,TBL,27,81,11,14,25
1,8476312.0,Josh Manson,D,COL,32,76,8,17,25
1,8478136.0,Jake Middleton,D,MIN,27,80,7,18,25
1,8481032.0,Paul Cotter,C,VGK,24,76,7,18,25
1,8477508.0,Curtis Lazar,C,NJD,28,71,7,18,25
1,8482245.0,Artem Zub,D,OTT,28,69,5,20,25
1,8478911.0,Matt Roy,D,LAK,28,81,5,20,25
1,8476879.0,Cody Ceci,D,EDM,30,79,5,20,25
1,8478507.0,John Marino,D,NJD,26,75,4,21,25
1,8478840.0,Will Borgen,D,SEA,27,82,3,22,25
1,8482259.0,Bobby McMann,C,TOR,27,56,15,9,24
1,8481604.0,Pavel Dorofeyev,L,VGK,23,47,13,11,24
1,8478043.0,Sam Lafferty,C,VAN,28,79,13,11,24
1,8479351.0,Sam Steel,C,DAL,25,77,9,15,24
1,8475193.0,Tomas Tatar,L,SEA,33,70,9,15,24
1,8475744.0,Evgeny Kuznetsov,C,WSH,31,63,8,16,24
1,8475233.0,David Savard,D,MTL,33,60,6,18,24
1,8476422.0,Mike Reilly,D,NYI,30,61,6,18,24
1,8474031.0,Kevin Shattenkirk,D,BOS,34,61,6,18,24
1,8473507.0,Jeff Petry,D,DET,36,73,3,21,24
1,8480246.0,Nick Perbix,D,TBL,25,77,2,22,24
1,8481606.0,Jordan Spence,D,LAK,22,71,2,22,24
1,8477947.0,Sonny Milano,L,WSH,27,49,15,8,23
1,8475793.0,Ryan Johansen,C,COL,31,63,13,10,23
1,8480821.0,Filip Zadina,R,SJS,24,72,13,10,23
1,8474149.0,Evgenii Dadonov,R,DAL,34,51,12,11,23
1,8475231.0,Casey Cizikas,C,NYI,32,70,10,13,23
1,8474884.0,Mike Hoffman,C,SJS,34,66,10,13,23
1,8482062.0,Cole Smith,L,NSH,28,80,9,14,23
1,8478882.0,Vladislav Gavrikov,D,LAK,28,77,6,17,23
1,8474157.0,Max Pacioretty,L,WSH,35,47,4,19,23
1,8480873.0,Rasmus Sandin,D,WSH,23,68,3,20,23
1,8480043.0,Timothy Liljegren,D,TOR,24,55,3,20,23
1,8475343.0,Nic Dowd,C,WSH,33,64,12,10,22
1,8470621.0,Corey Perry,R,EDM,38,54,12,10,22
1,8473449.0,Kyle Okposo,R,BUF,35,67,12,10,22
1,8477446.0,Michael McCarron,R,NSH,28,70,12,10,22
1,8481517.0,Brett Leason,R,ANA,24,68,11,11,22
1,8478970.0,Jalen Chatfield,D,CAR,27,72,8,14,22
1,8481014.0,Alexander Romanov,D,NYI,23,81,7,15,22
1,8482087.0,Kaiden Guhle,D,MTL,21,70,6,16,22
1,8477953.0,Kasperi Kapanen,R,STL,27,73,6,16,22
1,8476885.0,Jacob Trouba,D,NYR,29,69,3,19,22
1,8480281.0,Alexey Toropchenko,R,STL,24,82,14,7,21
1,8482157.0,Will Cuylle,L,NYR,21,81,13,8,21
1,8478013.0,Jake Walman,D,DET,27,63,12,9,21
1,8475714.0,Calle Jarnkrok,C,TOR,32,52,10,11,21
1,8475220.0,Marcus Foligno,L,MIN,32,55,9,12,21
1,8471218.0,Blake Wheeler,R,NYR,37,54,9,12,21
1,8479359.0,Beck Malenstyn,L,WSH,25,81,6,15,21
1,8476897.0,Oskar Sundqvist,C,STL,29,71,6,15,21
1,8481178.0,Egor Zamula,D,PHI,23,66,5,16,21
1,8480891.0,Michael Kesselring,D,ARI,23,65,5,16,21
1,8479983.0,Mario Ferraro,D,SJS,25,78,3,18,21
1,8475225.0,Craig Smith,C,DAL,34,75,11,9,20
1,8476981.0,Josh Anderson,R,MTL,29,78,9,11,20
1,8475455.0,Brenden Dillon,D,WPG,33,77,8,12,20
1,8481577.0,Philip Tomasino,C,NSH,22,41,7,13,20
1,8477507.0,Nikita Zadorov,D,VAN,28,75,6,14,20
1,8475279.0,Ben Chiarot,D,DET,32,77,5,15,20
1,8478851.0,Alexandre Carrier,D,NSH,27,73,4,16,20
1,8480035.0,Henri Jokiharju,D,BUF,24,74,3,17,20
1,8480073.0,Erik Brannstrom,D,OTT,24,76,3,17,20
1,8475179.0,Dmitry Kulikov,D,FLA,33,76,1,19,20
1,8481554.0,Kaapo Kakko,R,NYR,22,61,13,6,19
1,8480980.0,Connor Dewar,C,MIN,24,74,11,8,19
1,8479415.0,Michael McLeod,C,NJD,25,45,10,9,19
1,8482097.0,Jack Quinn,R,BUF,22,27,9,10,19
1,8480144.0,David Kampf,C,TOR,28,78,8,11,19
1,8479353.0,Brett Howden,C,VGK,25,72,8,11,19
1,8475164.0,Jakob Silfverberg,R,ANA,33,81,7,12,19
1,8476889.0,Radek Faksa,C,DAL,29,74,7,12,19
1,8473504.0,Cal Clutterbuck,R,NYI,36,82,7,12,19
1,8475855.0,Jesper Fast,R,CAR,32,73,6,13,19
1,8477380.0,Jonny Brodzinski,C,NYR,30,57,6,13,19
1,8471699.0,Andrew Cogliano,C,COL,36,75,6,13,19
1,8477506.0,Ryan Pulock,D,NYI,29,58,5,14,19
1,8480172.0,Jan Rutta,D,SJS,33,69,5,14,19
1,8482073.0,Braden Schneider,D,NYR,22,82,5,14,19
1,8478432.0,Christian Fischer,R,DET,26,79,5,14,19
1,8479410.0,Mikhail Sergachev,D,TBL,25,34,2,17,19
1,8475690.0,Chris Tanev,D,CGY,34,75,2,17,19
1,8480878.0,Nils Lundkvist,D,DAL,23,59,2,17,19
1,8479316.0,Luke Kunin,C,SJS,26,77,11,7,18
1,8480289.0,Morgan Barron,C,WPG,25,80,11,7,18
1,8476374.0,Sean Kuraly,C,CBJ,30,62,9,9,18
1,8480448.0,Parker Kelly,L,OTT,24,80,8,10,18
1,8478434.0,Keegan Kolesar,R,VGK,26,79,8,10,18
1,8475462.0,Radko Gudas,D,ANA,33,66,6,12,18
1,8480220.0,Noah Cates,L,PHI,24,59,6,12,18
1,8476457.0,Adam Larsson,D,SEA,31,81,4,14,18
1,8477932.0,Aaron Ekblad,D,FLA,27,51,4,14,18
1,8477365.0,Connor Clifton,D,BUF,28,79,4,14,18
1,8476874.0,Olli Maatta,D,DET,29,72,4,14,18
1,8479398.0,Samuel Girard,D,COL,25,59,3,15,18
1,8479998.0,Mikey Anderson,D,LAK,24,74,2,16,18
1,8480049.0,Dylan Samberg,D,WPG,24,78,1,17,18
1,8478508.0,Yakov Trenin,C,NSH,26,76,12,5,17
1,8477903.0,Garnet Hathaway,R,PHI,32,82,7,10,17
1,8480995.0,Pontus Holmberg,R,TOR,24,54,7,10,17
1,8479315.0,Joey Anderson,R,CHI,25,55,5,12,17
1,8478463.0,Anthony Beauvillier,L,CHI,26,60,5,12,17
1,8474166.0,Alec Martinez,D,VGK,36,55,4,13,17
1,8481522.0,Peyton Krebs,C,BUF,22,80,4,13,17
1,8478859.0,Niko Mikkola,D,FLA,27,82,3,14,17
1,8479324.0,Ryan Lindgren,D,NYR,25,76,3,14,17
1,8481605.0,Jackson LaCombe,D,ANA,22,71,2,15,17
1,8479976.0,Juuso Valimaki,D,ARI,25,68,2,15,17
1,8470600.0,Ryan Suter,D,DAL,38,82,2,15,17
1,8480884.0,Calen Addison,D,SJS,23,72,1,16,17
1,8475842.0,Sam Carrick,C,ANA,31,77,10,6,16
1,8479977.0,Kailer Yamamoto,R,SEA,25,59,8,8,16
1,8473453.0,Trevor Lewis,C,LAK,36,82,8,8,16
1,8480205.0,Emil Bemstrom,R,CBJ,24,56,8,8,16
1,8479293.0,Brandon Tanev,L,SEA,32,66,7,9,16
1,8477444.0,Andre Burakovsky,L,SEA,28,49,7,9,16
1,8475208.0,Brian Dumoulin,D,SEA,32,80,6,10,16
1,8482660.0,Kent Johnson,C,CBJ,21,42,6,10,16
1,8477979.0,Nicolas Aube-Kubel,R,WSH,27,60,6,10,16
1,8476462.0,Dougie Hamilton,D,NJD,30,20,5,11,16
1,8482117.0,Lukas Reichel,L,CHI,21,65,5,11,16
1,8474034.0,Pat Maroon,L,MIN,35,51,4,12,16
1,8480796.0,Martin Fehervary,D,WSH,24,66,3,13,16
1,8476967.0,Brett Kulak,D,EDM,29,82,3,13,16
1,8471677.0,Jack Johnson,D,COL,36,80,3,13,16
1,8481568.0,Alex Vlasic,D,CHI,22,76,2,14,16
1,8476917.0,Adam Pelech,D,NYI,29,58,1,15,16
1,8479423.0,Alex Nylander,L,PIT,25,28,11,4,15
1,8478831.0,Kevin Stenlund,C,FLA,27,81,11,4,15
1,8470604.0,Jeff Carter,C,PIT,38,72,11,4,15
1,8477330.0,Dominik Kubalik,L,OTT,28,74,11,4,15
1,8476873.0,Mark Jankowski,C,NSH,29,32,7,8,15
1,8476393.0,Nick Cousins,C,FLA,30,69,7,8,15
1,8481560.0,Arthur Kaliyev,R,LAK,22,51,7,8,15
1,8481481.0,Blake Lizotte,C,LAK,26,62,7,8,15
1,8478109.0,Victor Olofsson,L,BUF,28,51,7,8,15
1,8481533.0,Trevor Zegras,C,ANA,22,31,6,9,15
1,8478042.0,Viktor Arvidsson,R,LAK,30,18,6,9,15
1,8474090.0,Brendan Smith,D,NJD,34,63,5,10,15
1,8477919.0,Frederick Gaudreau,C,MIN,30,67,5,10,15
1,8479368.0,Max Jones,L,ANA,25,52,5,10,15
1,8477839.0,Conor Sheary,L,TBL,31,57,4,11,15
1,8476467.0,Jamie Oleksiak,D,SEA,31,82,2,13,15
1,8475197.0,Tyson Barrie,D,NSH,32,41,1,14,15
1,8476878.0,Zemgus Girgensons,L,BUF,29,63,8,6,14
1,8480011.0,Klim Kostin,C,DET,24,52,8,6,14
1,8479661.0,Tanner Jeannot,L,TBL,26,55,7,7,14
1,8478468.0,Jeremy Lauzon,D,NSH,26,79,6,8,14
1,8480003.0,Jesper Boqvist,C,BOS,25,47,6,8,14
1,8479390.0,Taylor Raddysh,R,CHI,25,73,5,9,14
1,8477070.0,Liam O'Brien,C,ARI,29,75,5,9,14
1,8478443.0,Brandon Carlo,D,BOS,27,76,4,10,14
1,8480879.0,Jacob Bernard-Docker,D,OTT,23,72,4,10,14
1,8477392.0,Hudson Fasching,R,NYI,28,45,4,10,14
1,8477435.0,Ryan Graves,D,PIT,28,70,3,11,14
1,8474567.0,Zach Bogosian,D,MIN,33,65,3,11,14
1,8480887.0,Jordan Harris,D,MTL,23,56,3,11,14
1,8480727.0,Zach Whitecloud,D,VGK,27,61,2,12,14
1,8477220.0,Nate Schmidt,D,WPG,32,63,2,12,14
1,8475324.0,Nick Jensen,D,WSH,33,78,1,13,14
1,8480001.0,Urho Vaakanainen,D,ANA,24,68,1,13,14
1,8477845.0,Trevor van Riemsdyk,D,WSH,32,70,0,14,14
1,8482111.0,Justin Barron,D,MTL,22,48,7,6,13
1,8479383.0,Boris Katchouk,L,CHI,25,59,7,6,13
1,8477573.0,Nathan Walker,L,STL,29,45,7,6,13
1,8480192.0,Johnathan Kovacevic,D,MTL,26,62,6,7,13
1,8479996.0,Cody Glass,C,NSH,24,41,6,7,13
1,8481477.0,Nico Sturm,C,SJS,28,63,5,8,13
1,8476871.0,Tanner Pearson,L,MTL,31,54,5,8,13
1,8479520.0,Brandon Duhaime,R,MIN,26,80,5,8,13
1,8479402.0,Jake Bean,D,CBJ,25,72,4,9,13
1,8482222.0,Alexander Barabanov,L,SJS,29,46,4,9,13
1,8477488.0,Brett Pesce,D,CAR,29,70,3,10,13
1,8479371.0,Dante Fabbro,D,NSH,25,56,3,10,13
1,8478416.0,Erik Cernak,D,TBL,26,69,2,11,13
1,8476372.0,Nick Seeler,D,PHI,30,71,1,12,13
1,8481704.0,Juuso Parssinen,C,NSH,22,44,8,4,12
1,8476278.0,Colin Blackwell,C,CHI,30,44,8,4,12
1,8479336.0,Carl Grundstrom,R,LAK,26,50,8,4,12
1,8471709.0,Marc-Edouard Vlasic,D,SJS,36,57,6,6,12
1,8479393.0,Noah Gregor,C,TOR,25,63,6,6,12
1,8478421.0,A.J. Greer,L,CGY,27,59,6,6,12
1,8479671.0,Mathieu Olivier,R,CBJ,26,54,5,7,12
1,8477846.0,Ryan Carpenter,C,SJS,32,62,5,7,12
1,8478585.0,Derek Ryan,C,EDM,37,70,5,7,12
1,8479414.0,Nathan Bastian,R,NJD,26,54,5,7,12
1,8477015.0,Connor Brown,R,EDM,29,71,4,8,12
1,8476624.0,Barclay Goodrow,C,NYR,30,80,4,8,12
1,8477406.0,Mattias Janmark,C,EDM,31,71,4,8,12
1,8476919.0,Chris Tierney,C,NJD,29,52,4,8,12
1,8479543.0,Michael Pezzetta,L,MTL,25,61,3,9,12
1,8475825.0,Jani Hakanpää,D,DAL,31,64,2,10,12
1,8479980.0,Nicolas Hague,D,VGK,25,73,2,10,12
1,8476822.0,Luke Glendening,C,TBL,34,81,10,1,11
1,8482133.0,Thomas Bordeleau,C,SJS,21,27,6,5,11
1,8480806.0,Isac Lundestrom,C,ANA,24,46,5,6,11
1,8480025.0,MacKenzie Entwistle,R,CHI,24,67,5,6,11
1,8475750.0,Jon Merrill,D,MIN,31,65,4,7,11
1,8481567.0,Henry Thrun,D,SJS,22,51,3,8,11
1,8477950.0,Tony DeAngelo,D,CAR,28,31,3,8,11
1,8474013.0,Ian Cole,D,VAN,34,78,2,9,11
1,8476891.0,Matt Grzelcyk,D,BOS,29,63,2,9,11
1,8480058.0,Pierre-Olivier Joseph,D,PIT,24,52,2,9,11
1,8480860.0,Kevin Bahl,D,NJD,23,82,1,10,11
1,8479576.0,Vincent Desharnais,D,EDM,27,78,1,10,11
1,8470610.0,Zach Parise,L,COL,39,30,5,5,10
1,8476858.0,Phillip Di Giuseppe,L,VAN,30,51,5,5,10
1,8474040.0,Sam Gagner,C,EDM,34,28,5,5,10
1,8480355.0,Mark Kastelic,C,OTT,24,63,5,5,10
1,8482142.0,Jamie Drysdale,D,PHI,21,34,3,7,10
1,8480849.0,Barrett Hayton,C,ARI,23,33,3,7,10
1,8475177.0,Calvin de Haan,D,TBL,32,59,3,7,10
1,8482964.0,Arber Xhekaj,D,MTL,22,44,3,7,10
1,8477384.0,Josh Brown,D,ARI,29,51,3,7,10
1,8480184.0,Gustav Lindström,D,ANA,25,46,3,7,10
1,8480762.0,Eric Robinson,L,BUF,28,47,3,7,10
1,8477018.0,Ben Hutton,D,VGK,30,41,2,8,10
1,8481093.0,Rafael Harvey-Pinard,L,MTL,24,45,2,8,10
1,8480880.0,Jakub Lauko,C,BOS,23,60,2,8,10
1,8480871.0,Adam Boqvist,D,CBJ,23,35,1,9,10
1,8479369.0,Andrew Peeke,D,CBJ,25,38,1,9,10
1,8479982.0,Conor Timmins,D,TOR,25,25,1,9,10
1,8483460.0,David Jiricek,D,CBJ,20,43,1,9,10
1,8477971.0,Andreas Englund,D,LAK,27,82,1,9,10
1,8471274.0,Alex Goligoski,D,MIN,38,36,0,10,10
1,8479439.0,Jacob MacDonald,D,SJS,30,34,7,2,9
1,8479339.0,Patrik Laine,L,CBJ,25,18,6,3,9
1,8477353.0,Tyler Motte,C,TBL,28,69,6,3,9
1,8482077.0,Dylan Holloway,L,EDM,22,38,6,3,9
1,8479718.0,Alex Barré-Boulet,C,TBL,26,36,6,3,9
1,8477989.0,Christian Dvorak,C,MTL,27,30,5,4,9
1,8479328.0,Julien Gauthier,R,NYI,26,27,5,4,9
1,8479968.0,Vinni Lettieri,C,MIN,28,46,5,4,9
1,8476525.0,Colin Miller,D,NJD,31,46,4,5,9
1,8470966.0,Mark Giordano,D,TOR,40,46,3,6,9
1,8482679.0,Matt Coronato,R,CGY,21,34,3,6,9
1,8480008.0,Adam Ruzicka,C,ARI,24,42,3,6,9
1,8481641.0,Joel Kiviranta,L,COL,27,56,3,6,9
1,8478028.0,Fredrik Olofsson,L,COL,27,57,3,6,9
1,8480222.0,Sebastian Aho,D,NYI,27,58,2,7,9
1,8481708.0,Zac Jones,D,NYR,23,31,2,7,9
1,8476960.0,Andreas Athanasiou,C,CHI,29,28,2,7,9
1,8480848.0,Ty Dellandrea,C,DAL,23,42,2,7,9
1,8478099.0,Kevin Labanc,R,SJS,28,46,2,7,9
1,8478399.0,Jonas Siegenthaler,D,NJD,26,57,1,8,9
1,8481527.0,Kaedan Korczak,D,VGK,22,26,1,8,9
1,8481537.0,Nikita Okhotiuk,D,SJS,23,52,1,8,9
1,8475797.0,Jarred Tinordi,D,CHI,31,52,0,9,9
1,8479372.0,Josh Mahura,D,FLA,25,30,0,9,9
1,8477478.0,William Carrier,L,VGK,29,39,6,2,8
1,8480252.0,Cole Guttman,C,CHI,24,27,4,4,8
1,8481058.0,Jesse Ylönen,R,MTL,24,59,4,4,8
1,8474709.0,Matt Martin,L,NYI,34,57,4,4,8
1,8477541.0,Dakota Mermis,D,MIN,29,47,3,5,8
1,8478211.0,Dryden Hunt,L,CGY,28,28,3,5,8
1,8476473.0,Connor Murphy,D,CHI,30,46,2,6,8
1,8477335.0,Kyle Burroughs,D,SJS,28,73,2,6,8
1,8474618.0,Marco Scandella,D,STL,33,65,2,6,8
1,8476329.0,Travis Boyd,C,ARI,30,16,2,6,8
1,8480196.0,Jacob Bryson,D,BUF,26,36,1,7,8
1,8478450.0,Parker Wotherspoon,D,BOS,26,41,0,8,8
1,8480950.0,Ilya Lyubushkin,D,ANA,29,74,0,8,8
1,8479066.0,Ryan Lomberg,L,FLA,29,75,5,2,7
1,8478569.0,Noel Acciari,C,PIT,32,55,4,3,7
1,8477930.0,Pierre-Edouard Bellemare,L,SEA,38,40,4,3,7
1,8482241.0,Radim Zohorna,L,PIT,27,33,4,3,7
1,8482624.0,Daniil Miromanov,D,VGK,26,24,3,4,7
1,8479346.0,Dillon Dube,C,CGY,25,43,3,4,7
1,8482496.0,Nils Aman,C,VAN,23,43,3,4,7
1,8481019.0,David Gustafsson,C,WPG,23,39,3,4,7
1,8478408.0,Travis Dermott,D,ARI,27,50,2,5,7
1,8479458.0,Nikita Zaitsev,D,CHI,32,38,2,5,7
1,8481167.0,Brayden Pachal,D,CGY,24,50,2,5,7
1,8480084.0,Nick DeSimone,D,NJD,29,34,2,5,7
1,8482652.0,Walker Duehr,R,CGY,26,40,2,5,7
1,8480807.0,Mattias Samuelsson,D,BUF,23,41,1,6,7
1,8479442.0,Troy Stecher,D,ARI,29,54,1,6,7
1,8482516.0,Matthew Kessel,D,STL,23,39,1,6,7
1,8474568.0,Luke Schenn,D,NSH,34,63,1,6,7
1,8478454.0,Noah Juulsen,D,VAN,26,54,1,6,7
1,8478502.0,Dennis Gilbert,D,CGY,27,34,1,6,7
1,8478104.0,Sammy Blais,L,STL,27,53,1,6,7
1,8482176.0,Wyatt Kaiser,D,CHI,21,32,0,7,7
1,8473446.0,Erik Johnson,D,BUF,35,67,5,1,6
1,8471817.0,Ryan Reaves,R,TOR,36,49,4,2,6
1,8479370.0,Tyson Jost,C,BUF,25,43,3,3,6
1,8477369.0,Carson Soucy,D,VAN,29,40,2,4,6
1,8474612.0,Travis Hamonic,D,OTT,33,48,2,4,6
1,8482730.0,Brandt Clarke,D,LAK,20,16,2,4,6
1,8477944.0,Jakub Vrana,L,STL,27,21,2,4,6
1,8477931.0,Tomas Nosek,L,NJD,31,36,2,4,6
1,8480789.0,Oliver Wahlstrom,R,NYI,23,32,2,4,6
1,8481013.0,Jonatan Berggren,R,DET,23,12,2,4,6
1,8476441.0,Joel Edmundson,D,WSH,30,53,1,5,6
1,8482192.0,Isaak Phillips,D,CHI,22,33,0,6,6
1,8480078.0,Filip Chytil,C,NYR,24,10,0,6,6
1,8483524.0,Shane Wright,C,SEA,19,8,4,1,5
1,8477962.0,Brendan Lemieux,L,CAR,27,32,3,2,5
1,8481541.0,Samuel Bolduc,D,NYI,23,34,2,3,5
1,8481147.0,Reese Johnson,C,CHI,25,42,2,3,5
1,8481422.0,Jacob Lucchini,C,MIN,28,40,2,3,5
1,8479536.0,Axel Jonsson-Fjallby,L,WPG,25,26,2,3,5
1,8481122.0,Simon Benoit,D,TOR,25,64,1,4,5
1,8477938.0,Haydn Fleury,D,TBL,27,24,1,4,5
1,8477810.0,Joel Hanley,D,DAL,32,42,1,4,5
1,8471686.0,Marc Staal,D,PHI,36,35,1,4,5
1,8474009.0,Nick Bonino,C,NYR,35,45,1,4,5
1,8476952.0,Dominic Toninato,C,WPG,29,15,1,4,5
1,8479547.0,Matthew Phillips,R,PIT,25,31,1,4,5
1,8480245.0,Olle Lycksell,R,PHI,24,18,1,4,5
1,8474716.0,Jared Spurgeon,D,MIN,34,16,0,5,5
1,8475906.0,John Klingberg,D,TOR,31,14,0,5,5
1,8476429.0,Scott Mayfield,D,NYI,31,41,0,5,5
1,8475718.0,Justin Holl,D,DET,31,38,0,5,5
1,8478452.0,Caleb Jones,D,COL,26,25,0,5,5
1,8479291.0,Kevin Rooney,C,CGY,30,33,3,1,4
1,8479344.0,Jesse Puljujarvi,R,PIT,25,22,3,1,4
1,8478051.0,Max Willman,C,NJD,28,18,3,1,4
1,8475791.0,Taylor Hall,L,CHI,32,10,2,2,4
1,8481056.0,Spencer Stastney,D,NSH,23,20,2,2,4
1,8476867.0,Brendan Gaunce,C,CBJ,29,24,2,2,4
1,8479981.0,Jonah Gadjovich,L,FLA,25,39,2,2,4
1,8475766.0,Austin Watson,L,TBL,31,33,2,2,4
1,8477499.0,Rasmus Ristolainen,D,PHI,29,31,1,3,4
1,8478451.0,Ethan Bear,D,WSH,26,24,1,3,4
1,8481609.0,Vladislav Kolyachonok,D,ARI,22,5,1,3,4
1,8477244.0,Chad Ruhwedel,D,PIT,33,52,1,3,4
1,8476442.0,Matt Nieto,L,PIT,31,22,1,3,4
1,8479994.0,Jaret Anderson-Dolan,C,LAK,24,31,1,3,4
1,8475752.0,Tyler Pitlick,C,NYR,32,34,1,3,4
1,8481532.0,Alex Turcotte,C,LAK,22,20,1,3,4
1,8477527.0,Ross Johnston,L,ANA,29,68,1,3,4
1,8475235.0,Nicolas Deslauriers,L,PHI,32,60,1,3,4
1,8476913.0,Devin Shore,C,SEA,29,21,1,3,4
1,8479379.0,Givani Smith,R,SJS,25,36,1,3,4
1,8475762.0,Derek Forbort,D,BOS,31,35,0,4,4
1,8478424.0,Jansen Harkins,C,PIT,26,45,0,4,4
1,8480441.0,Trey Fix-Wolansky,R,CBJ,24,11,2,1,3
1,8478078.0,Rourke Chartier,C,OTT,27,37,2,1,3
1,8480776.0,Sheldon Rempal,R,VGK,28,9,2,1,3
1,8480468.0,James Hamblin,L,EDM,24,31,2,1,3
1,8479772.0,Zack MacEwen,R,OTT,27,30,2,1,3
1,8477073.0,Kurtis MacDermid,D,COL,29,45,2,1,3
1,8480823.0,Alexander Alexeyev,D,WSH,24,39,1,2,3
1,8480007.0,Jonas Rondbjerg,R,VGK,24,20,1,2,3
1,8476934.0,Brock McGinn,L,ANA,29,24,1,2,3
1,8478409.0,Anthony Richard,C,BOS,27,9,1,2,3
1,8483570.0,Ben Meyers,C,COL,25,23,1,2,3
1,8476994.0,Vinnie Hinostroza,C,PIT,29,14,1,2,3
1,8481592.0,Jakob Pelletier,L,CGY,22,13,1,2,3
1,8478904.0,Steven Lorentz,C,FLA,27,38,1,2,3
1,8479972.0,Mason Shaw,C,MIN,25,20,1,2,3
1,8480853.0,Liam Foudy,C,NSH,23,13,0,3,3
1,8482762.0,Simon Edvinsson,D,DET,20,16,1,1,2
1,8482101.0,Danil Gushchin,L,SJS,21,4,1,1,2
1,8479378.0,Logan Stanley,D,WPG,25,25,1,1,2
1,8481006.0,Tyler Tucker,D,STL,23,26,1,1,2
1,8478495.0,Denis Gurianov,R,NSH,26,18,1,1,2
1,8479362.0,Riley Tufte,L,COL,25,5,1,1,2
1,8480292.0,Carson Meyer,R,CBJ,26,14,1,1,2
1,8477454.0,Adam Erne,L,EDM,28,24,1,1,2
1,8475780.0,Chris Wagner,R,BOS,32,13,1,1,2
1,8476988.0,Matt Benning,D,SJS,29,14,0,2,2
1,8477034.0,Jaycob Megna,D,CHI,31,44,0,2,2
1,8481521.0,Ronnie Attard,D,PHI,24,12,0,2,2
1,8480070.0,Ian Mitchell,D,BOS,24,13,0,2,2
1,8477851.0,Jordan Oesterle,D,CGY,31,22,0,2,2
1,8481161.0,Jake Christiansen,D,CBJ,24,12,0,2,2
1,8482451.0,Mikael Pyyhtia,L,CBJ,22,17,0,2,2
1,8473473.0,Milan Lucic,L,BOS,35,4,0,2,2
1,8480870.0,Bo Groulx,C,ANA,23,45,0,2,2
1,8481598.0,Philip Broberg,D,EDM,22,12,0,2,2
1,8477464.0,Nic Petan,C,MIN,28,6,0,2,2
1,8481617.0,Vasily Podkolzin,R,VAN,22,19,0,2,2
1,8481751.0,Lukas Rousek,R,BUF,24,15,0,2,2
1,8481550.0,Adam Beckman,L,MIN,22,11,0,2,2
1,8481523.0,Kirby Dach,C,MTL,22,2,0,2,2
1,8481543.0,Nikita Alexandrov,C,STL,23,23,0,2,2
1,8478146.0,Matthew Highmore,C,OTT,27,7,0,2,2
1,8481043.0,Cole Koepke,L,TBL,25,9,0,2,2
1,8483565.0,Nick Blankenburg,D,CBJ,25,12,1,0,1
1,8483397.0,Marc McLaughlin,C,BOS,24,1,1,0,1
1,8480874.0,Adam Ginning,D,PHI,23,9,1,0,1
1,8481754.0,Nikita Nesterenko,C,ANA,22,3,1,0,1
1,8480021.0,Jack Studnicka,C,SJS,24,22,1,0,1
1,8481518.0,Nolan Foote,L,NJD,23,4,1,0,1
1,8479421.0,Jacob Moverare,D,LAK,25,24,1,0,1
1,8481239.0,Samuel Fagemo,L,LAK,23,8,1,0,1
1,8479546.0,Oskar Steen,C,BOS,25,34,1,0,1
1,8480836.0,Jonathan Gruden,C,PIT,23,13,1,0,1
1,8481077.0,John Leonard,L,NSH,25,6,1,0,1
1,8482147.0,Jean-Luc Foudy,C,COL,21,4,1,0,1
1,8474053.0,Logan Couture,C,SJS,34,6,0,1,1
1,8481812.0,Nikolai Knyzhov,D,SJS,26,10,0,1,1
1,8479984.0,Cal Foote,D,NJD,25,4,0,1,1
1,8479321.0,Lucas Johansen,D,WSH,26,6,0,1,1
1,8473563.0,Nicklas Backstrom,C,WSH,36,8,0,1,1
1,8479320.0,Max Lajoie,D,TOR,26,7,0,1,1
1,8482095.0,Tyler Kleven,D,OTT,21,9,0,1,1
1,8480157.0,Calle Rosen,D,STL,29,6,0,1,1
1,8480031.0,Max Comtois,L,ANA,24,1,0,1,1
1,8478017.0,Mark Friedman,D,VAN,28,23,0,1,1
1,8479348.0,Kale Clague,D,BUF,25,3,0,1,1
1,8475278.0,Byron Froese,C,VGK,32,16,0,1,1
1,8475795.0,Dylan McIlrath,D,WSH,31,3,0,1,1
1,8480845.0,Rasmus Kupari,C,WPG,23,28,0,1,1
1,8480890.0,Jan Jenik,R,ARI,23,5,0,1,1
1,8477887.0,Patrick Brown,C,BOS,31,11,0,1,1
1,8478512.0,Austin Czarnik,C,DET,31,34,0,1,1
1,8479367.0,William Lockwood,R,FLA,25,26,0,1,1
1,8483597.0,Milos Kelemen,L,ARI,24,10,0,1,1
1,8477126.0,Jayson Megna,C,ANA,33,1,0,0,0
1,8479639.0,Dylan Coghlan,D,CAR,25,1,0,0,0
1,8482067.0,Connor Mackey,D,NYR,27,1,0,0,0
1,8476856.0,Matt Dumba,D,ARI,29,0,0,0,0
1,8478483.0,Mitchell Marner,R,TOR,26,0,0,0,0
1,8471873.0,Anton Stralman,D,BOS,37,0,0,0,0
1,8474162.0,Jake Muzzin,D,TOR,34,0,0,0,0
1,8470638.0,Patrice Bergeron,C,BOS,38,0,0,0,0
1,8473604.0,Jonathan Toews,C,CHI,35,0,0,0,0
1,8471276.0,David Krejci,C,BOS,37,0,0,0,0
1,8474207.0,Nick Holden,D,OTT,36,0,0,0,0
1,8475747.0,Patrik Nemeth,D,ARI,31,0,0,0,0
1,8477467.0,Gustav Olofsson,D,SEA,29,1,0,0,0
1,8479514.0,Rem Pitlick,C,CHI,26,9,0,0,0
1,8474027.0,Justin Braun,D,PHI,36,0,0,0,0
1,8481599.0,Victor Soderstrom,D,ARI,22,3,0,0,0
1,8474161.0,Jakub Voracek,R,CBJ,34,0,0,0,0
1,8479985.0,Cale Fleury,D,SEA,25,1,0,0,0
1,8471303.0,Alexander Edler,D,LAK,37,0,0,0,0
1,8474573.0,Josh Bailey,R,NYI,34,0,0,0,0
1,8483619.0,Filip Roos,D,CHI,24,4,0,0,0
1,8474818.0,Jordie Benn,D,TOR,36,0,0,0,0
1,8476449.0,Scott Harrington,D,ANA,30,0,0,0,0
1,8483620.0,Marcus Bjork,D,CBJ,26,0,0,0,0
1,8470595.0,Eric Staal,C,FLA,39,0,0,0,0
1,8481585.0,Egor Afanasyev,L,NSH,22,2,0,0,0
1,8482712.0,Oskar Olausson,R,COL,21,1,0,0,0
1,8481072.0,Tim Berni,D,CBJ,23,0,0,0,0
1,8479945.0,Gavin Bayreuther,D,CBJ,29,0,0,0,0
1,8481600.0,Tobias Bjornfot,D,VGK,22,4,0,0,0
1,8481679.0,Maxence Guenette,D,OTT,22,7,0,0,0
1,8474683.0,Derek Grant,C,ANA,33,0,0,0,0
1,8476470.0,Nathan Beaulieu,D,ANA,31,0,0,0,0
1,8474145.0,Robert Bortuzzo,D,NYI,34,27,0,0,0
1,8480216.0,Jacob Peterson,C,SJS,24,6,0,0,0
1,8473548.0,Phil Kessel,R,VGK,36,0,0,0,0
1,8480160.0,Radim Simek,D,SJS,31,0,0,0,0
1,8480883.0,Ty Smith,D,PIT,23,0,0,0,0
1,8471669.0,Paul Stastny,C,CAR,38,0,0,0,0
1,8475227.0,Chris Wideman,D,MTL,33,0,0,0,0
1,8480913.0,Jordan Gross,D,NSH,28,0,0,0,0
1,8475625.0,Matt Irwin,D,WSH,36,0,0,0,0
1,8479388.0,Riley Stillman,D,BUF,25,0,0,0,0
1,8474628.0,Michael Stone,D,CGY,33,0,0,0,0
1,8484254.0,Akito Hirose,D,VAN,24,3,0,0,0
1,8477941.0,Nick Ritchie,L,CGY,28,0,0,0,0
1,8477462.0,Robert Hagg,D,ANA,28,5,0,0,0
1,8478062.0,Dysin Mayo,D,ARI,27,0,0,0,0
1,8482634.0,Alex Steeves,C,TOR,24,1,0,0,0
1,8477433.0,Ben Harpur,D,NYR,28,0,0,0,0
1,8478841.0,Colton White,D,ANA,26,0,0,0,0
1,8473544.0,Derick Brassard,C,OTT,36,0,0,0,0
1,8476884.0,Derrick Pouliot,D,SJS,29,5,0,0,0
1,8479376.0,Victor Mete,D,PHI,25,1,0,0,0
1,8483630.0,Pavol Regenda,L,ANA,24,5,0,0,0
1,8479026.0,Philippe Myers,D,TBL,26,5,0,0,0
1,8477482.0,Zach Sanford,L,CHI,29,0,0,0,0
1,8477359.0,Tucker Poolman,D,VAN,30,0,0,0,0
1,8475857.0,Kevin Gravel,D,NSH,31,0,0,0,0
1,8476779.0,Brad Hunt,D,COL,35,0,0,0,0
1,8476850.0,Ryan Murray,D,EDM,30,0,0,0,0
1,8477341.0,Andreas Johnsson,L,SJS,29,0,0,0,0
1,8474218.0,Jason Demers,D,EDM,35,0,0,0,0
1,8480844.0,Grigori Denisenko,L,VGK,23,6,0,0,0
1,8484287.0,Cole McWard,D,VAN,22,1,0,0,0
1,8479322.0,Wade Allison,R,PHI,26,0,0,0,0
1,8478846.0,Christian Wolanin,D,VAN,28,0,0,0,0
1,8471887.0,Patric Hornqvist,R,FLA,36,0,0,0,0
1,8475163.0,Alex Chiasson,R,DET,33,0,0,0,0
1,8478881.0,Brett Seney,L,CHI,27,4,0,0,0
1,8474697.0,Mark Borowiecki,D,NSH,34,0,0,0,0
1,8476410.0,Josh Leivo,L,STL,30,0,0,0,0
1,8475968.0,Alex Belzile,R,MTL,32,0,0,0,0
1,8479580.0,Dylan Gambrell,C,OTT,27,0,0,0,0
1,8480901.0,Karson Kuhlman,C,WPG,28,0,0,0,0
1,8480326.0,Sheldon Dries,C,VAN,29,0,0,0,0
1,8478465.0,Guillaume Brisebois,D,VAN,26,0,0,0,0
1,8482861.0,Vincent Iorio,D,WSH,21,6,0,0,0
1,8471794.0,Darren Helm,C,COL,36,0,0,0,0
1,8479335.0,Rasmus Asplund,C,NSH,26,0,0,0,0
1,8478415.0,Jakub Zboril,D,BOS,26,0,0,0,0
1,8476310.0,Lukas Sedlak,C,PHI,30,0,0,0,0
1,8478075.0,Anders Bjork,L,CHI,27,0,0,0,0
1,8480267.0,Sammy Walker,C,MIN,24,4,0,0,0
1,8479578.0,Casey Fitzgerald,D,FLA,26,0,0,0,0
1,8480032.0,Shane Bowers,C,NJD,24,8,0,0,0
1,8478400.0,Colin White,C,PIT,26,28,0,0,0
1,8478431.0,Evgeny Svechnikov,L,SJS,27,0,0,0,0
1,8475772.0,Riley Sheahan,C,BUF,32,0,0,0,0
1,8481690.0,Tyler Angle,C,CBJ,23,2,0,0,0
1,8476326.0,Josh Archibald,R,PIT,31,0,0,0,0
1,8478843.0,Denis Malgin,C,COL,26,0,0,0,0
1,8478446.0,Glenn Gawdin,C,ANA,26,1,0,0,0
1,8477357.0,Saku Maenalanen,R,WPG,29,0,0,0,0
1,8478870.0,Rudolfs Balcers,L,TBL,26,0,0,0,0
1,8478476.0,Kyle Capobianco,D,WPG,26,0,0,0,0
1,8476439.0,Brett Ritchie,R,ARI,30,0,0,0,0
1,8474613.0,Derek Stepan,C,CAR,33,0,0,0,0
1,8475178.0,Zack Kassian,R,ARI,32,0,0,0,0
1,8480226.0,Marián Studenic,R,SEA,25,2,0,0,0
1,8481070.0,Hugh McGing,L,STL,25,5,0,0,0
1,8482250.0,Callahan Burke,C,CAR,26,1,0,0,0
1,8481591.0,Sam Poulin,R,PIT,22,3,0,0,0
1,8481441.0,Joe Snively,C,WSH,27,3,0,0,0
1,8478967.0,Lane Pederson,C,CBJ,26,0,0,0,0
1,8479333.0,Libor Hajek,D,NYR,25,0,0,0,0
1,8480833.0,Vitali Kravtsov,R,VAN,24,0,0,0,0
1,8477460.0,Laurent Dauphin,C,ARI,28,0,0,0,0
1,8481461.0,Corey Schueneman,D,MTL,28,0,0,0,0
1,8474190.0,Wayne Simmonds,R,TOR,35,0,0,0,0
1,8483549.0,Lucas Condotta,L,MTL,26,3,0,0,0
1,8477993.0,Justin Kirkland,C,ARI,27,2,0,0,0
1,8480935.0,Lawrence Pilut,D,BUF,28,0,0,0,0
1,8477210.0,Buddy Robinson,R,CHI,32,0,0,0,0
1,8476851.0,Alex Galchenyuk,C,COL,29,0,0,0,0
1,8482197.0,Adam Raska,R,MIN,22,5,0,0,0
1,8479366.0,Logan Brown,C,STL,25,0,0,0,0
1,8479356.0,Kieffer Bellows,L,PHI,25,0,0,0,0
1,8479533.0,Joona Koppanen,L,PIT,25,4,0,0,0
1,8477401.0,John Hayden,C,SEA,28,2,0,0,0
1,8480822.0,Martin Kaut,R,SJS,24,0,0,0,0
1,8474610.0,Zac Dalpe,C,FLA,34,0,0,0,0
1,8482399.0,Billy Sweezey,D,CBJ,27,0,0,0,0
1,8479991.0,Jake Leschyshyn,C,NYR,24,1,0,0,0
1,8479550.0,Tanner Laczynski,C,PHI,26,0,0,0,0
1,8476166.0,Taylor Fedun,D,PIT,35,0,0,0,0
1,8479338.0,Markus Niemelainen,D,EDM,25,0,0,0,0
1,8477320.0,Anton Blidh,L,NYR,28,1,0,0,0
1,8478147.0,Bokondji Imama,L,ARI,27,6,0,0,0
1,8478067.0,Oskar Lindblom,L,SJS,27,1,0,0,0
1,8478506.0,Gabriel Carlsson,D,WSH,26,0,0,0,0
1,8478131.0,Ondrej Kase,R,CAR,28,0,0,0,0
1,8479644.0,Matt Luff,R,DET,26,0,0,0,0
1,8482824.0,Nick Cicek,D,SJS,23,0,0,0,0
1,8482834.0,Jesper Froden,R,SEA,29,0,0,0,0
1,8478491.0,Jacob Larsson,D,OTT,26,0,0,0,0
1,8474089.0,Brad Malone,C,EDM,34,0,0,0,0
1,8482641.0,Matt Kiersted,D,FLA,25,0,0,0,0
1,8480071.0,Robin Salo,D,NYI,25,0,0,0,0
1,8475461.0,Andrew Agozzino,L,SJS,32,0,0,0,0
1,8475160.0,Kyle Clifford,L,TOR,32,0,0,0,0
1,8480056.0,Jack Rathbone,D,VAN,24,0,0,0,0
1,8481725.0,Elmer Soderblom,L,DET,22,0,0,0,0
1,8479465.0,Drake Caggiula,L,PIT,29,0,0,0,0
1,8476948.0,Charles Hudon,L,COL,29,0,0,0,0
1,8479523.0,Lucas Carlsson,D,FLA,26,0,0,0,0
1,8478455.0,Austin Wagner,L,CHI,26,0,0,0,0
1,8481572.0,Ville Heinola,D,WPG,22,0,0,0,0
1,8479404.0,Henrik Borgstrom,C,WSH,26,0,0,0,0
1,8479944.0,Zach Aston-Reese,C,DET,29,3,0,0,0
1,8482635.0,Mike Hardman,L,CHI,24,0,0,0,0
1,8479705.0,Jeffrey Viel,L,SJS,26,0,0,0,0
1,8480467.0,Austin Strand,D,ANA,26,0,0,0,0
1,8480037.0,Aleksi Heponiemi,C,FLA,24,0,0,0,0
1,8479573.0,Mikhail Maltsev,L,COL,25,0,0,0,0
1,8476404.0,Andy Andreoff,C,NYI,32,0,0,0,0
1,8484125.0,Hunter McKown,C,CBJ,21,0,0,0,0
1,8481649.0,Joona Luoto,L,CBJ,26,0,0,0,0
1,8477981.0,Roland McKeown,D,NSH,27,0,0,0,0
1,8480831.0,Alec Regula,D,CHI,23,0,0,0,0
1,8482691.0,Aatu Raty,C,VAN,21,0,0,0,0
1,8482623.0,Josh Dunne,C,CBJ,25,0,0,0,0
1,8481433.0,Taro Hirose,L,DET,27,0,0,0,0
1,8480328.0,David Gust,R,CHI,29,0,0,0,0
1,8479526.0,Otto Koivula,L,NYI,25,0,0,0,0
1,8476390.0,Joseph Cramarossa,C,MIN,31,0,0,0,0
1,8482654.0,Jackson Cates,C,PHI,26,0,0,0,0
1,8480439.0,Mac Hollowell,D,TOR,25,0,0,0,0
1,8480072.0,Lias Andersson,C,LAK,25,0,0,0,0
1,8479395.0,Dennis Cholowski,D,NYI,25,0,0,0,0
1,8477463.0,Steven Santini,D,STL,28,0,0,0,0
1,8479347.0,Tyler Benson,L,EDM,25,0,0,0,0
1,8477471.0,Dillon Heatherington,D,OTT,28,0,0,0,0
1,8477520.0,Jean-Sebastien Dea,C,ARI,29,0,0,0,0
1,8480846.0,Sampo Ranta,L,COL,23,0,0,0,0
1,8480979.0,Nathan Smith,C,ARI,25,0,0,0,0
1,8484256.0,Jake Livingstone,D,NSH,24,0,0,0,0
1,8476396.0,Steven Fogarty,C,MIN,30,0,0,0,0
1,8479252.0,Dan Renouf,D,BOS,29,0,0,0,0
1,8479518.0,Fredrik Karlström,C,DAL,25,0,0,0,0
1,8481683.0,Aidan McDonough,L,VAN,24,0,0,0,0
1,8478373.0,Nikita Soshnikov,R,NYI,30,0,0,0,0
1,8482081.0,Sean Farrell,C,MTL,22,0,0,0,0
1,8481575.0,Lassi Thomson,D,OTT,23,0,0,0,0
1,8481102.0,Egor Sokolov,L,OTT,23,0,0,0,0
1,8481712.0,Matej Blumel,R,DAL,23,0,0,0,0
1,8479602.0,Jeremy Davies,D,BUF,27,0,0,0,0
1,8480443.0,Kristian Reichel,C,WPG,25,0,0,0,0
1,8479304.0,Kyle Criscuolo,C,SJS,31,0,0,0,0
1,8478224.0,Luke Philp,C,CHI,28,0,0,0,0
1,8480242.0,Arnaud Durandeau,L,NYI,24,0,0,0,0
1,8479329.0,Frederic Allard,D,MTL,26,0,0,0,0
1,8476941.0,Connor Carrick,D,BOS,29,0,0,0,0
1,8479375.0,William Bitten,C,STL,25,0,0,0,0
1,8481720.0,Nick Abruzzese,C,TOR,24,0,0,0,0
1,8482452.0,Elliot Desnoyers,L,PHI,21,0,0,0,0
1,8476915.0,Jujhar Khaira,L,MIN,29,1,0,0,0
1,8483641.0,Anton Levtchi,L,FLA,28,0,0,0,0
1,8481740.0,Tyce Thompson,R,NJD,24,0,0,0,0
1,8478173.0,Hayden Hodgson,R,PHI,27,0,0,0,0
1,8482181.0,Tristen Robins,C,SJS,22,0,0,0,0
1,8481563.0,Drew Helleson,D,ANA,22,0,0,0,0
1,8480863.0,Gabriel Fortier,L,TBL,23,0,0,0,0
1,8478058.0,CJ Suess,L,SJS,29,0,0,0,0
1,8480041.0,Dmitri Samorukov,D,STL,24,0,0,0,0
1,8482179.0,Justin Richards,C,CBJ,25,0,0,0,0
1,8480034.0,Joel Teasdale,L,MTL,24,0,0,0,0
1,8480820.0,Filip Kral,D,TOR,24,0,0,0,0
1,8480842.0,Filip Hallander,C,PIT,23,0,0,0,0
1,8478367.0,Cole Bardreau,C,NYI,30,0,0,0,0
1,8482448.0,Samuel Knazko,D,CBJ,21,0,0,0,0
1,8482711.0,Stanislav Svozil,D,CBJ,20,0,0,0,0
1,8480275.0,Nick Swaney,R,MIN,26,0,0,0,0
1,8480994.0,Damien Giroux,C,MIN,23,0,0,0,0
1,8480977.0,Semyon Der-Arguchintsev,C,TOR,23,0,0,0,0
1,8482207.0,William Dufour,R,NYI,21,0,0,0,0
1,8483464.0,Marco Kasper,C,DET,19,0,0,0,0
1,8483424.0,Owen Beck,C,MTL,19,0,0,0,0
2,8476453.0,Nikita Kucherov,R,TBL,30,81,44,100,144
2,8477492.0,Nathan MacKinnon,C,COL,28,82,51,89,140
2,8478402.0,Connor McDavid,C,EDM,26,76,32,100,132
2,8478550.0,Artemi Panarin,L,NYR,32,82,49,71,120
2,8477956.0,David Pastrnak,R,BOS,27,82,47,63,110
2,8479318.0,Auston Matthews,C,TOR,26,81,69,38,107
2,8477934.0,Leon Draisaitl,C,EDM,28,81,41,65,106
2,8478420.0,Mikko Rantanen,R,COL,27,80,42,62,104
2,8476468.0,J.T. Miller,C,VAN,30,81,37,66,103
2,8477939.0,William Nylander,R,TOR,27,82,40,58,98
2,8478864.0,Kirill Kaprizov,L,MIN,26,75,46,50,96
2,8477933.0,Sam Reinhart,C,FLA,28,82,57,37,94
2,8476887.0,Filip Forsberg,L,NSH,29,82,48,46,94
2,8471675.0,Sidney Crosby,C,PIT,36,82,42,52,94
2,8480800.0,Quinn Hughes,D,VAN,24,82,17,75,92
2,8478010.0,Brayden Point,C,TBL,27,81,46,44,90
2,8480069.0,Cale Makar,D,COL,25,77,21,69,90
2,8478427.0,Sebastian Aho,C,CAR,26,78,36,53,89
2,8480012.0,Elias Pettersson,C,VAN,25,82,34,55,89
2,8479314.0,Matthew Tkachuk,L,FLA,26,80,26,62,88
2,8480023.0,Robert Thomas,C,STL,24,82,26,60,86
2,8474600.0,Roman Josi,D,NSH,33,82,23,62,85
2,8479407.0,Jesper Bratt,L,NJD,25,82,27,56,83
2,8480803.0,Evan Bouchard,D,EDM,24,81,18,64,82
2,8474564.0,Steven Stamkos,C,TBL,33,79,40,41,81
2,8480027.0,Jason Robertson,L,DAL,24,82,29,51,80
2,8478445.0,Mathew Barzal,C,NYI,26,80,23,57,80
2,8477493.0,Aleksander Barkov,C,FLA,28,73,23,57,80
2,8475786.0,Zach Hyman,L,EDM,31,80,54,23,77
2,8480018.0,Nick Suzuki,C,MTL,24,82,33,44,77
2,8477404.0,Jake Guentzel,L,PIT,29,67,30,47,77
2,8476389.0,Vincent Trocheck,C,NYR,30,82,25,52,77
2,8479343.0,Clayton Keller,R,ARI,25,78,33,43,76
2,8475167.0,Victor Hedman,D,TBL,33,78,13,63,76
2,8475184.0,Chris Kreider,L,NYR,32,82,39,36,75
2,8475172.0,Nazem Kadri,C,CGY,33,82,29,46,75
2,8477960.0,Adrian Kempe,R,LAK,27,77,28,47,75
2,8479542.0,Brandon Hagel,L,TBL,25,82,26,49,75
2,8474679.0,Gustav Nyquist,C,NSH,34,81,23,52,75
2,8480801.0,Brady Tkachuk,L,OTT,24,81,37,37,74
2,8481559.0,Jack Hughes,C,NJD,22,62,27,47,74
2,8478444.0,Brock Boeser,R,VAN,26,81,40,33,73
2,8477942.0,Kevin Fiala,L,LAK,27,82,29,44,73
2,8479323.0,Adam Fox,D,NYR,25,72,17,56,73
2,8477409.0,Carter Verhaeghe,C,FLA,28,76,34,38,72
2,8482078.0,Lucas Raymond,L,DET,21,82,31,41,72
2,8476459.0,Mika Zibanejad,C,NYR,30,81,26,46,72
2,8476460.0,Mark Scheifele,C,WPG,30,74,25,47,72
2,8471685.0,Anze Kopitar,C,LAK,36,81,26,44,70
2,8482116.0,Tim Stützle,C,OTT,21,75,18,52,70
2,8480865.0,Noah Dobson,D,NYI,23,79,10,60,70
2,8476539.0,Jonathan Marchessault,R,VGK,33,82,42,27,69
2,8475754.0,Brock Nelson,C,NYI,32,82,34,35,69
2,8477946.0,Dylan Larkin,C,DET,27,68,33,36,69
2,8475158.0,Ryan O'Reilly,C,NSH,32,82,26,43,69
2,8477504.0,Josh Morrissey,D,WPG,28,81,10,59,69
2,8478439.0,Travis Konecny,R,PHI,26,76,33,35,68
2,8477500.0,Bo Horvat,C,NYI,28,81,33,35,68
2,8478403.0,Jack Eichel,C,VGK,27,63,31,37,68
2,8481557.0,Matt Boldy,L,MIN,22,75,29,39,68
2,8482093.0,Seth Jarvis,C,CAR,21,81,33,34,67
2,8479385.0,Jordan Kyrou,C,STL,25,82,31,36,67
2,8473419.0,Brad Marchand,L,BOS,35,82,29,38,67
2,8480002.0,Nico Hischier,C,NJD,24,71,27,40,67
2,8471215.0,Evgeni Malkin,C,PIT,37,82,27,40,67
2,8478440.0,Dylan Strome,C,WSH,26,82,27,40,67
2,8479337.0,Alex DeBrincat,R,DET,26,82,27,40,67
2,8470794.0,Joe Pavelski,C,DAL,39,82,27,40,67
2,8476454.0,Ryan Nugent-Hopkins,C,EDM,30,80,18,49,67
2,8480208.0,Drake Batherson,R,OTT,25,82,28,38,66
2,8482740.0,Wyatt Johnston,C,DAL,20,82,32,33,65
2,8471214.0,Alex Ovechkin,L,WSH,38,79,31,34,65
2,8478449.0,Roope Hintz,C,DAL,27,80,30,35,65
2,8475166.0,John Tavares,C,TOR,33,80,29,36,65
2,8481540.0,Cole Caufield,R,MTL,22,82,28,37,65
2,8475168.0,Matt Duchene,C,DAL,32,80,25,40,65
2,8478493.0,Joel Eriksson Ek,C,MIN,26,77,30,34,64
2,8473512.0,Claude Giroux,R,OTT,35,82,21,43,64
2,8477402.0,Pavel Buchnevich,L,STL,28,80,27,36,63
2,8475692.0,Mats Zuccarello,R,MIN,36,69,12,51,63
2,8477955.0,Jared McCann,L,SEA,27,80,29,33,62
2,8476875.0,Mike Matheson,D,MTL,29,82,11,51,62
2,8478398.0,Kyle Connor,L,WPG,27,65,34,27,61
2,8477940.0,Nikolaj Ehlers,L,WPG,27,82,25,36,61
2,8477951.0,Nick Schmaltz,C,ARI,27,79,22,39,61
2,8478366.0,Frank Vatrano,R,ANA,29,82,37,23,60
2,8476448.0,William Karlsson,C,VGK,30,70,30,30,60
2,8475745.0,Charlie Coyle,C,BOS,31,82,25,35,60
2,8473994.0,Jamie Benn,L,DAL,34,82,21,39,60
2,8475798.0,Mikael Granlund,C,SJS,31,69,12,48,60
2,8476346.0,Johnny Gaudreau,L,CBJ,30,81,12,48,60
2,8481068.0,Yegor Sharangovich,C,CGY,25,82,31,28,59
2,8477497.0,Sean Monahan,C,WPG,29,83,26,33,59
2,8477949.0,Alex Tuch,R,BUF,27,75,22,37,59
2,8478401.0,Pavel Zacha,C,BOS,26,78,21,38,59
2,8480839.0,Rasmus Dahlin,D,BUF,23,81,20,39,59
2,8477416.0,Oliver Bjorkstrand,R,SEA,28,82,20,39,59
2,8476853.0,Morgan Rielly,D,TOR,29,72,7,51,58
2,8479675.0,Trevor Moore,L,LAK,28,82,31,26,57
2,8482109.0,Alexis Lafrenière,L,NYR,22,82,28,29,57
2,8479999.0,Casey Mittelstadt,C,BUF,25,80,18,39,57
2,8481711.0,Matias Maccelli,L,ARI,23,82,17,40,57
2,8478460.0,Zach Werenski,D,CBJ,26,70,11,46,57
2,8479420.0,Tage Thompson,C,BUF,26,71,29,27,56
2,8475810.0,Bryan Rust,R,PIT,31,62,28,28,56
2,8477494.0,Jonathan Drouin,L,COL,28,79,19,37,56
2,8474578.0,Erik Karlsson,D,PIT,33,82,11,45,56
2,8476906.0,Shayne Gostisbehere,D,DET,30,81,10,46,56
2,8475726.0,Tyler Toffoli,R,NJD,31,79,33,22,55
2,8475765.0,Vladimir Tarasenko,R,OTT,32,76,23,32,55
2,8482124.0,Quinton Byfield,R,LAK,21,80,20,35,55
2,8478047.0,Michael Bunting,L,CAR,28,81,19,36,55
2,8475151.0,Kyle Palmieri,C,NYI,32,82,30,24,54
2,8476399.0,Blake Coleman,C,CGY,32,78,30,24,54
2,8478873.0,Troy Terry,R,ANA,26,76,20,34,54
2,8480798.0,Philipp Kurashev,C,CHI,24,75,18,36,54
2,8480036.0,Miro Heiskanen,D,DAL,24,71,9,45,54
2,8477501.0,Valeri Nichushkin,R,COL,28,54,28,25,53
2,8480015.0,Owen Tippett,R,PHI,24,78,28,25,53
2,8476882.0,Teuvo Teravainen,L,CAR,29,76,25,28,53
2,8480039.0,Martin Necas,C,CAR,24,77,24,29,53
2,8478975.0,Mason Marchment,L,DAL,28,81,22,31,53
2,8475913.0,Mark Stone,R,VGK,31,56,16,37,53
2,8478414.0,Timo Meier,R,NJD,27,69,28,24,52
2,8475794.0,Tyler Seguin,C,DAL,31,68,25,27,52
2,8477346.0,MacKenzie Weegar,D,CGY,29,82,20,32,52
2,8480830.0,Andrei Svechnikov,R,CAR,23,59,19,33,52
2,8476456.0,Jonathan Huberdeau,C,CGY,30,81,12,40,52
2,8474590.0,John Carlson,D,WSH,33,82,10,42,52
2,8474641.0,Adam Henrique,C,ANA,33,82,24,27,51
2,8476905.0,Chandler Stephenson,C,VGK,29,75,16,35,51
2,8471724.0,Kris Letang,D,PIT,36,82,10,41,51
2,8482175.0,JJ Peterka,R,BUF,21,82,28,22,50
2,8480797.0,Joel Farabee,L,PHI,23,82,22,28,50
2,8483515.0,Juraj Slafkovsky,L,MTL,19,82,20,30,50
2,8474563.0,Drew Doughty,D,LAK,34,82,15,35,50
2,8478038.0,Devon Toews,D,COL,29,82,12,38,50
2,8477456.0,J.T. Compher,L,DET,28,77,19,29,48
2,8479425.0,Filip Hronek,D,VAN,26,81,5,43,48
2,8474141.0,Patrick Kane,R,DET,35,50,20,27,47
2,8478856.0,Conor Garland,R,VAN,27,82,20,27,47
2,8481528.0,Dylan Cozens,C,BUF,22,79,18,29,47
2,8476479.0,Phillip Danault,C,LAK,30,78,17,30,47
2,8474102.0,David Perron,L,DET,35,76,17,30,47
2,8481581.0,Thomas Harley,D,DAL,22,79,15,32,47
2,8478396.0,Noah Hanifin,D,CGY,26,80,13,34,47
2,8476869.0,Brady Skjei,D,CAR,29,80,13,34,47
2,8479325.0,Charlie McAvoy,D,BOS,26,74,12,35,47
2,8482684.0,Luke Hughes,D,NJD,20,82,9,38,47
2,8477503.0,Max Domi,C,TOR,28,80,9,38,47
2,8482122.0,Brock Faber,D,MIN,21,82,8,39,47
2,8477426.0,Nicholas Paul,L,TBL,28,82,24,22,46
2,8475784.0,Jeff Skinner,L,BUF,31,74,24,22,46
2,8483808.0,Andrei Kuzmenko,L,CGY,27,72,22,24,46
2,8475170.0,Brayden Schenn,C,STL,32,82,20,26,46
2,8478407.0,Vince Dunn,D,SEA,27,59,11,35,46
2,8475760.0,Nick Bjugstad,C,ARI,31,76,22,23,45
2,8477451.0,Ryan Hartman,R,MIN,29,74,21,24,45
2,8478519.0,Anthony Cirelli,C,TBL,26,79,20,25,45
2,8477964.0,Ivan Barbashev,C,VGK,28,82,19,26,45
2,8478438.0,Tommy Novak,C,NSH,26,71,18,27,45
2,8482667.0,William Eklund,L,SJS,21,80,16,29,45
2,8477021.0,Alex Kerfoot,C,ARI,29,82,13,32,45
2,8475218.0,Mattias Ekholm,D,EDM,33,79,11,34,45
2,8480188.0,Fabian Zetterlund,L,SJS,24,82,24,20,44
2,8475169.0,Evander Kane,L,EDM,32,77,24,20,44
2,8477511.0,Anthony Mantha,R,WSH,29,74,23,21,44
2,8474586.0,Jordan Eberle,R,SEA,33,78,17,27,44
2,8477496.0,Elias Lindholm,C,VAN,29,75,15,29,44
2,8477948.0,Travis Sanheim,D,PHI,27,81,10,34,44
2,8477479.0,Tyler Bertuzzi,L,TOR,28,80,21,22,43
2,8478466.0,Daniel Sprong,R,DET,26,76,18,25,43
2,8470613.0,Brent Burns,D,CAR,38,82,10,33,43
2,8476438.0,Brandon Saad,L,STL,31,82,26,16,42
2,8477407.0,Anthony Duclair,L,SJS,28,73,24,18,42
2,8478474.0,Lawson Crouse,L,ARI,26,81,23,19,42
2,8480893.0,Kirill Marchenko,R,CBJ,23,78,23,19,42
2,8482745.0,Mason McTavish,C,ANA,20,64,19,23,42
2,8481542.0,Moritz Seider,D,DET,22,82,9,33,42
2,8477447.0,Shea Theodore,D,VGK,28,47,5,37,42
2,8477935.0,Sam Bennett,C,FLA,27,69,20,21,41
2,8477998.0,Warren Foegele,L,EDM,27,82,20,21,41
2,8480009.0,Eeli Tolvanen,R,SEA,24,81,16,25,41
2,8479345.0,Jakob Chychrun,D,OTT,25,82,14,27,41
2,8480028.0,Morgan Frost,C,PHI,24,71,13,28,41
2,8478462.0,Nicolas Roy,C,VGK,26,70,13,28,41
2,8476458.0,Ryan Strome,C,ANA,30,79,11,30,41
2,8480434.0,Sean Durzi,D,ARI,25,76,9,32,41
2,8482079.0,Marco Rossi,C,MIN,22,82,21,19,40
2,8478498.0,Jake DeBrusk,L,BOS,27,80,19,21,40
2,8479365.0,Trent Frederic,C,BOS,25,82,18,22,40
2,8479525.0,Ross Colton,C,COL,27,80,17,23,40
2,8479400.0,Pierre-Luc Dubois,C,LAK,25,82,16,24,40
2,8478233.0,Andrew Mangiapane,L,CGY,27,75,14,26,40
2,8475191.0,Reilly Smith,R,PIT,32,76,13,27,40
2,8479987.0,Morgan Geekie,C,BOS,25,76,17,22,39
2,8482146.0,Luke Evangelista,R,NSH,21,80,16,23,39
2,8474150.0,Mikael Backlund,C,CGY,34,82,15,24,39
2,8476872.0,Scott Laughton,C,PHI,29,82,13,26,39
2,8478542.0,Evan Rodrigues,C,FLA,30,80,12,27,39
2,8478055.0,Gustav Forsling,D,FLA,27,79,10,29,39
2,8478397.0,Rasmus Andersson,D,CGY,27,78,9,30,39
2,8475764.0,Cam Fowler,D,ANA,32,81,5,34,39
2,8476792.0,Torey Krug,D,STL,32,77,4,35,39
2,8482089.0,Jake Neighbours,L,STL,21,77,27,11,38
2,8482149.0,Cole Perfetti,C,WPG,21,71,19,19,38
2,8476881.0,Tomas Hertl,C,SJS,30,54,17,21,38
2,8474037.0,James van Riemsdyk,L,BOS,34,71,11,27,38
2,8482105.0,Jake Sanderson,D,OTT,21,79,10,28,38
2,8475314.0,Anders Lee,L,NYI,33,81,20,17,37
2,8473422.0,Nick Foligno,L,CHI,36,74,17,20,37
2,8482665.0,Matty Beniers,C,SEA,21,77,15,22,37
2,8476483.0,Rickard Rakell,R,PIT,30,70,15,22,37
2,8476474.0,Stefan Noesen,R,CAR,30,81,14,23,37
2,8476480.0,Vladislav Namestnikov,C,WPG,31,78,11,26,37
2,8476958.0,Jaccob Slavin,D,CAR,29,81,6,31,37
2,8481535.0,Nils Hoglander,L,VAN,23,80,24,12,36
2,8480014.0,Gabriel Vilardi,C,WPG,24,47,22,14,36
2,8473986.0,Alex Killorn,L,ANA,34,63,18,18,36
2,8478046.0,Danton Heinen,L,BOS,28,74,17,19,36
2,8478891.0,Mason Appleton,C,WPG,27,82,14,22,36
2,8476432.0,Boone Jenner,C,CBJ,30,58,22,13,35
2,8477450.0,Jason Dickinson,C,CHI,28,82,22,13,35
2,8476880.0,Tom Wilson,R,WSH,29,74,18,17,35
2,8482699.0,Dylan Guenther,R,ARI,20,45,18,17,35
2,8475287.0,Erik Haula,L,NJD,32,76,16,19,35
2,8476925.0,Colton Sissons,C,NSH,30,81,15,20,35
2,8482720.0,Matthew Knies,L,TOR,21,80,15,20,35
2,8482113.0,Anton Lundell,C,FLA,22,78,13,22,35
2,8476392.0,Adam Lowry,C,WPG,30,81,12,23,35
2,8478472.0,Mathieu Joseph,R,OTT,26,72,11,24,35
2,8475799.0,Nino Niederreiter,R,WPG,31,77,18,16,34
2,8477476.0,Artturi Lehkonen,L,COL,28,45,16,18,34
2,8481618.0,Alex Newhook,C,MTL,22,55,15,19,34
2,8482159.0,Tyson Foerster,R,PHI,21,77,20,13,33
2,8482110.0,Dawson Mercer,C,NJD,22,82,20,13,33
2,8481580.0,Connor McMichael,C,WSH,22,80,18,15,33
2,8482055.0,Drew O'Connor,L,PIT,25,79,16,17,33
2,8477429.0,Andrew Copp,C,DET,29,79,13,20,33
2,8479992.0,Michael Rasmussen,C,DET,24,75,13,20,33
2,8476826.0,Yanni Gourde,C,SEA,32,80,11,22,33
2,8476419.0,Jean-Gabriel Pageau,C,NYI,31,82,11,22,33
2,8477986.0,Brandon Montour,D,FLA,29,66,8,25,33
2,8482671.0,Owen Power,D,BUF,21,76,6,27,33
2,8478178.0,Darren Raddysh,D,TBL,27,82,6,27,33
2,8480145.0,Neal Pionk,D,WPG,28,82,5,28,33
2,8474565.0,Alex Pietrangelo,D,VGK,33,64,4,29,33
2,8478057.0,Dakota Joshua,C,VAN,27,63,18,14,32
2,8477952.0,Robby Fabbri,C,DET,27,68,18,14,32
2,8476921.0,Jordan Martinook,L,CAR,31,82,14,18,32
2,8475722.0,Jason Zucker,L,ARI,31,69,14,18,32
2,8482705.0,Cole Sillinger,C,CBJ,20,77,13,19,32
2,8477498.0,Darnell Nurse,D,EDM,28,81,10,22,32
2,8475171.0,Oliver Ekman-Larsson,D,FLA,32,80,9,23,32
2,8478500.0,Ivan Provorov,D,CBJ,26,82,5,27,32
2,8474151.0,Ryan McDonagh,D,NSH,34,74,3,29,32
2,8474870.0,Tyler Johnson,C,CHI,33,67,17,14,31
2,8475848.0,Brendan Gallagher,R,MTL,31,77,16,15,31
2,8474189.0,Lars Eller,C,PIT,34,82,15,16,31
2,8476292.0,Ondrej Palat,L,NJD,32,71,11,20,31
2,8481624.0,Ilya Mikheyev,R,VAN,29,78,11,20,31
2,8478458.0,Jack Roslovic,C,CBJ,26,59,9,22,31
2,8477495.0,Seth Jones,D,CHI,29,67,8,23,31
2,8476979.0,Erik Gustafsson,D,NYR,31,76,6,25,31
2,8476331.0,Dylan DeMelo,D,WPG,30,82,3,28,31
2,8480064.0,Josh Norris,C,OTT,24,50,16,14,30
2,8475768.0,Jaden Schwartz,C,SEA,31,62,13,17,30
2,8480802.0,Ryan McLeod,C,EDM,24,81,12,18,30
2,8477987.0,Ryan Donato,C,CHI,27,78,12,18,30
2,8475149.0,Marcus Johansson,L,MIN,33,78,11,19,30
2,8481546.0,Cam York,D,PHI,22,82,10,20,30
2,8477505.0,Alex Wennberg,C,SEA,29,79,10,20,30
2,8473533.0,Jordan Staal,C,CAR,35,80,10,20,30
2,8478469.0,Thomas Chabot,D,OTT,26,51,9,21,30
2,8480817.0,K'Andre Miller,D,NYR,23,80,8,22,30
2,8477969.0,Marcus Pettersson,D,PIT,27,82,4,26,30
2,8475753.0,Justin Faulk,D,STL,31,60,2,28,30
2,8479619.0,Michael Carcone,L,ARI,27,74,21,8,29
2,8482475.0,Yegor Chinakhov,R,CBJ,22,53,16,13,29
2,8480459.0,Pius Suter,C,VAN,27,67,14,15,29
2,8475763.0,Kevin Hayes,R,STL,31,79,13,16,29
2,8481524.0,Bowen  Byram,D,COL,22,73,11,18,29
2,8480336.0,Sean Walker,D,PHI,29,81,10,19,29
2,8481656.0,Aliaksei Protas,C,WSH,22,78,6,23,29
2,8474574.0,Tyler Myers,D,VAN,33,77,5,24,29
2,8482125.0,Alexander Holtz,R,NJD,21,82,16,12,28
2,8480813.0,Joe Veleno,C,DET,23,80,12,16,28
2,8480068.0,Ryan Poehling,C,PHI,24,77,11,17,28
2,8478413.0,Jordan Greenway,L,BUF,26,67,10,18,28
2,8478115.0,Pierre Engvall,L,NYI,27,74,10,18,28
2,8476923.0,Damon Severson,D,CBJ,29,67,9,19,28
2,8476931.0,Jake McCabe,D,TOR,30,73,8,20,28
2,8478133.0,Jake Evans,C,MTL,27,82,7,21,28
2,8476927.0,Teddy Blueger,C,VAN,29,68,6,22,28
2,8475181.0,Nick Leddy,D,STL,32,82,3,25,28
2,8478020.0,Michael Amadio,R,VGK,27,73,14,13,27
2,8481582.0,Nicholas Robertson,L,TOR,22,56,14,13,27
2,8480185.0,Eetu Luostarinen,C,FLA,25,82,12,15,27
2,8480829.0,Jesperi Kotkaniemi,C,CAR,23,79,12,15,27
2,8480113.0,Alex Iafallo,L,WPG,30,82,11,16,27
2,8480748.0,Kiefer Sherwood,L,NSH,28,68,10,17,27
2,8481596.0,Shane Pinto,C,OTT,23,41,9,18,27
2,8480835.0,Jack Drury,C,CAR,23,74,8,19,27
2,8476463.0,Jonas Brodin,D,MIN,30,62,7,20,27
2,8482092.0,Ridly Greig,C,OTT,21,72,13,13,26
2,8476918.0,Jimmy Vesey,L,NYR,30,80,13,13,26
2,8476892.0,Colton Parayko,D,STL,30,82,10,16,26
2,8479941.0,Justin Danforth,R,CBJ,30,71,10,16,26
2,8477425.0,Miles Wood,L,COL,28,74,9,17,26
2,8480855.0,Jack McBain,C,ARI,23,67,8,18,26
2,8474602.0,Justin Schultz,D,SEA,33,70,7,19,26
2,8475790.0,Erik Gudbranson,D,CBJ,31,78,6,20,26
2,8475200.0,Dmitry Orlov,D,CAR,32,82,6,20,26
2,8482655.0,J.J. Moser,D,ARI,23,80,5,21,26
2,8476902.0,Esa Lindell,D,DAL,29,82,5,21,26
2,8475188.0,Brayden McNabb,D,VGK,32,82,4,22,26
2,8476854.0,Hampus Lindholm,D,BOS,29,73,3,23,26
2,8474673.0,TJ Brodie,D,TOR,33,78,1,25,26
2,8476469.0,Joel Armia,R,MTL,30,66,17,8,25
2,8481601.0,Simon Holmstrom,R,NYI,22,75,15,10,25
2,8481186.0,Logan O'Connor,R,COL,27,57,13,12,25
2,8471698.0,T.J. Oshie,R,WSH,37,52,12,13,25
2,8479591.0,Michael Eyssimont,C,TBL,27,81,11,14,25
2,8476312.0,Josh Manson,D,COL,32,76,8,17,25
2,8478136.0,Jake Middleton,D,MIN,27,80,7,18,25
2,8481032.0,Paul Cotter,C,VGK,24,76,7,18,25
2,8477508.0,Curtis Lazar,C,NJD,28,71,7,18,25
2,8482245.0,Artem Zub,D,OTT,28,69,5,20,25
2,8478911.0,Matt Roy,D,LAK,28,81,5,20,25
2,8476879.0,Cody Ceci,D,EDM,30,79,5,20,25
2,8478507.0,John Marino,D,NJD,26,75,4,21,25
2,8478840.0,Will Borgen,D,SEA,27,82,3,22,25
2,8482259.0,Bobby McMann,C,TOR,27,56,15,9,24
2,8481604.0,Pavel Dorofeyev,L,VGK,23,47,13,11,24
2,8478043.0,Sam Lafferty,C,VAN,28,79,13,11,24
2,8479351.0,Sam Steel,C,DAL,25,77,9,15,24
2,8475193.0,Tomas Tatar,L,SEA,33,70,9,15,24
2,8475744.0,Evgeny Kuznetsov,C,WSH,31,63,8,16,24
2,8475233.0,David Savard,D,MTL,33,60,6,18,24
2,8476422.0,Mike Reilly,D,NYI,30,61,6,18,24
2,8474031.0,Kevin Shattenkirk,D,BOS,34,61,6,18,24
2,8473507.0,Jeff Petry,D,DET,36,73,3,21,24
2,8480246.0,Nick Perbix,D,TBL,25,77,2,22,24
2,8481606.0,Jordan Spence,D,LAK,22,71,2,22,24
2,8477947.0,Sonny Milano,L,WSH,27,49,15,8,23
2,8475793.0,Ryan Johansen,C,COL,31,63,13,10,23
2,8480821.0,Filip Zadina,R,SJS,24,72,13,10,23
2,8474149.0,Evgenii Dadonov,R,DAL,34,51,12,11,23
2,8475231.0,Casey Cizikas,C,NYI,32,70,10,13,23
2,8474884.0,Mike Hoffman,C,SJS,34,66,10,13,23
2,8482062.0,Cole Smith,L,NSH,28,80,9,14,23
2,8478882.0,Vladislav Gavrikov,D,LAK,28,77,6,17,23
2,8474157.0,Max Pacioretty,L,WSH,35,47,4,19,23
2,8480873.0,Rasmus Sandin,D,WSH,23,68,3,20,23
2,8480043.0,Timothy Liljegren,D,TOR,24,55,3,20,23
2,8475343.0,Nic Dowd,C,WSH,33,64,12,10,22
2,8470621.0,Corey Perry,R,EDM,38,54,12,10,22
2,8473449.0,Kyle Okposo,R,BUF,35,67,12,10,22
2,8477446.0,Michael McCarron,R,NSH,28,70,12,10,22
2,8481517.0,Brett Leason,R,ANA,24,68,11,11,22
2,8478970.0,Jalen Chatfield,D,CAR,27,72,8,14,22
2,8481014.0,Alexander Romanov,D,NYI,23,81,7,15,22
2,8482087.0,Kaiden Guhle,D,MTL,21,70,6,16,22
2,8477953.0,Kasperi Kapanen,R,STL,27,73,6,16,22
2,8476885.0,Jacob Trouba,D,NYR,29,69,3,19,22
2,8480281.0,Alexey Toropchenko,R,STL,24,82,14,7,21
2,8482157.0,Will Cuylle,L,NYR,21,81,13,8,21
2,8478013.0,Jake Walman,D,DET,27,63,12,9,21
2,8475714.0,Calle Jarnkrok,C,TOR,32,52,10,11,21
2,8475220.0,Marcus Foligno,L,MIN,32,55,9,12,21
2,8471218.0,Blake Wheeler,R,NYR,37,54,9,12,21
2,8479359.0,Beck Malenstyn,L,WSH,25,81,6,15,21
2,8476897.0,Oskar Sundqvist,C,STL,29,71,6,15,21
2,8481178.0,Egor Zamula,D,PHI,23,66,5,16,21
2,8480891.0,Michael Kesselring,D,ARI,23,65,5,16,21
2,8479983.0,Mario Ferraro,D,SJS,25,78,3,18,21
2,8475225.0,Craig Smith,C,DAL,34,75,11,9,20
2,8476981.0,Josh Anderson,R,MTL,29,78,9,11,20
2,8475455.0,Brenden Dillon,D,WPG,33,77,8,12,20
2,8481577.0,Philip Tomasino,C,NSH,22,41,7,13,20
2,8477507.0,Nikita Zadorov,D,VAN,28,75,6,14,20
2,8475279.0,Ben Chiarot,D,DET,32,77,5,15,20
2,8478851.0,Alexandre Carrier,D,NSH,27,73,4,16,20
2,8480035.0,Henri Jokiharju,D,BUF,24,74,3,17,20
2,8480073.0,Erik Brannstrom,D,OTT,24,76,3,17,20
2,8475179.0,Dmitry Kulikov,D,FLA,33,76,1,19,20
2,8481554.0,Kaapo Kakko,R,NYR,22,61,13,6,19
2,8480980.0,Connor Dewar,C,MIN,24,74,11,8,19
2,8479415.0,Michael McLeod,C,NJD,25,45,10,9,19
2,8482097.0,Jack Quinn,R,BUF,22,27,9,10,19
2,8480144.0,David Kampf,C,TOR,28,78,8,11,19
2,8479353.0,Brett Howden,C,VGK,25,72,8,11,19
2,8475164.0,Jakob Silfverberg,R,ANA,33,81,7,12,19
2,8476889.0,Radek Faksa,C,DAL,29,74,7,12,19
2,8473504.0,Cal Clutterbuck,R,NYI,36,82,7,12,19
2,8475855.0,Jesper Fast,R,CAR,32,73,6,13,19
2,8477380.0,Jonny Brodzinski,C,NYR,30,57,6,13,19
2,8471699.0,Andrew Cogliano,C,COL,36,75,6,13,19
2,8477506.0,Ryan Pulock,D,NYI,29,58,5,14,19
2,8480172.0,Jan Rutta,D,SJS,33,69,5,14,19
2,8482073.0,Braden Schneider,D,NYR,22,82,5,14,19
2,8478432.0,Christian Fischer,R,DET,26,79,5,14,19
2,8479410.0,Mikhail Sergachev,D,TBL,25,34,2,17,19
2,8475690.0,Chris Tanev,D,CGY,34,75,2,17,19
2,8480878.0,Nils Lundkvist,D,DAL,23,59,2,17,19
2,8479316.0,Luke Kunin,C,SJS,26,77,11,7,18
2,8480289.0,Morgan Barron,C,WPG,25,80,11,7,18
2,8476374.0,Sean Kuraly,C,CBJ,30,62,9,9,18
2,8480448.0,Parker Kelly,L,OTT,24,80,8,10,18
2,8478434.0,Keegan Kolesar,R,VGK,26,79,8,10,18
2,8475462.0,Radko Gudas,D,ANA,33,66,6,12,18
2,8480220.0,Noah Cates,L,PHI,24,59,6,12,18
2,8476457.0,Adam Larsson,D,SEA,31,81,4,14,18
2,8477932.0,Aaron Ekblad,D,FLA,27,51,4,14,18
2,8477365.0,Connor Clifton,D,BUF,28,79,4,14,18
2,8476874.0,Olli Maatta,D,DET,29,72,4,14,18
2,8479398.0,Samuel Girard,D,COL,25,59,3,15,18
2,8479998.0,Mikey Anderson,D,LAK,24,74,2,16,18
2,8480049.0,Dylan Samberg,D,WPG,24,78,1,17,18
2,8478508.0,Yakov Trenin,C,NSH,26,76,12,5,17
2,8477903.0,Garnet Hathaway,R,PHI,32,82,7,10,17
2,8480995.0,Pontus Holmberg,R,TOR,24,54,7,10,17
2,8479315.0,Joey Anderson,R,CHI,25,55,5,12,17
2,8478463.0,Anthony Beauvillier,L,CHI,26,60,5,12,17
2,8474166.0,Alec Martinez,D,VGK,36,55,4,13,17
2,8481522.0,Peyton Krebs,C,BUF,22,80,4,13,17
2,8478859.0,Niko Mikkola,D,FLA,27,82,3,14,17
2,8479324.0,Ryan Lindgren,D,NYR,25,76,3,14,17
2,8481605.0,Jackson LaCombe,D,ANA,22,71,2,15,17
2,8479976.0,Juuso Valimaki,D,ARI,25,68,2,15,17
2,8470600.0,Ryan Suter,D,DAL,38,82,2,15,17
2,8480884.0,Calen Addison,D,SJS,23,72,1,16,17
2,8475842.0,Sam Carrick,C,ANA,31,77,10,6,16
2,8479977.0,Kailer Yamamoto,R,SEA,25,59,8,8,16
2,8473453.0,Trevor Lewis,C,LAK,36,82,8,8,16
2,8480205.0,Emil Bemstrom,R,CBJ,24,56,8,8,16
2,8479293.0,Brandon Tanev,L,SEA,32,66,7,9,16
2,8477444.0,Andre Burakovsky,L,SEA,28,49,7,9,16
2,8475208.0,Brian Dumoulin,D,SEA,32,80,6,10,16
2,8482660.0,Kent Johnson,C,CBJ,21,42,6,10,16
2,8477979.0,Nicolas Aube-Kubel,R,WSH,27,60,6,10,16
2,8476462.0,Dougie Hamilton,D,NJD,30,20,5,11,16
2,8482117.0,Lukas Reichel,L,CHI,21,65,5,11,16
2,8474034.0,Pat Maroon,L,MIN,35,51,4,12,16
2,8480796.0,Martin Fehervary,D,WSH,24,66,3,13,16
2,8476967.0,Brett Kulak,D,EDM,29,82,3,13,16
2,8471677.0,Jack Johnson,D,COL,36,80,3,13,16
2,8481568.0,Alex Vlasic,D,CHI,22,76,2,14,16
2,8476917.0,Adam Pelech,D,NYI,29,58,1,15,16
2,8479423.0,Alex Nylander,L,PIT,25,28,11,4,15
2,8478831.0,Kevin Stenlund,C,FLA,27,81,11,4,15
2,8470604.0,Jeff Carter,C,PIT,38,72,11,4,15
2,8477330.0,Dominik Kubalik,L,OTT,28,74,11,4,15
2,8476873.0,Mark Jankowski,C,NSH,29,32,7,8,15
2,8476393.0,Nick Cousins,C,FLA,30,69,7,8,15
2,8481560.0,Arthur Kaliyev,R,LAK,22,51,7,8,15
2,8481481.0,Blake Lizotte,C,LAK,26,62,7,8,15
2,8478109.0,Victor Olofsson,L,BUF,28,51,7,8,15
2,8481533.0,Trevor Zegras,C,ANA,22,31,6,9,15
2,8478042.0,Viktor Arvidsson,R,LAK,30,18,6,9,15
2,8474090.0,Brendan Smith,D,NJD,34,63,5,10,15
2,8477919.0,Frederick Gaudreau,C,MIN,30,67,5,10,15
2,8479368.0,Max Jones,L,ANA,25,52,5,10,15
2,8477839.0,Conor Sheary,L,TBL,31,57,4,11,15
2,8476467.0,Jamie Oleksiak,D,SEA,31,82,2,13,15
2,8475197.0,Tyson Barrie,D,NSH,32,41,1,14,15
2,8476878.0,Zemgus Girgensons,L,BUF,29,63,8,6,14
2,8480011.0,Klim Kostin,C,DET,24,52,8,6,14
2,8479661.0,Tanner Jeannot,L,TBL,26,55,7,7,14
2,8478468.0,Jeremy Lauzon,D,NSH,26,79,6,8,14
2,8480003.0,Jesper Boqvist,C,BOS,25,47,6,8,14
2,8479390.0,Taylor Raddysh,R,CHI,25,73,5,9,14
2,8477070.0,Liam O'Brien,C,ARI,29,75,5,9,14
2,8478443.0,Brandon Carlo,D,BOS,27,76,4,10,14
2,8480879.0,Jacob Bernard-Docker,D,OTT,23,72,4,10,14
2,8477392.0,Hudson Fasching,R,NYI,28,45,4,10,14
2,8477435.0,Ryan Graves,D,PIT,28,70,3,11,14
2,8474567.0,Zach Bogosian,D,MIN,33,65,3,11,14
2,8480887.0,Jordan Harris,D,MTL,23,56,3,11,14
2,8480727.0,Zach Whitecloud,D,VGK,27,61,2,12,14
2,8477220.0,Nate Schmidt,D,WPG,32,63,2,12,14
2,8475324.0,Nick Jensen,D,WSH,33,78,1,13,14
2,8480001.0,Urho Vaakanainen,D,ANA,24,68,1,13,14
2,8477845.0,Trevor van Riemsdyk,D,WSH,32,70,0,14,14
2,8482111.0,Justin Barron,D,MTL,22,48,7,6,13
2,8479383.0,Boris Katchouk,L,CHI,25,59,7,6,13
2,8477573.0,Nathan Walker,L,STL,29,45,7,6,13
2,8480192.0,Johnathan Kovacevic,D,MTL,26,62,6,7,13
2,8479996.0,Cody Glass,C,NSH,24,41,6,7,13
2,8481477.0,Nico Sturm,C,SJS,28,63,5,8,13
2,8476871.0,Tanner Pearson,L,MTL,31,54,5,8,13
2,8479520.0,Brandon Duhaime,R,MIN,26,80,5,8,13
2,8479402.0,Jake Bean,D,CBJ,25,72,4,9,13
2,8482222.0,Alexander Barabanov,L,SJS,29,46,4,9,13
2,8477488.0,Brett Pesce,D,CAR,29,70,3,10,13
2,8479371.0,Dante Fabbro,D,NSH,25,56,3,10,13
2,8478416.0,Erik Cernak,D,TBL,26,69,2,11,13
2,8476372.0,Nick Seeler,D,PHI,30,71,1,12,13
2,8481704.0,Juuso Parssinen,C,NSH,22,44,8,4,12
2,8476278.0,Colin Blackwell,C,CHI,30,44,8,4,12
2,8479336.0,Carl Grundstrom,R,LAK,26,50,8,4,12
2,8471709.0,Marc-Edouard Vlasic,D,SJS,36,57,6,6,12
2,8479393.0,Noah Gregor,C,TOR,25,63,6,6,12
2,8478421.0,A.J. Greer,L,CGY,27,59,6,6,12
2,8479671.0,Mathieu Olivier,R,CBJ,26,54,5,7,12
2,8477846.0,Ryan Carpenter,C,SJS,32,62,5,7,12
2,8478585.0,Derek Ryan,C,EDM,37,70,5,7,12
2,8479414.0,Nathan Bastian,R,NJD,26,54,5,7,12
2,8477015.0,Connor Brown,R,EDM,29,71,4,8,12
2,8476624.0,Barclay Goodrow,C,NYR,30,80,4,8,12
2,8477406.0,Mattias Janmark,C,EDM,31,71,4,8,12
2,8476919.0,Chris Tierney,C,NJD,29,52,4,8,12
2,8479543.0,Michael Pezzetta,L,MTL,25,61,3,9,12
2,8475825.0,Jani Hakanpää,D,DAL,31,64,2,10,12
2,8479980.0,Nicolas Hague,D,VGK,25,73,2,10,12
2,8476822.0,Luke Glendening,C,TBL,34,81,10,1,11
2,8482133.0,Thomas Bordeleau,C,SJS,21,27,6,5,11
2,8480806.0,Isac Lundestrom,C,ANA,24,46,5,6,11
2,8480025.0,MacKenzie Entwistle,R,CHI,24,67,5,6,11
2,8475750.0,Jon Merrill,D,MIN,31,65,4,7,11
2,8481567.0,Henry Thrun,D,SJS,22,51,3,8,11
2,8477950.0,Tony DeAngelo,D,CAR,28,31,3,8,11
2,8474013.0,Ian Cole,D,VAN,34,78,2,9,11
2,8476891.0,Matt Grzelcyk,D,BOS,29,63,2,9,11
2,8480058.0,Pierre-Olivier Joseph,D,PIT,24,52,2,9,11
2,8480860.0,Kevin Bahl,D,NJD,23,82,1,10,11
2,8479576.0,Vincent Desharnais,D,EDM,27,78,1,10,11
2,8470610.0,Zach Parise,L,COL,39,30,5,5,10
2,8476858.0,Phillip Di Giuseppe,L,VAN,30,51,5,5,10
2,8474040.0,Sam Gagner,C,EDM,34,28,5,5,10
2,8480355.0,Mark Kastelic,C,OTT,24,63,5,5,10
2,8482142.0,Jamie Drysdale,D,PHI,21,34,3,7,10
2,8480849.0,Barrett Hayton,C,ARI,23,33,3,7,10
2,8475177.0,Calvin de Haan,D,TBL,32,59,3,7,10
2,8482964.0,Arber Xhekaj,D,MTL,22,44,3,7,10
2,8477384.0,Josh Brown,D,ARI,29,51,3,7,10
2,8480184.0,Gustav Lindström,D,ANA,25,46,3,7,10
2,8480762.0,Eric Robinson,L,BUF,28,47,3,7,10
2,8477018.0,Ben Hutton,D,VGK,30,41,2,8,10
2,8481093.0,Rafael Harvey-Pinard,L,MTL,24,45,2,8,10
2,8480880.0,Jakub Lauko,C,BOS,23,60,2,8,10
2,8480871.0,Adam Boqvist,D,CBJ,23,35,1,9,10
2,8479369.0,Andrew Peeke,D,CBJ,25,38,1,9,10
2,8479982.0,Conor Timmins,D,TOR,25,25,1,9,10
2,8483460.0,David Jiricek,D,CBJ,20,43,1,9,10
2,8477971.0,Andreas Englund,D,LAK,27,82,1,9,10
2,8471274.0,Alex Goligoski,D,MIN,38,36,0,10,10
2,8479439.0,Jacob MacDonald,D,SJS,30,34,7,2,9
2,8479339.0,Patrik Laine,L,CBJ,25,18,6,3,9
2,8477353.0,Tyler Motte,C,TBL,28,69,6,3,9
2,8482077.0,Dylan Holloway,L,EDM,22,38,6,3,9
2,8479718.0,Alex Barré-Boulet,C,TBL,26,36,6,3,9
2,8477989.0,Christian Dvorak,C,MTL,27,30,5,4,9
2,8479328.0,Julien Gauthier,R,NYI,26,27,5,4,9
2,8479968.0,Vinni Lettieri,C,MIN,28,46,5,4,9
2,8476525.0,Colin Miller,D,NJD,31,46,4,5,9
2,8470966.0,Mark Giordano,D,TOR,40,46,3,6,9
2,8482679.0,Matt Coronato,R,CGY,21,34,3,6,9
2,8480008.0,Adam Ruzicka,C,ARI,24,42,3,6,9
2,8481641.0,Joel Kiviranta,L,COL,27,56,3,6,9
2,8478028.0,Fredrik Olofsson,L,COL,27,57,3,6,9
2,8480222.0,Sebastian Aho,D,NYI,27,58,2,7,9
2,8481708.0,Zac Jones,D,NYR,23,31,2,7,9
2,8476960.0,Andreas Athanasiou,C,CHI,29,28,2,7,9
2,8480848.0,Ty Dellandrea,C,DAL,23,42,2,7,9
2,8478099.0,Kevin Labanc,R,SJS,28,46,2,7,9
2,8478399.0,Jonas Siegenthaler,D,NJD,26,57,1,8,9
2,8481527.0,Kaedan Korczak,D,VGK,22,26,1,8,9
2,8481537.0,Nikita Okhotiuk,D,SJS,23,52,1,8,9
2,8475797.0,Jarred Tinordi,D,CHI,31,52,0,9,9
2,8479372.0,Josh Mahura,D,FLA,25,30,0,9,9
2,8477478.0,William Carrier,L,VGK,29,39,6,2,8
2,8480252.0,Cole Guttman,C,CHI,24,27,4,4,8
2,8481058.0,Jesse Ylönen,R,MTL,24,59,4,4,8
2,8474709.0,Matt Martin,L,NYI,34,57,4,4,8
2,8477541.0,Dakota Mermis,D,MIN,29,47,3,5,8
2,8478211.0,Dryden Hunt,L,CGY,28,28,3,5,8
2,8476473.0,Connor Murphy,D,CHI,30,46,2,6,8
2,8477335.0,Kyle Burroughs,D,SJS,28,73,2,6,8
2,8474618.0,Marco Scandella,D,STL,33,65,2,6,8
2,8476329.0,Travis Boyd,C,ARI,30,16,2,6,8
2,8480196.0,Jacob Bryson,D,BUF,26,36,1,7,8
2,8478450.0,Parker Wotherspoon,D,BOS,26,41,0,8,8
2,8480950.0,Ilya Lyubushkin,D,ANA,29,74,0,8,8
2,8479066.0,Ryan Lomberg,L,FLA,29,75,5,2,7
2,8478569.0,Noel Acciari,C,PIT,32,55,4,3,7
2,8477930.0,Pierre-Edouard Bellemare,L,SEA,38,40,4,3,7
2,8482241.0,Radim Zohorna,L,PIT,27,33,4,3,7
2,8482624.0,Daniil Miromanov,D,VGK,26,24,3,4,7
2,8479346.0,Dillon Dube,C,CGY,25,43,3,4,7
2,8482496.0,Nils Aman,C,VAN,23,43,3,4,7
2,8481019.0,David Gustafsson,C,WPG,23,39,3,4,7
2,8478408.0,Travis Dermott,D,ARI,27,50,2,5,7
2,8479458.0,Nikita Zaitsev,D,CHI,32,38,2,5,7
2,8481167.0,Brayden Pachal,D,CGY,24,50,2,5,7
2,8480084.0,Nick DeSimone,D,NJD,29,34,2,5,7
2,8482652.0,Walker Duehr,R,CGY,26,40,2,5,7
2,8480807.0,Mattias Samuelsson,D,BUF,23,41,1,6,7
2,8479442.0,Troy Stecher,D,ARI,29,54,1,6,7
2,8482516.0,Matthew Kessel,D,STL,23,39,1,6,7
2,8474568.0,Luke Schenn,D,NSH,34,63,1,6,7
2,8478454.0,Noah Juulsen,D,VAN,26,54,1,6,7
2,8478502.0,Dennis Gilbert,D,CGY,27,34,1,6,7
2,8478104.0,Sammy Blais,L,STL,27,53,1,6,7
2,8482176.0,Wyatt Kaiser,D,CHI,21,32,0,7,7
2,8473446.0,Erik Johnson,D,BUF,35,67,5,1,6
2,8471817.0,Ryan Reaves,R,TOR,36,49,4,2,6
2,8479370.0,Tyson Jost,C,BUF,25,43,3,3,6
2,8477369.0,Carson Soucy,D,VAN,29,40,2,4,6
2,8474612.0,Travis Hamonic,D,OTT,33,48,2,4,6
2,8482730.0,Brandt Clarke,D,LAK,20,16,2,4,6
2,8477944.0,Jakub Vrana,L,STL,27,21,2,4,6
2,8477931.0,Tomas Nosek,L,NJD,31,36,2,4,6
2,8480789.0,Oliver Wahlstrom,R,NYI,23,32,2,4,6
2,8481013.0,Jonatan Berggren,R,DET,23,12,2,4,6
2,8476441.0,Joel Edmundson,D,WSH,30,53,1,5,6
2,8482192.0,Isaak Phillips,D,CHI,22,33,0,6,6
2,8480078.0,Filip Chytil,C,NYR,24,10,0,6,6
2,8483524.0,Shane Wright,C,SEA,19,8,4,1,5
2,8477962.0,Brendan Lemieux,L,CAR,27,32,3,2,5
2,8481541.0,Samuel Bolduc,D,NYI,23,34,2,3,5
2,8481147.0,Reese Johnson,C,CHI,25,42,2,3,5
2,8481422.0,Jacob Lucchini,C,MIN,28,40,2,3,5
2,8479536.0,Axel Jonsson-Fjallby,L,WPG,25,26,2,3,5
2,8481122.0,Simon Benoit,D,TOR,25,64,1,4,5
2,8477938.0,Haydn Fleury,D,TBL,27,24,1,4,5
2,8477810.0,Joel Hanley,D,DAL,32,42,1,4,5
2,8471686.0,Marc Staal,D,PHI,36,35,1,4,5
2,8474009.0,Nick Bonino,C,NYR,35,45,1,4,5
2,8476952.0,Dominic Toninato,C,WPG,29,15,1,4,5
2,8479547.0,Matthew Phillips,R,PIT,25,31,1,4,5
2,8480245.0,Olle Lycksell,R,PHI,24,18,1,4,5
2,8474716.0,Jared Spurgeon,D,MIN,34,16,0,5,5
2,8475906.0,John Klingberg,D,TOR,31,14,0,5,5
2,8476429.0,Scott Mayfield,D,NYI,31,41,0,5,5
2,8475718.0,Justin Holl,D,DET,31,38,0,5,5
2,8478452.0,Caleb Jones,D,COL,26,25,0,5,5
2,8479291.0,Kevin Rooney,C,CGY,30,33,3,1,4
2,8479344.0,Jesse Puljujarvi,R,PIT,25,22,3,1,4
2,8478051.0,Max Willman,C,NJD,28,18,3,1,4
2,8475791.0,Taylor Hall,L,CHI,32,10,2,2,4
2,8481056.0,Spencer Stastney,D,NSH,23,20,2,2,4
2,8476867.0,Brendan Gaunce,C,CBJ,29,24,2,2,4
2,8479981.0,Jonah Gadjovich,L,FLA,25,39,2,2,4
2,8475766.0,Austin Watson,L,TBL,31,33,2,2,4
2,8477499.0,Rasmus Ristolainen,D,PHI,29,31,1,3,4
2,8478451.0,Ethan Bear,D,WSH,26,24,1,3,4
2,8481609.0,Vladislav Kolyachonok,D,ARI,22,5,1,3,4
2,8477244.0,Chad Ruhwedel,D,PIT,33,52,1,3,4
2,8476442.0,Matt Nieto,L,PIT,31,22,1,3,4
2,8479994.0,Jaret Anderson-Dolan,C,LAK,24,31,1,3,4
2,8475752.0,Tyler Pitlick,C,NYR,32,34,1,3,4
2,8481532.0,Alex Turcotte,C,LAK,22,20,1,3,4
2,8477527.0,Ross Johnston,L,ANA,29,68,1,3,4
2,8475235.0,Nicolas Deslauriers,L,PHI,32,60,1,3,4
2,8476913.0,Devin Shore,C,SEA,29,21,1,3,4
2,8479379.0,Givani Smith,R,SJS,25,36,1,3,4
2,8475762.0,Derek Forbort,D,BOS,31,35,0,4,4
2,8478424.0,Jansen Harkins,C,PIT,26,45,0,4,4
2,8480441.0,Trey Fix-Wolansky,R,CBJ,24,11,2,1,3
2,8478078.0,Rourke Chartier,C,OTT,27,37,2,1,3
2,8480776.0,Sheldon Rempal,R,VGK,28,9,2,1,3
2,8480468.0,James Hamblin,L,EDM,24,31,2,1,3
2,8479772.0,Zack MacEwen,R,OTT,27,30,2,1,3
2,8477073.0,Kurtis MacDermid,D,COL,29,45,2,1,3
2,8480823.0,Alexander Alexeyev,D,WSH,24,39,1,2,3
2,8480007.0,Jonas Rondbjerg,R,VGK,24,20,1,2,3
2,8476934.0,Brock McGinn,L,ANA,29,24,1,2,3
2,8478409.0,Anthony Richard,C,BOS,27,9,1,2,3
2,8483570.0,Ben Meyers,C,COL,25,23,1,2,3
2,8476994.0,Vinnie Hinostroza,C,PIT,29,14,1,2,3
2,8481592.0,Jakob Pelletier,L,CGY,22,13,1,2,3
2,8478904.0,Steven Lorentz,C,FLA,27,38,1,2,3
2,8479972.0,Mason Shaw,C,MIN,25,20,1,2,3
2,8480853.0,Liam Foudy,C,NSH,23,13,0,3,3
2,8482762.0,Simon Edvinsson,D,DET,20,16,1,1,2
2,8482101.0,Danil Gushchin,L,SJS,21,4,1,1,2
2,8479378.0,Logan Stanley,D,WPG,25,25,1,1,2
2,8481006.0,Tyler Tucker,D,STL,23,26,1,1,2
2,8478495.0,Denis Gurianov,R,NSH,26,18,1,1,2
2,8479362.0,Riley Tufte,L,COL,25,5,1,1,2
2,8480292.0,Carson Meyer,R,CBJ,26,14,1,1,2
2,8477454.0,Adam Erne,L,EDM,28,24,1,1,2
2,8475780.0,Chris Wagner,R,BOS,32,13,1,1,2
2,8476988.0,Matt Benning,D,SJS,29,14,0,2,2
2,8477034.0,Jaycob Megna,D,CHI,31,44,0,2,2
2,8481521.0,Ronnie Attard,D,PHI,24,12,0,2,2
2,8480070.0,Ian Mitchell,D,BOS,24,13,0,2,2
2,8477851.0,Jordan Oesterle,D,CGY,31,22,0,2,2
2,8481161.0,Jake Christiansen,D,CBJ,24,12,0,2,2
2,8482451.0,Mikael Pyyhtia,L,CBJ,22,17,0,2,2
2,8473473.0,Milan Lucic,L,BOS,35,4,0,2,2
2,8480870.0,Bo Groulx,C,ANA,23,45,0,2,2
2,8481598.0,Philip Broberg,D,EDM,22,12,0,2,2
2,8477464.0,Nic Petan,C,MIN,28,6,0,2,2
2,8481617.0,Vasily Podkolzin,R,VAN,22,19,0,2,2
2,8481751.0,Lukas Rousek,R,BUF,24,15,0,2,2
2,8481550.0,Adam Beckman,L,MIN,22,11,0,2,2
2,8481523.0,Kirby Dach,C,MTL,22,2,0,2,2
2,8481543.0,Nikita Alexandrov,C,STL,23,23,0,2,2
2,8478146.0,Matthew Highmore,C,OTT,27,7,0,2,2
2,8481043.0,Cole Koepke,L,TBL,25,9,0,2,2
2,8483565.0,Nick Blankenburg,D,CBJ,25,12,1,0,1
2,8483397.0,Marc McLaughlin,C,BOS,24,1,1,0,1
2,8480874.0,Adam Ginning,D,PHI,23,9,1,0,1
2,8481754.0,Nikita Nesterenko,C,ANA,22,3,1,0,1
2,8480021.0,Jack Studnicka,C,SJS,24,22,1,0,1
2,8481518.0,Nolan Foote,L,NJD,23,4,1,0,1
2,8479421.0,Jacob Moverare,D,LAK,25,24,1,0,1
2,8481239.0,Samuel Fagemo,L,LAK,23,8,1,0,1
2,8479546.0,Oskar Steen,C,BOS,25,34,1,0,1
2,8480836.0,Jonathan Gruden,C,PIT,23,13,1,0,1
2,8481077.0,John Leonard,L,NSH,25,6,1,0,1
2,8482147.0,Jean-Luc Foudy,C,COL,21,4,1,0,1
2,8474053.0,Logan Couture,C,SJS,34,6,0,1,1
2,8481812.0,Nikolai Knyzhov,D,SJS,26,10,0,1,1
2,8479984.0,Cal Foote,D,NJD,25,4,0,1,1
2,8479321.0,Lucas Johansen,D,WSH,26,6,0,1,1
2,8473563.0,Nicklas Backstrom,C,WSH,36,8,0,1,1
2,8479320.0,Max Lajoie,D,TOR,26,7,0,1,1
2,8482095.0,Tyler Kleven,D,OTT,21,9,0,1,1
2,8480157.0,Calle Rosen,D,STL,29,6,0,1,1
2,8480031.0,Max Comtois,L,ANA,24,1,0,1,1
2,8478017.0,Mark Friedman,D,VAN,28,23,0,1,1
2,8479348.0,Kale Clague,D,BUF,25,3,0,1,1
2,8475278.0,Byron Froese,C,VGK,32,16,0,1,1
2,8475795.0,Dylan McIlrath,D,WSH,31,3,0,1,1
2,8480845.0,Rasmus Kupari,C,WPG,23,28,0,1,1
2,8480890.0,Jan Jenik,R,ARI,23,5,0,1,1
2,8477887.0,Patrick Brown,C,BOS,31,11,0,1,1
2,8478512.0,Austin Czarnik,C,DET,31,34,0,1,1
2,8479367.0,William Lockwood,R,FLA,25,26,0,1,1
2,8483597.0,Milos Kelemen,L,ARI,24,10,0,1,1
2,8477126.0,Jayson Megna,C,ANA,33,1,0,0,0
2,8479639.0,Dylan Coghlan,D,CAR,25,1,0,0,0
2,8482067.0,Connor Mackey,D,NYR,27,1,0,0,0
2,8476856.0,Matt Dumba,D,ARI,29,0,0,0,0
2,8478483.0,Mitchell Marner,R,TOR,26,0,0,0,0
2,8471873.0,Anton Stralman,D,BOS,37,0,0,0,0
2,8474162.0,Jake Muzzin,D,TOR,34,0,0,0,0
2,8470638.0,Patrice Bergeron,C,BOS,38,0,0,0,0
2,8473604.0,Jonathan Toews,C,CHI,35,0,0,0,0
2,8471276.0,David Krejci,C,BOS,37,0,0,0,0
2,8474207.0,Nick Holden,D,OTT,36,0,0,0,0
2,8475747.0,Patrik Nemeth,D,ARI,31,0,0,0,0
2,8477467.0,Gustav Olofsson,D,SEA,29,1,0,0,0
2,8479514.0,Rem Pitlick,C,CHI,26,9,0,0,0
2,8474027.0,Justin Braun,D,PHI,36,0,0,0,0
2,8481599.0,Victor Soderstrom,D,ARI,22,3,0,0,0
2,8474161.0,Jakub Voracek,R,CBJ,34,0,0,0,0
2,8479985.0,Cale Fleury,D,SEA,25,1,0,0,0
2,8471303.0,Alexander Edler,D,LAK,37,0,0,0,0
2,8474573.0,Josh Bailey,R,NYI,34,0,0,0,0
2,8483619.0,Filip Roos,D,CHI,24,4,0,0,0
2,8474818.0,Jordie Benn,D,TOR,36,0,0,0,0
2,8476449.0,Scott Harrington,D,ANA,30,0,0,0,0
2,8483620.0,Marcus Bjork,D,CBJ,26,0,0,0,0
2,8470595.0,Eric Staal,C,FLA,39,0,0,0,0
2,8481585.0,Egor Afanasyev,L,NSH,22,2,0,0,0
2,8482712.0,Oskar Olausson,R,COL,21,1,0,0,0
2,8481072.0,Tim Berni,D,CBJ,23,0,0,0,0
2,8479945.0,Gavin Bayreuther,D,CBJ,29,0,0,0,0
2,8481600.0,Tobias Bjornfot,D,VGK,22,4,0,0,0
2,8481679.0,Maxence Guenette,D,OTT,22,7,0,0,0
2,8474683.0,Derek Grant,C,ANA,33,0,0,0,0
2,8476470.0,Nathan Beaulieu,D,ANA,31,0,0,0,0
2,8474145.0,Robert Bortuzzo,D,NYI,34,27,0,0,0
2,8480216.0,Jacob Peterson,C,SJS,24,6,0,0,0
2,8473548.0,Phil Kessel,R,VGK,36,0,0,0,0
2,8480160.0,Radim Simek,D,SJS,31,0,0,0,0
2,8480883.0,Ty Smith,D,PIT,23,0,0,0,0
2,8471669.0,Paul Stastny,C,CAR,38,0,0,0,0
2,8475227.0,Chris Wideman,D,MTL,33,0,0,0,0
2,8480913.0,Jordan Gross,D,NSH,28,0,0,0,0
2,8475625.0,Matt Irwin,D,WSH,36,0,0,0,0
2,8479388.0,Riley Stillman,D,BUF,25,0,0,0,0
2,8474628.0,Michael Stone,D,CGY,33,0,0,0,0
2,8484254.0,Akito Hirose,D,VAN,24,3,0,0,0
2,8477941.0,Nick Ritchie,L,CGY,28,0,0,0,0
2,8477462.0,Robert Hagg,D,ANA,28,5,0,0,0
2,8478062.0,Dysin Mayo,D,ARI,27,0,0,0,0
2,8482634.0,Alex Steeves,C,TOR,24,1,0,0,0
2,8477433.0,Ben Harpur,D,NYR,28,0,0,0,0
2,8478841.0,Colton White,D,ANA,26,0,0,0,0
2,8473544.0,Derick Brassard,C,OTT,36,0,0,0,0
2,8476884.0,Derrick Pouliot,D,SJS,29,5,0,0,0
2,8479376.0,Victor Mete,D,PHI,25,1,0,0,0
2,8483630.0,Pavol Regenda,L,ANA,24,5,0,0,0
2,8479026.0,Philippe Myers,D,TBL,26,5,0,0,0
2,8477482.0,Zach Sanford,L,CHI,29,0,0,0,0
2,8477359.0,Tucker Poolman,D,VAN,30,0,0,0,0
2,8475857.0,Kevin Gravel,D,NSH,31,0,0,0,0
2,8476779.0,Brad Hunt,D,COL,35,0,0,0,0
2,8476850.0,Ryan Murray,D,EDM,30,0,0,0,0
2,8477341.0,Andreas Johnsson,L,SJS,29,0,0,0,0
2,8474218.0,Jason Demers,D,EDM,35,0,0,0,0
2,8480844.0,Grigori Denisenko,L,VGK,23,6,0,0,0
2,8484287.0,Cole McWard,D,VAN,22,1,0,0,0
2,8479322.0,Wade Allison,R,PHI,26,0,0,0,0
2,8478846.0,Christian Wolanin,D,VAN,28,0,0,0,0
2,8471887.0,Patric Hornqvist,R,FLA,36,0,0,0,0
2,8475163.0,Alex Chiasson,R,DET,33,0,0,0,0
2,8478881.0,Brett Seney,L,CHI,27,4,0,0,0
2,8474697.0,Mark Borowiecki,D,NSH,34,0,0,0,0
2,8476410.0,Josh Leivo,L,STL,30,0,0,0,0
2,8475968.0,Alex Belzile,R,MTL,32,0,0,0,0
2,8479580.0,Dylan Gambrell,C,OTT,27,0,0,0,0
2,8480901.0,Karson Kuhlman,C,WPG,28,0,0,0,0
2,8480326.0,Sheldon Dries,C,VAN,29,0,0,0,0
2,8478465.0,Guillaume Brisebois,D,VAN,26,0,0,0,0
2,8482861.0,Vincent Iorio,D,WSH,21,6,0,0,0
2,8471794.0,Darren Helm,C,COL,36,0,0,0,0
2,8479335.0,Rasmus Asplund,C,NSH,26,0,0,0,0
2,8478415.0,Jakub Zboril,D,BOS,26,0,0,0,0
2,8476310.0,Lukas Sedlak,C,PHI,30,0,0,0,0
2,8478075.0,Anders Bjork,L,CHI,27,0,0,0,0
2,8480267.0,Sammy Walker,C,MIN,24,4,0,0,0
2,8479578.0,Casey Fitzgerald,D,FLA,26,0,0,0,0
2,8480032.0,Shane Bowers,C,NJD,24,8,0,0,0
2,8478400.0,Colin White,C,PIT,26,28,0,0,0
2,8478431.0,Evgeny Svechnikov,L,SJS,27,0,0,0,0
2,8475772.0,Riley Sheahan,C,BUF,32,0,0,0,0
2,8481690.0,Tyler Angle,C,CBJ,23,2,0,0,0
2,8476326.0,Josh Archibald,R,PIT,31,0,0,0,0
2,8478843.0,Denis Malgin,C,COL,26,0,0,0,0
2,8478446.0,Glenn Gawdin,C,ANA,26,1,0,0,0
2,8477357.0,Saku Maenalanen,R,WPG,29,0,0,0,0
2,8478870.0,Rudolfs Balcers,L,TBL,26,0,0,0,0
2,8478476.0,Kyle Capobianco,D,WPG,26,0,0,0,0
2,8476439.0,Brett Ritchie,R,ARI,30,0,0,0,0
2,8474613.0,Derek Stepan,C,CAR,33,0,0,0,0
2,8475178.0,Zack Kassian,R,ARI,32,0,0,0,0
2,8480226.0,Marián Studenic,R,SEA,25,2,0,0,0
2,8481070.0,Hugh McGing,L,STL,25,5,0,0,0
2,8482250.0,Callahan Burke,C,CAR,26,1,0,0,0
2,8481591.0,Sam Poulin,R,PIT,22,3,0,0,0
2,8481441.0,Joe Snively,C,WSH,27,3,0,0,0
2,8478967.0,Lane Pederson,C,CBJ,26,0,0,0,0
2,8479333.0,Libor Hajek,D,NYR,25,0,0,0,0
2,8480833.0,Vitali Kravtsov,R,VAN,24,0,0,0,0
2,8477460.0,Laurent Dauphin,C,ARI,28,0,0,0,0
2,8481461.0,Corey Schueneman,D,MTL,28,0,0,0,0
2,8474190.0,Wayne Simmonds,R,TOR,35,0,0,0,0
2,8483549.0,Lucas Condotta,L,MTL,26,3,0,0,0
2,8477993.0,Justin Kirkland,C,ARI,27,2,0,0,0
2,8480935.0,Lawrence Pilut,D,BUF,28,0,0,0,0
2,8477210.0,Buddy Robinson,R,CHI,32,0,0,0,0
2,8476851.0,Alex Galchenyuk,C,COL,29,0,0,0,0
2,8482197.0,Adam Raska,R,MIN,22,5,0,0,0
2,8479366.0,Logan Brown,C,STL,25,0,0,0,0
2,8479356.0,Kieffer Bellows,L,PHI,25,0,0,0,0
2,8479533.0,Joona Koppanen,L,PIT,25,4,0,0,0
2,8477401.0,John Hayden,C,SEA,28,2,0,0,0
2,8480822.0,Martin Kaut,R,SJS,24,0,0,0,0
2,8474610.0,Zac Dalpe,C,FLA,34,0,0,0,0
2,8482399.0,Billy Sweezey,D,CBJ,27,0,0,0,0
2,8479991.0,Jake Leschyshyn,C,NYR,24,1,0,0,0
2,8479550.0,Tanner Laczynski,C,PHI,26,0,0,0,0
2,8476166.0,Taylor Fedun,D,PIT,35,0,0,0,0
2,8479338.0,Markus Niemelainen,D,EDM,25,0,0,0,0
2,8477320.0,Anton Blidh,L,NYR,28,1,0,0,0
2,8478147.0,Bokondji Imama,L,ARI,27,6,0,0,0
2,8478067.0,Oskar Lindblom,L,SJS,27,1,0,0,0
2,8478506.0,Gabriel Carlsson,D,WSH,26,0,0,0,0
2,8478131.0,Ondrej Kase,R,CAR,28,0,0,0,0
2,8479644.0,Matt Luff,R,DET,26,0,0,0,0
2,8482824.0,Nick Cicek,D,SJS,23,0,0,0,0
2,8482834.0,Jesper Froden,R,SEA,29,0,0,0,0
2,8478491.0,Jacob Larsson,D,OTT,26,0,0,0,0
2,8474089.0,Brad Malone,C,EDM,34,0,0,0,0
2,8482641.0,Matt Kiersted,D,FLA,25,0,0,0,0
2,8480071.0,Robin Salo,D,NYI,25,0,0,0,0
2,8475461.0,Andrew Agozzino,L,SJS,32,0,0,0,0
2,8475160.0,Kyle Clifford,L,TOR,32,0,0,0,0
2,8480056.0,Jack Rathbone,D,VAN,24,0,0,0,0
2,8481725.0,Elmer Soderblom,L,DET,22,0,0,0,0
2,8479465.0,Drake Caggiula,L,PIT,29,0,0,0,0
2,8476948.0,Charles Hudon,L,COL,29,0,0,0,0
2,8479523.0,Lucas Carlsson,D,FLA,26,0,0,0,0
2,8478455.0,Austin Wagner,L,CHI,26,0,0,0,0
2,8481572.0,Ville Heinola,D,WPG,22,0,0,0,0
2,8479404.0,Henrik Borgstrom,C,WSH,26,0,0,0,0
2,8479944.0,Zach Aston-Reese,C,DET,29,3,0,0,0
2,8482635.0,Mike Hardman,L,CHI,24,0,0,0,0
2,8479705.0,Jeffrey Viel,L,SJS,26,0,0,0,0
2,8480467.0,Austin Strand,D,ANA,26,0,0,0,0
2,8480037.0,Aleksi Heponiemi,C,FLA,24,0,0,0,0
2,8479573.0,Mikhail Maltsev,L,COL,25,0,0,0,0
2,8476404.0,Andy Andreoff,C,NYI,32,0,0,0,0
2,8484125.0,Hunter McKown,C,CBJ,21,0,0,0,0
2,8481649.0,Joona Luoto,L,CBJ,26,0,0,0,0
2,8477981.0,Roland McKeown,D,NSH,27,0,0,0,0
2,8480831.0,Alec Regula,D,CHI,23,0,0,0,0
2,8482691.0,Aatu Raty,C,VAN,21,0,0,0,0
2,8482623.0,Josh Dunne,C,CBJ,25,0,0,0,0
2,8481433.0,Taro Hirose,L,DET,27,0,0,0,0
2,8480328.0,David Gust,R,CHI,29,0,0,0,0
2,8479526.0,Otto Koivula,L,NYI,25,0,0,0,0
2,8476390.0,Joseph Cramarossa,C,MIN,31,0,0,0,0
2,8482654.0,Jackson Cates,C,PHI,26,0,0,0,0
2,8480439.0,Mac Hollowell,D,TOR,25,0,0,0,0
2,8480072.0,Lias Andersson,C,LAK,25,0,0,0,0
2,8479395.0,Dennis Cholowski,D,NYI,25,0,0,0,0
2,8477463.0,Steven Santini,D,STL,28,0,0,0,0
2,8479347.0,Tyler Benson,L,EDM,25,0,0,0,0
2,8477471.0,Dillon Heatherington,D,OTT,28,0,0,0,0
2,8477520.0,Jean-Sebastien Dea,C,ARI,29,0,0,0,0
2,8480846.0,Sampo Ranta,L,COL,23,0,0,0,0
2,8480979.0,Nathan Smith,C,ARI,25,0,0,0,0
2,8484256.0,Jake Livingstone,D,NSH,24,0,0,0,0
2,8476396.0,Steven Fogarty,C,MIN,30,0,0,0,0
2,8479252.0,Dan Renouf,D,BOS,29,0,0,0,0
2,8479518.0,Fredrik Karlström,C,DAL,25,0,0,0,0
2,8481683.0,Aidan McDonough,L,VAN,24,0,0,0,0
2,8478373.0,Nikita Soshnikov,R,NYI,30,0,0,0,0
2,8482081.0,Sean Farrell,C,MTL,22,0,0,0,0
2,8481575.0,Lassi Thomson,D,OTT,23,0,0,0,0
2,8481102.0,Egor Sokolov,L,OTT,23,0,0,0,0
2,8481712.0,Matej Blumel,R,DAL,23,0,0,0,0
2,8479602.0,Jeremy Davies,D,BUF,27,0,0,0,0
2,8480443.0,Kristian Reichel,C,WPG,25,0,0,0,0
2,8479304.0,Kyle Criscuolo,C,SJS,31,0,0,0,0
2,8478224.0,Luke Philp,C,CHI,28,0,0,0,0
2,8480242.0,Arnaud Durandeau,L,NYI,24,0,0,0,0
2,8479329.0,Frederic Allard,D,MTL,26,0,0,0,0
2,8476941.0,Connor Carrick,D,BOS,29,0,0,0,0
2,8479375.0,William Bitten,C,STL,25,0,0,0,0
2,8481720.0,Nick Abruzzese,C,TOR,24,0,0,0,0
2,8482452.0,Elliot Desnoyers,L,PHI,21,0,0,0,0
2,8476915.0,Jujhar Khaira,L,MIN,29,1,0,0,0
2,8483641.0,Anton Levtchi,L,FLA,28,0,0,0,0
2,8481740.0,Tyce Thompson,R,NJD,24,0,0,0,0
2,8478173.0,Hayden Hodgson,R,PHI,27,0,0,0,0
2,8482181.0,Tristen Robins,C,SJS,22,0,0,0,0
2,8481563.0,Drew Helleson,D,ANA,22,0,0,0,0
2,8480863.0,Gabriel Fortier,L,TBL,23,0,0,0,0
2,8478058.0,CJ Suess,L,SJS,29,0,0,0,0
2,8480041.0,Dmitri Samorukov,D,STL,24,0,0,0,0
2,8482179.0,Justin Richards,C,CBJ,25,0,0,0,0
2,8480034.0,Joel Teasdale,L,MTL,24,0,0,0,0
2,8480820.0,Filip Kral,D,TOR,24,0,0,0,0
2,8480842.0,Filip Hallander,C,PIT,23,0,0,0,0
2,8478367.0,Cole Bardreau,C,NYI,30,0,0,0,0
2,8482448.0,Samuel Knazko,D,CBJ,21,0,0,0,0
2,8482711.0,Stanislav Svozil,D,CBJ,20,0,0,0,0
2,8480275.0,Nick Swaney,R,MIN,26,0,0,0,0
2,8480994.0,Damien Giroux,C,MIN,23,0,0,0,0
2,8480977.0,Semyon Der-Arguchintsev,C,TOR,23,0,0,0,0
2,8482207.0,William Dufour,R,NYI,21,0,0,0,0
2,8483464.0,Marco Kasper,C,DET,19,0,0,0,0
2,8483424.0,Owen Beck,C,MTL,19,0,0,0,0
3,8476453.0,Nikita Kucherov,R,TBL,30,81,44,100,144
3,8477492.0,Nathan MacKinnon,C,COL,28,82,51,89,140
3,8478402.0,Connor McDavid,C,EDM,26,76,32,100,132
3,8478550.0,Artemi Panarin,L,NYR,32,82,49,71,120
3,8477956.0,David Pastrnak,R,BOS,27,82,47,63,110
3,8479318.0,Auston Matthews,C,TOR,26,81,69,38,107
3,8477934.0,Leon Draisaitl,C,EDM,28,81,41,65,106
3,8478420.0,Mikko Rantanen,R,COL,27,80,42,62,104
3,8476468.0,J.T. Miller,C,VAN,30,81,37,66,103
3,8477939.0,William Nylander,R,TOR,27,82,40,58,98
3,8478864.0,Kirill Kaprizov,L,MIN,26,75,46,50,96
3,8477933.0,Sam Reinhart,C,FLA,28,82,57,37,94
3,8476887.0,Filip Forsberg,L,NSH,29,82,48,46,94
3,8471675.0,Sidney Crosby,C,PIT,36,82,42,52,94
3,8480800.0,Quinn Hughes,D,VAN,24,82,17,75,92
3,8478010.0,Brayden Point,C,TBL,27,81,46,44,90
3,8480069.0,Cale Makar,D,COL,25,77,21,69,90
3,8478427.0,Sebastian Aho,C,CAR,26,78,36,53,89
3,8480012.0,Elias Pettersson,C,VAN,25,82,34,55,89
3,8479314.0,Matthew Tkachuk,L,FLA,26,80,26,62,88
3,8480023.0,Robert Thomas,C,STL,24,82,26,60,86
3,8474600.0,Roman Josi,D,NSH,33,82,23,62,85
3,8479407.0,Jesper Bratt,L,NJD,25,82,27,56,83
3,8480803.0,Evan Bouchard,D,EDM,24,81,18,64,82
3,8474564.0,Steven Stamkos,C,TBL,33,79,40,41,81
3,8480027.0,Jason Robertson,L,DAL,24,82,29,51,80
3,8478445.0,Mathew Barzal,C,NYI,26,80,23,57,80
3,8477493.0,Aleksander Barkov,C,FLA,28,73,23,57,80
3,8475786.0,Zach Hyman,L,EDM,31,80,54,23,77
3,8480018.0,Nick Suzuki,C,MTL,24,82,33,44,77
3,8477404.0,Jake Guentzel,L,PIT,29,67,30,47,77
3,8476389.0,Vincent Trocheck,C,NYR,30,82,25,52,77
3,8479343.0,Clayton Keller,R,ARI,25,78,33,43,76
3,8475167.0,Victor Hedman,D,TBL,33,78,13,63,76
3,8475184.0,Chris Kreider,L,NYR,32,82,39,36,75
3,8475172.0,Nazem Kadri,C,CGY,33,82,29,46,75
3,8477960.0,Adrian Kempe,R,LAK,27,77,28,47,75
3,8479542.0,Brandon Hagel,L,TBL,25,82,26,49,75
3,8474679.0,Gustav Nyquist,C,NSH,34,81,23,52,75
3,8480801.0,Brady Tkachuk,L,OTT,24,81,37,37,74
3,8481559.0,Jack Hughes,C,NJD,22,62,27,47,74
3,8478444.0,Brock Boeser,R,VAN,26,81,40,33,73
3,8477942.0,Kevin Fiala,L,LAK,27,82,29,44,73
3,8479323.0,Adam Fox,D,NYR,25,72,17,56,73
3,8477409.0,Carter Verhaeghe,C,FLA,28,76,34,38,72
3,8482078.0,Lucas Raymond,L,DET,21,82,31,41,72
3,8476459.0,Mika Zibanejad,C,NYR,30,81,26,46,72
3,8476460.0,Mark Scheifele,C,WPG,30,74,25,47,72
3,8471685.0,Anze Kopitar,C,LAK,36,81,26,44,70
3,8482116.0,Tim Stützle,C,OTT,21,75,18,52,70
3,8480865.0,Noah Dobson,D,NYI,23,79,10,60,70
3,8476539.0,Jonathan Marchessault,R,VGK,33,82,42,27,69
3,8475754.0,Brock Nelson,C,NYI,32,82,34,35,69
3,8477946.0,Dylan Larkin,C,DET,27,68,33,36,69
3,8475158.0,Ryan O'Reilly,C,NSH,32,82,26,43,69
3,8477504.0,Josh Morrissey,D,WPG,28,81,10,59,69
3,8478439.0,Travis Konecny,R,PHI,26,76,33,35,68
3,8477500.0,Bo Horvat,C,NYI,28,81,33,35,68
3,8478403.0,Jack Eichel,C,VGK,27,63,31,37,68
3,8481557.0,Matt Boldy,L,MIN,22,75,29,39,68
3,8482093.0,Seth Jarvis,C,CAR,21,81,33,34,67
3,8479385.0,Jordan Kyrou,C,STL,25,82,31,36,67
3,8473419.0,Brad Marchand,L,BOS,35,82,29,38,67
3,8480002.0,Nico Hischier,C,NJD,24,71,27,40,67
3,8471215.0,Evgeni Malkin,C,PIT,37,82,27,40,67
3,8478440.0,Dylan Strome,C,WSH,26,82,27,40,67
3,8479337.0,Alex DeBrincat,R,DET,26,82,27,40,67
3,8470794.0,Joe Pavelski,C,DAL,39,82,27,40,67
3,8476454.0,Ryan Nugent-Hopkins,C,EDM,30,80,18,49,67
3,8480208.0,Drake Batherson,R,OTT,25,82,28,38,66
3,8482740.0,Wyatt Johnston,C,DAL,20,82,32,33,65
3,8471214.0,Alex Ovechkin,L,WSH,38,79,31,34,65
3,8478449.0,Roope Hintz,C,DAL,27,80,30,35,65
3,8475166.0,John Tavares,C,TOR,33,80,29,36,65
3,8481540.0,Cole Caufield,R,MTL,22,82,28,37,65
3,8475168.0,Matt Duchene,C,DAL,32,80,25,40,65
3,8478493.0,Joel Eriksson Ek,C,MIN,26,77,30,34,64
3,8473512.0,Claude Giroux,R,OTT,35,82,21,43,64
3,8477402.0,Pavel Buchnevich,L,STL,28,80,27,36,63
3,8475692.0,Mats Zuccarello,R,MIN,36,69,12,51,63
3,8477955.0,Jared McCann,L,SEA,27,80,29,33,62
3,8476875.0,Mike Matheson,D,MTL,29,82,11,51,62
3,8478398.0,Kyle Connor,L,WPG,27,65,34,27,61
3,8477940.0,Nikolaj Ehlers,L,WPG,27,82,25,36,61
3,8477951.0,Nick Schmaltz,C,ARI,27,79,22,39,61
3,8478366.0,Frank Vatrano,R,ANA,29,82,37,23,60
3,8476448.0,William Karlsson,C,VGK,30,70,30,30,60
3,8475745.0,Charlie Coyle,C,BOS,31,82,25,35,60
3,8473994.0,Jamie Benn,L,DAL,34,82,21,39,60
3,8475798.0,Mikael Granlund,C,SJS,31,69,12,48,60
3,8476346.0,Johnny Gaudreau,L,CBJ,30,81,12,48,60
3,8481068.0,Yegor Sharangovich,C,CGY,25,82,31,28,59
3,8477497.0,Sean Monahan,C,WPG,29,83,26,33,59
3,8477949.0,Alex Tuch,R,BUF,27,75,22,37,59
3,8478401.0,Pavel Zacha,C,BOS,26,78,21,38,59
3,8480839.0,Rasmus Dahlin,D,BUF,23,81,20,39,59
3,8477416.0,Oliver Bjorkstrand,R,SEA,28,82,20,39,59
3,8476853.0,Morgan Rielly,D,TOR,29,72,7,51,58
3,8479675.0,Trevor Moore,L,LAK,28,82,31,26,57
3,8482109.0,Alexis Lafrenière,L,NYR,22,82,28,29,57
3,8479999.0,Casey Mittelstadt,C,BUF,25,80,18,39,57
3,8481711.0,Matias Maccelli,L,ARI,23,82,17,40,57
3,8478460.0,Zach Werenski,D,CBJ,26,70,11,46,57
3,8479420.0,Tage Thompson,C,BUF,26,71,29,27,56
3,8475810.0,Bryan Rust,R,PIT,31,62,28,28,56
3,8477494.0,Jonathan Drouin,L,COL,28,79,19,37,56
3,8474578.0,Erik Karlsson,D,PIT,33,82,11,45,56
3,8476906.0,Shayne Gostisbehere,D,DET,30,81,10,46,56
3,8475726.0,Tyler Toffoli,R,NJD,31,79,33,22,55
3,8475765.0,Vladimir Tarasenko,R,OTT,32,76,23,32,55
3,8482124.0,Quinton Byfield,R,LAK,21,80,20,35,55
3,8478047.0,Michael Bunting,L,CAR,28,81,19,36,55
3,8475151.0,Kyle Palmieri,C,NYI,32,82,30,24,54
3,8476399.0,Blake Coleman,C,CGY,32,78,30,24,54
3,8478873.0,Troy Terry,R,ANA,26,76,20,34,54
3,8480798.0,Philipp Kurashev,C,CHI,24,75,18,36,54
3,8480036.0,Miro Heiskanen,D,DAL,24,71,9,45,54
3,8477501.0,Valeri Nichushkin,R,COL,28,54,28,25,53
3,8480015.0,Owen Tippett,R,PHI,24,78,28,25,53
3,8476882.0,Teuvo Teravainen,L,CAR,29,76,25,28,53
3,8480039.0,Martin Necas,C,CAR,24,77,24,29,53
3,8478975.0,Mason Marchment,L,DAL,28,81,22,31,53
3,8475913.0,Mark Stone,R,VGK,31,56,16,37,53
3,8478414.0,Timo Meier,R,NJD,27,69,28,24,52
3,8475794.0,Tyler Seguin,C,DAL,31,68,25,27,52
3,8477346.0,MacKenzie Weegar,D,CGY,29,82,20,32,52
3,8480830.0,Andrei Svechnikov,R,CAR,23,59,19,33,52
3,8476456.0,Jonathan Huberdeau,C,CGY,30,81,12,40,52
3,8474590.0,John Carlson,D,WSH,33,82,10,42,52
3,8474641.0,Adam Henrique,C,ANA,33,82,24,27,51
3,8476905.0,Chandler Stephenson,C,VGK,29,75,16,35,51
3,8471724.0,Kris Letang,D,PIT,36,82,10,41,51
3,8482175.0,JJ Peterka,R,BUF,21,82,28,22,50
3,8480797.0,Joel Farabee,L,PHI,23,82,22,28,50
3,8483515.0,Juraj Slafkovsky,L,MTL,19,82,20,30,50
3,8474563.0,Drew Doughty,D,LAK,34,82,15,35,50
3,8478038.0,Devon Toews,D,COL,29,82,12,38,50
3,8477456.0,J.T. Compher,L,DET,28,77,19,29,48
3,8479425.0,Filip Hronek,D,VAN,26,81,5,43,48
3,8474141.0,Patrick Kane,R,DET,35,50,20,27,47
3,8478856.0,Conor Garland,R,VAN,27,82,20,27,47
3,8481528.0,Dylan Cozens,C,BUF,22,79,18,29,47
3,8476479.0,Phillip Danault,C,LAK,30,78,17,30,47
3,8474102.0,David Perron,L,DET,35,76,17,30,47
3,8481581.0,Thomas Harley,D,DAL,22,79,15,32,47
3,8478396.0,Noah Hanifin,D,CGY,26,80,13,34,47
3,8476869.0,Brady Skjei,D,CAR,29,80,13,34,47
3,8479325.0,Charlie McAvoy,D,BOS,26,74,12,35,47
3,8482684.0,Luke Hughes,D,NJD,20,82,9,38,47
3,8477503.0,Max Domi,C,TOR,28,80,9,38,47
3,8482122.0,Brock Faber,D,MIN,21,82,8,39,47
3,8477426.0,Nicholas Paul,L,TBL,28,82,24,22,46
3,8475784.0,Jeff Skinner,L,BUF,31,74,24,22,46
3,8483808.0,Andrei Kuzmenko,L,CGY,27,72,22,24,46
3,8475170.0,Brayden Schenn,C,STL,32,82,20,26,46
3,8478407.0,Vince Dunn,D,SEA,27,59,11,35,46
3,8475760.0,Nick Bjugstad,C,ARI,31,76,22,23,45
3,8477451.0,Ryan Hartman,R,MIN,29,74,21,24,45
3,8478519.0,Anthony Cirelli,C,TBL,26,79,20,25,45
3,8477964.0,Ivan Barbashev,C,VGK,28,82,19,26,45
3,8478438.0,Tommy Novak,C,NSH,26,71,18,27,45
3,8482667.0,William Eklund,L,SJS,21,80,16,29,45
3,8477021.0,Alex Kerfoot,C,ARI,29,82,13,32,45
3,8475218.0,Mattias Ekholm,D,EDM,33,79,11,34,45
3,8480188.0,Fabian Zetterlund,L,SJS,24,82,24,20,44
3,8475169.0,Evander Kane,L,EDM,32,77,24,20,44
3,8477511.0,Anthony Mantha,R,WSH,29,74,23,21,44
3,8474586.0,Jordan Eberle,R,SEA,33,78,17,27,44
3,8477496.0,Elias Lindholm,C,VAN,29,75,15,29,44
3,8477948.0,Travis Sanheim,D,PHI,27,81,10,34,44
3,8477479.0,Tyler Bertuzzi,L,TOR,28,80,21,22,43
3,8478466.0,Daniel Sprong,R,DET,26,76,18,25,43
3,8470613.0,Brent Burns,D,CAR,38,82,10,33,43
3,8476438.0,Brandon Saad,L,STL,31,82,26,16,42
3,8477407.0,Anthony Duclair,L,SJS,28,73,24,18,42
3,8478474.0,Lawson Crouse,L,ARI,26,81,23,19,42
3,8480893.0,Kirill Marchenko,R,CBJ,23,78,23,19,42
3,8482745.0,Mason McTavish,C,ANA,20,64,19,23,42
3,8481542.0,Moritz Seider,D,DET,22,82,9,33,42
3,8477447.0,Shea Theodore,D,VGK,28,47,5,37,42
3,8477935.0,Sam Bennett,C,FLA,27,69,20,21,41
3,8477998.0,Warren Foegele,L,EDM,27,82,20,21,41
3,8480009.0,Eeli Tolvanen,R,SEA,24,81,16,25,41
3,8479345.0,Jakob Chychrun,D,OTT,25,82,14,27,41
3,8480028.0,Morgan Frost,C,PHI,24,71,13,28,41
3,8478462.0,Nicolas Roy,C,VGK,26,70,13,28,41
3,8476458.0,Ryan Strome,C,ANA,30,79,11,30,41
3,8480434.0,Sean Durzi,D,ARI,25,76,9,32,41
3,8482079.0,Marco Rossi,C,MIN,22,82,21,19,40
3,8478498.0,Jake DeBrusk,L,BOS,27,80,19,21,40
3,8479365.0,Trent Frederic,C,BOS,25,82,18,22,40
3,8479525.0,Ross Colton,C,COL,27,80,17,23,40
3,8479400.0,Pierre-Luc Dubois,C,LAK,25,82,16,24,40
3,8478233.0,Andrew Mangiapane,L,CGY,27,75,14,26,40
3,8475191.0,Reilly Smith,R,PIT,32,76,13,27,40
3,8479987.0,Morgan Geekie,C,BOS,25,76,17,22,39
3,8482146.0,Luke Evangelista,R,NSH,21,80,16,23,39
3,8474150.0,Mikael Backlund,C,CGY,34,82,15,24,39
3,8476872.0,Scott Laughton,C,PHI,29,82,13,26,39
3,8478542.0,Evan Rodrigues,C,FLA,30,80,12,27,39
3,8478055.0,Gustav Forsling,D,FLA,27,79,10,29,39
3,8478397.0,Rasmus Andersson,D,CGY,27,78,9,30,39
3,8475764.0,Cam Fowler,D,ANA,32,81,5,34,39
3,8476792.0,Torey Krug,D,STL,32,77,4,35,39
3,8482089.0,Jake Neighbours,L,STL,21,77,27,11,38
3,8482149.0,Cole Perfetti,C,WPG,21,71,19,19,38
3,8476881.0,Tomas Hertl,C,SJS,30,54,17,21,38
3,8474037.0,James van Riemsdyk,L,BOS,34,71,11,27,38
3,8482105.0,Jake Sanderson,D,OTT,21,79,10,28,38
3,8475314.0,Anders Lee,L,NYI,33,81,20,17,37
3,8473422.0,Nick Foligno,L,CHI,36,74,17,20,37
3,8482665.0,Matty Beniers,C,SEA,21,77,15,22,37
3,8476483.0,Rickard Rakell,R,PIT,30,70,15,22,37
3,8476474.0,Stefan Noesen,R,CAR,30,81,14,23,37
3,8476480.0,Vladislav Namestnikov,C,WPG,31,78,11,26,37
3,8476958.0,Jaccob Slavin,D,CAR,29,81,6,31,37
3,8481535.0,Nils Hoglander,L,VAN,23,80,24,12,36
3,8480014.0,Gabriel Vilardi,C,WPG,24,47,22,14,36
3,8473986.0,Alex Killorn,L,ANA,34,63,18,18,36
3,8478046.0,Danton Heinen,L,BOS,28,74,17,19,36
3,8478891.0,Mason Appleton,C,WPG,27,82,14,22,36
3,8476432.0,Boone Jenner,C,CBJ,30,58,22,13,35
3,8477450.0,Jason Dickinson,C,CHI,28,82,22,13,35
3,8476880.0,Tom Wilson,R,WSH,29,74,18,17,35
3,8482699.0,Dylan Guenther,R,ARI,20,45,18,17,35
3,8475287.0,Erik Haula,L,NJD,32,76,16,19,35
3,8476925.0,Colton Sissons,C,NSH,30,81,15,20,35
3,8482720.0,Matthew Knies,L,TOR,21,80,15,20,35
3,8482113.0,Anton Lundell,C,FLA,22,78,13,22,35
3,8476392.0,Adam Lowry,C,WPG,30,81,12,23,35
3,8478472.0,Mathieu Joseph,R,OTT,26,72,11,24,35
3,8475799.0,Nino Niederreiter,R,WPG,31,77,18,16,34
3,8477476.0,Artturi Lehkonen,L,COL,28,45,16,18,34
3,8481618.0,Alex Newhook,C,MTL,22,55,15,19,34
3,8482159.0,Tyson Foerster,R,PHI,21,77,20,13,33
3,8482110.0,Dawson Mercer,C,NJD,22,82,20,13,33
3,8481580.0,Connor McMichael,C,WSH,22,80,18,15,33
3,8482055.0,Drew O'Connor,L,PIT,25,79,16,17,33
3,8477429.0,Andrew Copp,C,DET,29,79,13,20,33
3,8479992.0,Michael Rasmussen,C,DET,24,75,13,20,33
3,8476826.0,Yanni Gourde,C,SEA,32,80,11,22,33
3,8476419.0,Jean-Gabriel Pageau,C,NYI,31,82,11,22,33
3,8477986.0,Brandon Montour,D,FLA,29,66,8,25,33
3,8482671.0,Owen Power,D,BUF,21,76,6,27,33
3,8478178.0,Darren Raddysh,D,TBL,27,82,6,27,33
3,8480145.0,Neal Pionk,D,WPG,28,82,5,28,33
3,8474565.0,Alex Pietrangelo,D,VGK,33,64,4,29,33
3,8478057.0,Dakota Joshua,C,VAN,27,63,18,14,32
3,8477952.0,Robby Fabbri,C,DET,27,68,18,14,32
3,8476921.0,Jordan Martinook,L,CAR,31,82,14,18,32
3,8475722.0,Jason Zucker,L,ARI,31,69,14,18,32
3,8482705.0,Cole Sillinger,C,CBJ,20,77,13,19,32
3,8477498.0,Darnell Nurse,D,EDM,28,81,10,22,32
3,8475171.0,Oliver Ekman-Larsson,D,FLA,32,80,9,23,32
3,8478500.0,Ivan Provorov,D,CBJ,26,82,5,27,32
3,8474151.0,Ryan McDonagh,D,NSH,34,74,3,29,32
3,8474870.0,Tyler Johnson,C,CHI,33,67,17,14,31
3,8475848.0,Brendan Gallagher,R,MTL,31,77,16,15,31
3,8474189.0,Lars Eller,C,PIT,34,82,15,16,31
3,8476292.0,Ondrej Palat,L,NJD,32,71,11,20,31
3,8481624.0,Ilya Mikheyev,R,VAN,29,78,11,20,31
3,8478458.0,Jack Roslovic,C,CBJ,26,59,9,22,31
3,8477495.0,Seth Jones,D,CHI,29,67,8,23,31
3,8476979.0,Erik Gustafsson,D,NYR,31,76,6,25,31
3,8476331.0,Dylan DeMelo,D,WPG,30,82,3,28,31
3,8480064.0,Josh Norris,C,OTT,24,50,16,14,30
3,8475768.0,Jaden Schwartz,C,SEA,31,62,13,17,30
3,8480802.0,Ryan McLeod,C,EDM,24,81,12,18,30
3,8477987.0,Ryan Donato,C,CHI,27,78,12,18,30
3,8475149.0,Marcus Johansson,L,MIN,33,78,11,19,30
3,8481546.0,Cam York,D,PHI,22,82,10,20,30
3,8477505.0,Alex Wennberg,C,SEA,29,79,10,20,30
3,8473533.0,Jordan Staal,C,CAR,35,80,10,20,30
3,8478469.0,Thomas Chabot,D,OTT,26,51,9,21,30
3,8480817.0,K'Andre Miller,D,NYR,23,80,8,22,30
3,8477969.0,Marcus Pettersson,D,PIT,27,82,4,26,30
3,8475753.0,Justin Faulk,D,STL,31,60,2,28,30
3,8479619.0,Michael Carcone,L,ARI,27,74,21,8,29
3,8482475.0,Yegor Chinakhov,R,CBJ,22,53,16,13,29
3,8480459.0,Pius Suter,C,VAN,27,67,14,15,29
3,8475763.0,Kevin Hayes,R,STL,31,79,13,16,29
3,8481524.0,Bowen  Byram,D,COL,22,73,11,18,29
3,8480336.0,Sean Walker,D,PHI,29,81,10,19,29
3,8481656.0,Aliaksei Protas,C,WSH,22,78,6,23,29
3,8474574.0,Tyler Myers,D,VAN,33,77,5,24,29
3,8482125.0,Alexander Holtz,R,NJD,21,82,16,12,28
3,8480813.0,Joe Veleno,C,DET,23,80,12,16,28
3,8480068.0,Ryan Poehling,C,PHI,24,77,11,17,28
3,8478413.0,Jordan Greenway,L,BUF,26,67,10,18,28
3,8478115.0,Pierre Engvall,L,NYI,27,74,10,18,28
3,8476923.0,Damon Severson,D,CBJ,29,67,9,19,28
3,8476931.0,Jake McCabe,D,TOR,30,73,8,20,28
3,8478133.0,Jake Evans,C,MTL,27,82,7,21,28
3,8476927.0,Teddy Blueger,C,VAN,29,68,6,22,28
3,8475181.0,Nick Leddy,D,STL,32,82,3,25,28
3,8478020.0,Michael Amadio,R,VGK,27,73,14,13,27
3,8481582.0,Nicholas Robertson,L,TOR,22,56,14,13,27
3,8480185.0,Eetu Luostarinen,C,FLA,25,82,12,15,27
3,8480829.0,Jesperi Kotkaniemi,C,CAR,23,79,12,15,27
3,8480113.0,Alex Iafallo,L,WPG,30,82,11,16,27
3,8480748.0,Kiefer Sherwood,L,NSH,28,68,10,17,27
3,8481596.0,Shane Pinto,C,OTT,23,41,9,18,27
3,8480835.0,Jack Drury,C,CAR,23,74,8,19,27
3,8476463.0,Jonas Brodin,D,MIN,30,62,7,20,27
3,8482092.0,Ridly Greig,C,OTT,21,72,13,13,26
3,8476918.0,Jimmy Vesey,L,NYR,30,80,13,13,26
3,8476892.0,Colton Parayko,D,STL,30,82,10,16,26
3,8479941.0,Justin Danforth,R,CBJ,30,71,10,16,26
3,8477425.0,Miles Wood,L,COL,28,74,9,17,26
3,8480855.0,Jack McBain,C,ARI,23,67,8,18,26
3,8474602.0,Justin Schultz,D,SEA,33,70,7,19,26
3,8475790.0,Erik Gudbranson,D,CBJ,31,78,6,20,26
3,8475200.0,Dmitry Orlov,D,CAR,32,82,6,20,26
3,8482655.0,J.J. Moser,D,ARI,23,80,5,21,26
3,8476902.0,Esa Lindell,D,DAL,29,82,5,21,26
3,8475188.0,Brayden McNabb,D,VGK,32,82,4,22,26
3,8476854.0,Hampus Lindholm,D,BOS,29,73,3,23,26
3,8474673.0,TJ Brodie,D,TOR,33,78,1,25,26
3,8476469.0,Joel Armia,R,MTL,30,66,17,8,25
3,8481601.0,Simon Holmstrom,R,NYI,22,75,15,10,25
3,8481186.0,Logan O'Connor,R,COL,27,57,13,12,25
3,8471698.0,T.J. Oshie,R,WSH,37,52,12,13,25
3,8479591.0,Michael Eyssimont,C,TBL,27,81,11,14,25
3,8476312.0,Josh Manson,D,COL,32,76,8,17,25
3,8478136.0,Jake Middleton,D,MIN,27,80,7,18,25
3,8481032.0,Paul Cotter,C,VGK,24,76,7,18,25
3,8477508.0,Curtis Lazar,C,NJD,28,71,7,18,25
3,8482245.0,Artem Zub,D,OTT,28,69,5,20,25
3,8478911.0,Matt Roy,D,LAK,28,81,5,20,25
3,8476879.0,Cody Ceci,D,EDM,30,79,5,20,25
3,8478507.0,John Marino,D,NJD,26,75,4,21,25
3,8478840.0,Will Borgen,D,SEA,27,82,3,22,25
3,8482259.0,Bobby McMann,C,TOR,27,56,15,9,24
3,8481604.0,Pavel Dorofeyev,L,VGK,23,47,13,11,24
3,8478043.0,Sam Lafferty,C,VAN,28,79,13,11,24
3,8479351.0,Sam Steel,C,DAL,25,77,9,15,24
3,8475193.0,Tomas Tatar,L,SEA,33,70,9,15,24
3,8475744.0,Evgeny Kuznetsov,C,WSH,31,63,8,16,24
3,8475233.0,David Savard,D,MTL,33,60,6,18,24
3,8476422.0,Mike Reilly,D,NYI,30,61,6,18,24
3,8474031.0,Kevin Shattenkirk,D,BOS,34,61,6,18,24
3,8473507.0,Jeff Petry,D,DET,36,73,3,21,24
3,8480246.0,Nick Perbix,D,TBL,25,77,2,22,24
3,8481606.0,Jordan Spence,D,LAK,22,71,2,22,24
3,8477947.0,Sonny Milano,L,WSH,27,49,15,8,23
3,8475793.0,Ryan Johansen,C,COL,31,63,13,10,23
3,8480821.0,Filip Zadina,R,SJS,24,72,13,10,23
3,8474149.0,Evgenii Dadonov,R,DAL,34,51,12,11,23
3,8475231.0,Casey Cizikas,C,NYI,32,70,10,13,23
3,8474884.0,Mike Hoffman,C,SJS,34,66,10,13,23
3,8482062.0,Cole Smith,L,NSH,28,80,9,14,23
3,8478882.0,Vladislav Gavrikov,D,LAK,28,77,6,17,23
3,8474157.0,Max Pacioretty,L,WSH,35,47,4,19,23
3,8480873.0,Rasmus Sandin,D,WSH,23,68,3,20,23
3,8480043.0,Timothy Liljegren,D,TOR,24,55,3,20,23
3,8475343.0,Nic Dowd,C,WSH,33,64,12,10,22
3,8470621.0,Corey Perry,R,EDM,38,54,12,10,22
3,8473449.0,Kyle Okposo,R,BUF,35,67,12,10,22
3,8477446.0,Michael McCarron,R,NSH,28,70,12,10,22
3,8481517.0,Brett Leason,R,ANA,24,68,11,11,22
3,8478970.0,Jalen Chatfield,D,CAR,27,72,8,14,22
3,8481014.0,Alexander Romanov,D,NYI,23,81,7,15,22
3,8482087.0,Kaiden Guhle,D,MTL,21,70,6,16,22
3,8477953.0,Kasperi Kapanen,R,STL,27,73,6,16,22
3,8476885.0,Jacob Trouba,D,NYR,29,69,3,19,22
3,8480281.0,Alexey Toropchenko,R,STL,24,82,14,7,21
3,8482157.0,Will Cuylle,L,NYR,21,81,13,8,21
3,8478013.0,Jake Walman,D,DET,27,63,12,9,21
3,8475714.0,Calle Jarnkrok,C,TOR,32,52,10,11,21
3,8475220.0,Marcus Foligno,L,MIN,32,55,9,12,21
3,8471218.0,Blake Wheeler,R,NYR,37,54,9,12,21
3,8479359.0,Beck Malenstyn,L,WSH,25,81,6,15,21
3,8476897.0,Oskar Sundqvist,C,STL,29,71,6,15,21
3,8481178.0,Egor Zamula,D,PHI,23,66,5,16,21
3,8480891.0,Michael Kesselring,D,ARI,23,65,5,16,21
3,8479983.0,Mario Ferraro,D,SJS,25,78,3,18,21
3,8475225.0,Craig Smith,C,DAL,34,75,11,9,20
3,8476981.0,Josh Anderson,R,MTL,29,78,9,11,20
3,8475455.0,Brenden Dillon,D,WPG,33,77,8,12,20
3,8481577.0,Philip Tomasino,C,NSH,22,41,7,13,20
3,8477507.0,Nikita Zadorov,D,VAN,28,75,6,14,20
3,8475279.0,Ben Chiarot,D,DET,32,77,5,15,20
3,8478851.0,Alexandre Carrier,D,NSH,27,73,4,16,20
3,8480035.0,Henri Jokiharju,D,BUF,24,74,3,17,20
3,8480073.0,Erik Brannstrom,D,OTT,24,76,3,17,20
3,8475179.0,Dmitry Kulikov,D,FLA,33,76,1,19,20
3,8481554.0,Kaapo Kakko,R,NYR,22,61,13,6,19
3,8480980.0,Connor Dewar,C,MIN,24,74,11,8,19
3,8479415.0,Michael McLeod,C,NJD,25,45,10,9,19
3,8482097.0,Jack Quinn,R,BUF,22,27,9,10,19
3,8480144.0,David Kampf,C,TOR,28,78,8,11,19
3,8479353.0,Brett Howden,C,VGK,25,72,8,11,19
3,8475164.0,Jakob Silfverberg,R,ANA,33,81,7,12,19
3,8476889.0,Radek Faksa,C,DAL,29,74,7,12,19
3,8473504.0,Cal Clutterbuck,R,NYI,36,82,7,12,19
3,8475855.0,Jesper Fast,R,CAR,32,73,6,13,19
3,8477380.0,Jonny Brodzinski,C,NYR,30,57,6,13,19
3,8471699.0,Andrew Cogliano,C,COL,36,75,6,13,19
3,8477506.0,Ryan Pulock,D,NYI,29,58,5,14,19
3,8480172.0,Jan Rutta,D,SJS,33,69,5,14,19
3,8482073.0,Braden Schneider,D,NYR,22,82,5,14,19
3,8478432.0,Christian Fischer,R,DET,26,79,5,14,19
3,8479410.0,Mikhail Sergachev,D,TBL,25,34,2,17,19
3,8475690.0,Chris Tanev,D,CGY,34,75,2,17,19
3,8480878.0,Nils Lundkvist,D,DAL,23,59,2,17,19
3,8479316.0,Luke Kunin,C,SJS,26,77,11,7,18
3,8480289.0,Morgan Barron,C,WPG,25,80,11,7,18
3,8476374.0,Sean Kuraly,C,CBJ,30,62,9,9,18
3,8480448.0,Parker Kelly,L,OTT,24,80,8,10,18
3,8478434.0,Keegan Kolesar,R,VGK,26,79,8,10,18
3,8475462.0,Radko Gudas,D,ANA,33,66,6,12,18
3,8480220.0,Noah Cates,L,PHI,24,59,6,12,18
3,8476457.0,Adam Larsson,D,SEA,31,81,4,14,18
3,8477932.0,Aaron Ekblad,D,FLA,27,51,4,14,18
3,8477365.0,Connor Clifton,D,BUF,28,79,4,14,18
3,8476874.0,Olli Maatta,D,DET,29,72,4,14,18
3,8479398.0,Samuel Girard,D,COL,25,59,3,15,18
3,8479998.0,Mikey Anderson,D,LAK,24,74,2,16,18
3,8480049.0,Dylan Samberg,D,WPG,24,78,1,17,18
3,8478508.0,Yakov Trenin,C,NSH,26,76,12,5,17
3,8477903.0,Garnet Hathaway,R,PHI,32,82,7,10,17
3,8480995.0,Pontus Holmberg,R,TOR,24,54,7,10,17
3,8479315.0,Joey Anderson,R,CHI,25,55,5,12,17
3,8478463.0,Anthony Beauvillier,L,CHI,26,60,5,12,17
3,8474166.0,Alec Martinez,D,VGK,36,55,4,13,17
3,8481522.0,Peyton Krebs,C,BUF,22,80,4,13,17
3,8478859.0,Niko Mikkola,D,FLA,27,82,3,14,17
3,8479324.0,Ryan Lindgren,D,NYR,25,76,3,14,17
3,8481605.0,Jackson LaCombe,D,ANA,22,71,2,15,17
3,8479976.0,Juuso Valimaki,D,ARI,25,68,2,15,17
3,8470600.0,Ryan Suter,D,DAL,38,82,2,15,17
3,8480884.0,Calen Addison,D,SJS,23,72,1,16,17
3,8475842.0,Sam Carrick,C,ANA,31,77,10,6,16
3,8479977.0,Kailer Yamamoto,R,SEA,25,59,8,8,16
3,8473453.0,Trevor Lewis,C,LAK,36,82,8,8,16
3,8480205.0,Emil Bemstrom,R,CBJ,24,56,8,8,16
3,8479293.0,Brandon Tanev,L,SEA,32,66,7,9,16
3,8477444.0,Andre Burakovsky,L,SEA,28,49,7,9,16
3,8475208.0,Brian Dumoulin,D,SEA,32,80,6,10,16
3,8482660.0,Kent Johnson,C,CBJ,21,42,6,10,16
3,8477979.0,Nicolas Aube-Kubel,R,WSH,27,60,6,10,16
3,8476462.0,Dougie Hamilton,D,NJD,30,20,5,11,16
3,8482117.0,Lukas Reichel,L,CHI,21,65,5,11,16
3,8474034.0,Pat Maroon,L,MIN,35,51,4,12,16
3,8480796.0,Martin Fehervary,D,WSH,24,66,3,13,16
3,8476967.0,Brett Kulak,D,EDM,29,82,3,13,16
3,8471677.0,Jack Johnson,D,COL,36,80,3,13,16
3,8481568.0,Alex Vlasic,D,CHI,22,76,2,14,16
3,8476917.0,Adam Pelech,D,NYI,29,58,1,15,16
3,8479423.0,Alex Nylander,L,PIT,25,28,11,4,15
3,8478831.0,Kevin Stenlund,C,FLA,27,81,11,4,15
3,8470604.0,Jeff Carter,C,PIT,38,72,11,4,15
3,8477330.0,Dominik Kubalik,L,OTT,28,74,11,4,15
3,8476873.0,Mark Jankowski,C,NSH,29,32,7,8,15
3,8476393.0,Nick Cousins,C,FLA,30,69,7,8,15
3,8481560.0,Arthur Kaliyev,R,LAK,22,51,7,8,15
3,8481481.0,Blake Lizotte,C,LAK,26,62,7,8,15
3,8478109.0,Victor Olofsson,L,BUF,28,51,7,8,15
3,8481533.0,Trevor Zegras,C,ANA,22,31,6,9,15
3,8478042.0,Viktor Arvidsson,R,LAK,30,18,6,9,15
3,8474090.0,Brendan Smith,D,NJD,34,63,5,10,15
3,8477919.0,Frederick Gaudreau,C,MIN,30,67,5,10,15
3,8479368.0,Max Jones,L,ANA,25,52,5,10,15
3,8477839.0,Conor Sheary,L,TBL,31,57,4,11,15
3,8476467.0,Jamie Oleksiak,D,SEA,31,82,2,13,15
3,8475197.0,Tyson Barrie,D,NSH,32,41,1,14,15
3,8476878.0,Zemgus Girgensons,L,BUF,29,63,8,6,14
3,8480011.0,Klim Kostin,C,DET,24,52,8,6,14
3,8479661.0,Tanner Jeannot,L,TBL,26,55,7,7,14
3,8478468.0,Jeremy Lauzon,D,NSH,26,79,6,8,14
3,8480003.0,Jesper Boqvist,C,BOS,25,47,6,8,14
3,8479390.0,Taylor Raddysh,R,CHI,25,73,5,9,14
3,8477070.0,Liam O'Brien,C,ARI,29,75,5,9,14
3,8478443.0,Brandon Carlo,D,BOS,27,76,4,10,14
3,8480879.0,Jacob Bernard-Docker,D,OTT,23,72,4,10,14
3,8477392.0,Hudson Fasching,R,NYI,28,45,4,10,14
3,8477435.0,Ryan Graves,D,PIT,28,70,3,11,14
3,8474567.0,Zach Bogosian,D,MIN,33,65,3,11,14
3,8480887.0,Jordan Harris,D,MTL,23,56,3,11,14
3,8480727.0,Zach Whitecloud,D,VGK,27,61,2,12,14
3,8477220.0,Nate Schmidt,D,WPG,32,63,2,12,14
3,8475324.0,Nick Jensen,D,WSH,33,78,1,13,14
3,8480001.0,Urho Vaakanainen,D,ANA,24,68,1,13,14
3,8477845.0,Trevor van Riemsdyk,D,WSH,32,70,0,14,14
3,8482111.0,Justin Barron,D,MTL,22,48,7,6,13
3,8479383.0,Boris Katchouk,L,CHI,25,59,7,6,13
3,8477573.0,Nathan Walker,L,STL,29,45,7,6,13
3,8480192.0,Johnathan Kovacevic,D,MTL,26,62,6,7,13
3,8479996.0,Cody Glass,C,NSH,24,41,6,7,13
3,8481477.0,Nico Sturm,C,SJS,28,63,5,8,13
3,8476871.0,Tanner Pearson,L,MTL,31,54,5,8,13
3,8479520.0,Brandon Duhaime,R,MIN,26,80,5,8,13
3,8479402.0,Jake Bean,D,CBJ,25,72,4,9,13
3,8482222.0,Alexander Barabanov,L,SJS,29,46,4,9,13
3,8477488.0,Brett Pesce,D,CAR,29,70,3,10,13
3,8479371.0,Dante Fabbro,D,NSH,25,56,3,10,13
3,8478416.0,Erik Cernak,D,TBL,26,69,2,11,13
3,8476372.0,Nick Seeler,D,PHI,30,71,1,12,13
3,8481704.0,Juuso Parssinen,C,NSH,22,44,8,4,12
3,8476278.0,Colin Blackwell,C,CHI,30,44,8,4,12
3,8479336.0,Carl Grundstrom,R,LAK,26,50,8,4,12
3,8471709.0,Marc-Edouard Vlasic,D,SJS,36,57,6,6,12
3,8479393.0,Noah Gregor,C,TOR,25,63,6,6,12
3,8478421.0,A.J. Greer,L,CGY,27,59,6,6,12
3,8479671.0,Mathieu Olivier,R,CBJ,26,54,5,7,12
3,8477846.0,Ryan Carpenter,C,SJS,32,62,5,7,12
3,8478585.0,Derek Ryan,C,EDM,37,70,5,7,12
3,8479414.0,Nathan Bastian,R,NJD,26,54,5,7,12
3,8477015.0,Connor Brown,R,EDM,29,71,4,8,12
3,8476624.0,Barclay Goodrow,C,NYR,30,80,4,8,12
3,8477406.0,Mattias Janmark,C,EDM,31,71,4,8,12
3,8476919.0,Chris Tierney,C,NJD,29,52,4,8,12
3,8479543.0,Michael Pezzetta,L,MTL,25,61,3,9,12
3,8475825.0,Jani Hakanpää,D,DAL,31,64,2,10,12
3,8479980.0,Nicolas Hague,D,VGK,25,73,2,10,12
3,8476822.0,Luke Glendening,C,TBL,34,81,10,1,11
3,8482133.0,Thomas Bordeleau,C,SJS,21,27,6,5,11
3,8480806.0,Isac Lundestrom,C,ANA,24,46,5,6,11
3,8480025.0,MacKenzie Entwistle,R,CHI,24,67,5,6,11
3,8475750.0,Jon Merrill,D,MIN,31,65,4,7,11
3,8481567.0,Henry Thrun,D,SJS,22,51,3,8,11
3,8477950.0,Tony DeAngelo,D,CAR,28,31,3,8,11
3,8474013.0,Ian Cole,D,VAN,34,78,2,9,11
3,8476891.0,Matt Grzelcyk,D,BOS,29,63,2,9,11
3,8480058.0,Pierre-Olivier Joseph,D,PIT,24,52,2,9,11
3,8480860.0,Kevin Bahl,D,NJD,23,82,1,10,11
3,8479576.0,Vincent Desharnais,D,EDM,27,78,1,10,11
3,8470610.0,Zach Parise,L,COL,39,30,5,5,10
3,8476858.0,Phillip Di Giuseppe,L,VAN,30,51,5,5,10
3,8474040.0,Sam Gagner,C,EDM,34,28,5,5,10
3,8480355.0,Mark Kastelic,C,OTT,24,63,5,5,10
3,8482142.0,Jamie Drysdale,D,PHI,21,34,3,7,10
3,8480849.0,Barrett Hayton,C,ARI,23,33,3,7,10
3,8475177.0,Calvin de Haan,D,TBL,32,59,3,7,10
3,8482964.0,Arber Xhekaj,D,MTL,22,44,3,7,10
3,8477384.0,Josh Brown,D,ARI,29,51,3,7,10
3,8480184.0,Gustav Lindström,D,ANA,25,46,3,7,10
3,8480762.0,Eric Robinson,L,BUF,28,47,3,7,10
3,8477018.0,Ben Hutton,D,VGK,30,41,2,8,10
3,8481093.0,Rafael Harvey-Pinard,L,MTL,24,45,2,8,10
3,8480880.0,Jakub Lauko,C,BOS,23,60,2,8,10
3,8480871.0,Adam Boqvist,D,CBJ,23,35,1,9,10
3,8479369.0,Andrew Peeke,D,CBJ,25,38,1,9,10
3,8479982.0,Conor Timmins,D,TOR,25,25,1,9,10
3,8483460.0,David Jiricek,D,CBJ,20,43,1,9,10
3,8477971.0,Andreas Englund,D,LAK,27,82,1,9,10
3,8471274.0,Alex Goligoski,D,MIN,38,36,0,10,10
3,8479439.0,Jacob MacDonald,D,SJS,30,34,7,2,9
3,8479339.0,Patrik Laine,L,CBJ,25,18,6,3,9
3,8477353.0,Tyler Motte,C,TBL,28,69,6,3,9
3,8482077.0,Dylan Holloway,L,EDM,22,38,6,3,9
3,8479718.0,Alex Barré-Boulet,C,TBL,26,36,6,3,9
3,8477989.0,Christian Dvorak,C,MTL,27,30,5,4,9
3,8479328.0,Julien Gauthier,R,NYI,26,27,5,4,9
3,8479968.0,Vinni Lettieri,C,MIN,28,46,5,4,9
3,8476525.0,Colin Miller,D,NJD,31,46,4,5,9
3,8470966.0,Mark Giordano,D,TOR,40,46,3,6,9
3,8482679.0,Matt Coronato,R,CGY,21,34,3,6,9
3,8480008.0,Adam Ruzicka,C,ARI,24,42,3,6,9
3,8481641.0,Joel Kiviranta,L,COL,27,56,3,6,9
3,8478028.0,Fredrik Olofsson,L,COL,27,57,3,6,9
3,8480222.0,Sebastian Aho,D,NYI,27,58,2,7,9
3,8481708.0,Zac Jones,D,NYR,23,31,2,7,9
3,8476960.0,Andreas Athanasiou,C,CHI,29,28,2,7,9
3,8480848.0,Ty Dellandrea,C,DAL,23,42,2,7,9
3,8478099.0,Kevin Labanc,R,SJS,28,46,2,7,9
3,8478399.0,Jonas Siegenthaler,D,NJD,26,57,1,8,9
3,8481527.0,Kaedan Korczak,D,VGK,22,26,1,8,9
3,8481537.0,Nikita Okhotiuk,D,SJS,23,52,1,8,9
3,8475797.0,Jarred Tinordi,D,CHI,31,52,0,9,9
3,8479372.0,Josh Mahura,D,FLA,25,30,0,9,9
3,8477478.0,William Carrier,L,VGK,29,39,6,2,8
3,8480252.0,Cole Guttman,C,CHI,24,27,4,4,8
3,8481058.0,Jesse Ylönen,R,MTL,24,59,4,4,8
3,8474709.0,Matt Martin,L,NYI,34,57,4,4,8
3,8477541.0,Dakota Mermis,D,MIN,29,47,3,5,8
3,8478211.0,Dryden Hunt,L,CGY,28,28,3,5,8
3,8476473.0,Connor Murphy,D,CHI,30,46,2,6,8
3,8477335.0,Kyle Burroughs,D,SJS,28,73,2,6,8
3,8474618.0,Marco Scandella,D,STL,33,65,2,6,8
3,8476329.0,Travis Boyd,C,ARI,30,16,2,6,8
3,8480196.0,Jacob Bryson,D,BUF,26,36,1,7,8
3,8478450.0,Parker Wotherspoon,D,BOS,26,41,0,8,8
3,8480950.0,Ilya Lyubushkin,D,ANA,29,74,0,8,8
3,8479066.0,Ryan Lomberg,L,FLA,29,75,5,2,7
3,8478569.0,Noel Acciari,C,PIT,32,55,4,3,7
3,8477930.0,Pierre-Edouard Bellemare,L,SEA,38,40,4,3,7
3,8482241.0,Radim Zohorna,L,PIT,27,33,4,3,7
3,8482624.0,Daniil Miromanov,D,VGK,26,24,3,4,7
3,8479346.0,Dillon Dube,C,CGY,25,43,3,4,7
3,8482496.0,Nils Aman,C,VAN,23,43,3,4,7
3,8481019.0,David Gustafsson,C,WPG,23,39,3,4,7
3,8478408.0,Travis Dermott,D,ARI,27,50,2,5,7
3,8479458.0,Nikita Zaitsev,D,CHI,32,38,2,5,7
3,8481167.0,Brayden Pachal,D,CGY,24,50,2,5,7
3,8480084.0,Nick DeSimone,D,NJD,29,34,2,5,7
3,8482652.0,Walker Duehr,R,CGY,26,40,2,5,7
3,8480807.0,Mattias Samuelsson,D,BUF,23,41,1,6,7
3,8479442.0,Troy Stecher,D,ARI,29,54,1,6,7
3,8482516.0,Matthew Kessel,D,STL,23,39,1,6,7
3,8474568.0,Luke Schenn,D,NSH,34,63,1,6,7
3,8478454.0,Noah Juulsen,D,VAN,26,54,1,6,7
3,8478502.0,Dennis Gilbert,D,CGY,27,34,1,6,7
3,8478104.0,Sammy Blais,L,STL,27,53,1,6,7
3,8482176.0,Wyatt Kaiser,D,CHI,21,32,0,7,7
3,8473446.0,Erik Johnson,D,BUF,35,67,5,1,6
3,8471817.0,Ryan Reaves,R,TOR,36,49,4,2,6
3,8479370.0,Tyson Jost,C,BUF,25,43,3,3,6
3,8477369.0,Carson Soucy,D,VAN,29,40,2,4,6
3,8474612.0,Travis Hamonic,D,OTT,33,48,2,4,6
3,8482730.0,Brandt Clarke,D,LAK,20,16,2,4,6
3,8477944.0,Jakub Vrana,L,STL,27,21,2,4,6
3,8477931.0,Tomas Nosek,L,NJD,31,36,2,4,6
3,8480789.0,Oliver Wahlstrom,R,NYI,23,32,2,4,6
3,8481013.0,Jonatan Berggren,R,DET,23,12,2,4,6
3,8476441.0,Joel Edmundson,D,WSH,30,53,1,5,6
3,8482192.0,Isaak Phillips,D,CHI,22,33,0,6,6
3,8480078.0,Filip Chytil,C,NYR,24,10,0,6,6
3,8483524.0,Shane Wright,C,SEA,19,8,4,1,5
3,8477962.0,Brendan Lemieux,L,CAR,27,32,3,2,5
3,8481541.0,Samuel Bolduc,D,NYI,23,34,2,3,5
3,8481147.0,Reese Johnson,C,CHI,25,42,2,3,5
3,8481422.0,Jacob Lucchini,C,MIN,28,40,2,3,5
3,8479536.0,Axel Jonsson-Fjallby,L,WPG,25,26,2,3,5
3,8481122.0,Simon Benoit,D,TOR,25,64,1,4,5
3,8477938.0,Haydn Fleury,D,TBL,27,24,1,4,5
3,8477810.0,Joel Hanley,D,DAL,32,42,1,4,5
3,8471686.0,Marc Staal,D,PHI,36,35,1,4,5
3,8474009.0,Nick Bonino,C,NYR,35,45,1,4,5
3,8476952.0,Dominic Toninato,C,WPG,29,15,1,4,5
3,8479547.0,Matthew Phillips,R,PIT,25,31,1,4,5
3,8480245.0,Olle Lycksell,R,PHI,24,18,1,4,5
3,8474716.0,Jared Spurgeon,D,MIN,34,16,0,5,5
3,8475906.0,John Klingberg,D,TOR,31,14,0,5,5
3,8476429.0,Scott Mayfield,D,NYI,31,41,0,5,5
3,8475718.0,Justin Holl,D,DET,31,38,0,5,5
3,8478452.0,Caleb Jones,D,COL,26,25,0,5,5
3,8479291.0,Kevin Rooney,C,CGY,30,33,3,1,4
3,8479344.0,Jesse Puljujarvi,R,PIT,25,22,3,1,4
3,8478051.0,Max Willman,C,NJD,28,18,3,1,4
3,8475791.0,Taylor Hall,L,CHI,32,10,2,2,4
3,8481056.0,Spencer Stastney,D,NSH,23,20,2,2,4
3,8476867.0,Brendan Gaunce,C,CBJ,29,24,2,2,4
3,8479981.0,Jonah Gadjovich,L,FLA,25,39,2,2,4
3,8475766.0,Austin Watson,L,TBL,31,33,2,2,4
3,8477499.0,Rasmus Ristolainen,D,PHI,29,31,1,3,4
3,8478451.0,Ethan Bear,D,WSH,26,24,1,3,4
3,8481609.0,Vladislav Kolyachonok,D,ARI,22,5,1,3,4
3,8477244.0,Chad Ruhwedel,D,PIT,33,52,1,3,4
3,8476442.0,Matt Nieto,L,PIT,31,22,1,3,4
3,8479994.0,Jaret Anderson-Dolan,C,LAK,24,31,1,3,4
3,8475752.0,Tyler Pitlick,C,NYR,32,34,1,3,4
3,8481532.0,Alex Turcotte,C,LAK,22,20,1,3,4
3,8477527.0,Ross Johnston,L,ANA,29,68,1,3,4
3,8475235.0,Nicolas Deslauriers,L,PHI,32,60,1,3,4
3,8476913.0,Devin Shore,C,SEA,29,21,1,3,4
3,8479379.0,Givani Smith,R,SJS,25,36,1,3,4
3,8475762.0,Derek Forbort,D,BOS,31,35,0,4,4
3,8478424.0,Jansen Harkins,C,PIT,26,45,0,4,4
3,8480441.0,Trey Fix-Wolansky,R,CBJ,24,11,2,1,3
3,8478078.0,Rourke Chartier,C,OTT,27,37,2,1,3
3,8480776.0,Sheldon Rempal,R,VGK,28,9,2,1,3
3,8480468.0,James Hamblin,L,EDM,24,31,2,1,3
3,8479772.0,Zack MacEwen,R,OTT,27,30,2,1,3
3,8477073.0,Kurtis MacDermid,D,COL,29,45,2,1,3
3,8480823.0,Alexander Alexeyev,D,WSH,24,39,1,2,3
3,8480007.0,Jonas Rondbjerg,R,VGK,24,20,1,2,3
3,8476934.0,Brock McGinn,L,ANA,29,24,1,2,3
3,8478409.0,Anthony Richard,C,BOS,27,9,1,2,3
3,8483570.0,Ben Meyers,C,COL,25,23,1,2,3
3,8476994.0,Vinnie Hinostroza,C,PIT,29,14,1,2,3
3,8481592.0,Jakob Pelletier,L,CGY,22,13,1,2,3
3,8478904.0,Steven Lorentz,C,FLA,27,38,1,2,3
3,8479972.0,Mason Shaw,C,MIN,25,20,1,2,3
3,8480853.0,Liam Foudy,C,NSH,23,13,0,3,3
3,8482762.0,Simon Edvinsson,D,DET,20,16,1,1,2
3,8482101.0,Danil Gushchin,L,SJS,21,4,1,1,2
3,8479378.0,Logan Stanley,D,WPG,25,25,1,1,2
3,8481006.0,Tyler Tucker,D,STL,23,26,1,1,2
3,8478495.0,Denis Gurianov,R,NSH,26,18,1,1,2
3,8479362.0,Riley Tufte,L,COL,25,5,1,1,2
3,8480292.0,Carson Meyer,R,CBJ,26,14,1,1,2
3,8477454.0,Adam Erne,L,EDM,28,24,1,1,2
3,8475780.0,Chris Wagner,R,BOS,32,13,1,1,2
3,8476988.0,Matt Benning,D,SJS,29,14,0,2,2
3,8477034.0,Jaycob Megna,D,CHI,31,44,0,2,2
3,8481521.0,Ronnie Attard,D,PHI,24,12,0,2,2
3,8480070.0,Ian Mitchell,D,BOS,24,13,0,2,2
3,8477851.0,Jordan Oesterle,D,CGY,31,22,0,2,2
3,8481161.0,Jake Christiansen,D,CBJ,24,12,0,2,2
3,8482451.0,Mikael Pyyhtia,L,CBJ,22,17,0,2,2
3,8473473.0,Milan Lucic,L,BOS,35,4,0,2,2
3,8480870.0,Bo Groulx,C,ANA,23,45,0,2,2
3,8481598.0,Philip Broberg,D,EDM,22,12,0,2,2
3,8477464.0,Nic Petan,C,MIN,28,6,0,2,2
3,8481617.0,Vasily Podkolzin,R,VAN,22,19,0,2,2
3,8481751.0,Lukas Rousek,R,BUF,24,15,0,2,2
3,8481550.0,Adam Beckman,L,MIN,22,11,0,2,2
3,8481523.0,Kirby Dach,C,MTL,22,2,0,2,2
3,8481543.0,Nikita Alexandrov,C,STL,23,23,0,2,2
3,8478146.0,Matthew Highmore,C,OTT,27,7,0,2,2
3,8481043.0,Cole Koepke,L,TBL,25,9,0,2,2
3,8483565.0,Nick Blankenburg,D,CBJ,25,12,1,0,1
3,8483397.0,Marc McLaughlin,C,BOS,24,1,1,0,1
3,8480874.0,Adam Ginning,D,PHI,23,9,1,0,1
3,8481754.0,Nikita Nesterenko,C,ANA,22,3,1,0,1
3,8480021.0,Jack Studnicka,C,SJS,24,22,1,0,1
3,8481518.0,Nolan Foote,L,NJD,23,4,1,0,1
3,8479421.0,Jacob Moverare,D,LAK,25,24,1,0,1
3,8481239.0,Samuel Fagemo,L,LAK,23,8,1,0,1
3,8479546.0,Oskar Steen,C,BOS,25,34,1,0,1
3,8480836.0,Jonathan Gruden,C,PIT,23,13,1,0,1
3,8481077.0,John Leonard,L,NSH,25,6,1,0,1
3,8482147.0,Jean-Luc Foudy,C,COL,21,4,1,0,1
3,8474053.0,Logan Couture,C,SJS,34,6,0,1,1
3,8481812.0,Nikolai Knyzhov,D,SJS,26,10,0,1,1
3,8479984.0,Cal Foote,D,NJD,25,4,0,1,1
3,8479321.0,Lucas Johansen,D,WSH,26,6,0,1,1
3,8473563.0,Nicklas Backstrom,C,WSH,36,8,0,1,1
3,8479320.0,Max Lajoie,D,TOR,26,7,0,1,1
3,8482095.0,Tyler Kleven,D,OTT,21,9,0,1,1
3,8480157.0,Calle Rosen,D,STL,29,6,0,1,1
3,8480031.0,Max Comtois,L,ANA,24,1,0,1,1
3,8478017.0,Mark Friedman,D,VAN,28,23,0,1,1
3,8479348.0,Kale Clague,D,BUF,25,3,0,1,1
3,8475278.0,Byron Froese,C,VGK,32,16,0,1,1
3,8475795.0,Dylan McIlrath,D,WSH,31,3,0,1,1
3,8480845.0,Rasmus Kupari,C,WPG,23,28,0,1,1
3,8480890.0,Jan Jenik,R,ARI,23,5,0,1,1
3,8477887.0,Patrick Brown,C,BOS,31,11,0,1,1
3,8478512.0,Austin Czarnik,C,DET,31,34,0,1,1
3,8479367.0,William Lockwood,R,FLA,25,26,0,1,1
3,8483597.0,Milos Kelemen,L,ARI,24,10,0,1,1
3,8477126.0,Jayson Megna,C,ANA,33,1,0,0,0
3,8479639.0,Dylan Coghlan,D,CAR,25,1,0,0,0
3,8482067.0,Connor Mackey,D,NYR,27,1,0,0,0
3,8476856.0,Matt Dumba,D,ARI,29,0,0,0,0
3,8478483.0,Mitchell Marner,R,TOR,26,0,0,0,0
3,8471873.0,Anton Stralman,D,BOS,37,0,0,0,0
3,8474162.0,Jake Muzzin,D,TOR,34,0,0,0,0
3,8470638.0,Patrice Bergeron,C,BOS,38,0,0,0,0
3,8473604.0,Jonathan Toews,C,CHI,35,0,0,0,0
3,8471276.0,David Krejci,C,BOS,37,0,0,0,0
3,8474207.0,Nick Holden,D,OTT,36,0,0,0,0
3,8475747.0,Patrik Nemeth,D,ARI,31,0,0,0,0
3,8477467.0,Gustav Olofsson,D,SEA,29,1,0,0,0
3,8479514.0,Rem Pitlick,C,CHI,26,9,0,0,0
3,8474027.0,Justin Braun,D,PHI,36,0,0,0,0
3,8481599.0,Victor Soderstrom,D,ARI,22,3,0,0,0
3,8474161.0,Jakub Voracek,R,CBJ,34,0,0,0,0
3,8479985.0,Cale Fleury,D,SEA,25,1,0,0,0
3,8471303.0,Alexander Edler,D,LAK,37,0,0,0,0
3,8474573.0,Josh Bailey,R,NYI,34,0,0,0,0
3,8483619.0,Filip Roos,D,CHI,24,4,0,0,0
3,8474818.0,Jordie Benn,D,TOR,36,0,0,0,0
3,8476449.0,Scott Harrington,D,ANA,30,0,0,0,0
3,8483620.0,Marcus Bjork,D,CBJ,26,0,0,0,0
3,8470595.0,Eric Staal,C,FLA,39,0,0,0,0
3,8481585.0,Egor Afanasyev,L,NSH,22,2,0,0,0
3,8482712.0,Oskar Olausson,R,COL,21,1,0,0,0
3,8481072.0,Tim Berni,D,CBJ,23,0,0,0,0
3,8479945.0,Gavin Bayreuther,D,CBJ,29,0,0,0,0
3,8481600.0,Tobias Bjornfot,D,VGK,22,4,0,0,0
3,8481679.0,Maxence Guenette,D,OTT,22,7,0,0,0
3,8474683.0,Derek Grant,C,ANA,33,0,0,0,0
3,8476470.0,Nathan Beaulieu,D,ANA,31,0,0,0,0
3,8474145.0,Robert Bortuzzo,D,NYI,34,27,0,0,0
3,8480216.0,Jacob Peterson,C,SJS,24,6,0,0,0
3,8473548.0,Phil Kessel,R,VGK,36,0,0,0,0
3,8480160.0,Radim Simek,D,SJS,31,0,0,0,0
3,8480883.0,Ty Smith,D,PIT,23,0,0,0,0
3,8471669.0,Paul Stastny,C,CAR,38,0,0,0,0
3,8475227.0,Chris Wideman,D,MTL,33,0,0,0,0
3,8480913.0,Jordan Gross,D,NSH,28,0,0,0,0
3,8475625.0,Matt Irwin,D,WSH,36,0,0,0,0
3,8479388.0,Riley Stillman,D,BUF,25,0,0,0,0
3,8474628.0,Michael Stone,D,CGY,33,0,0,0,0
3,8484254.0,Akito Hirose,D,VAN,24,3,0,0,0
3,8477941.0,Nick Ritchie,L,CGY,28,0,0,0,0
3,8477462.0,Robert Hagg,D,ANA,28,5,0,0,0
3,8478062.0,Dysin Mayo,D,ARI,27,0,0,0,0
3,8482634.0,Alex Steeves,C,TOR,24,1,0,0,0
3,8477433.0,Ben Harpur,D,NYR,28,0,0,0,0
3,8478841.0,Colton White,D,ANA,26,0,0,0,0
3,8473544.0,Derick Brassard,C,OTT,36,0,0,0,0
3,8476884.0,Derrick Pouliot,D,SJS,29,5,0,0,0
3,8479376.0,Victor Mete,D,PHI,25,1,0,0,0
3,8483630.0,Pavol Regenda,L,ANA,24,5,0,0,0
3,8479026.0,Philippe Myers,D,TBL,26,5,0,0,0
3,8477482.0,Zach Sanford,L,CHI,29,0,0,0,0
3,8477359.0,Tucker Poolman,D,VAN,30,0,0,0,0
3,8475857.0,Kevin Gravel,D,NSH,31,0,0,0,0
3,8476779.0,Brad Hunt,D,COL,35,0,0,0,0
3,8476850.0,Ryan Murray,D,EDM,30,0,0,0,0
3,8477341.0,Andreas Johnsson,L,SJS,29,0,0,0,0
3,8474218.0,Jason Demers,D,EDM,35,0,0,0,0
3,8480844.0,Grigori Denisenko,L,VGK,23,6,0,0,0
3,8484287.0,Cole McWard,D,VAN,22,1,0,0,0
3,8479322.0,Wade Allison,R,PHI,26,0,0,0,0
3,8478846.0,Christian Wolanin,D,VAN,28,0,0,0,0
3,8471887.0,Patric Hornqvist,R,FLA,36,0,0,0,0
3,8475163.0,Alex Chiasson,R,DET,33,0,0,0,0
3,8478881.0,Brett Seney,L,CHI,27,4,0,0,0
3,8474697.0,Mark Borowiecki,D,NSH,34,0,0,0,0
3,8476410.0,Josh Leivo,L,STL,30,0,0,0,0
3,8475968.0,Alex Belzile,R,MTL,32,0,0,0,0
3,8479580.0,Dylan Gambrell,C,OTT,27,0,0,0,0
3,8480901.0,Karson Kuhlman,C,WPG,28,0,0,0,0
3,8480326.0,Sheldon Dries,C,VAN,29,0,0,0,0
3,8478465.0,Guillaume Brisebois,D,VAN,26,0,0,0,0
3,8482861.0,Vincent Iorio,D,WSH,21,6,0,0,0
3,8471794.0,Darren Helm,C,COL,36,0,0,0,0
3,8479335.0,Rasmus Asplund,C,NSH,26,0,0,0,0
3,8478415.0,Jakub Zboril,D,BOS,26,0,0,0,0
3,8476310.0,Lukas Sedlak,C,PHI,30,0,0,0,0
3,8478075.0,Anders Bjork,L,CHI,27,0,0,0,0
3,8480267.0,Sammy Walker,C,MIN,24,4,0,0,0
3,8479578.0,Casey Fitzgerald,D,FLA,26,0,0,0,0
3,8480032.0,Shane Bowers,C,NJD,24,8,0,0,0
3,8478400.0,Colin White,C,PIT,26,28,0,0,0
3,8478431.0,Evgeny Svechnikov,L,SJS,27,0,0,0,0
3,8475772.0,Riley Sheahan,C,BUF,32,0,0,0,0
3,8481690.0,Tyler Angle,C,CBJ,23,2,0,0,0
3,8476326.0,Josh Archibald,R,PIT,31,0,0,0,0
3,8478843.0,Denis Malgin,C,COL,26,0,0,0,0
3,8478446.0,Glenn Gawdin,C,ANA,26,1,0,0,0
3,8477357.0,Saku Maenalanen,R,WPG,29,0,0,0,0
3,8478870.0,Rudolfs Balcers,L,TBL,26,0,0,0,0
3,8478476.0,Kyle Capobianco,D,WPG,26,0,0,0,0
3,8476439.0,Brett Ritchie,R,ARI,30,0,0,0,0
3,8474613.0,Derek Stepan,C,CAR,33,0,0,0,0
3,8475178.0,Zack Kassian,R,ARI,32,0,0,0,0
3,8480226.0,Marián Studenic,R,SEA,25,2,0,0,0
3,8481070.0,Hugh McGing,L,STL,25,5,0,0,0
3,8482250.0,Callahan Burke,C,CAR,26,1,0,0,0
3,8481591.0,Sam Poulin,R,PIT,22,3,0,0,0
3,8481441.0,Joe Snively,C,WSH,27,3,0,0,0
3,8478967.0,Lane Pederson,C,CBJ,26,0,0,0,0
3,8479333.0,Libor Hajek,D,NYR,25,0,0,0,0
3,8480833.0,Vitali Kravtsov,R,VAN,24,0,0,0,0
3,8477460.0,Laurent Dauphin,C,ARI,28,0,0,0,0
3,8481461.0,Corey Schueneman,D,MTL,28,0,0,0,0
3,8474190.0,Wayne Simmonds,R,TOR,35,0,0,0,0
3,8483549.0,Lucas Condotta,L,MTL,26,3,0,0,0
3,8477993.0,Justin Kirkland,C,ARI,27,2,0,0,0
3,8480935.0,Lawrence Pilut,D,BUF,28,0,0,0,0
3,8477210.0,Buddy Robinson,R,CHI,32,0,0,0,0
3,8476851.0,Alex Galchenyuk,C,COL,29,0,0,0,0
3,8482197.0,Adam Raska,R,MIN,22,5,0,0,0
3,8479366.0,Logan Brown,C,STL,25,0,0,0,0
3,8479356.0,Kieffer Bellows,L,PHI,25,0,0,0,0
3,8479533.0,Joona Koppanen,L,PIT,25,4,0,0,0
3,8477401.0,John Hayden,C,SEA,28,2,0,0,0
3,8480822.0,Martin Kaut,R,SJS,24,0,0,0,0
3,8474610.0,Zac Dalpe,C,FLA,34,0,0,0,0
3,8482399.0,Billy Sweezey,D,CBJ,27,0,0,0,0
3,8479991.0,Jake Leschyshyn,C,NYR,24,1,0,0,0
3,8479550.0,Tanner Laczynski,C,PHI,26,0,0,0,0
3,8476166.0,Taylor Fedun,D,PIT,35,0,0,0,0
3,8479338.0,Markus Niemelainen,D,EDM,25,0,0,0,0
3,8477320.0,Anton Blidh,L,NYR,28,1,0,0,0
3,8478147.0,Bokondji Imama,L,ARI,27,6,0,0,0
3,8478067.0,Oskar Lindblom,L,SJS,27,1,0,0,0
3,8478506.0,Gabriel Carlsson,D,WSH,26,0,0,0,0
3,8478131.0,Ondrej Kase,R,CAR,28,0,0,0,0
3,8479644.0,Matt Luff,R,DET,26,0,0,0,0
3,8482824.0,Nick Cicek,D,SJS,23,0,0,0,0
3,8482834.0,Jesper Froden,R,SEA,29,0,0,0,0
3,8478491.0,Jacob Larsson,D,OTT,26,0,0,0,0
3,8474089.0,Brad Malone,C,EDM,34,0,0,0,0
3,8482641.0,Matt Kiersted,D,FLA,25,0,0,0,0
3,8480071.0,Robin Salo,D,NYI,25,0,0,0,0
3,8475461.0,Andrew Agozzino,L,SJS,32,0,0,0,0
3,8475160.0,Kyle Clifford,L,TOR,32,0,0,0,0
3,8480056.0,Jack Rathbone,D,VAN,24,0,0,0,0
3,8481725.0,Elmer Soderblom,L,DET,22,0,0,0,0
3,8479465.0,Drake Caggiula,L,PIT,29,0,0,0,0
3,8476948.0,Charles Hudon,L,COL,29,0,0,0,0
3,8479523.0,Lucas Carlsson,D,FLA,26,0,0,0,0
3,8478455.0,Austin Wagner,L,CHI,26,0,0,0,0
3,8481572.0,Ville Heinola,D,WPG,22,0,0,0,0
3,8479404.0,Henrik Borgstrom,C,WSH,26,0,0,0,0
3,8479944.0,Zach Aston-Reese,C,DET,29,3,0,0,0
3,8482635.0,Mike Hardman,L,CHI,24,0,0,0,0
3,8479705.0,Jeffrey Viel,L,SJS,26,0,0,0,0
3,8480467.0,Austin Strand,D,ANA,26,0,0,0,0
3,8480037.0,Aleksi Heponiemi,C,FLA,24,0,0,0,0
3,8479573.0,Mikhail Maltsev,L,COL,25,0,0,0,0
3,8476404.0,Andy Andreoff,C,NYI,32,0,0,0,0
3,8484125.0,Hunter McKown,C,CBJ,21,0,0,0,0
3,8481649.0,Joona Luoto,L,CBJ,26,0,0,0,0
3,8477981.0,Roland McKeown,D,NSH,27,0,0,0,0
3,8480831.0,Alec Regula,D,CHI,23,0,0,0,0
3,8482691.0,Aatu Raty,C,VAN,21,0,0,0,0
3,8482623.0,Josh Dunne,C,CBJ,25,0,0,0,0
3,8481433.0,Taro Hirose,L,DET,27,0,0,0,0
3,8480328.0,David Gust,R,CHI,29,0,0,0,0
3,8479526.0,Otto Koivula,L,NYI,25,0,0,0,0
3,8476390.0,Joseph Cramarossa,C,MIN,31,0,0,0,0
3,8482654.0,Jackson Cates,C,PHI,26,0,0,0,0
3,8480439.0,Mac Hollowell,D,TOR,25,0,0,0,0
3,8480072.0,Lias Andersson,C,LAK,25,0,0,0,0
3,8479395.0,Dennis Cholowski,D,NYI,25,0,0,0,0
3,8477463.0,Steven Santini,D,STL,28,0,0,0,0
3,8479347.0,Tyler Benson,L,EDM,25,0,0,0,0
3,8477471.0,Dillon Heatherington,D,OTT,28,0,0,0,0
3,8477520.0,Jean-Sebastien Dea,C,ARI,29,0,0,0,0
3,8480846.0,Sampo Ranta,L,COL,23,0,0,0,0
3,8480979.0,Nathan Smith,C,ARI,25,0,0,0,0
3,8484256.0,Jake Livingstone,D,NSH,24,0,0,0,0
3,8476396.0,Steven Fogarty,C,MIN,30,0,0,0,0
3,8479252.0,Dan Renouf,D,BOS,29,0,0,0,0
3,8479518.0,Fredrik Karlström,C,DAL,25,0,0,0,0
3,8481683.0,Aidan McDonough,L,VAN,24,0,0,0,0
3,8478373.0,Nikita Soshnikov,R,NYI,30,0,0,0,0
3,8482081.0,Sean Farrell,C,MTL,22,0,0,0,0
3,8481575.0,Lassi Thomson,D,OTT,23,0,0,0,0
3,8481102.0,Egor Sokolov,L,OTT,23,0,0,0,0
3,8481712.0,Matej Blumel,R,DAL,23,0,0,0,0
3,8479602.0,Jeremy Davies,D,BUF,27,0,0,0,0
3,8480443.0,Kristian Reichel,C,WPG,25,0,0,0,0
3,8479304.0,Kyle Criscuolo,C,SJS,31,0,0,0,0
3,8478224.0,Luke Philp,C,CHI,28,0,0,0,0
3,8480242.0,Arnaud Durandeau,L,NYI,24,0,0,0,0
3,8479329.0,Frederic Allard,D,MTL,26,0,0,0,0
3,8476941.0,Connor Carrick,D,BOS,29,0,0,0,0
3,8479375.0,William Bitten,C,STL,25,0,0,0,0
3,8481720.0,Nick Abruzzese,C,TOR,24,0,0,0,0
3,8482452.0,Elliot Desnoyers,L,PHI,21,0,0,0,0
3,8476915.0,Jujhar Khaira,L,MIN,29,1,0,0,0
3,8483641.0,Anton Levtchi,L,FLA,28,0,0,0,0
3,8481740.0,Tyce Thompson,R,NJD,24,0,0,0,0
3,8478173.0,Hayden Hodgson,R,PHI,27,0,0,0,0
3,8482181.0,Tristen Robins,C,SJS,22,0,0,0,0
3,8481563.0,Drew Helleson,D,ANA,22,0,0,0,0
3,8480863.0,Gabriel Fortier,L,TBL,23,0,0,0,0
3,8478058.0,CJ Suess,L,SJS,29,0,0,0,0
3,8480041.0,Dmitri Samorukov,D,STL,24,0,0,0,0
3,8482179.0,Justin Richards,C,CBJ,25,0,0,0,0
3,8480034.0,Joel Teasdale,L,MTL,24,0,0,0,0
3,8480820.0,Filip Kral,D,TOR,24,0,0,0,0
3,8480842.0,Filip Hallander,C,PIT,23,0,0,0,0
3,8478367.0,Cole Bardreau,C,NYI,30,0,0,0,0
3,8482448.0,Samuel Knazko,D,CBJ,21,0,0,0,0
3,8482711.0,Stanislav Svozil,D,CBJ,20,0,0,0,0
3,8480275.0,Nick Swaney,R,MIN,26,0,0,0,0
3,8480994.0,Damien Giroux,C,MIN,23,0,0,0,0
3,8480977.0,Semyon Der-Arguchintsev,C,TOR,23,0,0,0,0
3,8482207.0,William Dufour,R,NYI,21,0,0,0,0
3,8483464.0,Marco Kasper,C,DET,19,0,0,0,0
3,8483424.0,Owen Beck,C,MTL,19,0,0,0,0
4,8476453.0,Nikita Kucherov,R,TBL,30,81,44,100,144
4,8477492.0,Nathan MacKinnon,C,COL,28,82,51,89,140
4,8478402.0,Connor McDavid,C,EDM,26,76,32,100,132
4,8478550.0,Artemi Panarin,L,NYR,32,82,49,71,120
4,8477956.0,David Pastrnak,R,BOS,27,82,47,63,110
4,8479318.0,Auston Matthews,C,TOR,26,81,69,38,107
4,8477934.0,Leon Draisaitl,C,EDM,28,81,41,65,106
4,8478420.0,Mikko Rantanen,R,COL,27,80,42,62,104
4,8476468.0,J.T. Miller,C,VAN,30,81,37,66,103
4,8477939.0,William Nylander,R,TOR,27,82,40,58,98
4,8478864.0,Kirill Kaprizov,L,MIN,26,75,46,50,96
4,8477933.0,Sam Reinhart,C,FLA,28,82,57,37,94
4,8476887.0,Filip Forsberg,L,NSH,29,82,48,46,94
4,8471675.0,Sidney Crosby,C,PIT,36,82,42,52,94
4,8480800.0,Quinn Hughes,D,VAN,24,82,17,75,92
4,8478010.0,Brayden Point,C,TBL,27,81,46,44,90
4,8480069.0,Cale Makar,D,COL,25,77,21,69,90
4,8478427.0,Sebastian Aho,C,CAR,26,78,36,53,89
4,8480012.0,Elias Pettersson,C,VAN,25,82,34,55,89
4,8479314.0,Matthew Tkachuk,L,FLA,26,80,26,62,88
4,8480023.0,Robert Thomas,C,STL,24,82,26,60,86
4,8474600.0,Roman Josi,D,NSH,33,82,23,62,85
4,8479407.0,Jesper Bratt,L,NJD,25,82,27,56,83
4,8480803.0,Evan Bouchard,D,EDM,24,81,18,64,82
4,8474564.0,Steven Stamkos,C,TBL,33,79,40,41,81
4,8480027.0,Jason Robertson,L,DAL,24,82,29,51,80
4,8478445.0,Mathew Barzal,C,NYI,26,80,23,57,80
4,8477493.0,Aleksander Barkov,C,FLA,28,73,23,57,80
4,8475786.0,Zach Hyman,L,EDM,31,80,54,23,77
4,8480018.0,Nick Suzuki,C,MTL,24,82,33,44,77
4,8477404.0,Jake Guentzel,L,PIT,29,67,30,47,77
4,8476389.0,Vincent Trocheck,C,NYR,30,82,25,52,77
4,8479343.0,Clayton Keller,R,ARI,25,78,33,43,76
4,8475167.0,Victor Hedman,D,TBL,33,78,13,63,76
4,8475184.0,Chris Kreider,L,NYR,32,82,39,36,75
4,8475172.0,Nazem Kadri,C,CGY,33,82,29,46,75
4,8477960.0,Adrian Kempe,R,LAK,27,77,28,47,75
4,8479542.0,Brandon Hagel,L,TBL,25,82,26,49,75
4,8474679.0,Gustav Nyquist,C,NSH,34,81,23,52,75
4,8480801.0,Brady Tkachuk,L,OTT,24,81,37,37,74
4,8481559.0,Jack Hughes,C,NJD,22,62,27,47,74
4,8478444.0,Brock Boeser,R,VAN,26,81,40,33,73
4,8477942.0,Kevin Fiala,L,LAK,27,82,29,44,73
4,8479323.0,Adam Fox,D,NYR,25,72,17,56,73
4,8477409.0,Carter Verhaeghe,C,FLA,28,76,34,38,72
4,8482078.0,Lucas Raymond,L,DET,21,82,31,41,72
4,8476459.0,Mika Zibanejad,C,NYR,30,81,26,46,72
4,8476460.0,Mark Scheifele,C,WPG,30,74,25,47,72
4,8471685.0,Anze Kopitar,C,LAK,36,81,26,44,70
4,8482116.0,Tim Stützle,C,OTT,21,75,18,52,70
4,8480865.0,Noah Dobson,D,NYI,23,79,10,60,70
4,8476539.0,Jonathan Marchessault,R,VGK,33,82,42,27,69
4,8475754.0,Brock Nelson,C,NYI,32,82,34,35,69
4,8477946.0,Dylan Larkin,C,DET,27,68,33,36,69
4,8475158.0,Ryan O'Reilly,C,NSH,32,82,26,43,69
4,8477504.0,Josh Morrissey,D,WPG,28,81,10,59,69
4,8478439.0,Travis Konecny,R,PHI,26,76,33,35,68
4,8477500.0,Bo Horvat,C,NYI,28,81,33,35,68
4,8478403.0,Jack Eichel,C,VGK,27,63,31,37,68
4,8481557.0,Matt Boldy,L,MIN,22,75,29,39,68
4,8482093.0,Seth Jarvis,C,CAR,21,81,33,34,67
4,8479385.0,Jordan Kyrou,C,STL,25,82,31,36,67
4,8473419.0,Brad Marchand,L,BOS,35,82,29,38,67
4,8480002.0,Nico Hischier,C,NJD,24,71,27,40,67
4,8471215.0,Evgeni Malkin,C,PIT,37,82,27,40,67
4,8478440.0,Dylan Strome,C,WSH,26,82,27,40,67
4,8479337.0,Alex DeBrincat,R,DET,26,82,27,40,67
4,8470794.0,Joe Pavelski,C,DAL,39,82,27,40,67
4,8476454.0,Ryan Nugent-Hopkins,C,EDM,30,80,18,49,67
4,8480208.0,Drake Batherson,R,OTT,25,82,28,38,66
4,8482740.0,Wyatt Johnston,C,DAL,20,82,32,33,65
4,8471214.0,Alex Ovechkin,L,WSH,38,79,31,34,65
4,8478449.0,Roope Hintz,C,DAL,27,80,30,35,65
4,8475166.0,John Tavares,C,TOR,33,80,29,36,65
4,8481540.0,Cole Caufield,R,MTL,22,82,28,37,65
4,8475168.0,Matt Duchene,C,DAL,32,80,25,40,65
4,8478493.0,Joel Eriksson Ek,C,MIN,26,77,30,34,64
4,8473512.0,Claude Giroux,R,OTT,35,82,21,43,64
4,8477402.0,Pavel Buchnevich,L,STL,28,80,27,36,63
4,8475692.0,Mats Zuccarello,R,MIN,36,69,12,51,63
4,8477955.0,Jared McCann,L,SEA,27,80,29,33,62
4,8476875.0,Mike Matheson,D,MTL,29,82,11,51,62
4,8478398.0,Kyle Connor,L,WPG,27,65,34,27,61
4,8477940.0,Nikolaj Ehlers,L,WPG,27,82,25,36,61
4,8477951.0,Nick Schmaltz,C,ARI,27,79,22,39,61
4,8478366.0,Frank Vatrano,R,ANA,29,82,37,23,60
4,8476448.0,William Karlsson,C,VGK,30,70,30,30,60
4,8475745.0,Charlie Coyle,C,BOS,31,82,25,35,60
4,8473994.0,Jamie Benn,L,DAL,34,82,21,39,60
4,8475798.0,Mikael Granlund,C,SJS,31,69,12,48,60
4,8476346.0,Johnny Gaudreau,L,CBJ,30,81,12,48,60
4,8481068.0,Yegor Sharangovich,C,CGY,25,82,31,28,59
4,8477497.0,Sean Monahan,C,WPG,29,83,26,33,59
4,8477949.0,Alex Tuch,R,BUF,27,75,22,37,59
4,8478401.0,Pavel Zacha,C,BOS,26,78,21,38,59
4,8480839.0,Rasmus Dahlin,D,BUF,23,81,20,39,59
4,8477416.0,Oliver Bjorkstrand,R,SEA,28,82,20,39,59
4,8476853.0,Morgan Rielly,D,TOR,29,72,7,51,58
4,8479675.0,Trevor Moore,L,LAK,28,82,31,26,57
4,8482109.0,Alexis Lafrenière,L,NYR,22,82,28,29,57
4,8479999.0,Casey Mittelstadt,C,BUF,25,80,18,39,57
4,8481711.0,Matias Maccelli,L,ARI,23,82,17,40,57
4,8478460.0,Zach Werenski,D,CBJ,26,70,11,46,57
4,8479420.0,Tage Thompson,C,BUF,26,71,29,27,56
4,8475810.0,Bryan Rust,R,PIT,31,62,28,28,56
4,8477494.0,Jonathan Drouin,L,COL,28,79,19,37,56
4,8474578.0,Erik Karlsson,D,PIT,33,82,11,45,56
4,8476906.0,Shayne Gostisbehere,D,DET,30,81,10,46,56
4,8475726.0,Tyler Toffoli,R,NJD,31,79,33,22,55
4,8475765.0,Vladimir Tarasenko,R,OTT,32,76,23,32,55
4,8482124.0,Quinton Byfield,R,LAK,21,80,20,35,55
4,8478047.0,Michael Bunting,L,CAR,28,81,19,36,55
4,8475151.0,Kyle Palmieri,C,NYI,32,82,30,24,54
4,8476399.0,Blake Coleman,C,CGY,32,78,30,24,54
4,8478873.0,Troy Terry,R,ANA,26,76,20,34,54
4,8480798.0,Philipp Kurashev,C,CHI,24,75,18,36,54
4,8480036.0,Miro Heiskanen,D,DAL,24,71,9,45,54
4,8477501.0,Valeri Nichushkin,R,COL,28,54,28,25,53
4,8480015.0,Owen Tippett,R,PHI,24,78,28,25,53
4,8476882.0,Teuvo Teravainen,L,CAR,29,76,25,28,53
4,8480039.0,Martin Necas,C,CAR,24,77,24,29,53
4,8478975.0,Mason Marchment,L,DAL,28,81,22,31,53
4,8475913.0,Mark Stone,R,VGK,31,56,16,37,53
4,8478414.0,Timo Meier,R,NJD,27,69,28,24,52
4,8475794.0,Tyler Seguin,C,DAL,31,68,25,27,52
4,8477346.0,MacKenzie Weegar,D,CGY,29,82,20,32,52
4,8480830.0,Andrei Svechnikov,R,CAR,23,59,19,33,52
4,8476456.0,Jonathan Huberdeau,C,CGY,30,81,12,40,52
4,8474590.0,John Carlson,D,WSH,33,82,10,42,52
4,8474641.0,Adam Henrique,C,ANA,33,82,24,27,51
4,8476905.0,Chandler Stephenson,C,VGK,29,75,16,35,51
4,8471724.0,Kris Letang,D,PIT,36,82,10,41,51
4,8482175.0,JJ Peterka,R,BUF,21,82,28,22,50
4,8480797.0,Joel Farabee,L,PHI,23,82,22,28,50
4,8483515.0,Juraj Slafkovsky,L,MTL,19,82,20,30,50
4,8474563.0,Drew Doughty,D,LAK,34,82,15,35,50
4,8478038.0,Devon Toews,D,COL,29,82,12,38,50
4,8477456.0,J.T. Compher,L,DET,28,77,19,29,48
4,8479425.0,Filip Hronek,D,VAN,26,81,5,43,48
4,8474141.0,Patrick Kane,R,DET,35,50,20,27,47
4,8478856.0,Conor Garland,R,VAN,27,82,20,27,47
4,8481528.0,Dylan Cozens,C,BUF,22,79,18,29,47
4,8476479.0,Phillip Danault,C,LAK,30,78,17,30,47
4,8474102.0,David Perron,L,DET,35,76,17,30,47
4,8481581.0,Thomas Harley,D,DAL,22,79,15,32,47
4,8478396.0,Noah Hanifin,D,CGY,26,80,13,34,47
4,8476869.0,Brady Skjei,D,CAR,29,80,13,34,47
4,8479325.0,Charlie McAvoy,D,BOS,26,74,12,35,47
4,8482684.0,Luke Hughes,D,NJD,20,82,9,38,47
4,8477503.0,Max Domi,C,TOR,28,80,9,38,47
4,8482122.0,Brock Faber,D,MIN,21,82,8,39,47
4,8477426.0,Nicholas Paul,L,TBL,28,82,24,22,46
4,8475784.0,Jeff Skinner,L,BUF,31,74,24,22,46
4,8483808.0,Andrei Kuzmenko,L,CGY,27,72,22,24,46
4,8475170.0,Brayden Schenn,C,STL,32,82,20,26,46
4,8478407.0,Vince Dunn,D,SEA,27,59,11,35,46
4,8475760.0,Nick Bjugstad,C,ARI,31,76,22,23,45
4,8477451.0,Ryan Hartman,R,MIN,29,74,21,24,45
4,8478519.0,Anthony Cirelli,C,TBL,26,79,20,25,45
4,8477964.0,Ivan Barbashev,C,VGK,28,82,19,26,45
4,8478438.0,Tommy Novak,C,NSH,26,71,18,27,45
4,8482667.0,William Eklund,L,SJS,21,80,16,29,45
4,8477021.0,Alex Kerfoot,C,ARI,29,82,13,32,45
4,8475218.0,Mattias Ekholm,D,EDM,33,79,11,34,45
4,8480188.0,Fabian Zetterlund,L,SJS,24,82,24,20,44
4,8475169.0,Evander Kane,L,EDM,32,77,24,20,44
4,8477511.0,Anthony Mantha,R,WSH,29,74,23,21,44
4,8474586.0,Jordan Eberle,R,SEA,33,78,17,27,44
4,8477496.0,Elias Lindholm,C,VAN,29,75,15,29,44
4,8477948.0,Travis Sanheim,D,PHI,27,81,10,34,44
4,8477479.0,Tyler Bertuzzi,L,TOR,28,80,21,22,43
4,8478466.0,Daniel Sprong,R,DET,26,76,18,25,43
4,8470613.0,Brent Burns,D,CAR,38,82,10,33,43
4,8476438.0,Brandon Saad,L,STL,31,82,26,16,42
4,8477407.0,Anthony Duclair,L,SJS,28,73,24,18,42
4,8478474.0,Lawson Crouse,L,ARI,26,81,23,19,42
4,8480893.0,Kirill Marchenko,R,CBJ,23,78,23,19,42
4,8482745.0,Mason McTavish,C,ANA,20,64,19,23,42
4,8481542.0,Moritz Seider,D,DET,22,82,9,33,42
4,8477447.0,Shea Theodore,D,VGK,28,47,5,37,42
4,8477935.0,Sam Bennett,C,FLA,27,69,20,21,41
4,8477998.0,Warren Foegele,L,EDM,27,82,20,21,41
4,8480009.0,Eeli Tolvanen,R,SEA,24,81,16,25,41
4,8479345.0,Jakob Chychrun,D,OTT,25,82,14,27,41
4,8480028.0,Morgan Frost,C,PHI,24,71,13,28,41
4,8478462.0,Nicolas Roy,C,VGK,26,70,13,28,41
4,8476458.0,Ryan Strome,C,ANA,30,79,11,30,41
4,8480434.0,Sean Durzi,D,ARI,25,76,9,32,41
4,8482079.0,Marco Rossi,C,MIN,22,82,21,19,40
4,8478498.0,Jake DeBrusk,L,BOS,27,80,19,21,40
4,8479365.0,Trent Frederic,C,BOS,25,82,18,22,40
4,8479525.0,Ross Colton,C,COL,27,80,17,23,40
4,8479400.0,Pierre-Luc Dubois,C,LAK,25,82,16,24,40
4,8478233.0,Andrew Mangiapane,L,CGY,27,75,14,26,40
4,8475191.0,Reilly Smith,R,PIT,32,76,13,27,40
4,8479987.0,Morgan Geekie,C,BOS,25,76,17,22,39
4,8482146.0,Luke Evangelista,R,NSH,21,80,16,23,39
4,8474150.0,Mikael Backlund,C,CGY,34,82,15,24,39
4,8476872.0,Scott Laughton,C,PHI,29,82,13,26,39
4,8478542.0,Evan Rodrigues,C,FLA,30,80,12,27,39
4,8478055.0,Gustav Forsling,D,FLA,27,79,10,29,39
4,8478397.0,Rasmus Andersson,D,CGY,27,78,9,30,39
4,8475764.0,Cam Fowler,D,ANA,32,81,5,34,39
4,8476792.0,Torey Krug,D,STL,32,77,4,35,39
4,8482089.0,Jake Neighbours,L,STL,21,77,27,11,38
4,8482149.0,Cole Perfetti,C,WPG,21,71,19,19,38
4,8476881.0,Tomas Hertl,C,SJS,30,54,17,21,38
4,8474037.0,James van Riemsdyk,L,BOS,34,71,11,27,38
4,8482105.0,Jake Sanderson,D,OTT,21,79,10,28,38
4,8475314.0,Anders Lee,L,NYI,33,81,20,17,37
4,8473422.0,Nick Foligno,L,CHI,36,74,17,20,37
4,8482665.0,Matty Beniers,C,SEA,21,77,15,22,37
4,8476483.0,Rickard Rakell,R,PIT,30,70,15,22,37
4,8476474.0,Stefan Noesen,R,CAR,30,81,14,23,37
4,8476480.0,Vladislav Namestnikov,C,WPG,31,78,11,26,37
4,8476958.0,Jaccob Slavin,D,CAR,29,81,6,31,37
4,8481535.0,Nils Hoglander,L,VAN,23,80,24,12,36
4,8480014.0,Gabriel Vilardi,C,WPG,24,47,22,14,36
4,8473986.0,Alex Killorn,L,ANA,34,63,18,18,36
4,8478046.0,Danton Heinen,L,BOS,28,74,17,19,36
4,8478891.0,Mason Appleton,C,WPG,27,82,14,22,36
4,8476432.0,Boone Jenner,C,CBJ,30,58,22,13,35
4,8477450.0,Jason Dickinson,C,CHI,28,82,22,13,35
4,8476880.0,Tom Wilson,R,WSH,29,74,18,17,35
4,8482699.0,Dylan Guenther,R,ARI,20,45,18,17,35
4,8475287.0,Erik Haula,L,NJD,32,76,16,19,35
4,8476925.0,Colton Sissons,C,NSH,30,81,15,20,35
4,8482720.0,Matthew Knies,L,TOR,21,80,15,20,35
4,8482113.0,Anton Lundell,C,FLA,22,78,13,22,35
4,8476392.0,Adam Lowry,C,WPG,30,81,12,23,35
4,8478472.0,Mathieu Joseph,R,OTT,26,72,11,24,35
4,8475799.0,Nino Niederreiter,R,WPG,31,77,18,16,34
4,8477476.0,Artturi Lehkonen,L,COL,28,45,16,18,34
4,8481618.0,Alex Newhook,C,MTL,22,55,15,19,34
4,8482159.0,Tyson Foerster,R,PHI,21,77,20,13,33
4,8482110.0,Dawson Mercer,C,NJD,22,82,20,13,33
4,8481580.0,Connor McMichael,C,WSH,22,80,18,15,33
4,8482055.0,Drew O'Connor,L,PIT,25,79,16,17,33
4,8477429.0,Andrew Copp,C,DET,29,79,13,20,33
4,8479992.0,Michael Rasmussen,C,DET,24,75,13,20,33
4,8476826.0,Yanni Gourde,C,SEA,32,80,11,22,33
4,8476419.0,Jean-Gabriel Pageau,C,NYI,31,82,11,22,33
4,8477986.0,Brandon Montour,D,FLA,29,66,8,25,33
4,8482671.0,Owen Power,D,BUF,21,76,6,27,33
4,8478178.0,Darren Raddysh,D,TBL,27,82,6,27,33
4,8480145.0,Neal Pionk,D,WPG,28,82,5,28,33
4,8474565.0,Alex Pietrangelo,D,VGK,33,64,4,29,33
4,8478057.0,Dakota Joshua,C,VAN,27,63,18,14,32
4,8477952.0,Robby Fabbri,C,DET,27,68,18,14,32
4,8476921.0,Jordan Martinook,L,CAR,31,82,14,18,32
4,8475722.0,Jason Zucker,L,ARI,31,69,14,18,32
4,8482705.0,Cole Sillinger,C,CBJ,20,77,13,19,32
4,8477498.0,Darnell Nurse,D,EDM,28,81,10,22,32
4,8475171.0,Oliver Ekman-Larsson,D,FLA,32,80,9,23,32
4,8478500.0,Ivan Provorov,D,CBJ,26,82,5,27,32
4,8474151.0,Ryan McDonagh,D,NSH,34,74,3,29,32
4,8474870.0,Tyler Johnson,C,CHI,33,67,17,14,31
4,8475848.0,Brendan Gallagher,R,MTL,31,77,16,15,31
4,8474189.0,Lars Eller,C,PIT,34,82,15,16,31
4,8476292.0,Ondrej Palat,L,NJD,32,71,11,20,31
4,8481624.0,Ilya Mikheyev,R,VAN,29,78,11,20,31
4,8478458.0,Jack Roslovic,C,CBJ,26,59,9,22,31
4,8477495.0,Seth Jones,D,CHI,29,67,8,23,31
4,8476979.0,Erik Gustafsson,D,NYR,31,76,6,25,31
4,8476331.0,Dylan DeMelo,D,WPG,30,82,3,28,31
4,8480064.0,Josh Norris,C,OTT,24,50,16,14,30
4,8475768.0,Jaden Schwartz,C,SEA,31,62,13,17,30
4,8480802.0,Ryan McLeod,C,EDM,24,81,12,18,30
4,8477987.0,Ryan Donato,C,CHI,27,78,12,18,30
4,8475149.0,Marcus Johansson,L,MIN,33,78,11,19,30
4,8481546.0,Cam York,D,PHI,22,82,10,20,30
4,8477505.0,Alex Wennberg,C,SEA,29,79,10,20,30
4,8473533.0,Jordan Staal,C,CAR,35,80,10,20,30
4,8478469.0,Thomas Chabot,D,OTT,26,51,9,21,30
4,8480817.0,K'Andre Miller,D,NYR,23,80,8,22,30
4,8477969.0,Marcus Pettersson,D,PIT,27,82,4,26,30
4,8475753.0,Justin Faulk,D,STL,31,60,2,28,30
4,8479619.0,Michael Carcone,L,ARI,27,74,21,8,29
4,8482475.0,Yegor Chinakhov,R,CBJ,22,53,16,13,29
4,8480459.0,Pius Suter,C,VAN,27,67,14,15,29
4,8475763.0,Kevin Hayes,R,STL,31,79,13,16,29
4,8481524.0,Bowen  Byram,D,COL,22,73,11,18,29
4,8480336.0,Sean Walker,D,PHI,29,81,10,19,29
4,8481656.0,Aliaksei Protas,C,WSH,22,78,6,23,29
4,8474574.0,Tyler Myers,D,VAN,33,77,5,24,29
4,8482125.0,Alexander Holtz,R,NJD,21,82,16,12,28
4,8480813.0,Joe Veleno,C,DET,23,80,12,16,28
4,8480068.0,Ryan Poehling,C,PHI,24,77,11,17,28
4,8478413.0,Jordan Greenway,L,BUF,26,67,10,18,28
4,8478115.0,Pierre Engvall,L,NYI,27,74,10,18,28
4,8476923.0,Damon Severson,D,CBJ,29,67,9,19,28
4,8476931.0,Jake McCabe,D,TOR,30,73,8,20,28
4,8478133.0,Jake Evans,C,MTL,27,82,7,21,28
4,8476927.0,Teddy Blueger,C,VAN,29,68,6,22,28
4,8475181.0,Nick Leddy,D,STL,32,82,3,25,28
4,8478020.0,Michael Amadio,R,VGK,27,73,14,13,27
4,8481582.0,Nicholas Robertson,L,TOR,22,56,14,13,27
4,8480185.0,Eetu Luostarinen,C,FLA,25,82,12,15,27
4,8480829.0,Jesperi Kotkaniemi,C,CAR,23,79,12,15,27
4,8480113.0,Alex Iafallo,L,WPG,30,82,11,16,27
4,8480748.0,Kiefer Sherwood,L,NSH,28,68,10,17,27
4,8481596.0,Shane Pinto,C,OTT,23,41,9,18,27
4,8480835.0,Jack Drury,C,CAR,23,74,8,19,27
4,8476463.0,Jonas Brodin,D,MIN,30,62,7,20,27
4,8482092.0,Ridly Greig,C,OTT,21,72,13,13,26
4,8476918.0,Jimmy Vesey,L,NYR,30,80,13,13,26
4,8476892.0,Colton Parayko,D,STL,30,82,10,16,26
4,8479941.0,Justin Danforth,R,CBJ,30,71,10,16,26
4,8477425.0,Miles Wood,L,COL,28,74,9,17,26
4,8480855.0,Jack McBain,C,ARI,23,67,8,18,26
4,8474602.0,Justin Schultz,D,SEA,33,70,7,19,26
4,8475790.0,Erik Gudbranson,D,CBJ,31,78,6,20,26
4,8475200.0,Dmitry Orlov,D,CAR,32,82,6,20,26
4,8482655.0,J.J. Moser,D,ARI,23,80,5,21,26
4,8476902.0,Esa Lindell,D,DAL,29,82,5,21,26
4,8475188.0,Brayden McNabb,D,VGK,32,82,4,22,26
4,8476854.0,Hampus Lindholm,D,BOS,29,73,3,23,26
4,8474673.0,TJ Brodie,D,TOR,33,78,1,25,26
4,8476469.0,Joel Armia,R,MTL,30,66,17,8,25
4,8481601.0,Simon Holmstrom,R,NYI,22,75,15,10,25
4,8481186.0,Logan O'Connor,R,COL,27,57,13,12,25
4,8471698.0,T.J. Oshie,R,WSH,37,52,12,13,25
4,8479591.0,Michael Eyssimont,C,TBL,27,81,11,14,25
4,8476312.0,Josh Manson,D,COL,32,76,8,17,25
4,8478136.0,Jake Middleton,D,MIN,27,80,7,18,25
4,8481032.0,Paul Cotter,C,VGK,24,76,7,18,25
4,8477508.0,Curtis Lazar,C,NJD,28,71,7,18,25
4,8482245.0,Artem Zub,D,OTT,28,69,5,20,25
4,8478911.0,Matt Roy,D,LAK,28,81,5,20,25
4,8476879.0,Cody Ceci,D,EDM,30,79,5,20,25
4,8478507.0,John Marino,D,NJD,26,75,4,21,25
4,8478840.0,Will Borgen,D,SEA,27,82,3,22,25
4,8482259.0,Bobby McMann,C,TOR,27,56,15,9,24
4,8481604.0,Pavel Dorofeyev,L,VGK,23,47,13,11,24
4,8478043.0,Sam Lafferty,C,VAN,28,79,13,11,24
4,8479351.0,Sam Steel,C,DAL,25,77,9,15,24
4,8475193.0,Tomas Tatar,L,SEA,33,70,9,15,24
4,8475744.0,Evgeny Kuznetsov,C,WSH,31,63,8,16,24
4,8475233.0,David Savard,D,MTL,33,60,6,18,24
4,8476422.0,Mike Reilly,D,NYI,30,61,6,18,24
4,8474031.0,Kevin Shattenkirk,D,BOS,34,61,6,18,24
4,8473507.0,Jeff Petry,D,DET,36,73,3,21,24
4,8480246.0,Nick Perbix,D,TBL,25,77,2,22,24
4,8481606.0,Jordan Spence,D,LAK,22,71,2,22,24
4,8477947.0,Sonny Milano,L,WSH,27,49,15,8,23
4,8475793.0,Ryan Johansen,C,COL,31,63,13,10,23
4,8480821.0,Filip Zadina,R,SJS,24,72,13,10,23
4,8474149.0,Evgenii Dadonov,R,DAL,34,51,12,11,23
4,8475231.0,Casey Cizikas,C,NYI,32,70,10,13,23
4,8474884.0,Mike Hoffman,C,SJS,34,66,10,13,23
4,8482062.0,Cole Smith,L,NSH,28,80,9,14,23
4,8478882.0,Vladislav Gavrikov,D,LAK,28,77,6,17,23
4,8474157.0,Max Pacioretty,L,WSH,35,47,4,19,23
4,8480873.0,Rasmus Sandin,D,WSH,23,68,3,20,23
4,8480043.0,Timothy Liljegren,D,TOR,24,55,3,20,23
4,8475343.0,Nic Dowd,C,WSH,33,64,12,10,22
4,8470621.0,Corey Perry,R,EDM,38,54,12,10,22
4,8473449.0,Kyle Okposo,R,BUF,35,67,12,10,22
4,8477446.0,Michael McCarron,R,NSH,28,70,12,10,22
4,8481517.0,Brett Leason,R,ANA,24,68,11,11,22
4,8478970.0,Jalen Chatfield,D,CAR,27,72,8,14,22
4,8481014.0,Alexander Romanov,D,NYI,23,81,7,15,22
4,8482087.0,Kaiden Guhle,D,MTL,21,70,6,16,22
4,8477953.0,Kasperi Kapanen,R,STL,27,73,6,16,22
4,8476885.0,Jacob Trouba,D,NYR,29,69,3,19,22
4,8480281.0,Alexey Toropchenko,R,STL,24,82,14,7,21
4,8482157.0,Will Cuylle,L,NYR,21,81,13,8,21
4,8478013.0,Jake Walman,D,DET,27,63,12,9,21
4,8475714.0,Calle Jarnkrok,C,TOR,32,52,10,11,21
4,8475220.0,Marcus Foligno,L,MIN,32,55,9,12,21
4,8471218.0,Blake Wheeler,R,NYR,37,54,9,12,21
4,8479359.0,Beck Malenstyn,L,WSH,25,81,6,15,21
4,8476897.0,Oskar Sundqvist,C,STL,29,71,6,15,21
4,8481178.0,Egor Zamula,D,PHI,23,66,5,16,21
4,8480891.0,Michael Kesselring,D,ARI,23,65,5,16,21
4,8479983.0,Mario Ferraro,D,SJS,25,78,3,18,21
4,8475225.0,Craig Smith,C,DAL,34,75,11,9,20
4,8476981.0,Josh Anderson,R,MTL,29,78,9,11,20
4,8475455.0,Brenden Dillon,D,WPG,33,77,8,12,20
4,8481577.0,Philip Tomasino,C,NSH,22,41,7,13,20
4,8477507.0,Nikita Zadorov,D,VAN,28,75,6,14,20
4,8475279.0,Ben Chiarot,D,DET,32,77,5,15,20
4,8478851.0,Alexandre Carrier,D,NSH,27,73,4,16,20
4,8480035.0,Henri Jokiharju,D,BUF,24,74,3,17,20
4,8480073.0,Erik Brannstrom,D,OTT,24,76,3,17,20
4,8475179.0,Dmitry Kulikov,D,FLA,33,76,1,19,20
4,8481554.0,Kaapo Kakko,R,NYR,22,61,13,6,19
4,8480980.0,Connor Dewar,C,MIN,24,74,11,8,19
4,8479415.0,Michael McLeod,C,NJD,25,45,10,9,19
4,8482097.0,Jack Quinn,R,BUF,22,27,9,10,19
4,8480144.0,David Kampf,C,TOR,28,78,8,11,19
4,8479353.0,Brett Howden,C,VGK,25,72,8,11,19
4,8475164.0,Jakob Silfverberg,R,ANA,33,81,7,12,19
4,8476889.0,Radek Faksa,C,DAL,29,74,7,12,19
4,8473504.0,Cal Clutterbuck,R,NYI,36,82,7,12,19
4,8475855.0,Jesper Fast,R,CAR,32,73,6,13,19
4,8477380.0,Jonny Brodzinski,C,NYR,30,57,6,13,19
4,8471699.0,Andrew Cogliano,C,COL,36,75,6,13,19
4,8477506.0,Ryan Pulock,D,NYI,29,58,5,14,19
4,8480172.0,Jan Rutta,D,SJS,33,69,5,14,19
4,8482073.0,Braden Schneider,D,NYR,22,82,5,14,19
4,8478432.0,Christian Fischer,R,DET,26,79,5,14,19
4,8479410.0,Mikhail Sergachev,D,TBL,25,34,2,17,19
4,8475690.0,Chris Tanev,D,CGY,34,75,2,17,19
4,8480878.0,Nils Lundkvist,D,DAL,23,59,2,17,19
4,8479316.0,Luke Kunin,C,SJS,26,77,11,7,18
4,8480289.0,Morgan Barron,C,WPG,25,80,11,7,18
4,8476374.0,Sean Kuraly,C,CBJ,30,62,9,9,18
4,8480448.0,Parker Kelly,L,OTT,24,80,8,10,18
4,8478434.0,Keegan Kolesar,R,VGK,26,79,8,10,18
4,8475462.0,Radko Gudas,D,ANA,33,66,6,12,18
4,8480220.0,Noah Cates,L,PHI,24,59,6,12,18
4,8476457.0,Adam Larsson,D,SEA,31,81,4,14,18
4,8477932.0,Aaron Ekblad,D,FLA,27,51,4,14,18
4,8477365.0,Connor Clifton,D,BUF,28,79,4,14,18
4,8476874.0,Olli Maatta,D,DET,29,72,4,14,18
4,8479398.0,Samuel Girard,D,COL,25,59,3,15,18
4,8479998.0,Mikey Anderson,D,LAK,24,74,2,16,18
4,8480049.0,Dylan Samberg,D,WPG,24,78,1,17,18
4,8478508.0,Yakov Trenin,C,NSH,26,76,12,5,17
4,8477903.0,Garnet Hathaway,R,PHI,32,82,7,10,17
4,8480995.0,Pontus Holmberg,R,TOR,24,54,7,10,17
4,8479315.0,Joey Anderson,R,CHI,25,55,5,12,17
4,8478463.0,Anthony Beauvillier,L,CHI,26,60,5,12,17
4,8474166.0,Alec Martinez,D,VGK,36,55,4,13,17
4,8481522.0,Peyton Krebs,C,BUF,22,80,4,13,17
4,8478859.0,Niko Mikkola,D,FLA,27,82,3,14,17
4,8479324.0,Ryan Lindgren,D,NYR,25,76,3,14,17
4,8481605.0,Jackson LaCombe,D,ANA,22,71,2,15,17
4,8479976.0,Juuso Valimaki,D,ARI,25,68,2,15,17
4,8470600.0,Ryan Suter,D,DAL,38,82,2,15,17
4,8480884.0,Calen Addison,D,SJS,23,72,1,16,17
4,8475842.0,Sam Carrick,C,ANA,31,77,10,6,16
4,8479977.0,Kailer Yamamoto,R,SEA,25,59,8,8,16
4,8473453.0,Trevor Lewis,C,LAK,36,82,8,8,16
4,8480205.0,Emil Bemstrom,R,CBJ,24,56,8,8,16
4,8479293.0,Brandon Tanev,L,SEA,32,66,7,9,16
4,8477444.0,Andre Burakovsky,L,SEA,28,49,7,9,16
4,8475208.0,Brian Dumoulin,D,SEA,32,80,6,10,16
4,8482660.0,Kent Johnson,C,CBJ,21,42,6,10,16
4,8477979.0,Nicolas Aube-Kubel,R,WSH,27,60,6,10,16
4,8476462.0,Dougie Hamilton,D,NJD,30,20,5,11,16
4,8482117.0,Lukas Reichel,L,CHI,21,65,5,11,16
4,8474034.0,Pat Maroon,L,MIN,35,51,4,12,16
4,8480796.0,Martin Fehervary,D,WSH,24,66,3,13,16
4,8476967.0,Brett Kulak,D,EDM,29,82,3,13,16
4,8471677.0,Jack Johnson,D,COL,36,80,3,13,16
4,8481568.0,Alex Vlasic,D,CHI,22,76,2,14,16
4,8476917.0,Adam Pelech,D,NYI,29,58,1,15,16
4,8479423.0,Alex Nylander,L,PIT,25,28,11,4,15
4,8478831.0,Kevin Stenlund,C,FLA,27,81,11,4,15
4,8470604.0,Jeff Carter,C,PIT,38,72,11,4,15
4,8477330.0,Dominik Kubalik,L,OTT,28,74,11,4,15
4,8476873.0,Mark Jankowski,C,NSH,29,32,7,8,15
4,8476393.0,Nick Cousins,C,FLA,30,69,7,8,15
4,8481560.0,Arthur Kaliyev,R,LAK,22,51,7,8,15
4,8481481.0,Blake Lizotte,C,LAK,26,62,7,8,15
4,8478109.0,Victor Olofsson,L,BUF,28,51,7,8,15
4,8481533.0,Trevor Zegras,C,ANA,22,31,6,9,15
4,8478042.0,Viktor Arvidsson,R,LAK,30,18,6,9,15
4,8474090.0,Brendan Smith,D,NJD,34,63,5,10,15
4,8477919.0,Frederick Gaudreau,C,MIN,30,67,5,10,15
4,8479368.0,Max Jones,L,ANA,25,52,5,10,15
4,8477839.0,Conor Sheary,L,TBL,31,57,4,11,15
4,8476467.0,Jamie Oleksiak,D,SEA,31,82,2,13,15
4,8475197.0,Tyson Barrie,D,NSH,32,41,1,14,15
4,8476878.0,Zemgus Girgensons,L,BUF,29,63,8,6,14
4,8480011.0,Klim Kostin,C,DET,24,52,8,6,14
4,8479661.0,Tanner Jeannot,L,TBL,26,55,7,7,14
4,8478468.0,Jeremy Lauzon,D,NSH,26,79,6,8,14
4,8480003.0,Jesper Boqvist,C,BOS,25,47,6,8,14
4,8479390.0,Taylor Raddysh,R,CHI,25,73,5,9,14
4,8477070.0,Liam O'Brien,C,ARI,29,75,5,9,14
4,8478443.0,Brandon Carlo,D,BOS,27,76,4,10,14
4,8480879.0,Jacob Bernard-Docker,D,OTT,23,72,4,10,14
4,8477392.0,Hudson Fasching,R,NYI,28,45,4,10,14
4,8477435.0,Ryan Graves,D,PIT,28,70,3,11,14
4,8474567.0,Zach Bogosian,D,MIN,33,65,3,11,14
4,8480887.0,Jordan Harris,D,MTL,23,56,3,11,14
4,8480727.0,Zach Whitecloud,D,VGK,27,61,2,12,14
4,8477220.0,Nate Schmidt,D,WPG,32,63,2,12,14
4,8475324.0,Nick Jensen,D,WSH,33,78,1,13,14
4,8480001.0,Urho Vaakanainen,D,ANA,24,68,1,13,14
4,8477845.0,Trevor van Riemsdyk,D,WSH,32,70,0,14,14
4,8482111.0,Justin Barron,D,MTL,22,48,7,6,13
4,8479383.0,Boris Katchouk,L,CHI,25,59,7,6,13
4,8477573.0,Nathan Walker,L,STL,29,45,7,6,13
4,8480192.0,Johnathan Kovacevic,D,MTL,26,62,6,7,13
4,8479996.0,Cody Glass,C,NSH,24,41,6,7,13
4,8481477.0,Nico Sturm,C,SJS,28,63,5,8,13
4,8476871.0,Tanner Pearson,L,MTL,31,54,5,8,13
4,8479520.0,Brandon Duhaime,R,MIN,26,80,5,8,13
4,8479402.0,Jake Bean,D,CBJ,25,72,4,9,13
4,8482222.0,Alexander Barabanov,L,SJS,29,46,4,9,13
4,8477488.0,Brett Pesce,D,CAR,29,70,3,10,13
4,8479371.0,Dante Fabbro,D,NSH,25,56,3,10,13
4,8478416.0,Erik Cernak,D,TBL,26,69,2,11,13
4,8476372.0,Nick Seeler,D,PHI,30,71,1,12,13
4,8481704.0,Juuso Parssinen,C,NSH,22,44,8,4,12
4,8476278.0,Colin Blackwell,C,CHI,30,44,8,4,12
4,8479336.0,Carl Grundstrom,R,LAK,26,50,8,4,12
4,8471709.0,Marc-Edouard Vlasic,D,SJS,36,57,6,6,12
4,8479393.0,Noah Gregor,C,TOR,25,63,6,6,12
4,8478421.0,A.J. Greer,L,CGY,27,59,6,6,12
4,8479671.0,Mathieu Olivier,R,CBJ,26,54,5,7,12
4,8477846.0,Ryan Carpenter,C,SJS,32,62,5,7,12
4,8478585.0,Derek Ryan,C,EDM,37,70,5,7,12
4,8479414.0,Nathan Bastian,R,NJD,26,54,5,7,12
4,8477015.0,Connor Brown,R,EDM,29,71,4,8,12
4,8476624.0,Barclay Goodrow,C,NYR,30,80,4,8,12
4,8477406.0,Mattias Janmark,C,EDM,31,71,4,8,12
4,8476919.0,Chris Tierney,C,NJD,29,52,4,8,12
4,8479543.0,Michael Pezzetta,L,MTL,25,61,3,9,12
4,8475825.0,Jani Hakanpää,D,DAL,31,64,2,10,12
4,8479980.0,Nicolas Hague,D,VGK,25,73,2,10,12
4,8476822.0,Luke Glendening,C,TBL,34,81,10,1,11
4,8482133.0,Thomas Bordeleau,C,SJS,21,27,6,5,11
4,8480806.0,Isac Lundestrom,C,ANA,24,46,5,6,11
4,8480025.0,MacKenzie Entwistle,R,CHI,24,67,5,6,11
4,8475750.0,Jon Merrill,D,MIN,31,65,4,7,11
4,8481567.0,Henry Thrun,D,SJS,22,51,3,8,11
4,8477950.0,Tony DeAngelo,D,CAR,28,31,3,8,11
4,8474013.0,Ian Cole,D,VAN,34,78,2,9,11
4,8476891.0,Matt Grzelcyk,D,BOS,29,63,2,9,11
4,8480058.0,Pierre-Olivier Joseph,D,PIT,24,52,2,9,11
4,8480860.0,Kevin Bahl,D,NJD,23,82,1,10,11
4,8479576.0,Vincent Desharnais,D,EDM,27,78,1,10,11
4,8470610.0,Zach Parise,L,COL,39,30,5,5,10
4,8476858.0,Phillip Di Giuseppe,L,VAN,30,51,5,5,10
4,8474040.0,Sam Gagner,C,EDM,34,28,5,5,10
4,8480355.0,Mark Kastelic,C,OTT,24,63,5,5,10
4,8482142.0,Jamie Drysdale,D,PHI,21,34,3,7,10
4,8480849.0,Barrett Hayton,C,ARI,23,33,3,7,10
4,8475177.0,Calvin de Haan,D,TBL,32,59,3,7,10
4,8482964.0,Arber Xhekaj,D,MTL,22,44,3,7,10
4,8477384.0,Josh Brown,D,ARI,29,51,3,7,10
4,8480184.0,Gustav Lindström,D,ANA,25,46,3,7,10
4,8480762.0,Eric Robinson,L,BUF,28,47,3,7,10
4,8477018.0,Ben Hutton,D,VGK,30,41,2,8,10
4,8481093.0,Rafael Harvey-Pinard,L,MTL,24,45,2,8,10
4,8480880.0,Jakub Lauko,C,BOS,23,60,2,8,10
4,8480871.0,Adam Boqvist,D,CBJ,23,35,1,9,10
4,8479369.0,Andrew Peeke,D,CBJ,25,38,1,9,10
4,8479982.0,Conor Timmins,D,TOR,25,25,1,9,10
4,8483460.0,David Jiricek,D,CBJ,20,43,1,9,10
4,8477971.0,Andreas Englund,D,LAK,27,82,1,9,10
4,8471274.0,Alex Goligoski,D,MIN,38,36,0,10,10
4,8479439.0,Jacob MacDonald,D,SJS,30,34,7,2,9
4,8479339.0,Patrik Laine,L,CBJ,25,18,6,3,9
4,8477353.0,Tyler Motte,C,TBL,28,69,6,3,9
4,8482077.0,Dylan Holloway,L,EDM,22,38,6,3,9
4,8479718.0,Alex Barré-Boulet,C,TBL,26,36,6,3,9
4,8477989.0,Christian Dvorak,C,MTL,27,30,5,4,9
4,8479328.0,Julien Gauthier,R,NYI,26,27,5,4,9
4,8479968.0,Vinni Lettieri,C,MIN,28,46,5,4,9
4,8476525.0,Colin Miller,D,NJD,31,46,4,5,9
4,8470966.0,Mark Giordano,D,TOR,40,46,3,6,9
4,8482679.0,Matt Coronato,R,CGY,21,34,3,6,9
4,8480008.0,Adam Ruzicka,C,ARI,24,42,3,6,9
4,8481641.0,Joel Kiviranta,L,COL,27,56,3,6,9
4,8478028.0,Fredrik Olofsson,L,COL,27,57,3,6,9
4,8480222.0,Sebastian Aho,D,NYI,27,58,2,7,9
4,8481708.0,Zac Jones,D,NYR,23,31,2,7,9
4,8476960.0,Andreas Athanasiou,C,CHI,29,28,2,7,9
4,8480848.0,Ty Dellandrea,C,DAL,23,42,2,7,9
4,8478099.0,Kevin Labanc,R,SJS,28,46,2,7,9
4,8478399.0,Jonas Siegenthaler,D,NJD,26,57,1,8,9
4,8481527.0,Kaedan Korczak,D,VGK,22,26,1,8,9
4,8481537.0,Nikita Okhotiuk,D,SJS,23,52,1,8,9
4,8475797.0,Jarred Tinordi,D,CHI,31,52,0,9,9
4,8479372.0,Josh Mahura,D,FLA,25,30,0,9,9
4,8477478.0,William Carrier,L,VGK,29,39,6,2,8
4,8480252.0,Cole Guttman,C,CHI,24,27,4,4,8
4,8481058.0,Jesse Ylönen,R,MTL,24,59,4,4,8
4,8474709.0,Matt Martin,L,NYI,34,57,4,4,8
4,8477541.0,Dakota Mermis,D,MIN,29,47,3,5,8
4,8478211.0,Dryden Hunt,L,CGY,28,28,3,5,8
4,8476473.0,Connor Murphy,D,CHI,30,46,2,6,8
4,8477335.0,Kyle Burroughs,D,SJS,28,73,2,6,8
4,8474618.0,Marco Scandella,D,STL,33,65,2,6,8
4,8476329.0,Travis Boyd,C,ARI,30,16,2,6,8
4,8480196.0,Jacob Bryson,D,BUF,26,36,1,7,8
4,8478450.0,Parker Wotherspoon,D,BOS,26,41,0,8,8
4,8480950.0,Ilya Lyubushkin,D,ANA,29,74,0,8,8
4,8479066.0,Ryan Lomberg,L,FLA,29,75,5,2,7
4,8478569.0,Noel Acciari,C,PIT,32,55,4,3,7
4,8477930.0,Pierre-Edouard Bellemare,L,SEA,38,40,4,3,7
4,8482241.0,Radim Zohorna,L,PIT,27,33,4,3,7
4,8482624.0,Daniil Miromanov,D,VGK,26,24,3,4,7
4,8479346.0,Dillon Dube,C,CGY,25,43,3,4,7
4,8482496.0,Nils Aman,C,VAN,23,43,3,4,7
4,8481019.0,David Gustafsson,C,WPG,23,39,3,4,7
4,8478408.0,Travis Dermott,D,ARI,27,50,2,5,7
4,8479458.0,Nikita Zaitsev,D,CHI,32,38,2,5,7
4,8481167.0,Brayden Pachal,D,CGY,24,50,2,5,7
4,8480084.0,Nick DeSimone,D,NJD,29,34,2,5,7
4,8482652.0,Walker Duehr,R,CGY,26,40,2,5,7
4,8480807.0,Mattias Samuelsson,D,BUF,23,41,1,6,7
4,8479442.0,Troy Stecher,D,ARI,29,54,1,6,7
4,8482516.0,Matthew Kessel,D,STL,23,39,1,6,7
4,8474568.0,Luke Schenn,D,NSH,34,63,1,6,7
4,8478454.0,Noah Juulsen,D,VAN,26,54,1,6,7
4,8478502.0,Dennis Gilbert,D,CGY,27,34,1,6,7
4,8478104.0,Sammy Blais,L,STL,27,53,1,6,7
4,8482176.0,Wyatt Kaiser,D,CHI,21,32,0,7,7
4,8473446.0,Erik Johnson,D,BUF,35,67,5,1,6
4,8471817.0,Ryan Reaves,R,TOR,36,49,4,2,6
4,8479370.0,Tyson Jost,C,BUF,25,43,3,3,6
4,8477369.0,Carson Soucy,D,VAN,29,40,2,4,6
4,8474612.0,Travis Hamonic,D,OTT,33,48,2,4,6
4,8482730.0,Brandt Clarke,D,LAK,20,16,2,4,6
4,8477944.0,Jakub Vrana,L,STL,27,21,2,4,6
4,8477931.0,Tomas Nosek,L,NJD,31,36,2,4,6
4,8480789.0,Oliver Wahlstrom,R,NYI,23,32,2,4,6
4,8481013.0,Jonatan Berggren,R,DET,23,12,2,4,6
4,8476441.0,Joel Edmundson,D,WSH,30,53,1,5,6
4,8482192.0,Isaak Phillips,D,CHI,22,33,0,6,6
4,8480078.0,Filip Chytil,C,NYR,24,10,0,6,6
4,8483524.0,Shane Wright,C,SEA,19,8,4,1,5
4,8477962.0,Brendan Lemieux,L,CAR,27,32,3,2,5
4,8481541.0,Samuel Bolduc,D,NYI,23,34,2,3,5
4,8481147.0,Reese Johnson,C,CHI,25,42,2,3,5
4,8481422.0,Jacob Lucchini,C,MIN,28,40,2,3,5
4,8479536.0,Axel Jonsson-Fjallby,L,WPG,25,26,2,3,5
4,8481122.0,Simon Benoit,D,TOR,25,64,1,4,5
4,8477938.0,Haydn Fleury,D,TBL,27,24,1,4,5
4,8477810.0,Joel Hanley,D,DAL,32,42,1,4,5
4,8471686.0,Marc Staal,D,PHI,36,35,1,4,5
4,8474009.0,Nick Bonino,C,NYR,35,45,1,4,5
4,8476952.0,Dominic Toninato,C,WPG,29,15,1,4,5
4,8479547.0,Matthew Phillips,R,PIT,25,31,1,4,5
4,8480245.0,Olle Lycksell,R,PHI,24,18,1,4,5
4,8474716.0,Jared Spurgeon,D,MIN,34,16,0,5,5
4,8475906.0,John Klingberg,D,TOR,31,14,0,5,5
4,8476429.0,Scott Mayfield,D,NYI,31,41,0,5,5
4,8475718.0,Justin Holl,D,DET,31,38,0,5,5
4,8478452.0,Caleb Jones,D,COL,26,25,0,5,5
4,8479291.0,Kevin Rooney,C,CGY,30,33,3,1,4
4,8479344.0,Jesse Puljujarvi,R,PIT,25,22,3,1,4
4,8478051.0,Max Willman,C,NJD,28,18,3,1,4
4,8475791.0,Taylor Hall,L,CHI,32,10,2,2,4
4,8481056.0,Spencer Stastney,D,NSH,23,20,2,2,4
4,8476867.0,Brendan Gaunce,C,CBJ,29,24,2,2,4
4,8479981.0,Jonah Gadjovich,L,FLA,25,39,2,2,4
4,8475766.0,Austin Watson,L,TBL,31,33,2,2,4
4,8477499.0,Rasmus Ristolainen,D,PHI,29,31,1,3,4
4,8478451.0,Ethan Bear,D,WSH,26,24,1,3,4
4,8481609.0,Vladislav Kolyachonok,D,ARI,22,5,1,3,4
4,8477244.0,Chad Ruhwedel,D,PIT,33,52,1,3,4
4,8476442.0,Matt Nieto,L,PIT,31,22,1,3,4
4,8479994.0,Jaret Anderson-Dolan,C,LAK,24,31,1,3,4
4,8475752.0,Tyler Pitlick,C,NYR,32,34,1,3,4
4,8481532.0,Alex Turcotte,C,LAK,22,20,1,3,4
4,8477527.0,Ross Johnston,L,ANA,29,68,1,3,4
4,8475235.0,Nicolas Deslauriers,L,PHI,32,60,1,3,4
4,8476913.0,Devin Shore,C,SEA,29,21,1,3,4
4,8479379.0,Givani Smith,R,SJS,25,36,1,3,4
4,8475762.0,Derek Forbort,D,BOS,31,35,0,4,4
4,8478424.0,Jansen Harkins,C,PIT,26,45,0,4,4
4,8480441.0,Trey Fix-Wolansky,R,CBJ,24,11,2,1,3
4,8478078.0,Rourke Chartier,C,OTT,27,37,2,1,3
4,8480776.0,Sheldon Rempal,R,VGK,28,9,2,1,3
4,8480468.0,James Hamblin,L,EDM,24,31,2,1,3
4,8479772.0,Zack MacEwen,R,OTT,27,30,2,1,3
4,8477073.0,Kurtis MacDermid,D,COL,29,45,2,1,3
4,8480823.0,Alexander Alexeyev,D,WSH,24,39,1,2,3
4,8480007.0,Jonas Rondbjerg,R,VGK,24,20,1,2,3
4,8476934.0,Brock McGinn,L,ANA,29,24,1,2,3
4,8478409.0,Anthony Richard,C,BOS,27,9,1,2,3
4,8483570.0,Ben Meyers,C,COL,25,23,1,2,3
4,8476994.0,Vinnie Hinostroza,C,PIT,29,14,1,2,3
4,8481592.0,Jakob Pelletier,L,CGY,22,13,1,2,3
4,8478904.0,Steven Lorentz,C,FLA,27,38,1,2,3
4,8479972.0,Mason Shaw,C,MIN,25,20,1,2,3
4,8480853.0,Liam Foudy,C,NSH,23,13,0,3,3
4,8482762.0,Simon Edvinsson,D,DET,20,16,1,1,2
4,8482101.0,Danil Gushchin,L,SJS,21,4,1,1,2
4,8479378.0,Logan Stanley,D,WPG,25,25,1,1,2
4,8481006.0,Tyler Tucker,D,STL,23,26,1,1,2
4,8478495.0,Denis Gurianov,R,NSH,26,18,1,1,2
4,8479362.0,Riley Tufte,L,COL,25,5,1,1,2
4,8480292.0,Carson Meyer,R,CBJ,26,14,1,1,2
4,8477454.0,Adam Erne,L,EDM,28,24,1,1,2
4,8475780.0,Chris Wagner,R,BOS,32,13,1,1,2
4,8476988.0,Matt Benning,D,SJS,29,14,0,2,2
4,8477034.0,Jaycob Megna,D,CHI,31,44,0,2,2
4,8481521.0,Ronnie Attard,D,PHI,24,12,0,2,2
4,8480070.0,Ian Mitchell,D,BOS,24,13,0,2,2
4,8477851.0,Jordan Oesterle,D,CGY,31,22,0,2,2
4,8481161.0,Jake Christiansen,D,CBJ,24,12,0,2,2
4,8482451.0,Mikael Pyyhtia,L,CBJ,22,17,0,2,2
4,8473473.0,Milan Lucic,L,BOS,35,4,0,2,2
4,8480870.0,Bo Groulx,C,ANA,23,45,0,2,2
4,8481598.0,Philip Broberg,D,EDM,22,12,0,2,2
4,8477464.0,Nic Petan,C,MIN,28,6,0,2,2
4,8481617.0,Vasily Podkolzin,R,VAN,22,19,0,2,2
4,8481751.0,Lukas Rousek,R,BUF,24,15,0,2,2
4,8481550.0,Adam Beckman,L,MIN,22,11,0,2,2
4,8481523.0,Kirby Dach,C,MTL,22,2,0,2,2
4,8481543.0,Nikita Alexandrov,C,STL,23,23,0,2,2
4,8478146.0,Matthew Highmore,C,OTT,27,7,0,2,2
4,8481043.0,Cole Koepke,L,TBL,25,9,0,2,2
4,8483565.0,Nick Blankenburg,D,CBJ,25,12,1,0,1
4,8483397.0,Marc McLaughlin,C,BOS,24,1,1,0,1
4,8480874.0,Adam Ginning,D,PHI,23,9,1,0,1
4,8481754.0,Nikita Nesterenko,C,ANA,22,3,1,0,1
4,8480021.0,Jack Studnicka,C,SJS,24,22,1,0,1
4,8481518.0,Nolan Foote,L,NJD,23,4,1,0,1
4,8479421.0,Jacob Moverare,D,LAK,25,24,1,0,1
4,8481239.0,Samuel Fagemo,L,LAK,23,8,1,0,1
4,8479546.0,Oskar Steen,C,BOS,25,34,1,0,1
4,8480836.0,Jonathan Gruden,C,PIT,23,13,1,0,1
4,8481077.0,John Leonard,L,NSH,25,6,1,0,1
4,8482147.0,Jean-Luc Foudy,C,COL,21,4,1,0,1
4,8474053.0,Logan Couture,C,SJS,34,6,0,1,1
4,8481812.0,Nikolai Knyzhov,D,SJS,26,10,0,1,1
4,8479984.0,Cal Foote,D,NJD,25,4,0,1,1
4,8479321.0,Lucas Johansen,D,WSH,26,6,0,1,1
4,8473563.0,Nicklas Backstrom,C,WSH,36,8,0,1,1
4,8479320.0,Max Lajoie,D,TOR,26,7,0,1,1
4,8482095.0,Tyler Kleven,D,OTT,21,9,0,1,1
4,8480157.0,Calle Rosen,D,STL,29,6,0,1,1
4,8480031.0,Max Comtois,L,ANA,24,1,0,1,1
4,8478017.0,Mark Friedman,D,VAN,28,23,0,1,1
4,8479348.0,Kale Clague,D,BUF,25,3,0,1,1
4,8475278.0,Byron Froese,C,VGK,32,16,0,1,1
4,8475795.0,Dylan McIlrath,D,WSH,31,3,0,1,1
4,8480845.0,Rasmus Kupari,C,WPG,23,28,0,1,1
4,8480890.0,Jan Jenik,R,ARI,23,5,0,1,1
4,8477887.0,Patrick Brown,C,BOS,31,11,0,1,1
4,8478512.0,Austin Czarnik,C,DET,31,34,0,1,1
4,8479367.0,William Lockwood,R,FLA,25,26,0,1,1
4,8483597.0,Milos Kelemen,L,ARI,24,10,0,1,1
4,8477126.0,Jayson Megna,C,ANA,33,1,0,0,0
4,8479639.0,Dylan Coghlan,D,CAR,25,1,0,0,0
4,8482067.0,Connor Mackey,D,NYR,27,1,0,0,0
4,8476856.0,Matt Dumba,D,ARI,29,0,0,0,0
4,8478483.0,Mitchell Marner,R,TOR,26,0,0,0,0
4,8471873.0,Anton Stralman,D,BOS,37,0,0,0,0
4,8474162.0,Jake Muzzin,D,TOR,34,0,0,0,0
4,8470638.0,Patrice Bergeron,C,BOS,38,0,0,0,0
4,8473604.0,Jonathan Toews,C,CHI,35,0,0,0,0
4,8471276.0,David Krejci,C,BOS,37,0,0,0,0
4,8474207.0,Nick Holden,D,OTT,36,0,0,0,0
4,8475747.0,Patrik Nemeth,D,ARI,31,0,0,0,0
4,8477467.0,Gustav Olofsson,D,SEA,29,1,0,0,0
4,8479514.0,Rem Pitlick,C,CHI,26,9,0,0,0
4,8474027.0,Justin Braun,D,PHI,36,0,0,0,0
4,8481599.0,Victor Soderstrom,D,ARI,22,3,0,0,0
4,8474161.0,Jakub Voracek,R,CBJ,34,0,0,0,0
4,8479985.0,Cale Fleury,D,SEA,25,1,0,0,0
4,8471303.0,Alexander Edler,D,LAK,37,0,0,0,0
4,8474573.0,Josh Bailey,R,NYI,34,0,0,0,0
4,8483619.0,Filip Roos,D,CHI,24,4,0,0,0
4,8474818.0,Jordie Benn,D,TOR,36,0,0,0,0
4,8476449.0,Scott Harrington,D,ANA,30,0,0,0,0
4,8483620.0,Marcus Bjork,D,CBJ,26,0,0,0,0
4,8470595.0,Eric Staal,C,FLA,39,0,0,0,0
4,8481585.0,Egor Afanasyev,L,NSH,22,2,0,0,0
4,8482712.0,Oskar Olausson,R,COL,21,1,0,0,0
4,8481072.0,Tim Berni,D,CBJ,23,0,0,0,0
4,8479945.0,Gavin Bayreuther,D,CBJ,29,0,0,0,0
4,8481600.0,Tobias Bjornfot,D,VGK,22,4,0,0,0
4,8481679.0,Maxence Guenette,D,OTT,22,7,0,0,0
4,8474683.0,Derek Grant,C,ANA,33,0,0,0,0
4,8476470.0,Nathan Beaulieu,D,ANA,31,0,0,0,0
4,8474145.0,Robert Bortuzzo,D,NYI,34,27,0,0,0
4,8480216.0,Jacob Peterson,C,SJS,24,6,0,0,0
4,8473548.0,Phil Kessel,R,VGK,36,0,0,0,0
4,8480160.0,Radim Simek,D,SJS,31,0,0,0,0
4,8480883.0,Ty Smith,D,PIT,23,0,0,0,0
4,8471669.0,Paul Stastny,C,CAR,38,0,0,0,0
4,8475227.0,Chris Wideman,D,MTL,33,0,0,0,0
4,8480913.0,Jordan Gross,D,NSH,28,0,0,0,0
4,8475625.0,Matt Irwin,D,WSH,36,0,0,0,0
4,8479388.0,Riley Stillman,D,BUF,25,0,0,0,0
4,8474628.0,Michael Stone,D,CGY,33,0,0,0,0
4,8484254.0,Akito Hirose,D,VAN,24,3,0,0,0
4,8477941.0,Nick Ritchie,L,CGY,28,0,0,0,0
4,8477462.0,Robert Hagg,D,ANA,28,5,0,0,0
4,8478062.0,Dysin Mayo,D,ARI,27,0,0,0,0
4,8482634.0,Alex Steeves,C,TOR,24,1,0,0,0
4,8477433.0,Ben Harpur,D,NYR,28,0,0,0,0
4,8478841.0,Colton White,D,ANA,26,0,0,0,0
4,8473544.0,Derick Brassard,C,OTT,36,0,0,0,0
4,8476884.0,Derrick Pouliot,D,SJS,29,5,0,0,0
4,8479376.0,Victor Mete,D,PHI,25,1,0,0,0
4,8483630.0,Pavol Regenda,L,ANA,24,5,0,0,0
4,8479026.0,Philippe Myers,D,TBL,26,5,0,0,0
4,8477482.0,Zach Sanford,L,CHI,29,0,0,0,0
4,8477359.0,Tucker Poolman,D,VAN,30,0,0,0,0
4,8475857.0,Kevin Gravel,D,NSH,31,0,0,0,0
4,8476779.0,Brad Hunt,D,COL,35,0,0,0,0
4,8476850.0,Ryan Murray,D,EDM,30,0,0,0,0
4,8477341.0,Andreas Johnsson,L,SJS,29,0,0,0,0
4,8474218.0,Jason Demers,D,EDM,35,0,0,0,0
4,8480844.0,Grigori Denisenko,L,VGK,23,6,0,0,0
4,8484287.0,Cole McWard,D,VAN,22,1,0,0,0
4,8479322.0,Wade Allison,R,PHI,26,0,0,0,0
4,8478846.0,Christian Wolanin,D,VAN,28,0,0,0,0
4,8471887.0,Patric Hornqvist,R,FLA,36,0,0,0,0
4,8475163.0,Alex Chiasson,R,DET,33,0,0,0,0
4,8478881.0,Brett Seney,L,CHI,27,4,0,0,0
4,8474697.0,Mark Borowiecki,D,NSH,34,0,0,0,0
4,8476410.0,Josh Leivo,L,STL,30,0,0,0,0
4,8475968.0,Alex Belzile,R,MTL,32,0,0,0,0
4,8479580.0,Dylan Gambrell,C,OTT,27,0,0,0,0
4,8480901.0,Karson Kuhlman,C,WPG,28,0,0,0,0
4,8480326.0,Sheldon Dries,C,VAN,29,0,0,0,0
4,8478465.0,Guillaume Brisebois,D,VAN,26,0,0,0,0
4,8482861.0,Vincent Iorio,D,WSH,21,6,0,0,0
4,8471794.0,Darren Helm,C,COL,36,0,0,0,0
4,8479335.0,Rasmus Asplund,C,NSH,26,0,0,0,0
4,8478415.0,Jakub Zboril,D,BOS,26,0,0,0,0
4,8476310.0,Lukas Sedlak,C,PHI,30,0,0,0,0
4,8478075.0,Anders Bjork,L,CHI,27,0,0,0,0
4,8480267.0,Sammy Walker,C,MIN,24,4,0,0,0
4,8479578.0,Casey Fitzgerald,D,FLA,26,0,0,0,0
4,8480032.0,Shane Bowers,C,NJD,24,8,0,0,0
4,8478400.0,Colin White,C,PIT,26,28,0,0,0
4,8478431.0,Evgeny Svechnikov,L,SJS,27,0,0,0,0
4,8475772.0,Riley Sheahan,C,BUF,32,0,0,0,0
4,8481690.0,Tyler Angle,C,CBJ,23,2,0,0,0
4,8476326.0,Josh Archibald,R,PIT,31,0,0,0,0
4,8478843.0,Denis Malgin,C,COL,26,0,0,0,0
4,8478446.0,Glenn Gawdin,C,ANA,26,1,0,0,0
4,8477357.0,Saku Maenalanen,R,WPG,29,0,0,0,0
4,8478870.0,Rudolfs Balcers,L,TBL,26,0,0,0,0
4,8478476.0,Kyle Capobianco,D,WPG,26,0,0,0,0
4,8476439.0,Brett Ritchie,R,ARI,30,0,0,0,0
4,8474613.0,Derek Stepan,C,CAR,33,0,0,0,0
4,8475178.0,Zack Kassian,R,ARI,32,0,0,0,0
4,8480226.0,Marián Studenic,R,SEA,25,2,0,0,0
4,8481070.0,Hugh McGing,L,STL,25,5,0,0,0
4,8482250.0,Callahan Burke,C,CAR,26,1,0,0,0
4,8481591.0,Sam Poulin,R,PIT,22,3,0,0,0
4,8481441.0,Joe Snively,C,WSH,27,3,0,0,0
4,8478967.0,Lane Pederson,C,CBJ,26,0,0,0,0
4,8479333.0,Libor Hajek,D,NYR,25,0,0,0,0
4,8480833.0,Vitali Kravtsov,R,VAN,24,0,0,0,0
4,8477460.0,Laurent Dauphin,C,ARI,28,0,0,0,0
4,8481461.0,Corey Schueneman,D,MTL,28,0,0,0,0
4,8474190.0,Wayne Simmonds,R,TOR,35,0,0,0,0
4,8483549.0,Lucas Condotta,L,MTL,26,3,0,0,0
4,8477993.0,Justin Kirkland,C,ARI,27,2,0,0,0
4,8480935.0,Lawrence Pilut,D,BUF,28,0,0,0,0
4,8477210.0,Buddy Robinson,R,CHI,32,0,0,0,0
4,8476851.0,Alex Galchenyuk,C,COL,29,0,0,0,0
4,8482197.0,Adam Raska,R,MIN,22,5,0,0,0
4,8479366.0,Logan Brown,C,STL,25,0,0,0,0
4,8479356.0,Kieffer Bellows,L,PHI,25,0,0,0,0
4,8479533.0,Joona Koppanen,L,PIT,25,4,0,0,0
4,8477401.0,John Hayden,C,SEA,28,2,0,0,0
4,8480822.0,Martin Kaut,R,SJS,24,0,0,0,0
4,8474610.0,Zac Dalpe,C,FLA,34,0,0,0,0
4,8482399.0,Billy Sweezey,D,CBJ,27,0,0,0,0
4,8479991.0,Jake Leschyshyn,C,NYR,24,1,0,0,0
4,8479550.0,Tanner Laczynski,C,PHI,26,0,0,0,0
4,8476166.0,Taylor Fedun,D,PIT,35,0,0,0,0
4,8479338.0,Markus Niemelainen,D,EDM,25,0,0,0,0
4,8477320.0,Anton Blidh,L,NYR,28,1,0,0,0
4,8478147.0,Bokondji Imama,L,ARI,27,6,0,0,0
4,8478067.0,Oskar Lindblom,L,SJS,27,1,0,0,0
4,8478506.0,Gabriel Carlsson,D,WSH,26,0,0,0,0
4,8478131.0,Ondrej Kase,R,CAR,28,0,0,0,0
4,8479644.0,Matt Luff,R,DET,26,0,0,0,0
4,8482824.0,Nick Cicek,D,SJS,23,0,0,0,0
4,8482834.0,Jesper Froden,R,SEA,29,0,0,0,0
4,8478491.0,Jacob Larsson,D,OTT,26,0,0,0,0
4,8474089.0,Brad Malone,C,EDM,34,0,0,0,0
4,8482641.0,Matt Kiersted,D,FLA,25,0,0,0,0
4,8480071.0,Robin Salo,D,NYI,25,0,0,0,0
4,8475461.0,Andrew Agozzino,L,SJS,32,0,0,0,0
4,8475160.0,Kyle Clifford,L,TOR,32,0,0,0,0
4,8480056.0,Jack Rathbone,D,VAN,24,0,0,0,0
4,8481725.0,Elmer Soderblom,L,DET,22,0,0,0,0
4,8479465.0,Drake Caggiula,L,PIT,29,0,0,0,0
4,8476948.0,Charles Hudon,L,COL,29,0,0,0,0
4,8479523.0,Lucas Carlsson,D,FLA,26,0,0,0,0
4,8478455.0,Austin Wagner,L,CHI,26,0,0,0,0
4,8481572.0,Ville Heinola,D,WPG,22,0,0,0,0
4,8479404.0,Henrik Borgstrom,C,WSH,26,0,0,0,0
4,8479944.0,Zach Aston-Reese,C,DET,29,3,0,0,0
4,8482635.0,Mike Hardman,L,CHI,24,0,0,0,0
4,8479705.0,Jeffrey Viel,L,SJS,26,0,0,0,0
4,8480467.0,Austin Strand,D,ANA,26,0,0,0,0
4,8480037.0,Aleksi Heponiemi,C,FLA,24,0,0,0,0
4,8479573.0,Mikhail Maltsev,L,COL,25,0,0,0,0
4,8476404.0,Andy Andreoff,C,NYI,32,0,0,0,0
4,8484125.0,Hunter McKown,C,CBJ,21,0,0,0,0
4,8481649.0,Joona Luoto,L,CBJ,26,0,0,0,0
4,8477981.0,Roland McKeown,D,NSH,27,0,0,0,0
4,8480831.0,Alec Regula,D,CHI,23,0,0,0,0
4,8482691.0,Aatu Raty,C,VAN,21,0,0,0,0
4,8482623.0,Josh Dunne,C,CBJ,25,0,0,0,0
4,8481433.0,Taro Hirose,L,DET,27,0,0,0,0
4,8480328.0,David Gust,R,CHI,29,0,0,0,0
4,8479526.0,Otto Koivula,L,NYI,25,0,0,0,0
4,8476390.0,Joseph Cramarossa,C,MIN,31,0,0,0,0
4,8482654.0,Jackson Cates,C,PHI,26,0,0,0,0
4,8480439.0,Mac Hollowell,D,TOR,25,0,0,0,0
4,8480072.0,Lias Andersson,C,LAK,25,0,0,0,0
4,8479395.0,Dennis Cholowski,D,NYI,25,0,0,0,0
4,8477463.0,Steven Santini,D,STL,28,0,0,0,0
4,8479347.0,Tyler Benson,L,EDM,25,0,0,0,0
4,8477471.0,Dillon Heatherington,D,OTT,28,0,0,0,0
4,8477520.0,Jean-Sebastien Dea,C,ARI,29,0,0,0,0
4,8480846.0,Sampo Ranta,L,COL,23,0,0,0,0
4,8480979.0,Nathan Smith,C,ARI,25,0,0,0,0
4,8484256.0,Jake Livingstone,D,NSH,24,0,0,0,0
4,8476396.0,Steven Fogarty,C,MIN,30,0,0,0,0
4,8479252.0,Dan Renouf,D,BOS,29,0,0,0,0
4,8479518.0,Fredrik Karlström,C,DAL,25,0,0,0,0
4,8481683.0,Aidan McDonough,L,VAN,24,0,0,0,0
4,8478373.0,Nikita Soshnikov,R,NYI,30,0,0,0,0
4,8482081.0,Sean Farrell,C,MTL,22,0,0,0,0
4,8481575.0,Lassi Thomson,D,OTT,23,0,0,0,0
4,8481102.0,Egor Sokolov,L,OTT,23,0,0,0,0
4,8481712.0,Matej Blumel,R,DAL,23,0,0,0,0
4,8479602.0,Jeremy Davies,D,BUF,27,0,0,0,0
4,8480443.0,Kristian Reichel,C,WPG,25,0,0,0,0
4,8479304.0,Kyle Criscuolo,C,SJS,31,0,0,0,0
4,8478224.0,Luke Philp,C,CHI,28,0,0,0,0
4,8480242.0,Arnaud Durandeau,L,NYI,24,0,0,0,0
4,8479329.0,Frederic Allard,D,MTL,26,0,0,0,0
4,8476941.0,Connor Carrick,D,BOS,29,0,0,0,0
4,8479375.0,William Bitten,C,STL,25,0,0,0,0
4,8481720.0,Nick Abruzzese,C,TOR,24,0,0,0,0
4,8482452.0,Elliot Desnoyers,L,PHI,21,0,0,0,0
4,8476915.0,Jujhar Khaira,L,MIN,29,1,0,0,0
4,8483641.0,Anton Levtchi,L,FLA,28,0,0,0,0
4,8481740.0,Tyce Thompson,R,NJD,24,0,0,0,0
4,8478173.0,Hayden Hodgson,R,PHI,27,0,0,0,0
4,8482181.0,Tristen Robins,C,SJS,22,0,0,0,0
4,8481563.0,Drew Helleson,D,ANA,22,0,0,0,0
4,8480863.0,Gabriel Fortier,L,TBL,23,0,0,0,0
4,8478058.0,CJ Suess,L,SJS,29,0,0,0,0
4,8480041.0,Dmitri Samorukov,D,STL,24,0,0,0,0
4,8482179.0,Justin Richards,C,CBJ,25,0,0,0,0
4,8480034.0,Joel Teasdale,L,MTL,24,0,0,0,0
4,8480820.0,Filip Kral,D,TOR,24,0,0,0,0
4,8480842.0,Filip Hallander,C,PIT,23,0,0,0,0
4,8478367.0,Cole Bardreau,C,NYI,30,0,0,0,0
4,8482448.0,Samuel Knazko,D,CBJ,21,0,0,0,0
4,8482711.0,Stanislav Svozil,D,CBJ,20,0,0,0,0
4,8480275.0,Nick Swaney,R,MIN,26,0,0,0,0
4,8480994.0,Damien Giroux,C,MIN,23,0,0,0,0
4,8480977.0,Semyon Der-Arguchintsev,C,TOR,23,0,0,0,0
4,8482207.0,William Dufour,R,NYI,21,0,0,0,0
4,8483464.0,Marco Kasper,C,DET,19,0,0,0,0
4,8483424.0,Owen Beck,C,MTL,19,0,0,0,0
5,8476453.0,Nikita Kucherov,R,TBL,30,81,44,100,144
5,8477492.0,Nathan MacKinnon,C,COL,28,82,51,89,140
5,8478402.0,Connor McDavid,C,EDM,26,76,32,100,132
5,8478550.0,Artemi Panarin,L,NYR,32,82,49,71,120
5,8477956.0,David Pastrnak,R,BOS,27,82,47,63,110
5,8479318.0,Auston Matthews,C,TOR,26,81,69,38,107
5,8477934.0,Leon Draisaitl,C,EDM,28,81,41,65,106
5,8478420.0,Mikko Rantanen,R,COL,27,80,42,62,104
5,8476468.0,J.T. Miller,C,VAN,30,81,37,66,103
5,8477939.0,William Nylander,R,TOR,27,82,40,58,98
5,8478864.0,Kirill Kaprizov,L,MIN,26,75,46,50,96
5,8477933.0,Sam Reinhart,C,FLA,28,82,57,37,94
5,8476887.0,Filip Forsberg,L,NSH,29,82,48,46,94
5,8471675.0,Sidney Crosby,C,PIT,36,82,42,52,94
5,8480800.0,Quinn Hughes,D,VAN,24,82,17,75,92
5,8478010.0,Brayden Point,C,TBL,27,81,46,44,90
5,8480069.0,Cale Makar,D,COL,25,77,21,69,90
5,8478427.0,Sebastian Aho,C,CAR,26,78,36,53,89
5,8480012.0,Elias Pettersson,C,VAN,25,82,34,55,89
5,8479314.0,Matthew Tkachuk,L,FLA,26,80,26,62,88
5,8480023.0,Robert Thomas,C,STL,24,82,26,60,86
5,8474600.0,Roman Josi,D,NSH,33,82,23,62,85
5,8479407.0,Jesper Bratt,L,NJD,25,82,27,56,83
5,8480803.0,Evan Bouchard,D,EDM,24,81,18,64,82
5,8474564.0,Steven Stamkos,C,TBL,33,79,40,41,81
5,8480027.0,Jason Robertson,L,DAL,24,82,29,51,80
5,8478445.0,Mathew Barzal,C,NYI,26,80,23,57,80
5,8477493.0,Aleksander Barkov,C,FLA,28,73,23,57,80
5,8475786.0,Zach Hyman,L,EDM,31,80,54,23,77
5,8480018.0,Nick Suzuki,C,MTL,24,82,33,44,77
5,8477404.0,Jake Guentzel,L,PIT,29,67,30,47,77
5,8476389.0,Vincent Trocheck,C,NYR,30,82,25,52,77
5,8479343.0,Clayton Keller,R,ARI,25,78,33,43,76
5,8475167.0,Victor Hedman,D,TBL,33,78,13,63,76
5,8475184.0,Chris Kreider,L,NYR,32,82,39,36,75
5,8475172.0,Nazem Kadri,C,CGY,33,82,29,46,75
5,8477960.0,Adrian Kempe,R,LAK,27,77,28,47,75
5,8479542.0,Brandon Hagel,L,TBL,25,82,26,49,75
5,8474679.0,Gustav Nyquist,C,NSH,34,81,23,52,75
5,8480801.0,Brady Tkachuk,L,OTT,24,81,37,37,74
5,8481559.0,Jack Hughes,C,NJD,22,62,27,47,74
5,8478444.0,Brock Boeser,R,VAN,26,81,40,33,73
5,8477942.0,Kevin Fiala,L,LAK,27,82,29,44,73
5,8479323.0,Adam Fox,D,NYR,25,72,17,56,73
5,8477409.0,Carter Verhaeghe,C,FLA,28,76,34,38,72
5,8482078.0,Lucas Raymond,L,DET,21,82,31,41,72
5,8476459.0,Mika Zibanejad,C,NYR,30,81,26,46,72
5,8476460.0,Mark Scheifele,C,WPG,30,74,25,47,72
5,8471685.0,Anze Kopitar,C,LAK,36,81,26,44,70
5,8482116.0,Tim Stützle,C,OTT,21,75,18,52,70
5,8480865.0,Noah Dobson,D,NYI,23,79,10,60,70
5,8476539.0,Jonathan Marchessault,R,VGK,33,82,42,27,69
5,8475754.0,Brock Nelson,C,NYI,32,82,34,35,69
5,8477946.0,Dylan Larkin,C,DET,27,68,33,36,69
5,8475158.0,Ryan O'Reilly,C,NSH,32,82,26,43,69
5,8477504.0,Josh Morrissey,D,WPG,28,81,10,59,69
5,8478439.0,Travis Konecny,R,PHI,26,76,33,35,68
5,8477500.0,Bo Horvat,C,NYI,28,81,33,35,68
5,8478403.0,Jack Eichel,C,VGK,27,63,31,37,68
5,8481557.0,Matt Boldy,L,MIN,22,75,29,39,68
5,8482093.0,Seth Jarvis,C,CAR,21,81,33,34,67
5,8479385.0,Jordan Kyrou,C,STL,25,82,31,36,67
5,8473419.0,Brad Marchand,L,BOS,35,82,29,38,67
5,8480002.0,Nico Hischier,C,NJD,24,71,27,40,67
5,8471215.0,Evgeni Malkin,C,PIT,37,82,27,40,67
5,8478440.0,Dylan Strome,C,WSH,26,82,27,40,67
5,8479337.0,Alex DeBrincat,R,DET,26,82,27,40,67
5,8470794.0,Joe Pavelski,C,DAL,39,82,27,40,67
5,8476454.0,Ryan Nugent-Hopkins,C,EDM,30,80,18,49,67
5,8480208.0,Drake Batherson,R,OTT,25,82,28,38,66
5,8482740.0,Wyatt Johnston,C,DAL,20,82,32,33,65
5,8471214.0,Alex Ovechkin,L,WSH,38,79,31,34,65
5,8478449.0,Roope Hintz,C,DAL,27,80,30,35,65
5,8475166.0,John Tavares,C,TOR,33,80,29,36,65
5,8481540.0,Cole Caufield,R,MTL,22,82,28,37,65
5,8475168.0,Matt Duchene,C,DAL,32,80,25,40,65
5,8478493.0,Joel Eriksson Ek,C,MIN,26,77,30,34,64
5,8473512.0,Claude Giroux,R,OTT,35,82,21,43,64
5,8477402.0,Pavel Buchnevich,L,STL,28,80,27,36,63
5,8475692.0,Mats Zuccarello,R,MIN,36,69,12,51,63
5,8477955.0,Jared McCann,L,SEA,27,80,29,33,62
5,8476875.0,Mike Matheson,D,MTL,29,82,11,51,62
5,8478398.0,Kyle Connor,L,WPG,27,65,34,27,61
5,8477940.0,Nikolaj Ehlers,L,WPG,27,82,25,36,61
5,8477951.0,Nick Schmaltz,C,ARI,27,79,22,39,61
5,8478366.0,Frank Vatrano,R,ANA,29,82,37,23,60
5,8476448.0,William Karlsson,C,VGK,30,70,30,30,60
5,8475745.0,Charlie Coyle,C,BOS,31,82,25,35,60
5,8473994.0,Jamie Benn,L,DAL,34,82,21,39,60
5,8475798.0,Mikael Granlund,C,SJS,31,69,12,48,60
5,8476346.0,Johnny Gaudreau,L,CBJ,30,81,12,48,60
5,8481068.0,Yegor Sharangovich,C,CGY,25,82,31,28,59
5,8477497.0,Sean Monahan,C,WPG,29,83,26,33,59
5,8477949.0,Alex Tuch,R,BUF,27,75,22,37,59
5,8478401.0,Pavel Zacha,C,BOS,26,78,21,38,59
5,8480839.0,Rasmus Dahlin,D,BUF,23,81,20,39,59
5,8477416.0,Oliver Bjorkstrand,R,SEA,28,82,20,39,59
5,8476853.0,Morgan Rielly,D,TOR,29,72,7,51,58
5,8479675.0,Trevor Moore,L,LAK,28,82,31,26,57
5,8482109.0,Alexis Lafrenière,L,NYR,22,82,28,29,57
5,8479999.0,Casey Mittelstadt,C,BUF,25,80,18,39,57
5,8481711.0,Matias Maccelli,L,ARI,23,82,17,40,57
5,8478460.0,Zach Werenski,D,CBJ,26,70,11,46,57
5,8479420.0,Tage Thompson,C,BUF,26,71,29,27,56
5,8475810.0,Bryan Rust,R,PIT,31,62,28,28,56
5,8477494.0,Jonathan Drouin,L,COL,28,79,19,37,56
5,8474578.0,Erik Karlsson,D,PIT,33,82,11,45,56
5,8476906.0,Shayne Gostisbehere,D,DET,30,81,10,46,56
5,8475726.0,Tyler Toffoli,R,NJD,31,79,33,22,55
5,8475765.0,Vladimir Tarasenko,R,OTT,32,76,23,32,55
5,8482124.0,Quinton Byfield,R,LAK,21,80,20,35,55
5,8478047.0,Michael Bunting,L,CAR,28,81,19,36,55
5,8475151.0,Kyle Palmieri,C,NYI,32,82,30,24,54
5,8476399.0,Blake Coleman,C,CGY,32,78,30,24,54
5,8478873.0,Troy Terry,R,ANA,26,76,20,34,54
5,8480798.0,Philipp Kurashev,C,CHI,24,75,18,36,54
5,8480036.0,Miro Heiskanen,D,DAL,24,71,9,45,54
5,8477501.0,Valeri Nichushkin,R,COL,28,54,28,25,53
5,8480015.0,Owen Tippett,R,PHI,24,78,28,25,53
5,8476882.0,Teuvo Teravainen,L,CAR,29,76,25,28,53
5,8480039.0,Martin Necas,C,CAR,24,77,24,29,53
5,8478975.0,Mason Marchment,L,DAL,28,81,22,31,53
5,8475913.0,Mark Stone,R,VGK,31,56,16,37,53
5,8478414.0,Timo Meier,R,NJD,27,69,28,24,52
5,8475794.0,Tyler Seguin,C,DAL,31,68,25,27,52
5,8477346.0,MacKenzie Weegar,D,CGY,29,82,20,32,52
5,8480830.0,Andrei Svechnikov,R,CAR,23,59,19,33,52
5,8476456.0,Jonathan Huberdeau,C,CGY,30,81,12,40,52
5,8474590.0,John Carlson,D,WSH,33,82,10,42,52
5,8474641.0,Adam Henrique,C,ANA,33,82,24,27,51
5,8476905.0,Chandler Stephenson,C,VGK,29,75,16,35,51
5,8471724.0,Kris Letang,D,PIT,36,82,10,41,51
5,8482175.0,JJ Peterka,R,BUF,21,82,28,22,50
5,8480797.0,Joel Farabee,L,PHI,23,82,22,28,50
5,8483515.0,Juraj Slafkovsky,L,MTL,19,82,20,30,50
5,8474563.0,Drew Doughty,D,LAK,34,82,15,35,50
5,8478038.0,Devon Toews,D,COL,29,82,12,38,50
5,8477456.0,J.T. Compher,L,DET,28,77,19,29,48
5,8479425.0,Filip Hronek,D,VAN,26,81,5,43,48
5,8474141.0,Patrick Kane,R,DET,35,50,20,27,47
5,8478856.0,Conor Garland,R,VAN,27,82,20,27,47
5,8481528.0,Dylan Cozens,C,BUF,22,79,18,29,47
5,8476479.0,Phillip Danault,C,LAK,30,78,17,30,47
5,8474102.0,David Perron,L,DET,35,76,17,30,47
5,8481581.0,Thomas Harley,D,DAL,22,79,15,32,47
5,8478396.0,Noah Hanifin,D,CGY,26,80,13,34,47
5,8476869.0,Brady Skjei,D,CAR,29,80,13,34,47
5,8479325.0,Charlie McAvoy,D,BOS,26,74,12,35,47
5,8482684.0,Luke Hughes,D,NJD,20,82,9,38,47
5,8477503.0,Max Domi,C,TOR,28,80,9,38,47
5,8482122.0,Brock Faber,D,MIN,21,82,8,39,47
5,8477426.0,Nicholas Paul,L,TBL,28,82,24,22,46
5,8475784.0,Jeff Skinner,L,BUF,31,74,24,22,46
5,8483808.0,Andrei Kuzmenko,L,CGY,27,72,22,24,46
5,8475170.0,Brayden Schenn,C,STL,32,82,20,26,46
5,8478407.0,Vince Dunn,D,SEA,27,59,11,35,46
5,8475760.0,Nick Bjugstad,C,ARI,31,76,22,23,45
5,8477451.0,Ryan Hartman,R,MIN,29,74,21,24,45
5,8478519.0,Anthony Cirelli,C,TBL,26,79,20,25,45
5,8477964.0,Ivan Barbashev,C,VGK,28,82,19,26,45
5,8478438.0,Tommy Novak,C,NSH,26,71,18,27,45
5,8482667.0,William Eklund,L,SJS,21,80,16,29,45
5,8477021.0,Alex Kerfoot,C,ARI,29,82,13,32,45
5,8475218.0,Mattias Ekholm,D,EDM,33,79,11,34,45
5,8480188.0,Fabian Zetterlund,L,SJS,24,82,24,20,44
5,8475169.0,Evander Kane,L,EDM,32,77,24,20,44
5,8477511.0,Anthony Mantha,R,WSH,29,74,23,21,44
5,8474586.0,Jordan Eberle,R,SEA,33,78,17,27,44
5,8477496.0,Elias Lindholm,C,VAN,29,75,15,29,44
5,8477948.0,Travis Sanheim,D,PHI,27,81,10,34,44
5,8477479.0,Tyler Bertuzzi,L,TOR,28,80,21,22,43
5,8478466.0,Daniel Sprong,R,DET,26,76,18,25,43
5,8470613.0,Brent Burns,D,CAR,38,82,10,33,43
5,8476438.0,Brandon Saad,L,STL,31,82,26,16,42
5,8477407.0,Anthony Duclair,L,SJS,28,73,24,18,42
5,8478474.0,Lawson Crouse,L,ARI,26,81,23,19,42
5,8480893.0,Kirill Marchenko,R,CBJ,23,78,23,19,42
5,8482745.0,Mason McTavish,C,ANA,20,64,19,23,42
5,8481542.0,Moritz Seider,D,DET,22,82,9,33,42
5,8477447.0,Shea Theodore,D,VGK,28,47,5,37,42
5,8477935.0,Sam Bennett,C,FLA,27,69,20,21,41
5,8477998.0,Warren Foegele,L,EDM,27,82,20,21,41
5,8480009.0,Eeli Tolvanen,R,SEA,24,81,16,25,41
5,8479345.0,Jakob Chychrun,D,OTT,25,82,14,27,41
5,8480028.0,Morgan Frost,C,PHI,24,71,13,28,41
5,8478462.0,Nicolas Roy,C,VGK,26,70,13,28,41
5,8476458.0,Ryan Strome,C,ANA,30,79,11,30,41
5,8480434.0,Sean Durzi,D,ARI,25,76,9,32,41
5,8482079.0,Marco Rossi,C,MIN,22,82,21,19,40
5,8478498.0,Jake DeBrusk,L,BOS,27,80,19,21,40
5,8479365.0,Trent Frederic,C,BOS,25,82,18,22,40
5,8479525.0,Ross Colton,C,COL,27,80,17,23,40
5,8479400.0,Pierre-Luc Dubois,C,LAK,25,82,16,24,40
5,8478233.0,Andrew Mangiapane,L,CGY,27,75,14,26,40
5,8475191.0,Reilly Smith,R,PIT,32,76,13,27,40
5,8479987.0,Morgan Geekie,C,BOS,25,76,17,22,39
5,8482146.0,Luke Evangelista,R,NSH,21,80,16,23,39
5,8474150.0,Mikael Backlund,C,CGY,34,82,15,24,39
5,8476872.0,Scott Laughton,C,PHI,29,82,13,26,39
5,8478542.0,Evan Rodrigues,C,FLA,30,80,12,27,39
5,8478055.0,Gustav Forsling,D,FLA,27,79,10,29,39
5,8478397.0,Rasmus Andersson,D,CGY,27,78,9,30,39
5,8475764.0,Cam Fowler,D,ANA,32,81,5,34,39
5,8476792.0,Torey Krug,D,STL,32,77,4,35,39
5,8482089.0,Jake Neighbours,L,STL,21,77,27,11,38
5,8482149.0,Cole Perfetti,C,WPG,21,71,19,19,38
5,8476881.0,Tomas Hertl,C,SJS,30,54,17,21,38
5,8474037.0,James van Riemsdyk,L,BOS,34,71,11,27,38
5,8482105.0,Jake Sanderson,D,OTT,21,79,10,28,38
5,8475314.0,Anders Lee,L,NYI,33,81,20,17,37
5,8473422.0,Nick Foligno,L,CHI,36,74,17,20,37
5,8482665.0,Matty Beniers,C,SEA,21,77,15,22,37
5,8476483.0,Rickard Rakell,R,PIT,30,70,15,22,37
5,8476474.0,Stefan Noesen,R,CAR,30,81,14,23,37
5,8476480.0,Vladislav Namestnikov,C,WPG,31,78,11,26,37
5,8476958.0,Jaccob Slavin,D,CAR,29,81,6,31,37
5,8481535.0,Nils Hoglander,L,VAN,23,80,24,12,36
5,8480014.0,Gabriel Vilardi,C,WPG,24,47,22,14,36
5,8473986.0,Alex Killorn,L,ANA,34,63,18,18,36
5,8478046.0,Danton Heinen,L,BOS,28,74,17,19,36
5,8478891.0,Mason Appleton,C,WPG,27,82,14,22,36
5,8476432.0,Boone Jenner,C,CBJ,30,58,22,13,35
5,8477450.0,Jason Dickinson,C,CHI,28,82,22,13,35
5,8476880.0,Tom Wilson,R,WSH,29,74,18,17,35
5,8482699.0,Dylan Guenther,R,ARI,20,45,18,17,35
5,8475287.0,Erik Haula,L,NJD,32,76,16,19,35
5,8476925.0,Colton Sissons,C,NSH,30,81,15,20,35
5,8482720.0,Matthew Knies,L,TOR,21,80,15,20,35
5,8482113.0,Anton Lundell,C,FLA,22,78,13,22,35
5,8476392.0,Adam Lowry,C,WPG,30,81,12,23,35
5,8478472.0,Mathieu Joseph,R,OTT,26,72,11,24,35
5,8475799.0,Nino Niederreiter,R,WPG,31,77,18,16,34
5,8477476.0,Artturi Lehkonen,L,COL,28,45,16,18,34
5,8481618.0,Alex Newhook,C,MTL,22,55,15,19,34
5,8482159.0,Tyson Foerster,R,PHI,21,77,20,13,33
5,8482110.0,Dawson Mercer,C,NJD,22,82,20,13,33
5,8481580.0,Connor McMichael,C,WSH,22,80,18,15,33
5,8482055.0,Drew O'Connor,L,PIT,25,79,16,17,33
5,8477429.0,Andrew Copp,C,DET,29,79,13,20,33
5,8479992.0,Michael Rasmussen,C,DET,24,75,13,20,33
5,8476826.0,Yanni Gourde,C,SEA,32,80,11,22,33
5,8476419.0,Jean-Gabriel Pageau,C,NYI,31,82,11,22,33
5,8477986.0,Brandon Montour,D,FLA,29,66,8,25,33
5,8482671.0,Owen Power,D,BUF,21,76,6,27,33
5,8478178.0,Darren Raddysh,D,TBL,27,82,6,27,33
5,8480145.0,Neal Pionk,D,WPG,28,82,5,28,33
5,8474565.0,Alex Pietrangelo,D,VGK,33,64,4,29,33
5,8478057.0,Dakota Joshua,C,VAN,27,63,18,14,32
5,8477952.0,Robby Fabbri,C,DET,27,68,18,14,32
5,8476921.0,Jordan Martinook,L,CAR,31,82,14,18,32
5,8475722.0,Jason Zucker,L,ARI,31,69,14,18,32
5,8482705.0,Cole Sillinger,C,CBJ,20,77,13,19,32
5,8477498.0,Darnell Nurse,D,EDM,28,81,10,22,32
5,8475171.0,Oliver Ekman-Larsson,D,FLA,32,80,9,23,32
5,8478500.0,Ivan Provorov,D,CBJ,26,82,5,27,32
5,8474151.0,Ryan McDonagh,D,NSH,34,74,3,29,32
5,8474870.0,Tyler Johnson,C,CHI,33,67,17,14,31
5,8475848.0,Brendan Gallagher,R,MTL,31,77,16,15,31
5,8474189.0,Lars Eller,C,PIT,34,82,15,16,31
5,8476292.0,Ondrej Palat,L,NJD,32,71,11,20,31
5,8481624.0,Ilya Mikheyev,R,VAN,29,78,11,20,31
5,8478458.0,Jack Roslovic,C,CBJ,26,59,9,22,31
5,8477495.0,Seth Jones,D,CHI,29,67,8,23,31
5,8476979.0,Erik Gustafsson,D,NYR,31,76,6,25,31
5,8476331.0,Dylan DeMelo,D,WPG,30,82,3,28,31
5,8480064.0,Josh Norris,C,OTT,24,50,16,14,30
5,8475768.0,Jaden Schwartz,C,SEA,31,62,13,17,30
5,8480802.0,Ryan McLeod,C,EDM,24,81,12,18,30
5,8477987.0,Ryan Donato,C,CHI,27,78,12,18,30
5,8475149.0,Marcus Johansson,L,MIN,33,78,11,19,30
5,8481546.0,Cam York,D,PHI,22,82,10,20,30
5,8477505.0,Alex Wennberg,C,SEA,29,79,10,20,30
5,8473533.0,Jordan Staal,C,CAR,35,80,10,20,30
5,8478469.0,Thomas Chabot,D,OTT,26,51,9,21,30
5,8480817.0,K'Andre Miller,D,NYR,23,80,8,22,30
5,8477969.0,Marcus Pettersson,D,PIT,27,82,4,26,30
5,8475753.0,Justin Faulk,D,STL,31,60,2,28,30
5,8479619.0,Michael Carcone,L,ARI,27,74,21,8,29
5,8482475.0,Yegor Chinakhov,R,CBJ,22,53,16,13,29
5,8480459.0,Pius Suter,C,VAN,27,67,14,15,29
5,8475763.0,Kevin Hayes,R,STL,31,79,13,16,29
5,8481524.0,Bowen  Byram,D,COL,22,73,11,18,29
5,8480336.0,Sean Walker,D,PHI,29,81,10,19,29
5,8481656.0,Aliaksei Protas,C,WSH,22,78,6,23,29
5,8474574.0,Tyler Myers,D,VAN,33,77,5,24,29
5,8482125.0,Alexander Holtz,R,NJD,21,82,16,12,28
5,8480813.0,Joe Veleno,C,DET,23,80,12,16,28
5,8480068.0,Ryan Poehling,C,PHI,24,77,11,17,28
5,8478413.0,Jordan Greenway,L,BUF,26,67,10,18,28
5,8478115.0,Pierre Engvall,L,NYI,27,74,10,18,28
5,8476923.0,Damon Severson,D,CBJ,29,67,9,19,28
5,8476931.0,Jake McCabe,D,TOR,30,73,8,20,28
5,8478133.0,Jake Evans,C,MTL,27,82,7,21,28
5,8476927.0,Teddy Blueger,C,VAN,29,68,6,22,28
5,8475181.0,Nick Leddy,D,STL,32,82,3,25,28
5,8478020.0,Michael Amadio,R,VGK,27,73,14,13,27
5,8481582.0,Nicholas Robertson,L,TOR,22,56,14,13,27
5,8480185.0,Eetu Luostarinen,C,FLA,25,82,12,15,27
5,8480829.0,Jesperi Kotkaniemi,C,CAR,23,79,12,15,27
5,8480113.0,Alex Iafallo,L,WPG,30,82,11,16,27
5,8480748.0,Kiefer Sherwood,L,NSH,28,68,10,17,27
5,8481596.0,Shane Pinto,C,OTT,23,41,9,18,27
5,8480835.0,Jack Drury,C,CAR,23,74,8,19,27
5,8476463.0,Jonas Brodin,D,MIN,30,62,7,20,27
5,8482092.0,Ridly Greig,C,OTT,21,72,13,13,26
5,8476918.0,Jimmy Vesey,L,NYR,30,80,13,13,26
5,8476892.0,Colton Parayko,D,STL,30,82,10,16,26
5,8479941.0,Justin Danforth,R,CBJ,30,71,10,16,26
5,8477425.0,Miles Wood,L,COL,28,74,9,17,26
5,8480855.0,Jack McBain,C,ARI,23,67,8,18,26
5,8474602.0,Justin Schultz,D,SEA,33,70,7,19,26
5,8475790.0,Erik Gudbranson,D,CBJ,31,78,6,20,26
5,8475200.0,Dmitry Orlov,D,CAR,32,82,6,20,26
5,8482655.0,J.J. Moser,D,ARI,23,80,5,21,26
5,8476902.0,Esa Lindell,D,DAL,29,82,5,21,26
5,8475188.0,Brayden McNabb,D,VGK,32,82,4,22,26
5,8476854.0,Hampus Lindholm,D,BOS,29,73,3,23,26
5,8474673.0,TJ Brodie,D,TOR,33,78,1,25,26
5,8476469.0,Joel Armia,R,MTL,30,66,17,8,25
5,8481601.0,Simon Holmstrom,R,NYI,22,75,15,10,25
5,8481186.0,Logan O'Connor,R,COL,27,57,13,12,25
5,8471698.0,T.J. Oshie,R,WSH,37,52,12,13,25
5,8479591.0,Michael Eyssimont,C,TBL,27,81,11,14,25
5,8476312.0,Josh Manson,D,COL,32,76,8,17,25
5,8478136.0,Jake Middleton,D,MIN,27,80,7,18,25
5,8481032.0,Paul Cotter,C,VGK,24,76,7,18,25
5,8477508.0,Curtis Lazar,C,NJD,28,71,7,18,25
5,8482245.0,Artem Zub,D,OTT,28,69,5,20,25
5,8478911.0,Matt Roy,D,LAK,28,81,5,20,25
5,8476879.0,Cody Ceci,D,EDM,30,79,5,20,25
5,8478507.0,John Marino,D,NJD,26,75,4,21,25
5,8478840.0,Will Borgen,D,SEA,27,82,3,22,25
5,8482259.0,Bobby McMann,C,TOR,27,56,15,9,24
5,8481604.0,Pavel Dorofeyev,L,VGK,23,47,13,11,24
5,8478043.0,Sam Lafferty,C,VAN,28,79,13,11,24
5,8479351.0,Sam Steel,C,DAL,25,77,9,15,24
5,8475193.0,Tomas Tatar,L,SEA,33,70,9,15,24
5,8475744.0,Evgeny Kuznetsov,C,WSH,31,63,8,16,24
5,8475233.0,David Savard,D,MTL,33,60,6,18,24
5,8476422.0,Mike Reilly,D,NYI,30,61,6,18,24
5,8474031.0,Kevin Shattenkirk,D,BOS,34,61,6,18,24
5,8473507.0,Jeff Petry,D,DET,36,73,3,21,24
5,8480246.0,Nick Perbix,D,TBL,25,77,2,22,24
5,8481606.0,Jordan Spence,D,LAK,22,71,2,22,24
5,8477947.0,Sonny Milano,L,WSH,27,49,15,8,23
5,8475793.0,Ryan Johansen,C,COL,31,63,13,10,23
5,8480821.0,Filip Zadina,R,SJS,24,72,13,10,23
5,8474149.0,Evgenii Dadonov,R,DAL,34,51,12,11,23
5,8475231.0,Casey Cizikas,C,NYI,32,70,10,13,23
5,8474884.0,Mike Hoffman,C,SJS,34,66,10,13,23
5,8482062.0,Cole Smith,L,NSH,28,80,9,14,23
5,8478882.0,Vladislav Gavrikov,D,LAK,28,77,6,17,23
5,8474157.0,Max Pacioretty,L,WSH,35,47,4,19,23
5,8480873.0,Rasmus Sandin,D,WSH,23,68,3,20,23
5,8480043.0,Timothy Liljegren,D,TOR,24,55,3,20,23
5,8475343.0,Nic Dowd,C,WSH,33,64,12,10,22
5,8470621.0,Corey Perry,R,EDM,38,54,12,10,22
5,8473449.0,Kyle Okposo,R,BUF,35,67,12,10,22
5,8477446.0,Michael McCarron,R,NSH,28,70,12,10,22
5,8481517.0,Brett Leason,R,ANA,24,68,11,11,22
5,8478970.0,Jalen Chatfield,D,CAR,27,72,8,14,22
5,8481014.0,Alexander Romanov,D,NYI,23,81,7,15,22
5,8482087.0,Kaiden Guhle,D,MTL,21,70,6,16,22
5,8477953.0,Kasperi Kapanen,R,STL,27,73,6,16,22
5,8476885.0,Jacob Trouba,D,NYR,29,69,3,19,22
5,8480281.0,Alexey Toropchenko,R,STL,24,82,14,7,21
5,8482157.0,Will Cuylle,L,NYR,21,81,13,8,21
5,8478013.0,Jake Walman,D,DET,27,63,12,9,21
5,8475714.0,Calle Jarnkrok,C,TOR,32,52,10,11,21
5,8475220.0,Marcus Foligno,L,MIN,32,55,9,12,21
5,8471218.0,Blake Wheeler,R,NYR,37,54,9,12,21
5,8479359.0,Beck Malenstyn,L,WSH,25,81,6,15,21
5,8476897.0,Oskar Sundqvist,C,STL,29,71,6,15,21
5,8481178.0,Egor Zamula,D,PHI,23,66,5,16,21
5,8480891.0,Michael Kesselring,D,ARI,23,65,5,16,21
5,8479983.0,Mario Ferraro,D,SJS,25,78,3,18,21
5,8475225.0,Craig Smith,C,DAL,34,75,11,9,20
5,8476981.0,Josh Anderson,R,MTL,29,78,9,11,20
5,8475455.0,Brenden Dillon,D,WPG,33,77,8,12,20
5,8481577.0,Philip Tomasino,C,NSH,22,41,7,13,20
5,8477507.0,Nikita Zadorov,D,VAN,28,75,6,14,20
5,8475279.0,Ben Chiarot,D,DET,32,77,5,15,20
5,8478851.0,Alexandre Carrier,D,NSH,27,73,4,16,20
5,8480035.0,Henri Jokiharju,D,BUF,24,74,3,17,20
5,8480073.0,Erik Brannstrom,D,OTT,24,76,3,17,20
5,8475179.0,Dmitry Kulikov,D,FLA,33,76,1,19,20
5,8481554.0,Kaapo Kakko,R,NYR,22,61,13,6,19
5,8480980.0,Connor Dewar,C,MIN,24,74,11,8,19
5,8479415.0,Michael McLeod,C,NJD,25,45,10,9,19
5,8482097.0,Jack Quinn,R,BUF,22,27,9,10,19
5,8480144.0,David Kampf,C,TOR,28,78,8,11,19
5,8479353.0,Brett Howden,C,VGK,25,72,8,11,19
5,8475164.0,Jakob Silfverberg,R,ANA,33,81,7,12,19
5,8476889.0,Radek Faksa,C,DAL,29,74,7,12,19
5,8473504.0,Cal Clutterbuck,R,NYI,36,82,7,12,19
5,8475855.0,Jesper Fast,R,CAR,32,73,6,13,19
5,8477380.0,Jonny Brodzinski,C,NYR,30,57,6,13,19
5,8471699.0,Andrew Cogliano,C,COL,36,75,6,13,19
5,8477506.0,Ryan Pulock,D,NYI,29,58,5,14,19
5,8480172.0,Jan Rutta,D,SJS,33,69,5,14,19
5,8482073.0,Braden Schneider,D,NYR,22,82,5,14,19
5,8478432.0,Christian Fischer,R,DET,26,79,5,14,19
5,8479410.0,Mikhail Sergachev,D,TBL,25,34,2,17,19
5,8475690.0,Chris Tanev,D,CGY,34,75,2,17,19
5,8480878.0,Nils Lundkvist,D,DAL,23,59,2,17,19
5,8479316.0,Luke Kunin,C,SJS,26,77,11,7,18
5,8480289.0,Morgan Barron,C,WPG,25,80,11,7,18
5,8476374.0,Sean Kuraly,C,CBJ,30,62,9,9,18
5,8480448.0,Parker Kelly,L,OTT,24,80,8,10,18
5,8478434.0,Keegan Kolesar,R,VGK,26,79,8,10,18
5,8475462.0,Radko Gudas,D,ANA,33,66,6,12,18
5,8480220.0,Noah Cates,L,PHI,24,59,6,12,18
5,8476457.0,Adam Larsson,D,SEA,31,81,4,14,18
5,8477932.0,Aaron Ekblad,D,FLA,27,51,4,14,18
5,8477365.0,Connor Clifton,D,BUF,28,79,4,14,18
5,8476874.0,Olli Maatta,D,DET,29,72,4,14,18
5,8479398.0,Samuel Girard,D,COL,25,59,3,15,18
5,8479998.0,Mikey Anderson,D,LAK,24,74,2,16,18
5,8480049.0,Dylan Samberg,D,WPG,24,78,1,17,18
5,8478508.0,Yakov Trenin,C,NSH,26,76,12,5,17
5,8477903.0,Garnet Hathaway,R,PHI,32,82,7,10,17
5,8480995.0,Pontus Holmberg,R,TOR,24,54,7,10,17
5,8479315.0,Joey Anderson,R,CHI,25,55,5,12,17
5,8478463.0,Anthony Beauvillier,L,CHI,26,60,5,12,17
5,8474166.0,Alec Martinez,D,VGK,36,55,4,13,17
5,8481522.0,Peyton Krebs,C,BUF,22,80,4,13,17
5,8478859.0,Niko Mikkola,D,FLA,27,82,3,14,17
5,8479324.0,Ryan Lindgren,D,NYR,25,76,3,14,17
5,8481605.0,Jackson LaCombe,D,ANA,22,71,2,15,17
5,8479976.0,Juuso Valimaki,D,ARI,25,68,2,15,17
5,8470600.0,Ryan Suter,D,DAL,38,82,2,15,17
5,8480884.0,Calen Addison,D,SJS,23,72,1,16,17
5,8475842.0,Sam Carrick,C,ANA,31,77,10,6,16
5,8479977.0,Kailer Yamamoto,R,SEA,25,59,8,8,16
5,8473453.0,Trevor Lewis,C,LAK,36,82,8,8,16
5,8480205.0,Emil Bemstrom,R,CBJ,24,56,8,8,16
5,8479293.0,Brandon Tanev,L,SEA,32,66,7,9,16
5,8477444.0,Andre Burakovsky,L,SEA,28,49,7,9,16
5,8475208.0,Brian Dumoulin,D,SEA,32,80,6,10,16
5,8482660.0,Kent Johnson,C,CBJ,21,42,6,10,16
5,8477979.0,Nicolas Aube-Kubel,R,WSH,27,60,6,10,16
5,8476462.0,Dougie Hamilton,D,NJD,30,20,5,11,16
5,8482117.0,Lukas Reichel,L,CHI,21,65,5,11,16
5,8474034.0,Pat Maroon,L,MIN,35,51,4,12,16
5,8480796.0,Martin Fehervary,D,WSH,24,66,3,13,16
5,8476967.0,Brett Kulak,D,EDM,29,82,3,13,16
5,8471677.0,Jack Johnson,D,COL,36,80,3,13,16
5,8481568.0,Alex Vlasic,D,CHI,22,76,2,14,16
5,8476917.0,Adam Pelech,D,NYI,29,58,1,15,16
5,8479423.0,Alex Nylander,L,PIT,25,28,11,4,15
5,8478831.0,Kevin Stenlund,C,FLA,27,81,11,4,15
5,8470604.0,Jeff Carter,C,PIT,38,72,11,4,15
5,8477330.0,Dominik Kubalik,L,OTT,28,74,11,4,15
5,8476873.0,Mark Jankowski,C,NSH,29,32,7,8,15
5,8476393.0,Nick Cousins,C,FLA,30,69,7,8,15
5,8481560.0,Arthur Kaliyev,R,LAK,22,51,7,8,15
5,8481481.0,Blake Lizotte,C,LAK,26,62,7,8,15
5,8478109.0,Victor Olofsson,L,BUF,28,51,7,8,15
5,8481533.0,Trevor Zegras,C,ANA,22,31,6,9,15
5,8478042.0,Viktor Arvidsson,R,LAK,30,18,6,9,15
5,8474090.0,Brendan Smith,D,NJD,34,63,5,10,15
5,8477919.0,Frederick Gaudreau,C,MIN,30,67,5,10,15
5,8479368.0,Max Jones,L,ANA,25,52,5,10,15
5,8477839.0,Conor Sheary,L,TBL,31,57,4,11,15
5,8476467.0,Jamie Oleksiak,D,SEA,31,82,2,13,15
5,8475197.0,Tyson Barrie,D,NSH,32,41,1,14,15
5,8476878.0,Zemgus Girgensons,L,BUF,29,63,8,6,14
5,8480011.0,Klim Kostin,C,DET,24,52,8,6,14
5,8479661.0,Tanner Jeannot,L,TBL,26,55,7,7,14
5,8478468.0,Jeremy Lauzon,D,NSH,26,79,6,8,14
5,8480003.0,Jesper Boqvist,C,BOS,25,47,6,8,14
5,8479390.0,Taylor Raddysh,R,CHI,25,73,5,9,14
5,8477070.0,Liam O'Brien,C,ARI,29,75,5,9,14
5,8478443.0,Brandon Carlo,D,BOS,27,76,4,10,14
5,8480879.0,Jacob Bernard-Docker,D,OTT,23,72,4,10,14
5,8477392.0,Hudson Fasching,R,NYI,28,45,4,10,14
5,8477435.0,Ryan Graves,D,PIT,28,70,3,11,14
5,8474567.0,Zach Bogosian,D,MIN,33,65,3,11,14
5,8480887.0,Jordan Harris,D,MTL,23,56,3,11,14
5,8480727.0,Zach Whitecloud,D,VGK,27,61,2,12,14
5,8477220.0,Nate Schmidt,D,WPG,32,63,2,12,14
5,8475324.0,Nick Jensen,D,WSH,33,78,1,13,14
5,8480001.0,Urho Vaakanainen,D,ANA,24,68,1,13,14
5,8477845.0,Trevor van Riemsdyk,D,WSH,32,70,0,14,14
5,8482111.0,Justin Barron,D,MTL,22,48,7,6,13
5,8479383.0,Boris Katchouk,L,CHI,25,59,7,6,13
5,8477573.0,Nathan Walker,L,STL,29,45,7,6,13
5,8480192.0,Johnathan Kovacevic,D,MTL,26,62,6,7,13
5,8479996.0,Cody Glass,C,NSH,24,41,6,7,13
5,8481477.0,Nico Sturm,C,SJS,28,63,5,8,13
5,8476871.0,Tanner Pearson,L,MTL,31,54,5,8,13
5,8479520.0,Brandon Duhaime,R,MIN,26,80,5,8,13
5,8479402.0,Jake Bean,D,CBJ,25,72,4,9,13
5,8482222.0,Alexander Barabanov,L,SJS,29,46,4,9,13
5,8477488.0,Brett Pesce,D,CAR,29,70,3,10,13
5,8479371.0,Dante Fabbro,D,NSH,25,56,3,10,13
5,8478416.0,Erik Cernak,D,TBL,26,69,2,11,13
5,8476372.0,Nick Seeler,D,PHI,30,71,1,12,13
5,8481704.0,Juuso Parssinen,C,NSH,22,44,8,4,12
5,8476278.0,Colin Blackwell,C,CHI,30,44,8,4,12
5,8479336.0,Carl Grundstrom,R,LAK,26,50,8,4,12
5,8471709.0,Marc-Edouard Vlasic,D,SJS,36,57,6,6,12
5,8479393.0,Noah Gregor,C,TOR,25,63,6,6,12
5,8478421.0,A.J. Greer,L,CGY,27,59,6,6,12
5,8479671.0,Mathieu Olivier,R,CBJ,26,54,5,7,12
5,8477846.0,Ryan Carpenter,C,SJS,32,62,5,7,12
5,8478585.0,Derek Ryan,C,EDM,37,70,5,7,12
5,8479414.0,Nathan Bastian,R,NJD,26,54,5,7,12
5,8477015.0,Connor Brown,R,EDM,29,71,4,8,12
5,8476624.0,Barclay Goodrow,C,NYR,30,80,4,8,12
5,8477406.0,Mattias Janmark,C,EDM,31,71,4,8,12
5,8476919.0,Chris Tierney,C,NJD,29,52,4,8,12
5,8479543.0,Michael Pezzetta,L,MTL,25,61,3,9,12
5,8475825.0,Jani Hakanpää,D,DAL,31,64,2,10,12
5,8479980.0,Nicolas Hague,D,VGK,25,73,2,10,12
5,8476822.0,Luke Glendening,C,TBL,34,81,10,1,11
5,8482133.0,Thomas Bordeleau,C,SJS,21,27,6,5,11
5,8480806.0,Isac Lundestrom,C,ANA,24,46,5,6,11
5,8480025.0,MacKenzie Entwistle,R,CHI,24,67,5,6,11
5,8475750.0,Jon Merrill,D,MIN,31,65,4,7,11
5,8481567.0,Henry Thrun,D,SJS,22,51,3,8,11
5,8477950.0,Tony DeAngelo,D,CAR,28,31,3,8,11
5,8474013.0,Ian Cole,D,VAN,34,78,2,9,11
5,8476891.0,Matt Grzelcyk,D,BOS,29,63,2,9,11
5,8480058.0,Pierre-Olivier Joseph,D,PIT,24,52,2,9,11
5,8480860.0,Kevin Bahl,D,NJD,23,82,1,10,11
5,8479576.0,Vincent Desharnais,D,EDM,27,78,1,10,11
5,8470610.0,Zach Parise,L,COL,39,30,5,5,10
5,8476858.0,Phillip Di Giuseppe,L,VAN,30,51,5,5,10
5,8474040.0,Sam Gagner,C,EDM,34,28,5,5,10
5,8480355.0,Mark Kastelic,C,OTT,24,63,5,5,10
5,8482142.0,Jamie Drysdale,D,PHI,21,34,3,7,10
5,8480849.0,Barrett Hayton,C,ARI,23,33,3,7,10
5,8475177.0,Calvin de Haan,D,TBL,32,59,3,7,10
5,8482964.0,Arber Xhekaj,D,MTL,22,44,3,7,10
5,8477384.0,Josh Brown,D,ARI,29,51,3,7,10
5,8480184.0,Gustav Lindström,D,ANA,25,46,3,7,10
5,8480762.0,Eric Robinson,L,BUF,28,47,3,7,10
5,8477018.0,Ben Hutton,D,VGK,30,41,2,8,10
5,8481093.0,Rafael Harvey-Pinard,L,MTL,24,45,2,8,10
5,8480880.0,Jakub Lauko,C,BOS,23,60,2,8,10
5,8480871.0,Adam Boqvist,D,CBJ,23,35,1,9,10
5,8479369.0,Andrew Peeke,D,CBJ,25,38,1,9,10
5,8479982.0,Conor Timmins,D,TOR,25,25,1,9,10
5,8483460.0,David Jiricek,D,CBJ,20,43,1,9,10
5,8477971.0,Andreas Englund,D,LAK,27,82,1,9,10
5,8471274.0,Alex Goligoski,D,MIN,38,36,0,10,10
5,8479439.0,Jacob MacDonald,D,SJS,30,34,7,2,9
5,8479339.0,Patrik Laine,L,CBJ,25,18,6,3,9
5,8477353.0,Tyler Motte,C,TBL,28,69,6,3,9
5,8482077.0,Dylan Holloway,L,EDM,22,38,6,3,9
5,8479718.0,Alex Barré-Boulet,C,TBL,26,36,6,3,9
5,8477989.0,Christian Dvorak,C,MTL,27,30,5,4,9
5,8479328.0,Julien Gauthier,R,NYI,26,27,5,4,9
5,8479968.0,Vinni Lettieri,C,MIN,28,46,5,4,9
5,8476525.0,Colin Miller,D,NJD,31,46,4,5,9
5,8470966.0,Mark Giordano,D,TOR,40,46,3,6,9
5,8482679.0,Matt Coronato,R,CGY,21,34,3,6,9
5,8480008.0,Adam Ruzicka,C,ARI,24,42,3,6,9
5,8481641.0,Joel Kiviranta,L,COL,27,56,3,6,9
5,8478028.0,Fredrik Olofsson,L,COL,27,57,3,6,9
5,8480222.0,Sebastian Aho,D,NYI,27,58,2,7,9
5,8481708.0,Zac Jones,D,NYR,23,31,2,7,9
5,8476960.0,Andreas Athanasiou,C,CHI,29,28,2,7,9
5,8480848.0,Ty Dellandrea,C,DAL,23,42,2,7,9
5,8478099.0,Kevin Labanc,R,SJS,28,46,2,7,9
5,8478399.0,Jonas Siegenthaler,D,NJD,26,57,1,8,9
5,8481527.0,Kaedan Korczak,D,VGK,22,26,1,8,9
5,8481537.0,Nikita Okhotiuk,D,SJS,23,52,1,8,9
5,8475797.0,Jarred Tinordi,D,CHI,31,52,0,9,9
5,8479372.0,Josh Mahura,D,FLA,25,30,0,9,9
5,8477478.0,William Carrier,L,VGK,29,39,6,2,8
5,8480252.0,Cole Guttman,C,CHI,24,27,4,4,8
5,8481058.0,Jesse Ylönen,R,MTL,24,59,4,4,8
5,8474709.0,Matt Martin,L,NYI,34,57,4,4,8
5,8477541.0,Dakota Mermis,D,MIN,29,47,3,5,8
5,8478211.0,Dryden Hunt,L,CGY,28,28,3,5,8
5,8476473.0,Connor Murphy,D,CHI,30,46,2,6,8
5,8477335.0,Kyle Burroughs,D,SJS,28,73,2,6,8
5,8474618.0,Marco Scandella,D,STL,33,65,2,6,8
5,8476329.0,Travis Boyd,C,ARI,30,16,2,6,8
5,8480196.0,Jacob Bryson,D,BUF,26,36,1,7,8
5,8478450.0,Parker Wotherspoon,D,BOS,26,41,0,8,8
5,8480950.0,Ilya Lyubushkin,D,ANA,29,74,0,8,8
5,8479066.0,Ryan Lomberg,L,FLA,29,75,5,2,7
5,8478569.0,Noel Acciari,C,PIT,32,55,4,3,7
5,8477930.0,Pierre-Edouard Bellemare,L,SEA,38,40,4,3,7
5,8482241.0,Radim Zohorna,L,PIT,27,33,4,3,7
5,8482624.0,Daniil Miromanov,D,VGK,26,24,3,4,7
5,8479346.0,Dillon Dube,C,CGY,25,43,3,4,7
5,8482496.0,Nils Aman,C,VAN,23,43,3,4,7
5,8481019.0,David Gustafsson,C,WPG,23,39,3,4,7
5,8478408.0,Travis Dermott,D,ARI,27,50,2,5,7
5,8479458.0,Nikita Zaitsev,D,CHI,32,38,2,5,7
5,8481167.0,Brayden Pachal,D,CGY,24,50,2,5,7
5,8480084.0,Nick DeSimone,D,NJD,29,34,2,5,7
5,8482652.0,Walker Duehr,R,CGY,26,40,2,5,7
5,8480807.0,Mattias Samuelsson,D,BUF,23,41,1,6,7
5,8479442.0,Troy Stecher,D,ARI,29,54,1,6,7
5,8482516.0,Matthew Kessel,D,STL,23,39,1,6,7
5,8474568.0,Luke Schenn,D,NSH,34,63,1,6,7
5,8478454.0,Noah Juulsen,D,VAN,26,54,1,6,7
5,8478502.0,Dennis Gilbert,D,CGY,27,34,1,6,7
5,8478104.0,Sammy Blais,L,STL,27,53,1,6,7
5,8482176.0,Wyatt Kaiser,D,CHI,21,32,0,7,7
5,8473446.0,Erik Johnson,D,BUF,35,67,5,1,6
5,8471817.0,Ryan Reaves,R,TOR,36,49,4,2,6
5,8479370.0,Tyson Jost,C,BUF,25,43,3,3,6
5,8477369.0,Carson Soucy,D,VAN,29,40,2,4,6
5,8474612.0,Travis Hamonic,D,OTT,33,48,2,4,6
5,8482730.0,Brandt Clarke,D,LAK,20,16,2,4,6
5,8477944.0,Jakub Vrana,L,STL,27,21,2,4,6
5,8477931.0,Tomas Nosek,L,NJD,31,36,2,4,6
5,8480789.0,Oliver Wahlstrom,R,NYI,23,32,2,4,6
5,8481013.0,Jonatan Berggren,R,DET,23,12,2,4,6
5,8476441.0,Joel Edmundson,D,WSH,30,53,1,5,6
5,8482192.0,Isaak Phillips,D,CHI,22,33,0,6,6
5,8480078.0,Filip Chytil,C,NYR,24,10,0,6,6
5,8483524.0,Shane Wright,C,SEA,19,8,4,1,5
5,8477962.0,Brendan Lemieux,L,CAR,27,32,3,2,5
5,8481541.0,Samuel Bolduc,D,NYI,23,34,2,3,5
5,8481147.0,Reese Johnson,C,CHI,25,42,2,3,5
5,8481422.0,Jacob Lucchini,C,MIN,28,40,2,3,5
5,8479536.0,Axel Jonsson-Fjallby,L,WPG,25,26,2,3,5
5,8481122.0,Simon Benoit,D,TOR,25,64,1,4,5
5,8477938.0,Haydn Fleury,D,TBL,27,24,1,4,5
5,8477810.0,Joel Hanley,D,DAL,32,42,1,4,5
5,8471686.0,Marc Staal,D,PHI,36,35,1,4,5
5,8474009.0,Nick Bonino,C,NYR,35,45,1,4,5
5,8476952.0,Dominic Toninato,C,WPG,29,15,1,4,5
5,8479547.0,Matthew Phillips,R,PIT,25,31,1,4,5
5,8480245.0,Olle Lycksell,R,PHI,24,18,1,4,5
5,8474716.0,Jared Spurgeon,D,MIN,34,16,0,5,5
5,8475906.0,John Klingberg,D,TOR,31,14,0,5,5
5,8476429.0,Scott Mayfield,D,NYI,31,41,0,5,5
5,8475718.0,Justin Holl,D,DET,31,38,0,5,5
5,8478452.0,Caleb Jones,D,COL,26,25,0,5,5
5,8479291.0,Kevin Rooney,C,CGY,30,33,3,1,4
5,8479344.0,Jesse Puljujarvi,R,PIT,25,22,3,1,4
5,8478051.0,Max Willman,C,NJD,28,18,3,1,4
5,8475791.0,Taylor Hall,L,CHI,32,10,2,2,4
5,8481056.0,Spencer Stastney,D,NSH,23,20,2,2,4
5,8476867.0,Brendan Gaunce,C,CBJ,29,24,2,2,4
5,8479981.0,Jonah Gadjovich,L,FLA,25,39,2,2,4
5,8475766.0,Austin Watson,L,TBL,31,33,2,2,4
5,8477499.0,Rasmus Ristolainen,D,PHI,29,31,1,3,4
5,8478451.0,Ethan Bear,D,WSH,26,24,1,3,4
5,8481609.0,Vladislav Kolyachonok,D,ARI,22,5,1,3,4
5,8477244.0,Chad Ruhwedel,D,PIT,33,52,1,3,4
5,8476442.0,Matt Nieto,L,PIT,31,22,1,3,4
5,8479994.0,Jaret Anderson-Dolan,C,LAK,24,31,1,3,4
5,8475752.0,Tyler Pitlick,C,NYR,32,34,1,3,4
5,8481532.0,Alex Turcotte,C,LAK,22,20,1,3,4
5,8477527.0,Ross Johnston,L,ANA,29,68,1,3,4
5,8475235.0,Nicolas Deslauriers,L,PHI,32,60,1,3,4
5,8476913.0,Devin Shore,C,SEA,29,21,1,3,4
5,8479379.0,Givani Smith,R,SJS,25,36,1,3,4
5,8475762.0,Derek Forbort,D,BOS,31,35,0,4,4
5,8478424.0,Jansen Harkins,C,PIT,26,45,0,4,4
5,8480441.0,Trey Fix-Wolansky,R,CBJ,24,11,2,1,3
5,8478078.0,Rourke Chartier,C,OTT,27,37,2,1,3
5,8480776.0,Sheldon Rempal,R,VGK,28,9,2,1,3
5,8480468.0,James Hamblin,L,EDM,24,31,2,1,3
5,8479772.0,Zack MacEwen,R,OTT,27,30,2,1,3
5,8477073.0,Kurtis MacDermid,D,COL,29,45,2,1,3
5,8480823.0,Alexander Alexeyev,D,WSH,24,39,1,2,3
5,8480007.0,Jonas Rondbjerg,R,VGK,24,20,1,2,3
5,8476934.0,Brock McGinn,L,ANA,29,24,1,2,3
5,8478409.0,Anthony Richard,C,BOS,27,9,1,2,3
5,8483570.0,Ben Meyers,C,COL,25,23,1,2,3
5,8476994.0,Vinnie Hinostroza,C,PIT,29,14,1,2,3
5,8481592.0,Jakob Pelletier,L,CGY,22,13,1,2,3
5,8478904.0,Steven Lorentz,C,FLA,27,38,1,2,3
5,8479972.0,Mason Shaw,C,MIN,25,20,1,2,3
5,8480853.0,Liam Foudy,C,NSH,23,13,0,3,3
5,8482762.0,Simon Edvinsson,D,DET,20,16,1,1,2
5,8482101.0,Danil Gushchin,L,SJS,21,4,1,1,2
5,8479378.0,Logan Stanley,D,WPG,25,25,1,1,2
5,8481006.0,Tyler Tucker,D,STL,23,26,1,1,2
5,8478495.0,Denis Gurianov,R,NSH,26,18,1,1,2
5,8479362.0,Riley Tufte,L,COL,25,5,1,1,2
5,8480292.0,Carson Meyer,R,CBJ,26,14,1,1,2
5,8477454.0,Adam Erne,L,EDM,28,24,1,1,2
5,8475780.0,Chris Wagner,R,BOS,32,13,1,1,2
5,8476988.0,Matt Benning,D,SJS,29,14,0,2,2
5,8477034.0,Jaycob Megna,D,CHI,31,44,0,2,2
5,8481521.0,Ronnie Attard,D,PHI,24,12,0,2,2
5,8480070.0,Ian Mitchell,D,BOS,24,13,0,2,2
5,8477851.0,Jordan Oesterle,D,CGY,31,22,0,2,2
5,8481161.0,Jake Christiansen,D,CBJ,24,12,0,2,2
5,8482451.0,Mikael Pyyhtia,L,CBJ,22,17,0,2,2
5,8473473.0,Milan Lucic,L,BOS,35,4,0,2,2
5,8480870.0,Bo Groulx,C,ANA,23,45,0,2,2
5,8481598.0,Philip Broberg,D,EDM,22,12,0,2,2
5,8477464.0,Nic Petan,C,MIN,28,6,0,2,2
5,8481617.0,Vasily Podkolzin,R,VAN,22,19,0,2,2
5,8481751.0,Lukas Rousek,R,BUF,24,15,0,2,2
5,8481550.0,Adam Beckman,L,MIN,22,11,0,2,2
5,8481523.0,Kirby Dach,C,MTL,22,2,0,2,2
5,8481543.0,Nikita Alexandrov,C,STL,23,23,0,2,2
5,8478146.0,Matthew Highmore,C,OTT,27,7,0,2,2
5,8481043.0,Cole Koepke,L,TBL,25,9,0,2,2
5,8483565.0,Nick Blankenburg,D,CBJ,25,12,1,0,1
5,8483397.0,Marc McLaughlin,C,BOS,24,1,1,0,1
5,8480874.0,Adam Ginning,D,PHI,23,9,1,0,1
5,8481754.0,Nikita Nesterenko,C,ANA,22,3,1,0,1
5,8480021.0,Jack Studnicka,C,SJS,24,22,1,0,1
5,8481518.0,Nolan Foote,L,NJD,23,4,1,0,1
5,8479421.0,Jacob Moverare,D,LAK,25,24,1,0,1
5,8481239.0,Samuel Fagemo,L,LAK,23,8,1,0,1
5,8479546.0,Oskar Steen,C,BOS,25,34,1,0,1
5,8480836.0,Jonathan Gruden,C,PIT,23,13,1,0,1
5,8481077.0,John Leonard,L,NSH,25,6,1,0,1
5,8482147.0,Jean-Luc Foudy,C,COL,21,4,1,0,1
5,8474053.0,Logan Couture,C,SJS,34,6,0,1,1
5,8481812.0,Nikolai Knyzhov,D,SJS,26,10,0,1,1
5,8479984.0,Cal Foote,D,NJD,25,4,0,1,1
5,8479321.0,Lucas Johansen,D,WSH,26,6,0,1,1
5,8473563.0,Nicklas Backstrom,C,WSH,36,8,0,1,1
5,8479320.0,Max Lajoie,D,TOR,26,7,0,1,1
5,8482095.0,Tyler Kleven,D,OTT,21,9,0,1,1
5,8480157.0,Calle Rosen,D,STL,29,6,0,1,1
5,8480031.0,Max Comtois,L,ANA,24,1,0,1,1
5,8478017.0,Mark Friedman,D,VAN,28,23,0,1,1
5,8479348.0,Kale Clague,D,BUF,25,3,0,1,1
5,8475278.0,Byron Froese,C,VGK,32,16,0,1,1
5,8475795.0,Dylan McIlrath,D,WSH,31,3,0,1,1
5,8480845.0,Rasmus Kupari,C,WPG,23,28,0,1,1
5,8480890.0,Jan Jenik,R,ARI,23,5,0,1,1
5,8477887.0,Patrick Brown,C,BOS,31,11,0,1,1
5,8478512.0,Austin Czarnik,C,DET,31,34,0,1,1
5,8479367.0,William Lockwood,R,FLA,25,26,0,1,1
5,8483597.0,Milos Kelemen,L,ARI,24,10,0,1,1
5,8477126.0,Jayson Megna,C,ANA,33,1,0,0,0
5,8479639.0,Dylan Coghlan,D,CAR,25,1,0,0,0
5,8482067.0,Connor Mackey,D,NYR,27,1,0,0,0
5,8476856.0,Matt Dumba,D,ARI,29,0,0,0,0
5,8478483.0,Mitchell Marner,R,TOR,26,0,0,0,0
5,8471873.0,Anton Stralman,D,BOS,37,0,0,0,0
5,8474162.0,Jake Muzzin,D,TOR,34,0,0,0,0
5,8470638.0,Patrice Bergeron,C,BOS,38,0,0,0,0
5,8473604.0,Jonathan Toews,C,CHI,35,0,0,0,0
5,8471276.0,David Krejci,C,BOS,37,0,0,0,0
5,8474207.0,Nick Holden,D,OTT,36,0,0,0,0
5,8475747.0,Patrik Nemeth,D,ARI,31,0,0,0,0
5,8477467.0,Gustav Olofsson,D,SEA,29,1,0,0,0
5,8479514.0,Rem Pitlick,C,CHI,26,9,0,0,0
5,8474027.0,Justin Braun,D,PHI,36,0,0,0,0
5,8481599.0,Victor Soderstrom,D,ARI,22,3,0,0,0
5,8474161.0,Jakub Voracek,R,CBJ,34,0,0,0,0
5,8479985.0,Cale Fleury,D,SEA,25,1,0,0,0
5,8471303.0,Alexander Edler,D,LAK,37,0,0,0,0
5,8474573.0,Josh Bailey,R,NYI,34,0,0,0,0
5,8483619.0,Filip Roos,D,CHI,24,4,0,0,0
5,8474818.0,Jordie Benn,D,TOR,36,0,0,0,0
5,8476449.0,Scott Harrington,D,ANA,30,0,0,0,0
5,8483620.0,Marcus Bjork,D,CBJ,26,0,0,0,0
5,8470595.0,Eric Staal,C,FLA,39,0,0,0,0
5,8481585.0,Egor Afanasyev,L,NSH,22,2,0,0,0
5,8482712.0,Oskar Olausson,R,COL,21,1,0,0,0
5,8481072.0,Tim Berni,D,CBJ,23,0,0,0,0
5,8479945.0,Gavin Bayreuther,D,CBJ,29,0,0,0,0
5,8481600.0,Tobias Bjornfot,D,VGK,22,4,0,0,0
5,8481679.0,Maxence Guenette,D,OTT,22,7,0,0,0
5,8474683.0,Derek Grant,C,ANA,33,0,0,0,0
5,8476470.0,Nathan Beaulieu,D,ANA,31,0,0,0,0
5,8474145.0,Robert Bortuzzo,D,NYI,34,27,0,0,0
5,8480216.0,Jacob Peterson,C,SJS,24,6,0,0,0
5,8473548.0,Phil Kessel,R,VGK,36,0,0,0,0
5,8480160.0,Radim Simek,D,SJS,31,0,0,0,0
5,8480883.0,Ty Smith,D,PIT,23,0,0,0,0
5,8471669.0,Paul Stastny,C,CAR,38,0,0,0,0
5,8475227.0,Chris Wideman,D,MTL,33,0,0,0,0
5,8480913.0,Jordan Gross,D,NSH,28,0,0,0,0
5,8475625.0,Matt Irwin,D,WSH,36,0,0,0,0
5,8479388.0,Riley Stillman,D,BUF,25,0,0,0,0
5,8474628.0,Michael Stone,D,CGY,33,0,0,0,0
5,8484254.0,Akito Hirose,D,VAN,24,3,0,0,0
5,8477941.0,Nick Ritchie,L,CGY,28,0,0,0,0
5,8477462.0,Robert Hagg,D,ANA,28,5,0,0,0
5,8478062.0,Dysin Mayo,D,ARI,27,0,0,0,0
5,8482634.0,Alex Steeves,C,TOR,24,1,0,0,0
5,8477433.0,Ben Harpur,D,NYR,28,0,0,0,0
5,8478841.0,Colton White,D,ANA,26,0,0,0,0
5,8473544.0,Derick Brassard,C,OTT,36,0,0,0,0
5,8476884.0,Derrick Pouliot,D,SJS,29,5,0,0,0
5,8479376.0,Victor Mete,D,PHI,25,1,0,0,0
5,8483630.0,Pavol Regenda,L,ANA,24,5,0,0,0
5,8479026.0,Philippe Myers,D,TBL,26,5,0,0,0
5,8477482.0,Zach Sanford,L,CHI,29,0,0,0,0
5,8477359.0,Tucker Poolman,D,VAN,30,0,0,0,0
5,8475857.0,Kevin Gravel,D,NSH,31,0,0,0,0
5,8476779.0,Brad Hunt,D,COL,35,0,0,0,0
5,8476850.0,Ryan Murray,D,EDM,30,0,0,0,0
5,8477341.0,Andreas Johnsson,L,SJS,29,0,0,0,0
5,8474218.0,Jason Demers,D,EDM,35,0,0,0,0
5,8480844.0,Grigori Denisenko,L,VGK,23,6,0,0,0
5,8484287.0,Cole McWard,D,VAN,22,1,0,0,0
5,8479322.0,Wade Allison,R,PHI,26,0,0,0,0
5,8478846.0,Christian Wolanin,D,VAN,28,0,0,0,0
5,8471887.0,Patric Hornqvist,R,FLA,36,0,0,0,0
5,8475163.0,Alex Chiasson,R,DET,33,0,0,0,0
5,8478881.0,Brett Seney,L,CHI,27,4,0,0,0
5,8474697.0,Mark Borowiecki,D,NSH,34,0,0,0,0
5,8476410.0,Josh Leivo,L,STL,30,0,0,0,0
5,8475968.0,Alex Belzile,R,MTL,32,0,0,0,0
5,8479580.0,Dylan Gambrell,C,OTT,27,0,0,0,0
5,8480901.0,Karson Kuhlman,C,WPG,28,0,0,0,0
5,8480326.0,Sheldon Dries,C,VAN,29,0,0,0,0
5,8478465.0,Guillaume Brisebois,D,VAN,26,0,0,0,0
5,8482861.0,Vincent Iorio,D,WSH,21,6,0,0,0
5,8471794.0,Darren Helm,C,COL,36,0,0,0,0
5,8479335.0,Rasmus Asplund,C,NSH,26,0,0,0,0
5,8478415.0,Jakub Zboril,D,BOS,26,0,0,0,0
5,8476310.0,Lukas Sedlak,C,PHI,30,0,0,0,0
5,8478075.0,Anders Bjork,L,CHI,27,0,0,0,0
5,8480267.0,Sammy Walker,C,MIN,24,4,0,0,0
5,8479578.0,Casey Fitzgerald,D,FLA,26,0,0,0,0
5,8480032.0,Shane Bowers,C,NJD,24,8,0,0,0
5,8478400.0,Colin White,C,PIT,26,28,0,0,0
5,8478431.0,Evgeny Svechnikov,L,SJS,27,0,0,0,0
5,8475772.0,Riley Sheahan,C,BUF,32,0,0,0,0
5,8481690.0,Tyler Angle,C,CBJ,23,2,0,0,0
5,8476326.0,Josh Archibald,R,PIT,31,0,0,0,0
5,8478843.0,Denis Malgin,C,COL,26,0,0,0,0
5,8478446.0,Glenn Gawdin,C,ANA,26,1,0,0,0
5,8477357.0,Saku Maenalanen,R,WPG,29,0,0,0,0
5,8478870.0,Rudolfs Balcers,L,TBL,26,0,0,0,0
5,8478476.0,Kyle Capobianco,D,WPG,26,0,0,0,0
5,8476439.0,Brett Ritchie,R,ARI,30,0,0,0,0
5,8474613.0,Derek Stepan,C,CAR,33,0,0,0,0
5,8475178.0,Zack Kassian,R,ARI,32,0,0,0,0
5,8480226.0,Marián Studenic,R,SEA,25,2,0,0,0
5,8481070.0,Hugh McGing,L,STL,25,5,0,0,0
5,8482250.0,Callahan Burke,C,CAR,26,1,0,0,0
5,8481591.0,Sam Poulin,R,PIT,22,3,0,0,0
5,8481441.0,Joe Snively,C,WSH,27,3,0,0,0
5,8478967.0,Lane Pederson,C,CBJ,26,0,0,0,0
5,8479333.0,Libor Hajek,D,NYR,25,0,0,0,0
5,8480833.0,Vitali Kravtsov,R,VAN,24,0,0,0,0
5,8477460.0,Laurent Dauphin,C,ARI,28,0,0,0,0
5,8481461.0,Corey Schueneman,D,MTL,28,0,0,0,0
5,8474190.0,Wayne Simmonds,R,TOR,35,0,0,0,0
5,8483549.0,Lucas Condotta,L,MTL,26,3,0,0,0
5,8477993.0,Justin Kirkland,C,ARI,27,2,0,0,0
5,8480935.0,Lawrence Pilut,D,BUF,28,0,0,0,0
5,8477210.0,Buddy Robinson,R,CHI,32,0,0,0,0
5,8476851.0,Alex Galchenyuk,C,COL,29,0,0,0,0
5,8482197.0,Adam Raska,R,MIN,22,5,0,0,0
5,8479366.0,Logan Brown,C,STL,25,0,0,0,0
5,8479356.0,Kieffer Bellows,L,PHI,25,0,0,0,0
5,8479533.0,Joona Koppanen,L,PIT,25,4,0,0,0
5,8477401.0,John Hayden,C,SEA,28,2,0,0,0
5,8480822.0,Martin Kaut,R,SJS,24,0,0,0,0
5,8474610.0,Zac Dalpe,C,FLA,34,0,0,0,0
5,8482399.0,Billy Sweezey,D,CBJ,27,0,0,0,0
5,8479991.0,Jake Leschyshyn,C,NYR,24,1,0,0,0
5,8479550.0,Tanner Laczynski,C,PHI,26,0,0,0,0
5,8476166.0,Taylor Fedun,D,PIT,35,0,0,0,0
5,8479338.0,Markus Niemelainen,D,EDM,25,0,0,0,0
5,8477320.0,Anton Blidh,L,NYR,28,1,0,0,0
5,8478147.0,Bokondji Imama,L,ARI,27,6,0,0,0
5,8478067.0,Oskar Lindblom,L,SJS,27,1,0,0,0
5,8478506.0,Gabriel Carlsson,D,WSH,26,0,0,0,0
5,8478131.0,Ondrej Kase,R,CAR,28,0,0,0,0
5,8479644.0,Matt Luff,R,DET,26,0,0,0,0
5,8482824.0,Nick Cicek,D,SJS,23,0,0,0,0
5,8482834.0,Jesper Froden,R,SEA,29,0,0,0,0
5,8478491.0,Jacob Larsson,D,OTT,26,0,0,0,0
5,8474089.0,Brad Malone,C,EDM,34,0,0,0,0
5,8482641.0,Matt Kiersted,D,FLA,25,0,0,0,0
5,8480071.0,Robin Salo,D,NYI,25,0,0,0,0
5,8475461.0,Andrew Agozzino,L,SJS,32,0,0,0,0
5,8475160.0,Kyle Clifford,L,TOR,32,0,0,0,0
5,8480056.0,Jack Rathbone,D,VAN,24,0,0,0,0
5,8481725.0,Elmer Soderblom,L,DET,22,0,0,0,0
5,8479465.0,Drake Caggiula,L,PIT,29,0,0,0,0
5,8476948.0,Charles Hudon,L,COL,29,0,0,0,0
5,8479523.0,Lucas Carlsson,D,FLA,26,0,0,0,0
5,8478455.0,Austin Wagner,L,CHI,26,0,0,0,0
5,8481572.0,Ville Heinola,D,WPG,22,0,0,0,0
5,8479404.0,Henrik Borgstrom,C,WSH,26,0,0,0,0
5,8479944.0,Zach Aston-Reese,C,DET,29,3,0,0,0
5,8482635.0,Mike Hardman,L,CHI,24,0,0,0,0
5,8479705.0,Jeffrey Viel,L,SJS,26,0,0,0,0
5,8480467.0,Austin Strand,D,ANA,26,0,0,0,0
5,8480037.0,Aleksi Heponiemi,C,FLA,24,0,0,0,0
5,8479573.0,Mikhail Maltsev,L,COL,25,0,0,0,0
5,8476404.0,Andy Andreoff,C,NYI,32,0,0,0,0
5,8484125.0,Hunter McKown,C,CBJ,21,0,0,0,0
5,8481649.0,Joona Luoto,L,CBJ,26,0,0,0,0
5,8477981.0,Roland McKeown,D,NSH,27,0,0,0,0
5,8480831.0,Alec Regula,D,CHI,23,0,0,0,0
5,8482691.0,Aatu Raty,C,VAN,21,0,0,0,0
5,8482623.0,Josh Dunne,C,CBJ,25,0,0,0,0
5,8481433.0,Taro Hirose,L,DET,27,0,0,0,0
5,8480328.0,David Gust,R,CHI,29,0,0,0,0
5,8479526.0,Otto Koivula,L,NYI,25,0,0,0,0
5,8476390.0,Joseph Cramarossa,C,MIN,31,0,0,0,0
5,8482654.0,Jackson Cates,C,PHI,26,0,0,0,0
5,8480439.0,Mac Hollowell,D,TOR,25,0,0,0,0
5,8480072.0,Lias Andersson,C,LAK,25,0,0,0,0
5,8479395.0,Dennis Cholowski,D,NYI,25,0,0,0,0
5,8477463.0,Steven Santini,D,STL,28,0,0,0,0
5,8479347.0,Tyler Benson,L,EDM,25,0,0,0,0
5,8477471.0,Dillon Heatherington,D,OTT,28,0,0,0,0
5,8477520.0,Jean-Sebastien Dea,C,ARI,29,0,0,0,0
5,8480846.0,Sampo Ranta,L,COL,23,0,0,0,0
5,8480979.0,Nathan Smith,C,ARI,25,0,0,0,0
5,8484256.0,Jake Livingstone,D,NSH,24,0,0,0,0
5,8476396.0,Steven Fogarty,C,MIN,30,0,0,0,0
5,8479252.0,Dan Renouf,D,BOS,29,0,0,0,0
5,8479518.0,Fredrik Karlström,C,DAL,25,0,0,0,0
5,8481683.0,Aidan McDonough,L,VAN,24,0,0,0,0
5,8478373.0,Nikita Soshnikov,R,NYI,30,0,0,0,0
5,8482081.0,Sean Farrell,C,MTL,22,0,0,0,0
5,8481575.0,Lassi Thomson,D,OTT,23,0,0,0,0
5,8481102.0,Egor Sokolov,L,OTT,23,0,0,0,0
5,8481712.0,Matej Blumel,R,DAL,23,0,0,0,0
5,8479602.0,Jeremy Davies,D,BUF,27,0,0,0,0
5,8480443.0,Kristian Reichel,C,WPG,25,0,0,0,0
5,8479304.0,Kyle Criscuolo,C,SJS,31,0,0,0,0
5,8478224.0,Luke Philp,C,CHI,28,0,0,0,0
5,8480242.0,Arnaud Durandeau,L,NYI,24,0,0,0,0
5,8479329.0,Frederic Allard,D,MTL,26,0,0,0,0
5,8476941.0,Connor Carrick,D,BOS,29,0,0,0,0
5,8479375.0,William Bitten,C,STL,25,0,0,0,0
5,8481720.0,Nick Abruzzese,C,TOR,24,0,0,0,0
5,8482452.0,Elliot Desnoyers,L,PHI,21,0,0,0,0
5,8476915.0,Jujhar Khaira,L,MIN,29,1,0,0,0
5,8483641.0,Anton Levtchi,L,FLA,28,0,0,0,0
5,8481740.0,Tyce Thompson,R,NJD,24,0,0,0,0
5,8478173.0,Hayden Hodgson,R,PHI,27,0,0,0,0
5,8482181.0,Tristen Robins,C,SJS,22,0,0,0,0
5,8481563.0,Drew Helleson,D,ANA,22,0,0,0,0
5,8480863.0,Gabriel Fortier,L,TBL,23,0,0,0,0
5,8478058.0,CJ Suess,L,SJS,29,0,0,0,0
5,8480041.0,Dmitri Samorukov,D,STL,24,0,0,0,0
5,8482179.0,Justin Richards,C,CBJ,25,0,0,0,0
5,8480034.0,Joel Teasdale,L,MTL,24,0,0,0,0
5,8480820.0,Filip Kral,D,TOR,24,0,0,0,0
5,8480842.0,Filip Hallander,C,PIT,23,0,0,0,0
5,8478367.0,Cole Bardreau,C,NYI,30,0,0,0,0
5,8482448.0,Samuel Knazko,D,CBJ,21,0,0,0,0
5,8482711.0,Stanislav Svozil,D,CBJ,20,0,0,0,0
5,8480275.0,Nick Swaney,R,MIN,26,0,0,0,0
5,8480994.0,Damien Giroux,C,MIN,23,0,0,0,0
5,8480977.0,Semyon Der-Arguchintsev,C,TOR,23,0,0,0,0
5,8482207.0,William Dufour,R,NYI,21,0,0,0,0
5,8483464.0,Marco Kasper,C,DET,19,0,0,0,0
5,8483424.0,Owen Beck,C,MTL,19,0,0,0,0
6,8476453.0,Nikita Kucherov,R,TBL,30,81,44,100,144
6,8477492.0,Nathan MacKinnon,C,COL,28,82,51,89,140
6,8478402.0,Connor McDavid,C,EDM,26,76,32,100,132
6,8478550.0,Artemi Panarin,L,NYR,32,82,49,71,120
6,8477956.0,David Pastrnak,R,BOS,27,82,47,63,110
6,8479318.0,Auston Matthews,C,TOR,26,81,69,38,107
6,8477934.0,Leon Draisaitl,C,EDM,28,81,41,65,106
6,8478420.0,Mikko Rantanen,R,COL,27,80,42,62,104
6,8476468.0,J.T. Miller,C,VAN,30,81,37,66,103
6,8477939.0,William Nylander,R,TOR,27,82,40,58,98
6,8478864.0,Kirill Kaprizov,L,MIN,26,75,46,50,96
6,8477933.0,Sam Reinhart,C,FLA,28,82,57,37,94
6,8476887.0,Filip Forsberg,L,NSH,29,82,48,46,94
6,8471675.0,Sidney Crosby,C,PIT,36,82,42,52,94
6,8480800.0,Quinn Hughes,D,VAN,24,82,17,75,92
6,8478010.0,Brayden Point,C,TBL,27,81,46,44,90
6,8480069.0,Cale Makar,D,COL,25,77,21,69,90
6,8478427.0,Sebastian Aho,C,CAR,26,78,36,53,89
6,8480012.0,Elias Pettersson,C,VAN,25,82,34,55,89
6,8479314.0,Matthew Tkachuk,L,FLA,26,80,26,62,88
6,8480023.0,Robert Thomas,C,STL,24,82,26,60,86
6,8474600.0,Roman Josi,D,NSH,33,82,23,62,85
6,8479407.0,Jesper Bratt,L,NJD,25,82,27,56,83
6,8480803.0,Evan Bouchard,D,EDM,24,81,18,64,82
6,8474564.0,Steven Stamkos,C,TBL,33,79,40,41,81
6,8480027.0,Jason Robertson,L,DAL,24,82,29,51,80
6,8478445.0,Mathew Barzal,C,NYI,26,80,23,57,80
6,8477493.0,Aleksander Barkov,C,FLA,28,73,23,57,80
6,8475786.0,Zach Hyman,L,EDM,31,80,54,23,77
6,8480018.0,Nick Suzuki,C,MTL,24,82,33,44,77
6,8477404.0,Jake Guentzel,L,PIT,29,67,30,47,77
6,8476389.0,Vincent Trocheck,C,NYR,30,82,25,52,77
6,8479343.0,Clayton Keller,R,ARI,25,78,33,43,76
6,8475167.0,Victor Hedman,D,TBL,33,78,13,63,76
6,8475184.0,Chris Kreider,L,NYR,32,82,39,36,75
6,8475172.0,Nazem Kadri,C,CGY,33,82,29,46,75
6,8477960.0,Adrian Kempe,R,LAK,27,77,28,47,75
6,8479542.0,Brandon Hagel,L,TBL,25,82,26,49,75
6,8474679.0,Gustav Nyquist,C,NSH,34,81,23,52,75
6,8480801.0,Brady Tkachuk,L,OTT,24,81,37,37,74
6,8481559.0,Jack Hughes,C,NJD,22,62,27,47,74
6,8478444.0,Brock Boeser,R,VAN,26,81,40,33,73
6,8477942.0,Kevin Fiala,L,LAK,27,82,29,44,73
6,8479323.0,Adam Fox,D,NYR,25,72,17,56,73
6,8477409.0,Carter Verhaeghe,C,FLA,28,76,34,38,72
6,8482078.0,Lucas Raymond,L,DET,21,82,31,41,72
6,8476459.0,Mika Zibanejad,C,NYR,30,81,26,46,72
6,8476460.0,Mark Scheifele,C,WPG,30,74,25,47,72
6,8471685.0,Anze Kopitar,C,LAK,36,81,26,44,70
6,8482116.0,Tim Stützle,C,OTT,21,75,18,52,70
6,8480865.0,Noah Dobson,D,NYI,23,79,10,60,70
6,8476539.0,Jonathan Marchessault,R,VGK,33,82,42,27,69
6,8475754.0,Brock Nelson,C,NYI,32,82,34,35,69
6,8477946.0,Dylan Larkin,C,DET,27,68,33,36,69
6,8475158.0,Ryan O'Reilly,C,NSH,32,82,26,43,69
6,8477504.0,Josh Morrissey,D,WPG,28,81,10,59,69
6,8478439.0,Travis Konecny,R,PHI,26,76,33,35,68
6,8477500.0,Bo Horvat,C,NYI,28,81,33,35,68
6,8478403.0,Jack Eichel,C,VGK,27,63,31,37,68
6,8481557.0,Matt Boldy,L,MIN,22,75,29,39,68
6,8482093.0,Seth Jarvis,C,CAR,21,81,33,34,67
6,8479385.0,Jordan Kyrou,C,STL,25,82,31,36,67
6,8473419.0,Brad Marchand,L,BOS,35,82,29,38,67
6,8480002.0,Nico Hischier,C,NJD,24,71,27,40,67
6,8471215.0,Evgeni Malkin,C,PIT,37,82,27,40,67
6,8478440.0,Dylan Strome,C,WSH,26,82,27,40,67
6,8479337.0,Alex DeBrincat,R,DET,26,82,27,40,67
6,8470794.0,Joe Pavelski,C,DAL,39,82,27,40,67
6,8476454.0,Ryan Nugent-Hopkins,C,EDM,30,80,18,49,67
6,8480208.0,Drake Batherson,R,OTT,25,82,28,38,66
6,8482740.0,Wyatt Johnston,C,DAL,20,82,32,33,65
6,8471214.0,Alex Ovechkin,L,WSH,38,79,31,34,65
6,8478449.0,Roope Hintz,C,DAL,27,80,30,35,65
6,8475166.0,John Tavares,C,TOR,33,80,29,36,65
6,8481540.0,Cole Caufield,R,MTL,22,82,28,37,65
6,8475168.0,Matt Duchene,C,DAL,32,80,25,40,65
6,8478493.0,Joel Eriksson Ek,C,MIN,26,77,30,34,64
6,8473512.0,Claude Giroux,R,OTT,35,82,21,43,64
6,8477402.0,Pavel Buchnevich,L,STL,28,80,27,36,63
6,8475692.0,Mats Zuccarello,R,MIN,36,69,12,51,63
6,8477955.0,Jared McCann,L,SEA,27,80,29,33,62
6,8476875.0,Mike Matheson,D,MTL,29,82,11,51,62
6,8478398.0,Kyle Connor,L,WPG,27,65,34,27,61
6,8477940.0,Nikolaj Ehlers,L,WPG,27,82,25,36,61
6,8477951.0,Nick Schmaltz,C,ARI,27,79,22,39,61
6,8478366.0,Frank Vatrano,R,ANA,29,82,37,23,60
6,8476448.0,William Karlsson,C,VGK,30,70,30,30,60
6,8475745.0,Charlie Coyle,C,BOS,31,82,25,35,60
6,8473994.0,Jamie Benn,L,DAL,34,82,21,39,60
6,8475798.0,Mikael Granlund,C,SJS,31,69,12,48,60
6,8476346.0,Johnny Gaudreau,L,CBJ,30,81,12,48,60
6,8481068.0,Yegor Sharangovich,C,CGY,25,82,31,28,59
6,8477497.0,Sean Monahan,C,WPG,29,83,26,33,59
6,8477949.0,Alex Tuch,R,BUF,27,75,22,37,59
6,8478401.0,Pavel Zacha,C,BOS,26,78,21,38,59
6,8480839.0,Rasmus Dahlin,D,BUF,23,81,20,39,59
6,8477416.0,Oliver Bjorkstrand,R,SEA,28,82,20,39,59
6,8476853.0,Morgan Rielly,D,TOR,29,72,7,51,58
6,8479675.0,Trevor Moore,L,LAK,28,82,31,26,57
6,8482109.0,Alexis Lafrenière,L,NYR,22,82,28,29,57
6,8479999.0,Casey Mittelstadt,C,BUF,25,80,18,39,57
6,8481711.0,Matias Maccelli,L,ARI,23,82,17,40,57
6,8478460.0,Zach Werenski,D,CBJ,26,70,11,46,57
6,8479420.0,Tage Thompson,C,BUF,26,71,29,27,56
6,8475810.0,Bryan Rust,R,PIT,31,62,28,28,56
6,8477494.0,Jonathan Drouin,L,COL,28,79,19,37,56
6,8474578.0,Erik Karlsson,D,PIT,33,82,11,45,56
6,8476906.0,Shayne Gostisbehere,D,DET,30,81,10,46,56
6,8475726.0,Tyler Toffoli,R,NJD,31,79,33,22,55
6,8475765.0,Vladimir Tarasenko,R,OTT,32,76,23,32,55
6,8482124.0,Quinton Byfield,R,LAK,21,80,20,35,55
6,8478047.0,Michael Bunting,L,CAR,28,81,19,36,55
6,8475151.0,Kyle Palmieri,C,NYI,32,82,30,24,54
6,8476399.0,Blake Coleman,C,CGY,32,78,30,24,54
6,8478873.0,Troy Terry,R,ANA,26,76,20,34,54
6,8480798.0,Philipp Kurashev,C,CHI,24,75,18,36,54
6,8480036.0,Miro Heiskanen,D,DAL,24,71,9,45,54
6,8477501.0,Valeri Nichushkin,R,COL,28,54,28,25,53
6,8480015.0,Owen Tippett,R,PHI,24,78,28,25,53
6,8476882.0,Teuvo Teravainen,L,CAR,29,76,25,28,53
6,8480039.0,Martin Necas,C,CAR,24,77,24,29,53
6,8478975.0,Mason Marchment,L,DAL,28,81,22,31,53
6,8475913.0,Mark Stone,R,VGK,31,56,16,37,53
6,8478414.0,Timo Meier,R,NJD,27,69,28,24,52
6,8475794.0,Tyler Seguin,C,DAL,31,68,25,27,52
6,8477346.0,MacKenzie Weegar,D,CGY,29,82,20,32,52
6,8480830.0,Andrei Svechnikov,R,CAR,23,59,19,33,52
6,8476456.0,Jonathan Huberdeau,C,CGY,30,81,12,40,52
6,8474590.0,John Carlson,D,WSH,33,82,10,42,52
6,8474641.0,Adam Henrique,C,ANA,33,82,24,27,51
6,8476905.0,Chandler Stephenson,C,VGK,29,75,16,35,51
6,8471724.0,Kris Letang,D,PIT,36,82,10,41,51
6,8482175.0,JJ Peterka,R,BUF,21,82,28,22,50
6,8480797.0,Joel Farabee,L,PHI,23,82,22,28,50
6,8483515.0,Juraj Slafkovsky,L,MTL,19,82,20,30,50
6,8474563.0,Drew Doughty,D,LAK,34,82,15,35,50
6,8478038.0,Devon Toews,D,COL,29,82,12,38,50
6,8477456.0,J.T. Compher,L,DET,28,77,19,29,48
6,8479425.0,Filip Hronek,D,VAN,26,81,5,43,48
6,8474141.0,Patrick Kane,R,DET,35,50,20,27,47
6,8478856.0,Conor Garland,R,VAN,27,82,20,27,47
6,8481528.0,Dylan Cozens,C,BUF,22,79,18,29,47
6,8476479.0,Phillip Danault,C,LAK,30,78,17,30,47
6,8474102.0,David Perron,L,DET,35,76,17,30,47
6,8481581.0,Thomas Harley,D,DAL,22,79,15,32,47
6,8478396.0,Noah Hanifin,D,CGY,26,80,13,34,47
6,8476869.0,Brady Skjei,D,CAR,29,80,13,34,47
6,8479325.0,Charlie McAvoy,D,BOS,26,74,12,35,47
6,8482684.0,Luke Hughes,D,NJD,20,82,9,38,47
6,8477503.0,Max Domi,C,TOR,28,80,9,38,47
6,8482122.0,Brock Faber,D,MIN,21,82,8,39,47
6,8477426.0,Nicholas Paul,L,TBL,28,82,24,22,46
6,8475784.0,Jeff Skinner,L,BUF,31,74,24,22,46
6,8483808.0,Andrei Kuzmenko,L,CGY,27,72,22,24,46
6,8475170.0,Brayden Schenn,C,STL,32,82,20,26,46
6,8478407.0,Vince Dunn,D,SEA,27,59,11,35,46
6,8475760.0,Nick Bjugstad,C,ARI,31,76,22,23,45
6,8477451.0,Ryan Hartman,R,MIN,29,74,21,24,45
6,8478519.0,Anthony Cirelli,C,TBL,26,79,20,25,45
6,8477964.0,Ivan Barbashev,C,VGK,28,82,19,26,45
6,8478438.0,Tommy Novak,C,NSH,26,71,18,27,45
6,8482667.0,William Eklund,L,SJS,21,80,16,29,45
6,8477021.0,Alex Kerfoot,C,ARI,29,82,13,32,45
6,8475218.0,Mattias Ekholm,D,EDM,33,79,11,34,45
6,8480188.0,Fabian Zetterlund,L,SJS,24,82,24,20,44
6,8475169.0,Evander Kane,L,EDM,32,77,24,20,44
6,8477511.0,Anthony Mantha,R,WSH,29,74,23,21,44
6,8474586.0,Jordan Eberle,R,SEA,33,78,17,27,44
6,8477496.0,Elias Lindholm,C,VAN,29,75,15,29,44
6,8477948.0,Travis Sanheim,D,PHI,27,81,10,34,44
6,8477479.0,Tyler Bertuzzi,L,TOR,28,80,21,22,43
6,8478466.0,Daniel Sprong,R,DET,26,76,18,25,43
6,8470613.0,Brent Burns,D,CAR,38,82,10,33,43
6,8476438.0,Brandon Saad,L,STL,31,82,26,16,42
6,8477407.0,Anthony Duclair,L,SJS,28,73,24,18,42
6,8478474.0,Lawson Crouse,L,ARI,26,81,23,19,42
6,8480893.0,Kirill Marchenko,R,CBJ,23,78,23,19,42
6,8482745.0,Mason McTavish,C,ANA,20,64,19,23,42
6,8481542.0,Moritz Seider,D,DET,22,82,9,33,42
6,8477447.0,Shea Theodore,D,VGK,28,47,5,37,42
6,8477935.0,Sam Bennett,C,FLA,27,69,20,21,41
6,8477998.0,Warren Foegele,L,EDM,27,82,20,21,41
6,8480009.0,Eeli Tolvanen,R,SEA,24,81,16,25,41
6,8479345.0,Jakob Chychrun,D,OTT,25,82,14,27,41
6,8480028.0,Morgan Frost,C,PHI,24,71,13,28,41
6,8478462.0,Nicolas Roy,C,VGK,26,70,13,28,41
6,8476458.0,Ryan Strome,C,ANA,30,79,11,30,41
6,8480434.0,Sean Durzi,D,ARI,25,76,9,32,41
6,8482079.0,Marco Rossi,C,MIN,22,82,21,19,40
6,8478498.0,Jake DeBrusk,L,BOS,27,80,19,21,40
6,8479365.0,Trent Frederic,C,BOS,25,82,18,22,40
6,8479525.0,Ross Colton,C,COL,27,80,17,23,40
6,8479400.0,Pierre-Luc Dubois,C,LAK,25,82,16,24,40
6,8478233.0,Andrew Mangiapane,L,CGY,27,75,14,26,40
6,8475191.0,Reilly Smith,R,PIT,32,76,13,27,40
6,8479987.0,Morgan Geekie,C,BOS,25,76,17,22,39
6,8482146.0,Luke Evangelista,R,NSH,21,80,16,23,39
6,8474150.0,Mikael Backlund,C,CGY,34,82,15,24,39
6,8476872.0,Scott Laughton,C,PHI,29,82,13,26,39
6,8478542.0,Evan Rodrigues,C,FLA,30,80,12,27,39
6,8478055.0,Gustav Forsling,D,FLA,27,79,10,29,39
6,8478397.0,Rasmus Andersson,D,CGY,27,78,9,30,39
6,8475764.0,Cam Fowler,D,ANA,32,81,5,34,39
6,8476792.0,Torey Krug,D,STL,32,77,4,35,39
6,8482089.0,Jake Neighbours,L,STL,21,77,27,11,38
6,8482149.0,Cole Perfetti,C,WPG,21,71,19,19,38
6,8476881.0,Tomas Hertl,C,SJS,30,54,17,21,38
6,8474037.0,James van Riemsdyk,L,BOS,34,71,11,27,38
6,8482105.0,Jake Sanderson,D,OTT,21,79,10,28,38
6,8475314.0,Anders Lee,L,NYI,33,81,20,17,37
6,8473422.0,Nick Foligno,L,CHI,36,74,17,20,37
6,8482665.0,Matty Beniers,C,SEA,21,77,15,22,37
6,8476483.0,Rickard Rakell,R,PIT,30,70,15,22,37
6,8476474.0,Stefan Noesen,R,CAR,30,81,14,23,37
6,8476480.0,Vladislav Namestnikov,C,WPG,31,78,11,26,37
6,8476958.0,Jaccob Slavin,D,CAR,29,81,6,31,37
6,8481535.0,Nils Hoglander,L,VAN,23,80,24,12,36
6,8480014.0,Gabriel Vilardi,C,WPG,24,47,22,14,36
6,8473986.0,Alex Killorn,L,ANA,34,63,18,18,36
6,8478046.0,Danton Heinen,L,BOS,28,74,17,19,36
6,8478891.0,Mason Appleton,C,WPG,27,82,14,22,36
6,8476432.0,Boone Jenner,C,CBJ,30,58,22,13,35
6,8477450.0,Jason Dickinson,C,CHI,28,82,22,13,35
6,8476880.0,Tom Wilson,R,WSH,29,74,18,17,35
6,8482699.0,Dylan Guenther,R,ARI,20,45,18,17,35
6,8475287.0,Erik Haula,L,NJD,32,76,16,19,35
6,8476925.0,Colton Sissons,C,NSH,30,81,15,20,35
6,8482720.0,Matthew Knies,L,TOR,21,80,15,20,35
6,8482113.0,Anton Lundell,C,FLA,22,78,13,22,35
6,8476392.0,Adam Lowry,C,WPG,30,81,12,23,35
6,8478472.0,Mathieu Joseph,R,OTT,26,72,11,24,35
6,8475799.0,Nino Niederreiter,R,WPG,31,77,18,16,34
6,8477476.0,Artturi Lehkonen,L,COL,28,45,16,18,34
6,8481618.0,Alex Newhook,C,MTL,22,55,15,19,34
6,8482159.0,Tyson Foerster,R,PHI,21,77,20,13,33
6,8482110.0,Dawson Mercer,C,NJD,22,82,20,13,33
6,8481580.0,Connor McMichael,C,WSH,22,80,18,15,33
6,8482055.0,Drew O'Connor,L,PIT,25,79,16,17,33
6,8477429.0,Andrew Copp,C,DET,29,79,13,20,33
6,8479992.0,Michael Rasmussen,C,DET,24,75,13,20,33
6,8476826.0,Yanni Gourde,C,SEA,32,80,11,22,33
6,8476419.0,Jean-Gabriel Pageau,C,NYI,31,82,11,22,33
6,8477986.0,Brandon Montour,D,FLA,29,66,8,25,33
6,8482671.0,Owen Power,D,BUF,21,76,6,27,33
6,8478178.0,Darren Raddysh,D,TBL,27,82,6,27,33
6,8480145.0,Neal Pionk,D,WPG,28,82,5,28,33
6,8474565.0,Alex Pietrangelo,D,VGK,33,64,4,29,33
6,8478057.0,Dakota Joshua,C,VAN,27,63,18,14,32
6,8477952.0,Robby Fabbri,C,DET,27,68,18,14,32
6,8476921.0,Jordan Martinook,L,CAR,31,82,14,18,32
6,8475722.0,Jason Zucker,L,ARI,31,69,14,18,32
6,8482705.0,Cole Sillinger,C,CBJ,20,77,13,19,32
6,8477498.0,Darnell Nurse,D,EDM,28,81,10,22,32
6,8475171.0,Oliver Ekman-Larsson,D,FLA,32,80,9,23,32
6,8478500.0,Ivan Provorov,D,CBJ,26,82,5,27,32
6,8474151.0,Ryan McDonagh,D,NSH,34,74,3,29,32
6,8474870.0,Tyler Johnson,C,CHI,33,67,17,14,31
6,8475848.0,Brendan Gallagher,R,MTL,31,77,16,15,31
6,8474189.0,Lars Eller,C,PIT,34,82,15,16,31
6,8476292.0,Ondrej Palat,L,NJD,32,71,11,20,31
6,8481624.0,Ilya Mikheyev,R,VAN,29,78,11,20,31
6,8478458.0,Jack Roslovic,C,CBJ,26,59,9,22,31
6,8477495.0,Seth Jones,D,CHI,29,67,8,23,31
6,8476979.0,Erik Gustafsson,D,NYR,31,76,6,25,31
6,8476331.0,Dylan DeMelo,D,WPG,30,82,3,28,31
6,8480064.0,Josh Norris,C,OTT,24,50,16,14,30
6,8475768.0,Jaden Schwartz,C,SEA,31,62,13,17,30
6,8480802.0,Ryan McLeod,C,EDM,24,81,12,18,30
6,8477987.0,Ryan Donato,C,CHI,27,78,12,18,30
6,8475149.0,Marcus Johansson,L,MIN,33,78,11,19,30
6,8481546.0,Cam York,D,PHI,22,82,10,20,30
6,8477505.0,Alex Wennberg,C,SEA,29,79,10,20,30
6,8473533.0,Jordan Staal,C,CAR,35,80,10,20,30
6,8478469.0,Thomas Chabot,D,OTT,26,51,9,21,30
6,8480817.0,K'Andre Miller,D,NYR,23,80,8,22,30
6,8477969.0,Marcus Pettersson,D,PIT,27,82,4,26,30
6,8475753.0,Justin Faulk,D,STL,31,60,2,28,30
6,8479619.0,Michael Carcone,L,ARI,27,74,21,8,29
6,8482475.0,Yegor Chinakhov,R,CBJ,22,53,16,13,29
6,8480459.0,Pius Suter,C,VAN,27,67,14,15,29
6,8475763.0,Kevin Hayes,R,STL,31,79,13,16,29
6,8481524.0,Bowen  Byram,D,COL,22,73,11,18,29
6,8480336.0,Sean Walker,D,PHI,29,81,10,19,29
6,8481656.0,Aliaksei Protas,C,WSH,22,78,6,23,29
6,8474574.0,Tyler Myers,D,VAN,33,77,5,24,29
6,8482125.0,Alexander Holtz,R,NJD,21,82,16,12,28
6,8480813.0,Joe Veleno,C,DET,23,80,12,16,28
6,8480068.0,Ryan Poehling,C,PHI,24,77,11,17,28
6,8478413.0,Jordan Greenway,L,BUF,26,67,10,18,28
6,8478115.0,Pierre Engvall,L,NYI,27,74,10,18,28
6,8476923.0,Damon Severson,D,CBJ,29,67,9,19,28
6,8476931.0,Jake McCabe,D,TOR,30,73,8,20,28
6,8478133.0,Jake Evans,C,MTL,27,82,7,21,28
6,8476927.0,Teddy Blueger,C,VAN,29,68,6,22,28
6,8475181.0,Nick Leddy,D,STL,32,82,3,25,28
6,8478020.0,Michael Amadio,R,VGK,27,73,14,13,27
6,8481582.0,Nicholas Robertson,L,TOR,22,56,14,13,27
6,8480185.0,Eetu Luostarinen,C,FLA,25,82,12,15,27
6,8480829.0,Jesperi Kotkaniemi,C,CAR,23,79,12,15,27
6,8480113.0,Alex Iafallo,L,WPG,30,82,11,16,27
6,8480748.0,Kiefer Sherwood,L,NSH,28,68,10,17,27
6,8481596.0,Shane Pinto,C,OTT,23,41,9,18,27
6,8480835.0,Jack Drury,C,CAR,23,74,8,19,27
6,8476463.0,Jonas Brodin,D,MIN,30,62,7,20,27
6,8482092.0,Ridly Greig,C,OTT,21,72,13,13,26
6,8476918.0,Jimmy Vesey,L,NYR,30,80,13,13,26
6,8476892.0,Colton Parayko,D,STL,30,82,10,16,26
6,8479941.0,Justin Danforth,R,CBJ,30,71,10,16,26
6,8477425.0,Miles Wood,L,COL,28,74,9,17,26
6,8480855.0,Jack McBain,C,ARI,23,67,8,18,26
6,8474602.0,Justin Schultz,D,SEA,33,70,7,19,26
6,8475790.0,Erik Gudbranson,D,CBJ,31,78,6,20,26
6,8475200.0,Dmitry Orlov,D,CAR,32,82,6,20,26
6,8482655.0,J.J. Moser,D,ARI,23,80,5,21,26
6,8476902.0,Esa Lindell,D,DAL,29,82,5,21,26
6,8475188.0,Brayden McNabb,D,VGK,32,82,4,22,26
6,8476854.0,Hampus Lindholm,D,BOS,29,73,3,23,26
6,8474673.0,TJ Brodie,D,TOR,33,78,1,25,26
6,8476469.0,Joel Armia,R,MTL,30,66,17,8,25
6,8481601.0,Simon Holmstrom,R,NYI,22,75,15,10,25
6,8481186.0,Logan O'Connor,R,COL,27,57,13,12,25
6,8471698.0,T.J. Oshie,R,WSH,37,52,12,13,25
6,8479591.0,Michael Eyssimont,C,TBL,27,81,11,14,25
6,8476312.0,Josh Manson,D,COL,32,76,8,17,25
6,8478136.0,Jake Middleton,D,MIN,27,80,7,18,25
6,8481032.0,Paul Cotter,C,VGK,24,76,7,18,25
6,8477508.0,Curtis Lazar,C,NJD,28,71,7,18,25
6,8482245.0,Artem Zub,D,OTT,28,69,5,20,25
6,8478911.0,Matt Roy,D,LAK,28,81,5,20,25
6,8476879.0,Cody Ceci,D,EDM,30,79,5,20,25
6,8478507.0,John Marino,D,NJD,26,75,4,21,25
6,8478840.0,Will Borgen,D,SEA,27,82,3,22,25
6,8482259.0,Bobby McMann,C,TOR,27,56,15,9,24
6,8481604.0,Pavel Dorofeyev,L,VGK,23,47,13,11,24
6,8478043.0,Sam Lafferty,C,VAN,28,79,13,11,24
6,8479351.0,Sam Steel,C,DAL,25,77,9,15,24
6,8475193.0,Tomas Tatar,L,SEA,33,70,9,15,24
6,8475744.0,Evgeny Kuznetsov,C,WSH,31,63,8,16,24
6,8475233.0,David Savard,D,MTL,33,60,6,18,24
6,8476422.0,Mike Reilly,D,NYI,30,61,6,18,24
6,8474031.0,Kevin Shattenkirk,D,BOS,34,61,6,18,24
6,8473507.0,Jeff Petry,D,DET,36,73,3,21,24
6,8480246.0,Nick Perbix,D,TBL,25,77,2,22,24
6,8481606.0,Jordan Spence,D,LAK,22,71,2,22,24
6,8477947.0,Sonny Milano,L,WSH,27,49,15,8,23
6,8475793.0,Ryan Johansen,C,COL,31,63,13,10,23
6,8480821.0,Filip Zadina,R,SJS,24,72,13,10,23
6,8474149.0,Evgenii Dadonov,R,DAL,34,51,12,11,23
6,8475231.0,Casey Cizikas,C,NYI,32,70,10,13,23
6,8474884.0,Mike Hoffman,C,SJS,34,66,10,13,23
6,8482062.0,Cole Smith,L,NSH,28,80,9,14,23
6,8478882.0,Vladislav Gavrikov,D,LAK,28,77,6,17,23
6,8474157.0,Max Pacioretty,L,WSH,35,47,4,19,23
6,8480873.0,Rasmus Sandin,D,WSH,23,68,3,20,23
6,8480043.0,Timothy Liljegren,D,TOR,24,55,3,20,23
6,8475343.0,Nic Dowd,C,WSH,33,64,12,10,22
6,8470621.0,Corey Perry,R,EDM,38,54,12,10,22
6,8473449.0,Kyle Okposo,R,BUF,35,67,12,10,22
6,8477446.0,Michael McCarron,R,NSH,28,70,12,10,22
6,8481517.0,Brett Leason,R,ANA,24,68,11,11,22
6,8478970.0,Jalen Chatfield,D,CAR,27,72,8,14,22
6,8481014.0,Alexander Romanov,D,NYI,23,81,7,15,22
6,8482087.0,Kaiden Guhle,D,MTL,21,70,6,16,22
6,8477953.0,Kasperi Kapanen,R,STL,27,73,6,16,22
6,8476885.0,Jacob Trouba,D,NYR,29,69,3,19,22
6,8480281.0,Alexey Toropchenko,R,STL,24,82,14,7,21
6,8482157.0,Will Cuylle,L,NYR,21,81,13,8,21
6,8478013.0,Jake Walman,D,DET,27,63,12,9,21
6,8475714.0,Calle Jarnkrok,C,TOR,32,52,10,11,21
6,8475220.0,Marcus Foligno,L,MIN,32,55,9,12,21
6,8471218.0,Blake Wheeler,R,NYR,37,54,9,12,21
6,8479359.0,Beck Malenstyn,L,WSH,25,81,6,15,21
6,8476897.0,Oskar Sundqvist,C,STL,29,71,6,15,21
6,8481178.0,Egor Zamula,D,PHI,23,66,5,16,21
6,8480891.0,Michael Kesselring,D,ARI,23,65,5,16,21
6,8479983.0,Mario Ferraro,D,SJS,25,78,3,18,21
6,8475225.0,Craig Smith,C,DAL,34,75,11,9,20
6,8476981.0,Josh Anderson,R,MTL,29,78,9,11,20
6,8475455.0,Brenden Dillon,D,WPG,33,77,8,12,20
6,8481577.0,Philip Tomasino,C,NSH,22,41,7,13,20
6,8477507.0,Nikita Zadorov,D,VAN,28,75,6,14,20
6,8475279.0,Ben Chiarot,D,DET,32,77,5,15,20
6,8478851.0,Alexandre Carrier,D,NSH,27,73,4,16,20
6,8480035.0,Henri Jokiharju,D,BUF,24,74,3,17,20
6,8480073.0,Erik Brannstrom,D,OTT,24,76,3,17,20
6,8475179.0,Dmitry Kulikov,D,FLA,33,76,1,19,20
6,8481554.0,Kaapo Kakko,R,NYR,22,61,13,6,19
6,8480980.0,Connor Dewar,C,MIN,24,74,11,8,19
6,8479415.0,Michael McLeod,C,NJD,25,45,10,9,19
6,8482097.0,Jack Quinn,R,BUF,22,27,9,10,19
6,8480144.0,David Kampf,C,TOR,28,78,8,11,19
6,8479353.0,Brett Howden,C,VGK,25,72,8,11,19
6,8475164.0,Jakob Silfverberg,R,ANA,33,81,7,12,19
6,8476889.0,Radek Faksa,C,DAL,29,74,7,12,19
6,8473504.0,Cal Clutterbuck,R,NYI,36,82,7,12,19
6,8475855.0,Jesper Fast,R,CAR,32,73,6,13,19
6,8477380.0,Jonny Brodzinski,C,NYR,30,57,6,13,19
6,8471699.0,Andrew Cogliano,C,COL,36,75,6,13,19
6,8477506.0,Ryan Pulock,D,NYI,29,58,5,14,19
6,8480172.0,Jan Rutta,D,SJS,33,69,5,14,19
6,8482073.0,Braden Schneider,D,NYR,22,82,5,14,19
6,8478432.0,Christian Fischer,R,DET,26,79,5,14,19
6,8479410.0,Mikhail Sergachev,D,TBL,25,34,2,17,19
6,8475690.0,Chris Tanev,D,CGY,34,75,2,17,19
6,8480878.0,Nils Lundkvist,D,DAL,23,59,2,17,19
6,8479316.0,Luke Kunin,C,SJS,26,77,11,7,18
6,8480289.0,Morgan Barron,C,WPG,25,80,11,7,18
6,8476374.0,Sean Kuraly,C,CBJ,30,62,9,9,18
6,8480448.0,Parker Kelly,L,OTT,24,80,8,10,18
6,8478434.0,Keegan Kolesar,R,VGK,26,79,8,10,18
6,8475462.0,Radko Gudas,D,ANA,33,66,6,12,18
6,8480220.0,Noah Cates,L,PHI,24,59,6,12,18
6,8476457.0,Adam Larsson,D,SEA,31,81,4,14,18
6,8477932.0,Aaron Ekblad,D,FLA,27,51,4,14,18
6,8477365.0,Connor Clifton,D,BUF,28,79,4,14,18
6,8476874.0,Olli Maatta,D,DET,29,72,4,14,18
6,8479398.0,Samuel Girard,D,COL,25,59,3,15,18
6,8479998.0,Mikey Anderson,D,LAK,24,74,2,16,18
6,8480049.0,Dylan Samberg,D,WPG,24,78,1,17,18
6,8478508.0,Yakov Trenin,C,NSH,26,76,12,5,17
6,8477903.0,Garnet Hathaway,R,PHI,32,82,7,10,17
6,8480995.0,Pontus Holmberg,R,TOR,24,54,7,10,17
6,8479315.0,Joey Anderson,R,CHI,25,55,5,12,17
6,8478463.0,Anthony Beauvillier,L,CHI,26,60,5,12,17
6,8474166.0,Alec Martinez,D,VGK,36,55,4,13,17
6,8481522.0,Peyton Krebs,C,BUF,22,80,4,13,17
6,8478859.0,Niko Mikkola,D,FLA,27,82,3,14,17
6,8479324.0,Ryan Lindgren,D,NYR,25,76,3,14,17
6,8481605.0,Jackson LaCombe,D,ANA,22,71,2,15,17
6,8479976.0,Juuso Valimaki,D,ARI,25,68,2,15,17
6,8470600.0,Ryan Suter,D,DAL,38,82,2,15,17
6,8480884.0,Calen Addison,D,SJS,23,72,1,16,17
6,8475842.0,Sam Carrick,C,ANA,31,77,10,6,16
6,8479977.0,Kailer Yamamoto,R,SEA,25,59,8,8,16
6,8473453.0,Trevor Lewis,C,LAK,36,82,8,8,16
6,8480205.0,Emil Bemstrom,R,CBJ,24,56,8,8,16
6,8479293.0,Brandon Tanev,L,SEA,32,66,7,9,16
6,8477444.0,Andre Burakovsky,L,SEA,28,49,7,9,16
6,8475208.0,Brian Dumoulin,D,SEA,32,80,6,10,16
6,8482660.0,Kent Johnson,C,CBJ,21,42,6,10,16
6,8477979.0,Nicolas Aube-Kubel,R,WSH,27,60,6,10,16
6,8476462.0,Dougie Hamilton,D,NJD,30,20,5,11,16
6,8482117.0,Lukas Reichel,L,CHI,21,65,5,11,16
6,8474034.0,Pat Maroon,L,MIN,35,51,4,12,16
6,8480796.0,Martin Fehervary,D,WSH,24,66,3,13,16
6,8476967.0,Brett Kulak,D,EDM,29,82,3,13,16
6,8471677.0,Jack Johnson,D,COL,36,80,3,13,16
6,8481568.0,Alex Vlasic,D,CHI,22,76,2,14,16
6,8476917.0,Adam Pelech,D,NYI,29,58,1,15,16
6,8479423.0,Alex Nylander,L,PIT,25,28,11,4,15
6,8478831.0,Kevin Stenlund,C,FLA,27,81,11,4,15
6,8470604.0,Jeff Carter,C,PIT,38,72,11,4,15
6,8477330.0,Dominik Kubalik,L,OTT,28,74,11,4,15
6,8476873.0,Mark Jankowski,C,NSH,29,32,7,8,15
6,8476393.0,Nick Cousins,C,FLA,30,69,7,8,15
6,8481560.0,Arthur Kaliyev,R,LAK,22,51,7,8,15
6,8481481.0,Blake Lizotte,C,LAK,26,62,7,8,15
6,8478109.0,Victor Olofsson,L,BUF,28,51,7,8,15
6,8481533.0,Trevor Zegras,C,ANA,22,31,6,9,15
6,8478042.0,Viktor Arvidsson,R,LAK,30,18,6,9,15
6,8474090.0,Brendan Smith,D,NJD,34,63,5,10,15
6,8477919.0,Frederick Gaudreau,C,MIN,30,67,5,10,15
6,8479368.0,Max Jones,L,ANA,25,52,5,10,15
6,8477839.0,Conor Sheary,L,TBL,31,57,4,11,15
6,8476467.0,Jamie Oleksiak,D,SEA,31,82,2,13,15
6,8475197.0,Tyson Barrie,D,NSH,32,41,1,14,15
6,8476878.0,Zemgus Girgensons,L,BUF,29,63,8,6,14
6,8480011.0,Klim Kostin,C,DET,24,52,8,6,14
6,8479661.0,Tanner Jeannot,L,TBL,26,55,7,7,14
6,8478468.0,Jeremy Lauzon,D,NSH,26,79,6,8,14
6,8480003.0,Jesper Boqvist,C,BOS,25,47,6,8,14
6,8479390.0,Taylor Raddysh,R,CHI,25,73,5,9,14
6,8477070.0,Liam O'Brien,C,ARI,29,75,5,9,14
6,8478443.0,Brandon Carlo,D,BOS,27,76,4,10,14
6,8480879.0,Jacob Bernard-Docker,D,OTT,23,72,4,10,14
6,8477392.0,Hudson Fasching,R,NYI,28,45,4,10,14
6,8477435.0,Ryan Graves,D,PIT,28,70,3,11,14
6,8474567.0,Zach Bogosian,D,MIN,33,65,3,11,14
6,8480887.0,Jordan Harris,D,MTL,23,56,3,11,14
6,8480727.0,Zach Whitecloud,D,VGK,27,61,2,12,14
6,8477220.0,Nate Schmidt,D,WPG,32,63,2,12,14
6,8475324.0,Nick Jensen,D,WSH,33,78,1,13,14
6,8480001.0,Urho Vaakanainen,D,ANA,24,68,1,13,14
6,8477845.0,Trevor van Riemsdyk,D,WSH,32,70,0,14,14
6,8482111.0,Justin Barron,D,MTL,22,48,7,6,13
6,8479383.0,Boris Katchouk,L,CHI,25,59,7,6,13
6,8477573.0,Nathan Walker,L,STL,29,45,7,6,13
6,8480192.0,Johnathan Kovacevic,D,MTL,26,62,6,7,13
6,8479996.0,Cody Glass,C,NSH,24,41,6,7,13
6,8481477.0,Nico Sturm,C,SJS,28,63,5,8,13
6,8476871.0,Tanner Pearson,L,MTL,31,54,5,8,13
6,8479520.0,Brandon Duhaime,R,MIN,26,80,5,8,13
6,8479402.0,Jake Bean,D,CBJ,25,72,4,9,13
6,8482222.0,Alexander Barabanov,L,SJS,29,46,4,9,13
6,8477488.0,Brett Pesce,D,CAR,29,70,3,10,13
6,8479371.0,Dante Fabbro,D,NSH,25,56,3,10,13
6,8478416.0,Erik Cernak,D,TBL,26,69,2,11,13
6,8476372.0,Nick Seeler,D,PHI,30,71,1,12,13
6,8481704.0,Juuso Parssinen,C,NSH,22,44,8,4,12
6,8476278.0,Colin Blackwell,C,CHI,30,44,8,4,12
6,8479336.0,Carl Grundstrom,R,LAK,26,50,8,4,12
6,8471709.0,Marc-Edouard Vlasic,D,SJS,36,57,6,6,12
6,8479393.0,Noah Gregor,C,TOR,25,63,6,6,12
6,8478421.0,A.J. Greer,L,CGY,27,59,6,6,12
6,8479671.0,Mathieu Olivier,R,CBJ,26,54,5,7,12
6,8477846.0,Ryan Carpenter,C,SJS,32,62,5,7,12
6,8478585.0,Derek Ryan,C,EDM,37,70,5,7,12
6,8479414.0,Nathan Bastian,R,NJD,26,54,5,7,12
6,8477015.0,Connor Brown,R,EDM,29,71,4,8,12
6,8476624.0,Barclay Goodrow,C,NYR,30,80,4,8,12
6,8477406.0,Mattias Janmark,C,EDM,31,71,4,8,12
6,8476919.0,Chris Tierney,C,NJD,29,52,4,8,12
6,8479543.0,Michael Pezzetta,L,MTL,25,61,3,9,12
6,8475825.0,Jani Hakanpää,D,DAL,31,64,2,10,12
6,8479980.0,Nicolas Hague,D,VGK,25,73,2,10,12
6,8476822.0,Luke Glendening,C,TBL,34,81,10,1,11
6,8482133.0,Thomas Bordeleau,C,SJS,21,27,6,5,11
6,8480806.0,Isac Lundestrom,C,ANA,24,46,5,6,11
6,8480025.0,MacKenzie Entwistle,R,CHI,24,67,5,6,11
6,8475750.0,Jon Merrill,D,MIN,31,65,4,7,11
6,8481567.0,Henry Thrun,D,SJS,22,51,3,8,11
6,8477950.0,Tony DeAngelo,D,CAR,28,31,3,8,11
6,8474013.0,Ian Cole,D,VAN,34,78,2,9,11
6,8476891.0,Matt Grzelcyk,D,BOS,29,63,2,9,11
6,8480058.0,Pierre-Olivier Joseph,D,PIT,24,52,2,9,11
6,8480860.0,Kevin Bahl,D,NJD,23,82,1,10,11
6,8479576.0,Vincent Desharnais,D,EDM,27,78,1,10,11
6,8470610.0,Zach Parise,L,COL,39,30,5,5,10
6,8476858.0,Phillip Di Giuseppe,L,VAN,30,51,5,5,10
6,8474040.0,Sam Gagner,C,EDM,34,28,5,5,10
6,8480355.0,Mark Kastelic,C,OTT,24,63,5,5,10
6,8482142.0,Jamie Drysdale,D,PHI,21,34,3,7,10
6,8480849.0,Barrett Hayton,C,ARI,23,33,3,7,10
6,8475177.0,Calvin de Haan,D,TBL,32,59,3,7,10
6,8482964.0,Arber Xhekaj,D,MTL,22,44,3,7,10
6,8477384.0,Josh Brown,D,ARI,29,51,3,7,10
6,8480184.0,Gustav Lindström,D,ANA,25,46,3,7,10
6,8480762.0,Eric Robinson,L,BUF,28,47,3,7,10
6,8477018.0,Ben Hutton,D,VGK,30,41,2,8,10
6,8481093.0,Rafael Harvey-Pinard,L,MTL,24,45,2,8,10
6,8480880.0,Jakub Lauko,C,BOS,23,60,2,8,10
6,8480871.0,Adam Boqvist,D,CBJ,23,35,1,9,10
6,8479369.0,Andrew Peeke,D,CBJ,25,38,1,9,10
6,8479982.0,Conor Timmins,D,TOR,25,25,1,9,10
6,8483460.0,David Jiricek,D,CBJ,20,43,1,9,10
6,8477971.0,Andreas Englund,D,LAK,27,82,1,9,10
6,8471274.0,Alex Goligoski,D,MIN,38,36,0,10,10
6,8479439.0,Jacob MacDonald,D,SJS,30,34,7,2,9
6,8479339.0,Patrik Laine,L,CBJ,25,18,6,3,9
6,8477353.0,Tyler Motte,C,TBL,28,69,6,3,9
6,8482077.0,Dylan Holloway,L,EDM,22,38,6,3,9
6,8479718.0,Alex Barré-Boulet,C,TBL,26,36,6,3,9
6,8477989.0,Christian Dvorak,C,MTL,27,30,5,4,9
6,8479328.0,Julien Gauthier,R,NYI,26,27,5,4,9
6,8479968.0,Vinni Lettieri,C,MIN,28,46,5,4,9
6,8476525.0,Colin Miller,D,NJD,31,46,4,5,9
6,8470966.0,Mark Giordano,D,TOR,40,46,3,6,9
6,8482679.0,Matt Coronato,R,CGY,21,34,3,6,9
6,8480008.0,Adam Ruzicka,C,ARI,24,42,3,6,9
6,8481641.0,Joel Kiviranta,L,COL,27,56,3,6,9
6,8478028.0,Fredrik Olofsson,L,COL,27,57,3,6,9
6,8480222.0,Sebastian Aho,D,NYI,27,58,2,7,9
6,8481708.0,Zac Jones,D,NYR,23,31,2,7,9
6,8476960.0,Andreas Athanasiou,C,CHI,29,28,2,7,9
6,8480848.0,Ty Dellandrea,C,DAL,23,42,2,7,9
6,8478099.0,Kevin Labanc,R,SJS,28,46,2,7,9
6,8478399.0,Jonas Siegenthaler,D,NJD,26,57,1,8,9
6,8481527.0,Kaedan Korczak,D,VGK,22,26,1,8,9
6,8481537.0,Nikita Okhotiuk,D,SJS,23,52,1,8,9
6,8475797.0,Jarred Tinordi,D,CHI,31,52,0,9,9
6,8479372.0,Josh Mahura,D,FLA,25,30,0,9,9
6,8477478.0,William Carrier,L,VGK,29,39,6,2,8
6,8480252.0,Cole Guttman,C,CHI,24,27,4,4,8
6,8481058.0,Jesse Ylönen,R,MTL,24,59,4,4,8
6,8474709.0,Matt Martin,L,NYI,34,57,4,4,8
6,8477541.0,Dakota Mermis,D,MIN,29,47,3,5,8
6,8478211.0,Dryden Hunt,L,CGY,28,28,3,5,8
6,8476473.0,Connor Murphy,D,CHI,30,46,2,6,8
6,8477335.0,Kyle Burroughs,D,SJS,28,73,2,6,8
6,8474618.0,Marco Scandella,D,STL,33,65,2,6,8
6,8476329.0,Travis Boyd,C,ARI,30,16,2,6,8
6,8480196.0,Jacob Bryson,D,BUF,26,36,1,7,8
6,8478450.0,Parker Wotherspoon,D,BOS,26,41,0,8,8
6,8480950.0,Ilya Lyubushkin,D,ANA,29,74,0,8,8
6,8479066.0,Ryan Lomberg,L,FLA,29,75,5,2,7
6,8478569.0,Noel Acciari,C,PIT,32,55,4,3,7
6,8477930.0,Pierre-Edouard Bellemare,L,SEA,38,40,4,3,7
6,8482241.0,Radim Zohorna,L,PIT,27,33,4,3,7
6,8482624.0,Daniil Miromanov,D,VGK,26,24,3,4,7
6,8479346.0,Dillon Dube,C,CGY,25,43,3,4,7
6,8482496.0,Nils Aman,C,VAN,23,43,3,4,7
6,8481019.0,David Gustafsson,C,WPG,23,39,3,4,7
6,8478408.0,Travis Dermott,D,ARI,27,50,2,5,7
6,8479458.0,Nikita Zaitsev,D,CHI,32,38,2,5,7
6,8481167.0,Brayden Pachal,D,CGY,24,50,2,5,7
6,8480084.0,Nick DeSimone,D,NJD,29,34,2,5,7
6,8482652.0,Walker Duehr,R,CGY,26,40,2,5,7
6,8480807.0,Mattias Samuelsson,D,BUF,23,41,1,6,7
6,8479442.0,Troy Stecher,D,ARI,29,54,1,6,7
6,8482516.0,Matthew Kessel,D,STL,23,39,1,6,7
6,8474568.0,Luke Schenn,D,NSH,34,63,1,6,7
6,8478454.0,Noah Juulsen,D,VAN,26,54,1,6,7
6,8478502.0,Dennis Gilbert,D,CGY,27,34,1,6,7
6,8478104.0,Sammy Blais,L,STL,27,53,1,6,7
6,8482176.0,Wyatt Kaiser,D,CHI,21,32,0,7,7
6,8473446.0,Erik Johnson,D,BUF,35,67,5,1,6
6,8471817.0,Ryan Reaves,R,TOR,36,49,4,2,6
6,8479370.0,Tyson Jost,C,BUF,25,43,3,3,6
6,8477369.0,Carson Soucy,D,VAN,29,40,2,4,6
6,8474612.0,Travis Hamonic,D,OTT,33,48,2,4,6
6,8482730.0,Brandt Clarke,D,LAK,20,16,2,4,6
6,8477944.0,Jakub Vrana,L,STL,27,21,2,4,6
6,8477931.0,Tomas Nosek,L,NJD,31,36,2,4,6
6,8480789.0,Oliver Wahlstrom,R,NYI,23,32,2,4,6
6,8481013.0,Jonatan Berggren,R,DET,23,12,2,4,6
6,8476441.0,Joel Edmundson,D,WSH,30,53,1,5,6
6,8482192.0,Isaak Phillips,D,CHI,22,33,0,6,6
6,8480078.0,Filip Chytil,C,NYR,24,10,0,6,6
6,8483524.0,Shane Wright,C,SEA,19,8,4,1,5
6,8477962.0,Brendan Lemieux,L,CAR,27,32,3,2,5
6,8481541.0,Samuel Bolduc,D,NYI,23,34,2,3,5
6,8481147.0,Reese Johnson,C,CHI,25,42,2,3,5
6,8481422.0,Jacob Lucchini,C,MIN,28,40,2,3,5
6,8479536.0,Axel Jonsson-Fjallby,L,WPG,25,26,2,3,5
6,8481122.0,Simon Benoit,D,TOR,25,64,1,4,5
6,8477938.0,Haydn Fleury,D,TBL,27,24,1,4,5
6,8477810.0,Joel Hanley,D,DAL,32,42,1,4,5
6,8471686.0,Marc Staal,D,PHI,36,35,1,4,5
6,8474009.0,Nick Bonino,C,NYR,35,45,1,4,5
6,8476952.0,Dominic Toninato,C,WPG,29,15,1,4,5
6,8479547.0,Matthew Phillips,R,PIT,25,31,1,4,5
6,8480245.0,Olle Lycksell,R,PHI,24,18,1,4,5
6,8474716.0,Jared Spurgeon,D,MIN,34,16,0,5,5
6,8475906.0,John Klingberg,D,TOR,31,14,0,5,5
6,8476429.0,Scott Mayfield,D,NYI,31,41,0,5,5
6,8475718.0,Justin Holl,D,DET,31,38,0,5,5
6,8478452.0,Caleb Jones,D,COL,26,25,0,5,5
6,8479291.0,Kevin Rooney,C,CGY,30,33,3,1,4
6,8479344.0,Jesse Puljujarvi,R,PIT,25,22,3,1,4
6,8478051.0,Max Willman,C,NJD,28,18,3,1,4
6,8475791.0,Taylor Hall,L,CHI,32,10,2,2,4
6,8481056.0,Spencer Stastney,D,NSH,23,20,2,2,4
6,8476867.0,Brendan Gaunce,C,CBJ,29,24,2,2,4
6,8479981.0,Jonah Gadjovich,L,FLA,25,39,2,2,4
6,8475766.0,Austin Watson,L,TBL,31,33,2,2,4
6,8477499.0,Rasmus Ristolainen,D,PHI,29,31,1,3,4
6,8478451.0,Ethan Bear,D,WSH,26,24,1,3,4
6,8481609.0,Vladislav Kolyachonok,D,ARI,22,5,1,3,4
6,8477244.0,Chad Ruhwedel,D,PIT,33,52,1,3,4
6,8476442.0,Matt Nieto,L,PIT,31,22,1,3,4
6,8479994.0,Jaret Anderson-Dolan,C,LAK,24,31,1,3,4
6,8475752.0,Tyler Pitlick,C,NYR,32,34,1,3,4
6,8481532.0,Alex Turcotte,C,LAK,22,20,1,3,4
6,8477527.0,Ross Johnston,L,ANA,29,68,1,3,4
6,8475235.0,Nicolas Deslauriers,L,PHI,32,60,1,3,4
6,8476913.0,Devin Shore,C,SEA,29,21,1,3,4
6,8479379.0,Givani Smith,R,SJS,25,36,1,3,4
6,8475762.0,Derek Forbort,D,BOS,31,35,0,4,4
6,8478424.0,Jansen Harkins,C,PIT,26,45,0,4,4
6,8480441.0,Trey Fix-Wolansky,R,CBJ,24,11,2,1,3
6,8478078.0,Rourke Chartier,C,OTT,27,37,2,1,3
6,8480776.0,Sheldon Rempal,R,VGK,28,9,2,1,3
6,8480468.0,James Hamblin,L,EDM,24,31,2,1,3
6,8479772.0,Zack MacEwen,R,OTT,27,30,2,1,3
6,8477073.0,Kurtis MacDermid,D,COL,29,45,2,1,3
6,8480823.0,Alexander Alexeyev,D,WSH,24,39,1,2,3
6,8480007.0,Jonas Rondbjerg,R,VGK,24,20,1,2,3
6,8476934.0,Brock McGinn,L,ANA,29,24,1,2,3
6,8478409.0,Anthony Richard,C,BOS,27,9,1,2,3
6,8483570.0,Ben Meyers,C,COL,25,23,1,2,3
6,8476994.0,Vinnie Hinostroza,C,PIT,29,14,1,2,3
6,8481592.0,Jakob Pelletier,L,CGY,22,13,1,2,3
6,8478904.0,Steven Lorentz,C,FLA,27,38,1,2,3
6,8479972.0,Mason Shaw,C,MIN,25,20,1,2,3
6,8480853.0,Liam Foudy,C,NSH,23,13,0,3,3
6,8482762.0,Simon Edvinsson,D,DET,20,16,1,1,2
6,8482101.0,Danil Gushchin,L,SJS,21,4,1,1,2
6,8479378.0,Logan Stanley,D,WPG,25,25,1,1,2
6,8481006.0,Tyler Tucker,D,STL,23,26,1,1,2
6,8478495.0,Denis Gurianov,R,NSH,26,18,1,1,2
6,8479362.0,Riley Tufte,L,COL,25,5,1,1,2
6,8480292.0,Carson Meyer,R,CBJ,26,14,1,1,2
6,8477454.0,Adam Erne,L,EDM,28,24,1,1,2
6,8475780.0,Chris Wagner,R,BOS,32,13,1,1,2
6,8476988.0,Matt Benning,D,SJS,29,14,0,2,2
6,8477034.0,Jaycob Megna,D,CHI,31,44,0,2,2
6,8481521.0,Ronnie Attard,D,PHI,24,12,0,2,2
6,8480070.0,Ian Mitchell,D,BOS,24,13,0,2,2
6,8477851.0,Jordan Oesterle,D,CGY,31,22,0,2,2
6,8481161.0,Jake Christiansen,D,CBJ,24,12,0,2,2
6,8482451.0,Mikael Pyyhtia,L,CBJ,22,17,0,2,2
6,8473473.0,Milan Lucic,L,BOS,35,4,0,2,2
6,8480870.0,Bo Groulx,C,ANA,23,45,0,2,2
6,8481598.0,Philip Broberg,D,EDM,22,12,0,2,2
6,8477464.0,Nic Petan,C,MIN,28,6,0,2,2
6,8481617.0,Vasily Podkolzin,R,VAN,22,19,0,2,2
6,8481751.0,Lukas Rousek,R,BUF,24,15,0,2,2
6,8481550.0,Adam Beckman,L,MIN,22,11,0,2,2
6,8481523.0,Kirby Dach,C,MTL,22,2,0,2,2
6,8481543.0,Nikita Alexandrov,C,STL,23,23,0,2,2
6,8478146.0,Matthew Highmore,C,OTT,27,7,0,2,2
6,8481043.0,Cole Koepke,L,TBL,25,9,0,2,2
6,8483565.0,Nick Blankenburg,D,CBJ,25,12,1,0,1
6,8483397.0,Marc McLaughlin,C,BOS,24,1,1,0,1
6,8480874.0,Adam Ginning,D,PHI,23,9,1,0,1
6,8481754.0,Nikita Nesterenko,C,ANA,22,3,1,0,1
6,8480021.0,Jack Studnicka,C,SJS,24,22,1,0,1
6,8481518.0,Nolan Foote,L,NJD,23,4,1,0,1
6,8479421.0,Jacob Moverare,D,LAK,25,24,1,0,1
6,8481239.0,Samuel Fagemo,L,LAK,23,8,1,0,1
6,8479546.0,Oskar Steen,C,BOS,25,34,1,0,1
6,8480836.0,Jonathan Gruden,C,PIT,23,13,1,0,1
6,8481077.0,John Leonard,L,NSH,25,6,1,0,1
6,8482147.0,Jean-Luc Foudy,C,COL,21,4,1,0,1
6,8474053.0,Logan Couture,C,SJS,34,6,0,1,1
6,8481812.0,Nikolai Knyzhov,D,SJS,26,10,0,1,1
6,8479984.0,Cal Foote,D,NJD,25,4,0,1,1
6,8479321.0,Lucas Johansen,D,WSH,26,6,0,1,1
6,8473563.0,Nicklas Backstrom,C,WSH,36,8,0,1,1
6,8479320.0,Max Lajoie,D,TOR,26,7,0,1,1
6,8482095.0,Tyler Kleven,D,OTT,21,9,0,1,1
6,8480157.0,Calle Rosen,D,STL,29,6,0,1,1
6,8480031.0,Max Comtois,L,ANA,24,1,0,1,1
6,8478017.0,Mark Friedman,D,VAN,28,23,0,1,1
6,8479348.0,Kale Clague,D,BUF,25,3,0,1,1
6,8475278.0,Byron Froese,C,VGK,32,16,0,1,1
6,8475795.0,Dylan McIlrath,D,WSH,31,3,0,1,1
6,8480845.0,Rasmus Kupari,C,WPG,23,28,0,1,1
6,8480890.0,Jan Jenik,R,ARI,23,5,0,1,1
6,8477887.0,Patrick Brown,C,BOS,31,11,0,1,1
6,8478512.0,Austin Czarnik,C,DET,31,34,0,1,1
6,8479367.0,William Lockwood,R,FLA,25,26,0,1,1
6,8483597.0,Milos Kelemen,L,ARI,24,10,0,1,1
6,8477126.0,Jayson Megna,C,ANA,33,1,0,0,0
6,8479639.0,Dylan Coghlan,D,CAR,25,1,0,0,0
6,8482067.0,Connor Mackey,D,NYR,27,1,0,0,0
6,8476856.0,Matt Dumba,D,ARI,29,0,0,0,0
6,8478483.0,Mitchell Marner,R,TOR,26,0,0,0,0
6,8471873.0,Anton Stralman,D,BOS,37,0,0,0,0
6,8474162.0,Jake Muzzin,D,TOR,34,0,0,0,0
6,8470638.0,Patrice Bergeron,C,BOS,38,0,0,0,0
6,8473604.0,Jonathan Toews,C,CHI,35,0,0,0,0
6,8471276.0,David Krejci,C,BOS,37,0,0,0,0
6,8474207.0,Nick Holden,D,OTT,36,0,0,0,0
6,8475747.0,Patrik Nemeth,D,ARI,31,0,0,0,0
6,8477467.0,Gustav Olofsson,D,SEA,29,1,0,0,0
6,8479514.0,Rem Pitlick,C,CHI,26,9,0,0,0
6,8474027.0,Justin Braun,D,PHI,36,0,0,0,0
6,8481599.0,Victor Soderstrom,D,ARI,22,3,0,0,0
6,8474161.0,Jakub Voracek,R,CBJ,34,0,0,0,0
6,8479985.0,Cale Fleury,D,SEA,25,1,0,0,0
6,8471303.0,Alexander Edler,D,LAK,37,0,0,0,0
6,8474573.0,Josh Bailey,R,NYI,34,0,0,0,0
6,8483619.0,Filip Roos,D,CHI,24,4,0,0,0
6,8474818.0,Jordie Benn,D,TOR,36,0,0,0,0
6,8476449.0,Scott Harrington,D,ANA,30,0,0,0,0
6,8483620.0,Marcus Bjork,D,CBJ,26,0,0,0,0
6,8470595.0,Eric Staal,C,FLA,39,0,0,0,0
6,8481585.0,Egor Afanasyev,L,NSH,22,2,0,0,0
6,8482712.0,Oskar Olausson,R,COL,21,1,0,0,0
6,8481072.0,Tim Berni,D,CBJ,23,0,0,0,0
6,8479945.0,Gavin Bayreuther,D,CBJ,29,0,0,0,0
6,8481600.0,Tobias Bjornfot,D,VGK,22,4,0,0,0
6,8481679.0,Maxence Guenette,D,OTT,22,7,0,0,0
6,8474683.0,Derek Grant,C,ANA,33,0,0,0,0
6,8476470.0,Nathan Beaulieu,D,ANA,31,0,0,0,0
6,8474145.0,Robert Bortuzzo,D,NYI,34,27,0,0,0
6,8480216.0,Jacob Peterson,C,SJS,24,6,0,0,0
6,8473548.0,Phil Kessel,R,VGK,36,0,0,0,0
6,8480160.0,Radim Simek,D,SJS,31,0,0,0,0
6,8480883.0,Ty Smith,D,PIT,23,0,0,0,0
6,8471669.0,Paul Stastny,C,CAR,38,0,0,0,0
6,8475227.0,Chris Wideman,D,MTL,33,0,0,0,0
6,8480913.0,Jordan Gross,D,NSH,28,0,0,0,0
6,8475625.0,Matt Irwin,D,WSH,36,0,0,0,0
6,8479388.0,Riley Stillman,D,BUF,25,0,0,0,0
6,8474628.0,Michael Stone,D,CGY,33,0,0,0,0
6,8484254.0,Akito Hirose,D,VAN,24,3,0,0,0
6,8477941.0,Nick Ritchie,L,CGY,28,0,0,0,0
6,8477462.0,Robert Hagg,D,ANA,28,5,0,0,0
6,8478062.0,Dysin Mayo,D,ARI,27,0,0,0,0
6,8482634.0,Alex Steeves,C,TOR,24,1,0,0,0
6,8477433.0,Ben Harpur,D,NYR,28,0,0,0,0
6,8478841.0,Colton White,D,ANA,26,0,0,0,0
6,8473544.0,Derick Brassard,C,OTT,36,0,0,0,0
6,8476884.0,Derrick Pouliot,D,SJS,29,5,0,0,0
6,8479376.0,Victor Mete,D,PHI,25,1,0,0,0
6,8483630.0,Pavol Regenda,L,ANA,24,5,0,0,0
6,8479026.0,Philippe Myers,D,TBL,26,5,0,0,0
6,8477482.0,Zach Sanford,L,CHI,29,0,0,0,0
6,8477359.0,Tucker Poolman,D,VAN,30,0,0,0,0
6,8475857.0,Kevin Gravel,D,NSH,31,0,0,0,0
6,8476779.0,Brad Hunt,D,COL,35,0,0,0,0
6,8476850.0,Ryan Murray,D,EDM,30,0,0,0,0
6,8477341.0,Andreas Johnsson,L,SJS,29,0,0,0,0
6,8474218.0,Jason Demers,D,EDM,35,0,0,0,0
6,8480844.0,Grigori Denisenko,L,VGK,23,6,0,0,0
6,8484287.0,Cole McWard,D,VAN,22,1,0,0,0
6,8479322.0,Wade Allison,R,PHI,26,0,0,0,0
6,8478846.0,Christian Wolanin,D,VAN,28,0,0,0,0
6,8471887.0,Patric Hornqvist,R,FLA,36,0,0,0,0
6,8475163.0,Alex Chiasson,R,DET,33,0,0,0,0
6,8478881.0,Brett Seney,L,CHI,27,4,0,0,0
6,8474697.0,Mark Borowiecki,D,NSH,34,0,0,0,0
6,8476410.0,Josh Leivo,L,STL,30,0,0,0,0
6,8475968.0,Alex Belzile,R,MTL,32,0,0,0,0
6,8479580.0,Dylan Gambrell,C,OTT,27,0,0,0,0
6,8480901.0,Karson Kuhlman,C,WPG,28,0,0,0,0
6,8480326.0,Sheldon Dries,C,VAN,29,0,0,0,0
6,8478465.0,Guillaume Brisebois,D,VAN,26,0,0,0,0
6,8482861.0,Vincent Iorio,D,WSH,21,6,0,0,0
6,8471794.0,Darren Helm,C,COL,36,0,0,0,0
6,8479335.0,Rasmus Asplund,C,NSH,26,0,0,0,0
6,8478415.0,Jakub Zboril,D,BOS,26,0,0,0,0
6,8476310.0,Lukas Sedlak,C,PHI,30,0,0,0,0
6,8478075.0,Anders Bjork,L,CHI,27,0,0,0,0
6,8480267.0,Sammy Walker,C,MIN,24,4,0,0,0
6,8479578.0,Casey Fitzgerald,D,FLA,26,0,0,0,0
6,8480032.0,Shane Bowers,C,NJD,24,8,0,0,0
6,8478400.0,Colin White,C,PIT,26,28,0,0,0
6,8478431.0,Evgeny Svechnikov,L,SJS,27,0,0,0,0
6,8475772.0,Riley Sheahan,C,BUF,32,0,0,0,0
6,8481690.0,Tyler Angle,C,CBJ,23,2,0,0,0
6,8476326.0,Josh Archibald,R,PIT,31,0,0,0,0
6,8478843.0,Denis Malgin,C,COL,26,0,0,0,0
6,8478446.0,Glenn Gawdin,C,ANA,26,1,0,0,0
6,8477357.0,Saku Maenalanen,R,WPG,29,0,0,0,0
6,8478870.0,Rudolfs Balcers,L,TBL,26,0,0,0,0
6,8478476.0,Kyle Capobianco,D,WPG,26,0,0,0,0
6,8476439.0,Brett Ritchie,R,ARI,30,0,0,0,0
6,8474613.0,Derek Stepan,C,CAR,33,0,0,0,0
6,8475178.0,Zack Kassian,R,ARI,32,0,0,0,0
6,8480226.0,Marián Studenic,R,SEA,25,2,0,0,0
6,8481070.0,Hugh McGing,L,STL,25,5,0,0,0
6,8482250.0,Callahan Burke,C,CAR,26,1,0,0,0
6,8481591.0,Sam Poulin,R,PIT,22,3,0,0,0
6,8481441.0,Joe Snively,C,WSH,27,3,0,0,0
6,8478967.0,Lane Pederson,C,CBJ,26,0,0,0,0
6,8479333.0,Libor Hajek,D,NYR,25,0,0,0,0
6,8480833.0,Vitali Kravtsov,R,VAN,24,0,0,0,0
6,8477460.0,Laurent Dauphin,C,ARI,28,0,0,0,0
6,8481461.0,Corey Schueneman,D,MTL,28,0,0,0,0
6,8474190.0,Wayne Simmonds,R,TOR,35,0,0,0,0
6,8483549.0,Lucas Condotta,L,MTL,26,3,0,0,0
6,8477993.0,Justin Kirkland,C,ARI,27,2,0,0,0
6,8480935.0,Lawrence Pilut,D,BUF,28,0,0,0,0
6,8477210.0,Buddy Robinson,R,CHI,32,0,0,0,0
6,8476851.0,Alex Galchenyuk,C,COL,29,0,0,0,0
6,8482197.0,Adam Raska,R,MIN,22,5,0,0,0
6,8479366.0,Logan Brown,C,STL,25,0,0,0,0
6,8479356.0,Kieffer Bellows,L,PHI,25,0,0,0,0
6,8479533.0,Joona Koppanen,L,PIT,25,4,0,0,0
6,8477401.0,John Hayden,C,SEA,28,2,0,0,0
6,8480822.0,Martin Kaut,R,SJS,24,0,0,0,0
6,8474610.0,Zac Dalpe,C,FLA,34,0,0,0,0
6,8482399.0,Billy Sweezey,D,CBJ,27,0,0,0,0
6,8479991.0,Jake Leschyshyn,C,NYR,24,1,0,0,0
6,8479550.0,Tanner Laczynski,C,PHI,26,0,0,0,0
6,8476166.0,Taylor Fedun,D,PIT,35,0,0,0,0
6,8479338.0,Markus Niemelainen,D,EDM,25,0,0,0,0
6,8477320.0,Anton Blidh,L,NYR,28,1,0,0,0
6,8478147.0,Bokondji Imama,L,ARI,27,6,0,0,0
6,8478067.0,Oskar Lindblom,L,SJS,27,1,0,0,0
6,8478506.0,Gabriel Carlsson,D,WSH,26,0,0,0,0
6,8478131.0,Ondrej Kase,R,CAR,28,0,0,0,0
6,8479644.0,Matt Luff,R,DET,26,0,0,0,0
6,8482824.0,Nick Cicek,D,SJS,23,0,0,0,0
6,8482834.0,Jesper Froden,R,SEA,29,0,0,0,0
6,8478491.0,Jacob Larsson,D,OTT,26,0,0,0,0
6,8474089.0,Brad Malone,C,EDM,34,0,0,0,0
6,8482641.0,Matt Kiersted,D,FLA,25,0,0,0,0
6,8480071.0,Robin Salo,D,NYI,25,0,0,0,0
6,8475461.0,Andrew Agozzino,L,SJS,32,0,0,0,0
6,8475160.0,Kyle Clifford,L,TOR,32,0,0,0,0
6,8480056.0,Jack Rathbone,D,VAN,24,0,0,0,0
6,8481725.0,Elmer Soderblom,L,DET,22,0,0,0,0
6,8479465.0,Drake Caggiula,L,PIT,29,0,0,0,0
6,8476948.0,Charles Hudon,L,COL,29,0,0,0,0
6,8479523.0,Lucas Carlsson,D,FLA,26,0,0,0,0
6,8478455.0,Austin Wagner,L,CHI,26,0,0,0,0
6,8481572.0,Ville Heinola,D,WPG,22,0,0,0,0
6,8479404.0,Henrik Borgstrom,C,WSH,26,0,0,0,0
6,8479944.0,Zach Aston-Reese,C,DET,29,3,0,0,0
6,8482635.0,Mike Hardman,L,CHI,24,0,0,0,0
6,8479705.0,Jeffrey Viel,L,SJS,26,0,0,0,0
6,8480467.0,Austin Strand,D,ANA,26,0,0,0,0
6,8480037.0,Aleksi Heponiemi,C,FLA,24,0,0,0,0
6,8479573.0,Mikhail Maltsev,L,COL,25,0,0,0,0
6,8476404.0,Andy Andreoff,C,NYI,32,0,0,0,0
6,8484125.0,Hunter McKown,C,CBJ,21,0,0,0,0
6,8481649.0,Joona Luoto,L,CBJ,26,0,0,0,0
6,8477981.0,Roland McKeown,D,NSH,27,0,0,0,0
6,8480831.0,Alec Regula,D,CHI,23,0,0,0,0
6,8482691.0,Aatu Raty,C,VAN,21,0,0,0,0
6,8482623.0,Josh Dunne,C,CBJ,25,0,0,0,0
6,8481433.0,Taro Hirose,L,DET,27,0,0,0,0
6,8480328.0,David Gust,R,CHI,29,0,0,0,0
6,8479526.0,Otto Koivula,L,NYI,25,0,0,0,0
6,8476390.0,Joseph Cramarossa,C,MIN,31,0,0,0,0
6,8482654.0,Jackson Cates,C,PHI,26,0,0,0,0
6,8480439.0,Mac Hollowell,D,TOR,25,0,0,0,0
6,8480072.0,Lias Andersson,C,LAK,25,0,0,0,0
6,8479395.0,Dennis Cholowski,D,NYI,25,0,0,0,0
6,8477463.0,Steven Santini,D,STL,28,0,0,0,0
6,8479347.0,Tyler Benson,L,EDM,25,0,0,0,0
6,8477471.0,Dillon Heatherington,D,OTT,28,0,0,0,0
6,8477520.0,Jean-Sebastien Dea,C,ARI,29,0,0,0,0
6,8480846.0,Sampo Ranta,L,COL,23,0,0,0,0
6,8480979.0,Nathan Smith,C,ARI,25,0,0,0,0
6,8484256.0,Jake Livingstone,D,NSH,24,0,0,0,0
6,8476396.0,Steven Fogarty,C,MIN,30,0,0,0,0
6,8479252.0,Dan Renouf,D,BOS,29,0,0,0,0
6,8479518.0,Fredrik Karlström,C,DAL,25,0,0,0,0
6,8481683.0,Aidan McDonough,L,VAN,24,0,0,0,0
6,8478373.0,Nikita Soshnikov,R,NYI,30,0,0,0,0
6,8482081.0,Sean Farrell,C,MTL,22,0,0,0,0
6,8481575.0,Lassi Thomson,D,OTT,23,0,0,0,0
6,8481102.0,Egor Sokolov,L,OTT,23,0,0,0,0
6,8481712.0,Matej Blumel,R,DAL,23,0,0,0,0
6,8479602.0,Jeremy Davies,D,BUF,27,0,0,0,0
6,8480443.0,Kristian Reichel,C,WPG,25,0,0,0,0
6,8479304.0,Kyle Criscuolo,C,SJS,31,0,0,0,0
6,8478224.0,Luke Philp,C,CHI,28,0,0,0,0
6,8480242.0,Arnaud Durandeau,L,NYI,24,0,0,0,0
6,8479329.0,Frederic Allard,D,MTL,26,0,0,0,0
6,8476941.0,Connor Carrick,D,BOS,29,0,0,0,0
6,8479375.0,William Bitten,C,STL,25,0,0,0,0
6,8481720.0,Nick Abruzzese,C,TOR,24,0,0,0,0
6,8482452.0,Elliot Desnoyers,L,PHI,21,0,0,0,0
6,8476915.0,Jujhar Khaira,L,MIN,29,1,0,0,0
6,8483641.0,Anton Levtchi,L,FLA,28,0,0,0,0
6,8481740.0,Tyce Thompson,R,NJD,24,0,0,0,0
6,8478173.0,Hayden Hodgson,R,PHI,27,0,0,0,0
6,8482181.0,Tristen Robins,C,SJS,22,0,0,0,0
6,8481563.0,Drew Helleson,D,ANA,22,0,0,0,0
6,8480863.0,Gabriel Fortier,L,TBL,23,0,0,0,0
6,8478058.0,CJ Suess,L,SJS,29,0,0,0,0
6,8480041.0,Dmitri Samorukov,D,STL,24,0,0,0,0
6,8482179.0,Justin Richards,C,CBJ,25,0,0,0,0
6,8480034.0,Joel Teasdale,L,MTL,24,0,0,0,0
6,8480820.0,Filip Kral,D,TOR,24,0,0,0,0
6,8480842.0,Filip Hallander,C,PIT,23,0,0,0,0
6,8478367.0,Cole Bardreau,C,NYI,30,0,0,0,0
6,8482448.0,Samuel Knazko,D,CBJ,21,0,0,0,0
6,8482711.0,Stanislav Svozil,D,CBJ,20,0,0,0,0
6,8480275.0,Nick Swaney,R,MIN,26,0,0,0,0
6,8480994.0,Damien Giroux,C,MIN,23,0,0,0,0
6,8480977.0,Semyon Der-Arguchintsev,C,TOR,23,0,0,0,0
6,8482207.0,William Dufour,R,NYI,21,0,0,0,0
6,8483464.0,Marco Kasper,C,DET,19,0,0,0,0
6,8483424.0,Owen Beck,C,MTL,19,0,0,0,0
7,8476453.0,Nikita Kucherov,R,TBL,30,81,44,100,144
7,8477492.0,Nathan MacKinnon,C,COL,28,82,51,89,140
7,8478402.0,Connor McDavid,C,EDM,26,76,32,100,132
7,8478550.0,Artemi Panarin,L,NYR,32,82,49,71,120
7,8477956.0,David Pastrnak,R,BOS,27,82,47,63,110
7,8479318.0,Auston Matthews,C,TOR,26,81,69,38,107
7,8477934.0,Leon Draisaitl,C,EDM,28,81,41,65,106
7,8478420.0,Mikko Rantanen,R,COL,27,80,42,62,104
7,8476468.0,J.T. Miller,C,VAN,30,81,37,66,103
7,8477939.0,William Nylander,R,TOR,27,82,40,58,98
7,8478864.0,Kirill Kaprizov,L,MIN,26,75,46,50,96
7,8477933.0,Sam Reinhart,C,FLA,28,82,57,37,94
7,8476887.0,Filip Forsberg,L,NSH,29,82,48,46,94
7,8471675.0,Sidney Crosby,C,PIT,36,82,42,52,94
7,8480800.0,Quinn Hughes,D,VAN,24,82,17,75,92
7,8478010.0,Brayden Point,C,TBL,27,81,46,44,90
7,8480069.0,Cale Makar,D,COL,25,77,21,69,90
7,8478427.0,Sebastian Aho,C,CAR,26,78,36,53,89
7,8480012.0,Elias Pettersson,C,VAN,25,82,34,55,89
7,8479314.0,Matthew Tkachuk,L,FLA,26,80,26,62,88
7,8480023.0,Robert Thomas,C,STL,24,82,26,60,86
7,8474600.0,Roman Josi,D,NSH,33,82,23,62,85
7,8479407.0,Jesper Bratt,L,NJD,25,82,27,56,83
7,8480803.0,Evan Bouchard,D,EDM,24,81,18,64,82
7,8474564.0,Steven Stamkos,C,TBL,33,79,40,41,81
7,8480027.0,Jason Robertson,L,DAL,24,82,29,51,80
7,8478445.0,Mathew Barzal,C,NYI,26,80,23,57,80
7,8477493.0,Aleksander Barkov,C,FLA,28,73,23,57,80
7,8475786.0,Zach Hyman,L,EDM,31,80,54,23,77
7,8480018.0,Nick Suzuki,C,MTL,24,82,33,44,77
7,8477404.0,Jake Guentzel,L,PIT,29,67,30,47,77
7,8476389.0,Vincent Trocheck,C,NYR,30,82,25,52,77
7,8479343.0,Clayton Keller,R,ARI,25,78,33,43,76
7,8475167.0,Victor Hedman,D,TBL,33,78,13,63,76
7,8475184.0,Chris Kreider,L,NYR,32,82,39,36,75
7,8475172.0,Nazem Kadri,C,CGY,33,82,29,46,75
7,8477960.0,Adrian Kempe,R,LAK,27,77,28,47,75
7,8479542.0,Brandon Hagel,L,TBL,25,82,26,49,75
7,8474679.0,Gustav Nyquist,C,NSH,34,81,23,52,75
7,8480801.0,Brady Tkachuk,L,OTT,24,81,37,37,74
7,8481559.0,Jack Hughes,C,NJD,22,62,27,47,74
7,8478444.0,Brock Boeser,R,VAN,26,81,40,33,73
7,8477942.0,Kevin Fiala,L,LAK,27,82,29,44,73
7,8479323.0,Adam Fox,D,NYR,25,72,17,56,73
7,8477409.0,Carter Verhaeghe,C,FLA,28,76,34,38,72
7,8482078.0,Lucas Raymond,L,DET,21,82,31,41,72
7,8476459.0,Mika Zibanejad,C,NYR,30,81,26,46,72
7,8476460.0,Mark Scheifele,C,WPG,30,74,25,47,72
7,8471685.0,Anze Kopitar,C,LAK,36,81,26,44,70
7,8482116.0,Tim Stützle,C,OTT,21,75,18,52,70
7,8480865.0,Noah Dobson,D,NYI,23,79,10,60,70
7,8476539.0,Jonathan Marchessault,R,VGK,33,82,42,27,69
7,8475754.0,Brock Nelson,C,NYI,32,82,34,35,69
7,8477946.0,Dylan Larkin,C,DET,27,68,33,36,69
7,8475158.0,Ryan O'Reilly,C,NSH,32,82,26,43,69
7,8477504.0,Josh Morrissey,D,WPG,28,81,10,59,69
7,8478439.0,Travis Konecny,R,PHI,26,76,33,35,68
7,8477500.0,Bo Horvat,C,NYI,28,81,33,35,68
7,8478403.0,Jack Eichel,C,VGK,27,63,31,37,68
7,8481557.0,Matt Boldy,L,MIN,22,75,29,39,68
7,8482093.0,Seth Jarvis,C,CAR,21,81,33,34,67
7,8479385.0,Jordan Kyrou,C,STL,25,82,31,36,67
7,8473419.0,Brad Marchand,L,BOS,35,82,29,38,67
7,8480002.0,Nico Hischier,C,NJD,24,71,27,40,67
7,8471215.0,Evgeni Malkin,C,PIT,37,82,27,40,67
7,8478440.0,Dylan Strome,C,WSH,26,82,27,40,67
7,8479337.0,Alex DeBrincat,R,DET,26,82,27,40,67
7,8470794.0,Joe Pavelski,C,DAL,39,82,27,40,67
7,8476454.0,Ryan Nugent-Hopkins,C,EDM,30,80,18,49,67
7,8480208.0,Drake Batherson,R,OTT,25,82,28,38,66
7,8482740.0,Wyatt Johnston,C,DAL,20,82,32,33,65
7,8471214.0,Alex Ovechkin,L,WSH,38,79,31,34,65
7,8478449.0,Roope Hintz,C,DAL,27,80,30,35,65
7,8475166.0,John Tavares,C,TOR,33,80,29,36,65
7,8481540.0,Cole Caufield,R,MTL,22,82,28,37,65
7,8475168.0,Matt Duchene,C,DAL,32,80,25,40,65
7,8478493.0,Joel Eriksson Ek,C,MIN,26,77,30,34,64
7,8473512.0,Claude Giroux,R,OTT,35,82,21,43,64
7,8477402.0,Pavel Buchnevich,L,STL,28,80,27,36,63
7,8475692.0,Mats Zuccarello,R,MIN,36,69,12,51,63
7,8477955.0,Jared McCann,L,SEA,27,80,29,33,62
7,8476875.0,Mike Matheson,D,MTL,29,82,11,51,62
7,8478398.0,Kyle Connor,L,WPG,27,65,34,27,61
7,8477940.0,Nikolaj Ehlers,L,WPG,27,82,25,36,61
7,8477951.0,Nick Schmaltz,C,ARI,27,79,22,39,61
7,8478366.0,Frank Vatrano,R,ANA,29,82,37,23,60
7,8476448.0,William Karlsson,C,VGK,30,70,30,30,60
7,8475745.0,Charlie Coyle,C,BOS,31,82,25,35,60
7,8473994.0,Jamie Benn,L,DAL,34,82,21,39,60
7,8475798.0,Mikael Granlund,C,SJS,31,69,12,48,60
7,8476346.0,Johnny Gaudreau,L,CBJ,30,81,12,48,60
7,8481068.0,Yegor Sharangovich,C,CGY,25,82,31,28,59
7,8477497.0,Sean Monahan,C,WPG,29,83,26,33,59
7,8477949.0,Alex Tuch,R,BUF,27,75,22,37,59
7,8478401.0,Pavel Zacha,C,BOS,26,78,21,38,59
7,8480839.0,Rasmus Dahlin,D,BUF,23,81,20,39,59
7,8477416.0,Oliver Bjorkstrand,R,SEA,28,82,20,39,59
7,8476853.0,Morgan Rielly,D,TOR,29,72,7,51,58
7,8479675.0,Trevor Moore,L,LAK,28,82,31,26,57
7,8482109.0,Alexis Lafrenière,L,NYR,22,82,28,29,57
7,8479999.0,Casey Mittelstadt,C,BUF,25,80,18,39,57
7,8481711.0,Matias Maccelli,L,ARI,23,82,17,40,57
7,8478460.0,Zach Werenski,D,CBJ,26,70,11,46,57
7,8479420.0,Tage Thompson,C,BUF,26,71,29,27,56
7,8475810.0,Bryan Rust,R,PIT,31,62,28,28,56
7,8477494.0,Jonathan Drouin,L,COL,28,79,19,37,56
7,8474578.0,Erik Karlsson,D,PIT,33,82,11,45,56
7,8476906.0,Shayne Gostisbehere,D,DET,30,81,10,46,56
7,8475726.0,Tyler Toffoli,R,NJD,31,79,33,22,55
7,8475765.0,Vladimir Tarasenko,R,OTT,32,76,23,32,55
7,8482124.0,Quinton Byfield,R,LAK,21,80,20,35,55
7,8478047.0,Michael Bunting,L,CAR,28,81,19,36,55
7,8475151.0,Kyle Palmieri,C,NYI,32,82,30,24,54
7,8476399.0,Blake Coleman,C,CGY,32,78,30,24,54
7,8478873.0,Troy Terry,R,ANA,26,76,20,34,54
7,8480798.0,Philipp Kurashev,C,CHI,24,75,18,36,54
7,8480036.0,Miro Heiskanen,D,DAL,24,71,9,45,54
7,8477501.0,Valeri Nichushkin,R,COL,28,54,28,25,53
7,8480015.0,Owen Tippett,R,PHI,24,78,28,25,53
7,8476882.0,Teuvo Teravainen,L,CAR,29,76,25,28,53
7,8480039.0,Martin Necas,C,CAR,24,77,24,29,53
7,8478975.0,Mason Marchment,L,DAL,28,81,22,31,53
7,8475913.0,Mark Stone,R,VGK,31,56,16,37,53
7,8478414.0,Timo Meier,R,NJD,27,69,28,24,52
7,8475794.0,Tyler Seguin,C,DAL,31,68,25,27,52
7,8477346.0,MacKenzie Weegar,D,CGY,29,82,20,32,52
7,8480830.0,Andrei Svechnikov,R,CAR,23,59,19,33,52
7,8476456.0,Jonathan Huberdeau,C,CGY,30,81,12,40,52
7,8474590.0,John Carlson,D,WSH,33,82,10,42,52
7,8474641.0,Adam Henrique,C,ANA,33,82,24,27,51
7,8476905.0,Chandler Stephenson,C,VGK,29,75,16,35,51
7,8471724.0,Kris Letang,D,PIT,36,82,10,41,51
7,8482175.0,JJ Peterka,R,BUF,21,82,28,22,50
7,8480797.0,Joel Farabee,L,PHI,23,82,22,28,50
7,8483515.0,Juraj Slafkovsky,L,MTL,19,82,20,30,50
7,8474563.0,Drew Doughty,D,LAK,34,82,15,35,50
7,8478038.0,Devon Toews,D,COL,29,82,12,38,50
7,8477456.0,J.T. Compher,L,DET,28,77,19,29,48
7,8479425.0,Filip Hronek,D,VAN,26,81,5,43,48
7,8474141.0,Patrick Kane,R,DET,35,50,20,27,47
7,8478856.0,Conor Garland,R,VAN,27,82,20,27,47
7,8481528.0,Dylan Cozens,C,BUF,22,79,18,29,47
7,8476479.0,Phillip Danault,C,LAK,30,78,17,30,47
7,8474102.0,David Perron,L,DET,35,76,17,30,47
7,8481581.0,Thomas Harley,D,DAL,22,79,15,32,47
7,8478396.0,Noah Hanifin,D,CGY,26,80,13,34,47
7,8476869.0,Brady Skjei,D,CAR,29,80,13,34,47
7,8479325.0,Charlie McAvoy,D,BOS,26,74,12,35,47
7,8482684.0,Luke Hughes,D,NJD,20,82,9,38,47
7,8477503.0,Max Domi,C,TOR,28,80,9,38,47
7,8482122.0,Brock Faber,D,MIN,21,82,8,39,47
7,8477426.0,Nicholas Paul,L,TBL,28,82,24,22,46
7,8475784.0,Jeff Skinner,L,BUF,31,74,24,22,46
7,8483808.0,Andrei Kuzmenko,L,CGY,27,72,22,24,46
7,8475170.0,Brayden Schenn,C,STL,32,82,20,26,46
7,8478407.0,Vince Dunn,D,SEA,27,59,11,35,46
7,8475760.0,Nick Bjugstad,C,ARI,31,76,22,23,45
7,8477451.0,Ryan Hartman,R,MIN,29,74,21,24,45
7,8478519.0,Anthony Cirelli,C,TBL,26,79,20,25,45
7,8477964.0,Ivan Barbashev,C,VGK,28,82,19,26,45
7,8478438.0,Tommy Novak,C,NSH,26,71,18,27,45
7,8482667.0,William Eklund,L,SJS,21,80,16,29,45
7,8477021.0,Alex Kerfoot,C,ARI,29,82,13,32,45
7,8475218.0,Mattias Ekholm,D,EDM,33,79,11,34,45
7,8480188.0,Fabian Zetterlund,L,SJS,24,82,24,20,44
7,8475169.0,Evander Kane,L,EDM,32,77,24,20,44
7,8477511.0,Anthony Mantha,R,WSH,29,74,23,21,44
7,8474586.0,Jordan Eberle,R,SEA,33,78,17,27,44
7,8477496.0,Elias Lindholm,C,VAN,29,75,15,29,44
7,8477948.0,Travis Sanheim,D,PHI,27,81,10,34,44
7,8477479.0,Tyler Bertuzzi,L,TOR,28,80,21,22,43
7,8478466.0,Daniel Sprong,R,DET,26,76,18,25,43
7,8470613.0,Brent Burns,D,CAR,38,82,10,33,43
7,8476438.0,Brandon Saad,L,STL,31,82,26,16,42
7,8477407.0,Anthony Duclair,L,SJS,28,73,24,18,42
7,8478474.0,Lawson Crouse,L,ARI,26,81,23,19,42
7,8480893.0,Kirill Marchenko,R,CBJ,23,78,23,19,42
7,8482745.0,Mason McTavish,C,ANA,20,64,19,23,42
7,8481542.0,Moritz Seider,D,DET,22,82,9,33,42
7,8477447.0,Shea Theodore,D,VGK,28,47,5,37,42
7,8477935.0,Sam Bennett,C,FLA,27,69,20,21,41
7,8477998.0,Warren Foegele,L,EDM,27,82,20,21,41
7,8480009.0,Eeli Tolvanen,R,SEA,24,81,16,25,41
7,8479345.0,Jakob Chychrun,D,OTT,25,82,14,27,41
7,8480028.0,Morgan Frost,C,PHI,24,71,13,28,41
7,8478462.0,Nicolas Roy,C,VGK,26,70,13,28,41
7,8476458.0,Ryan Strome,C,ANA,30,79,11,30,41
7,8480434.0,Sean Durzi,D,ARI,25,76,9,32,41
7,8482079.0,Marco Rossi,C,MIN,22,82,21,19,40
7,8478498.0,Jake DeBrusk,L,BOS,27,80,19,21,40
7,8479365.0,Trent Frederic,C,BOS,25,82,18,22,40
7,8479525.0,Ross Colton,C,COL,27,80,17,23,40
7,8479400.0,Pierre-Luc Dubois,C,LAK,25,82,16,24,40
7,8478233.0,Andrew Mangiapane,L,CGY,27,75,14,26,40
7,8475191.0,Reilly Smith,R,PIT,32,76,13,27,40
7,8479987.0,Morgan Geekie,C,BOS,25,76,17,22,39
7,8482146.0,Luke Evangelista,R,NSH,21,80,16,23,39
7,8474150.0,Mikael Backlund,C,CGY,34,82,15,24,39
7,8476872.0,Scott Laughton,C,PHI,29,82,13,26,39
7,8478542.0,Evan Rodrigues,C,FLA,30,80,12,27,39
7,8478055.0,Gustav Forsling,D,FLA,27,79,10,29,39
7,8478397.0,Rasmus Andersson,D,CGY,27,78,9,30,39
7,8475764.0,Cam Fowler,D,ANA,32,81,5,34,39
7,8476792.0,Torey Krug,D,STL,32,77,4,35,39
7,8482089.0,Jake Neighbours,L,STL,21,77,27,11,38
7,8482149.0,Cole Perfetti,C,WPG,21,71,19,19,38
7,8476881.0,Tomas Hertl,C,SJS,30,54,17,21,38
7,8474037.0,James van Riemsdyk,L,BOS,34,71,11,27,38
7,8482105.0,Jake Sanderson,D,OTT,21,79,10,28,38
7,8475314.0,Anders Lee,L,NYI,33,81,20,17,37
7,8473422.0,Nick Foligno,L,CHI,36,74,17,20,37
7,8482665.0,Matty Beniers,C,SEA,21,77,15,22,37
7,8476483.0,Rickard Rakell,R,PIT,30,70,15,22,37
7,8476474.0,Stefan Noesen,R,CAR,30,81,14,23,37
7,8476480.0,Vladislav Namestnikov,C,WPG,31,78,11,26,37
7,8476958.0,Jaccob Slavin,D,CAR,29,81,6,31,37
7,8481535.0,Nils Hoglander,L,VAN,23,80,24,12,36
7,8480014.0,Gabriel Vilardi,C,WPG,24,47,22,14,36
7,8473986.0,Alex Killorn,L,ANA,34,63,18,18,36
7,8478046.0,Danton Heinen,L,BOS,28,74,17,19,36
7,8478891.0,Mason Appleton,C,WPG,27,82,14,22,36
7,8476432.0,Boone Jenner,C,CBJ,30,58,22,13,35
7,8477450.0,Jason Dickinson,C,CHI,28,82,22,13,35
7,8476880.0,Tom Wilson,R,WSH,29,74,18,17,35
7,8482699.0,Dylan Guenther,R,ARI,20,45,18,17,35
7,8475287.0,Erik Haula,L,NJD,32,76,16,19,35
7,8476925.0,Colton Sissons,C,NSH,30,81,15,20,35
7,8482720.0,Matthew Knies,L,TOR,21,80,15,20,35
7,8482113.0,Anton Lundell,C,FLA,22,78,13,22,35
7,8476392.0,Adam Lowry,C,WPG,30,81,12,23,35
7,8478472.0,Mathieu Joseph,R,OTT,26,72,11,24,35
7,8475799.0,Nino Niederreiter,R,WPG,31,77,18,16,34
7,8477476.0,Artturi Lehkonen,L,COL,28,45,16,18,34
7,8481618.0,Alex Newhook,C,MTL,22,55,15,19,34
7,8482159.0,Tyson Foerster,R,PHI,21,77,20,13,33
7,8482110.0,Dawson Mercer,C,NJD,22,82,20,13,33
7,8481580.0,Connor McMichael,C,WSH,22,80,18,15,33
7,8482055.0,Drew O'Connor,L,PIT,25,79,16,17,33
7,8477429.0,Andrew Copp,C,DET,29,79,13,20,33
7,8479992.0,Michael Rasmussen,C,DET,24,75,13,20,33
7,8476826.0,Yanni Gourde,C,SEA,32,80,11,22,33
7,8476419.0,Jean-Gabriel Pageau,C,NYI,31,82,11,22,33
7,8477986.0,Brandon Montour,D,FLA,29,66,8,25,33
7,8482671.0,Owen Power,D,BUF,21,76,6,27,33
7,8478178.0,Darren Raddysh,D,TBL,27,82,6,27,33
7,8480145.0,Neal Pionk,D,WPG,28,82,5,28,33
7,8474565.0,Alex Pietrangelo,D,VGK,33,64,4,29,33
7,8478057.0,Dakota Joshua,C,VAN,27,63,18,14,32
7,8477952.0,Robby Fabbri,C,DET,27,68,18,14,32
7,8476921.0,Jordan Martinook,L,CAR,31,82,14,18,32
7,8475722.0,Jason Zucker,L,ARI,31,69,14,18,32
7,8482705.0,Cole Sillinger,C,CBJ,20,77,13,19,32
7,8477498.0,Darnell Nurse,D,EDM,28,81,10,22,32
7,8475171.0,Oliver Ekman-Larsson,D,FLA,32,80,9,23,32
7,8478500.0,Ivan Provorov,D,CBJ,26,82,5,27,32
7,8474151.0,Ryan McDonagh,D,NSH,34,74,3,29,32
7,8474870.0,Tyler Johnson,C,CHI,33,67,17,14,31
7,8475848.0,Brendan Gallagher,R,MTL,31,77,16,15,31
7,8474189.0,Lars Eller,C,PIT,34,82,15,16,31
7,8476292.0,Ondrej Palat,L,NJD,32,71,11,20,31
7,8481624.0,Ilya Mikheyev,R,VAN,29,78,11,20,31
7,8478458.0,Jack Roslovic,C,CBJ,26,59,9,22,31
7,8477495.0,Seth Jones,D,CHI,29,67,8,23,31
7,8476979.0,Erik Gustafsson,D,NYR,31,76,6,25,31
7,8476331.0,Dylan DeMelo,D,WPG,30,82,3,28,31
7,8480064.0,Josh Norris,C,OTT,24,50,16,14,30
7,8475768.0,Jaden Schwartz,C,SEA,31,62,13,17,30
7,8480802.0,Ryan McLeod,C,EDM,24,81,12,18,30
7,8477987.0,Ryan Donato,C,CHI,27,78,12,18,30
7,8475149.0,Marcus Johansson,L,MIN,33,78,11,19,30
7,8481546.0,Cam York,D,PHI,22,82,10,20,30
7,8477505.0,Alex Wennberg,C,SEA,29,79,10,20,30
7,8473533.0,Jordan Staal,C,CAR,35,80,10,20,30
7,8478469.0,Thomas Chabot,D,OTT,26,51,9,21,30
7,8480817.0,K'Andre Miller,D,NYR,23,80,8,22,30
7,8477969.0,Marcus Pettersson,D,PIT,27,82,4,26,30
7,8475753.0,Justin Faulk,D,STL,31,60,2,28,30
7,8479619.0,Michael Carcone,L,ARI,27,74,21,8,29
7,8482475.0,Yegor Chinakhov,R,CBJ,22,53,16,13,29
7,8480459.0,Pius Suter,C,VAN,27,67,14,15,29
7,8475763.0,Kevin Hayes,R,STL,31,79,13,16,29
7,8481524.0,Bowen  Byram,D,COL,22,73,11,18,29
7,8480336.0,Sean Walker,D,PHI,29,81,10,19,29
7,8481656.0,Aliaksei Protas,C,WSH,22,78,6,23,29
7,8474574.0,Tyler Myers,D,VAN,33,77,5,24,29
7,8482125.0,Alexander Holtz,R,NJD,21,82,16,12,28
7,8480813.0,Joe Veleno,C,DET,23,80,12,16,28
7,8480068.0,Ryan Poehling,C,PHI,24,77,11,17,28
7,8478413.0,Jordan Greenway,L,BUF,26,67,10,18,28
7,8478115.0,Pierre Engvall,L,NYI,27,74,10,18,28
7,8476923.0,Damon Severson,D,CBJ,29,67,9,19,28
7,8476931.0,Jake McCabe,D,TOR,30,73,8,20,28
7,8478133.0,Jake Evans,C,MTL,27,82,7,21,28
7,8476927.0,Teddy Blueger,C,VAN,29,68,6,22,28
7,8475181.0,Nick Leddy,D,STL,32,82,3,25,28
7,8478020.0,Michael Amadio,R,VGK,27,73,14,13,27
7,8481582.0,Nicholas Robertson,L,TOR,22,56,14,13,27
7,8480185.0,Eetu Luostarinen,C,FLA,25,82,12,15,27
7,8480829.0,Jesperi Kotkaniemi,C,CAR,23,79,12,15,27
7,8480113.0,Alex Iafallo,L,WPG,30,82,11,16,27
7,8480748.0,Kiefer Sherwood,L,NSH,28,68,10,17,27
7,8481596.0,Shane Pinto,C,OTT,23,41,9,18,27
7,8480835.0,Jack Drury,C,CAR,23,74,8,19,27
7,8476463.0,Jonas Brodin,D,MIN,30,62,7,20,27
7,8482092.0,Ridly Greig,C,OTT,21,72,13,13,26
7,8476918.0,Jimmy Vesey,L,NYR,30,80,13,13,26
7,8476892.0,Colton Parayko,D,STL,30,82,10,16,26
7,8479941.0,Justin Danforth,R,CBJ,30,71,10,16,26
7,8477425.0,Miles Wood,L,COL,28,74,9,17,26
7,8480855.0,Jack McBain,C,ARI,23,67,8,18,26
7,8474602.0,Justin Schultz,D,SEA,33,70,7,19,26
7,8475790.0,Erik Gudbranson,D,CBJ,31,78,6,20,26
7,8475200.0,Dmitry Orlov,D,CAR,32,82,6,20,26
7,8482655.0,J.J. Moser,D,ARI,23,80,5,21,26
7,8476902.0,Esa Lindell,D,DAL,29,82,5,21,26
7,8475188.0,Brayden McNabb,D,VGK,32,82,4,22,26
7,8476854.0,Hampus Lindholm,D,BOS,29,73,3,23,26
7,8474673.0,TJ Brodie,D,TOR,33,78,1,25,26
7,8476469.0,Joel Armia,R,MTL,30,66,17,8,25
7,8481601.0,Simon Holmstrom,R,NYI,22,75,15,10,25
7,8481186.0,Logan O'Connor,R,COL,27,57,13,12,25
7,8471698.0,T.J. Oshie,R,WSH,37,52,12,13,25
7,8479591.0,Michael Eyssimont,C,TBL,27,81,11,14,25
7,8476312.0,Josh Manson,D,COL,32,76,8,17,25
7,8478136.0,Jake Middleton,D,MIN,27,80,7,18,25
7,8481032.0,Paul Cotter,C,VGK,24,76,7,18,25
7,8477508.0,Curtis Lazar,C,NJD,28,71,7,18,25
7,8482245.0,Artem Zub,D,OTT,28,69,5,20,25
7,8478911.0,Matt Roy,D,LAK,28,81,5,20,25
7,8476879.0,Cody Ceci,D,EDM,30,79,5,20,25
7,8478507.0,John Marino,D,NJD,26,75,4,21,25
7,8478840.0,Will Borgen,D,SEA,27,82,3,22,25
7,8482259.0,Bobby McMann,C,TOR,27,56,15,9,24
7,8481604.0,Pavel Dorofeyev,L,VGK,23,47,13,11,24
7,8478043.0,Sam Lafferty,C,VAN,28,79,13,11,24
7,8479351.0,Sam Steel,C,DAL,25,77,9,15,24
7,8475193.0,Tomas Tatar,L,SEA,33,70,9,15,24
7,8475744.0,Evgeny Kuznetsov,C,WSH,31,63,8,16,24
7,8475233.0,David Savard,D,MTL,33,60,6,18,24
7,8476422.0,Mike Reilly,D,NYI,30,61,6,18,24
7,8474031.0,Kevin Shattenkirk,D,BOS,34,61,6,18,24
7,8473507.0,Jeff Petry,D,DET,36,73,3,21,24
7,8480246.0,Nick Perbix,D,TBL,25,77,2,22,24
7,8481606.0,Jordan Spence,D,LAK,22,71,2,22,24
7,8477947.0,Sonny Milano,L,WSH,27,49,15,8,23
7,8475793.0,Ryan Johansen,C,COL,31,63,13,10,23
7,8480821.0,Filip Zadina,R,SJS,24,72,13,10,23
7,8474149.0,Evgenii Dadonov,R,DAL,34,51,12,11,23
7,8475231.0,Casey Cizikas,C,NYI,32,70,10,13,23
7,8474884.0,Mike Hoffman,C,SJS,34,66,10,13,23
7,8482062.0,Cole Smith,L,NSH,28,80,9,14,23
7,8478882.0,Vladislav Gavrikov,D,LAK,28,77,6,17,23
7,8474157.0,Max Pacioretty,L,WSH,35,47,4,19,23
7,8480873.0,Rasmus Sandin,D,WSH,23,68,3,20,23
7,8480043.0,Timothy Liljegren,D,TOR,24,55,3,20,23
7,8475343.0,Nic Dowd,C,WSH,33,64,12,10,22
7,8470621.0,Corey Perry,R,EDM,38,54,12,10,22
7,8473449.0,Kyle Okposo,R,BUF,35,67,12,10,22
7,8477446.0,Michael McCarron,R,NSH,28,70,12,10,22
7,8481517.0,Brett Leason,R,ANA,24,68,11,11,22
7,8478970.0,Jalen Chatfield,D,CAR,27,72,8,14,22
7,8481014.0,Alexander Romanov,D,NYI,23,81,7,15,22
7,8482087.0,Kaiden Guhle,D,MTL,21,70,6,16,22
7,8477953.0,Kasperi Kapanen,R,STL,27,73,6,16,22
7,8476885.0,Jacob Trouba,D,NYR,29,69,3,19,22
7,8480281.0,Alexey Toropchenko,R,STL,24,82,14,7,21
7,8482157.0,Will Cuylle,L,NYR,21,81,13,8,21
7,8478013.0,Jake Walman,D,DET,27,63,12,9,21
7,8475714.0,Calle Jarnkrok,C,TOR,32,52,10,11,21
7,8475220.0,Marcus Foligno,L,MIN,32,55,9,12,21
7,8471218.0,Blake Wheeler,R,NYR,37,54,9,12,21
7,8479359.0,Beck Malenstyn,L,WSH,25,81,6,15,21
7,8476897.0,Oskar Sundqvist,C,STL,29,71,6,15,21
7,8481178.0,Egor Zamula,D,PHI,23,66,5,16,21
7,8480891.0,Michael Kesselring,D,ARI,23,65,5,16,21
7,8479983.0,Mario Ferraro,D,SJS,25,78,3,18,21
7,8475225.0,Craig Smith,C,DAL,34,75,11,9,20
7,8476981.0,Josh Anderson,R,MTL,29,78,9,11,20
7,8475455.0,Brenden Dillon,D,WPG,33,77,8,12,20
7,8481577.0,Philip Tomasino,C,NSH,22,41,7,13,20
7,8477507.0,Nikita Zadorov,D,VAN,28,75,6,14,20
7,8475279.0,Ben Chiarot,D,DET,32,77,5,15,20
7,8478851.0,Alexandre Carrier,D,NSH,27,73,4,16,20
7,8480035.0,Henri Jokiharju,D,BUF,24,74,3,17,20
7,8480073.0,Erik Brannstrom,D,OTT,24,76,3,17,20
7,8475179.0,Dmitry Kulikov,D,FLA,33,76,1,19,20
7,8481554.0,Kaapo Kakko,R,NYR,22,61,13,6,19
7,8480980.0,Connor Dewar,C,MIN,24,74,11,8,19
7,8479415.0,Michael McLeod,C,NJD,25,45,10,9,19
7,8482097.0,Jack Quinn,R,BUF,22,27,9,10,19
7,8480144.0,David Kampf,C,TOR,28,78,8,11,19
7,8479353.0,Brett Howden,C,VGK,25,72,8,11,19
7,8475164.0,Jakob Silfverberg,R,ANA,33,81,7,12,19
7,8476889.0,Radek Faksa,C,DAL,29,74,7,12,19
7,8473504.0,Cal Clutterbuck,R,NYI,36,82,7,12,19
7,8475855.0,Jesper Fast,R,CAR,32,73,6,13,19
7,8477380.0,Jonny Brodzinski,C,NYR,30,57,6,13,19
7,8471699.0,Andrew Cogliano,C,COL,36,75,6,13,19
7,8477506.0,Ryan Pulock,D,NYI,29,58,5,14,19
7,8480172.0,Jan Rutta,D,SJS,33,69,5,14,19
7,8482073.0,Braden Schneider,D,NYR,22,82,5,14,19
7,8478432.0,Christian Fischer,R,DET,26,79,5,14,19
7,8479410.0,Mikhail Sergachev,D,TBL,25,34,2,17,19
7,8475690.0,Chris Tanev,D,CGY,34,75,2,17,19
7,8480878.0,Nils Lundkvist,D,DAL,23,59,2,17,19
7,8479316.0,Luke Kunin,C,SJS,26,77,11,7,18
7,8480289.0,Morgan Barron,C,WPG,25,80,11,7,18
7,8476374.0,Sean Kuraly,C,CBJ,30,62,9,9,18
7,8480448.0,Parker Kelly,L,OTT,24,80,8,10,18
7,8478434.0,Keegan Kolesar,R,VGK,26,79,8,10,18
7,8475462.0,Radko Gudas,D,ANA,33,66,6,12,18
7,8480220.0,Noah Cates,L,PHI,24,59,6,12,18
7,8476457.0,Adam Larsson,D,SEA,31,81,4,14,18
7,8477932.0,Aaron Ekblad,D,FLA,27,51,4,14,18
7,8477365.0,Connor Clifton,D,BUF,28,79,4,14,18
7,8476874.0,Olli Maatta,D,DET,29,72,4,14,18
7,8479398.0,Samuel Girard,D,COL,25,59,3,15,18
7,8479998.0,Mikey Anderson,D,LAK,24,74,2,16,18
7,8480049.0,Dylan Samberg,D,WPG,24,78,1,17,18
7,8478508.0,Yakov Trenin,C,NSH,26,76,12,5,17
7,8477903.0,Garnet Hathaway,R,PHI,32,82,7,10,17
7,8480995.0,Pontus Holmberg,R,TOR,24,54,7,10,17
7,8479315.0,Joey Anderson,R,CHI,25,55,5,12,17
7,8478463.0,Anthony Beauvillier,L,CHI,26,60,5,12,17
7,8474166.0,Alec Martinez,D,VGK,36,55,4,13,17
7,8481522.0,Peyton Krebs,C,BUF,22,80,4,13,17
7,8478859.0,Niko Mikkola,D,FLA,27,82,3,14,17
7,8479324.0,Ryan Lindgren,D,NYR,25,76,3,14,17
7,8481605.0,Jackson LaCombe,D,ANA,22,71,2,15,17
7,8479976.0,Juuso Valimaki,D,ARI,25,68,2,15,17
7,8470600.0,Ryan Suter,D,DAL,38,82,2,15,17
7,8480884.0,Calen Addison,D,SJS,23,72,1,16,17
7,8475842.0,Sam Carrick,C,ANA,31,77,10,6,16
7,8479977.0,Kailer Yamamoto,R,SEA,25,59,8,8,16
7,8473453.0,Trevor Lewis,C,LAK,36,82,8,8,16
7,8480205.0,Emil Bemstrom,R,CBJ,24,56,8,8,16
7,8479293.0,Brandon Tanev,L,SEA,32,66,7,9,16
7,8477444.0,Andre Burakovsky,L,SEA,28,49,7,9,16
7,8475208.0,Brian Dumoulin,D,SEA,32,80,6,10,16
7,8482660.0,Kent Johnson,C,CBJ,21,42,6,10,16
7,8477979.0,Nicolas Aube-Kubel,R,WSH,27,60,6,10,16
7,8476462.0,Dougie Hamilton,D,NJD,30,20,5,11,16
7,8482117.0,Lukas Reichel,L,CHI,21,65,5,11,16
7,8474034.0,Pat Maroon,L,MIN,35,51,4,12,16
7,8480796.0,Martin Fehervary,D,WSH,24,66,3,13,16
7,8476967.0,Brett Kulak,D,EDM,29,82,3,13,16
7,8471677.0,Jack Johnson,D,COL,36,80,3,13,16
7,8481568.0,Alex Vlasic,D,CHI,22,76,2,14,16
7,8476917.0,Adam Pelech,D,NYI,29,58,1,15,16
7,8479423.0,Alex Nylander,L,PIT,25,28,11,4,15
7,8478831.0,Kevin Stenlund,C,FLA,27,81,11,4,15
7,8470604.0,Jeff Carter,C,PIT,38,72,11,4,15
7,8477330.0,Dominik Kubalik,L,OTT,28,74,11,4,15
7,8476873.0,Mark Jankowski,C,NSH,29,32,7,8,15
7,8476393.0,Nick Cousins,C,FLA,30,69,7,8,15
7,8481560.0,Arthur Kaliyev,R,LAK,22,51,7,8,15
7,8481481.0,Blake Lizotte,C,LAK,26,62,7,8,15
7,8478109.0,Victor Olofsson,L,BUF,28,51,7,8,15
7,8481533.0,Trevor Zegras,C,ANA,22,31,6,9,15
7,8478042.0,Viktor Arvidsson,R,LAK,30,18,6,9,15
7,8474090.0,Brendan Smith,D,NJD,34,63,5,10,15
7,8477919.0,Frederick Gaudreau,C,MIN,30,67,5,10,15
7,8479368.0,Max Jones,L,ANA,25,52,5,10,15
7,8477839.0,Conor Sheary,L,TBL,31,57,4,11,15
7,8476467.0,Jamie Oleksiak,D,SEA,31,82,2,13,15
7,8475197.0,Tyson Barrie,D,NSH,32,41,1,14,15
7,8476878.0,Zemgus Girgensons,L,BUF,29,63,8,6,14
7,8480011.0,Klim Kostin,C,DET,24,52,8,6,14
7,8479661.0,Tanner Jeannot,L,TBL,26,55,7,7,14
7,8478468.0,Jeremy Lauzon,D,NSH,26,79,6,8,14
7,8480003.0,Jesper Boqvist,C,BOS,25,47,6,8,14
7,8479390.0,Taylor Raddysh,R,CHI,25,73,5,9,14
7,8477070.0,Liam O'Brien,C,ARI,29,75,5,9,14
7,8478443.0,Brandon Carlo,D,BOS,27,76,4,10,14
7,8480879.0,Jacob Bernard-Docker,D,OTT,23,72,4,10,14
7,8477392.0,Hudson Fasching,R,NYI,28,45,4,10,14
7,8477435.0,Ryan Graves,D,PIT,28,70,3,11,14
7,8474567.0,Zach Bogosian,D,MIN,33,65,3,11,14
7,8480887.0,Jordan Harris,D,MTL,23,56,3,11,14
7,8480727.0,Zach Whitecloud,D,VGK,27,61,2,12,14
7,8477220.0,Nate Schmidt,D,WPG,32,63,2,12,14
7,8475324.0,Nick Jensen,D,WSH,33,78,1,13,14
7,8480001.0,Urho Vaakanainen,D,ANA,24,68,1,13,14
7,8477845.0,Trevor van Riemsdyk,D,WSH,32,70,0,14,14
7,8482111.0,Justin Barron,D,MTL,22,48,7,6,13
7,8479383.0,Boris Katchouk,L,CHI,25,59,7,6,13
7,8477573.0,Nathan Walker,L,STL,29,45,7,6,13
7,8480192.0,Johnathan Kovacevic,D,MTL,26,62,6,7,13
7,8479996.0,Cody Glass,C,NSH,24,41,6,7,13
7,8481477.0,Nico Sturm,C,SJS,28,63,5,8,13
7,8476871.0,Tanner Pearson,L,MTL,31,54,5,8,13
7,8479520.0,Brandon Duhaime,R,MIN,26,80,5,8,13
7,8479402.0,Jake Bean,D,CBJ,25,72,4,9,13
7,8482222.0,Alexander Barabanov,L,SJS,29,46,4,9,13
7,8477488.0,Brett Pesce,D,CAR,29,70,3,10,13
7,8479371.0,Dante Fabbro,D,NSH,25,56,3,10,13
7,8478416.0,Erik Cernak,D,TBL,26,69,2,11,13
7,8476372.0,Nick Seeler,D,PHI,30,71,1,12,13
7,8481704.0,Juuso Parssinen,C,NSH,22,44,8,4,12
7,8476278.0,Colin Blackwell,C,CHI,30,44,8,4,12
7,8479336.0,Carl Grundstrom,R,LAK,26,50,8,4,12
7,8471709.0,Marc-Edouard Vlasic,D,SJS,36,57,6,6,12
7,8479393.0,Noah Gregor,C,TOR,25,63,6,6,12
7,8478421.0,A.J. Greer,L,CGY,27,59,6,6,12
7,8479671.0,Mathieu Olivier,R,CBJ,26,54,5,7,12
7,8477846.0,Ryan Carpenter,C,SJS,32,62,5,7,12
7,8478585.0,Derek Ryan,C,EDM,37,70,5,7,12
7,8479414.0,Nathan Bastian,R,NJD,26,54,5,7,12
7,8477015.0,Connor Brown,R,EDM,29,71,4,8,12
7,8476624.0,Barclay Goodrow,C,NYR,30,80,4,8,12
7,8477406.0,Mattias Janmark,C,EDM,31,71,4,8,12
7,8476919.0,Chris Tierney,C,NJD,29,52,4,8,12
7,8479543.0,Michael Pezzetta,L,MTL,25,61,3,9,12
7,8475825.0,Jani Hakanpää,D,DAL,31,64,2,10,12
7,8479980.0,Nicolas Hague,D,VGK,25,73,2,10,12
7,8476822.0,Luke Glendening,C,TBL,34,81,10,1,11
7,8482133.0,Thomas Bordeleau,C,SJS,21,27,6,5,11
7,8480806.0,Isac Lundestrom,C,ANA,24,46,5,6,11
7,8480025.0,MacKenzie Entwistle,R,CHI,24,67,5,6,11
7,8475750.0,Jon Merrill,D,MIN,31,65,4,7,11
7,8481567.0,Henry Thrun,D,SJS,22,51,3,8,11
7,8477950.0,Tony DeAngelo,D,CAR,28,31,3,8,11
7,8474013.0,Ian Cole,D,VAN,34,78,2,9,11
7,8476891.0,Matt Grzelcyk,D,BOS,29,63,2,9,11
7,8480058.0,Pierre-Olivier Joseph,D,PIT,24,52,2,9,11
7,8480860.0,Kevin Bahl,D,NJD,23,82,1,10,11
7,8479576.0,Vincent Desharnais,D,EDM,27,78,1,10,11
7,8470610.0,Zach Parise,L,COL,39,30,5,5,10
7,8476858.0,Phillip Di Giuseppe,L,VAN,30,51,5,5,10
7,8474040.0,Sam Gagner,C,EDM,34,28,5,5,10
7,8480355.0,Mark Kastelic,C,OTT,24,63,5,5,10
7,8482142.0,Jamie Drysdale,D,PHI,21,34,3,7,10
7,8480849.0,Barrett Hayton,C,ARI,23,33,3,7,10
7,8475177.0,Calvin de Haan,D,TBL,32,59,3,7,10
7,8482964.0,Arber Xhekaj,D,MTL,22,44,3,7,10
7,8477384.0,Josh Brown,D,ARI,29,51,3,7,10
7,8480184.0,Gustav Lindström,D,ANA,25,46,3,7,10
7,8480762.0,Eric Robinson,L,BUF,28,47,3,7,10
7,8477018.0,Ben Hutton,D,VGK,30,41,2,8,10
7,8481093.0,Rafael Harvey-Pinard,L,MTL,24,45,2,8,10
7,8480880.0,Jakub Lauko,C,BOS,23,60,2,8,10
7,8480871.0,Adam Boqvist,D,CBJ,23,35,1,9,10
7,8479369.0,Andrew Peeke,D,CBJ,25,38,1,9,10
7,8479982.0,Conor Timmins,D,TOR,25,25,1,9,10
7,8483460.0,David Jiricek,D,CBJ,20,43,1,9,10
7,8477971.0,Andreas Englund,D,LAK,27,82,1,9,10
7,8471274.0,Alex Goligoski,D,MIN,38,36,0,10,10
7,8479439.0,Jacob MacDonald,D,SJS,30,34,7,2,9
7,8479339.0,Patrik Laine,L,CBJ,25,18,6,3,9
7,8477353.0,Tyler Motte,C,TBL,28,69,6,3,9
7,8482077.0,Dylan Holloway,L,EDM,22,38,6,3,9
7,8479718.0,Alex Barré-Boulet,C,TBL,26,36,6,3,9
7,8477989.0,Christian Dvorak,C,MTL,27,30,5,4,9
7,8479328.0,Julien Gauthier,R,NYI,26,27,5,4,9
7,8479968.0,Vinni Lettieri,C,MIN,28,46,5,4,9
7,8476525.0,Colin Miller,D,NJD,31,46,4,5,9
7,8470966.0,Mark Giordano,D,TOR,40,46,3,6,9
7,8482679.0,Matt Coronato,R,CGY,21,34,3,6,9
7,8480008.0,Adam Ruzicka,C,ARI,24,42,3,6,9
7,8481641.0,Joel Kiviranta,L,COL,27,56,3,6,9
7,8478028.0,Fredrik Olofsson,L,COL,27,57,3,6,9
7,8480222.0,Sebastian Aho,D,NYI,27,58,2,7,9
7,8481708.0,Zac Jones,D,NYR,23,31,2,7,9
7,8476960.0,Andreas Athanasiou,C,CHI,29,28,2,7,9
7,8480848.0,Ty Dellandrea,C,DAL,23,42,2,7,9
7,8478099.0,Kevin Labanc,R,SJS,28,46,2,7,9
7,8478399.0,Jonas Siegenthaler,D,NJD,26,57,1,8,9
7,8481527.0,Kaedan Korczak,D,VGK,22,26,1,8,9
7,8481537.0,Nikita Okhotiuk,D,SJS,23,52,1,8,9
7,8475797.0,Jarred Tinordi,D,CHI,31,52,0,9,9
7,8479372.0,Josh Mahura,D,FLA,25,30,0,9,9
7,8477478.0,William Carrier,L,VGK,29,39,6,2,8
7,8480252.0,Cole Guttman,C,CHI,24,27,4,4,8
7,8481058.0,Jesse Ylönen,R,MTL,24,59,4,4,8
7,8474709.0,Matt Martin,L,NYI,34,57,4,4,8
7,8477541.0,Dakota Mermis,D,MIN,29,47,3,5,8
7,8478211.0,Dryden Hunt,L,CGY,28,28,3,5,8
7,8476473.0,Connor Murphy,D,CHI,30,46,2,6,8
7,8477335.0,Kyle Burroughs,D,SJS,28,73,2,6,8
7,8474618.0,Marco Scandella,D,STL,33,65,2,6,8
7,8476329.0,Travis Boyd,C,ARI,30,16,2,6,8
7,8480196.0,Jacob Bryson,D,BUF,26,36,1,7,8
7,8478450.0,Parker Wotherspoon,D,BOS,26,41,0,8,8
7,8480950.0,Ilya Lyubushkin,D,ANA,29,74,0,8,8
7,8479066.0,Ryan Lomberg,L,FLA,29,75,5,2,7
7,8478569.0,Noel Acciari,C,PIT,32,55,4,3,7
7,8477930.0,Pierre-Edouard Bellemare,L,SEA,38,40,4,3,7
7,8482241.0,Radim Zohorna,L,PIT,27,33,4,3,7
7,8482624.0,Daniil Miromanov,D,VGK,26,24,3,4,7
7,8479346.0,Dillon Dube,C,CGY,25,43,3,4,7
7,8482496.0,Nils Aman,C,VAN,23,43,3,4,7
7,8481019.0,David Gustafsson,C,WPG,23,39,3,4,7
7,8478408.0,Travis Dermott,D,ARI,27,50,2,5,7
7,8479458.0,Nikita Zaitsev,D,CHI,32,38,2,5,7
7,8481167.0,Brayden Pachal,D,CGY,24,50,2,5,7
7,8480084.0,Nick DeSimone,D,NJD,29,34,2,5,7
7,8482652.0,Walker Duehr,R,CGY,26,40,2,5,7
7,8480807.0,Mattias Samuelsson,D,BUF,23,41,1,6,7
7,8479442.0,Troy Stecher,D,ARI,29,54,1,6,7
7,8482516.0,Matthew Kessel,D,STL,23,39,1,6,7
7,8474568.0,Luke Schenn,D,NSH,34,63,1,6,7
7,8478454.0,Noah Juulsen,D,VAN,26,54,1,6,7
7,8478502.0,Dennis Gilbert,D,CGY,27,34,1,6,7
7,8478104.0,Sammy Blais,L,STL,27,53,1,6,7
7,8482176.0,Wyatt Kaiser,D,CHI,21,32,0,7,7
7,8473446.0,Erik Johnson,D,BUF,35,67,5,1,6
7,8471817.0,Ryan Reaves,R,TOR,36,49,4,2,6
7,8479370.0,Tyson Jost,C,BUF,25,43,3,3,6
7,8477369.0,Carson Soucy,D,VAN,29,40,2,4,6
7,8474612.0,Travis Hamonic,D,OTT,33,48,2,4,6
7,8482730.0,Brandt Clarke,D,LAK,20,16,2,4,6
7,8477944.0,Jakub Vrana,L,STL,27,21,2,4,6
7,8477931.0,Tomas Nosek,L,NJD,31,36,2,4,6
7,8480789.0,Oliver Wahlstrom,R,NYI,23,32,2,4,6
7,8481013.0,Jonatan Berggren,R,DET,23,12,2,4,6
7,8476441.0,Joel Edmundson,D,WSH,30,53,1,5,6
7,8482192.0,Isaak Phillips,D,CHI,22,33,0,6,6
7,8480078.0,Filip Chytil,C,NYR,24,10,0,6,6
7,8483524.0,Shane Wright,C,SEA,19,8,4,1,5
7,8477962.0,Brendan Lemieux,L,CAR,27,32,3,2,5
7,8481541.0,Samuel Bolduc,D,NYI,23,34,2,3,5
7,8481147.0,Reese Johnson,C,CHI,25,42,2,3,5
7,8481422.0,Jacob Lucchini,C,MIN,28,40,2,3,5
7,8479536.0,Axel Jonsson-Fjallby,L,WPG,25,26,2,3,5
7,8481122.0,Simon Benoit,D,TOR,25,64,1,4,5
7,8477938.0,Haydn Fleury,D,TBL,27,24,1,4,5
7,8477810.0,Joel Hanley,D,DAL,32,42,1,4,5
7,8471686.0,Marc Staal,D,PHI,36,35,1,4,5
7,8474009.0,Nick Bonino,C,NYR,35,45,1,4,5
7,8476952.0,Dominic Toninato,C,WPG,29,15,1,4,5
7,8479547.0,Matthew Phillips,R,PIT,25,31,1,4,5
7,8480245.0,Olle Lycksell,R,PHI,24,18,1,4,5
7,8474716.0,Jared Spurgeon,D,MIN,34,16,0,5,5
7,8475906.0,John Klingberg,D,TOR,31,14,0,5,5
7,8476429.0,Scott Mayfield,D,NYI,31,41,0,5,5
7,8475718.0,Justin Holl,D,DET,31,38,0,5,5
7,8478452.0,Caleb Jones,D,COL,26,25,0,5,5
7,8479291.0,Kevin Rooney,C,CGY,30,33,3,1,4
7,8479344.0,Jesse Puljujarvi,R,PIT,25,22,3,1,4
7,8478051.0,Max Willman,C,NJD,28,18,3,1,4
7,8475791.0,Taylor Hall,L,CHI,32,10,2,2,4
7,8481056.0,Spencer Stastney,D,NSH,23,20,2,2,4
7,8476867.0,Brendan Gaunce,C,CBJ,29,24,2,2,4
7,8479981.0,Jonah Gadjovich,L,FLA,25,39,2,2,4
7,8475766.0,Austin Watson,L,TBL,31,33,2,2,4
7,8477499.0,Rasmus Ristolainen,D,PHI,29,31,1,3,4
7,8478451.0,Ethan Bear,D,WSH,26,24,1,3,4
7,8481609.0,Vladislav Kolyachonok,D,ARI,22,5,1,3,4
7,8477244.0,Chad Ruhwedel,D,PIT,33,52,1,3,4
7,8476442.0,Matt Nieto,L,PIT,31,22,1,3,4
7,8479994.0,Jaret Anderson-Dolan,C,LAK,24,31,1,3,4
7,8475752.0,Tyler Pitlick,C,NYR,32,34,1,3,4
7,8481532.0,Alex Turcotte,C,LAK,22,20,1,3,4
7,8477527.0,Ross Johnston,L,ANA,29,68,1,3,4
7,8475235.0,Nicolas Deslauriers,L,PHI,32,60,1,3,4
7,8476913.0,Devin Shore,C,SEA,29,21,1,3,4
7,8479379.0,Givani Smith,R,SJS,25,36,1,3,4
7,8475762.0,Derek Forbort,D,BOS,31,35,0,4,4
7,8478424.0,Jansen Harkins,C,PIT,26,45,0,4,4
7,8480441.0,Trey Fix-Wolansky,R,CBJ,24,11,2,1,3
7,8478078.0,Rourke Chartier,C,OTT,27,37,2,1,3
7,8480776.0,Sheldon Rempal,R,VGK,28,9,2,1,3
7,8480468.0,James Hamblin,L,EDM,24,31,2,1,3
7,8479772.0,Zack MacEwen,R,OTT,27,30,2,1,3
7,8477073.0,Kurtis MacDermid,D,COL,29,45,2,1,3
7,8480823.0,Alexander Alexeyev,D,WSH,24,39,1,2,3
7,8480007.0,Jonas Rondbjerg,R,VGK,24,20,1,2,3
7,8476934.0,Brock McGinn,L,ANA,29,24,1,2,3
7,8478409.0,Anthony Richard,C,BOS,27,9,1,2,3
7,8483570.0,Ben Meyers,C,COL,25,23,1,2,3
7,8476994.0,Vinnie Hinostroza,C,PIT,29,14,1,2,3
7,8481592.0,Jakob Pelletier,L,CGY,22,13,1,2,3
7,8478904.0,Steven Lorentz,C,FLA,27,38,1,2,3
7,8479972.0,Mason Shaw,C,MIN,25,20,1,2,3
7,8480853.0,Liam Foudy,C,NSH,23,13,0,3,3
7,8482762.0,Simon Edvinsson,D,DET,20,16,1,1,2
7,8482101.0,Danil Gushchin,L,SJS,21,4,1,1,2
7,8479378.0,Logan Stanley,D,WPG,25,25,1,1,2
7,8481006.0,Tyler Tucker,D,STL,23,26,1,1,2
7,8478495.0,Denis Gurianov,R,NSH,26,18,1,1,2
7,8479362.0,Riley Tufte,L,COL,25,5,1,1,2
7,8480292.0,Carson Meyer,R,CBJ,26,14,1,1,2
7,8477454.0,Adam Erne,L,EDM,28,24,1,1,2
7,8475780.0,Chris Wagner,R,BOS,32,13,1,1,2
7,8476988.0,Matt Benning,D,SJS,29,14,0,2,2
7,8477034.0,Jaycob Megna,D,CHI,31,44,0,2,2
7,8481521.0,Ronnie Attard,D,PHI,24,12,0,2,2
7,8480070.0,Ian Mitchell,D,BOS,24,13,0,2,2
7,8477851.0,Jordan Oesterle,D,CGY,31,22,0,2,2
7,8481161.0,Jake Christiansen,D,CBJ,24,12,0,2,2
7,8482451.0,Mikael Pyyhtia,L,CBJ,22,17,0,2,2
7,8473473.0,Milan Lucic,L,BOS,35,4,0,2,2
7,8480870.0,Bo Groulx,C,ANA,23,45,0,2,2
7,8481598.0,Philip Broberg,D,EDM,22,12,0,2,2
7,8477464.0,Nic Petan,C,MIN,28,6,0,2,2
7,8481617.0,Vasily Podkolzin,R,VAN,22,19,0,2,2
7,8481751.0,Lukas Rousek,R,BUF,24,15,0,2,2
7,8481550.0,Adam Beckman,L,MIN,22,11,0,2,2
7,8481523.0,Kirby Dach,C,MTL,22,2,0,2,2
7,8481543.0,Nikita Alexandrov,C,STL,23,23,0,2,2
7,8478146.0,Matthew Highmore,C,OTT,27,7,0,2,2
7,8481043.0,Cole Koepke,L,TBL,25,9,0,2,2
7,8483565.0,Nick Blankenburg,D,CBJ,25,12,1,0,1
7,8483397.0,Marc McLaughlin,C,BOS,24,1,1,0,1
7,8480874.0,Adam Ginning,D,PHI,23,9,1,0,1
7,8481754.0,Nikita Nesterenko,C,ANA,22,3,1,0,1
7,8480021.0,Jack Studnicka,C,SJS,24,22,1,0,1
7,8481518.0,Nolan Foote,L,NJD,23,4,1,0,1
7,8479421.0,Jacob Moverare,D,LAK,25,24,1,0,1
7,8481239.0,Samuel Fagemo,L,LAK,23,8,1,0,1
7,8479546.0,Oskar Steen,C,BOS,25,34,1,0,1
7,8480836.0,Jonathan Gruden,C,PIT,23,13,1,0,1
7,8481077.0,John Leonard,L,NSH,25,6,1,0,1
7,8482147.0,Jean-Luc Foudy,C,COL,21,4,1,0,1
7,8474053.0,Logan Couture,C,SJS,34,6,0,1,1
7,8481812.0,Nikolai Knyzhov,D,SJS,26,10,0,1,1
7,8479984.0,Cal Foote,D,NJD,25,4,0,1,1
7,8479321.0,Lucas Johansen,D,WSH,26,6,0,1,1
7,8473563.0,Nicklas Backstrom,C,WSH,36,8,0,1,1
7,8479320.0,Max Lajoie,D,TOR,26,7,0,1,1
7,8482095.0,Tyler Kleven,D,OTT,21,9,0,1,1
7,8480157.0,Calle Rosen,D,STL,29,6,0,1,1
7,8480031.0,Max Comtois,L,ANA,24,1,0,1,1
7,8478017.0,Mark Friedman,D,VAN,28,23,0,1,1
7,8479348.0,Kale Clague,D,BUF,25,3,0,1,1
7,8475278.0,Byron Froese,C,VGK,32,16,0,1,1
7,8475795.0,Dylan McIlrath,D,WSH,31,3,0,1,1
7,8480845.0,Rasmus Kupari,C,WPG,23,28,0,1,1
7,8480890.0,Jan Jenik,R,ARI,23,5,0,1,1
7,8477887.0,Patrick Brown,C,BOS,31,11,0,1,1
7,8478512.0,Austin Czarnik,C,DET,31,34,0,1,1
7,8479367.0,William Lockwood,R,FLA,25,26,0,1,1
7,8483597.0,Milos Kelemen,L,ARI,24,10,0,1,1
7,8477126.0,Jayson Megna,C,ANA,33,1,0,0,0
7,8479639.0,Dylan Coghlan,D,CAR,25,1,0,0,0
7,8482067.0,Connor Mackey,D,NYR,27,1,0,0,0
7,8476856.0,Matt Dumba,D,ARI,29,0,0,0,0
7,8478483.0,Mitchell Marner,R,TOR,26,0,0,0,0
7,8471873.0,Anton Stralman,D,BOS,37,0,0,0,0
7,8474162.0,Jake Muzzin,D,TOR,34,0,0,0,0
7,8470638.0,Patrice Bergeron,C,BOS,38,0,0,0,0
7,8473604.0,Jonathan Toews,C,CHI,35,0,0,0,0
7,8471276.0,David Krejci,C,BOS,37,0,0,0,0
7,8474207.0,Nick Holden,D,OTT,36,0,0,0,0
7,8475747.0,Patrik Nemeth,D,ARI,31,0,0,0,0
7,8477467.0,Gustav Olofsson,D,SEA,29,1,0,0,0
7,8479514.0,Rem Pitlick,C,CHI,26,9,0,0,0
7,8474027.0,Justin Braun,D,PHI,36,0,0,0,0
7,8481599.0,Victor Soderstrom,D,ARI,22,3,0,0,0
7,8474161.0,Jakub Voracek,R,CBJ,34,0,0,0,0
7,8479985.0,Cale Fleury,D,SEA,25,1,0,0,0
7,8471303.0,Alexander Edler,D,LAK,37,0,0,0,0
7,8474573.0,Josh Bailey,R,NYI,34,0,0,0,0
7,8483619.0,Filip Roos,D,CHI,24,4,0,0,0
7,8474818.0,Jordie Benn,D,TOR,36,0,0,0,0
7,8476449.0,Scott Harrington,D,ANA,30,0,0,0,0
7,8483620.0,Marcus Bjork,D,CBJ,26,0,0,0,0
7,8470595.0,Eric Staal,C,FLA,39,0,0,0,0
7,8481585.0,Egor Afanasyev,L,NSH,22,2,0,0,0
7,8482712.0,Oskar Olausson,R,COL,21,1,0,0,0
7,8481072.0,Tim Berni,D,CBJ,23,0,0,0,0
7,8479945.0,Gavin Bayreuther,D,CBJ,29,0,0,0,0
7,8481600.0,Tobias Bjornfot,D,VGK,22,4,0,0,0
7,8481679.0,Maxence Guenette,D,OTT,22,7,0,0,0
7,8474683.0,Derek Grant,C,ANA,33,0,0,0,0
7,8476470.0,Nathan Beaulieu,D,ANA,31,0,0,0,0
7,8474145.0,Robert Bortuzzo,D,NYI,34,27,0,0,0
7,8480216.0,Jacob Peterson,C,SJS,24,6,0,0,0
7,8473548.0,Phil Kessel,R,VGK,36,0,0,0,0
7,8480160.0,Radim Simek,D,SJS,31,0,0,0,0
7,8480883.0,Ty Smith,D,PIT,23,0,0,0,0
7,8471669.0,Paul Stastny,C,CAR,38,0,0,0,0
7,8475227.0,Chris Wideman,D,MTL,33,0,0,0,0
7,8480913.0,Jordan Gross,D,NSH,28,0,0,0,0
7,8475625.0,Matt Irwin,D,WSH,36,0,0,0,0
7,8479388.0,Riley Stillman,D,BUF,25,0,0,0,0
7,8474628.0,Michael Stone,D,CGY,33,0,0,0,0
7,8484254.0,Akito Hirose,D,VAN,24,3,0,0,0
7,8477941.0,Nick Ritchie,L,CGY,28,0,0,0,0
7,8477462.0,Robert Hagg,D,ANA,28,5,0,0,0
7,8478062.0,Dysin Mayo,D,ARI,27,0,0,0,0
7,8482634.0,Alex Steeves,C,TOR,24,1,0,0,0
7,8477433.0,Ben Harpur,D,NYR,28,0,0,0,0
7,8478841.0,Colton White,D,ANA,26,0,0,0,0
7,8473544.0,Derick Brassard,C,OTT,36,0,0,0,0
7,8476884.0,Derrick Pouliot,D,SJS,29,5,0,0,0
7,8479376.0,Victor Mete,D,PHI,25,1,0,0,0
7,8483630.0,Pavol Regenda,L,ANA,24,5,0,0,0
7,8479026.0,Philippe Myers,D,TBL,26,5,0,0,0
7,8477482.0,Zach Sanford,L,CHI,29,0,0,0,0
7,8477359.0,Tucker Poolman,D,VAN,30,0,0,0,0
7,8475857.0,Kevin Gravel,D,NSH,31,0,0,0,0
7,8476779.0,Brad Hunt,D,COL,35,0,0,0,0
7,8476850.0,Ryan Murray,D,EDM,30,0,0,0,0
7,8477341.0,Andreas Johnsson,L,SJS,29,0,0,0,0
7,8474218.0,Jason Demers,D,EDM,35,0,0,0,0
7,8480844.0,Grigori Denisenko,L,VGK,23,6,0,0,0
7,8484287.0,Cole McWard,D,VAN,22,1,0,0,0
7,8479322.0,Wade Allison,R,PHI,26,0,0,0,0
7,8478846.0,Christian Wolanin,D,VAN,28,0,0,0,0
7,8471887.0,Patric Hornqvist,R,FLA,36,0,0,0,0
7,8475163.0,Alex Chiasson,R,DET,33,0,0,0,0
7,8478881.0,Brett Seney,L,CHI,27,4,0,0,0
7,8474697.0,Mark Borowiecki,D,NSH,34,0,0,0,0
7,8476410.0,Josh Leivo,L,STL,30,0,0,0,0
7,8475968.0,Alex Belzile,R,MTL,32,0,0,0,0
7,8479580.0,Dylan Gambrell,C,OTT,27,0,0,0,0
7,8480901.0,Karson Kuhlman,C,WPG,28,0,0,0,0
7,8480326.0,Sheldon Dries,C,VAN,29,0,0,0,0
7,8478465.0,Guillaume Brisebois,D,VAN,26,0,0,0,0
7,8482861.0,Vincent Iorio,D,WSH,21,6,0,0,0
7,8471794.0,Darren Helm,C,COL,36,0,0,0,0
7,8479335.0,Rasmus Asplund,C,NSH,26,0,0,0,0
7,8478415.0,Jakub Zboril,D,BOS,26,0,0,0,0
7,8476310.0,Lukas Sedlak,C,PHI,30,0,0,0,0
7,8478075.0,Anders Bjork,L,CHI,27,0,0,0,0
7,8480267.0,Sammy Walker,C,MIN,24,4,0,0,0
7,8479578.0,Casey Fitzgerald,D,FLA,26,0,0,0,0
7,8480032.0,Shane Bowers,C,NJD,24,8,0,0,0
7,8478400.0,Colin White,C,PIT,26,28,0,0,0
7,8478431.0,Evgeny Svechnikov,L,SJS,27,0,0,0,0
7,8475772.0,Riley Sheahan,C,BUF,32,0,0,0,0
7,8481690.0,Tyler Angle,C,CBJ,23,2,0,0,0
7,8476326.0,Josh Archibald,R,PIT,31,0,0,0,0
7,8478843.0,Denis Malgin,C,COL,26,0,0,0,0
7,8478446.0,Glenn Gawdin,C,ANA,26,1,0,0,0
7,8477357.0,Saku Maenalanen,R,WPG,29,0,0,0,0
7,8478870.0,Rudolfs Balcers,L,TBL,26,0,0,0,0
7,8478476.0,Kyle Capobianco,D,WPG,26,0,0,0,0
7,8476439.0,Brett Ritchie,R,ARI,30,0,0,0,0
7,8474613.0,Derek Stepan,C,CAR,33,0,0,0,0
7,8475178.0,Zack Kassian,R,ARI,32,0,0,0,0
7,8480226.0,Marián Studenic,R,SEA,25,2,0,0,0
7,8481070.0,Hugh McGing,L,STL,25,5,0,0,0
7,8482250.0,Callahan Burke,C,CAR,26,1,0,0,0
7,8481591.0,Sam Poulin,R,PIT,22,3,0,0,0
7,8481441.0,Joe Snively,C,WSH,27,3,0,0,0
7,8478967.0,Lane Pederson,C,CBJ,26,0,0,0,0
7,8479333.0,Libor Hajek,D,NYR,25,0,0,0,0
7,8480833.0,Vitali Kravtsov,R,VAN,24,0,0,0,0
7,8477460.0,Laurent Dauphin,C,ARI,28,0,0,0,0
7,8481461.0,Corey Schueneman,D,MTL,28,0,0,0,0
7,8474190.0,Wayne Simmonds,R,TOR,35,0,0,0,0
7,8483549.0,Lucas Condotta,L,MTL,26,3,0,0,0
7,8477993.0,Justin Kirkland,C,ARI,27,2,0,0,0
7,8480935.0,Lawrence Pilut,D,BUF,28,0,0,0,0
7,8477210.0,Buddy Robinson,R,CHI,32,0,0,0,0
7,8476851.0,Alex Galchenyuk,C,COL,29,0,0,0,0
7,8482197.0,Adam Raska,R,MIN,22,5,0,0,0
7,8479366.0,Logan Brown,C,STL,25,0,0,0,0
7,8479356.0,Kieffer Bellows,L,PHI,25,0,0,0,0
7,8479533.0,Joona Koppanen,L,PIT,25,4,0,0,0
7,8477401.0,John Hayden,C,SEA,28,2,0,0,0
7,8480822.0,Martin Kaut,R,SJS,24,0,0,0,0
7,8474610.0,Zac Dalpe,C,FLA,34,0,0,0,0
7,8482399.0,Billy Sweezey,D,CBJ,27,0,0,0,0
7,8479991.0,Jake Leschyshyn,C,NYR,24,1,0,0,0
7,8479550.0,Tanner Laczynski,C,PHI,26,0,0,0,0
7,8476166.0,Taylor Fedun,D,PIT,35,0,0,0,0
7,8479338.0,Markus Niemelainen,D,EDM,25,0,0,0,0
7,8477320.0,Anton Blidh,L,NYR,28,1,0,0,0
7,8478147.0,Bokondji Imama,L,ARI,27,6,0,0,0
7,8478067.0,Oskar Lindblom,L,SJS,27,1,0,0,0
7,8478506.0,Gabriel Carlsson,D,WSH,26,0,0,0,0
7,8478131.0,Ondrej Kase,R,CAR,28,0,0,0,0
7,8479644.0,Matt Luff,R,DET,26,0,0,0,0
7,8482824.0,Nick Cicek,D,SJS,23,0,0,0,0
7,8482834.0,Jesper Froden,R,SEA,29,0,0,0,0
7,8478491.0,Jacob Larsson,D,OTT,26,0,0,0,0
7,8474089.0,Brad Malone,C,EDM,34,0,0,0,0
7,8482641.0,Matt Kiersted,D,FLA,25,0,0,0,0
7,8480071.0,Robin Salo,D,NYI,25,0,0,0,0
7,8475461.0,Andrew Agozzino,L,SJS,32,0,0,0,0
7,8475160.0,Kyle Clifford,L,TOR,32,0,0,0,0
7,8480056.0,Jack Rathbone,D,VAN,24,0,0,0,0
7,8481725.0,Elmer Soderblom,L,DET,22,0,0,0,0
7,8479465.0,Drake Caggiula,L,PIT,29,0,0,0,0
7,8476948.0,Charles Hudon,L,COL,29,0,0,0,0
7,8479523.0,Lucas Carlsson,D,FLA,26,0,0,0,0
7,8478455.0,Austin Wagner,L,CHI,26,0,0,0,0
7,8481572.0,Ville Heinola,D,WPG,22,0,0,0,0
7,8479404.0,Henrik Borgstrom,C,WSH,26,0,0,0,0
7,8479944.0,Zach Aston-Reese,C,DET,29,3,0,0,0
7,8482635.0,Mike Hardman,L,CHI,24,0,0,0,0
7,8479705.0,Jeffrey Viel,L,SJS,26,0,0,0,0
7,8480467.0,Austin Strand,D,ANA,26,0,0,0,0
7,8480037.0,Aleksi Heponiemi,C,FLA,24,0,0,0,0
7,8479573.0,Mikhail Maltsev,L,COL,25,0,0,0,0
7,8476404.0,Andy Andreoff,C,NYI,32,0,0,0,0
7,8484125.0,Hunter McKown,C,CBJ,21,0,0,0,0
7,8481649.0,Joona Luoto,L,CBJ,26,0,0,0,0
7,8477981.0,Roland McKeown,D,NSH,27,0,0,0,0
7,8480831.0,Alec Regula,D,CHI,23,0,0,0,0
7,8482691.0,Aatu Raty,C,VAN,21,0,0,0,0
7,8482623.0,Josh Dunne,C,CBJ,25,0,0,0,0
7,8481433.0,Taro Hirose,L,DET,27,0,0,0,0
7,8480328.0,David Gust,R,CHI,29,0,0,0,0
7,8479526.0,Otto Koivula,L,NYI,25,0,0,0,0
7,8476390.0,Joseph Cramarossa,C,MIN,31,0,0,0,0
7,8482654.0,Jackson Cates,C,PHI,26,0,0,0,0
7,8480439.0,Mac Hollowell,D,TOR,25,0,0,0,0
7,8480072.0,Lias Andersson,C,LAK,25,0,0,0,0
7,8479395.0,Dennis Cholowski,D,NYI,25,0,0,0,0
7,8477463.0,Steven Santini,D,STL,28,0,0,0,0
7,8479347.0,Tyler Benson,L,EDM,25,0,0,0,0
7,8477471.0,Dillon Heatherington,D,OTT,28,0,0,0,0
7,8477520.0,Jean-Sebastien Dea,C,ARI,29,0,0,0,0
7,8480846.0,Sampo Ranta,L,COL,23,0,0,0,0
7,8480979.0,Nathan Smith,C,ARI,25,0,0,0,0
7,8484256.0,Jake Livingstone,D,NSH,24,0,0,0,0
7,8476396.0,Steven Fogarty,C,MIN,30,0,0,0,0
7,8479252.0,Dan Renouf,D,BOS,29,0,0,0,0
7,8479518.0,Fredrik Karlström,C,DAL,25,0,0,0,0
7,8481683.0,Aidan McDonough,L,VAN,24,0,0,0,0
7,8478373.0,Nikita Soshnikov,R,NYI,30,0,0,0,0
7,8482081.0,Sean Farrell,C,MTL,22,0,0,0,0
7,8481575.0,Lassi Thomson,D,OTT,23,0,0,0,0
7,8481102.0,Egor Sokolov,L,OTT,23,0,0,0,0
7,8481712.0,Matej Blumel,R,DAL,23,0,0,0,0
7,8479602.0,Jeremy Davies,D,BUF,27,0,0,0,0
7,8480443.0,Kristian Reichel,C,WPG,25,0,0,0,0
7,8479304.0,Kyle Criscuolo,C,SJS,31,0,0,0,0
7,8478224.0,Luke Philp,C,CHI,28,0,0,0,0
7,8480242.0,Arnaud Durandeau,L,NYI,24,0,0,0,0
7,8479329.0,Frederic Allard,D,MTL,26,0,0,0,0
7,8476941.0,Connor Carrick,D,BOS,29,0,0,0,0
7,8479375.0,William Bitten,C,STL,25,0,0,0,0
7,8481720.0,Nick Abruzzese,C,TOR,24,0,0,0,0
7,8482452.0,Elliot Desnoyers,L,PHI,21,0,0,0,0
7,8476915.0,Jujhar Khaira,L,MIN,29,1,0,0,0
7,8483641.0,Anton Levtchi,L,FLA,28,0,0,0,0
7,8481740.0,Tyce Thompson,R,NJD,24,0,0,0,0
7,8478173.0,Hayden Hodgson,R,PHI,27,0,0,0,0
7,8482181.0,Tristen Robins,C,SJS,22,0,0,0,0
7,8481563.0,Drew Helleson,D,ANA,22,0,0,0,0
7,8480863.0,Gabriel Fortier,L,TBL,23,0,0,0,0
7,8478058.0,CJ Suess,L,SJS,29,0,0,0,0
7,8480041.0,Dmitri Samorukov,D,STL,24,0,0,0,0
7,8482179.0,Justin Richards,C,CBJ,25,0,0,0,0
7,8480034.0,Joel Teasdale,L,MTL,24,0,0,0,0
7,8480820.0,Filip Kral,D,TOR,24,0,0,0,0
7,8480842.0,Filip Hallander,C,PIT,23,0,0,0,0
7,8478367.0,Cole Bardreau,C,NYI,30,0,0,0,0
7,8482448.0,Samuel Knazko,D,CBJ,21,0,0,0,0
7,8482711.0,Stanislav Svozil,D,CBJ,20,0,0,0,0
7,8480275.0,Nick Swaney,R,MIN,26,0,0,0,0
7,8480994.0,Damien Giroux,C,MIN,23,0,0,0,0
7,8480977.0,Semyon Der-Arguchintsev,C,TOR,23,0,0,0,0
7,8482207.0,William Dufour,R,NYI,21,0,0,0,0
7,8483464.0,Marco Kasper,C,DET,19,0,0,0,0
7,8483424.0,Owen Beck,C,MTL,19,0,0,0,0
8,8476453.0,Nikita Kucherov,R,TBL,30,81,44,100,144
8,8477492.0,Nathan MacKinnon,C,COL,28,82,51,89,140
8,8478402.0,Connor McDavid,C,EDM,26,76,32,100,132
8,8478550.0,Artemi Panarin,L,NYR,32,82,49,71,120
8,8477956.0,David Pastrnak,R,BOS,27,82,47,63,110
8,8479318.0,Auston Matthews,C,TOR,26,81,69,38,107
8,8477934.0,Leon Draisaitl,C,EDM,28,81,41,65,106
8,8478420.0,Mikko Rantanen,R,COL,27,80,42,62,104
8,8476468.0,J.T. Miller,C,VAN,30,81,37,66,103
8,8477939.0,William Nylander,R,TOR,27,82,40,58,98
8,8478864.0,Kirill Kaprizov,L,MIN,26,75,46,50,96
8,8477933.0,Sam Reinhart,C,FLA,28,82,57,37,94
8,8476887.0,Filip Forsberg,L,NSH,29,82,48,46,94
8,8471675.0,Sidney Crosby,C,PIT,36,82,42,52,94
8,8480800.0,Quinn Hughes,D,VAN,24,82,17,75,92
8,8478010.0,Brayden Point,C,TBL,27,81,46,44,90
8,8480069.0,Cale Makar,D,COL,25,77,21,69,90
8,8478427.0,Sebastian Aho,C,CAR,26,78,36,53,89
8,8480012.0,Elias Pettersson,C,VAN,25,82,34,55,89
8,8479314.0,Matthew Tkachuk,L,FLA,26,80,26,62,88
8,8480023.0,Robert Thomas,C,STL,24,82,26,60,86
8,8474600.0,Roman Josi,D,NSH,33,82,23,62,85
8,8479407.0,Jesper Bratt,L,NJD,25,82,27,56,83
8,8480803.0,Evan Bouchard,D,EDM,24,81,18,64,82
8,8474564.0,Steven Stamkos,C,TBL,33,79,40,41,81
8,8480027.0,Jason Robertson,L,DAL,24,82,29,51,80
8,8478445.0,Mathew Barzal,C,NYI,26,80,23,57,80
8,8477493.0,Aleksander Barkov,C,FLA,28,73,23,57,80
8,8475786.0,Zach Hyman,L,EDM,31,80,54,23,77
8,8480018.0,Nick Suzuki,C,MTL,24,82,33,44,77
8,8477404.0,Jake Guentzel,L,PIT,29,67,30,47,77
8,8476389.0,Vincent Trocheck,C,NYR,30,82,25,52,77
8,8479343.0,Clayton Keller,R,ARI,25,78,33,43,76
8,8475167.0,Victor Hedman,D,TBL,33,78,13,63,76
8,8475184.0,Chris Kreider,L,NYR,32,82,39,36,75
8,8475172.0,Nazem Kadri,C,CGY,33,82,29,46,75
8,8477960.0,Adrian Kempe,R,LAK,27,77,28,47,75
8,8479542.0,Brandon Hagel,L,TBL,25,82,26,49,75
8,8474679.0,Gustav Nyquist,C,NSH,34,81,23,52,75
8,8480801.0,Brady Tkachuk,L,OTT,24,81,37,37,74
8,8481559.0,Jack Hughes,C,NJD,22,62,27,47,74
8,8478444.0,Brock Boeser,R,VAN,26,81,40,33,73
8,8477942.0,Kevin Fiala,L,LAK,27,82,29,44,73
8,8479323.0,Adam Fox,D,NYR,25,72,17,56,73
8,8477409.0,Carter Verhaeghe,C,FLA,28,76,34,38,72
8,8482078.0,Lucas Raymond,L,DET,21,82,31,41,72
8,8476459.0,Mika Zibanejad,C,NYR,30,81,26,46,72
8,8476460.0,Mark Scheifele,C,WPG,30,74,25,47,72
8,8471685.0,Anze Kopitar,C,LAK,36,81,26,44,70
8,8482116.0,Tim Stützle,C,OTT,21,75,18,52,70
8,8480865.0,Noah Dobson,D,NYI,23,79,10,60,70
8,8476539.0,Jonathan Marchessault,R,VGK,33,82,42,27,69
8,8475754.0,Brock Nelson,C,NYI,32,82,34,35,69
8,8477946.0,Dylan Larkin,C,DET,27,68,33,36,69
8,8475158.0,Ryan O'Reilly,C,NSH,32,82,26,43,69
8,8477504.0,Josh Morrissey,D,WPG,28,81,10,59,69
8,8478439.0,Travis Konecny,R,PHI,26,76,33,35,68
8,8477500.0,Bo Horvat,C,NYI,28,81,33,35,68
8,8478403.0,Jack Eichel,C,VGK,27,63,31,37,68
8,8481557.0,Matt Boldy,L,MIN,22,75,29,39,68
8,8482093.0,Seth Jarvis,C,CAR,21,81,33,34,67
8,8479385.0,Jordan Kyrou,C,STL,25,82,31,36,67
8,8473419.0,Brad Marchand,L,BOS,35,82,29,38,67
8,8480002.0,Nico Hischier,C,NJD,24,71,27,40,67
8,8471215.0,Evgeni Malkin,C,PIT,37,82,27,40,67
8,8478440.0,Dylan Strome,C,WSH,26,82,27,40,67
8,8479337.0,Alex DeBrincat,R,DET,26,82,27,40,67
8,8470794.0,Joe Pavelski,C,DAL,39,82,27,40,67
8,8476454.0,Ryan Nugent-Hopkins,C,EDM,30,80,18,49,67
8,8480208.0,Drake Batherson,R,OTT,25,82,28,38,66
8,8482740.0,Wyatt Johnston,C,DAL,20,82,32,33,65
8,8471214.0,Alex Ovechkin,L,WSH,38,79,31,34,65
8,8478449.0,Roope Hintz,C,DAL,27,80,30,35,65
8,8475166.0,John Tavares,C,TOR,33,80,29,36,65
8,8481540.0,Cole Caufield,R,MTL,22,82,28,37,65
8,8475168.0,Matt Duchene,C,DAL,32,80,25,40,65
8,8478493.0,Joel Eriksson Ek,C,MIN,26,77,30,34,64
8,8473512.0,Claude Giroux,R,OTT,35,82,21,43,64
8,8477402.0,Pavel Buchnevich,L,STL,28,80,27,36,63
8,8475692.0,Mats Zuccarello,R,MIN,36,69,12,51,63
8,8477955.0,Jared McCann,L,SEA,27,80,29,33,62
8,8476875.0,Mike Matheson,D,MTL,29,82,11,51,62
8,8478398.0,Kyle Connor,L,WPG,27,65,34,27,61
8,8477940.0,Nikolaj Ehlers,L,WPG,27,82,25,36,61
8,8477951.0,Nick Schmaltz,C,ARI,27,79,22,39,61
8,8478366.0,Frank Vatrano,R,ANA,29,82,37,23,60
8,8476448.0,William Karlsson,C,VGK,30,70,30,30,60
8,8475745.0,Charlie Coyle,C,BOS,31,82,25,35,60
8,8473994.0,Jamie Benn,L,DAL,34,82,21,39,60
8,8475798.0,Mikael Granlund,C,SJS,31,69,12,48,60
8,8476346.0,Johnny Gaudreau,L,CBJ,30,81,12,48,60
8,8481068.0,Yegor Sharangovich,C,CGY,25,82,31,28,59
8,8477497.0,Sean Monahan,C,WPG,29,83,26,33,59
8,8477949.0,Alex Tuch,R,BUF,27,75,22,37,59
8,8478401.0,Pavel Zacha,C,BOS,26,78,21,38,59
8,8480839.0,Rasmus Dahlin,D,BUF,23,81,20,39,59
8,8477416.0,Oliver Bjorkstrand,R,SEA,28,82,20,39,59
8,8476853.0,Morgan Rielly,D,TOR,29,72,7,51,58
8,8479675.0,Trevor Moore,L,LAK,28,82,31,26,57
8,8482109.0,Alexis Lafrenière,L,NYR,22,82,28,29,57
8,8479999.0,Casey Mittelstadt,C,BUF,25,80,18,39,57
8,8481711.0,Matias Maccelli,L,ARI,23,82,17,40,57
8,8478460.0,Zach Werenski,D,CBJ,26,70,11,46,57
8,8479420.0,Tage Thompson,C,BUF,26,71,29,27,56
8,8475810.0,Bryan Rust,R,PIT,31,62,28,28,56
8,8477494.0,Jonathan Drouin,L,COL,28,79,19,37,56
8,8474578.0,Erik Karlsson,D,PIT,33,82,11,45,56
8,8476906.0,Shayne Gostisbehere,D,DET,30,81,10,46,56
8,8475726.0,Tyler Toffoli,R,NJD,31,79,33,22,55
8,8475765.0,Vladimir Tarasenko,R,OTT,32,76,23,32,55
8,8482124.0,Quinton Byfield,R,LAK,21,80,20,35,55
8,8478047.0,Michael Bunting,L,CAR,28,81,19,36,55
8,8475151.0,Kyle Palmieri,C,NYI,32,82,30,24,54
8,8476399.0,Blake Coleman,C,CGY,32,78,30,24,54
8,8478873.0,Troy Terry,R,ANA,26,76,20,34,54
8,8480798.0,Philipp Kurashev,C,CHI,24,75,18,36,54
8,8480036.0,Miro Heiskanen,D,DAL,24,71,9,45,54
8,8477501.0,Valeri Nichushkin,R,COL,28,54,28,25,53
8,8480015.0,Owen Tippett,R,PHI,24,78,28,25,53
8,8476882.0,Teuvo Teravainen,L,CAR,29,76,25,28,53
8,8480039.0,Martin Necas,C,CAR,24,77,24,29,53
8,8478975.0,Mason Marchment,L,DAL,28,81,22,31,53
8,8475913.0,Mark Stone,R,VGK,31,56,16,37,53
8,8478414.0,Timo Meier,R,NJD,27,69,28,24,52
8,8475794.0,Tyler Seguin,C,DAL,31,68,25,27,52
8,8477346.0,MacKenzie Weegar,D,CGY,29,82,20,32,52
8,8480830.0,Andrei Svechnikov,R,CAR,23,59,19,33,52
8,8476456.0,Jonathan Huberdeau,C,CGY,30,81,12,40,52
8,8474590.0,John Carlson,D,WSH,33,82,10,42,52
8,8474641.0,Adam Henrique,C,ANA,33,82,24,27,51
8,8476905.0,Chandler Stephenson,C,VGK,29,75,16,35,51
8,8471724.0,Kris Letang,D,PIT,36,82,10,41,51
8,8482175.0,JJ Peterka,R,BUF,21,82,28,22,50
8,8480797.0,Joel Farabee,L,PHI,23,82,22,28,50
8,8483515.0,Juraj Slafkovsky,L,MTL,19,82,20,30,50
8,8474563.0,Drew Doughty,D,LAK,34,82,15,35,50
8,8478038.0,Devon Toews,D,COL,29,82,12,38,50
8,8477456.0,J.T. Compher,L,DET,28,77,19,29,48
8,8479425.0,Filip Hronek,D,VAN,26,81,5,43,48
8,8474141.0,Patrick Kane,R,DET,35,50,20,27,47
8,8478856.0,Conor Garland,R,VAN,27,82,20,27,47
8,8481528.0,Dylan Cozens,C,BUF,22,79,18,29,47
8,8476479.0,Phillip Danault,C,LAK,30,78,17,30,47
8,8474102.0,David Perron,L,DET,35,76,17,30,47
8,8481581.0,Thomas Harley,D,DAL,22,79,15,32,47
8,8478396.0,Noah Hanifin,D,CGY,26,80,13,34,47
8,8476869.0,Brady Skjei,D,CAR,29,80,13,34,47
8,8479325.0,Charlie McAvoy,D,BOS,26,74,12,35,47
8,8482684.0,Luke Hughes,D,NJD,20,82,9,38,47
8,8477503.0,Max Domi,C,TOR,28,80,9,38,47
8,8482122.0,Brock Faber,D,MIN,21,82,8,39,47
8,8477426.0,Nicholas Paul,L,TBL,28,82,24,22,46
8,8475784.0,Jeff Skinner,L,BUF,31,74,24,22,46
8,8483808.0,Andrei Kuzmenko,L,CGY,27,72,22,24,46
8,8475170.0,Brayden Schenn,C,STL,32,82,20,26,46
8,8478407.0,Vince Dunn,D,SEA,27,59,11,35,46
8,8475760.0,Nick Bjugstad,C,ARI,31,76,22,23,45
8,8477451.0,Ryan Hartman,R,MIN,29,74,21,24,45
8,8478519.0,Anthony Cirelli,C,TBL,26,79,20,25,45
8,8477964.0,Ivan Barbashev,C,VGK,28,82,19,26,45
8,8478438.0,Tommy Novak,C,NSH,26,71,18,27,45
8,8482667.0,William Eklund,L,SJS,21,80,16,29,45
8,8477021.0,Alex Kerfoot,C,ARI,29,82,13,32,45
8,8475218.0,Mattias Ekholm,D,EDM,33,79,11,34,45
8,8480188.0,Fabian Zetterlund,L,SJS,24,82,24,20,44
8,8475169.0,Evander Kane,L,EDM,32,77,24,20,44
8,8477511.0,Anthony Mantha,R,WSH,29,74,23,21,44
8,8474586.0,Jordan Eberle,R,SEA,33,78,17,27,44
8,8477496.0,Elias Lindholm,C,VAN,29,75,15,29,44
8,8477948.0,Travis Sanheim,D,PHI,27,81,10,34,44
8,8477479.0,Tyler Bertuzzi,L,TOR,28,80,21,22,43
8,8478466.0,Daniel Sprong,R,DET,26,76,18,25,43
8,8470613.0,Brent Burns,D,CAR,38,82,10,33,43
8,8476438.0,Brandon Saad,L,STL,31,82,26,16,42
8,8477407.0,Anthony Duclair,L,SJS,28,73,24,18,42
8,8478474.0,Lawson Crouse,L,ARI,26,81,23,19,42
8,8480893.0,Kirill Marchenko,R,CBJ,23,78,23,19,42
8,8482745.0,Mason McTavish,C,ANA,20,64,19,23,42
8,8481542.0,Moritz Seider,D,DET,22,82,9,33,42
8,8477447.0,Shea Theodore,D,VGK,28,47,5,37,42
8,8477935.0,Sam Bennett,C,FLA,27,69,20,21,41
8,8477998.0,Warren Foegele,L,EDM,27,82,20,21,41
8,8480009.0,Eeli Tolvanen,R,SEA,24,81,16,25,41
8,8479345.0,Jakob Chychrun,D,OTT,25,82,14,27,41
8,8480028.0,Morgan Frost,C,PHI,24,71,13,28,41
8,8478462.0,Nicolas Roy,C,VGK,26,70,13,28,41
8,8476458.0,Ryan Strome,C,ANA,30,79,11,30,41
8,8480434.0,Sean Durzi,D,ARI,25,76,9,32,41
8,8482079.0,Marco Rossi,C,MIN,22,82,21,19,40
8,8478498.0,Jake DeBrusk,L,BOS,27,80,19,21,40
8,8479365.0,Trent Frederic,C,BOS,25,82,18,22,40
8,8479525.0,Ross Colton,C,COL,27,80,17,23,40
8,8479400.0,Pierre-Luc Dubois,C,LAK,25,82,16,24,40
8,8478233.0,Andrew Mangiapane,L,CGY,27,75,14,26,40
8,8475191.0,Reilly Smith,R,PIT,32,76,13,27,40
8,8479987.0,Morgan Geekie,C,BOS,25,76,17,22,39
8,8482146.0,Luke Evangelista,R,NSH,21,80,16,23,39
8,8474150.0,Mikael Backlund,C,CGY,34,82,15,24,39
8,8476872.0,Scott Laughton,C,PHI,29,82,13,26,39
8,8478542.0,Evan Rodrigues,C,FLA,30,80,12,27,39
8,8478055.0,Gustav Forsling,D,FLA,27,79,10,29,39
8,8478397.0,Rasmus Andersson,D,CGY,27,78,9,30,39
8,8475764.0,Cam Fowler,D,ANA,32,81,5,34,39
8,8476792.0,Torey Krug,D,STL,32,77,4,35,39
8,8482089.0,Jake Neighbours,L,STL,21,77,27,11,38
8,8482149.0,Cole Perfetti,C,WPG,21,71,19,19,38
8,8476881.0,Tomas Hertl,C,SJS,30,54,17,21,38
8,8474037.0,James van Riemsdyk,L,BOS,34,71,11,27,38
8,8482105.0,Jake Sanderson,D,OTT,21,79,10,28,38
8,8475314.0,Anders Lee,L,NYI,33,81,20,17,37
8,8473422.0,Nick Foligno,L,CHI,36,74,17,20,37
8,8482665.0,Matty Beniers,C,SEA,21,77,15,22,37
8,8476483.0,Rickard Rakell,R,PIT,30,70,15,22,37
8,8476474.0,Stefan Noesen,R,CAR,30,81,14,23,37
8,8476480.0,Vladislav Namestnikov,C,WPG,31,78,11,26,37
8,8476958.0,Jaccob Slavin,D,CAR,29,81,6,31,37
8,8481535.0,Nils Hoglander,L,VAN,23,80,24,12,36
8,8480014.0,Gabriel Vilardi,C,WPG,24,47,22,14,36
8,8473986.0,Alex Killorn,L,ANA,34,63,18,18,36
8,8478046.0,Danton Heinen,L,BOS,28,74,17,19,36
8,8478891.0,Mason Appleton,C,WPG,27,82,14,22,36
8,8476432.0,Boone Jenner,C,CBJ,30,58,22,13,35
8,8477450.0,Jason Dickinson,C,CHI,28,82,22,13,35
8,8476880.0,Tom Wilson,R,WSH,29,74,18,17,35
8,8482699.0,Dylan Guenther,R,ARI,20,45,18,17,35
8,8475287.0,Erik Haula,L,NJD,32,76,16,19,35
8,8476925.0,Colton Sissons,C,NSH,30,81,15,20,35
8,8482720.0,Matthew Knies,L,TOR,21,80,15,20,35
8,8482113.0,Anton Lundell,C,FLA,22,78,13,22,35
8,8476392.0,Adam Lowry,C,WPG,30,81,12,23,35
8,8478472.0,Mathieu Joseph,R,OTT,26,72,11,24,35
8,8475799.0,Nino Niederreiter,R,WPG,31,77,18,16,34
8,8477476.0,Artturi Lehkonen,L,COL,28,45,16,18,34
8,8481618.0,Alex Newhook,C,MTL,22,55,15,19,34
8,8482159.0,Tyson Foerster,R,PHI,21,77,20,13,33
8,8482110.0,Dawson Mercer,C,NJD,22,82,20,13,33
8,8481580.0,Connor McMichael,C,WSH,22,80,18,15,33
8,8482055.0,Drew O'Connor,L,PIT,25,79,16,17,33
8,8477429.0,Andrew Copp,C,DET,29,79,13,20,33
8,8479992.0,Michael Rasmussen,C,DET,24,75,13,20,33
8,8476826.0,Yanni Gourde,C,SEA,32,80,11,22,33
8,8476419.0,Jean-Gabriel Pageau,C,NYI,31,82,11,22,33
8,8477986.0,Brandon Montour,D,FLA,29,66,8,25,33
8,8482671.0,Owen Power,D,BUF,21,76,6,27,33
8,8478178.0,Darren Raddysh,D,TBL,27,82,6,27,33
8,8480145.0,Neal Pionk,D,WPG,28,82,5,28,33
8,8474565.0,Alex Pietrangelo,D,VGK,33,64,4,29,33
8,8478057.0,Dakota Joshua,C,VAN,27,63,18,14,32
8,8477952.0,Robby Fabbri,C,DET,27,68,18,14,32
8,8476921.0,Jordan Martinook,L,CAR,31,82,14,18,32
8,8475722.0,Jason Zucker,L,ARI,31,69,14,18,32
8,8482705.0,Cole Sillinger,C,CBJ,20,77,13,19,32
8,8477498.0,Darnell Nurse,D,EDM,28,81,10,22,32
8,8475171.0,Oliver Ekman-Larsson,D,FLA,32,80,9,23,32
8,8478500.0,Ivan Provorov,D,CBJ,26,82,5,27,32
8,8474151.0,Ryan McDonagh,D,NSH,34,74,3,29,32
8,8474870.0,Tyler Johnson,C,CHI,33,67,17,14,31
8,8475848.0,Brendan Gallagher,R,MTL,31,77,16,15,31
8,8474189.0,Lars Eller,C,PIT,34,82,15,16,31
8,8476292.0,Ondrej Palat,L,NJD,32,71,11,20,31
8,8481624.0,Ilya Mikheyev,R,VAN,29,78,11,20,31
8,8478458.0,Jack Roslovic,C,CBJ,26,59,9,22,31
8,8477495.0,Seth Jones,D,CHI,29,67,8,23,31
8,8476979.0,Erik Gustafsson,D,NYR,31,76,6,25,31
8,8476331.0,Dylan DeMelo,D,WPG,30,82,3,28,31
8,8480064.0,Josh Norris,C,OTT,24,50,16,14,30
8,8475768.0,Jaden Schwartz,C,SEA,31,62,13,17,30
8,8480802.0,Ryan McLeod,C,EDM,24,81,12,18,30
8,8477987.0,Ryan Donato,C,CHI,27,78,12,18,30
8,8475149.0,Marcus Johansson,L,MIN,33,78,11,19,30
8,8481546.0,Cam York,D,PHI,22,82,10,20,30
8,8477505.0,Alex Wennberg,C,SEA,29,79,10,20,30
8,8473533.0,Jordan Staal,C,CAR,35,80,10,20,30
8,8478469.0,Thomas Chabot,D,OTT,26,51,9,21,30
8,8480817.0,K'Andre Miller,D,NYR,23,80,8,22,30
8,8477969.0,Marcus Pettersson,D,PIT,27,82,4,26,30
8,8475753.0,Justin Faulk,D,STL,31,60,2,28,30
8,8479619.0,Michael Carcone,L,ARI,27,74,21,8,29
8,8482475.0,Yegor Chinakhov,R,CBJ,22,53,16,13,29
8,8480459.0,Pius Suter,C,VAN,27,67,14,15,29
8,8475763.0,Kevin Hayes,R,STL,31,79,13,16,29
8,8481524.0,Bowen  Byram,D,COL,22,73,11,18,29
8,8480336.0,Sean Walker,D,PHI,29,81,10,19,29
8,8481656.0,Aliaksei Protas,C,WSH,22,78,6,23,29
8,8474574.0,Tyler Myers,D,VAN,33,77,5,24,29
8,8482125.0,Alexander Holtz,R,NJD,21,82,16,12,28
8,8480813.0,Joe Veleno,C,DET,23,80,12,16,28
8,8480068.0,Ryan Poehling,C,PHI,24,77,11,17,28
8,8478413.0,Jordan Greenway,L,BUF,26,67,10,18,28
8,8478115.0,Pierre Engvall,L,NYI,27,74,10,18,28
8,8476923.0,Damon Severson,D,CBJ,29,67,9,19,28
8,8476931.0,Jake McCabe,D,TOR,30,73,8,20,28
8,8478133.0,Jake Evans,C,MTL,27,82,7,21,28
8,8476927.0,Teddy Blueger,C,VAN,29,68,6,22,28
8,8475181.0,Nick Leddy,D,STL,32,82,3,25,28
8,8478020.0,Michael Amadio,R,VGK,27,73,14,13,27
8,8481582.0,Nicholas Robertson,L,TOR,22,56,14,13,27
8,8480185.0,Eetu Luostarinen,C,FLA,25,82,12,15,27
8,8480829.0,Jesperi Kotkaniemi,C,CAR,23,79,12,15,27
8,8480113.0,Alex Iafallo,L,WPG,30,82,11,16,27
8,8480748.0,Kiefer Sherwood,L,NSH,28,68,10,17,27
8,8481596.0,Shane Pinto,C,OTT,23,41,9,18,27
8,8480835.0,Jack Drury,C,CAR,23,74,8,19,27
8,8476463.0,Jonas Brodin,D,MIN,30,62,7,20,27
8,8482092.0,Ridly Greig,C,OTT,21,72,13,13,26
8,8476918.0,Jimmy Vesey,L,NYR,30,80,13,13,26
8,8476892.0,Colton Parayko,D,STL,30,82,10,16,26
8,8479941.0,Justin Danforth,R,CBJ,30,71,10,16,26
8,8477425.0,Miles Wood,L,COL,28,74,9,17,26
8,8480855.0,Jack McBain,C,ARI,23,67,8,18,26
8,8474602.0,Justin Schultz,D,SEA,33,70,7,19,26
8,8475790.0,Erik Gudbranson,D,CBJ,31,78,6,20,26
8,8475200.0,Dmitry Orlov,D,CAR,32,82,6,20,26
8,8482655.0,J.J. Moser,D,ARI,23,80,5,21,26
8,8476902.0,Esa Lindell,D,DAL,29,82,5,21,26
8,8475188.0,Brayden McNabb,D,VGK,32,82,4,22,26
8,8476854.0,Hampus Lindholm,D,BOS,29,73,3,23,26
8,8474673.0,TJ Brodie,D,TOR,33,78,1,25,26
8,8476469.0,Joel Armia,R,MTL,30,66,17,8,25
8,8481601.0,Simon Holmstrom,R,NYI,22,75,15,10,25
8,8481186.0,Logan O'Connor,R,COL,27,57,13,12,25
8,8471698.0,T.J. Oshie,R,WSH,37,52,12,13,25
8,8479591.0,Michael Eyssimont,C,TBL,27,81,11,14,25
8,8476312.0,Josh Manson,D,COL,32,76,8,17,25
8,8478136.0,Jake Middleton,D,MIN,27,80,7,18,25
8,8481032.0,Paul Cotter,C,VGK,24,76,7,18,25
8,8477508.0,Curtis Lazar,C,NJD,28,71,7,18,25
8,8482245.0,Artem Zub,D,OTT,28,69,5,20,25
8,8478911.0,Matt Roy,D,LAK,28,81,5,20,25
8,8476879.0,Cody Ceci,D,EDM,30,79,5,20,25
8,8478507.0,John Marino,D,NJD,26,75,4,21,25
8,8478840.0,Will Borgen,D,SEA,27,82,3,22,25
8,8482259.0,Bobby McMann,C,TOR,27,56,15,9,24
8,8481604.0,Pavel Dorofeyev,L,VGK,23,47,13,11,24
8,8478043.0,Sam Lafferty,C,VAN,28,79,13,11,24
8,8479351.0,Sam Steel,C,DAL,25,77,9,15,24
8,8475193.0,Tomas Tatar,L,SEA,33,70,9,15,24
8,8475744.0,Evgeny Kuznetsov,C,WSH,31,63,8,16,24
8,8475233.0,David Savard,D,MTL,33,60,6,18,24
8,8476422.0,Mike Reilly,D,NYI,30,61,6,18,24
8,8474031.0,Kevin Shattenkirk,D,BOS,34,61,6,18,24
8,8473507.0,Jeff Petry,D,DET,36,73,3,21,24
8,8480246.0,Nick Perbix,D,TBL,25,77,2,22,24
8,8481606.0,Jordan Spence,D,LAK,22,71,2,22,24
8,8477947.0,Sonny Milano,L,WSH,27,49,15,8,23
8,8475793.0,Ryan Johansen,C,COL,31,63,13,10,23
8,8480821.0,Filip Zadina,R,SJS,24,72,13,10,23
8,8474149.0,Evgenii Dadonov,R,DAL,34,51,12,11,23
8,8475231.0,Casey Cizikas,C,NYI,32,70,10,13,23
8,8474884.0,Mike Hoffman,C,SJS,34,66,10,13,23
8,8482062.0,Cole Smith,L,NSH,28,80,9,14,23
8,8478882.0,Vladislav Gavrikov,D,LAK,28,77,6,17,23
8,8474157.0,Max Pacioretty,L,WSH,35,47,4,19,23
8,8480873.0,Rasmus Sandin,D,WSH,23,68,3,20,23
8,8480043.0,Timothy Liljegren,D,TOR,24,55,3,20,23
8,8475343.0,Nic Dowd,C,WSH,33,64,12,10,22
8,8470621.0,Corey Perry,R,EDM,38,54,12,10,22
8,8473449.0,Kyle Okposo,R,BUF,35,67,12,10,22
8,8477446.0,Michael McCarron,R,NSH,28,70,12,10,22
8,8481517.0,Brett Leason,R,ANA,24,68,11,11,22
8,8478970.0,Jalen Chatfield,D,CAR,27,72,8,14,22
8,8481014.0,Alexander Romanov,D,NYI,23,81,7,15,22
8,8482087.0,Kaiden Guhle,D,MTL,21,70,6,16,22
8,8477953.0,Kasperi Kapanen,R,STL,27,73,6,16,22
8,8476885.0,Jacob Trouba,D,NYR,29,69,3,19,22
8,8480281.0,Alexey Toropchenko,R,STL,24,82,14,7,21
8,8482157.0,Will Cuylle,L,NYR,21,81,13,8,21
8,8478013.0,Jake Walman,D,DET,27,63,12,9,21
8,8475714.0,Calle Jarnkrok,C,TOR,32,52,10,11,21
8,8475220.0,Marcus Foligno,L,MIN,32,55,9,12,21
8,8471218.0,Blake Wheeler,R,NYR,37,54,9,12,21
8,8479359.0,Beck Malenstyn,L,WSH,25,81,6,15,21
8,8476897.0,Oskar Sundqvist,C,STL,29,71,6,15,21
8,8481178.0,Egor Zamula,D,PHI,23,66,5,16,21
8,8480891.0,Michael Kesselring,D,ARI,23,65,5,16,21
8,8479983.0,Mario Ferraro,D,SJS,25,78,3,18,21
8,8475225.0,Craig Smith,C,DAL,34,75,11,9,20
8,8476981.0,Josh Anderson,R,MTL,29,78,9,11,20
8,8475455.0,Brenden Dillon,D,WPG,33,77,8,12,20
8,8481577.0,Philip Tomasino,C,NSH,22,41,7,13,20
8,8477507.0,Nikita Zadorov,D,VAN,28,75,6,14,20
8,8475279.0,Ben Chiarot,D,DET,32,77,5,15,20
8,8478851.0,Alexandre Carrier,D,NSH,27,73,4,16,20
8,8480035.0,Henri Jokiharju,D,BUF,24,74,3,17,20
8,8480073.0,Erik Brannstrom,D,OTT,24,76,3,17,20
8,8475179.0,Dmitry Kulikov,D,FLA,33,76,1,19,20
8,8481554.0,Kaapo Kakko,R,NYR,22,61,13,6,19
8,8480980.0,Connor Dewar,C,MIN,24,74,11,8,19
8,8479415.0,Michael McLeod,C,NJD,25,45,10,9,19
8,8482097.0,Jack Quinn,R,BUF,22,27,9,10,19
8,8480144.0,David Kampf,C,TOR,28,78,8,11,19
8,8479353.0,Brett Howden,C,VGK,25,72,8,11,19
8,8475164.0,Jakob Silfverberg,R,ANA,33,81,7,12,19
8,8476889.0,Radek Faksa,C,DAL,29,74,7,12,19
8,8473504.0,Cal Clutterbuck,R,NYI,36,82,7,12,19
8,8475855.0,Jesper Fast,R,CAR,32,73,6,13,19
8,8477380.0,Jonny Brodzinski,C,NYR,30,57,6,13,19
8,8471699.0,Andrew Cogliano,C,COL,36,75,6,13,19
8,8477506.0,Ryan Pulock,D,NYI,29,58,5,14,19
8,8480172.0,Jan Rutta,D,SJS,33,69,5,14,19
8,8482073.0,Braden Schneider,D,NYR,22,82,5,14,19
8,8478432.0,Christian Fischer,R,DET,26,79,5,14,19
8,8479410.0,Mikhail Sergachev,D,TBL,25,34,2,17,19
8,8475690.0,Chris Tanev,D,CGY,34,75,2,17,19
8,8480878.0,Nils Lundkvist,D,DAL,23,59,2,17,19
8,8479316.0,Luke Kunin,C,SJS,26,77,11,7,18
8,8480289.0,Morgan Barron,C,WPG,25,80,11,7,18
8,8476374.0,Sean Kuraly,C,CBJ,30,62,9,9,18
8,8480448.0,Parker Kelly,L,OTT,24,80,8,10,18
8,8478434.0,Keegan Kolesar,R,VGK,26,79,8,10,18
8,8475462.0,Radko Gudas,D,ANA,33,66,6,12,18
8,8480220.0,Noah Cates,L,PHI,24,59,6,12,18
8,8476457.0,Adam Larsson,D,SEA,31,81,4,14,18
8,8477932.0,Aaron Ekblad,D,FLA,27,51,4,14,18
8,8477365.0,Connor Clifton,D,BUF,28,79,4,14,18
8,8476874.0,Olli Maatta,D,DET,29,72,4,14,18
8,8479398.0,Samuel Girard,D,COL,25,59,3,15,18
8,8479998.0,Mikey Anderson,D,LAK,24,74,2,16,18
8,8480049.0,Dylan Samberg,D,WPG,24,78,1,17,18
8,8478508.0,Yakov Trenin,C,NSH,26,76,12,5,17
8,8477903.0,Garnet Hathaway,R,PHI,32,82,7,10,17
8,8480995.0,Pontus Holmberg,R,TOR,24,54,7,10,17
8,8479315.0,Joey Anderson,R,CHI,25,55,5,12,17
8,8478463.0,Anthony Beauvillier,L,CHI,26,60,5,12,17
8,8474166.0,Alec Martinez,D,VGK,36,55,4,13,17
8,8481522.0,Peyton Krebs,C,BUF,22,80,4,13,17
8,8478859.0,Niko Mikkola,D,FLA,27,82,3,14,17
8,8479324.0,Ryan Lindgren,D,NYR,25,76,3,14,17
8,8481605.0,Jackson LaCombe,D,ANA,22,71,2,15,17
8,8479976.0,Juuso Valimaki,D,ARI,25,68,2,15,17
8,8470600.0,Ryan Suter,D,DAL,38,82,2,15,17
8,8480884.0,Calen Addison,D,SJS,23,72,1,16,17
8,8475842.0,Sam Carrick,C,ANA,31,77,10,6,16
8,8479977.0,Kailer Yamamoto,R,SEA,25,59,8,8,16
8,8473453.0,Trevor Lewis,C,LAK,36,82,8,8,16
8,8480205.0,Emil Bemstrom,R,CBJ,24,56,8,8,16
8,8479293.0,Brandon Tanev,L,SEA,32,66,7,9,16
8,8477444.0,Andre Burakovsky,L,SEA,28,49,7,9,16
8,8475208.0,Brian Dumoulin,D,SEA,32,80,6,10,16
8,8482660.0,Kent Johnson,C,CBJ,21,42,6,10,16
8,8477979.0,Nicolas Aube-Kubel,R,WSH,27,60,6,10,16
8,8476462.0,Dougie Hamilton,D,NJD,30,20,5,11,16
8,8482117.0,Lukas Reichel,L,CHI,21,65,5,11,16
8,8474034.0,Pat Maroon,L,MIN,35,51,4,12,16
8,8480796.0,Martin Fehervary,D,WSH,24,66,3,13,16
8,8476967.0,Brett Kulak,D,EDM,29,82,3,13,16
8,8471677.0,Jack Johnson,D,COL,36,80,3,13,16
8,8481568.0,Alex Vlasic,D,CHI,22,76,2,14,16
8,8476917.0,Adam Pelech,D,NYI,29,58,1,15,16
8,8479423.0,Alex Nylander,L,PIT,25,28,11,4,15
8,8478831.0,Kevin Stenlund,C,FLA,27,81,11,4,15
8,8470604.0,Jeff Carter,C,PIT,38,72,11,4,15
8,8477330.0,Dominik Kubalik,L,OTT,28,74,11,4,15
8,8476873.0,Mark Jankowski,C,NSH,29,32,7,8,15
8,8476393.0,Nick Cousins,C,FLA,30,69,7,8,15
8,8481560.0,Arthur Kaliyev,R,LAK,22,51,7,8,15
8,8481481.0,Blake Lizotte,C,LAK,26,62,7,8,15
8,8478109.0,Victor Olofsson,L,BUF,28,51,7,8,15
8,8481533.0,Trevor Zegras,C,ANA,22,31,6,9,15
8,8478042.0,Viktor Arvidsson,R,LAK,30,18,6,9,15
8,8474090.0,Brendan Smith,D,NJD,34,63,5,10,15
8,8477919.0,Frederick Gaudreau,C,MIN,30,67,5,10,15
8,8479368.0,Max Jones,L,ANA,25,52,5,10,15
8,8477839.0,Conor Sheary,L,TBL,31,57,4,11,15
8,8476467.0,Jamie Oleksiak,D,SEA,31,82,2,13,15
8,8475197.0,Tyson Barrie,D,NSH,32,41,1,14,15
8,8476878.0,Zemgus Girgensons,L,BUF,29,63,8,6,14
8,8480011.0,Klim Kostin,C,DET,24,52,8,6,14
8,8479661.0,Tanner Jeannot,L,TBL,26,55,7,7,14
8,8478468.0,Jeremy Lauzon,D,NSH,26,79,6,8,14
8,8480003.0,Jesper Boqvist,C,BOS,25,47,6,8,14
8,8479390.0,Taylor Raddysh,R,CHI,25,73,5,9,14
8,8477070.0,Liam O'Brien,C,ARI,29,75,5,9,14
8,8478443.0,Brandon Carlo,D,BOS,27,76,4,10,14
8,8480879.0,Jacob Bernard-Docker,D,OTT,23,72,4,10,14
8,8477392.0,Hudson Fasching,R,NYI,28,45,4,10,14
8,8477435.0,Ryan Graves,D,PIT,28,70,3,11,14
8,8474567.0,Zach Bogosian,D,MIN,33,65,3,11,14
8,8480887.0,Jordan Harris,D,MTL,23,56,3,11,14
8,8480727.0,Zach Whitecloud,D,VGK,27,61,2,12,14
8,8477220.0,Nate Schmidt,D,WPG,32,63,2,12,14
8,8475324.0,Nick Jensen,D,WSH,33,78,1,13,14
8,8480001.0,Urho Vaakanainen,D,ANA,24,68,1,13,14
8,8477845.0,Trevor van Riemsdyk,D,WSH,32,70,0,14,14
8,8482111.0,Justin Barron,D,MTL,22,48,7,6,13
8,8479383.0,Boris Katchouk,L,CHI,25,59,7,6,13
8,8477573.0,Nathan Walker,L,STL,29,45,7,6,13
8,8480192.0,Johnathan Kovacevic,D,MTL,26,62,6,7,13
8,8479996.0,Cody Glass,C,NSH,24,41,6,7,13
8,8481477.0,Nico Sturm,C,SJS,28,63,5,8,13
8,8476871.0,Tanner Pearson,L,MTL,31,54,5,8,13
8,8479520.0,Brandon Duhaime,R,MIN,26,80,5,8,13
8,8479402.0,Jake Bean,D,CBJ,25,72,4,9,13
8,8482222.0,Alexander Barabanov,L,SJS,29,46,4,9,13
8,8477488.0,Brett Pesce,D,CAR,29,70,3,10,13
8,8479371.0,Dante Fabbro,D,NSH,25,56,3,10,13
8,8478416.0,Erik Cernak,D,TBL,26,69,2,11,13
8,8476372.0,Nick Seeler,D,PHI,30,71,1,12,13
8,8481704.0,Juuso Parssinen,C,NSH,22,44,8,4,12
8,8476278.0,Colin Blackwell,C,CHI,30,44,8,4,12
8,8479336.0,Carl Grundstrom,R,LAK,26,50,8,4,12
8,8471709.0,Marc-Edouard Vlasic,D,SJS,36,57,6,6,12
8,8479393.0,Noah Gregor,C,TOR,25,63,6,6,12
8,8478421.0,A.J. Greer,L,CGY,27,59,6,6,12
8,8479671.0,Mathieu Olivier,R,CBJ,26,54,5,7,12
8,8477846.0,Ryan Carpenter,C,SJS,32,62,5,7,12
8,8478585.0,Derek Ryan,C,EDM,37,70,5,7,12
8,8479414.0,Nathan Bastian,R,NJD,26,54,5,7,12
8,8477015.0,Connor Brown,R,EDM,29,71,4,8,12
8,8476624.0,Barclay Goodrow,C,NYR,30,80,4,8,12
8,8477406.0,Mattias Janmark,C,EDM,31,71,4,8,12
8,8476919.0,Chris Tierney,C,NJD,29,52,4,8,12
8,8479543.0,Michael Pezzetta,L,MTL,25,61,3,9,12
8,8475825.0,Jani Hakanpää,D,DAL,31,64,2,10,12
8,8479980.0,Nicolas Hague,D,VGK,25,73,2,10,12
8,8476822.0,Luke Glendening,C,TBL,34,81,10,1,11
8,8482133.0,Thomas Bordeleau,C,SJS,21,27,6,5,11
8,8480806.0,Isac Lundestrom,C,ANA,24,46,5,6,11
8,8480025.0,MacKenzie Entwistle,R,CHI,24,67,5,6,11
8,8475750.0,Jon Merrill,D,MIN,31,65,4,7,11
8,8481567.0,Henry Thrun,D,SJS,22,51,3,8,11
8,8477950.0,Tony DeAngelo,D,CAR,28,31,3,8,11
8,8474013.0,Ian Cole,D,VAN,34,78,2,9,11
8,8476891.0,Matt Grzelcyk,D,BOS,29,63,2,9,11
8,8480058.0,Pierre-Olivier Joseph,D,PIT,24,52,2,9,11
8,8480860.0,Kevin Bahl,D,NJD,23,82,1,10,11
8,8479576.0,Vincent Desharnais,D,EDM,27,78,1,10,11
8,8470610.0,Zach Parise,L,COL,39,30,5,5,10
8,8476858.0,Phillip Di Giuseppe,L,VAN,30,51,5,5,10
8,8474040.0,Sam Gagner,C,EDM,34,28,5,5,10
8,8480355.0,Mark Kastelic,C,OTT,24,63,5,5,10
8,8482142.0,Jamie Drysdale,D,PHI,21,34,3,7,10
8,8480849.0,Barrett Hayton,C,ARI,23,33,3,7,10
8,8475177.0,Calvin de Haan,D,TBL,32,59,3,7,10
8,8482964.0,Arber Xhekaj,D,MTL,22,44,3,7,10
8,8477384.0,Josh Brown,D,ARI,29,51,3,7,10
8,8480184.0,Gustav Lindström,D,ANA,25,46,3,7,10
8,8480762.0,Eric Robinson,L,BUF,28,47,3,7,10
8,8477018.0,Ben Hutton,D,VGK,30,41,2,8,10
8,8481093.0,Rafael Harvey-Pinard,L,MTL,24,45,2,8,10
8,8480880.0,Jakub Lauko,C,BOS,23,60,2,8,10
8,8480871.0,Adam Boqvist,D,CBJ,23,35,1,9,10
8,8479369.0,Andrew Peeke,D,CBJ,25,38,1,9,10
8,8479982.0,Conor Timmins,D,TOR,25,25,1,9,10
8,8483460.0,David Jiricek,D,CBJ,20,43,1,9,10
8,8477971.0,Andreas Englund,D,LAK,27,82,1,9,10
8,8471274.0,Alex Goligoski,D,MIN,38,36,0,10,10
8,8479439.0,Jacob MacDonald,D,SJS,30,34,7,2,9
8,8479339.0,Patrik Laine,L,CBJ,25,18,6,3,9
8,8477353.0,Tyler Motte,C,TBL,28,69,6,3,9
8,8482077.0,Dylan Holloway,L,EDM,22,38,6,3,9
8,8479718.0,Alex Barré-Boulet,C,TBL,26,36,6,3,9
8,8477989.0,Christian Dvorak,C,MTL,27,30,5,4,9
8,8479328.0,Julien Gauthier,R,NYI,26,27,5,4,9
8,8479968.0,Vinni Lettieri,C,MIN,28,46,5,4,9
8,8476525.0,Colin Miller,D,NJD,31,46,4,5,9
8,8470966.0,Mark Giordano,D,TOR,40,46,3,6,9
8,8482679.0,Matt Coronato,R,CGY,21,34,3,6,9
8,8480008.0,Adam Ruzicka,C,ARI,24,42,3,6,9
8,8481641.0,Joel Kiviranta,L,COL,27,56,3,6,9
8,8478028.0,Fredrik Olofsson,L,COL,27,57,3,6,9
8,8480222.0,Sebastian Aho,D,NYI,27,58,2,7,9
8,8481708.0,Zac Jones,D,NYR,23,31,2,7,9
8,8476960.0,Andreas Athanasiou,C,CHI,29,28,2,7,9
8,8480848.0,Ty Dellandrea,C,DAL,23,42,2,7,9
8,8478099.0,Kevin Labanc,R,SJS,28,46,2,7,9
8,8478399.0,Jonas Siegenthaler,D,NJD,26,57,1,8,9
8,8481527.0,Kaedan Korczak,D,VGK,22,26,1,8,9
8,8481537.0,Nikita Okhotiuk,D,SJS,23,52,1,8,9
8,8475797.0,Jarred Tinordi,D,CHI,31,52,0,9,9
8,8479372.0,Josh Mahura,D,FLA,25,30,0,9,9
8,8477478.0,William Carrier,L,VGK,29,39,6,2,8
8,8480252.0,Cole Guttman,C,CHI,24,27,4,4,8
8,8481058.0,Jesse Ylönen,R,MTL,24,59,4,4,8
8,8474709.0,Matt Martin,L,NYI,34,57,4,4,8
8,8477541.0,Dakota Mermis,D,MIN,29,47,3,5,8
8,8478211.0,Dryden Hunt,L,CGY,28,28,3,5,8
8,8476473.0,Connor Murphy,D,CHI,30,46,2,6,8
8,8477335.0,Kyle Burroughs,D,SJS,28,73,2,6,8
8,8474618.0,Marco Scandella,D,STL,33,65,2,6,8
8,8476329.0,Travis Boyd,C,ARI,30,16,2,6,8
8,8480196.0,Jacob Bryson,D,BUF,26,36,1,7,8
8,8478450.0,Parker Wotherspoon,D,BOS,26,41,0,8,8
8,8480950.0,Ilya Lyubushkin,D,ANA,29,74,0,8,8
8,8479066.0,Ryan Lomberg,L,FLA,29,75,5,2,7
8,8478569.0,Noel Acciari,C,PIT,32,55,4,3,7
8,8477930.0,Pierre-Edouard Bellemare,L,SEA,38,40,4,3,7
8,8482241.0,Radim Zohorna,L,PIT,27,33,4,3,7
8,8482624.0,Daniil Miromanov,D,VGK,26,24,3,4,7
8,8479346.0,Dillon Dube,C,CGY,25,43,3,4,7
8,8482496.0,Nils Aman,C,VAN,23,43,3,4,7
8,8481019.0,David Gustafsson,C,WPG,23,39,3,4,7
8,8478408.0,Travis Dermott,D,ARI,27,50,2,5,7
8,8479458.0,Nikita Zaitsev,D,CHI,32,38,2,5,7
8,8481167.0,Brayden Pachal,D,CGY,24,50,2,5,7
8,8480084.0,Nick DeSimone,D,NJD,29,34,2,5,7
8,8482652.0,Walker Duehr,R,CGY,26,40,2,5,7
8,8480807.0,Mattias Samuelsson,D,BUF,23,41,1,6,7
8,8479442.0,Troy Stecher,D,ARI,29,54,1,6,7
8,8482516.0,Matthew Kessel,D,STL,23,39,1,6,7
8,8474568.0,Luke Schenn,D,NSH,34,63,1,6,7
8,8478454.0,Noah Juulsen,D,VAN,26,54,1,6,7
8,8478502.0,Dennis Gilbert,D,CGY,27,34,1,6,7
8,8478104.0,Sammy Blais,L,STL,27,53,1,6,7
8,8482176.0,Wyatt Kaiser,D,CHI,21,32,0,7,7
8,8473446.0,Erik Johnson,D,BUF,35,67,5,1,6
8,8471817.0,Ryan Reaves,R,TOR,36,49,4,2,6
8,8479370.0,Tyson Jost,C,BUF,25,43,3,3,6
8,8477369.0,Carson Soucy,D,VAN,29,40,2,4,6
8,8474612.0,Travis Hamonic,D,OTT,33,48,2,4,6
8,8482730.0,Brandt Clarke,D,LAK,20,16,2,4,6
8,8477944.0,Jakub Vrana,L,STL,27,21,2,4,6
8,8477931.0,Tomas Nosek,L,NJD,31,36,2,4,6
8,8480789.0,Oliver Wahlstrom,R,NYI,23,32,2,4,6
8,8481013.0,Jonatan Berggren,R,DET,23,12,2,4,6
8,8476441.0,Joel Edmundson,D,WSH,30,53,1,5,6
8,8482192.0,Isaak Phillips,D,CHI,22,33,0,6,6
8,8480078.0,Filip Chytil,C,NYR,24,10,0,6,6
8,8483524.0,Shane Wright,C,SEA,19,8,4,1,5
8,8477962.0,Brendan Lemieux,L,CAR,27,32,3,2,5
8,8481541.0,Samuel Bolduc,D,NYI,23,34,2,3,5
8,8481147.0,Reese Johnson,C,CHI,25,42,2,3,5
8,8481422.0,Jacob Lucchini,C,MIN,28,40,2,3,5
8,8479536.0,Axel Jonsson-Fjallby,L,WPG,25,26,2,3,5
8,8481122.0,Simon Benoit,D,TOR,25,64,1,4,5
8,8477938.0,Haydn Fleury,D,TBL,27,24,1,4,5
8,8477810.0,Joel Hanley,D,DAL,32,42,1,4,5
8,8471686.0,Marc Staal,D,PHI,36,35,1,4,5
8,8474009.0,Nick Bonino,C,NYR,35,45,1,4,5
8,8476952.0,Dominic Toninato,C,WPG,29,15,1,4,5
8,8479547.0,Matthew Phillips,R,PIT,25,31,1,4,5
8,8480245.0,Olle Lycksell,R,PHI,24,18,1,4,5
8,8474716.0,Jared Spurgeon,D,MIN,34,16,0,5,5
8,8475906.0,John Klingberg,D,TOR,31,14,0,5,5
8,8476429.0,Scott Mayfield,D,NYI,31,41,0,5,5
8,8475718.0,Justin Holl,D,DET,31,38,0,5,5
8,8478452.0,Caleb Jones,D,COL,26,25,0,5,5
8,8479291.0,Kevin Rooney,C,CGY,30,33,3,1,4
8,8479344.0,Jesse Puljujarvi,R,PIT,25,22,3,1,4
8,8478051.0,Max Willman,C,NJD,28,18,3,1,4
8,8475791.0,Taylor Hall,L,CHI,32,10,2,2,4
8,8481056.0,Spencer Stastney,D,NSH,23,20,2,2,4
8,8476867.0,Brendan Gaunce,C,CBJ,29,24,2,2,4
8,8479981.0,Jonah Gadjovich,L,FLA,25,39,2,2,4
8,8475766.0,Austin Watson,L,TBL,31,33,2,2,4
8,8477499.0,Rasmus Ristolainen,D,PHI,29,31,1,3,4
8,8478451.0,Ethan Bear,D,WSH,26,24,1,3,4
8,8481609.0,Vladislav Kolyachonok,D,ARI,22,5,1,3,4
8,8477244.0,Chad Ruhwedel,D,PIT,33,52,1,3,4
8,8476442.0,Matt Nieto,L,PIT,31,22,1,3,4
8,8479994.0,Jaret Anderson-Dolan,C,LAK,24,31,1,3,4
8,8475752.0,Tyler Pitlick,C,NYR,32,34,1,3,4
8,8481532.0,Alex Turcotte,C,LAK,22,20,1,3,4
8,8477527.0,Ross Johnston,L,ANA,29,68,1,3,4
8,8475235.0,Nicolas Deslauriers,L,PHI,32,60,1,3,4
8,8476913.0,Devin Shore,C,SEA,29,21,1,3,4
8,8479379.0,Givani Smith,R,SJS,25,36,1,3,4
8,8475762.0,Derek Forbort,D,BOS,31,35,0,4,4
8,8478424.0,Jansen Harkins,C,PIT,26,45,0,4,4
8,8480441.0,Trey Fix-Wolansky,R,CBJ,24,11,2,1,3
8,8478078.0,Rourke Chartier,C,OTT,27,37,2,1,3
8,8480776.0,Sheldon Rempal,R,VGK,28,9,2,1,3
8,8480468.0,James Hamblin,L,EDM,24,31,2,1,3
8,8479772.0,Zack MacEwen,R,OTT,27,30,2,1,3
8,8477073.0,Kurtis MacDermid,D,COL,29,45,2,1,3
8,8480823.0,Alexander Alexeyev,D,WSH,24,39,1,2,3
8,8480007.0,Jonas Rondbjerg,R,VGK,24,20,1,2,3
8,8476934.0,Brock McGinn,L,ANA,29,24,1,2,3
8,8478409.0,Anthony Richard,C,BOS,27,9,1,2,3
8,8483570.0,Ben Meyers,C,COL,25,23,1,2,3
8,8476994.0,Vinnie Hinostroza,C,PIT,29,14,1,2,3
8,8481592.0,Jakob Pelletier,L,CGY,22,13,1,2,3
8,8478904.0,Steven Lorentz,C,FLA,27,38,1,2,3
8,8479972.0,Mason Shaw,C,MIN,25,20,1,2,3
8,8480853.0,Liam Foudy,C,NSH,23,13,0,3,3
8,8482762.0,Simon Edvinsson,D,DET,20,16,1,1,2
8,8482101.0,Danil Gushchin,L,SJS,21,4,1,1,2
8,8479378.0,Logan Stanley,D,WPG,25,25,1,1,2
8,8481006.0,Tyler Tucker,D,STL,23,26,1,1,2
8,8478495.0,Denis Gurianov,R,NSH,26,18,1,1,2
8,8479362.0,Riley Tufte,L,COL,25,5,1,1,2
8,8480292.0,Carson Meyer,R,CBJ,26,14,1,1,2
8,8477454.0,Adam Erne,L,EDM,28,24,1,1,2
8,8475780.0,Chris Wagner,R,BOS,32,13,1,1,2
8,8476988.0,Matt Benning,D,SJS,29,14,0,2,2
8,8477034.0,Jaycob Megna,D,CHI,31,44,0,2,2
8,8481521.0,Ronnie Attard,D,PHI,24,12,0,2,2
8,8480070.0,Ian Mitchell,D,BOS,24,13,0,2,2
8,8477851.0,Jordan Oesterle,D,CGY,31,22,0,2,2
8,8481161.0,Jake Christiansen,D,CBJ,24,12,0,2,2
8,8482451.0,Mikael Pyyhtia,L,CBJ,22,17,0,2,2
8,8473473.0,Milan Lucic,L,BOS,35,4,0,2,2
8,8480870.0,Bo Groulx,C,ANA,23,45,0,2,2
8,8481598.0,Philip Broberg,D,EDM,22,12,0,2,2
8,8477464.0,Nic Petan,C,MIN,28,6,0,2,2
8,8481617.0,Vasily Podkolzin,R,VAN,22,19,0,2,2
8,8481751.0,Lukas Rousek,R,BUF,24,15,0,2,2
8,8481550.0,Adam Beckman,L,MIN,22,11,0,2,2
8,8481523.0,Kirby Dach,C,MTL,22,2,0,2,2
8,8481543.0,Nikita Alexandrov,C,STL,23,23,0,2,2
8,8478146.0,Matthew Highmore,C,OTT,27,7,0,2,2
8,8481043.0,Cole Koepke,L,TBL,25,9,0,2,2
8,8483565.0,Nick Blankenburg,D,CBJ,25,12,1,0,1
8,8483397.0,Marc McLaughlin,C,BOS,24,1,1,0,1
8,8480874.0,Adam Ginning,D,PHI,23,9,1,0,1
8,8481754.0,Nikita Nesterenko,C,ANA,22,3,1,0,1
8,8480021.0,Jack Studnicka,C,SJS,24,22,1,0,1
8,8481518.0,Nolan Foote,L,NJD,23,4,1,0,1
8,8479421.0,Jacob Moverare,D,LAK,25,24,1,0,1
8,8481239.0,Samuel Fagemo,L,LAK,23,8,1,0,1
8,8479546.0,Oskar Steen,C,BOS,25,34,1,0,1
8,8480836.0,Jonathan Gruden,C,PIT,23,13,1,0,1
8,8481077.0,John Leonard,L,NSH,25,6,1,0,1
8,8482147.0,Jean-Luc Foudy,C,COL,21,4,1,0,1
8,8474053.0,Logan Couture,C,SJS,34,6,0,1,1
8,8481812.0,Nikolai Knyzhov,D,SJS,26,10,0,1,1
8,8479984.0,Cal Foote,D,NJD,25,4,0,1,1
8,8479321.0,Lucas Johansen,D,WSH,26,6,0,1,1
8,8473563.0,Nicklas Backstrom,C,WSH,36,8,0,1,1
8,8479320.0,Max Lajoie,D,TOR,26,7,0,1,1
8,8482095.0,Tyler Kleven,D,OTT,21,9,0,1,1
8,8480157.0,Calle Rosen,D,STL,29,6,0,1,1
8,8480031.0,Max Comtois,L,ANA,24,1,0,1,1
8,8478017.0,Mark Friedman,D,VAN,28,23,0,1,1
8,8479348.0,Kale Clague,D,BUF,25,3,0,1,1
8,8475278.0,Byron Froese,C,VGK,32,16,0,1,1
8,8475795.0,Dylan McIlrath,D,WSH,31,3,0,1,1
8,8480845.0,Rasmus Kupari,C,WPG,23,28,0,1,1
8,8480890.0,Jan Jenik,R,ARI,23,5,0,1,1
8,8477887.0,Patrick Brown,C,BOS,31,11,0,1,1
8,8478512.0,Austin Czarnik,C,DET,31,34,0,1,1
8,8479367.0,William Lockwood,R,FLA,25,26,0,1,1
8,8483597.0,Milos Kelemen,L,ARI,24,10,0,1,1
8,8477126.0,Jayson Megna,C,ANA,33,1,0,0,0
8,8479639.0,Dylan Coghlan,D,CAR,25,1,0,0,0
8,8482067.0,Connor Mackey,D,NYR,27,1,0,0,0
8,8476856.0,Matt Dumba,D,ARI,29,0,0,0,0
8,8478483.0,Mitchell Marner,R,TOR,26,0,0,0,0
8,8471873.0,Anton Stralman,D,BOS,37,0,0,0,0
8,8474162.0,Jake Muzzin,D,TOR,34,0,0,0,0
8,8470638.0,Patrice Bergeron,C,BOS,38,0,0,0,0
8,8473604.0,Jonathan Toews,C,CHI,35,0,0,0,0
8,8471276.0,David Krejci,C,BOS,37,0,0,0,0
8,8474207.0,Nick Holden,D,OTT,36,0,0,0,0
8,8475747.0,Patrik Nemeth,D,ARI,31,0,0,0,0
8,8477467.0,Gustav Olofsson,D,SEA,29,1,0,0,0
8,8479514.0,Rem Pitlick,C,CHI,26,9,0,0,0
8,8474027.0,Justin Braun,D,PHI,36,0,0,0,0
8,8481599.0,Victor Soderstrom,D,ARI,22,3,0,0,0
8,8474161.0,Jakub Voracek,R,CBJ,34,0,0,0,0
8,8479985.0,Cale Fleury,D,SEA,25,1,0,0,0
8,8471303.0,Alexander Edler,D,LAK,37,0,0,0,0
8,8474573.0,Josh Bailey,R,NYI,34,0,0,0,0
8,8483619.0,Filip Roos,D,CHI,24,4,0,0,0
8,8474818.0,Jordie Benn,D,TOR,36,0,0,0,0
8,8476449.0,Scott Harrington,D,ANA,30,0,0,0,0
8,8483620.0,Marcus Bjork,D,CBJ,26,0,0,0,0
8,8470595.0,Eric Staal,C,FLA,39,0,0,0,0
8,8481585.0,Egor Afanasyev,L,NSH,22,2,0,0,0
8,8482712.0,Oskar Olausson,R,COL,21,1,0,0,0
8,8481072.0,Tim Berni,D,CBJ,23,0,0,0,0
8,8479945.0,Gavin Bayreuther,D,CBJ,29,0,0,0,0
8,8481600.0,Tobias Bjornfot,D,VGK,22,4,0,0,0
8,8481679.0,Maxence Guenette,D,OTT,22,7,0,0,0
8,8474683.0,Derek Grant,C,ANA,33,0,0,0,0
8,8476470.0,Nathan Beaulieu,D,ANA,31,0,0,0,0
8,8474145.0,Robert Bortuzzo,D,NYI,34,27,0,0,0
8,8480216.0,Jacob Peterson,C,SJS,24,6,0,0,0
8,8473548.0,Phil Kessel,R,VGK,36,0,0,0,0
8,8480160.0,Radim Simek,D,SJS,31,0,0,0,0
8,8480883.0,Ty Smith,D,PIT,23,0,0,0,0
8,8471669.0,Paul Stastny,C,CAR,38,0,0,0,0
8,8475227.0,Chris Wideman,D,MTL,33,0,0,0,0
8,8480913.0,Jordan Gross,D,NSH,28,0,0,0,0
8,8475625.0,Matt Irwin,D,WSH,36,0,0,0,0
8,8479388.0,Riley Stillman,D,BUF,25,0,0,0,0
8,8474628.0,Michael Stone,D,CGY,33,0,0,0,0
8,8484254.0,Akito Hirose,D,VAN,24,3,0,0,0
8,8477941.0,Nick Ritchie,L,CGY,28,0,0,0,0
8,8477462.0,Robert Hagg,D,ANA,28,5,0,0,0
8,8478062.0,Dysin Mayo,D,ARI,27,0,0,0,0
8,8482634.0,Alex Steeves,C,TOR,24,1,0,0,0
8,8477433.0,Ben Harpur,D,NYR,28,0,0,0,0
8,8478841.0,Colton White,D,ANA,26,0,0,0,0
8,8473544.0,Derick Brassard,C,OTT,36,0,0,0,0
8,8476884.0,Derrick Pouliot,D,SJS,29,5,0,0,0
8,8479376.0,Victor Mete,D,PHI,25,1,0,0,0
8,8483630.0,Pavol Regenda,L,ANA,24,5,0,0,0
8,8479026.0,Philippe Myers,D,TBL,26,5,0,0,0
8,8477482.0,Zach Sanford,L,CHI,29,0,0,0,0
8,8477359.0,Tucker Poolman,D,VAN,30,0,0,0,0
8,8475857.0,Kevin Gravel,D,NSH,31,0,0,0,0
8,8476779.0,Brad Hunt,D,COL,35,0,0,0,0
8,8476850.0,Ryan Murray,D,EDM,30,0,0,0,0
8,8477341.0,Andreas Johnsson,L,SJS,29,0,0,0,0
8,8474218.0,Jason Demers,D,EDM,35,0,0,0,0
8,8480844.0,Grigori Denisenko,L,VGK,23,6,0,0,0
8,8484287.0,Cole McWard,D,VAN,22,1,0,0,0
8,8479322.0,Wade Allison,R,PHI,26,0,0,0,0
8,8478846.0,Christian Wolanin,D,VAN,28,0,0,0,0
8,8471887.0,Patric Hornqvist,R,FLA,36,0,0,0,0
8,8475163.0,Alex Chiasson,R,DET,33,0,0,0,0
8,8478881.0,Brett Seney,L,CHI,27,4,0,0,0
8,8474697.0,Mark Borowiecki,D,NSH,34,0,0,0,0
8,8476410.0,Josh Leivo,L,STL,30,0,0,0,0
8,8475968.0,Alex Belzile,R,MTL,32,0,0,0,0
8,8479580.0,Dylan Gambrell,C,OTT,27,0,0,0,0
8,8480901.0,Karson Kuhlman,C,WPG,28,0,0,0,0
8,8480326.0,Sheldon Dries,C,VAN,29,0,0,0,0
8,8478465.0,Guillaume Brisebois,D,VAN,26,0,0,0,0
8,8482861.0,Vincent Iorio,D,WSH,21,6,0,0,0
8,8471794.0,Darren Helm,C,COL,36,0,0,0,0
8,8479335.0,Rasmus Asplund,C,NSH,26,0,0,0,0
8,8478415.0,Jakub Zboril,D,BOS,26,0,0,0,0
8,8476310.0,Lukas Sedlak,C,PHI,30,0,0,0,0
8,8478075.0,Anders Bjork,L,CHI,27,0,0,0,0
8,8480267.0,Sammy Walker,C,MIN,24,4,0,0,0
8,8479578.0,Casey Fitzgerald,D,FLA,26,0,0,0,0
8,8480032.0,Shane Bowers,C,NJD,24,8,0,0,0
8,8478400.0,Colin White,C,PIT,26,28,0,0,0
8,8478431.0,Evgeny Svechnikov,L,SJS,27,0,0,0,0
8,8475772.0,Riley Sheahan,C,BUF,32,0,0,0,0
8,8481690.0,Tyler Angle,C,CBJ,23,2,0,0,0
8,8476326.0,Josh Archibald,R,PIT,31,0,0,0,0
8,8478843.0,Denis Malgin,C,COL,26,0,0,0,0
8,8478446.0,Glenn Gawdin,C,ANA,26,1,0,0,0
8,8477357.0,Saku Maenalanen,R,WPG,29,0,0,0,0
8,8478870.0,Rudolfs Balcers,L,TBL,26,0,0,0,0
8,8478476.0,Kyle Capobianco,D,WPG,26,0,0,0,0
8,8476439.0,Brett Ritchie,R,ARI,30,0,0,0,0
8,8474613.0,Derek Stepan,C,CAR,33,0,0,0,0
8,8475178.0,Zack Kassian,R,ARI,32,0,0,0,0
8,8480226.0,Marián Studenic,R,SEA,25,2,0,0,0
8,8481070.0,Hugh McGing,L,STL,25,5,0,0,0
8,8482250.0,Callahan Burke,C,CAR,26,1,0,0,0
8,8481591.0,Sam Poulin,R,PIT,22,3,0,0,0
8,8481441.0,Joe Snively,C,WSH,27,3,0,0,0
8,8478967.0,Lane Pederson,C,CBJ,26,0,0,0,0
8,8479333.0,Libor Hajek,D,NYR,25,0,0,0,0
8,8480833.0,Vitali Kravtsov,R,VAN,24,0,0,0,0
8,8477460.0,Laurent Dauphin,C,ARI,28,0,0,0,0
8,8481461.0,Corey Schueneman,D,MTL,28,0,0,0,0
8,8474190.0,Wayne Simmonds,R,TOR,35,0,0,0,0
8,8483549.0,Lucas Condotta,L,MTL,26,3,0,0,0
8,8477993.0,Justin Kirkland,C,ARI,27,2,0,0,0
8,8480935.0,Lawrence Pilut,D,BUF,28,0,0,0,0
8,8477210.0,Buddy Robinson,R,CHI,32,0,0,0,0
8,8476851.0,Alex Galchenyuk,C,COL,29,0,0,0,0
8,8482197.0,Adam Raska,R,MIN,22,5,0,0,0
8,8479366.0,Logan Brown,C,STL,25,0,0,0,0
8,8479356.0,Kieffer Bellows,L,PHI,25,0,0,0,0
8,8479533.0,Joona Koppanen,L,PIT,25,4,0,0,0
8,8477401.0,John Hayden,C,SEA,28,2,0,0,0
8,8480822.0,Martin Kaut,R,SJS,24,0,0,0,0
8,8474610.0,Zac Dalpe,C,FLA,34,0,0,0,0
8,8482399.0,Billy Sweezey,D,CBJ,27,0,0,0,0
8,8479991.0,Jake Leschyshyn,C,NYR,24,1,0,0,0
8,8479550.0,Tanner Laczynski,C,PHI,26,0,0,0,0
8,8476166.0,Taylor Fedun,D,PIT,35,0,0,0,0
8,8479338.0,Markus Niemelainen,D,EDM,25,0,0,0,0
8,8477320.0,Anton Blidh,L,NYR,28,1,0,0,0
8,8478147.0,Bokondji Imama,L,ARI,27,6,0,0,0
8,8478067.0,Oskar Lindblom,L,SJS,27,1,0,0,0
8,8478506.0,Gabriel Carlsson,D,WSH,26,0,0,0,0
8,8478131.0,Ondrej Kase,R,CAR,28,0,0,0,0
8,8479644.0,Matt Luff,R,DET,26,0,0,0,0
8,8482824.0,Nick Cicek,D,SJS,23,0,0,0,0
8,8482834.0,Jesper Froden,R,SEA,29,0,0,0,0
8,8478491.0,Jacob Larsson,D,OTT,26,0,0,0,0
8,8474089.0,Brad Malone,C,EDM,34,0,0,0,0
8,8482641.0,Matt Kiersted,D,FLA,25,0,0,0,0
8,8480071.0,Robin Salo,D,NYI,25,0,0,0,0
8,8475461.0,Andrew Agozzino,L,SJS,32,0,0,0,0
8,8475160.0,Kyle Clifford,L,TOR,32,0,0,0,0
8,8480056.0,Jack Rathbone,D,VAN,24,0,0,0,0
8,8481725.0,Elmer Soderblom,L,DET,22,0,0,0,0
8,8479465.0,Drake Caggiula,L,PIT,29,0,0,0,0
8,8476948.0,Charles Hudon,L,COL,29,0,0,0,0
8,8479523.0,Lucas Carlsson,D,FLA,26,0,0,0,0
8,8478455.0,Austin Wagner,L,CHI,26,0,0,0,0
8,8481572.0,Ville Heinola,D,WPG,22,0,0,0,0
8,8479404.0,Henrik Borgstrom,C,WSH,26,0,0,0,0
8,8479944.0,Zach Aston-Reese,C,DET,29,3,0,0,0
8,8482635.0,Mike Hardman,L,CHI,24,0,0,0,0
8,8479705.0,Jeffrey Viel,L,SJS,26,0,0,0,0
8,8480467.0,Austin Strand,D,ANA,26,0,0,0,0
8,8480037.0,Aleksi Heponiemi,C,FLA,24,0,0,0,0
8,8479573.0,Mikhail Maltsev,L,COL,25,0,0,0,0
8,8476404.0,Andy Andreoff,C,NYI,32,0,0,0,0
8,8484125.0,Hunter McKown,C,CBJ,21,0,0,0,0
8,8481649.0,Joona Luoto,L,CBJ,26,0,0,0,0
8,8477981.0,Roland McKeown,D,NSH,27,0,0,0,0
8,8480831.0,Alec Regula,D,CHI,23,0,0,0,0
8,8482691.0,Aatu Raty,C,VAN,21,0,0,0,0
8,8482623.0,Josh Dunne,C,CBJ,25,0,0,0,0
8,8481433.0,Taro Hirose,L,DET,27,0,0,0,0
8,8480328.0,David Gust,R,CHI,29,0,0,0,0
8,8479526.0,Otto Koivula,L,NYI,25,0,0,0,0
8,8476390.0,Joseph Cramarossa,C,MIN,31,0,0,0,0
8,8482654.0,Jackson Cates,C,PHI,26,0,0,0,0
8,8480439.0,Mac Hollowell,D,TOR,25,0,0,0,0
8,8480072.0,Lias Andersson,C,LAK,25,0,0,0,0
8,8479395.0,Dennis Cholowski,D,NYI,25,0,0,0,0
8,8477463.0,Steven Santini,D,STL,28,0,0,0,0
8,8479347.0,Tyler Benson,L,EDM,25,0,0,0,0
8,8477471.0,Dillon Heatherington,D,OTT,28,0,0,0,0
8,8477520.0,Jean-Sebastien Dea,C,ARI,29,0,0,0,0
8,8480846.0,Sampo Ranta,L,COL,23,0,0,0,0
8,8480979.0,Nathan Smith,C,ARI,25,0,0,0,0
8,8484256.0,Jake Livingstone,D,NSH,24,0,0,0,0
8,8476396.0,Steven Fogarty,C,MIN,30,0,0,0,0
8,8479252.0,Dan Renouf,D,BOS,29,0,0,0,0
8,8479518.0,Fredrik Karlström,C,DAL,25,0,0,0,0
8,8481683.0,Aidan McDonough,L,VAN,24,0,0,0,0
8,8478373.0,Nikita Soshnikov,R,NYI,30,0,0,0,0
8,8482081.0,Sean Farrell,C,MTL,22,0,0,0,0
8,8481575.0,Lassi Thomson,D,OTT,23,0,0,0,0
8,8481102.0,Egor Sokolov,L,OTT,23,0,0,0,0
8,8481712.0,Matej Blumel,R,DAL,23,0,0,0,0
8,8479602.0,Jeremy Davies,D,BUF,27,0,0,0,0
8,8480443.0,Kristian Reichel,C,WPG,25,0,0,0,0
8,8479304.0,Kyle Criscuolo,C,SJS,31,0,0,0,0
8,8478224.0,Luke Philp,C,CHI,28,0,0,0,0
8,8480242.0,Arnaud Durandeau,L,NYI,24,0,0,0,0
8,8479329.0,Frederic Allard,D,MTL,26,0,0,0,0
8,8476941.0,Connor Carrick,D,BOS,29,0,0,0,0
8,8479375.0,William Bitten,C,STL,25,0,0,0,0
8,8481720.0,Nick Abruzzese,C,TOR,24,0,0,0,0
8,8482452.0,Elliot Desnoyers,L,PHI,21,0,0,0,0
8,8476915.0,Jujhar Khaira,L,MIN,29,1,0,0,0
8,8483641.0,Anton Levtchi,L,FLA,28,0,0,0,0
8,8481740.0,Tyce Thompson,R,NJD,24,0,0,0,0
8,8478173.0,Hayden Hodgson,R,PHI,27,0,0,0,0
8,8482181.0,Tristen Robins,C,SJS,22,0,0,0,0
8,8481563.0,Drew Helleson,D,ANA,22,0,0,0,0
8,8480863.0,Gabriel Fortier,L,TBL,23,0,0,0,0
8,8478058.0,CJ Suess,L,SJS,29,0,0,0,0
8,8480041.0,Dmitri Samorukov,D,STL,24,0,0,0,0
8,8482179.0,Justin Richards,C,CBJ,25,0,0,0,0
8,8480034.0,Joel Teasdale,L,MTL,24,0,0,0,0
8,8480820.0,Filip Kral,D,TOR,24,0,0,0,0
8,8480842.0,Filip Hallander,C,PIT,23,0,0,0,0
8,8478367.0,Cole Bardreau,C,NYI,30,0,0,0,0
8,8482448.0,Samuel Knazko,D,CBJ,21,0,0,0,0
8,8482711.0,Stanislav Svozil,D,CBJ,20,0,0,0,0
8,8480275.0,Nick Swaney,R,MIN,26,0,0,0,0
8,8480994.0,Damien Giroux,C,MIN,23,0,0,0,0
8,8480977.0,Semyon Der-Arguchintsev,C,TOR,23,0,0,0,0
8,8482207.0,William Dufour,R,NYI,21,0,0,0,0
8,8483464.0,Marco Kasper,C,DET,19,0,0,0,0
8,8483424.0,Owen Beck,C,MTL,19,0,0,0,0
9,8476453.0,Nikita Kucherov,R,TBL,30,81,44,100,144
9,8477492.0,Nathan MacKinnon,C,COL,28,82,51,89,140
9,8478402.0,Connor McDavid,C,EDM,26,76,32,100,132
9,8478550.0,Artemi Panarin,L,NYR,32,82,49,71,120
9,8477956.0,David Pastrnak,R,BOS,27,82,47,63,110
9,8479318.0,Auston Matthews,C,TOR,26,81,69,38,107
9,8477934.0,Leon Draisaitl,C,EDM,28,81,41,65,106
9,8478420.0,Mikko Rantanen,R,COL,27,80,42,62,104
9,8476468.0,J.T. Miller,C,VAN,30,81,37,66,103
9,8477939.0,William Nylander,R,TOR,27,82,40,58,98
9,8478864.0,Kirill Kaprizov,L,MIN,26,75,46,50,96
9,8477933.0,Sam Reinhart,C,FLA,28,82,57,37,94
9,8476887.0,Filip Forsberg,L,NSH,29,82,48,46,94
9,8471675.0,Sidney Crosby,C,PIT,36,82,42,52,94
9,8480800.0,Quinn Hughes,D,VAN,24,82,17,75,92
9,8478010.0,Brayden Point,C,TBL,27,81,46,44,90
9,8480069.0,Cale Makar,D,COL,25,77,21,69,90
9,8478427.0,Sebastian Aho,C,CAR,26,78,36,53,89
9,8480012.0,Elias Pettersson,C,VAN,25,82,34,55,89
9,8479314.0,Matthew Tkachuk,L,FLA,26,80,26,62,88
9,8480023.0,Robert Thomas,C,STL,24,82,26,60,86
9,8474600.0,Roman Josi,D,NSH,33,82,23,62,85
9,8479407.0,Jesper Bratt,L,NJD,25,82,27,56,83
9,8480803.0,Evan Bouchard,D,EDM,24,81,18,64,82
9,8474564.0,Steven Stamkos,C,TBL,33,79,40,41,81
9,8480027.0,Jason Robertson,L,DAL,24,82,29,51,80
9,8478445.0,Mathew Barzal,C,NYI,26,80,23,57,80
9,8477493.0,Aleksander Barkov,C,FLA,28,73,23,57,80
9,8475786.0,Zach Hyman,L,EDM,31,80,54,23,77
9,8480018.0,Nick Suzuki,C,MTL,24,82,33,44,77
9,8477404.0,Jake Guentzel,L,PIT,29,67,30,47,77
9,8476389.0,Vincent Trocheck,C,NYR,30,82,25,52,77
9,8479343.0,Clayton Keller,R,ARI,25,78,33,43,76
9,8475167.0,Victor Hedman,D,TBL,33,78,13,63,76
9,8475184.0,Chris Kreider,L,NYR,32,82,39,36,75
9,8475172.0,Nazem Kadri,C,CGY,33,82,29,46,75
9,8477960.0,Adrian Kempe,R,LAK,27,77,28,47,75
9,8479542.0,Brandon Hagel,L,TBL,25,82,26,49,75
9,8474679.0,Gustav Nyquist,C,NSH,34,81,23,52,75
9,8480801.0,Brady Tkachuk,L,OTT,24,81,37,37,74
9,8481559.0,Jack Hughes,C,NJD,22,62,27,47,74
9,8478444.0,Brock Boeser,R,VAN,26,81,40,33,73
9,8477942.0,Kevin Fiala,L,LAK,27,82,29,44,73
9,8479323.0,Adam Fox,D,NYR,25,72,17,56,73
9,8477409.0,Carter Verhaeghe,C,FLA,28,76,34,38,72
9,8482078.0,Lucas Raymond,L,DET,21,82,31,41,72
9,8476459.0,Mika Zibanejad,C,NYR,30,81,26,46,72
9,8476460.0,Mark Scheifele,C,WPG,30,74,25,47,72
9,8471685.0,Anze Kopitar,C,LAK,36,81,26,44,70
9,8482116.0,Tim Stützle,C,OTT,21,75,18,52,70
9,8480865.0,Noah Dobson,D,NYI,23,79,10,60,70
9,8476539.0,Jonathan Marchessault,R,VGK,33,82,42,27,69
9,8475754.0,Brock Nelson,C,NYI,32,82,34,35,69
9,8477946.0,Dylan Larkin,C,DET,27,68,33,36,69
9,8475158.0,Ryan O'Reilly,C,NSH,32,82,26,43,69
9,8477504.0,Josh Morrissey,D,WPG,28,81,10,59,69
9,8478439.0,Travis Konecny,R,PHI,26,76,33,35,68
9,8477500.0,Bo Horvat,C,NYI,28,81,33,35,68
9,8478403.0,Jack Eichel,C,VGK,27,63,31,37,68
9,8481557.0,Matt Boldy,L,MIN,22,75,29,39,68
9,8482093.0,Seth Jarvis,C,CAR,21,81,33,34,67
9,8479385.0,Jordan Kyrou,C,STL,25,82,31,36,67
9,8473419.0,Brad Marchand,L,BOS,35,82,29,38,67
9,8480002.0,Nico Hischier,C,NJD,24,71,27,40,67
9,8471215.0,Evgeni Malkin,C,PIT,37,82,27,40,67
9,8478440.0,Dylan Strome,C,WSH,26,82,27,40,67
9,8479337.0,Alex DeBrincat,R,DET,26,82,27,40,67
9,8470794.0,Joe Pavelski,C,DAL,39,82,27,40,67
9,8476454.0,Ryan Nugent-Hopkins,C,EDM,30,80,18,49,67
9,8480208.0,Drake Batherson,R,OTT,25,82,28,38,66
9,8482740.0,Wyatt Johnston,C,DAL,20,82,32,33,65
9,8471214.0,Alex Ovechkin,L,WSH,38,79,31,34,65
9,8478449.0,Roope Hintz,C,DAL,27,80,30,35,65
9,8475166.0,John Tavares,C,TOR,33,80,29,36,65
9,8481540.0,Cole Caufield,R,MTL,22,82,28,37,65
9,8475168.0,Matt Duchene,C,DAL,32,80,25,40,65
9,8478493.0,Joel Eriksson Ek,C,MIN,26,77,30,34,64
9,8473512.0,Claude Giroux,R,OTT,35,82,21,43,64
9,8477402.0,Pavel Buchnevich,L,STL,28,80,27,36,63
9,8475692.0,Mats Zuccarello,R,MIN,36,69,12,51,63
9,8477955.0,Jared McCann,L,SEA,27,80,29,33,62
9,8476875.0,Mike Matheson,D,MTL,29,82,11,51,62
9,8478398.0,Kyle Connor,L,WPG,27,65,34,27,61
9,8477940.0,Nikolaj Ehlers,L,WPG,27,82,25,36,61
9,8477951.0,Nick Schmaltz,C,ARI,27,79,22,39,61
9,8478366.0,Frank Vatrano,R,ANA,29,82,37,23,60
9,8476448.0,William Karlsson,C,VGK,30,70,30,30,60
9,8475745.0,Charlie Coyle,C,BOS,31,82,25,35,60
9,8473994.0,Jamie Benn,L,DAL,34,82,21,39,60
9,8475798.0,Mikael Granlund,C,SJS,31,69,12,48,60
9,8476346.0,Johnny Gaudreau,L,CBJ,30,81,12,48,60
9,8481068.0,Yegor Sharangovich,C,CGY,25,82,31,28,59
9,8477497.0,Sean Monahan,C,WPG,29,83,26,33,59
9,8477949.0,Alex Tuch,R,BUF,27,75,22,37,59
9,8478401.0,Pavel Zacha,C,BOS,26,78,21,38,59
9,8480839.0,Rasmus Dahlin,D,BUF,23,81,20,39,59
9,8477416.0,Oliver Bjorkstrand,R,SEA,28,82,20,39,59
9,8476853.0,Morgan Rielly,D,TOR,29,72,7,51,58
9,8479675.0,Trevor Moore,L,LAK,28,82,31,26,57
9,8482109.0,Alexis Lafrenière,L,NYR,22,82,28,29,57
9,8479999.0,Casey Mittelstadt,C,BUF,25,80,18,39,57
9,8481711.0,Matias Maccelli,L,ARI,23,82,17,40,57
9,8478460.0,Zach Werenski,D,CBJ,26,70,11,46,57
9,8479420.0,Tage Thompson,C,BUF,26,71,29,27,56
9,8475810.0,Bryan Rust,R,PIT,31,62,28,28,56
9,8477494.0,Jonathan Drouin,L,COL,28,79,19,37,56
9,8474578.0,Erik Karlsson,D,PIT,33,82,11,45,56
9,8476906.0,Shayne Gostisbehere,D,DET,30,81,10,46,56
9,8475726.0,Tyler Toffoli,R,NJD,31,79,33,22,55
9,8475765.0,Vladimir Tarasenko,R,OTT,32,76,23,32,55
9,8482124.0,Quinton Byfield,R,LAK,21,80,20,35,55
9,8478047.0,Michael Bunting,L,CAR,28,81,19,36,55
9,8475151.0,Kyle Palmieri,C,NYI,32,82,30,24,54
9,8476399.0,Blake Coleman,C,CGY,32,78,30,24,54
9,8478873.0,Troy Terry,R,ANA,26,76,20,34,54
9,8480798.0,Philipp Kurashev,C,CHI,24,75,18,36,54
9,8480036.0,Miro Heiskanen,D,DAL,24,71,9,45,54
9,8477501.0,Valeri Nichushkin,R,COL,28,54,28,25,53
9,8480015.0,Owen Tippett,R,PHI,24,78,28,25,53
9,8476882.0,Teuvo Teravainen,L,CAR,29,76,25,28,53
9,8480039.0,Martin Necas,C,CAR,24,77,24,29,53
9,8478975.0,Mason Marchment,L,DAL,28,81,22,31,53
9,8475913.0,Mark Stone,R,VGK,31,56,16,37,53
9,8478414.0,Timo Meier,R,NJD,27,69,28,24,52
9,8475794.0,Tyler Seguin,C,DAL,31,68,25,27,52
9,8477346.0,MacKenzie Weegar,D,CGY,29,82,20,32,52
9,8480830.0,Andrei Svechnikov,R,CAR,23,59,19,33,52
9,8476456.0,Jonathan Huberdeau,C,CGY,30,81,12,40,52
9,8474590.0,John Carlson,D,WSH,33,82,10,42,52
9,8474641.0,Adam Henrique,C,ANA,33,82,24,27,51
9,8476905.0,Chandler Stephenson,C,VGK,29,75,16,35,51
9,8471724.0,Kris Letang,D,PIT,36,82,10,41,51
9,8482175.0,JJ Peterka,R,BUF,21,82,28,22,50
9,8480797.0,Joel Farabee,L,PHI,23,82,22,28,50
9,8483515.0,Juraj Slafkovsky,L,MTL,19,82,20,30,50
9,8474563.0,Drew Doughty,D,LAK,34,82,15,35,50
9,8478038.0,Devon Toews,D,COL,29,82,12,38,50
9,8477456.0,J.T. Compher,L,DET,28,77,19,29,48
9,8479425.0,Filip Hronek,D,VAN,26,81,5,43,48
9,8474141.0,Patrick Kane,R,DET,35,50,20,27,47
9,8478856.0,Conor Garland,R,VAN,27,82,20,27,47
9,8481528.0,Dylan Cozens,C,BUF,22,79,18,29,47
9,8476479.0,Phillip Danault,C,LAK,30,78,17,30,47
9,8474102.0,David Perron,L,DET,35,76,17,30,47
9,8481581.0,Thomas Harley,D,DAL,22,79,15,32,47
9,8478396.0,Noah Hanifin,D,CGY,26,80,13,34,47
9,8476869.0,Brady Skjei,D,CAR,29,80,13,34,47
9,8479325.0,Charlie McAvoy,D,BOS,26,74,12,35,47
9,8482684.0,Luke Hughes,D,NJD,20,82,9,38,47
9,8477503.0,Max Domi,C,TOR,28,80,9,38,47
9,8482122.0,Brock Faber,D,MIN,21,82,8,39,47
9,8477426.0,Nicholas Paul,L,TBL,28,82,24,22,46
9,8475784.0,Jeff Skinner,L,BUF,31,74,24,22,46
9,8483808.0,Andrei Kuzmenko,L,CGY,27,72,22,24,46
9,8475170.0,Brayden Schenn,C,STL,32,82,20,26,46
9,8478407.0,Vince Dunn,D,SEA,27,59,11,35,46
9,8475760.0,Nick Bjugstad,C,ARI,31,76,22,23,45
9,8477451.0,Ryan Hartman,R,MIN,29,74,21,24,45
9,8478519.0,Anthony Cirelli,C,TBL,26,79,20,25,45
9,8477964.0,Ivan Barbashev,C,VGK,28,82,19,26,45
9,8478438.0,Tommy Novak,C,NSH,26,71,18,27,45
9,8482667.0,William Eklund,L,SJS,21,80,16,29,45
9,8477021.0,Alex Kerfoot,C,ARI,29,82,13,32,45
9,8475218.0,Mattias Ekholm,D,EDM,33,79,11,34,45
9,8480188.0,Fabian Zetterlund,L,SJS,24,82,24,20,44
9,8475169.0,Evander Kane,L,EDM,32,77,24,20,44
9,8477511.0,Anthony Mantha,R,WSH,29,74,23,21,44
9,8474586.0,Jordan Eberle,R,SEA,33,78,17,27,44
9,8477496.0,Elias Lindholm,C,VAN,29,75,15,29,44
9,8477948.0,Travis Sanheim,D,PHI,27,81,10,34,44
9,8477479.0,Tyler Bertuzzi,L,TOR,28,80,21,22,43
9,8478466.0,Daniel Sprong,R,DET,26,76,18,25,43
9,8470613.0,Brent Burns,D,CAR,38,82,10,33,43
9,8476438.0,Brandon Saad,L,STL,31,82,26,16,42
9,8477407.0,Anthony Duclair,L,SJS,28,73,24,18,42
9,8478474.0,Lawson Crouse,L,ARI,26,81,23,19,42
9,8480893.0,Kirill Marchenko,R,CBJ,23,78,23,19,42
9,8482745.0,Mason McTavish,C,ANA,20,64,19,23,42
9,8481542.0,Moritz Seider,D,DET,22,82,9,33,42
9,8477447.0,Shea Theodore,D,VGK,28,47,5,37,42
9,8477935.0,Sam Bennett,C,FLA,27,69,20,21,41
9,8477998.0,Warren Foegele,L,EDM,27,82,20,21,41
9,8480009.0,Eeli Tolvanen,R,SEA,24,81,16,25,41
9,8479345.0,Jakob Chychrun,D,OTT,25,82,14,27,41
9,8480028.0,Morgan Frost,C,PHI,24,71,13,28,41
9,8478462.0,Nicolas Roy,C,VGK,26,70,13,28,41
9,8476458.0,Ryan Strome,C,ANA,30,79,11,30,41
9,8480434.0,Sean Durzi,D,ARI,25,76,9,32,41
9,8482079.0,Marco Rossi,C,MIN,22,82,21,19,40
9,8478498.0,Jake DeBrusk,L,BOS,27,80,19,21,40
9,8479365.0,Trent Frederic,C,BOS,25,82,18,22,40
9,8479525.0,Ross Colton,C,COL,27,80,17,23,40
9,8479400.0,Pierre-Luc Dubois,C,LAK,25,82,16,24,40
9,8478233.0,Andrew Mangiapane,L,CGY,27,75,14,26,40
9,8475191.0,Reilly Smith,R,PIT,32,76,13,27,40
9,8479987.0,Morgan Geekie,C,BOS,25,76,17,22,39
9,8482146.0,Luke Evangelista,R,NSH,21,80,16,23,39
9,8474150.0,Mikael Backlund,C,CGY,34,82,15,24,39
9,8476872.0,Scott Laughton,C,PHI,29,82,13,26,39
9,8478542.0,Evan Rodrigues,C,FLA,30,80,12,27,39
9,8478055.0,Gustav Forsling,D,FLA,27,79,10,29,39
9,8478397.0,Rasmus Andersson,D,CGY,27,78,9,30,39
9,8475764.0,Cam Fowler,D,ANA,32,81,5,34,39
9,8476792.0,Torey Krug,D,STL,32,77,4,35,39
9,8482089.0,Jake Neighbours,L,STL,21,77,27,11,38
9,8482149.0,Cole Perfetti,C,WPG,21,71,19,19,38
9,8476881.0,Tomas Hertl,C,SJS,30,54,17,21,38
9,8474037.0,James van Riemsdyk,L,BOS,34,71,11,27,38
9,8482105.0,Jake Sanderson,D,OTT,21,79,10,28,38
9,8475314.0,Anders Lee,L,NYI,33,81,20,17,37
9,8473422.0,Nick Foligno,L,CHI,36,74,17,20,37
9,8482665.0,Matty Beniers,C,SEA,21,77,15,22,37
9,8476483.0,Rickard Rakell,R,PIT,30,70,15,22,37
9,8476474.0,Stefan Noesen,R,CAR,30,81,14,23,37
9,8476480.0,Vladislav Namestnikov,C,WPG,31,78,11,26,37
9,8476958.0,Jaccob Slavin,D,CAR,29,81,6,31,37
9,8481535.0,Nils Hoglander,L,VAN,23,80,24,12,36
9,8480014.0,Gabriel Vilardi,C,WPG,24,47,22,14,36
9,8473986.0,Alex Killorn,L,ANA,34,63,18,18,36
9,8478046.0,Danton Heinen,L,BOS,28,74,17,19,36
9,8478891.0,Mason Appleton,C,WPG,27,82,14,22,36
9,8476432.0,Boone Jenner,C,CBJ,30,58,22,13,35
9,8477450.0,Jason Dickinson,C,CHI,28,82,22,13,35
9,8476880.0,Tom Wilson,R,WSH,29,74,18,17,35
9,8482699.0,Dylan Guenther,R,ARI,20,45,18,17,35
9,8475287.0,Erik Haula,L,NJD,32,76,16,19,35
9,8476925.0,Colton Sissons,C,NSH,30,81,15,20,35
9,8482720.0,Matthew Knies,L,TOR,21,80,15,20,35
9,8482113.0,Anton Lundell,C,FLA,22,78,13,22,35
9,8476392.0,Adam Lowry,C,WPG,30,81,12,23,35
9,8478472.0,Mathieu Joseph,R,OTT,26,72,11,24,35
9,8475799.0,Nino Niederreiter,R,WPG,31,77,18,16,34
9,8477476.0,Artturi Lehkonen,L,COL,28,45,16,18,34
9,8481618.0,Alex Newhook,C,MTL,22,55,15,19,34
9,8482159.0,Tyson Foerster,R,PHI,21,77,20,13,33
9,8482110.0,Dawson Mercer,C,NJD,22,82,20,13,33
9,8481580.0,Connor McMichael,C,WSH,22,80,18,15,33
9,8482055.0,Drew O'Connor,L,PIT,25,79,16,17,33
9,8477429.0,Andrew Copp,C,DET,29,79,13,20,33
9,8479992.0,Michael Rasmussen,C,DET,24,75,13,20,33
9,8476826.0,Yanni Gourde,C,SEA,32,80,11,22,33
9,8476419.0,Jean-Gabriel Pageau,C,NYI,31,82,11,22,33
9,8477986.0,Brandon Montour,D,FLA,29,66,8,25,33
9,8482671.0,Owen Power,D,BUF,21,76,6,27,33
9,8478178.0,Darren Raddysh,D,TBL,27,82,6,27,33
9,8480145.0,Neal Pionk,D,WPG,28,82,5,28,33
9,8474565.0,Alex Pietrangelo,D,VGK,33,64,4,29,33
9,8478057.0,Dakota Joshua,C,VAN,27,63,18,14,32
9,8477952.0,Robby Fabbri,C,DET,27,68,18,14,32
9,8476921.0,Jordan Martinook,L,CAR,31,82,14,18,32
9,8475722.0,Jason Zucker,L,ARI,31,69,14,18,32
9,8482705.0,Cole Sillinger,C,CBJ,20,77,13,19,32
9,8477498.0,Darnell Nurse,D,EDM,28,81,10,22,32
9,8475171.0,Oliver Ekman-Larsson,D,FLA,32,80,9,23,32
9,8478500.0,Ivan Provorov,D,CBJ,26,82,5,27,32
9,8474151.0,Ryan McDonagh,D,NSH,34,74,3,29,32
9,8474870.0,Tyler Johnson,C,CHI,33,67,17,14,31
9,8475848.0,Brendan Gallagher,R,MTL,31,77,16,15,31
9,8474189.0,Lars Eller,C,PIT,34,82,15,16,31
9,8476292.0,Ondrej Palat,L,NJD,32,71,11,20,31
9,8481624.0,Ilya Mikheyev,R,VAN,29,78,11,20,31
9,8478458.0,Jack Roslovic,C,CBJ,26,59,9,22,31
9,8477495.0,Seth Jones,D,CHI,29,67,8,23,31
9,8476979.0,Erik Gustafsson,D,NYR,31,76,6,25,31
9,8476331.0,Dylan DeMelo,D,WPG,30,82,3,28,31
9,8480064.0,Josh Norris,C,OTT,24,50,16,14,30
9,8475768.0,Jaden Schwartz,C,SEA,31,62,13,17,30
9,8480802.0,Ryan McLeod,C,EDM,24,81,12,18,30
9,8477987.0,Ryan Donato,C,CHI,27,78,12,18,30
9,8475149.0,Marcus Johansson,L,MIN,33,78,11,19,30
9,8481546.0,Cam York,D,PHI,22,82,10,20,30
9,8477505.0,Alex Wennberg,C,SEA,29,79,10,20,30
9,8473533.0,Jordan Staal,C,CAR,35,80,10,20,30
9,8478469.0,Thomas Chabot,D,OTT,26,51,9,21,30
9,8480817.0,K'Andre Miller,D,NYR,23,80,8,22,30
9,8477969.0,Marcus Pettersson,D,PIT,27,82,4,26,30
9,8475753.0,Justin Faulk,D,STL,31,60,2,28,30
9,8479619.0,Michael Carcone,L,ARI,27,74,21,8,29
9,8482475.0,Yegor Chinakhov,R,CBJ,22,53,16,13,29
9,8480459.0,Pius Suter,C,VAN,27,67,14,15,29
9,8475763.0,Kevin Hayes,R,STL,31,79,13,16,29
9,8481524.0,Bowen  Byram,D,COL,22,73,11,18,29
9,8480336.0,Sean Walker,D,PHI,29,81,10,19,29
9,8481656.0,Aliaksei Protas,C,WSH,22,78,6,23,29
9,8474574.0,Tyler Myers,D,VAN,33,77,5,24,29
9,8482125.0,Alexander Holtz,R,NJD,21,82,16,12,28
9,8480813.0,Joe Veleno,C,DET,23,80,12,16,28
9,8480068.0,Ryan Poehling,C,PHI,24,77,11,17,28
9,8478413.0,Jordan Greenway,L,BUF,26,67,10,18,28
9,8478115.0,Pierre Engvall,L,NYI,27,74,10,18,28
9,8476923.0,Damon Severson,D,CBJ,29,67,9,19,28
9,8476931.0,Jake McCabe,D,TOR,30,73,8,20,28
9,8478133.0,Jake Evans,C,MTL,27,82,7,21,28
9,8476927.0,Teddy Blueger,C,VAN,29,68,6,22,28
9,8475181.0,Nick Leddy,D,STL,32,82,3,25,28
9,8478020.0,Michael Amadio,R,VGK,27,73,14,13,27
9,8481582.0,Nicholas Robertson,L,TOR,22,56,14,13,27
9,8480185.0,Eetu Luostarinen,C,FLA,25,82,12,15,27
9,8480829.0,Jesperi Kotkaniemi,C,CAR,23,79,12,15,27
9,8480113.0,Alex Iafallo,L,WPG,30,82,11,16,27
9,8480748.0,Kiefer Sherwood,L,NSH,28,68,10,17,27
9,8481596.0,Shane Pinto,C,OTT,23,41,9,18,27
9,8480835.0,Jack Drury,C,CAR,23,74,8,19,27
9,8476463.0,Jonas Brodin,D,MIN,30,62,7,20,27
9,8482092.0,Ridly Greig,C,OTT,21,72,13,13,26
9,8476918.0,Jimmy Vesey,L,NYR,30,80,13,13,26
9,8476892.0,Colton Parayko,D,STL,30,82,10,16,26
9,8479941.0,Justin Danforth,R,CBJ,30,71,10,16,26
9,8477425.0,Miles Wood,L,COL,28,74,9,17,26
9,8480855.0,Jack McBain,C,ARI,23,67,8,18,26
9,8474602.0,Justin Schultz,D,SEA,33,70,7,19,26
9,8475790.0,Erik Gudbranson,D,CBJ,31,78,6,20,26
9,8475200.0,Dmitry Orlov,D,CAR,32,82,6,20,26
9,8482655.0,J.J. Moser,D,ARI,23,80,5,21,26
9,8476902.0,Esa Lindell,D,DAL,29,82,5,21,26
9,8475188.0,Brayden McNabb,D,VGK,32,82,4,22,26
9,8476854.0,Hampus Lindholm,D,BOS,29,73,3,23,26
9,8474673.0,TJ Brodie,D,TOR,33,78,1,25,26
9,8476469.0,Joel Armia,R,MTL,30,66,17,8,25
9,8481601.0,Simon Holmstrom,R,NYI,22,75,15,10,25
9,8481186.0,Logan O'Connor,R,COL,27,57,13,12,25
9,8471698.0,T.J. Oshie,R,WSH,37,52,12,13,25
9,8479591.0,Michael Eyssimont,C,TBL,27,81,11,14,25
9,8476312.0,Josh Manson,D,COL,32,76,8,17,25
9,8478136.0,Jake Middleton,D,MIN,27,80,7,18,25
9,8481032.0,Paul Cotter,C,VGK,24,76,7,18,25
9,8477508.0,Curtis Lazar,C,NJD,28,71,7,18,25
9,8482245.0,Artem Zub,D,OTT,28,69,5,20,25
9,8478911.0,Matt Roy,D,LAK,28,81,5,20,25
9,8476879.0,Cody Ceci,D,EDM,30,79,5,20,25
9,8478507.0,John Marino,D,NJD,26,75,4,21,25
9,8478840.0,Will Borgen,D,SEA,27,82,3,22,25
9,8482259.0,Bobby McMann,C,TOR,27,56,15,9,24
9,8481604.0,Pavel Dorofeyev,L,VGK,23,47,13,11,24
9,8478043.0,Sam Lafferty,C,VAN,28,79,13,11,24
9,8479351.0,Sam Steel,C,DAL,25,77,9,15,24
9,8475193.0,Tomas Tatar,L,SEA,33,70,9,15,24
9,8475744.0,Evgeny Kuznetsov,C,WSH,31,63,8,16,24
9,8475233.0,David Savard,D,MTL,33,60,6,18,24
9,8476422.0,Mike Reilly,D,NYI,30,61,6,18,24
9,8474031.0,Kevin Shattenkirk,D,BOS,34,61,6,18,24
9,8473507.0,Jeff Petry,D,DET,36,73,3,21,24
9,8480246.0,Nick Perbix,D,TBL,25,77,2,22,24
9,8481606.0,Jordan Spence,D,LAK,22,71,2,22,24
9,8477947.0,Sonny Milano,L,WSH,27,49,15,8,23
9,8475793.0,Ryan Johansen,C,COL,31,63,13,10,23
9,8480821.0,Filip Zadina,R,SJS,24,72,13,10,23
9,8474149.0,Evgenii Dadonov,R,DAL,34,51,12,11,23
9,8475231.0,Casey Cizikas,C,NYI,32,70,10,13,23
9,8474884.0,Mike Hoffman,C,SJS,34,66,10,13,23
9,8482062.0,Cole Smith,L,NSH,28,80,9,14,23
9,8478882.0,Vladislav Gavrikov,D,LAK,28,77,6,17,23
9,8474157.0,Max Pacioretty,L,WSH,35,47,4,19,23
9,8480873.0,Rasmus Sandin,D,WSH,23,68,3,20,23
9,8480043.0,Timothy Liljegren,D,TOR,24,55,3,20,23
9,8475343.0,Nic Dowd,C,WSH,33,64,12,10,22
9,8470621.0,Corey Perry,R,EDM,38,54,12,10,22
9,8473449.0,Kyle Okposo,R,BUF,35,67,12,10,22
9,8477446.0,Michael McCarron,R,NSH,28,70,12,10,22
9,8481517.0,Brett Leason,R,ANA,24,68,11,11,22
9,8478970.0,Jalen Chatfield,D,CAR,27,72,8,14,22
9,8481014.0,Alexander Romanov,D,NYI,23,81,7,15,22
9,8482087.0,Kaiden Guhle,D,MTL,21,70,6,16,22
9,8477953.0,Kasperi Kapanen,R,STL,27,73,6,16,22
9,8476885.0,Jacob Trouba,D,NYR,29,69,3,19,22
9,8480281.0,Alexey Toropchenko,R,STL,24,82,14,7,21
9,8482157.0,Will Cuylle,L,NYR,21,81,13,8,21
9,8478013.0,Jake Walman,D,DET,27,63,12,9,21
9,8475714.0,Calle Jarnkrok,C,TOR,32,52,10,11,21
9,8475220.0,Marcus Foligno,L,MIN,32,55,9,12,21
9,8471218.0,Blake Wheeler,R,NYR,37,54,9,12,21
9,8479359.0,Beck Malenstyn,L,WSH,25,81,6,15,21
9,8476897.0,Oskar Sundqvist,C,STL,29,71,6,15,21
9,8481178.0,Egor Zamula,D,PHI,23,66,5,16,21
9,8480891.0,Michael Kesselring,D,ARI,23,65,5,16,21
9,8479983.0,Mario Ferraro,D,SJS,25,78,3,18,21
9,8475225.0,Craig Smith,C,DAL,34,75,11,9,20
9,8476981.0,Josh Anderson,R,MTL,29,78,9,11,20
9,8475455.0,Brenden Dillon,D,WPG,33,77,8,12,20
9,8481577.0,Philip Tomasino,C,NSH,22,41,7,13,20
9,8477507.0,Nikita Zadorov,D,VAN,28,75,6,14,20
9,8475279.0,Ben Chiarot,D,DET,32,77,5,15,20
9,8478851.0,Alexandre Carrier,D,NSH,27,73,4,16,20
9,8480035.0,Henri Jokiharju,D,BUF,24,74,3,17,20
9,8480073.0,Erik Brannstrom,D,OTT,24,76,3,17,20
9,8475179.0,Dmitry Kulikov,D,FLA,33,76,1,19,20
9,8481554.0,Kaapo Kakko,R,NYR,22,61,13,6,19
9,8480980.0,Connor Dewar,C,MIN,24,74,11,8,19
9,8479415.0,Michael McLeod,C,NJD,25,45,10,9,19
9,8482097.0,Jack Quinn,R,BUF,22,27,9,10,19
9,8480144.0,David Kampf,C,TOR,28,78,8,11,19
9,8479353.0,Brett Howden,C,VGK,25,72,8,11,19
9,8475164.0,Jakob Silfverberg,R,ANA,33,81,7,12,19
9,8476889.0,Radek Faksa,C,DAL,29,74,7,12,19
9,8473504.0,Cal Clutterbuck,R,NYI,36,82,7,12,19
9,8475855.0,Jesper Fast,R,CAR,32,73,6,13,19
9,8477380.0,Jonny Brodzinski,C,NYR,30,57,6,13,19
9,8471699.0,Andrew Cogliano,C,COL,36,75,6,13,19
9,8477506.0,Ryan Pulock,D,NYI,29,58,5,14,19
9,8480172.0,Jan Rutta,D,SJS,33,69,5,14,19
9,8482073.0,Braden Schneider,D,NYR,22,82,5,14,19
9,8478432.0,Christian Fischer,R,DET,26,79,5,14,19
9,8479410.0,Mikhail Sergachev,D,TBL,25,34,2,17,19
9,8475690.0,Chris Tanev,D,CGY,34,75,2,17,19
9,8480878.0,Nils Lundkvist,D,DAL,23,59,2,17,19
9,8479316.0,Luke Kunin,C,SJS,26,77,11,7,18
9,8480289.0,Morgan Barron,C,WPG,25,80,11,7,18
9,8476374.0,Sean Kuraly,C,CBJ,30,62,9,9,18
9,8480448.0,Parker Kelly,L,OTT,24,80,8,10,18
9,8478434.0,Keegan Kolesar,R,VGK,26,79,8,10,18
9,8475462.0,Radko Gudas,D,ANA,33,66,6,12,18
9,8480220.0,Noah Cates,L,PHI,24,59,6,12,18
9,8476457.0,Adam Larsson,D,SEA,31,81,4,14,18
9,8477932.0,Aaron Ekblad,D,FLA,27,51,4,14,18
9,8477365.0,Connor Clifton,D,BUF,28,79,4,14,18
9,8476874.0,Olli Maatta,D,DET,29,72,4,14,18
9,8479398.0,Samuel Girard,D,COL,25,59,3,15,18
9,8479998.0,Mikey Anderson,D,LAK,24,74,2,16,18
9,8480049.0,Dylan Samberg,D,WPG,24,78,1,17,18
9,8478508.0,Yakov Trenin,C,NSH,26,76,12,5,17
9,8477903.0,Garnet Hathaway,R,PHI,32,82,7,10,17
9,8480995.0,Pontus Holmberg,R,TOR,24,54,7,10,17
9,8479315.0,Joey Anderson,R,CHI,25,55,5,12,17
9,8478463.0,Anthony Beauvillier,L,CHI,26,60,5,12,17
9,8474166.0,Alec Martinez,D,VGK,36,55,4,13,17
9,8481522.0,Peyton Krebs,C,BUF,22,80,4,13,17
9,8478859.0,Niko Mikkola,D,FLA,27,82,3,14,17
9,8479324.0,Ryan Lindgren,D,NYR,25,76,3,14,17
9,8481605.0,Jackson LaCombe,D,ANA,22,71,2,15,17
9,8479976.0,Juuso Valimaki,D,ARI,25,68,2,15,17
9,8470600.0,Ryan Suter,D,DAL,38,82,2,15,17
9,8480884.0,Calen Addison,D,SJS,23,72,1,16,17
9,8475842.0,Sam Carrick,C,ANA,31,77,10,6,16
9,8479977.0,Kailer Yamamoto,R,SEA,25,59,8,8,16
9,8473453.0,Trevor Lewis,C,LAK,36,82,8,8,16
9,8480205.0,Emil Bemstrom,R,CBJ,24,56,8,8,16
9,8479293.0,Brandon Tanev,L,SEA,32,66,7,9,16
9,8477444.0,Andre Burakovsky,L,SEA,28,49,7,9,16
9,8475208.0,Brian Dumoulin,D,SEA,32,80,6,10,16
9,8482660.0,Kent Johnson,C,CBJ,21,42,6,10,16
9,8477979.0,Nicolas Aube-Kubel,R,WSH,27,60,6,10,16
9,8476462.0,Dougie Hamilton,D,NJD,30,20,5,11,16
9,8482117.0,Lukas Reichel,L,CHI,21,65,5,11,16
9,8474034.0,Pat Maroon,L,MIN,35,51,4,12,16
9,8480796.0,Martin Fehervary,D,WSH,24,66,3,13,16
9,8476967.0,Brett Kulak,D,EDM,29,82,3,13,16
9,8471677.0,Jack Johnson,D,COL,36,80,3,13,16
9,8481568.0,Alex Vlasic,D,CHI,22,76,2,14,16
9,8476917.0,Adam Pelech,D,NYI,29,58,1,15,16
9,8479423.0,Alex Nylander,L,PIT,25,28,11,4,15
9,8478831.0,Kevin Stenlund,C,FLA,27,81,11,4,15
9,8470604.0,Jeff Carter,C,PIT,38,72,11,4,15
9,8477330.0,Dominik Kubalik,L,OTT,28,74,11,4,15
9,8476873.0,Mark Jankowski,C,NSH,29,32,7,8,15
9,8476393.0,Nick Cousins,C,FLA,30,69,7,8,15
9,8481560.0,Arthur Kaliyev,R,LAK,22,51,7,8,15
9,8481481.0,Blake Lizotte,C,LAK,26,62,7,8,15
9,8478109.0,Victor Olofsson,L,BUF,28,51,7,8,15
9,8481533.0,Trevor Zegras,C,ANA,22,31,6,9,15
9,8478042.0,Viktor Arvidsson,R,LAK,30,18,6,9,15
9,8474090.0,Brendan Smith,D,NJD,34,63,5,10,15
9,8477919.0,Frederick Gaudreau,C,MIN,30,67,5,10,15
9,8479368.0,Max Jones,L,ANA,25,52,5,10,15
9,8477839.0,Conor Sheary,L,TBL,31,57,4,11,15
9,8476467.0,Jamie Oleksiak,D,SEA,31,82,2,13,15
9,8475197.0,Tyson Barrie,D,NSH,32,41,1,14,15
9,8476878.0,Zemgus Girgensons,L,BUF,29,63,8,6,14
9,8480011.0,Klim Kostin,C,DET,24,52,8,6,14
9,8479661.0,Tanner Jeannot,L,TBL,26,55,7,7,14
9,8478468.0,Jeremy Lauzon,D,NSH,26,79,6,8,14
9,8480003.0,Jesper Boqvist,C,BOS,25,47,6,8,14
9,8479390.0,Taylor Raddysh,R,CHI,25,73,5,9,14
9,8477070.0,Liam O'Brien,C,ARI,29,75,5,9,14
9,8478443.0,Brandon Carlo,D,BOS,27,76,4,10,14
9,8480879.0,Jacob Bernard-Docker,D,OTT,23,72,4,10,14
9,8477392.0,Hudson Fasching,R,NYI,28,45,4,10,14
9,8477435.0,Ryan Graves,D,PIT,28,70,3,11,14
9,8474567.0,Zach Bogosian,D,MIN,33,65,3,11,14
9,8480887.0,Jordan Harris,D,MTL,23,56,3,11,14
9,8480727.0,Zach Whitecloud,D,VGK,27,61,2,12,14
9,8477220.0,Nate Schmidt,D,WPG,32,63,2,12,14
9,8475324.0,Nick Jensen,D,WSH,33,78,1,13,14
9,8480001.0,Urho Vaakanainen,D,ANA,24,68,1,13,14
9,8477845.0,Trevor van Riemsdyk,D,WSH,32,70,0,14,14
9,8482111.0,Justin Barron,D,MTL,22,48,7,6,13
9,8479383.0,Boris Katchouk,L,CHI,25,59,7,6,13
9,8477573.0,Nathan Walker,L,STL,29,45,7,6,13
9,8480192.0,Johnathan Kovacevic,D,MTL,26,62,6,7,13
9,8479996.0,Cody Glass,C,NSH,24,41,6,7,13
9,8481477.0,Nico Sturm,C,SJS,28,63,5,8,13
9,8476871.0,Tanner Pearson,L,MTL,31,54,5,8,13
9,8479520.0,Brandon Duhaime,R,MIN,26,80,5,8,13
9,8479402.0,Jake Bean,D,CBJ,25,72,4,9,13
9,8482222.0,Alexander Barabanov,L,SJS,29,46,4,9,13
9,8477488.0,Brett Pesce,D,CAR,29,70,3,10,13
9,8479371.0,Dante Fabbro,D,NSH,25,56,3,10,13
9,8478416.0,Erik Cernak,D,TBL,26,69,2,11,13
9,8476372.0,Nick Seeler,D,PHI,30,71,1,12,13
9,8481704.0,Juuso Parssinen,C,NSH,22,44,8,4,12
9,8476278.0,Colin Blackwell,C,CHI,30,44,8,4,12
9,8479336.0,Carl Grundstrom,R,LAK,26,50,8,4,12
9,8471709.0,Marc-Edouard Vlasic,D,SJS,36,57,6,6,12
9,8479393.0,Noah Gregor,C,TOR,25,63,6,6,12
9,8478421.0,A.J. Greer,L,CGY,27,59,6,6,12
9,8479671.0,Mathieu Olivier,R,CBJ,26,54,5,7,12
9,8477846.0,Ryan Carpenter,C,SJS,32,62,5,7,12
9,8478585.0,Derek Ryan,C,EDM,37,70,5,7,12
9,8479414.0,Nathan Bastian,R,NJD,26,54,5,7,12
9,8477015.0,Connor Brown,R,EDM,29,71,4,8,12
9,8476624.0,Barclay Goodrow,C,NYR,30,80,4,8,12
9,8477406.0,Mattias Janmark,C,EDM,31,71,4,8,12
9,8476919.0,Chris Tierney,C,NJD,29,52,4,8,12
9,8479543.0,Michael Pezzetta,L,MTL,25,61,3,9,12
9,8475825.0,Jani Hakanpää,D,DAL,31,64,2,10,12
9,8479980.0,Nicolas Hague,D,VGK,25,73,2,10,12
9,8476822.0,Luke Glendening,C,TBL,34,81,10,1,11
9,8482133.0,Thomas Bordeleau,C,SJS,21,27,6,5,11
9,8480806.0,Isac Lundestrom,C,ANA,24,46,5,6,11
9,8480025.0,MacKenzie Entwistle,R,CHI,24,67,5,6,11
9,8475750.0,Jon Merrill,D,MIN,31,65,4,7,11
9,8481567.0,Henry Thrun,D,SJS,22,51,3,8,11
9,8477950.0,Tony DeAngelo,D,CAR,28,31,3,8,11
9,8474013.0,Ian Cole,D,VAN,34,78,2,9,11
9,8476891.0,Matt Grzelcyk,D,BOS,29,63,2,9,11
9,8480058.0,Pierre-Olivier Joseph,D,PIT,24,52,2,9,11
9,8480860.0,Kevin Bahl,D,NJD,23,82,1,10,11
9,8479576.0,Vincent Desharnais,D,EDM,27,78,1,10,11
9,8470610.0,Zach Parise,L,COL,39,30,5,5,10
9,8476858.0,Phillip Di Giuseppe,L,VAN,30,51,5,5,10
9,8474040.0,Sam Gagner,C,EDM,34,28,5,5,10
9,8480355.0,Mark Kastelic,C,OTT,24,63,5,5,10
9,8482142.0,Jamie Drysdale,D,PHI,21,34,3,7,10
9,8480849.0,Barrett Hayton,C,ARI,23,33,3,7,10
9,8475177.0,Calvin de Haan,D,TBL,32,59,3,7,10
9,8482964.0,Arber Xhekaj,D,MTL,22,44,3,7,10
9,8477384.0,Josh Brown,D,ARI,29,51,3,7,10
9,8480184.0,Gustav Lindström,D,ANA,25,46,3,7,10
9,8480762.0,Eric Robinson,L,BUF,28,47,3,7,10
9,8477018.0,Ben Hutton,D,VGK,30,41,2,8,10
9,8481093.0,Rafael Harvey-Pinard,L,MTL,24,45,2,8,10
9,8480880.0,Jakub Lauko,C,BOS,23,60,2,8,10
9,8480871.0,Adam Boqvist,D,CBJ,23,35,1,9,10
9,8479369.0,Andrew Peeke,D,CBJ,25,38,1,9,10
9,8479982.0,Conor Timmins,D,TOR,25,25,1,9,10
9,8483460.0,David Jiricek,D,CBJ,20,43,1,9,10
9,8477971.0,Andreas Englund,D,LAK,27,82,1,9,10
9,8471274.0,Alex Goligoski,D,MIN,38,36,0,10,10
9,8479439.0,Jacob MacDonald,D,SJS,30,34,7,2,9
9,8479339.0,Patrik Laine,L,CBJ,25,18,6,3,9
9,8477353.0,Tyler Motte,C,TBL,28,69,6,3,9
9,8482077.0,Dylan Holloway,L,EDM,22,38,6,3,9
9,8479718.0,Alex Barré-Boulet,C,TBL,26,36,6,3,9
9,8477989.0,Christian Dvorak,C,MTL,27,30,5,4,9
9,8479328.0,Julien Gauthier,R,NYI,26,27,5,4,9
9,8479968.0,Vinni Lettieri,C,MIN,28,46,5,4,9
9,8476525.0,Colin Miller,D,NJD,31,46,4,5,9
9,8470966.0,Mark Giordano,D,TOR,40,46,3,6,9
9,8482679.0,Matt Coronato,R,CGY,21,34,3,6,9
9,8480008.0,Adam Ruzicka,C,ARI,24,42,3,6,9
9,8481641.0,Joel Kiviranta,L,COL,27,56,3,6,9
9,8478028.0,Fredrik Olofsson,L,COL,27,57,3,6,9
9,8480222.0,Sebastian Aho,D,NYI,27,58,2,7,9
9,8481708.0,Zac Jones,D,NYR,23,31,2,7,9
9,8476960.0,Andreas Athanasiou,C,CHI,29,28,2,7,9
9,8480848.0,Ty Dellandrea,C,DAL,23,42,2,7,9
9,8478099.0,Kevin Labanc,R,SJS,28,46,2,7,9
9,8478399.0,Jonas Siegenthaler,D,NJD,26,57,1,8,9
9,8481527.0,Kaedan Korczak,D,VGK,22,26,1,8,9
9,8481537.0,Nikita Okhotiuk,D,SJS,23,52,1,8,9
9,8475797.0,Jarred Tinordi,D,CHI,31,52,0,9,9
9,8479372.0,Josh Mahura,D,FLA,25,30,0,9,9
9,8477478.0,William Carrier,L,VGK,29,39,6,2,8
9,8480252.0,Cole Guttman,C,CHI,24,27,4,4,8
9,8481058.0,Jesse Ylönen,R,MTL,24,59,4,4,8
9,8474709.0,Matt Martin,L,NYI,34,57,4,4,8
9,8477541.0,Dakota Mermis,D,MIN,29,47,3,5,8
9,8478211.0,Dryden Hunt,L,CGY,28,28,3,5,8
9,8476473.0,Connor Murphy,D,CHI,30,46,2,6,8
9,8477335.0,Kyle Burroughs,D,SJS,28,73,2,6,8
9,8474618.0,Marco Scandella,D,STL,33,65,2,6,8
9,8476329.0,Travis Boyd,C,ARI,30,16,2,6,8
9,8480196.0,Jacob Bryson,D,BUF,26,36,1,7,8
9,8478450.0,Parker Wotherspoon,D,BOS,26,41,0,8,8
9,8480950.0,Ilya Lyubushkin,D,ANA,29,74,0,8,8
9,8479066.0,Ryan Lomberg,L,FLA,29,75,5,2,7
9,8478569.0,Noel Acciari,C,PIT,32,55,4,3,7
9,8477930.0,Pierre-Edouard Bellemare,L,SEA,38,40,4,3,7
9,8482241.0,Radim Zohorna,L,PIT,27,33,4,3,7
9,8482624.0,Daniil Miromanov,D,VGK,26,24,3,4,7
9,8479346.0,Dillon Dube,C,CGY,25,43,3,4,7
9,8482496.0,Nils Aman,C,VAN,23,43,3,4,7
9,8481019.0,David Gustafsson,C,WPG,23,39,3,4,7
9,8478408.0,Travis Dermott,D,ARI,27,50,2,5,7
9,8479458.0,Nikita Zaitsev,D,CHI,32,38,2,5,7
9,8481167.0,Brayden Pachal,D,CGY,24,50,2,5,7
9,8480084.0,Nick DeSimone,D,NJD,29,34,2,5,7
9,8482652.0,Walker Duehr,R,CGY,26,40,2,5,7
9,8480807.0,Mattias Samuelsson,D,BUF,23,41,1,6,7
9,8479442.0,Troy Stecher,D,ARI,29,54,1,6,7
9,8482516.0,Matthew Kessel,D,STL,23,39,1,6,7
9,8474568.0,Luke Schenn,D,NSH,34,63,1,6,7
9,8478454.0,Noah Juulsen,D,VAN,26,54,1,6,7
9,8478502.0,Dennis Gilbert,D,CGY,27,34,1,6,7
9,8478104.0,Sammy Blais,L,STL,27,53,1,6,7
9,8482176.0,Wyatt Kaiser,D,CHI,21,32,0,7,7
9,8473446.0,Erik Johnson,D,BUF,35,67,5,1,6
9,8471817.0,Ryan Reaves,R,TOR,36,49,4,2,6
9,8479370.0,Tyson Jost,C,BUF,25,43,3,3,6
9,8477369.0,Carson Soucy,D,VAN,29,40,2,4,6
9,8474612.0,Travis Hamonic,D,OTT,33,48,2,4,6
9,8482730.0,Brandt Clarke,D,LAK,20,16,2,4,6
9,8477944.0,Jakub Vrana,L,STL,27,21,2,4,6
9,8477931.0,Tomas Nosek,L,NJD,31,36,2,4,6
9,8480789.0,Oliver Wahlstrom,R,NYI,23,32,2,4,6
9,8481013.0,Jonatan Berggren,R,DET,23,12,2,4,6
9,8476441.0,Joel Edmundson,D,WSH,30,53,1,5,6
9,8482192.0,Isaak Phillips,D,CHI,22,33,0,6,6
9,8480078.0,Filip Chytil,C,NYR,24,10,0,6,6
9,8483524.0,Shane Wright,C,SEA,19,8,4,1,5
9,8477962.0,Brendan Lemieux,L,CAR,27,32,3,2,5
9,8481541.0,Samuel Bolduc,D,NYI,23,34,2,3,5
9,8481147.0,Reese Johnson,C,CHI,25,42,2,3,5
9,8481422.0,Jacob Lucchini,C,MIN,28,40,2,3,5
9,8479536.0,Axel Jonsson-Fjallby,L,WPG,25,26,2,3,5
9,8481122.0,Simon Benoit,D,TOR,25,64,1,4,5
9,8477938.0,Haydn Fleury,D,TBL,27,24,1,4,5
9,8477810.0,Joel Hanley,D,DAL,32,42,1,4,5
9,8471686.0,Marc Staal,D,PHI,36,35,1,4,5
9,8474009.0,Nick Bonino,C,NYR,35,45,1,4,5
9,8476952.0,Dominic Toninato,C,WPG,29,15,1,4,5
9,8479547.0,Matthew Phillips,R,PIT,25,31,1,4,5
9,8480245.0,Olle Lycksell,R,PHI,24,18,1,4,5
9,8474716.0,Jared Spurgeon,D,MIN,34,16,0,5,5
9,8475906.0,John Klingberg,D,TOR,31,14,0,5,5
9,8476429.0,Scott Mayfield,D,NYI,31,41,0,5,5
9,8475718.0,Justin Holl,D,DET,31,38,0,5,5
9,8478452.0,Caleb Jones,D,COL,26,25,0,5,5
9,8479291.0,Kevin Rooney,C,CGY,30,33,3,1,4
9,8479344.0,Jesse Puljujarvi,R,PIT,25,22,3,1,4
9,8478051.0,Max Willman,C,NJD,28,18,3,1,4
9,8475791.0,Taylor Hall,L,CHI,32,10,2,2,4
9,8481056.0,Spencer Stastney,D,NSH,23,20,2,2,4
9,8476867.0,Brendan Gaunce,C,CBJ,29,24,2,2,4
9,8479981.0,Jonah Gadjovich,L,FLA,25,39,2,2,4
9,8475766.0,Austin Watson,L,TBL,31,33,2,2,4
9,8477499.0,Rasmus Ristolainen,D,PHI,29,31,1,3,4
9,8478451.0,Ethan Bear,D,WSH,26,24,1,3,4
9,8481609.0,Vladislav Kolyachonok,D,ARI,22,5,1,3,4
9,8477244.0,Chad Ruhwedel,D,PIT,33,52,1,3,4
9,8476442.0,Matt Nieto,L,PIT,31,22,1,3,4
9,8479994.0,Jaret Anderson-Dolan,C,LAK,24,31,1,3,4
9,8475752.0,Tyler Pitlick,C,NYR,32,34,1,3,4
9,8481532.0,Alex Turcotte,C,LAK,22,20,1,3,4
9,8477527.0,Ross Johnston,L,ANA,29,68,1,3,4
9,8475235.0,Nicolas Deslauriers,L,PHI,32,60,1,3,4
9,8476913.0,Devin Shore,C,SEA,29,21,1,3,4
9,8479379.0,Givani Smith,R,SJS,25,36,1,3,4
9,8475762.0,Derek Forbort,D,BOS,31,35,0,4,4
9,8478424.0,Jansen Harkins,C,PIT,26,45,0,4,4
9,8480441.0,Trey Fix-Wolansky,R,CBJ,24,11,2,1,3
9,8478078.0,Rourke Chartier,C,OTT,27,37,2,1,3
9,8480776.0,Sheldon Rempal,R,VGK,28,9,2,1,3
9,8480468.0,James Hamblin,L,EDM,24,31,2,1,3
9,8479772.0,Zack MacEwen,R,OTT,27,30,2,1,3
9,8477073.0,Kurtis MacDermid,D,COL,29,45,2,1,3
9,8480823.0,Alexander Alexeyev,D,WSH,24,39,1,2,3
9,8480007.0,Jonas Rondbjerg,R,VGK,24,20,1,2,3
9,8476934.0,Brock McGinn,L,ANA,29,24,1,2,3
9,8478409.0,Anthony Richard,C,BOS,27,9,1,2,3
9,8483570.0,Ben Meyers,C,COL,25,23,1,2,3
9,8476994.0,Vinnie Hinostroza,C,PIT,29,14,1,2,3
9,8481592.0,Jakob Pelletier,L,CGY,22,13,1,2,3
9,8478904.0,Steven Lorentz,C,FLA,27,38,1,2,3
9,8479972.0,Mason Shaw,C,MIN,25,20,1,2,3
9,8480853.0,Liam Foudy,C,NSH,23,13,0,3,3
9,8482762.0,Simon Edvinsson,D,DET,20,16,1,1,2
9,8482101.0,Danil Gushchin,L,SJS,21,4,1,1,2
9,8479378.0,Logan Stanley,D,WPG,25,25,1,1,2
9,8481006.0,Tyler Tucker,D,STL,23,26,1,1,2
9,8478495.0,Denis Gurianov,R,NSH,26,18,1,1,2
9,8479362.0,Riley Tufte,L,COL,25,5,1,1,2
9,8480292.0,Carson Meyer,R,CBJ,26,14,1,1,2
9,8477454.0,Adam Erne,L,EDM,28,24,1,1,2
9,8475780.0,Chris Wagner,R,BOS,32,13,1,1,2
9,8476988.0,Matt Benning,D,SJS,29,14,0,2,2
9,8477034.0,Jaycob Megna,D,CHI,31,44,0,2,2
9,8481521.0,Ronnie Attard,D,PHI,24,12,0,2,2
9,8480070.0,Ian Mitchell,D,BOS,24,13,0,2,2
9,8477851.0,Jordan Oesterle,D,CGY,31,22,0,2,2
9,8481161.0,Jake Christiansen,D,CBJ,24,12,0,2,2
9,8482451.0,Mikael Pyyhtia,L,CBJ,22,17,0,2,2
9,8473473.0,Milan Lucic,L,BOS,35,4,0,2,2
9,8480870.0,Bo Groulx,C,ANA,23,45,0,2,2
9,8481598.0,Philip Broberg,D,EDM,22,12,0,2,2
9,8477464.0,Nic Petan,C,MIN,28,6,0,2,2
9,8481617.0,Vasily Podkolzin,R,VAN,22,19,0,2,2
9,8481751.0,Lukas Rousek,R,BUF,24,15,0,2,2
9,8481550.0,Adam Beckman,L,MIN,22,11,0,2,2
9,8481523.0,Kirby Dach,C,MTL,22,2,0,2,2
9,8481543.0,Nikita Alexandrov,C,STL,23,23,0,2,2
9,8478146.0,Matthew Highmore,C,OTT,27,7,0,2,2
9,8481043.0,Cole Koepke,L,TBL,25,9,0,2,2
9,8483565.0,Nick Blankenburg,D,CBJ,25,12,1,0,1
9,8483397.0,Marc McLaughlin,C,BOS,24,1,1,0,1
9,8480874.0,Adam Ginning,D,PHI,23,9,1,0,1
9,8481754.0,Nikita Nesterenko,C,ANA,22,3,1,0,1
9,8480021.0,Jack Studnicka,C,SJS,24,22,1,0,1
9,8481518.0,Nolan Foote,L,NJD,23,4,1,0,1
9,8479421.0,Jacob Moverare,D,LAK,25,24,1,0,1
9,8481239.0,Samuel Fagemo,L,LAK,23,8,1,0,1
9,8479546.0,Oskar Steen,C,BOS,25,34,1,0,1
9,8480836.0,Jonathan Gruden,C,PIT,23,13,1,0,1
9,8481077.0,John Leonard,L,NSH,25,6,1,0,1
9,8482147.0,Jean-Luc Foudy,C,COL,21,4,1,0,1
9,8474053.0,Logan Couture,C,SJS,34,6,0,1,1
9,8481812.0,Nikolai Knyzhov,D,SJS,26,10,0,1,1
9,8479984.0,Cal Foote,D,NJD,25,4,0,1,1
9,8479321.0,Lucas Johansen,D,WSH,26,6,0,1,1
9,8473563.0,Nicklas Backstrom,C,WSH,36,8,0,1,1
9,8479320.0,Max Lajoie,D,TOR,26,7,0,1,1
9,8482095.0,Tyler Kleven,D,OTT,21,9,0,1,1
9,8480157.0,Calle Rosen,D,STL,29,6,0,1,1
9,8480031.0,Max Comtois,L,ANA,24,1,0,1,1
9,8478017.0,Mark Friedman,D,VAN,28,23,0,1,1
9,8479348.0,Kale Clague,D,BUF,25,3,0,1,1
9,8475278.0,Byron Froese,C,VGK,32,16,0,1,1
9,8475795.0,Dylan McIlrath,D,WSH,31,3,0,1,1
9,8480845.0,Rasmus Kupari,C,WPG,23,28,0,1,1
9,8480890.0,Jan Jenik,R,ARI,23,5,0,1,1
9,8477887.0,Patrick Brown,C,BOS,31,11,0,1,1
9,8478512.0,Austin Czarnik,C,DET,31,34,0,1,1
9,8479367.0,William Lockwood,R,FLA,25,26,0,1,1
9,8483597.0,Milos Kelemen,L,ARI,24,10,0,1,1
9,8477126.0,Jayson Megna,C,ANA,33,1,0,0,0
9,8479639.0,Dylan Coghlan,D,CAR,25,1,0,0,0
9,8482067.0,Connor Mackey,D,NYR,27,1,0,0,0
9,8476856.0,Matt Dumba,D,ARI,29,0,0,0,0
9,8478483.0,Mitchell Marner,R,TOR,26,0,0,0,0
9,8471873.0,Anton Stralman,D,BOS,37,0,0,0,0
9,8474162.0,Jake Muzzin,D,TOR,34,0,0,0,0
9,8470638.0,Patrice Bergeron,C,BOS,38,0,0,0,0
9,8473604.0,Jonathan Toews,C,CHI,35,0,0,0,0
9,8471276.0,David Krejci,C,BOS,37,0,0,0,0
9,8474207.0,Nick Holden,D,OTT,36,0,0,0,0
9,8475747.0,Patrik Nemeth,D,ARI,31,0,0,0,0
9,8477467.0,Gustav Olofsson,D,SEA,29,1,0,0,0
9,8479514.0,Rem Pitlick,C,CHI,26,9,0,0,0
9,8474027.0,Justin Braun,D,PHI,36,0,0,0,0
9,8481599.0,Victor Soderstrom,D,ARI,22,3,0,0,0
9,8474161.0,Jakub Voracek,R,CBJ,34,0,0,0,0
9,8479985.0,Cale Fleury,D,SEA,25,1,0,0,0
9,8471303.0,Alexander Edler,D,LAK,37,0,0,0,0
9,8474573.0,Josh Bailey,R,NYI,34,0,0,0,0
9,8483619.0,Filip Roos,D,CHI,24,4,0,0,0
9,8474818.0,Jordie Benn,D,TOR,36,0,0,0,0
9,8476449.0,Scott Harrington,D,ANA,30,0,0,0,0
9,8483620.0,Marcus Bjork,D,CBJ,26,0,0,0,0
9,8470595.0,Eric Staal,C,FLA,39,0,0,0,0
9,8481585.0,Egor Afanasyev,L,NSH,22,2,0,0,0
9,8482712.0,Oskar Olausson,R,COL,21,1,0,0,0
9,8481072.0,Tim Berni,D,CBJ,23,0,0,0,0
9,8479945.0,Gavin Bayreuther,D,CBJ,29,0,0,0,0
9,8481600.0,Tobias Bjornfot,D,VGK,22,4,0,0,0
9,8481679.0,Maxence Guenette,D,OTT,22,7,0,0,0
9,8474683.0,Derek Grant,C,ANA,33,0,0,0,0
9,8476470.0,Nathan Beaulieu,D,ANA,31,0,0,0,0
9,8474145.0,Robert Bortuzzo,D,NYI,34,27,0,0,0
9,8480216.0,Jacob Peterson,C,SJS,24,6,0,0,0
9,8473548.0,Phil Kessel,R,VGK,36,0,0,0,0
9,8480160.0,Radim Simek,D,SJS,31,0,0,0,0
9,8480883.0,Ty Smith,D,PIT,23,0,0,0,0
9,8471669.0,Paul Stastny,C,CAR,38,0,0,0,0
9,8475227.0,Chris Wideman,D,MTL,33,0,0,0,0
9,8480913.0,Jordan Gross,D,NSH,28,0,0,0,0
9,8475625.0,Matt Irwin,D,WSH,36,0,0,0,0
9,8479388.0,Riley Stillman,D,BUF,25,0,0,0,0
9,8474628.0,Michael Stone,D,CGY,33,0,0,0,0
9,8484254.0,Akito Hirose,D,VAN,24,3,0,0,0
9,8477941.0,Nick Ritchie,L,CGY,28,0,0,0,0
9,8477462.0,Robert Hagg,D,ANA,28,5,0,0,0
9,8478062.0,Dysin Mayo,D,ARI,27,0,0,0,0
9,8482634.0,Alex Steeves,C,TOR,24,1,0,0,0
9,8477433.0,Ben Harpur,D,NYR,28,0,0,0,0
9,8478841.0,Colton White,D,ANA,26,0,0,0,0
9,8473544.0,Derick Brassard,C,OTT,36,0,0,0,0
9,8476884.0,Derrick Pouliot,D,SJS,29,5,0,0,0
9,8479376.0,Victor Mete,D,PHI,25,1,0,0,0
9,8483630.0,Pavol Regenda,L,ANA,24,5,0,0,0
9,8479026.0,Philippe Myers,D,TBL,26,5,0,0,0
9,8477482.0,Zach Sanford,L,CHI,29,0,0,0,0
9,8477359.0,Tucker Poolman,D,VAN,30,0,0,0,0
9,8475857.0,Kevin Gravel,D,NSH,31,0,0,0,0
9,8476779.0,Brad Hunt,D,COL,35,0,0,0,0
9,8476850.0,Ryan Murray,D,EDM,30,0,0,0,0
9,8477341.0,Andreas Johnsson,L,SJS,29,0,0,0,0
9,8474218.0,Jason Demers,D,EDM,35,0,0,0,0
9,8480844.0,Grigori Denisenko,L,VGK,23,6,0,0,0
9,8484287.0,Cole McWard,D,VAN,22,1,0,0,0
9,8479322.0,Wade Allison,R,PHI,26,0,0,0,0
9,8478846.0,Christian Wolanin,D,VAN,28,0,0,0,0
9,8471887.0,Patric Hornqvist,R,FLA,36,0,0,0,0
9,8475163.0,Alex Chiasson,R,DET,33,0,0,0,0
9,8478881.0,Brett Seney,L,CHI,27,4,0,0,0
9,8474697.0,Mark Borowiecki,D,NSH,34,0,0,0,0
9,8476410.0,Josh Leivo,L,STL,30,0,0,0,0
9,8475968.0,Alex Belzile,R,MTL,32,0,0,0,0
9,8479580.0,Dylan Gambrell,C,OTT,27,0,0,0,0
9,8480901.0,Karson Kuhlman,C,WPG,28,0,0,0,0
9,8480326.0,Sheldon Dries,C,VAN,29,0,0,0,0
9,8478465.0,Guillaume Brisebois,D,VAN,26,0,0,0,0
9,8482861.0,Vincent Iorio,D,WSH,21,6,0,0,0
9,8471794.0,Darren Helm,C,COL,36,0,0,0,0
9,8479335.0,Rasmus Asplund,C,NSH,26,0,0,0,0
9,8478415.0,Jakub Zboril,D,BOS,26,0,0,0,0
9,8476310.0,Lukas Sedlak,C,PHI,30,0,0,0,0
9,8478075.0,Anders Bjork,L,CHI,27,0,0,0,0
9,8480267.0,Sammy Walker,C,MIN,24,4,0,0,0
9,8479578.0,Casey Fitzgerald,D,FLA,26,0,0,0,0
9,8480032.0,Shane Bowers,C,NJD,24,8,0,0,0
9,8478400.0,Colin White,C,PIT,26,28,0,0,0
9,8478431.0,Evgeny Svechnikov,L,SJS,27,0,0,0,0
9,8475772.0,Riley Sheahan,C,BUF,32,0,0,0,0
9,8481690.0,Tyler Angle,C,CBJ,23,2,0,0,0
9,8476326.0,Josh Archibald,R,PIT,31,0,0,0,0
9,8478843.0,Denis Malgin,C,COL,26,0,0,0,0
9,8478446.0,Glenn Gawdin,C,ANA,26,1,0,0,0
9,8477357.0,Saku Maenalanen,R,WPG,29,0,0,0,0
9,8478870.0,Rudolfs Balcers,L,TBL,26,0,0,0,0
9,8478476.0,Kyle Capobianco,D,WPG,26,0,0,0,0
9,8476439.0,Brett Ritchie,R,ARI,30,0,0,0,0
9,8474613.0,Derek Stepan,C,CAR,33,0,0,0,0
9,8475178.0,Zack Kassian,R,ARI,32,0,0,0,0
9,8480226.0,Marián Studenic,R,SEA,25,2,0,0,0
9,8481070.0,Hugh McGing,L,STL,25,5,0,0,0
9,8482250.0,Callahan Burke,C,CAR,26,1,0,0,0
9,8481591.0,Sam Poulin,R,PIT,22,3,0,0,0
9,8481441.0,Joe Snively,C,WSH,27,3,0,0,0
9,8478967.0,Lane Pederson,C,CBJ,26,0,0,0,0
9,8479333.0,Libor Hajek,D,NYR,25,0,0,0,0
9,8480833.0,Vitali Kravtsov,R,VAN,24,0,0,0,0
9,8477460.0,Laurent Dauphin,C,ARI,28,0,0,0,0
9,8481461.0,Corey Schueneman,D,MTL,28,0,0,0,0
9,8474190.0,Wayne Simmonds,R,TOR,35,0,0,0,0
9,8483549.0,Lucas Condotta,L,MTL,26,3,0,0,0
9,8477993.0,Justin Kirkland,C,ARI,27,2,0,0,0
9,8480935.0,Lawrence Pilut,D,BUF,28,0,0,0,0
9,8477210.0,Buddy Robinson,R,CHI,32,0,0,0,0
9,8476851.0,Alex Galchenyuk,C,COL,29,0,0,0,0
9,8482197.0,Adam Raska,R,MIN,22,5,0,0,0
9,8479366.0,Logan Brown,C,STL,25,0,0,0,0
9,8479356.0,Kieffer Bellows,L,PHI,25,0,0,0,0
9,8479533.0,Joona Koppanen,L,PIT,25,4,0,0,0
9,8477401.0,John Hayden,C,SEA,28,2,0,0,0
9,8480822.0,Martin Kaut,R,SJS,24,0,0,0,0
9,8474610.0,Zac Dalpe,C,FLA,34,0,0,0,0
9,8482399.0,Billy Sweezey,D,CBJ,27,0,0,0,0
9,8479991.0,Jake Leschyshyn,C,NYR,24,1,0,0,0
9,8479550.0,Tanner Laczynski,C,PHI,26,0,0,0,0
9,8476166.0,Taylor Fedun,D,PIT,35,0,0,0,0
9,8479338.0,Markus Niemelainen,D,EDM,25,0,0,0,0
9,8477320.0,Anton Blidh,L,NYR,28,1,0,0,0
9,8478147.0,Bokondji Imama,L,ARI,27,6,0,0,0
9,8478067.0,Oskar Lindblom,L,SJS,27,1,0,0,0
9,8478506.0,Gabriel Carlsson,D,WSH,26,0,0,0,0
9,8478131.0,Ondrej Kase,R,CAR,28,0,0,0,0
9,8479644.0,Matt Luff,R,DET,26,0,0,0,0
9,8482824.0,Nick Cicek,D,SJS,23,0,0,0,0
9,8482834.0,Jesper Froden,R,SEA,29,0,0,0,0
9,8478491.0,Jacob Larsson,D,OTT,26,0,0,0,0
9,8474089.0,Brad Malone,C,EDM,34,0,0,0,0
9,8482641.0,Matt Kiersted,D,FLA,25,0,0,0,0
9,8480071.0,Robin Salo,D,NYI,25,0,0,0,0
9,8475461.0,Andrew Agozzino,L,SJS,32,0,0,0,0
9,8475160.0,Kyle Clifford,L,TOR,32,0,0,0,0
9,8480056.0,Jack Rathbone,D,VAN,24,0,0,0,0
9,8481725.0,Elmer Soderblom,L,DET,22,0,0,0,0
9,8479465.0,Drake Caggiula,L,PIT,29,0,0,0,0
9,8476948.0,Charles Hudon,L,COL,29,0,0,0,0
9,8479523.0,Lucas Carlsson,D,FLA,26,0,0,0,0
9,8478455.0,Austin Wagner,L,CHI,26,0,0,0,0
9,8481572.0,Ville Heinola,D,WPG,22,0,0,0,0
9,8479404.0,Henrik Borgstrom,C,WSH,26,0,0,0,0
9,8479944.0,Zach Aston-Reese,C,DET,29,3,0,0,0
9,8482635.0,Mike Hardman,L,CHI,24,0,0,0,0
9,8479705.0,Jeffrey Viel,L,SJS,26,0,0,0,0
9,8480467.0,Austin Strand,D,ANA,26,0,0,0,0
9,8480037.0,Aleksi Heponiemi,C,FLA,24,0,0,0,0
9,8479573.0,Mikhail Maltsev,L,COL,25,0,0,0,0
9,8476404.0,Andy Andreoff,C,NYI,32,0,0,0,0
9,8484125.0,Hunter McKown,C,CBJ,21,0,0,0,0
9,8481649.0,Joona Luoto,L,CBJ,26,0,0,0,0
9,8477981.0,Roland McKeown,D,NSH,27,0,0,0,0
9,8480831.0,Alec Regula,D,CHI,23,0,0,0,0
9,8482691.0,Aatu Raty,C,VAN,21,0,0,0,0
9,8482623.0,Josh Dunne,C,CBJ,25,0,0,0,0
9,8481433.0,Taro Hirose,L,DET,27,0,0,0,0
9,8480328.0,David Gust,R,CHI,29,0,0,0,0
9,8479526.0,Otto Koivula,L,NYI,25,0,0,0,0
9,8476390.0,Joseph Cramarossa,C,MIN,31,0,0,0,0
9,8482654.0,Jackson Cates,C,PHI,26,0,0,0,0
9,8480439.0,Mac Hollowell,D,TOR,25,0,0,0,0
9,8480072.0,Lias Andersson,C,LAK,25,0,0,0,0
9,8479395.0,Dennis Cholowski,D,NYI,25,0,0,0,0
9,8477463.0,Steven Santini,D,STL,28,0,0,0,0
9,8479347.0,Tyler Benson,L,EDM,25,0,0,0,0
9,8477471.0,Dillon Heatherington,D,OTT,28,0,0,0,0
9,8477520.0,Jean-Sebastien Dea,C,ARI,29,0,0,0,0
9,8480846.0,Sampo Ranta,L,COL,23,0,0,0,0
9,8480979.0,Nathan Smith,C,ARI,25,0,0,0,0
9,8484256.0,Jake Livingstone,D,NSH,24,0,0,0,0
9,8476396.0,Steven Fogarty,C,MIN,30,0,0,0,0
9,8479252.0,Dan Renouf,D,BOS,29,0,0,0,0
9,8479518.0,Fredrik Karlström,C,DAL,25,0,0,0,0
9,8481683.0,Aidan McDonough,L,VAN,24,0,0,0,0
9,8478373.0,Nikita Soshnikov,R,NYI,30,0,0,0,0
9,8482081.0,Sean Farrell,C,MTL,22,0,0,0,0
9,8481575.0,Lassi Thomson,D,OTT,23,0,0,0,0
9,8481102.0,Egor Sokolov,L,OTT,23,0,0,0,0
9,8481712.0,Matej Blumel,R,DAL,23,0,0,0,0
9,8479602.0,Jeremy Davies,D,BUF,27,0,0,0,0
9,8480443.0,Kristian Reichel,C,WPG,25,0,0,0,0
9,8479304.0,Kyle Criscuolo,C,SJS,31,0,0,0,0
9,8478224.0,Luke Philp,C,CHI,28,0,0,0,0
9,8480242.0,Arnaud Durandeau,L,NYI,24,0,0,0,0
9,8479329.0,Frederic Allard,D,MTL,26,0,0,0,0
9,8476941.0,Connor Carrick,D,BOS,29,0,0,0,0
9,8479375.0,William Bitten,C,STL,25,0,0,0,0
9,8481720.0,Nick Abruzzese,C,TOR,24,0,0,0,0
9,8482452.0,Elliot Desnoyers,L,PHI,21,0,0,0,0
9,8476915.0,Jujhar Khaira,L,MIN,29,1,0,0,0
9,8483641.0,Anton Levtchi,L,FLA,28,0,0,0,0
9,8481740.0,Tyce Thompson,R,NJD,24,0,0,0,0
9,8478173.0,Hayden Hodgson,R,PHI,27,0,0,0,0
9,8482181.0,Tristen Robins,C,SJS,22,0,0,0,0
9,8481563.0,Drew Helleson,D,ANA,22,0,0,0,0
9,8480863.0,Gabriel Fortier,L,TBL,23,0,0,0,0
9,8478058.0,CJ Suess,L,SJS,29,0,0,0,0
9,8480041.0,Dmitri Samorukov,D,STL,24,0,0,0,0
9,8482179.0,Justin Richards,C,CBJ,25,0,0,0,0
9,8480034.0,Joel Teasdale,L,MTL,24,0,0,0,0
9,8480820.0,Filip Kral,D,TOR,24,0,0,0,0
9,8480842.0,Filip Hallander,C,PIT,23,0,0,0,0
9,8478367.0,Cole Bardreau,C,NYI,30,0,0,0,0
9,8482448.0,Samuel Knazko,D,CBJ,21,0,0,0,0
9,8482711.0,Stanislav Svozil,D,CBJ,20,0,0,0,0
9,8480275.0,Nick Swaney,R,MIN,26,0,0,0,0
9,8480994.0,Damien Giroux,C,MIN,23,0,0,0,0
9,8480977.0,Semyon Der-Arguchintsev,C,TOR,23,0,0,0,0
9,8482207.0,William Dufour,R,NYI,21,0,0,0,0
9,8483464.0,Marco Kasper,C,DET,19,0,0,0,0
9,8483424.0,Owen Beck,C,MTL,19,0,0,0,0
10,8476453.0,Nikita Kucherov,R,TBL,30,81,44,100,144
10,8477492.0,Nathan MacKinnon,C,COL,28,82,51,89,140
10,8478402.0,Connor McDavid,C,EDM,26,76,32,100,132
10,8478550.0,Artemi Panarin,L,NYR,32,82,49,71,120
10,8477956.0,David Pastrnak,R,BOS,27,82,47,63,110
10,8479318.0,Auston Matthews,C,TOR,26,81,69,38,107
10,8477934.0,Leon Draisaitl,C,EDM,28,81,41,65,106
10,8478420.0,Mikko Rantanen,R,COL,27,80,42,62,104
10,8476468.0,J.T. Miller,C,VAN,30,81,37,66,103
10,8477939.0,William Nylander,R,TOR,27,82,40,58,98
10,8478864.0,Kirill Kaprizov,L,MIN,26,75,46,50,96
10,8477933.0,Sam Reinhart,C,FLA,28,82,57,37,94
10,8476887.0,Filip Forsberg,L,NSH,29,82,48,46,94
10,8471675.0,Sidney Crosby,C,PIT,36,82,42,52,94
10,8480800.0,Quinn Hughes,D,VAN,24,82,17,75,92
10,8478010.0,Brayden Point,C,TBL,27,81,46,44,90
10,8480069.0,Cale Makar,D,COL,25,77,21,69,90
10,8478427.0,Sebastian Aho,C,CAR,26,78,36,53,89
10,8480012.0,Elias Pettersson,C,VAN,25,82,34,55,89
10,8479314.0,Matthew Tkachuk,L,FLA,26,80,26,62,88
10,8480023.0,Robert Thomas,C,STL,24,82,26,60,86
10,8474600.0,Roman Josi,D,NSH,33,82,23,62,85
10,8479407.0,Jesper Bratt,L,NJD,25,82,27,56,83
10,8480803.0,Evan Bouchard,D,EDM,24,81,18,64,82
10,8474564.0,Steven Stamkos,C,TBL,33,79,40,41,81
10,8480027.0,Jason Robertson,L,DAL,24,82,29,51,80
10,8478445.0,Mathew Barzal,C,NYI,26,80,23,57,80
10,8477493.0,Aleksander Barkov,C,FLA,28,73,23,57,80
10,8475786.0,Zach Hyman,L,EDM,31,80,54,23,77
10,8480018.0,Nick Suzuki,C,MTL,24,82,33,44,77
10,8477404.0,Jake Guentzel,L,PIT,29,67,30,47,77
10,8476389.0,Vincent Trocheck,C,NYR,30,82,25,52,77
10,8479343.0,Clayton Keller,R,ARI,25,78,33,43,76
10,8475167.0,Victor Hedman,D,TBL,33,78,13,63,76
10,8475184.0,Chris Kreider,L,NYR,32,82,39,36,75
10,8475172.0,Nazem Kadri,C,CGY,33,82,29,46,75
10,8477960.0,Adrian Kempe,R,LAK,27,77,28,47,75
10,8479542.0,Brandon Hagel,L,TBL,25,82,26,49,75
10,8474679.0,Gustav Nyquist,C,NSH,34,81,23,52,75
10,8480801.0,Brady Tkachuk,L,OTT,24,81,37,37,74
10,8481559.0,Jack Hughes,C,NJD,22,62,27,47,74
10,8478444.0,Brock Boeser,R,VAN,26,81,40,33,73
10,8477942.0,Kevin Fiala,L,LAK,27,82,29,44,73
10,8479323.0,Adam Fox,D,NYR,25,72,17,56,73
10,8477409.0,Carter Verhaeghe,C,FLA,28,76,34,38,72
10,8482078.0,Lucas Raymond,L,DET,21,82,31,41,72
10,8476459.0,Mika Zibanejad,C,NYR,30,81,26,46,72
10,8476460.0,Mark Scheifele,C,WPG,30,74,25,47,72
10,8471685.0,Anze Kopitar,C,LAK,36,81,26,44,70
10,8482116.0,Tim Stützle,C,OTT,21,75,18,52,70
10,8480865.0,Noah Dobson,D,NYI,23,79,10,60,70
10,8476539.0,Jonathan Marchessault,R,VGK,33,82,42,27,69
10,8475754.0,Brock Nelson,C,NYI,32,82,34,35,69
10,8477946.0,Dylan Larkin,C,DET,27,68,33,36,69
10,8475158.0,Ryan O'Reilly,C,NSH,32,82,26,43,69
10,8477504.0,Josh Morrissey,D,WPG,28,81,10,59,69
10,8478439.0,Travis Konecny,R,PHI,26,76,33,35,68
10,8477500.0,Bo Horvat,C,NYI,28,81,33,35,68
10,8478403.0,Jack Eichel,C,VGK,27,63,31,37,68
10,8481557.0,Matt Boldy,L,MIN,22,75,29,39,68
10,8482093.0,Seth Jarvis,C,CAR,21,81,33,34,67
10,8479385.0,Jordan Kyrou,C,STL,25,82,31,36,67
10,8473419.0,Brad Marchand,L,BOS,35,82,29,38,67
10,8480002.0,Nico Hischier,C,NJD,24,71,27,40,67
10,8471215.0,Evgeni Malkin,C,PIT,37,82,27,40,67
10,8478440.0,Dylan Strome,C,WSH,26,82,27,40,67
10,8479337.0,Alex DeBrincat,R,DET,26,82,27,40,67
10,8470794.0,Joe Pavelski,C,DAL,39,82,27,40,67
10,8476454.0,Ryan Nugent-Hopkins,C,EDM,30,80,18,49,67
10,8480208.0,Drake Batherson,R,OTT,25,82,28,38,66
10,8482740.0,Wyatt Johnston,C,DAL,20,82,32,33,65
10,8471214.0,Alex Ovechkin,L,WSH,38,79,31,34,65
10,8478449.0,Roope Hintz,C,DAL,27,80,30,35,65
10,8475166.0,John Tavares,C,TOR,33,80,29,36,65
10,8481540.0,Cole Caufield,R,MTL,22,82,28,37,65
10,8475168.0,Matt Duchene,C,DAL,32,80,25,40,65
10,8478493.0,Joel Eriksson Ek,C,MIN,26,77,30,34,64
10,8473512.0,Claude Giroux,R,OTT,35,82,21,43,64
10,8477402.0,Pavel Buchnevich,L,STL,28,80,27,36,63
10,8475692.0,Mats Zuccarello,R,MIN,36,69,12,51,63
10,8477955.0,Jared McCann,L,SEA,27,80,29,33,62
10,8476875.0,Mike Matheson,D,MTL,29,82,11,51,62
10,8478398.0,Kyle Connor,L,WPG,27,65,34,27,61
10,8477940.0,Nikolaj Ehlers,L,WPG,27,82,25,36,61
10,8477951.0,Nick Schmaltz,C,ARI,27,79,22,39,61
10,8478366.0,Frank Vatrano,R,ANA,29,82,37,23,60
10,8476448.0,William Karlsson,C,VGK,30,70,30,30,60
10,8475745.0,Charlie Coyle,C,BOS,31,82,25,35,60
10,8473994.0,Jamie Benn,L,DAL,34,82,21,39,60
10,8475798.0,Mikael Granlund,C,SJS,31,69,12,48,60
10,8476346.0,Johnny Gaudreau,L,CBJ,30,81,12,48,60
10,8481068.0,Yegor Sharangovich,C,CGY,25,82,31,28,59
10,8477497.0,Sean Monahan,C,WPG,29,83,26,33,59
10,8477949.0,Alex Tuch,R,BUF,27,75,22,37,59
10,8478401.0,Pavel Zacha,C,BOS,26,78,21,38,59
10,8480839.0,Rasmus Dahlin,D,BUF,23,81,20,39,59
10,8477416.0,Oliver Bjorkstrand,R,SEA,28,82,20,39,59
10,8476853.0,Morgan Rielly,D,TOR,29,72,7,51,58
10,8479675.0,Trevor Moore,L,LAK,28,82,31,26,57
10,8482109.0,Alexis Lafrenière,L,NYR,22,82,28,29,57
10,8479999.0,Casey Mittelstadt,C,BUF,25,80,18,39,57
10,8481711.0,Matias Maccelli,L,ARI,23,82,17,40,57
10,8478460.0,Zach Werenski,D,CBJ,26,70,11,46,57
10,8479420.0,Tage Thompson,C,BUF,26,71,29,27,56
10,8475810.0,Bryan Rust,R,PIT,31,62,28,28,56
10,8477494.0,Jonathan Drouin,L,COL,28,79,19,37,56
10,8474578.0,Erik Karlsson,D,PIT,33,82,11,45,56
10,8476906.0,Shayne Gostisbehere,D,DET,30,81,10,46,56
10,8475726.0,Tyler Toffoli,R,NJD,31,79,33,22,55
10,8475765.0,Vladimir Tarasenko,R,OTT,32,76,23,32,55
10,8482124.0,Quinton Byfield,R,LAK,21,80,20,35,55
10,8478047.0,Michael Bunting,L,CAR,28,81,19,36,55
10,8475151.0,Kyle Palmieri,C,NYI,32,82,30,24,54
10,8476399.0,Blake Coleman,C,CGY,32,78,30,24,54
10,8478873.0,Troy Terry,R,ANA,26,76,20,34,54
10,8480798.0,Philipp Kurashev,C,CHI,24,75,18,36,54
10,8480036.0,Miro Heiskanen,D,DAL,24,71,9,45,54
10,8477501.0,Valeri Nichushkin,R,COL,28,54,28,25,53
10,8480015.0,Owen Tippett,R,PHI,24,78,28,25,53
10,8476882.0,Teuvo Teravainen,L,CAR,29,76,25,28,53
10,8480039.0,Martin Necas,C,CAR,24,77,24,29,53
10,8478975.0,Mason Marchment,L,DAL,28,81,22,31,53
10,8475913.0,Mark Stone,R,VGK,31,56,16,37,53
10,8478414.0,Timo Meier,R,NJD,27,69,28,24,52
10,8475794.0,Tyler Seguin,C,DAL,31,68,25,27,52
10,8477346.0,MacKenzie Weegar,D,CGY,29,82,20,32,52
10,8480830.0,Andrei Svechnikov,R,CAR,23,59,19,33,52
10,8476456.0,Jonathan Huberdeau,C,CGY,30,81,12,40,52
10,8474590.0,John Carlson,D,WSH,33,82,10,42,52
10,8474641.0,Adam Henrique,C,ANA,33,82,24,27,51
10,8476905.0,Chandler Stephenson,C,VGK,29,75,16,35,51
10,8471724.0,Kris Letang,D,PIT,36,82,10,41,51
10,8482175.0,JJ Peterka,R,BUF,21,82,28,22,50
10,8480797.0,Joel Farabee,L,PHI,23,82,22,28,50
10,8483515.0,Juraj Slafkovsky,L,MTL,19,82,20,30,50
10,8474563.0,Drew Doughty,D,LAK,34,82,15,35,50
10,8478038.0,Devon Toews,D,COL,29,82,12,38,50
10,8477456.0,J.T. Compher,L,DET,28,77,19,29,48
10,8479425.0,Filip Hronek,D,VAN,26,81,5,43,48
10,8474141.0,Patrick Kane,R,DET,35,50,20,27,47
10,8478856.0,Conor Garland,R,VAN,27,82,20,27,47
10,8481528.0,Dylan Cozens,C,BUF,22,79,18,29,47
10,8476479.0,Phillip Danault,C,LAK,30,78,17,30,47
10,8474102.0,David Perron,L,DET,35,76,17,30,47
10,8481581.0,Thomas Harley,D,DAL,22,79,15,32,47
10,8478396.0,Noah Hanifin,D,CGY,26,80,13,34,47
10,8476869.0,Brady Skjei,D,CAR,29,80,13,34,47
10,8479325.0,Charlie McAvoy,D,BOS,26,74,12,35,47
10,8482684.0,Luke Hughes,D,NJD,20,82,9,38,47
10,8477503.0,Max Domi,C,TOR,28,80,9,38,47
10,8482122.0,Brock Faber,D,MIN,21,82,8,39,47
10,8477426.0,Nicholas Paul,L,TBL,28,82,24,22,46
10,8475784.0,Jeff Skinner,L,BUF,31,74,24,22,46
10,8483808.0,Andrei Kuzmenko,L,CGY,27,72,22,24,46
10,8475170.0,Brayden Schenn,C,STL,32,82,20,26,46
10,8478407.0,Vince Dunn,D,SEA,27,59,11,35,46
10,8475760.0,Nick Bjugstad,C,ARI,31,76,22,23,45
10,8477451.0,Ryan Hartman,R,MIN,29,74,21,24,45
10,8478519.0,Anthony Cirelli,C,TBL,26,79,20,25,45
10,8477964.0,Ivan Barbashev,C,VGK,28,82,19,26,45
10,8478438.0,Tommy Novak,C,NSH,26,71,18,27,45
10,8482667.0,William Eklund,L,SJS,21,80,16,29,45
10,8477021.0,Alex Kerfoot,C,ARI,29,82,13,32,45
10,8475218.0,Mattias Ekholm,D,EDM,33,79,11,34,45
10,8480188.0,Fabian Zetterlund,L,SJS,24,82,24,20,44
10,8475169.0,Evander Kane,L,EDM,32,77,24,20,44
10,8477511.0,Anthony Mantha,R,WSH,29,74,23,21,44
10,8474586.0,Jordan Eberle,R,SEA,33,78,17,27,44
10,8477496.0,Elias Lindholm,C,VAN,29,75,15,29,44
10,8477948.0,Travis Sanheim,D,PHI,27,81,10,34,44
10,8477479.0,Tyler Bertuzzi,L,TOR,28,80,21,22,43
10,8478466.0,Daniel Sprong,R,DET,26,76,18,25,43
10,8470613.0,Brent Burns,D,CAR,38,82,10,33,43
10,8476438.0,Brandon Saad,L,STL,31,82,26,16,42
10,8477407.0,Anthony Duclair,L,SJS,28,73,24,18,42
10,8478474.0,Lawson Crouse,L,ARI,26,81,23,19,42
10,8480893.0,Kirill Marchenko,R,CBJ,23,78,23,19,42
10,8482745.0,Mason McTavish,C,ANA,20,64,19,23,42
10,8481542.0,Moritz Seider,D,DET,22,82,9,33,42
10,8477447.0,Shea Theodore,D,VGK,28,47,5,37,42
10,8477935.0,Sam Bennett,C,FLA,27,69,20,21,41
10,8477998.0,Warren Foegele,L,EDM,27,82,20,21,41
10,8480009.0,Eeli Tolvanen,R,SEA,24,81,16,25,41
10,8479345.0,Jakob Chychrun,D,OTT,25,82,14,27,41
10,8480028.0,Morgan Frost,C,PHI,24,71,13,28,41
10,8478462.0,Nicolas Roy,C,VGK,26,70,13,28,41
10,8476458.0,Ryan Strome,C,ANA,30,79,11,30,41
10,8480434.0,Sean Durzi,D,ARI,25,76,9,32,41
10,8482079.0,Marco Rossi,C,MIN,22,82,21,19,40
10,8478498.0,Jake DeBrusk,L,BOS,27,80,19,21,40
10,8479365.0,Trent Frederic,C,BOS,25,82,18,22,40
10,8479525.0,Ross Colton,C,COL,27,80,17,23,40
10,8479400.0,Pierre-Luc Dubois,C,LAK,25,82,16,24,40
10,8478233.0,Andrew Mangiapane,L,CGY,27,75,14,26,40
10,8475191.0,Reilly Smith,R,PIT,32,76,13,27,40
10,8479987.0,Morgan Geekie,C,BOS,25,76,17,22,39
10,8482146.0,Luke Evangelista,R,NSH,21,80,16,23,39
10,8474150.0,Mikael Backlund,C,CGY,34,82,15,24,39
10,8476872.0,Scott Laughton,C,PHI,29,82,13,26,39
10,8478542.0,Evan Rodrigues,C,FLA,30,80,12,27,39
10,8478055.0,Gustav Forsling,D,FLA,27,79,10,29,39
10,8478397.0,Rasmus Andersson,D,CGY,27,78,9,30,39
10,8475764.0,Cam Fowler,D,ANA,32,81,5,34,39
10,8476792.0,Torey Krug,D,STL,32,77,4,35,39
10,8482089.0,Jake Neighbours,L,STL,21,77,27,11,38
10,8482149.0,Cole Perfetti,C,WPG,21,71,19,19,38
10,8476881.0,Tomas Hertl,C,SJS,30,54,17,21,38
10,8474037.0,James van Riemsdyk,L,BOS,34,71,11,27,38
10,8482105.0,Jake Sanderson,D,OTT,21,79,10,28,38
10,8475314.0,Anders Lee,L,NYI,33,81,20,17,37
10,8473422.0,Nick Foligno,L,CHI,36,74,17,20,37
10,8482665.0,Matty Beniers,C,SEA,21,77,15,22,37
10,8476483.0,Rickard Rakell,R,PIT,30,70,15,22,37
10,8476474.0,Stefan Noesen,R,CAR,30,81,14,23,37
10,8476480.0,Vladislav Namestnikov,C,WPG,31,78,11,26,37
10,8476958.0,Jaccob Slavin,D,CAR,29,81,6,31,37
10,8481535.0,Nils Hoglander,L,VAN,23,80,24,12,36
10,8480014.0,Gabriel Vilardi,C,WPG,24,47,22,14,36
10,8473986.0,Alex Killorn,L,ANA,34,63,18,18,36
10,8478046.0,Danton Heinen,L,BOS,28,74,17,19,36
10,8478891.0,Mason Appleton,C,WPG,27,82,14,22,36
10,8476432.0,Boone Jenner,C,CBJ,30,58,22,13,35
10,8477450.0,Jason Dickinson,C,CHI,28,82,22,13,35
10,8476880.0,Tom Wilson,R,WSH,29,74,18,17,35
10,8482699.0,Dylan Guenther,R,ARI,20,45,18,17,35
10,8475287.0,Erik Haula,L,NJD,32,76,16,19,35
10,8476925.0,Colton Sissons,C,NSH,30,81,15,20,35
10,8482720.0,Matthew Knies,L,TOR,21,80,15,20,35
10,8482113.0,Anton Lundell,C,FLA,22,78,13,22,35
10,8476392.0,Adam Lowry,C,WPG,30,81,12,23,35
10,8478472.0,Mathieu Joseph,R,OTT,26,72,11,24,35
10,8475799.0,Nino Niederreiter,R,WPG,31,77,18,16,34
10,8477476.0,Artturi Lehkonen,L,COL,28,45,16,18,34
10,8481618.0,Alex Newhook,C,MTL,22,55,15,19,34
10,8482159.0,Tyson Foerster,R,PHI,21,77,20,13,33
10,8482110.0,Dawson Mercer,C,NJD,22,82,20,13,33
10,8481580.0,Connor McMichael,C,WSH,22,80,18,15,33
10,8482055.0,Drew O'Connor,L,PIT,25,79,16,17,33
10,8477429.0,Andrew Copp,C,DET,29,79,13,20,33
10,8479992.0,Michael Rasmussen,C,DET,24,75,13,20,33
10,8476826.0,Yanni Gourde,C,SEA,32,80,11,22,33
10,8476419.0,Jean-Gabriel Pageau,C,NYI,31,82,11,22,33
10,8477986.0,Brandon Montour,D,FLA,29,66,8,25,33
10,8482671.0,Owen Power,D,BUF,21,76,6,27,33
10,8478178.0,Darren Raddysh,D,TBL,27,82,6,27,33
10,8480145.0,Neal Pionk,D,WPG,28,82,5,28,33
10,8474565.0,Alex Pietrangelo,D,VGK,33,64,4,29,33
10,8478057.0,Dakota Joshua,C,VAN,27,63,18,14,32
10,8477952.0,Robby Fabbri,C,DET,27,68,18,14,32
10,8476921.0,Jordan Martinook,L,CAR,31,82,14,18,32
10,8475722.0,Jason Zucker,L,ARI,31,69,14,18,32
10,8482705.0,Cole Sillinger,C,CBJ,20,77,13,19,32
10,8477498.0,Darnell Nurse,D,EDM,28,81,10,22,32
10,8475171.0,Oliver Ekman-Larsson,D,FLA,32,80,9,23,32
10,8478500.0,Ivan Provorov,D,CBJ,26,82,5,27,32
10,8474151.0,Ryan McDonagh,D,NSH,34,74,3,29,32
10,8474870.0,Tyler Johnson,C,CHI,33,67,17,14,31
10,8475848.0,Brendan Gallagher,R,MTL,31,77,16,15,31
10,8474189.0,Lars Eller,C,PIT,34,82,15,16,31
10,8476292.0,Ondrej Palat,L,NJD,32,71,11,20,31
10,8481624.0,Ilya Mikheyev,R,VAN,29,78,11,20,31
10,8478458.0,Jack Roslovic,C,CBJ,26,59,9,22,31
10,8477495.0,Seth Jones,D,CHI,29,67,8,23,31
10,8476979.0,Erik Gustafsson,D,NYR,31,76,6,25,31
10,8476331.0,Dylan DeMelo,D,WPG,30,82,3,28,31
10,8480064.0,Josh Norris,C,OTT,24,50,16,14,30
10,8475768.0,Jaden Schwartz,C,SEA,31,62,13,17,30
10,8480802.0,Ryan McLeod,C,EDM,24,81,12,18,30
10,8477987.0,Ryan Donato,C,CHI,27,78,12,18,30
10,8475149.0,Marcus Johansson,L,MIN,33,78,11,19,30
10,8481546.0,Cam York,D,PHI,22,82,10,20,30
10,8477505.0,Alex Wennberg,C,SEA,29,79,10,20,30
10,8473533.0,Jordan Staal,C,CAR,35,80,10,20,30
10,8478469.0,Thomas Chabot,D,OTT,26,51,9,21,30
10,8480817.0,K'Andre Miller,D,NYR,23,80,8,22,30
10,8477969.0,Marcus Pettersson,D,PIT,27,82,4,26,30
10,8475753.0,Justin Faulk,D,STL,31,60,2,28,30
10,8479619.0,Michael Carcone,L,ARI,27,74,21,8,29
10,8482475.0,Yegor Chinakhov,R,CBJ,22,53,16,13,29
10,8480459.0,Pius Suter,C,VAN,27,67,14,15,29
10,8475763.0,Kevin Hayes,R,STL,31,79,13,16,29
10,8481524.0,Bowen  Byram,D,COL,22,73,11,18,29
10,8480336.0,Sean Walker,D,PHI,29,81,10,19,29
10,8481656.0,Aliaksei Protas,C,WSH,22,78,6,23,29
10,8474574.0,Tyler Myers,D,VAN,33,77,5,24,29
10,8482125.0,Alexander Holtz,R,NJD,21,82,16,12,28
10,8480813.0,Joe Veleno,C,DET,23,80,12,16,28
10,8480068.0,Ryan Poehling,C,PHI,24,77,11,17,28
10,8478413.0,Jordan Greenway,L,BUF,26,67,10,18,28
10,8478115.0,Pierre Engvall,L,NYI,27,74,10,18,28
10,8476923.0,Damon Severson,D,CBJ,29,67,9,19,28
10,8476931.0,Jake McCabe,D,TOR,30,73,8,20,28
10,8478133.0,Jake Evans,C,MTL,27,82,7,21,28
10,8476927.0,Teddy Blueger,C,VAN,29,68,6,22,28
10,8475181.0,Nick Leddy,D,STL,32,82,3,25,28
10,8478020.0,Michael Amadio,R,VGK,27,73,14,13,27
10,8481582.0,Nicholas Robertson,L,TOR,22,56,14,13,27
10,8480185.0,Eetu Luostarinen,C,FLA,25,82,12,15,27
10,8480829.0,Jesperi Kotkaniemi,C,CAR,23,79,12,15,27
10,8480113.0,Alex Iafallo,L,WPG,30,82,11,16,27
10,8480748.0,Kiefer Sherwood,L,NSH,28,68,10,17,27
10,8481596.0,Shane Pinto,C,OTT,23,41,9,18,27
10,8480835.0,Jack Drury,C,CAR,23,74,8,19,27
10,8476463.0,Jonas Brodin,D,MIN,30,62,7,20,27
10,8482092.0,Ridly Greig,C,OTT,21,72,13,13,26
10,8476918.0,Jimmy Vesey,L,NYR,30,80,13,13,26
10,8476892.0,Colton Parayko,D,STL,30,82,10,16,26
10,8479941.0,Justin Danforth,R,CBJ,30,71,10,16,26
10,8477425.0,Miles Wood,L,COL,28,74,9,17,26
10,8480855.0,Jack McBain,C,ARI,23,67,8,18,26
10,8474602.0,Justin Schultz,D,SEA,33,70,7,19,26
10,8475790.0,Erik Gudbranson,D,CBJ,31,78,6,20,26
10,8475200.0,Dmitry Orlov,D,CAR,32,82,6,20,26
10,8482655.0,J.J. Moser,D,ARI,23,80,5,21,26
10,8476902.0,Esa Lindell,D,DAL,29,82,5,21,26
10,8475188.0,Brayden McNabb,D,VGK,32,82,4,22,26
10,8476854.0,Hampus Lindholm,D,BOS,29,73,3,23,26
10,8474673.0,TJ Brodie,D,TOR,33,78,1,25,26
10,8476469.0,Joel Armia,R,MTL,30,66,17,8,25
10,8481601.0,Simon Holmstrom,R,NYI,22,75,15,10,25
10,8481186.0,Logan O'Connor,R,COL,27,57,13,12,25
10,8471698.0,T.J. Oshie,R,WSH,37,52,12,13,25
10,8479591.0,Michael Eyssimont,C,TBL,27,81,11,14,25
10,8476312.0,Josh Manson,D,COL,32,76,8,17,25
10,8478136.0,Jake Middleton,D,MIN,27,80,7,18,25
10,8481032.0,Paul Cotter,C,VGK,24,76,7,18,25
10,8477508.0,Curtis Lazar,C,NJD,28,71,7,18,25
10,8482245.0,Artem Zub,D,OTT,28,69,5,20,25
10,8478911.0,Matt Roy,D,LAK,28,81,5,20,25
10,8476879.0,Cody Ceci,D,EDM,30,79,5,20,25
10,8478507.0,John Marino,D,NJD,26,75,4,21,25
10,8478840.0,Will Borgen,D,SEA,27,82,3,22,25
10,8482259.0,Bobby McMann,C,TOR,27,56,15,9,24
10,8481604.0,Pavel Dorofeyev,L,VGK,23,47,13,11,24
10,8478043.0,Sam Lafferty,C,VAN,28,79,13,11,24
10,8479351.0,Sam Steel,C,DAL,25,77,9,15,24
10,8475193.0,Tomas Tatar,L,SEA,33,70,9,15,24
10,8475744.0,Evgeny Kuznetsov,C,WSH,31,63,8,16,24
10,8475233.0,David Savard,D,MTL,33,60,6,18,24
10,8476422.0,Mike Reilly,D,NYI,30,61,6,18,24
10,8474031.0,Kevin Shattenkirk,D,BOS,34,61,6,18,24
10,8473507.0,Jeff Petry,D,DET,36,73,3,21,24
10,8480246.0,Nick Perbix,D,TBL,25,77,2,22,24
10,8481606.0,Jordan Spence,D,LAK,22,71,2,22,24
10,8477947.0,Sonny Milano,L,WSH,27,49,15,8,23
10,8475793.0,Ryan Johansen,C,COL,31,63,13,10,23
10,8480821.0,Filip Zadina,R,SJS,24,72,13,10,23
10,8474149.0,Evgenii Dadonov,R,DAL,34,51,12,11,23
10,8475231.0,Casey Cizikas,C,NYI,32,70,10,13,23
10,8474884.0,Mike Hoffman,C,SJS,34,66,10,13,23
10,8482062.0,Cole Smith,L,NSH,28,80,9,14,23
10,8478882.0,Vladislav Gavrikov,D,LAK,28,77,6,17,23
10,8474157.0,Max Pacioretty,L,WSH,35,47,4,19,23
10,8480873.0,Rasmus Sandin,D,WSH,23,68,3,20,23
10,8480043.0,Timothy Liljegren,D,TOR,24,55,3,20,23
10,8475343.0,Nic Dowd,C,WSH,33,64,12,10,22
10,8470621.0,Corey Perry,R,EDM,38,54,12,10,22
10,8473449.0,Kyle Okposo,R,BUF,35,67,12,10,22
10,8477446.0,Michael McCarron,R,NSH,28,70,12,10,22
10,8481517.0,Brett Leason,R,ANA,24,68,11,11,22
10,8478970.0,Jalen Chatfield,D,CAR,27,72,8,14,22
10,8481014.0,Alexander Romanov,D,NYI,23,81,7,15,22
10,8482087.0,Kaiden Guhle,D,MTL,21,70,6,16,22
10,8477953.0,Kasperi Kapanen,R,STL,27,73,6,16,22
10,8476885.0,Jacob Trouba,D,NYR,29,69,3,19,22
10,8480281.0,Alexey Toropchenko,R,STL,24,82,14,7,21
10,8482157.0,Will Cuylle,L,NYR,21,81,13,8,21
10,8478013.0,Jake Walman,D,DET,27,63,12,9,21
10,8475714.0,Calle Jarnkrok,C,TOR,32,52,10,11,21
10,8475220.0,Marcus Foligno,L,MIN,32,55,9,12,21
10,8471218.0,Blake Wheeler,R,NYR,37,54,9,12,21
10,8479359.0,Beck Malenstyn,L,WSH,25,81,6,15,21
10,8476897.0,Oskar Sundqvist,C,STL,29,71,6,15,21
10,8481178.0,Egor Zamula,D,PHI,23,66,5,16,21
10,8480891.0,Michael Kesselring,D,ARI,23,65,5,16,21
10,8479983.0,Mario Ferraro,D,SJS,25,78,3,18,21
10,8475225.0,Craig Smith,C,DAL,34,75,11,9,20
10,8476981.0,Josh Anderson,R,MTL,29,78,9,11,20
10,8475455.0,Brenden Dillon,D,WPG,33,77,8,12,20
10,8481577.0,Philip Tomasino,C,NSH,22,41,7,13,20
10,8477507.0,Nikita Zadorov,D,VAN,28,75,6,14,20
10,8475279.0,Ben Chiarot,D,DET,32,77,5,15,20
10,8478851.0,Alexandre Carrier,D,NSH,27,73,4,16,20
10,8480035.0,Henri Jokiharju,D,BUF,24,74,3,17,20
10,8480073.0,Erik Brannstrom,D,OTT,24,76,3,17,20
10,8475179.0,Dmitry Kulikov,D,FLA,33,76,1,19,20
10,8481554.0,Kaapo Kakko,R,NYR,22,61,13,6,19
10,8480980.0,Connor Dewar,C,MIN,24,74,11,8,19
10,8479415.0,Michael McLeod,C,NJD,25,45,10,9,19
10,8482097.0,Jack Quinn,R,BUF,22,27,9,10,19
10,8480144.0,David Kampf,C,TOR,28,78,8,11,19
10,8479353.0,Brett Howden,C,VGK,25,72,8,11,19
10,8475164.0,Jakob Silfverberg,R,ANA,33,81,7,12,19
10,8476889.0,Radek Faksa,C,DAL,29,74,7,12,19
10,8473504.0,Cal Clutterbuck,R,NYI,36,82,7,12,19
10,8475855.0,Jesper Fast,R,CAR,32,73,6,13,19
10,8477380.0,Jonny Brodzinski,C,NYR,30,57,6,13,19
10,8471699.0,Andrew Cogliano,C,COL,36,75,6,13,19
10,8477506.0,Ryan Pulock,D,NYI,29,58,5,14,19
10,8480172.0,Jan Rutta,D,SJS,33,69,5,14,19
10,8482073.0,Braden Schneider,D,NYR,22,82,5,14,19
10,8478432.0,Christian Fischer,R,DET,26,79,5,14,19
10,8479410.0,Mikhail Sergachev,D,TBL,25,34,2,17,19
10,8475690.0,Chris Tanev,D,CGY,34,75,2,17,19
10,8480878.0,Nils Lundkvist,D,DAL,23,59,2,17,19
10,8479316.0,Luke Kunin,C,SJS,26,77,11,7,18
10,8480289.0,Morgan Barron,C,WPG,25,80,11,7,18
10,8476374.0,Sean Kuraly,C,CBJ,30,62,9,9,18
10,8480448.0,Parker Kelly,L,OTT,24,80,8,10,18
10,8478434.0,Keegan Kolesar,R,VGK,26,79,8,10,18
10,8475462.0,Radko Gudas,D,ANA,33,66,6,12,18
10,8480220.0,Noah Cates,L,PHI,24,59,6,12,18
10,8476457.0,Adam Larsson,D,SEA,31,81,4,14,18
10,8477932.0,Aaron Ekblad,D,FLA,27,51,4,14,18
10,8477365.0,Connor Clifton,D,BUF,28,79,4,14,18
10,8476874.0,Olli Maatta,D,DET,29,72,4,14,18
10,8479398.0,Samuel Girard,D,COL,25,59,3,15,18
10,8479998.0,Mikey Anderson,D,LAK,24,74,2,16,18
10,8480049.0,Dylan Samberg,D,WPG,24,78,1,17,18
10,8478508.0,Yakov Trenin,C,NSH,26,76,12,5,17
10,8477903.0,Garnet Hathaway,R,PHI,32,82,7,10,17
10,8480995.0,Pontus Holmberg,R,TOR,24,54,7,10,17
10,8479315.0,Joey Anderson,R,CHI,25,55,5,12,17
10,8478463.0,Anthony Beauvillier,L,CHI,26,60,5,12,17
10,8474166.0,Alec Martinez,D,VGK,36,55,4,13,17
10,8481522.0,Peyton Krebs,C,BUF,22,80,4,13,17
10,8478859.0,Niko Mikkola,D,FLA,27,82,3,14,17
10,8479324.0,Ryan Lindgren,D,NYR,25,76,3,14,17
10,8481605.0,Jackson LaCombe,D,ANA,22,71,2,15,17
10,8479976.0,Juuso Valimaki,D,ARI,25,68,2,15,17
10,8470600.0,Ryan Suter,D,DAL,38,82,2,15,17
10,8480884.0,Calen Addison,D,SJS,23,72,1,16,17
10,8475842.0,Sam Carrick,C,ANA,31,77,10,6,16
10,8479977.0,Kailer Yamamoto,R,SEA,25,59,8,8,16
10,8473453.0,Trevor Lewis,C,LAK,36,82,8,8,16
10,8480205.0,Emil Bemstrom,R,CBJ,24,56,8,8,16
10,8479293.0,Brandon Tanev,L,SEA,32,66,7,9,16
10,8477444.0,Andre Burakovsky,L,SEA,28,49,7,9,16
10,8475208.0,Brian Dumoulin,D,SEA,32,80,6,10,16
10,8482660.0,Kent Johnson,C,CBJ,21,42,6,10,16
10,8477979.0,Nicolas Aube-Kubel,R,WSH,27,60,6,10,16
10,8476462.0,Dougie Hamilton,D,NJD,30,20,5,11,16
10,8482117.0,Lukas Reichel,L,CHI,21,65,5,11,16
10,8474034.0,Pat Maroon,L,MIN,35,51,4,12,16
10,8480796.0,Martin Fehervary,D,WSH,24,66,3,13,16
10,8476967.0,Brett Kulak,D,EDM,29,82,3,13,16
10,8471677.0,Jack Johnson,D,COL,36,80,3,13,16
10,8481568.0,Alex Vlasic,D,CHI,22,76,2,14,16
10,8476917.0,Adam Pelech,D,NYI,29,58,1,15,16
10,8479423.0,Alex Nylander,L,PIT,25,28,11,4,15
10,8478831.0,Kevin Stenlund,C,FLA,27,81,11,4,15
10,8470604.0,Jeff Carter,C,PIT,38,72,11,4,15
10,8477330.0,Dominik Kubalik,L,OTT,28,74,11,4,15
10,8476873.0,Mark Jankowski,C,NSH,29,32,7,8,15
10,8476393.0,Nick Cousins,C,FLA,30,69,7,8,15
10,8481560.0,Arthur Kaliyev,R,LAK,22,51,7,8,15
10,8481481.0,Blake Lizotte,C,LAK,26,62,7,8,15
10,8478109.0,Victor Olofsson,L,BUF,28,51,7,8,15
10,8481533.0,Trevor Zegras,C,ANA,22,31,6,9,15
10,8478042.0,Viktor Arvidsson,R,LAK,30,18,6,9,15
10,8474090.0,Brendan Smith,D,NJD,34,63,5,10,15
10,8477919.0,Frederick Gaudreau,C,MIN,30,67,5,10,15
10,8479368.0,Max Jones,L,ANA,25,52,5,10,15
10,8477839.0,Conor Sheary,L,TBL,31,57,4,11,15
10,8476467.0,Jamie Oleksiak,D,SEA,31,82,2,13,15
10,8475197.0,Tyson Barrie,D,NSH,32,41,1,14,15
10,8476878.0,Zemgus Girgensons,L,BUF,29,63,8,6,14
10,8480011.0,Klim Kostin,C,DET,24,52,8,6,14
10,8479661.0,Tanner Jeannot,L,TBL,26,55,7,7,14
10,8478468.0,Jeremy Lauzon,D,NSH,26,79,6,8,14
10,8480003.0,Jesper Boqvist,C,BOS,25,47,6,8,14
10,8479390.0,Taylor Raddysh,R,CHI,25,73,5,9,14
10,8477070.0,Liam O'Brien,C,ARI,29,75,5,9,14
10,8478443.0,Brandon Carlo,D,BOS,27,76,4,10,14
10,8480879.0,Jacob Bernard-Docker,D,OTT,23,72,4,10,14
10,8477392.0,Hudson Fasching,R,NYI,28,45,4,10,14
10,8477435.0,Ryan Graves,D,PIT,28,70,3,11,14
10,8474567.0,Zach Bogosian,D,MIN,33,65,3,11,14
10,8480887.0,Jordan Harris,D,MTL,23,56,3,11,14
10,8480727.0,Zach Whitecloud,D,VGK,27,61,2,12,14
10,8477220.0,Nate Schmidt,D,WPG,32,63,2,12,14
10,8475324.0,Nick Jensen,D,WSH,33,78,1,13,14
10,8480001.0,Urho Vaakanainen,D,ANA,24,68,1,13,14
10,8477845.0,Trevor van Riemsdyk,D,WSH,32,70,0,14,14
10,8482111.0,Justin Barron,D,MTL,22,48,7,6,13
10,8479383.0,Boris Katchouk,L,CHI,25,59,7,6,13
10,8477573.0,Nathan Walker,L,STL,29,45,7,6,13
10,8480192.0,Johnathan Kovacevic,D,MTL,26,62,6,7,13
10,8479996.0,Cody Glass,C,NSH,24,41,6,7,13
10,8481477.0,Nico Sturm,C,SJS,28,63,5,8,13
10,8476871.0,Tanner Pearson,L,MTL,31,54,5,8,13
10,8479520.0,Brandon Duhaime,R,MIN,26,80,5,8,13
10,8479402.0,Jake Bean,D,CBJ,25,72,4,9,13
10,8482222.0,Alexander Barabanov,L,SJS,29,46,4,9,13
10,8477488.0,Brett Pesce,D,CAR,29,70,3,10,13
10,8479371.0,Dante Fabbro,D,NSH,25,56,3,10,13
10,8478416.0,Erik Cernak,D,TBL,26,69,2,11,13
10,8476372.0,Nick Seeler,D,PHI,30,71,1,12,13
10,8481704.0,Juuso Parssinen,C,NSH,22,44,8,4,12
10,8476278.0,Colin Blackwell,C,CHI,30,44,8,4,12
10,8479336.0,Carl Grundstrom,R,LAK,26,50,8,4,12
10,8471709.0,Marc-Edouard Vlasic,D,SJS,36,57,6,6,12
10,8479393.0,Noah Gregor,C,TOR,25,63,6,6,12
10,8478421.0,A.J. Greer,L,CGY,27,59,6,6,12
10,8479671.0,Mathieu Olivier,R,CBJ,26,54,5,7,12
10,8477846.0,Ryan Carpenter,C,SJS,32,62,5,7,12
10,8478585.0,Derek Ryan,C,EDM,37,70,5,7,12
10,8479414.0,Nathan Bastian,R,NJD,26,54,5,7,12
10,8477015.0,Connor Brown,R,EDM,29,71,4,8,12
10,8476624.0,Barclay Goodrow,C,NYR,30,80,4,8,12
10,8477406.0,Mattias Janmark,C,EDM,31,71,4,8,12
10,8476919.0,Chris Tierney,C,NJD,29,52,4,8,12
10,8479543.0,Michael Pezzetta,L,MTL,25,61,3,9,12
10,8475825.0,Jani Hakanpää,D,DAL,31,64,2,10,12
10,8479980.0,Nicolas Hague,D,VGK,25,73,2,10,12
10,8476822.0,Luke Glendening,C,TBL,34,81,10,1,11
10,8482133.0,Thomas Bordeleau,C,SJS,21,27,6,5,11
10,8480806.0,Isac Lundestrom,C,ANA,24,46,5,6,11
10,8480025.0,MacKenzie Entwistle,R,CHI,24,67,5,6,11
10,8475750.0,Jon Merrill,D,MIN,31,65,4,7,11
10,8481567.0,Henry Thrun,D,SJS,22,51,3,8,11
10,8477950.0,Tony DeAngelo,D,CAR,28,31,3,8,11
10,8474013.0,Ian Cole,D,VAN,34,78,2,9,11
10,8476891.0,Matt Grzelcyk,D,BOS,29,63,2,9,11
10,8480058.0,Pierre-Olivier Joseph,D,PIT,24,52,2,9,11
10,8480860.0,Kevin Bahl,D,NJD,23,82,1,10,11
10,8479576.0,Vincent Desharnais,D,EDM,27,78,1,10,11
10,8470610.0,Zach Parise,L,COL,39,30,5,5,10
10,8476858.0,Phillip Di Giuseppe,L,VAN,30,51,5,5,10
10,8474040.0,Sam Gagner,C,EDM,34,28,5,5,10
10,8480355.0,Mark Kastelic,C,OTT,24,63,5,5,10
10,8482142.0,Jamie Drysdale,D,PHI,21,34,3,7,10
10,8480849.0,Barrett Hayton,C,ARI,23,33,3,7,10
10,8475177.0,Calvin de Haan,D,TBL,32,59,3,7,10
10,8482964.0,Arber Xhekaj,D,MTL,22,44,3,7,10
10,8477384.0,Josh Brown,D,ARI,29,51,3,7,10
10,8480184.0,Gustav Lindström,D,ANA,25,46,3,7,10
10,8480762.0,Eric Robinson,L,BUF,28,47,3,7,10
10,8477018.0,Ben Hutton,D,VGK,30,41,2,8,10
10,8481093.0,Rafael Harvey-Pinard,L,MTL,24,45,2,8,10
10,8480880.0,Jakub Lauko,C,BOS,23,60,2,8,10
10,8480871.0,Adam Boqvist,D,CBJ,23,35,1,9,10
10,8479369.0,Andrew Peeke,D,CBJ,25,38,1,9,10
10,8479982.0,Conor Timmins,D,TOR,25,25,1,9,10
10,8483460.0,David Jiricek,D,CBJ,20,43,1,9,10
10,8477971.0,Andreas Englund,D,LAK,27,82,1,9,10
10,8471274.0,Alex Goligoski,D,MIN,38,36,0,10,10
10,8479439.0,Jacob MacDonald,D,SJS,30,34,7,2,9
10,8479339.0,Patrik Laine,L,CBJ,25,18,6,3,9
10,8477353.0,Tyler Motte,C,TBL,28,69,6,3,9
10,8482077.0,Dylan Holloway,L,EDM,22,38,6,3,9
10,8479718.0,Alex Barré-Boulet,C,TBL,26,36,6,3,9
10,8477989.0,Christian Dvorak,C,MTL,27,30,5,4,9
10,8479328.0,Julien Gauthier,R,NYI,26,27,5,4,9
10,8479968.0,Vinni Lettieri,C,MIN,28,46,5,4,9
10,8476525.0,Colin Miller,D,NJD,31,46,4,5,9
10,8470966.0,Mark Giordano,D,TOR,40,46,3,6,9
10,8482679.0,Matt Coronato,R,CGY,21,34,3,6,9
10,8480008.0,Adam Ruzicka,C,ARI,24,42,3,6,9
10,8481641.0,Joel Kiviranta,L,COL,27,56,3,6,9
10,8478028.0,Fredrik Olofsson,L,COL,27,57,3,6,9
10,8480222.0,Sebastian Aho,D,NYI,27,58,2,7,9
10,8481708.0,Zac Jones,D,NYR,23,31,2,7,9
10,8476960.0,Andreas Athanasiou,C,CHI,29,28,2,7,9
10,8480848.0,Ty Dellandrea,C,DAL,23,42,2,7,9
10,8478099.0,Kevin Labanc,R,SJS,28,46,2,7,9
10,8478399.0,Jonas Siegenthaler,D,NJD,26,57,1,8,9
10,8481527.0,Kaedan Korczak,D,VGK,22,26,1,8,9
10,8481537.0,Nikita Okhotiuk,D,SJS,23,52,1,8,9
10,8475797.0,Jarred Tinordi,D,CHI,31,52,0,9,9
10,8479372.0,Josh Mahura,D,FLA,25,30,0,9,9
10,8477478.0,William Carrier,L,VGK,29,39,6,2,8
10,8480252.0,Cole Guttman,C,CHI,24,27,4,4,8
10,8481058.0,Jesse Ylönen,R,MTL,24,59,4,4,8
10,8474709.0,Matt Martin,L,NYI,34,57,4,4,8
10,8477541.0,Dakota Mermis,D,MIN,29,47,3,5,8
10,8478211.0,Dryden Hunt,L,CGY,28,28,3,5,8
10,8476473.0,Connor Murphy,D,CHI,30,46,2,6,8
10,8477335.0,Kyle Burroughs,D,SJS,28,73,2,6,8
10,8474618.0,Marco Scandella,D,STL,33,65,2,6,8
10,8476329.0,Travis Boyd,C,ARI,30,16,2,6,8
10,8480196.0,Jacob Bryson,D,BUF,26,36,1,7,8
10,8478450.0,Parker Wotherspoon,D,BOS,26,41,0,8,8
10,8480950.0,Ilya Lyubushkin,D,ANA,29,74,0,8,8
10,8479066.0,Ryan Lomberg,L,FLA,29,75,5,2,7
10,8478569.0,Noel Acciari,C,PIT,32,55,4,3,7
10,8477930.0,Pierre-Edouard Bellemare,L,SEA,38,40,4,3,7
10,8482241.0,Radim Zohorna,L,PIT,27,33,4,3,7
10,8482624.0,Daniil Miromanov,D,VGK,26,24,3,4,7
10,8479346.0,Dillon Dube,C,CGY,25,43,3,4,7
10,8482496.0,Nils Aman,C,VAN,23,43,3,4,7
10,8481019.0,David Gustafsson,C,WPG,23,39,3,4,7
10,8478408.0,Travis Dermott,D,ARI,27,50,2,5,7
10,8479458.0,Nikita Zaitsev,D,CHI,32,38,2,5,7
10,8481167.0,Brayden Pachal,D,CGY,24,50,2,5,7
10,8480084.0,Nick DeSimone,D,NJD,29,34,2,5,7
10,8482652.0,Walker Duehr,R,CGY,26,40,2,5,7
10,8480807.0,Mattias Samuelsson,D,BUF,23,41,1,6,7
10,8479442.0,Troy Stecher,D,ARI,29,54,1,6,7
10,8482516.0,Matthew Kessel,D,STL,23,39,1,6,7
10,8474568.0,Luke Schenn,D,NSH,34,63,1,6,7
10,8478454.0,Noah Juulsen,D,VAN,26,54,1,6,7
10,8478502.0,Dennis Gilbert,D,CGY,27,34,1,6,7
10,8478104.0,Sammy Blais,L,STL,27,53,1,6,7
10,8482176.0,Wyatt Kaiser,D,CHI,21,32,0,7,7
10,8473446.0,Erik Johnson,D,BUF,35,67,5,1,6
10,8471817.0,Ryan Reaves,R,TOR,36,49,4,2,6
10,8479370.0,Tyson Jost,C,BUF,25,43,3,3,6
10,8477369.0,Carson Soucy,D,VAN,29,40,2,4,6
10,8474612.0,Travis Hamonic,D,OTT,33,48,2,4,6
10,8482730.0,Brandt Clarke,D,LAK,20,16,2,4,6
10,8477944.0,Jakub Vrana,L,STL,27,21,2,4,6
10,8477931.0,Tomas Nosek,L,NJD,31,36,2,4,6
10,8480789.0,Oliver Wahlstrom,R,NYI,23,32,2,4,6
10,8481013.0,Jonatan Berggren,R,DET,23,12,2,4,6
10,8476441.0,Joel Edmundson,D,WSH,30,53,1,5,6
10,8482192.0,Isaak Phillips,D,CHI,22,33,0,6,6
10,8480078.0,Filip Chytil,C,NYR,24,10,0,6,6
10,8483524.0,Shane Wright,C,SEA,19,8,4,1,5
10,8477962.0,Brendan Lemieux,L,CAR,27,32,3,2,5
10,8481541.0,Samuel Bolduc,D,NYI,23,34,2,3,5
10,8481147.0,Reese Johnson,C,CHI,25,42,2,3,5
10,8481422.0,Jacob Lucchini,C,MIN,28,40,2,3,5
10,8479536.0,Axel Jonsson-Fjallby,L,WPG,25,26,2,3,5
10,8481122.0,Simon Benoit,D,TOR,25,64,1,4,5
10,8477938.0,Haydn Fleury,D,TBL,27,24,1,4,5
10,8477810.0,Joel Hanley,D,DAL,32,42,1,4,5
10,8471686.0,Marc Staal,D,PHI,36,35,1,4,5
10,8474009.0,Nick Bonino,C,NYR,35,45,1,4,5
10,8476952.0,Dominic Toninato,C,WPG,29,15,1,4,5
10,8479547.0,Matthew Phillips,R,PIT,25,31,1,4,5
10,8480245.0,Olle Lycksell,R,PHI,24,18,1,4,5
10,8474716.0,Jared Spurgeon,D,MIN,34,16,0,5,5
10,8475906.0,John Klingberg,D,TOR,31,14,0,5,5
10,8476429.0,Scott Mayfield,D,NYI,31,41,0,5,5
10,8475718.0,Justin Holl,D,DET,31,38,0,5,5
10,8478452.0,Caleb Jones,D,COL,26,25,0,5,5
10,8479291.0,Kevin Rooney,C,CGY,30,33,3,1,4
10,8479344.0,Jesse Puljujarvi,R,PIT,25,22,3,1,4
10,8478051.0,Max Willman,C,NJD,28,18,3,1,4
10,8475791.0,Taylor Hall,L,CHI,32,10,2,2,4
10,8481056.0,Spencer Stastney,D,NSH,23,20,2,2,4
10,8476867.0,Brendan Gaunce,C,CBJ,29,24,2,2,4
10,8479981.0,Jonah Gadjovich,L,FLA,25,39,2,2,4
10,8475766.0,Austin Watson,L,TBL,31,33,2,2,4
10,8477499.0,Rasmus Ristolainen,D,PHI,29,31,1,3,4
10,8478451.0,Ethan Bear,D,WSH,26,24,1,3,4
10,8481609.0,Vladislav Kolyachonok,D,ARI,22,5,1,3,4
10,8477244.0,Chad Ruhwedel,D,PIT,33,52,1,3,4
10,8476442.0,Matt Nieto,L,PIT,31,22,1,3,4
10,8479994.0,Jaret Anderson-Dolan,C,LAK,24,31,1,3,4
10,8475752.0,Tyler Pitlick,C,NYR,32,34,1,3,4
10,8481532.0,Alex Turcotte,C,LAK,22,20,1,3,4
10,8477527.0,Ross Johnston,L,ANA,29,68,1,3,4
10,8475235.0,Nicolas Deslauriers,L,PHI,32,60,1,3,4
10,8476913.0,Devin Shore,C,SEA,29,21,1,3,4
10,8479379.0,Givani Smith,R,SJS,25,36,1,3,4
10,8475762.0,Derek Forbort,D,BOS,31,35,0,4,4
10,8478424.0,Jansen Harkins,C,PIT,26,45,0,4,4
10,8480441.0,Trey Fix-Wolansky,R,CBJ,24,11,2,1,3
10,8478078.0,Rourke Chartier,C,OTT,27,37,2,1,3
10,8480776.0,Sheldon Rempal,R,VGK,28,9,2,1,3
10,8480468.0,James Hamblin,L,EDM,24,31,2,1,3
10,8479772.0,Zack MacEwen,R,OTT,27,30,2,1,3
10,8477073.0,Kurtis MacDermid,D,COL,29,45,2,1,3
10,8480823.0,Alexander Alexeyev,D,WSH,24,39,1,2,3
10,8480007.0,Jonas Rondbjerg,R,VGK,24,20,1,2,3
10,8476934.0,Brock McGinn,L,ANA,29,24,1,2,3
10,8478409.0,Anthony Richard,C,BOS,27,9,1,2,3
10,8483570.0,Ben Meyers,C,COL,25,23,1,2,3
10,8476994.0,Vinnie Hinostroza,C,PIT,29,14,1,2,3
10,8481592.0,Jakob Pelletier,L,CGY,22,13,1,2,3
10,8478904.0,Steven Lorentz,C,FLA,27,38,1,2,3
10,8479972.0,Mason Shaw,C,MIN,25,20,1,2,3
10,8480853.0,Liam Foudy,C,NSH,23,13,0,3,3
10,8482762.0,Simon Edvinsson,D,DET,20,16,1,1,2
10,8482101.0,Danil Gushchin,L,SJS,21,4,1,1,2
10,8479378.0,Logan Stanley,D,WPG,25,25,1,1,2
10,8481006.0,Tyler Tucker,D,STL,23,26,1,1,2
10,8478495.0,Denis Gurianov,R,NSH,26,18,1,1,2
10,8479362.0,Riley Tufte,L,COL,25,5,1,1,2
10,8480292.0,Carson Meyer,R,CBJ,26,14,1,1,2
10,8477454.0,Adam Erne,L,EDM,28,24,1,1,2
10,8475780.0,Chris Wagner,R,BOS,32,13,1,1,2
10,8476988.0,Matt Benning,D,SJS,29,14,0,2,2
10,8477034.0,Jaycob Megna,D,CHI,31,44,0,2,2
10,8481521.0,Ronnie Attard,D,PHI,24,12,0,2,2
10,8480070.0,Ian Mitchell,D,BOS,24,13,0,2,2
10,8477851.0,Jordan Oesterle,D,CGY,31,22,0,2,2
10,8481161.0,Jake Christiansen,D,CBJ,24,12,0,2,2
10,8482451.0,Mikael Pyyhtia,L,CBJ,22,17,0,2,2
10,8473473.0,Milan Lucic,L,BOS,35,4,0,2,2
10,8480870.0,Bo Groulx,C,ANA,23,45,0,2,2
10,8481598.0,Philip Broberg,D,EDM,22,12,0,2,2
10,8477464.0,Nic Petan,C,MIN,28,6,0,2,2
10,8481617.0,Vasily Podkolzin,R,VAN,22,19,0,2,2
10,8481751.0,Lukas Rousek,R,BUF,24,15,0,2,2
10,8481550.0,Adam Beckman,L,MIN,22,11,0,2,2
10,8481523.0,Kirby Dach,C,MTL,22,2,0,2,2
10,8481543.0,Nikita Alexandrov,C,STL,23,23,0,2,2
10,8478146.0,Matthew Highmore,C,OTT,27,7,0,2,2
10,8481043.0,Cole Koepke,L,TBL,25,9,0,2,2
10,8483565.0,Nick Blankenburg,D,CBJ,25,12,1,0,1
10,8483397.0,Marc McLaughlin,C,BOS,24,1,1,0,1
10,8480874.0,Adam Ginning,D,PHI,23,9,1,0,1
10,8481754.0,Nikita Nesterenko,C,ANA,22,3,1,0,1
10,8480021.0,Jack Studnicka,C,SJS,24,22,1,0,1
10,8481518.0,Nolan Foote,L,NJD,23,4,1,0,1
10,8479421.0,Jacob Moverare,D,LAK,25,24,1,0,1
10,8481239.0,Samuel Fagemo,L,LAK,23,8,1,0,1
10,8479546.0,Oskar Steen,C,BOS,25,34,1,0,1
10,8480836.0,Jonathan Gruden,C,PIT,23,13,1,0,1
10,8481077.0,John Leonard,L,NSH,25,6,1,0,1
10,8482147.0,Jean-Luc Foudy,C,COL,21,4,1,0,1
10,8474053.0,Logan Couture,C,SJS,34,6,0,1,1
10,8481812.0,Nikolai Knyzhov,D,SJS,26,10,0,1,1
10,8479984.0,Cal Foote,D,NJD,25,4,0,1,1
10,8479321.0,Lucas Johansen,D,WSH,26,6,0,1,1
10,8473563.0,Nicklas Backstrom,C,WSH,36,8,0,1,1
10,8479320.0,Max Lajoie,D,TOR,26,7,0,1,1
10,8482095.0,Tyler Kleven,D,OTT,21,9,0,1,1
10,8480157.0,Calle Rosen,D,STL,29,6,0,1,1
10,8480031.0,Max Comtois,L,ANA,24,1,0,1,1
10,8478017.0,Mark Friedman,D,VAN,28,23,0,1,1
10,8479348.0,Kale Clague,D,BUF,25,3,0,1,1
10,8475278.0,Byron Froese,C,VGK,32,16,0,1,1
10,8475795.0,Dylan McIlrath,D,WSH,31,3,0,1,1
10,8480845.0,Rasmus Kupari,C,WPG,23,28,0,1,1
10,8480890.0,Jan Jenik,R,ARI,23,5,0,1,1
10,8477887.0,Patrick Brown,C,BOS,31,11,0,1,1
10,8478512.0,Austin Czarnik,C,DET,31,34,0,1,1
10,8479367.0,William Lockwood,R,FLA,25,26,0,1,1
10,8483597.0,Milos Kelemen,L,ARI,24,10,0,1,1
10,8477126.0,Jayson Megna,C,ANA,33,1,0,0,0
10,8479639.0,Dylan Coghlan,D,CAR,25,1,0,0,0
10,8482067.0,Connor Mackey,D,NYR,27,1,0,0,0
10,8476856.0,Matt Dumba,D,ARI,29,0,0,0,0
10,8478483.0,Mitchell Marner,R,TOR,26,0,0,0,0
10,8471873.0,Anton Stralman,D,BOS,37,0,0,0,0
10,8474162.0,Jake Muzzin,D,TOR,34,0,0,0,0
10,8470638.0,Patrice Bergeron,C,BOS,38,0,0,0,0
10,8473604.0,Jonathan Toews,C,CHI,35,0,0,0,0
10,8471276.0,David Krejci,C,BOS,37,0,0,0,0
10,8474207.0,Nick Holden,D,OTT,36,0,0,0,0
10,8475747.0,Patrik Nemeth,D,ARI,31,0,0,0,0
10,8477467.0,Gustav Olofsson,D,SEA,29,1,0,0,0
10,8479514.0,Rem Pitlick,C,CHI,26,9,0,0,0
10,8474027.0,Justin Braun,D,PHI,36,0,0,0,0
10,8481599.0,Victor Soderstrom,D,ARI,22,3,0,0,0
10,8474161.0,Jakub Voracek,R,CBJ,34,0,0,0,0
10,8479985.0,Cale Fleury,D,SEA,25,1,0,0,0
10,8471303.0,Alexander Edler,D,LAK,37,0,0,0,0
10,8474573.0,Josh Bailey,R,NYI,34,0,0,0,0
10,8483619.0,Filip Roos,D,CHI,24,4,0,0,0
10,8474818.0,Jordie Benn,D,TOR,36,0,0,0,0
10,8476449.0,Scott Harrington,D,ANA,30,0,0,0,0
10,8483620.0,Marcus Bjork,D,CBJ,26,0,0,0,0
10,8470595.0,Eric Staal,C,FLA,39,0,0,0,0
10,8481585.0,Egor Afanasyev,L,NSH,22,2,0,0,0
10,8482712.0,Oskar Olausson,R,COL,21,1,0,0,0
10,8481072.0,Tim Berni,D,CBJ,23,0,0,0,0
10,8479945.0,Gavin Bayreuther,D,CBJ,29,0,0,0,0
10,8481600.0,Tobias Bjornfot,D,VGK,22,4,0,0,0
10,8481679.0,Maxence Guenette,D,OTT,22,7,0,0,0
10,8474683.0,Derek Grant,C,ANA,33,0,0,0,0
10,8476470.0,Nathan Beaulieu,D,ANA,31,0,0,0,0
10,8474145.0,Robert Bortuzzo,D,NYI,34,27,0,0,0
10,8480216.0,Jacob Peterson,C,SJS,24,6,0,0,0
10,8473548.0,Phil Kessel,R,VGK,36,0,0,0,0
10,8480160.0,Radim Simek,D,SJS,31,0,0,0,0
10,8480883.0,Ty Smith,D,PIT,23,0,0,0,0
10,8471669.0,Paul Stastny,C,CAR,38,0,0,0,0
10,8475227.0,Chris Wideman,D,MTL,33,0,0,0,0
10,8480913.0,Jordan Gross,D,NSH,28,0,0,0,0
10,8475625.0,Matt Irwin,D,WSH,36,0,0,0,0
10,8479388.0,Riley Stillman,D,BUF,25,0,0,0,0
10,8474628.0,Michael Stone,D,CGY,33,0,0,0,0
10,8484254.0,Akito Hirose,D,VAN,24,3,0,0,0
10,8477941.0,Nick Ritchie,L,CGY,28,0,0,0,0
10,8477462.0,Robert Hagg,D,ANA,28,5,0,0,0
10,8478062.0,Dysin Mayo,D,ARI,27,0,0,0,0
10,8482634.0,Alex Steeves,C,TOR,24,1,0,0,0
10,8477433.0,Ben Harpur,D,NYR,28,0,0,0,0
10,8478841.0,Colton White,D,ANA,26,0,0,0,0
10,8473544.0,Derick Brassard,C,OTT,36,0,0,0,0
10,8476884.0,Derrick Pouliot,D,SJS,29,5,0,0,0
10,8479376.0,Victor Mete,D,PHI,25,1,0,0,0
10,8483630.0,Pavol Regenda,L,ANA,24,5,0,0,0
10,8479026.0,Philippe Myers,D,TBL,26,5,0,0,0
10,8477482.0,Zach Sanford,L,CHI,29,0,0,0,0
10,8477359.0,Tucker Poolman,D,VAN,30,0,0,0,0
10,8475857.0,Kevin Gravel,D,NSH,31,0,0,0,0
10,8476779.0,Brad Hunt,D,COL,35,0,0,0,0
10,8476850.0,Ryan Murray,D,EDM,30,0,0,0,0
10,8477341.0,Andreas Johnsson,L,SJS,29,0,0,0,0
10,8474218.0,Jason Demers,D,EDM,35,0,0,0,0
10,8480844.0,Grigori Denisenko,L,VGK,23,6,0,0,0
10,8484287.0,Cole McWard,D,VAN,22,1,0,0,0
10,8479322.0,Wade Allison,R,PHI,26,0,0,0,0
10,8478846.0,Christian Wolanin,D,VAN,28,0,0,0,0
10,8471887.0,Patric Hornqvist,R,FLA,36,0,0,0,0
10,8475163.0,Alex Chiasson,R,DET,33,0,0,0,0
10,8478881.0,Brett Seney,L,CHI,27,4,0,0,0
10,8474697.0,Mark Borowiecki,D,NSH,34,0,0,0,0
10,8476410.0,Josh Leivo,L,STL,30,0,0,0,0
10,8475968.0,Alex Belzile,R,MTL,32,0,0,0,0
10,8479580.0,Dylan Gambrell,C,OTT,27,0,0,0,0
10,8480901.0,Karson Kuhlman,C,WPG,28,0,0,0,0
10,8480326.0,Sheldon Dries,C,VAN,29,0,0,0,0
10,8478465.0,Guillaume Brisebois,D,VAN,26,0,0,0,0
10,8482861.0,Vincent Iorio,D,WSH,21,6,0,0,0
10,8471794.0,Darren Helm,C,COL,36,0,0,0,0
10,8479335.0,Rasmus Asplund,C,NSH,26,0,0,0,0
10,8478415.0,Jakub Zboril,D,BOS,26,0,0,0,0
10,8476310.0,Lukas Sedlak,C,PHI,30,0,0,0,0
10,8478075.0,Anders Bjork,L,CHI,27,0,0,0,0
10,8480267.0,Sammy Walker,C,MIN,24,4,0,0,0
10,8479578.0,Casey Fitzgerald,D,FLA,26,0,0,0,0
10,8480032.0,Shane Bowers,C,NJD,24,8,0,0,0
10,8478400.0,Colin White,C,PIT,26,28,0,0,0
10,8478431.0,Evgeny Svechnikov,L,SJS,27,0,0,0,0
10,8475772.0,Riley Sheahan,C,BUF,32,0,0,0,0
10,8481690.0,Tyler Angle,C,CBJ,23,2,0,0,0
10,8476326.0,Josh Archibald,R,PIT,31,0,0,0,0
10,8478843.0,Denis Malgin,C,COL,26,0,0,0,0
10,8478446.0,Glenn Gawdin,C,ANA,26,1,0,0,0
10,8477357.0,Saku Maenalanen,R,WPG,29,0,0,0,0
10,8478870.0,Rudolfs Balcers,L,TBL,26,0,0,0,0
10,8478476.0,Kyle Capobianco,D,WPG,26,0,0,0,0
10,8476439.0,Brett Ritchie,R,ARI,30,0,0,0,0
10,8474613.0,Derek Stepan,C,CAR,33,0,0,0,0
10,8475178.0,Zack Kassian,R,ARI,32,0,0,0,0
10,8480226.0,Marián Studenic,R,SEA,25,2,0,0,0
10,8481070.0,Hugh McGing,L,STL,25,5,0,0,0
10,8482250.0,Callahan Burke,C,CAR,26,1,0,0,0
10,8481591.0,Sam Poulin,R,PIT,22,3,0,0,0
10,8481441.0,Joe Snively,C,WSH,27,3,0,0,0
10,8478967.0,Lane Pederson,C,CBJ,26,0,0,0,0
10,8479333.0,Libor Hajek,D,NYR,25,0,0,0,0
10,8480833.0,Vitali Kravtsov,R,VAN,24,0,0,0,0
10,8477460.0,Laurent Dauphin,C,ARI,28,0,0,0,0
10,8481461.0,Corey Schueneman,D,MTL,28,0,0,0,0
10,8474190.0,Wayne Simmonds,R,TOR,35,0,0,0,0
10,8483549.0,Lucas Condotta,L,MTL,26,3,0,0,0
10,8477993.0,Justin Kirkland,C,ARI,27,2,0,0,0
10,8480935.0,Lawrence Pilut,D,BUF,28,0,0,0,0
10,8477210.0,Buddy Robinson,R,CHI,32,0,0,0,0
10,8476851.0,Alex Galchenyuk,C,COL,29,0,0,0,0
10,8482197.0,Adam Raska,R,MIN,22,5,0,0,0
10,8479366.0,Logan Brown,C,STL,25,0,0,0,0
10,8479356.0,Kieffer Bellows,L,PHI,25,0,0,0,0
10,8479533.0,Joona Koppanen,L,PIT,25,4,0,0,0
10,8477401.0,John Hayden,C,SEA,28,2,0,0,0
10,8480822.0,Martin Kaut,R,SJS,24,0,0,0,0
10,8474610.0,Zac Dalpe,C,FLA,34,0,0,0,0
10,8482399.0,Billy Sweezey,D,CBJ,27,0,0,0,0
10,8479991.0,Jake Leschyshyn,C,NYR,24,1,0,0,0
10,8479550.0,Tanner Laczynski,C,PHI,26,0,0,0,0
10,8476166.0,Taylor Fedun,D,PIT,35,0,0,0,0
10,8479338.0,Markus Niemelainen,D,EDM,25,0,0,0,0
10,8477320.0,Anton Blidh,L,NYR,28,1,0,0,0
10,8478147.0,Bokondji Imama,L,ARI,27,6,0,0,0
10,8478067.0,Oskar Lindblom,L,SJS,27,1,0,0,0
10,8478506.0,Gabriel Carlsson,D,WSH,26,0,0,0,0
10,8478131.0,Ondrej Kase,R,CAR,28,0,0,0,0
10,8479644.0,Matt Luff,R,DET,26,0,0,0,0
10,8482824.0,Nick Cicek,D,SJS,23,0,0,0,0
10,8482834.0,Jesper Froden,R,SEA,29,0,0,0,0
10,8478491.0,Jacob Larsson,D,OTT,26,0,0,0,0
10,8474089.0,Brad Malone,C,EDM,34,0,0,0,0
10,8482641.0,Matt Kiersted,D,FLA,25,0,0,0,0
10,8480071.0,Robin Salo,D,NYI,25,0,0,0,0
10,8475461.0,Andrew Agozzino,L,SJS,32,0,0,0,0
10,8475160.0,Kyle Clifford,L,TOR,32,0,0,0,0
10,8480056.0,Jack Rathbone,D,VAN,24,0,0,0,0
10,8481725.0,Elmer Soderblom,L,DET,22,0,0,0,0
10,8479465.0,Drake Caggiula,L,PIT,29,0,0,0,0
10,8476948.0,Charles Hudon,L,COL,29,0,0,0,0
10,8479523.0,Lucas Carlsson,D,FLA,26,0,0,0,0
10,8478455.0,Austin Wagner,L,CHI,26,0,0,0,0
10,8481572.0,Ville Heinola,D,WPG,22,0,0,0,0
10,8479404.0,Henrik Borgstrom,C,WSH,26,0,0,0,0
10,8479944.0,Zach Aston-Reese,C,DET,29,3,0,0,0
10,8482635.0,Mike Hardman,L,CHI,24,0,0,0,0
10,8479705.0,Jeffrey Viel,L,SJS,26,0,0,0,0
10,8480467.0,Austin Strand,D,ANA,26,0,0,0,0
10,8480037.0,Aleksi Heponiemi,C,FLA,24,0,0,0,0
10,8479573.0,Mikhail Maltsev,L,COL,25,0,0,0,0
10,8476404.0,Andy Andreoff,C,NYI,32,0,0,0,0
10,8484125.0,Hunter McKown,C,CBJ,21,0,0,0,0
10,8481649.0,Joona Luoto,L,CBJ,26,0,0,0,0
10,8477981.0,Roland McKeown,D,NSH,27,0,0,0,0
10,8480831.0,Alec Regula,D,CHI,23,0,0,0,0
10,8482691.0,Aatu Raty,C,VAN,21,0,0,0,0
10,8482623.0,Josh Dunne,C,CBJ,25,0,0,0,0
10,8481433.0,Taro Hirose,L,DET,27,0,0,0,0
10,8480328.0,David Gust,R,CHI,29,0,0,0,0
10,8479526.0,Otto Koivula,L,NYI,25,0,0,0,0
10,8476390.0,Joseph Cramarossa,C,MIN,31,0,0,0,0
10,8482654.0,Jackson Cates,C,PHI,26,0,0,0,0
10,8480439.0,Mac Hollowell,D,TOR,25,0,0,0,0
10,8480072.0,Lias Andersson,C,LAK,25,0,0,0,0
10,8479395.0,Dennis Cholowski,D,NYI,25,0,0,0,0
10,8477463.0,Steven Santini,D,STL,28,0,0,0,0
10,8479347.0,Tyler Benson,L,EDM,25,0,0,0,0
10,8477471.0,Dillon Heatherington,D,OTT,28,0,0,0,0
10,8477520.0,Jean-Sebastien Dea,C,ARI,29,0,0,0,0
10,8480846.0,Sampo Ranta,L,COL,23,0,0,0,0
10,8480979.0,Nathan Smith,C,ARI,25,0,0,0,0
10,8484256.0,Jake Livingstone,D,NSH,24,0,0,0,0
10,8476396.0,Steven Fogarty,C,MIN,30,0,0,0,0
10,8479252.0,Dan Renouf,D,BOS,29,0,0,0,0
10,8479518.0,Fredrik Karlström,C,DAL,25,0,0,0,0
10,8481683.0,Aidan McDonough,L,VAN,24,0,0,0,0
10,8478373.0,Nikita Soshnikov,R,NYI,30,0,0,0,0
10,8482081.0,Sean Farrell,C,MTL,22,0,0,0,0
10,8481575.0,Lassi Thomson,D,OTT,23,0,0,0,0
10,8481102.0,Egor Sokolov,L,OTT,23,0,0,0,0
10,8481712.0,Matej Blumel,R,DAL,23,0,0,0,0
10,8479602.0,Jeremy Davies,D,BUF,27,0,0,0,0
10,8480443.0,Kristian Reichel,C,WPG,25,0,0,0,0
10,8479304.0,Kyle Criscuolo,C,SJS,31,0,0,0,0
10,8478224.0,Luke Philp,C,CHI,28,0,0,0,0
10,8480242.0,Arnaud Durandeau,L,NYI,24,0,0,0,0
10,8479329.0,Frederic Allard,D,MTL,26,0,0,0,0
10,8476941.0,Connor Carrick,D,BOS,29,0,0,0,0
10,8479375.0,William Bitten,C,STL,25,0,0,0,0
10,8481720.0,Nick Abruzzese,C,TOR,24,0,0,0,0
10,8482452.0,Elliot Desnoyers,L,PHI,21,0,0,0,0
10,8476915.0,Jujhar Khaira,L,MIN,29,1,0,0,0
10,8483641.0,Anton Levtchi,L,FLA,28,0,0,0,0
10,8481740.0,Tyce Thompson,R,NJD,24,0,0,0,0
10,8478173.0,Hayden Hodgson,R,PHI,27,0,0,0,0
10,8482181.0,Tristen Robins,C,SJS,22,0,0,0,0
10,8481563.0,Drew Helleson,D,ANA,22,0,0,0,0
10,8480863.0,Gabriel Fortier,L,TBL,23,0,0,0,0
10,8478058.0,CJ Suess,L,SJS,29,0,0,0,0
10,8480041.0,Dmitri Samorukov,D,STL,24,0,0,0,0
10,8482179.0,Justin Richards,C,CBJ,25,0,0,0,0
10,8480034.0,Joel Teasdale,L,MTL,24,0,0,0,0
10,8480820.0,Filip Kral,D,TOR,24,0,0,0,0
10,8480842.0,Filip Hallander,C,PIT,23,0,0,0,0
10,8478367.0,Cole Bardreau,C,NYI,30,0,0,0,0
10,8482448.0,Samuel Knazko,D,CBJ,21,0,0,0,0
10,8482711.0,Stanislav Svozil,D,CBJ,20,0,0,0,0
10,8480275.0,Nick Swaney,R,MIN,26,0,0,0,0
10,8480994.0,Damien Giroux,C,MIN,23,0,0,0,0
10,8480977.0,Semyon Der-Arguchintsev,C,TOR,23,0,0,0,0
10,8482207.0,William Dufour,R,NYI,21,0,0,0,0
10,8483464.0,Marco Kasper,C,DET,19,0,0,0,0
10,8483424.0,Owen Beck,C,MTL,19,0,0,0,0
